εἰ δʼ ἄγε νῦν, Ἐρατώ, παρά θ᾽ἵστασο, καί μοι ἔνισπε,	- uu - uu- uu -uu - u u--	dactylic hexameter	masculine penthemimeral, trithemimeral
ἔνθεν ὅπως ἐς Ἰωλκὸν ἀνήγαγε κῶας Ἰήσων	-u u- u u-u u-uu -u u--	dactylic hexameter	feminine penthemimeral, trithemimeral
Μηδείης ὑπʼ ἔρωτι. σὺ γὰρ καὶ Κύπριδος αἶσαν	--- u u-u u - - -uu --	dactylic hexameter	feminine penthemimeral, hepthemimeral, trithemimeral
ἔμμορες, ἀδμῆτας δὲ τεοῖς μελεδήμασι θέλγεις	-uu --- u u- uu-uu --	dactylic hexameter	masculine penthemimeral, hepthemimeral
παρθενικάς· τῶ καί τοι ἐπήρατον οὔνομʼ ἀνῆπται.	-uu- - - u u-uu -u u--	dactylic hexameter	masculine penthemimeral, trithemimeral
ὧς οἱ μὲν πυκινοῖσιν ἀνωίστως δονάκεσσιν	- - - uu-u u--- uu--	dactylic hexameter	feminine penthemimeral, trithemimeral
μίμνον ἀριστῆες λελοχημένοι· αἱ δʼ ἐνόησαν	-u u--- uu-uu - uu--	dactylic hexameter	masculine penthemimeral
Ἥρη Ἀθηναίη τε, Διὸς δʼ αὐτοῖο καὶ ἄλλων	-u u--- u u- --u u --	dactylic hexameter	masculine penthemimeral, hepthemimeral
ἀθανάτων ἀπονόσφι θεῶν θάλαμόνδε κιοῦσαι	-uu- uu-u u- uu-u u--	dactylic hexameter	feminine penthemimeral, hepthemimeral, trithemimeral
βούλευον· πείραζε δʼ Ἀθηναίην πάρος Ἥρη·	--- --u u--- uu --	dactylic hexameter	feminine penthemimeral, trithemimeral
‘αὐτὴ νῦν προτέρη, θύγατερ Διός, ἄρχεο βουλῆς.	-- - uu- uu- uu -uu --	dactylic hexameter	masculine penthemimeral, hepthemimeral, trithemimeral
τί χρέος; ἠὲ δόλον τινὰ μήσεαι, ᾧ κεν ἑλόντες	- uu -u u- uu -uu - u u--	dactylic hexameter	masculine penthemimeral
χρύσεον Αἰήταο μεθʼ Ἑλλάδα κῶας ἄγοιντο,	-uu ---u u -uu -u u--	dactylic hexameter	feminine penthemimeral
ἦ καὶ τόν γʼ ἐπέεσσι παραιφάμενοι πεπίθοιεν	- - - uu-u u-uu- uu--	dactylic hexameter	feminine penthemimeral, trithemimeral
μειλιχίοις; ἦ γὰρ ὅ γʼ ὑπερφίαλος πέλει αἰνῶς.	-uu- - - u u-uu- uu --	dactylic hexameter	masculine penthemimeral, trithemimeral
ἔμπης δʼ οὔτινα πεῖραν ἀποτρωπᾶσθαι ἔοικεν.’	-- -uu -u u---u u--	dactylic hexameter	feminine penthemimeral
ὧς φάτο· τὴν δὲ παρᾶσσον Ἀθηναίη προσέειπεν·	- uu - u u-u u--- uu--	dactylic hexameter	feminine penthemimeral, trithemimeral
‘καὶ δʼ αὐτὴν ἐμὲ τοῖα μετὰ φρεσὶν ὁρμαίνουσαν,	- -- uu -u u- uu ----	dactylic hexameter	feminine penthemimeral, hepthemimeral, trithemimeral
Ἤρη, ἀπηλεγέως ἐξείρεαι. ἀλλά τοι οὔπω	-u u-uu- --uu -u u --	dactylic hexameter	masculine penthemimeral
φράσσασθαι νοέω τοῦτον δόλον, ὅστις ὀνήσει	--- uu- -- uu -u u--	dactylic hexameter	masculine penthemimeral, hepthemimeral, trithemimeral
θυμὸν ἀριστήων· πολέας δʼ ἐπεδοίασα βουλάς.’	-u u--- uu- uu-uu --	dactylic hexameter	masculine penthemimeral, hepthemimeral
ἦ, καὶ ἐπʼ οὔδεος αἵγε ποδῶν πάρος ὄμματʼ ἔπηξαν,	- u u -uu -u u- uu -u u--	dactylic hexameter	feminine penthemimeral, hepthemimeral
ἄνδιχα πορφύρουσαι ἐνὶ σφίσιν· αὐτίκα δʼ Ἥρη	-uu ---u u- uu -uu --	dactylic hexameter	feminine penthemimeral, hepthemimeral
τοῖον μητιόωσα παροιτέρη ἔκφατο μῦθον·	-- -uu-u u-uu -uu --	dactylic hexameter	feminine penthemimeral
‘δεῦρʼ ἴομεν μετὰ Κύπριν· ἐπιπλόμεναι δέ μιν ἄμφω	- uu- uu -u u-uu- u u --	dactylic hexameter	feminine penthemimeral, trithemimeral
παιδὶ ἑῷ εἰπεῖν ὀτρύνομεν, αἴ κε πίθηται	-u u- -- --uu - u u--	dactylic hexameter	masculine penthemimeral, trithemimeral
κούρην Αἰήτεω πολυφάρμακον οἷσι βέλεσσιν	-- --- uu-uu -u u--	dactylic hexameter	masculine penthemimeral
θέλξαι ὀιστεύσας ἐπʼ Ἰήσονι. τὸν δʼ ἂν ὀίω	-u u--- u u-uu - u u--	dactylic hexameter	masculine penthemimeral
κείνης ἐννεσίῃσιν ἐς Ἑλλάδα κῶας ἀνάξειν.’	-- -uu-u u -uu -u u--	dactylic hexameter	feminine penthemimeral
ὧς ἄρʼ ἔφη· πυκινὴ δὲ συνεύαδε μῆτις Ἀθήνῃ,	- u u- uu- u u-uu -u u--	dactylic hexameter	masculine penthemimeral, trithemimeral
καί μιν ἔπειτʼ ἐξαῦτις ἀμείβετο μειλιχίοισιν·	- u u- --u u-uu -uu--	dactylic hexameter	feminine penthemimeral, trithemimeral
‘Ἥρη, νήιδα μέν με πατὴρ τέκε τοῖο βολάων,	-- -uu - u u- uu -u u--	dactylic hexameter	masculine penthemimeral, hepthemimeral
οὐδέ τινα χρειὼ θελκτήριον οἶδα πόθοιο.	-u u- -- --uu -u u--	dactylic hexameter	masculine penthemimeral, trithemimeral
εἰ δέ σοι αὐτῇ μῦθος ἐφανδάνει, ἦ τʼ ἂν ἔγωγε	- u u -- -u u-uu - u u--	dactylic hexameter	feminine penthemimeral
ἑσποίμην· σὺ δέ κεν φαίης ἔπος ἀντιόωσα.’	--- u u - -- uu -uu--	dactylic hexameter	masculine penthemimeral, hepthemimeral, trithemimeral
ἦ, καὶ ἀναΐξασαι ἐπὶ μέγα δῶμα νέοντο	- u u-uu- uu -- -u u--	dactylic hexameter	masculine penthemimeral
Κύπριδος, ὅ ῥά τέ οἱ δεῖμεν πόσις ἀμφιγυήεις,	-uu - u u - -- uu -uu--	dactylic hexameter	masculine penthemimeral, hepthemimeral, trithemimeral
ὁππότε μιν τὰ πρῶτα παραὶ Διὸς ἦγεν ἄκοιτιν.	-uu - - -u u- uu -u u--	dactylic hexameter	feminine penthemimeral, hepthemimeral, trithemimeral
ἕρκεα δʼ εἰσελθοῦσαι ὑπʼ αἰθούσῃ θαλάμοιο	-uu ---u u --- uu--	dactylic hexameter	feminine penthemimeral
ἔσταν, ἵνʼ ἐντύνεσκε θεὰ λέχος Ἡφαίστοιο.	-u u ---u u- uu ----	dactylic hexameter	feminine penthemimeral, hepthemimeral
ἀλλʼ ὁ μὲν ἐς χαλκεῶνα καὶ ἄκμονας ἦρι βεβήκει,	- u u - --u u -uu -u u--	dactylic hexameter	feminine penthemimeral, trithemimeral
νήσοιο πλαγκτῆς εὐρὺν μυχόν, ᾧ ἔνι πάντα	--- -- -- uu - uu --	dactylic hexameter	masculine penthemimeral, hepthemimeral, trithemimeral
δαίδαλα χάλκευεν ῥιπῇ πυρόσʼ ἡ δʼ ἄρα μούνη	-uu --- -- uu - uu --	dactylic hexameter	masculine penthemimeral, hepthemimeral
ἧστο δόμῳ δινωτὸν ἀνὰ θρόνον, ἄντα θυράων.	-u u- --u u- uu -u u--	dactylic hexameter	feminine penthemimeral, hepthemimeral, trithemimeral
λευκοῖσιν δʼ ἑκάτερθε κόμας ἐπιειμένη ὤμοις	--- uu-u u- uu-uu --	dactylic hexameter	feminine penthemimeral, hepthemimeral, trithemimeral
κόσμει χρυσείῃ διὰ κερκίδι, μέλλε δὲ μακροὺς	-- --- uu -uu -u u --	dactylic hexameter	masculine penthemimeral
πλέξασθαι πλοκάμους· τὰς δὲ προπάροιθεν ἰδοῦσα	--- uu- - - uu-u u--	dactylic hexameter	masculine penthemimeral, hepthemimeral, trithemimeral
ἔσχεθεν, εἴσω τέ σφʼ ἐκάλει, καὶ ἀπὸ θρόνου ὦρτο,	-uu -- - uu- u u- uu --	dactylic hexameter	masculine penthemimeral, hepthemimeral
εἷσέ τʼ ἐνὶ κλισμοῖσιν· ἀτὰρ μετέπειτα καὶ αὐτὴ	-u u- --u u- uu-u u --	dactylic hexameter	feminine penthemimeral, hepthemimeral, trithemimeral
ἵζανεν, ἀψήκτους δὲ χεροῖν ἀνεδήσατο χαίτας.	-uu --- u u- uu-uu --	dactylic hexameter	masculine penthemimeral, hepthemimeral
τοῖα δὲ μειδιόωσα προσέννεπεν αἱμυλίοισιν·	-u u -uu-u u-uu -uu--	dactylic hexameter	feminine penthemimeral
‘Ἠθεῖαι, τίς δεῦρο νόος χρειω τε κομίζει	--- - -u u- -- u u--	dactylic hexameter	feminine penthemimeral, hepthemimeral, trithemimeral
δηναιὰς αὔτως; τί δʼ ἱκάνετον, οὔτι πάρος γε	--- -- u u-uu -u u- -	dactylic hexameter	masculine penthemimeral, trithemimeral
λίην φοιτίζουσαι, ἐπεὶ περίεστε θεάων;’	-- ---u u- uu-u u--	dactylic hexameter	feminine penthemimeral, hepthemimeral
τὴν δʼ Ἥρη τοίοισιν ἀμειβομένη προσέειπεν·	- -- --u u-uu- uu--	dactylic hexameter	feminine penthemimeral, trithemimeral
‘Κερτομέεις· νῶιν δὲ κέαρ συνορίνεται ἄτῃ.	-uu- -- u u- uu-uu --	dactylic hexameter	masculine penthemimeral, hepthemimeral, trithemimeral
ἤδη γὰρ ποταμῷ ἐνὶ Φάσιδι νῆα κατίσχει	-- - uu- uu -uu -u u--	dactylic hexameter	masculine penthemimeral, trithemimeral
Αἰσονίδης, ἠδʼ ἄλλοι ὅσοι μετὰ κῶας ἕπονται.	-uu- - -u u- uu -u u--	dactylic hexameter	feminine penthemimeral, hepthemimeral, trithemimeral
τῶν ἤτοι πάντων μέν, ἐπεὶ πέλας ἔργον ὄρωρεν,	- -- -- u u- uu -u u--	dactylic hexameter	masculine penthemimeral, hepthemimeral, trithemimeral
δείδιμεν ἐκπάγλως, περὶ δʼ Αἰσονίδαο μάλιστα.	-uu --- uu -uu-u u--	dactylic hexameter	masculine penthemimeral
τὸν μὲν ἐγών, εἰ καί περ ἐς Ἄιδα ναυτίλληται	- u u- - - u u -- ----	dactylic hexameter	masculine penthemimeral, trithemimeral
λυσόμενος χαλκέων Ἰξίονα νειόθι δεσμῶν,	-uu- -- --uu -uu --	dactylic hexameter	masculine penthemimeral, trithemimeral
ῥύσομαι, ὅσσον ἐμοῖσιν ἐνὶ σθένος ἔπλετο γυίοις,	-uu -u u-u u- uu -uu --	dactylic hexameter	feminine penthemimeral, hepthemimeral
ὄφρα μὴ ἐγγελάσῃ Πελίης κακὸν οἶτον ἀλύξας,	-u u -uu- uu- uu -u u--	dactylic hexameter	masculine penthemimeral, hepthemimeral
ὅς μ᾽ὑπερηνορέῃ θυέων ἀγέραστον ἔθηκεν.	- uu-uu- uu- uu-u u--	dactylic hexameter	masculine penthemimeral, hepthemimeral
καὶ δʼ ἄλλως ἔτι καὶ πρὶν ἐμοὶ μέγα φίλατʼ Ἰήσων	- -- uu - u u- uu -u u--	dactylic hexameter	masculine penthemimeral, hepthemimeral, trithemimeral
ἐξότʼ ἐπὶ προχοῇσιν ἅλις πλήθοντος Ἀναύρου	-u u- uu-u u- --u u--	dactylic hexameter	feminine penthemimeral, hepthemimeral, trithemimeral
ἀνδρῶν εὐνομίης πειρωμένῃ ἀντεβόλησεν	-- -uu- --uu -uu--	dactylic hexameter	masculine penthemimeral
θήρης ἐξανιών· νιφετῷ δʼ ἐπαλύνετο πάντα	-- -uu- uu- uu-uu --	dactylic hexameter	masculine penthemimeral, hepthemimeral
οὔρεα καὶ σκοπιαὶ περιμήκεες, οἱ δὲ κατʼ αὐτῶν	-uu - uu- uu-uu - u u --	dactylic hexameter	masculine penthemimeral, trithemimeral
χείμαρροι καναχηδὰ κυλινδόμενοι φορέοντο.	--- uu-u u-uu- uu--	dactylic hexameter	feminine penthemimeral, trithemimeral
γρηὶ δέ μ᾽εἰσαμένην ὀλοφύρατο, καί μ᾽ἀναείρας	-u u -uu- uu-uu - uu--	dactylic hexameter	masculine penthemimeral
αὐτὸς ἑοῖς ὤμοισι διὲκ προαλὲς φέρεν ὕδωρ.	-u u- --u u- uu- uu --	dactylic hexameter	feminine penthemimeral, hepthemimeral, trithemimeral
τῶ νύ μοι ἄλληκτον περιτίεται· οὐδέ κε λώβην	- u u --- uu-uu -u u --	dactylic hexameter	masculine penthemimeral
τίσειεν Πελίης, εἰ μή σύ γε νόστον ὀπάσσεις.’	--- uu- - - u u -u u--	dactylic hexameter	masculine penthemimeral, hepthemimeral, trithemimeral
ὧς ηὔδα· Κύπριν δʼ ἐνεοστασίη λάβε μύθων.	- -- -- uu-uu- uu --	dactylic hexameter	masculine penthemimeral, trithemimeral
ἅζετο δʼ ἀντομένην Ἥρην ἕθεν εἰσορόωσα,	-uu -uu- -- uu -uu--	dactylic hexameter	masculine penthemimeral, hepthemimeral
καί μιν ἔπειτʼ ἀγανοῖσι προσέννεπεν ἥ γʼ ἐπέεσσιν·	- u u- uu-u u-uu - uu--	dactylic hexameter	feminine penthemimeral, trithemimeral
‘πότνα θεά, μή τοί τι κακώτερον ἄλλο πέλοιτο	-u u- - - u u-uu -u u--	dactylic hexameter	masculine penthemimeral, trithemimeral
Κύπριδος, εἰ δὴ σεῖο λιλαιομένης ἀθερίζω	-uu - - -u u-uu- uu--	dactylic hexameter	feminine penthemimeral, trithemimeral
ἢ ἔπος ἠέ τι ἔργον, ὅ κεν χέρες αἵγε κάμοιεν	- uu -u u -u u - uu -u u--	dactylic hexameter	feminine penthemimeral, hepthemimeral
ἠπεδαναί· καὶ μή τις ἀμοιβαίη χάρις ἔστω.’	-uu- - - u u--- uu --	dactylic hexameter	masculine penthemimeral, trithemimeral
ὧς ἔφαθʼ· Ἥρη δʼ αὖτις ἐπιφραδέως ἀγορευσεν·	- uu -- -u u-uu- uu--	dactylic hexameter	feminine penthemimeral
‘οὔτι βίης χατέουσαι ἱκάνομεν, οὐδέ τι χειρῶν.	-u u- uu-u u-uu -u u --	dactylic hexameter	feminine penthemimeral, trithemimeral
ἀλλʼ αὔτως ἀκέουσα τεῷ ἐπικέκλεο παιδὶ	- -- uu-u u- uu-uu --	dactylic hexameter	feminine penthemimeral, hepthemimeral, trithemimeral
παρθένον Αἰήτεω θέλξαι πόθῳ Αἰσονίδαο.	-uu --- -- uu -uu--	dactylic hexameter	masculine penthemimeral, hepthemimeral
εἰ γάρ οἱ κείνη συμφράσσεται εὐμενέουσα,	- - - -- --uu -uu--	dactylic hexameter	masculine penthemimeral, trithemimeral
ῥηιδίως μιν ἑλόντα δέρος χρύσειον ὀίω	-uu- u u-u u- --u u--	dactylic hexameter	feminine penthemimeral, hepthemimeral, trithemimeral
νοστήσειν ἐς Ἰωλκόν, ἐπεὶ δολόεσσα τέτυκται.’	--- u u-u u- uu-u u--	dactylic hexameter	feminine penthemimeral, hepthemimeral, trithemimeral
ὧς ἄρʼ ἔφη· Κύπρις δὲ μετʼ ἀμφοτέρῃσιν ἔειπεν·	- u u- -- u u -uu-u u--	dactylic hexameter	masculine penthemimeral, trithemimeral
‘Ἥρη, Ἀθηναίη τε, πίθοιτό κεν ὔμμι μάλιστα,	-u u--- u u-u u -u u--	dactylic hexameter	masculine penthemimeral
ἢ ἐμοί. ὑμείων γὰρ ἀναιδήτῳ περ ἐόντι	- uu --- u u--- u u--	dactylic hexameter	masculine penthemimeral
τυτθή γ᾽αἰδὼς ἔσσετʼ ἐν ὄμμασιν· αὐτὰρ ἐμεῖο	-- -- -u u -uu -u u--	dactylic hexameter	feminine penthemimeral
οὐκ ὄθεται, μάλα δʼ αἰὲν ἐριδμαίνων ἀθερίζει.	- uu- uu -u u--- uu--	dactylic hexameter	feminine penthemimeral, trithemimeral
καὶ δή οἱ μενέηνα, περισχομένη κακότητι,	- - - uu-u u-uu- uu--	dactylic hexameter	feminine penthemimeral, trithemimeral
αὐτοῖσιν τόξοισι δυσηχέας ἆξαι ὀιστοὺς	--- --u u-uu -u u--	dactylic hexameter	feminine penthemimeral, trithemimeral
ἀμφαδίην. τοῖον γὰρ ἐπηπείλησε χαλεφθείς,	-uu- -- u u---u u--	dactylic hexameter	masculine penthemimeral, trithemimeral
εἰ μὴ τηλόθι χεῖρας, ἕως ἔτι θυμὸν ἐρύκει,	- - -uu -u u- uu -u u--	dactylic hexameter	feminine penthemimeral, hepthemimeral
ἕξω ἐμάς, μετέπειτά γ᾽ἀτεμβοίμην ἑοῖ αὐτῇ.’	-u u- uu-u u--- uu --	dactylic hexameter	feminine penthemimeral, trithemimeral
ὧς φάτο· μείδησαν δὲ θεαί, καὶ ἐσέδρακον ἄντην	- uu --- u u- u u-uu --	dactylic hexameter	masculine penthemimeral, hepthemimeral
ἀλλήλαις. ἡ δʼ αὖτις ἀκηχεμένη προσέειπεν·	--- - -u u-uu- uu--	dactylic hexameter	feminine penthemimeral, trithemimeral
‘ἄλλοις ἄλγεα τἀμὰ γέλως πέλει· οὐδέ τί με χρὴ	-- -uu -u u- uu -u u - -	dactylic hexameter	feminine penthemimeral, hepthemimeral
μυθεῖσθαι πάντεσσιν· ἅλις εἰδυῖα καὶ αὐτή.	--- --u u- --u u --	dactylic hexameter	feminine penthemimeral, hepthemimeral, trithemimeral
νῦν δʼ ἐπεὶ ὔμμι φίλον τόδε δὴ πέλει ἀμφοτέρῃσιν,	- uu -u u- uu - uu -uu--	dactylic hexameter	masculine penthemimeral, hepthemimeral
πειρήσω, καί μιν μειλίξομαι, οὐδʼ ἀπιθήσει.’	--- - - --uu - uu--	dactylic hexameter	masculine penthemimeral, trithemimeral
ὧς φάτο· τὴν δʼ Ἥρη ῥαδινῆς ἐπεμάσσατο χειρός,	- uu - -- uu- uu-uu --	dactylic hexameter	masculine penthemimeral, hepthemimeral, trithemimeral
ἦκα δὲ μειδιόωσα παραβλήδην προσέειπεν·	-u u -uu-u u--- uu--	dactylic hexameter	feminine penthemimeral
‘οὕτω νῦν, Κυθέρεια, τόδε χρέος, ὡς ἀγορεύεις,	-- - uu-u u- uu - uu--	dactylic hexameter	feminine penthemimeral, hepthemimeral, trithemimeral
ἔρξον ἄφαρ· καὶ μή τι χαλέπτεο, μηδʼ ἐρίδαινε	-u u- - - u u-uu - uu--	dactylic hexameter	masculine penthemimeral, trithemimeral
χωομένη σῷ παιδί· μεταλλήξει γὰρ ὀπίσσω.’	-uu- - -u u--- u u--	dactylic hexameter	feminine penthemimeral, trithemimeral
ἦ ῥα, καὶ ἔλλιπε θῶκον· ἐφωμάρτησε δʼ Ἀθήνη·	- u u -uu -u u---u u--	dactylic hexameter	feminine penthemimeral
ἐκ δʼ ἴσαν ἄμφω ταίγε παλίσσυτοι. ἡ δὲ καὶ αὐτὴ	- uu -- -u u-uu - u u --	dactylic hexameter	feminine penthemimeral
βῆ ῥʼ ἴμεν Οὐλύμποιο κατὰ πτύχας, εἴ μιν ἐφεύροι.	- uu ---u u- uu - u u--	dactylic hexameter	feminine penthemimeral, hepthemimeral
εὗρε δὲ τόν γʼ ἀπάνευθε Διὸς θαλερῇ ἐν ἀλωῇ,	-u u - uu-u u- uu- u u--	dactylic hexameter	feminine penthemimeral, hepthemimeral, trithemimeral
οὐκ οἶον, μετα καὶ Γανυμήδεα, τόν ῥά ποτε Ζεὺς	- -- uu - uu-uu - u u- -	dactylic hexameter	masculine penthemimeral, trithemimeral
οὐρανῷ ἐγκατένασσεν ἐφέστιον ἀθανάτοισιν,	-uu -uu-u u-uu -uu--	dactylic hexameter	feminine penthemimeral
κάλλεος ἱμερθείς. ἀμφʼ ἀστραγάλοισι δὲ τώγε	-uu --- - -uu-u u --	dactylic hexameter	masculine penthemimeral
χρυσείοις, ἅ τε κοῦροι ὁμήθεες, ἑψιόωντο.	--- u u -u u-uu -uu--	dactylic hexameter	feminine penthemimeral, trithemimeral
καί ῥʼ ὁ μὲν ἤδη πάμπαν ἐνίπλεον ᾧ ὑπὸ μαζῷ	- u u -- -u u-uu - uu --	dactylic hexameter	feminine penthemimeral
μάργος Ἔρως λαιῆς ὑποΐσχανε χειρὸς ἀγοστόν,	-u u- -- uu-uu -u u--	dactylic hexameter	masculine penthemimeral, trithemimeral
ὀρθὸς ἐφεστηώς· γλυκερὸν δέ οἱ ἀμφὶ παρειὰς	-u u--- uu- u u -u u--	dactylic hexameter	masculine penthemimeral, hepthemimeral
χροιῇ θάλλεν ἔρευθος. ὁ δʼ ἐγγύθεν ὀκλαδὸν ἧστο	-- -u u-u u -uu -uu --	dactylic hexameter	feminine penthemimeral
σῖγα κατηφιόων· δοιὼ δʼ ἔχεν, ἄλλον ἔτʼ αὔτως	-u u-uu- -- uu -u u --	dactylic hexameter	masculine penthemimeral, hepthemimeral
ἄλλῳ ἐπιπροϊείς, κεχόλωτο δὲ καγχαλόωντι.	-u u-uu- uu-u u -uu--	dactylic hexameter	masculine penthemimeral
καὶ μὴν τούσγε παρᾶσσον ἐπὶ προτέροισιν ὀλέσσας	- - -u u-u u- uu-u u--	dactylic hexameter	feminine penthemimeral, hepthemimeral
βῆ κενεαῖς σὺν χερσὶν ἀμήχανος, οὐδʼ ἐνόησεν	- uu- - -u u-uu - uu--	dactylic hexameter	feminine penthemimeral, trithemimeral
Κύπριν ἐπιπλομένην. ἡ δʼ ἀντίη ἵστατο παιδός,	-u u-uu- - -uu -uu --	dactylic hexameter	masculine penthemimeral
καί μιν ἄφαρ γναθμοῖο κατασχομένη προσέειπεν·	- u u- --u u-uu- uu--	dactylic hexameter	feminine penthemimeral, trithemimeral
‘τίπτʼ ἐπιμειδιάᾳς, ἄφατον κακόν; ἦέ μιν αὔτως	- uu-uu- uu- uu -u u --	dactylic hexameter	masculine penthemimeral, hepthemimeral
ἤπαφες, οὐδὲ δίκῃ περιέπλεο νῆιν ἐόντα;	-uu -u u- uu-uu -u u--	dactylic hexameter	masculine penthemimeral
εἰ δʼ ἄγε μοι πρόφρων τέλεσον χρέος, ὅττι κεν εἴπω·	- uu - -- uu- uu -u u --	dactylic hexameter	masculine penthemimeral, hepthemimeral, trithemimeral
καί κέν τοι ὀπάσαιμι Διὸς περικαλλὲς ἄθυρμα	- - - uu-u u- uu-u u--	dactylic hexameter	feminine penthemimeral, hepthemimeral, trithemimeral
κεῖνο, τό οἱ ποίησε φίλη τροφὸς Ἀδρήστεια	-u u - --u u- uu ----	dactylic hexameter	feminine penthemimeral, hepthemimeral, trithemimeral
ἄντρῳ ἐν Ἰδαίῳ ἔτι νήπια κουρίζοντι,	-u u --- uu -uu ----	dactylic hexameter	masculine penthemimeral
σφαῖραν ἐυτρόχαλον, τῆς οὐ σύγε μείλιον ἄλλο	-u u-uu- - - uu -uu --	dactylic hexameter	masculine penthemimeral, hepthemimeral
χειρῶν Ἡφαίστοιο κατακτεατίσσῃ ἄρειον.	-- ---u u-uu-u u--	dactylic hexameter	feminine penthemimeral
χρύσεα μέν οἱ κύκλα τετεύχαται· ἀμφὶ δʼ ἑκάστῳ	-uu - - -u u-uu -u u--	dactylic hexameter	feminine penthemimeral, trithemimeral
διπλόαι ἁψῖδες περιηγέες εἱλίσσονται·	-uu --- uu-uu ----	dactylic hexameter	masculine penthemimeral
κρυπταὶ δὲ ῥαφαί εἰσιν· ἕλιξ δʼ ἐπιδέδρομε πάσαις	-- - uu -u u- uu-uu --	dactylic hexameter	feminine penthemimeral, hepthemimeral, trithemimeral
κυανέη. ἀτὰρ εἴ μιν ἑαῖς ἐνὶ χερσὶ βάλοιο,	-uu- uu - u u- uu -u u--	dactylic hexameter	masculine penthemimeral, hepthemimeral, trithemimeral
ἀστὴρ ὥς, φλεγέθοντα διʼ ἠέρος ὁλκὸν ἵησιν.	-- - uu-u u -uu -u u--	dactylic hexameter	feminine penthemimeral, trithemimeral
τήν τοι ἐγὼν ὀπάσω· σὺ δὲ παρθένον Αἰήταο	- u u- uu- u u -uu ----	dactylic hexameter	masculine penthemimeral, trithemimeral
θέλξον ὀιστεύσας ἐπʼ Ἰήσονι· μηδέ τις ἔστω	-u u--- u u-uu -u u --	dactylic hexameter	masculine penthemimeral
ἀμβολίη. δὴ γάρ κεν ἀφαυροτέρη χάρις εἴη.’	-uu- - - u u-uu- uu --	dactylic hexameter	masculine penthemimeral, trithemimeral
ὧς φάτο· τῷ δʼ ἀσπαστὸν ἔπος γένετʼ εἰσαΐοντι.	- uu - --u u- uu -uu--	dactylic hexameter	feminine penthemimeral, hepthemimeral, trithemimeral
μείλια δʼ ἔκβαλε πάντα, καὶ ἀμφοτέρῃσι χιτῶνος	-uu -uu -u u -uu-u u--	dactylic hexameter	feminine penthemimeral
νωλεμὲς ἔνθα καὶ ἔνθα θεᾶς ἔχεν ἀμφιμεμαρπώς.	-uu -u u -u u- uu -uu--	dactylic hexameter	feminine penthemimeral, hepthemimeral
λίσσετο δʼ αἶψα πορεῖν αὐτοσχεδόν· ἡ δʼ ἀγανοῖσιν	-uu -u u- --uu - uu--	dactylic hexameter	masculine penthemimeral
ἀντομένη μύθοισιν, ἐπειρύσσασα παρειάς,	-uu- --u u---u u--	dactylic hexameter	feminine penthemimeral, trithemimeral
κύσσε ποτισχομένη, καὶ ἀμείβετο μειδιόωσα·	-u u-uu- u u-uu -uu--	dactylic hexameter	masculine penthemimeral
‘ἴστω νῦν τόδε σεῖο φίλον κάρη ἠδʼ ἐμὸν αὐτῆς,	-- - uu -u u- uu - uu --	dactylic hexameter	feminine penthemimeral, hepthemimeral, trithemimeral
ἦ μέν τοι δῶρόν γε παρέξομαι, οὐδʼ ἀπατήσω,	- - - -- u u-uu - uu--	dactylic hexameter	masculine penthemimeral, trithemimeral
εἴ κεν ἐνισκίμψῃς κούρῃ βέλος Αἰήταο.’	- u u--- -- uu ----	dactylic hexameter	masculine penthemimeral, hepthemimeral
φῆ· ὁ δʼ ἄρʼ ἀστραγάλους συναμήσατο, κὰδ δὲ φαεινῷ	- u u -uu- uu-uu - u u--	dactylic hexameter	masculine penthemimeral
μητρὸς ἑῆς εὖ πάντας ἀριθμήσας βάλε κόλπῳ.	-u u- - -u u--- uu --	dactylic hexameter	feminine penthemimeral, trithemimeral
αὐτίκα δʼ ἰοδόκην χρυσέῃ περικάτθετο μίτρῃ	-uu -uu- uu- uu-uu --	dactylic hexameter	masculine penthemimeral, hepthemimeral
πρέμνῳ κεκλιμένην· ἀνὰ δʼ ἀγκύλον εἵλετο τόξον.	-- -uu- uu -uu -uu --	dactylic hexameter	masculine penthemimeral
βῆ δὲ διὲκ μεγάροιο Διὸς πάγκαρπον ἀλωήν.	- u u- uu-u u- --u u--	dactylic hexameter	feminine penthemimeral, hepthemimeral, trithemimeral
αὐτὰρ ἔπειτα πύλας ἐξήλυθεν Οὐλύμποιο	-u u-u u- --uu ----	dactylic hexameter	masculine penthemimeral
αἰθερίας· ἔνθεν δὲ καταιβάτις ἐστὶ κέλευθος	-uu- -- u u-uu -u u--	dactylic hexameter	masculine penthemimeral, trithemimeral
οὐρανίη· δοιὼ δὲ πόλοι ἀνέχουσι κάρηνα	-uu- -- u u- uu-u u--	dactylic hexameter	masculine penthemimeral, hepthemimeral, trithemimeral
οὐρέων ἠλιβάτων, κορυφαὶ χθονός, ᾗχί τʼ ἀερθεὶς	-- -uu- uu- uu -u u--	dactylic hexameter	masculine penthemimeral, hepthemimeral
ἠέλιος πρώτῃσιν ἐρεύθεται ἀκτίνεσσιν.	-uu- --u u-uu ----	dactylic hexameter	feminine penthemimeral, trithemimeral
νειόθι δʼ ἄλλοτε γαῖα φερέσβιος ἄστεά τʼ ἀνδρῶν	-uu -uu -u u-uu -uu --	dactylic hexameter	feminine penthemimeral
φαίνετο καὶ ποταμῶν ἱεροὶ ῥόοι, ἄλλοτε δʼ αὖτε	-uu - uu- uu- uu -uu --	dactylic hexameter	masculine penthemimeral, hepthemimeral, trithemimeral
ἄκριες, ἀμφὶ δὲ πόντος ἀνʼ αἰθέρα πολλὸν ἰόντι.	-uu -u u -u u -uu -u u--	dactylic hexameter	feminine penthemimeral
ἥρωες δʼ ἀπάνευθεν ἑῆς ἐπὶ σέλμασι νηὸς	--- uu-u u- uu -uu --	dactylic hexameter	feminine penthemimeral, hepthemimeral, trithemimeral
ἐν ποταμῷ καθʼ ἕλος λελοχημένοι ἠγορόωντο.	- uu- u u- uu-uu -uu--	dactylic hexameter	masculine penthemimeral, trithemimeral
αὐτὸς δʼ Αἰσονίδης μετεφώνεεν· οἱ δʼ ὑπάκουον	-- -uu- uu-uu - uu--	dactylic hexameter	masculine penthemimeral
ἠρέμας ᾗ ἐνὶ χώρῃ ἐπισχερὼ ἑδριόωντες·	-uu - uu -u u-uu -uu--	dactylic hexameter	feminine penthemimeral, trithemimeral
‘ὦ φίλοι, ἤτοι ἐγὼ μὲν ὅ μοι ἐπιανδάνει αὐτῷ	- uu -u u- u u - uu-uu --	dactylic hexameter	masculine penthemimeral, hepthemimeral
ἐξερέω· τοῦ δʼ ὔμμι τέλος κρηῆναι ἔοικεν.	-uu- - -u u- --u u--	dactylic hexameter	feminine penthemimeral, hepthemimeral, trithemimeral
ξυνὴ γὰρ χρειώ, ξυνοὶ δέ τε μῦθοι ἔασιν	-- - -- -- u u -u u--	dactylic hexameter	masculine penthemimeral, hepthemimeral, trithemimeral
πᾶσιν ὁμῶς· ὁ δὲ σῖγα νόον βουλήν τʼ ἀπερύκων	-u u- u u -u u- -- uu--	dactylic hexameter	feminine penthemimeral, hepthemimeral, trithemimeral
ἴστω καὶ νόστου τόνδε στόλον οἶος ἀπούρας.	-- - -- -- uu -u u--	dactylic hexameter	masculine penthemimeral, hepthemimeral, trithemimeral
ὧλλοι μὲν κατὰ νῆα σὺν ἔντεσι μίμνεθʼ ἕκηλοι·	-- - uu -u u -uu -u u--	dactylic hexameter	feminine penthemimeral, trithemimeral
αὐτὰρ ἐγὼν ἐς δώματʼ ἐλεύσομαι Αἰήταο,	-u u- - -u u-uu ----	dactylic hexameter	feminine penthemimeral, trithemimeral
υἷας ἑλὼν Φρίξοιο δύω δʼ ἐπὶ τοῖσιν ἑταίρους.	-u u- --u u- uu -u u--	dactylic hexameter	feminine penthemimeral, hepthemimeral, trithemimeral
πειρήσω δʼ ἐπέεσσι παροίτερον ἀντιβολήσας,	--- uu-u u-uu -uu--	dactylic hexameter	feminine penthemimeral, trithemimeral
εἴ κʼ ἐθέλοι φιλότητι δέρος χρύσειον ὀπάσσαι,	- uu- uu-u u- --u u--	dactylic hexameter	feminine penthemimeral, hepthemimeral, trithemimeral
ἦε καὶ οὔ, πίσυνος δὲ βίῃ μετιόντας ἀτίσσει.	-u u - uu- u u- uu-u u--	dactylic hexameter	masculine penthemimeral, hepthemimeral, trithemimeral
ὧδε γὰρ ἐξ αὐτοῖο πάρος κακότητα δαέντες	-u u - --u u- uu-u u--	dactylic hexameter	feminine penthemimeral, hepthemimeral, trithemimeral
φρασσόμεθʼ, εἴτʼ ἄρηι συνοισόμεθʼ εἴτε τις ἄλλη	-uu - --u u-uu -u u --	dactylic hexameter	feminine penthemimeral, trithemimeral
μῆτις ἐπίρροθος ἔσται ἐεργομένοισιν ἀυτῆς.	-u u-uu -u u-uu-u u--	dactylic hexameter	feminine penthemimeral
μηδʼ αὔτως ἀλκῇ, πρὶν ἔπεσσί γε πειρηθῆναι,	- -- -- u u-u u ----	dactylic hexameter	masculine penthemimeral, trithemimeral
τόνδʼ ἀπαμείρωμεν σφέτερον κτέρας. ἀλλὰ πάροιθεν	- uu--- uu- uu -u u--	dactylic hexameter	masculine penthemimeral, hepthemimeral
λωίτερον μύθῳ μιν ἀρέσσασθαι μετιόντας.	-uu- -- u u--- uu--	dactylic hexameter	masculine penthemimeral, trithemimeral
πολλάκι τοι ῥέα μῦθος, ὅ κεν μόλις ἐξανύσειεν	-uu - uu -u u - uu -uu--	dactylic hexameter	feminine penthemimeral, hepthemimeral, trithemimeral
ἠνορέη, τόδʼ ἔρεξε κατὰ χρέος, ᾗπερ ἐῴκει	-uu- u u-u u- uu -u u--	dactylic hexameter	feminine penthemimeral, hepthemimeral, trithemimeral
πρηΰνας. ὁ δὲ καί ποτʼ ἀμύμονα Φρίξον ἔδεκτο	--- u u - u u-uu -u u--	dactylic hexameter	masculine penthemimeral, trithemimeral
μητρυιῆς φεύγοντα δόλον πατρός τε θυηλάς.	--- --u u- -- u u--	dactylic hexameter	feminine penthemimeral, hepthemimeral, trithemimeral
πάντες ἐπεὶ πάντῃ καὶ ὅτις μάλα κύντατος ἀνδρῶν,	-u u- -- u u- uu -uu --	dactylic hexameter	masculine penthemimeral, hepthemimeral, trithemimeral
ξεινίου αἰδεῖται Ζηνὸς θέμιν ἠδʼ ἀλεγίζει.’	-uu --- -- uu - uu--	dactylic hexameter	masculine penthemimeral, hepthemimeral
ὧς φάτʼ· ἐπῄνησαν δὲ νέοι ἔπος Αἰσονίδαο	- u u--- u u- uu -uu--	dactylic hexameter	masculine penthemimeral, hepthemimeral
πασσυδίῃ, οὐδʼ ἔσκε παρὲξ ὅτις ἄλλο κελεύοι.	-uu- - -u u- uu -u u--	dactylic hexameter	feminine penthemimeral, hepthemimeral, trithemimeral
καὶ τότʼ ἄρʼ υἱῆας Φρίξου Τελαμῶνά θ᾽ἕπεσθαι	- u u --- -- uu-u u--	dactylic hexameter	masculine penthemimeral, hepthemimeral
ὦρσε καὶ Αὐγείην· αὐτὸς δʼ ἕλεν Ἑρμείαο	-u u --- -- uu ----	dactylic hexameter	masculine penthemimeral, hepthemimeral
σκῆπτρον· ἄφαρ δʼ ἄρα νηὸς ὑπὲρ δόνακάς τε καὶ ὕδωρ	-u u- uu -u u- uu- u u --	dactylic hexameter	feminine penthemimeral, hepthemimeral, trithemimeral
χέρσονδʼ ἐξαπέβησαν ἐπὶ θρῳσμοῦ πεδίοιο.	-- -uu-u u- -- uu--	dactylic hexameter	feminine penthemimeral, hepthemimeral
Κιρκαῖον τόδε που κικλήσκεται· ἔνθα δὲ πολλαὶ	--- uu - --uu -u u --	dactylic hexameter	masculine penthemimeral, trithemimeral
ἑξείης πρόμαλοί τε καὶ ἰτέαι ἐκπεφύασιν,	--- uu- u u -uu -uu--	dactylic hexameter	masculine penthemimeral, trithemimeral
τῶν καὶ ἐπʼ ἀκροτάτων νέκυες σειρῇσι κρέμανται	- u u -uu- uu- --u u--	dactylic hexameter	masculine penthemimeral, hepthemimeral
δέσμιοι. εἰσέτι νῦν γὰρ ἄγος Κόλχοισιν ὄρωρεν	-uu -uu - u u- --u u--	dactylic hexameter	masculine penthemimeral, hepthemimeral
ἀνέρας οἰχομένους πυρὶ καιέμεν· οὐδʼ ἐνὶ γαίῃ	-uu -uu- uu -uu - uu --	dactylic hexameter	masculine penthemimeral
ἔστι θέμις στείλαντας ὕπερθʼ ἐπὶ σῆμα χέεσθαι,	-u u- --u u- uu -u u--	dactylic hexameter	feminine penthemimeral, hepthemimeral, trithemimeral
ἀλλʼ ἐν ἀδεψήτοισι κατειλύσαντε βοείαις	- u u---u u---u u--	dactylic hexameter	feminine penthemimeral
δενδρέων ἐξάπτειν ἑκὰς ἄστεος. ἠέρι δʼ ἴσην	-- --- uu -uu -uu --	dactylic hexameter	masculine penthemimeral
καὶ χθὼν ἔμμορεν αἶσαν, ἐπεὶ χθονὶ ταρχύουσιν	- - -uu -u u- uu ----	dactylic hexameter	feminine penthemimeral, hepthemimeral
θηλυτέρας· ἡ γάρ τε δίκη θεσμοῖο τέτυκται.	-uu- - - u u- --u u--	dactylic hexameter	masculine penthemimeral, hepthemimeral, trithemimeral
τοῖσι δὲ νισσομένοις Ἥρη φίλα μητιόωσα	-u u -uu- -- uu -uu--	dactylic hexameter	masculine penthemimeral, hepthemimeral
ἠέρα πουλὺν ἐφῆκε διʼ ἄστεος, ὄφρα λάθοιεν	-uu -u u-u u -uu -u u--	dactylic hexameter	feminine penthemimeral
Κόλχων μυρίον ἔθνος ἐς Αἰήταο κιόντες.	-- -uu -u u ---u u--	dactylic hexameter	feminine penthemimeral
ὦκα δʼ ὅτʼ ἐκ πεδίοιο πόλιν καὶ δώμαθʼ ἵκοντο	-u u - uu-u u- - -u u--	dactylic hexameter	feminine penthemimeral, hepthemimeral, trithemimeral
Αἰήτεω, τότε δʼ αὖτις ἀπεσκέδασεν νέφος Ἥρη.	--- uu -u u-uu- uu --	dactylic hexameter	feminine penthemimeral, trithemimeral
ἔσταν δʼ ἐν προμολῇσι τεθηπότες ἕρκεʼ ἄνακτος	-- - uu-u u-uu -u u--	dactylic hexameter	feminine penthemimeral, trithemimeral
εὐρείας τε πύλας καὶ κίονας, οἳ περὶ τοίχους	--- u u- - -uu - uu --	dactylic hexameter	masculine penthemimeral, trithemimeral
ἑξείης ἄνεχον· θριγκὸς δʼ ἐφύπερθε δόμοιο	--- uu- -- uu-u u--	dactylic hexameter	masculine penthemimeral, hepthemimeral, trithemimeral
λαΐνεος χαλκέῃσιν ἐπὶ γλυφίδεσσιν ἀρήρει.	-uu- --u u- uu-u u--	dactylic hexameter	feminine penthemimeral, hepthemimeral, trithemimeral
εὔκηλοι δʼ ὑπὲρ οὐδὸν ἔπειτʼ ἔβαν. ἄγχι δὲ τοῖο	--- uu -u u- uu -u u --	dactylic hexameter	feminine penthemimeral, hepthemimeral, trithemimeral
ἡμερίδες χλοεροῖσι καταστεφέες πετάλοισιν	-uu- uu-u u-uu- uu--	dactylic hexameter	feminine penthemimeral, trithemimeral
ὑψοῦ ἀειρόμεναι μέ γʼ ἐθήλεον. αἱ δʼ ὑπὸ τῇσιν	-u u-uu- u u-uu - uu --	dactylic hexameter	masculine penthemimeral
ἀέναοι κρῆναι πίσυρες ῥέον, ἃς ἐλάχηνεν	-uu- -- uu- uu - uu--	dactylic hexameter	masculine penthemimeral, hepthemimeral, trithemimeral
Ἥφαιστος. καί ῥʼ ἡ μέν ἀναβλύεσκε γάλακτι,	--- - - u u---u u--	dactylic hexameter	masculine penthemimeral, trithemimeral
ἡ δʼ οἴνῳ, τριτάτη δὲ θυώδεϊ νᾶεν ἀλοιφῇ·	- -- uu- u u-uu -u u--	dactylic hexameter	masculine penthemimeral, trithemimeral
ἡ δʼ ἄρʼ ὕδωρ προρέεσκε, τὸ μέν ποθι δυομένῃσιν	- u u- uu-u u - uu -uu--	dactylic hexameter	feminine penthemimeral, hepthemimeral, trithemimeral
θέρμετο Πληιάδεσσιν, ἀμοιβηδὶς δʼ ἀνιούσαις	-uu -uu-u u--- uu--	dactylic hexameter	feminine penthemimeral
κρυστάλλῳ ἴκελον κοίλης ἀνεκήκιε πέτρης.	--- uu- -- uu-uu --	dactylic hexameter	masculine penthemimeral, hepthemimeral, trithemimeral
τοῖʼ ἄρʼ ἐνὶ μεγάροισι Κυταιέος Αἰήταο	- u u- uu-u u-uu ----	dactylic hexameter	feminine penthemimeral, trithemimeral
τεχνήεις Ἥφαιστος ἐμήσατο θέσκελα ἔργα.	--- --u u-uu -uu --	dactylic hexameter	feminine penthemimeral, trithemimeral
καί οἱ χαλκόποδας ταύρους κάμε, χάλκεα δέ σφεων	- - -uu- -- uu -uu - -	dactylic hexameter	masculine penthemimeral, hepthemimeral
ἦν στόματʼ, ἐκ δὲ πυρὸς δεινὸν σέλας ἀμπνείεσκον·	- uu - u u- -- uu ----	dactylic hexameter	masculine penthemimeral, hepthemimeral, trithemimeral
πρὸς δὲ καὶ αὐτόγυον στιβαροῦ ἀδάμαντος ἄροτρον	- u u -uu- uu- uu-u u--	dactylic hexameter	masculine penthemimeral, hepthemimeral
ἤλασεν, Ἠελίῳ τίνων χάριν, ὅς ῥά μιν ἵπποις	-uu -uu- -- uu - u u --	dactylic hexameter	masculine penthemimeral, hepthemimeral
δέξατο, Φλεγραίῃ κεκμηότα δηιοτῆτι.	-uu --- --uu -uu--	dactylic hexameter	masculine penthemimeral
ἔνθα δὲ καὶ μέσσαυλος ἐλήλατο· τῇ δʼ ἐπὶ πολλαὶ	-u u - --u u-uu - uu --	dactylic hexameter	feminine penthemimeral, trithemimeral
δικλίδες εὐπηγεῖς θάλαμοί τʼ ἔσαν ἔνθα καὶ ἔνθα·	-uu --- uu- uu -u u --	dactylic hexameter	masculine penthemimeral, hepthemimeral
δαιδαλέη δʼ αἴθουσα παρὲξ ἑκάτερθε τέτυκτο.	-uu- --u u- uu-u u--	dactylic hexameter	feminine penthemimeral, hepthemimeral, trithemimeral
λέχρις δʼ αἰπύτεροι δόμοι ἕστασαν ἀμφοτέρωθεν.	-- -uu- uu -uu -uu--	dactylic hexameter	masculine penthemimeral
τῶν ἤτοι ἄλλῳ μέν, ὅτις καὶ ὑπείροχος ἦεν,	- -- -- u u- u u-uu --	dactylic hexameter	masculine penthemimeral, hepthemimeral, trithemimeral
κρείων Αἰήτης σὺν ἑῇ ναίεσκε δάμαρτι·	-- --- u u- --u u--	dactylic hexameter	masculine penthemimeral, hepthemimeral
ἄλλῳ δʼ Ἄψυρτος ναῖεν πάις Αἰήταο.	-- --- -- uu ----	dactylic hexameter	masculine penthemimeral, hepthemimeral
τὸν μὲν Καυκασίη νύμφη τέκεν Ἀστερόδεια	- - -uu- -- uu -uu--	dactylic hexameter	masculine penthemimeral, hepthemimeral
πρίν περ κουριδίην θέσθαι Εἰδυῖαν ἄκοιτιν,	- - -uu- -- --u u--	dactylic hexameter	masculine penthemimeral, hepthemimeral
Τηθύος Ὠκεανοῦ τε πανοπλοτάτην γεγαυῖαν.	-uu -uu- u u-uu- uu--	dactylic hexameter	masculine penthemimeral
καί μιν Κόλχων υἷες ἐπωνυμίην Φαέθοντα	- - -- -u u-uu- uu--	dactylic hexameter	feminine penthemimeral
ἔκλεον, οὕνεκα πᾶσι μετέπρεπεν ἠιθέοισιν.	-uu -uu -u u-uu -uu--	dactylic hexameter	feminine penthemimeral
τοὺς δʼ ἔχον ἀμφίπολοί τε καὶ Αἰήταο θύγατρες	- uu -uu- u u ---u u--	dactylic hexameter	masculine penthemimeral
ἄμφω, Χαλκιόπη Μήδειά τε. τὴν μὲν ἄρʼ οἵγε	-- -uu- --u u - u u --	dactylic hexameter	masculine penthemimeral
ἐκ θαλάμου θάλαμόνδε κασιγνήτην μετιοῦσαν	- uu- uu-u u--- uu---	lyric	
Ἥρη γάρ μιν ἔρυκε δόμῳ· πρὶν δʼ οὔτι θάμιζεν	-- - u u-u u- - -u u--	dactylic hexameter	feminine penthemimeral, hepthemimeral, trithemimeral
ἐν μεγάροις, Ἑκάτης δὲ πανήμερος ἀμφεπονεῖτο	- uu- uu- u u-uu -uu--	dactylic hexameter	masculine penthemimeral, trithemimeral
νηόν, ἐπεί ῥα θεᾶς αὐτὴ πέλεν ἀρήτειρα	-u u- u u- -- uu -----	lyric	
καί σφεας ὡς ἴδεν ἆσσον, ἀνίαχεν· ὀξὺ δʼ ἄκουσεν	- uu - uu -u u-uu -u u--	dactylic hexameter	feminine penthemimeral, trithemimeral
Χαλκιόπη· δμωαὶ δὲ ποδῶν προπάροιθε βαλοῦσαι	-uu- -- u u- uu-u u--	dactylic hexameter	masculine penthemimeral, hepthemimeral, trithemimeral
νήματα καὶ κλωστῆρας ἀολλέες ἔκτοθι πᾶσαι	-uu - --u u-uu -uu --	dactylic hexameter	feminine penthemimeral, trithemimeral
ἔδραμον. ἡ δʼ ἅμα τοῖσιν ἑοὺς υἱῆας ἰδοῦσα	-uu - uu -u u- --u u--	dactylic hexameter	feminine penthemimeral, hepthemimeral, trithemimeral
ὑψοῦ χάρματι χεῖρας ἀνέσχεθεν· ὧς δὲ καὶ αὐτοὶ	-- -uu -u u-uu - u u --	dactylic hexameter	feminine penthemimeral
μητέρα δεξιόωντο, καὶ ἀμφαγάπαζον ἰδόντες	-uu -uu-u u -uu-u u--	dactylic hexameter	feminine penthemimeral
γηθόσυνοι· τοῖον δὲ κινυρομένη φάτο μῦθον·	-uu- -- u u-uu- uu --	dactylic hexameter	masculine penthemimeral, trithemimeral
‘ἔμπης οὐκ ἄρʼ ἐμέλλετʼ ἀκηδείῃ με λιπόντες	-- - u u-u u--- u u--	dactylic hexameter	feminine penthemimeral, trithemimeral
τηλόθι πλάγξασθαι· μετὰ δʼ ὑμέας ἔτραπεν αἶσα.	-uu --- uu -uu -uu --	dactylic hexameter	masculine penthemimeral
δειλὴ ἐγώ, οἷον πόθον Ἑλλάδος ἔκποθεν ἄτης	-u u- -- uu -uu -uu --	dactylic hexameter	masculine penthemimeral, trithemimeral
λευγαλέης Φρίξοιο ἐφημοσύνῃσιν ἕλεσθε	-uu- --u u-uu-u u--	dactylic hexameter	feminine penthemimeral, trithemimeral
πατρός. ὁ μὲν θνῄσκων στυγερὰς ἐπετείλατʼ ἀνίας	-u u - -- uu- uu-u u--	dactylic hexameter	masculine penthemimeral, hepthemimeral, trithemimeral
ἡμετέρῃ κραδίῃ. τί δέ κεν πόλιν Ὀρχομενοῖο,	-uu- uu- u u - uu -uu--	dactylic hexameter	masculine penthemimeral, hepthemimeral, trithemimeral
ὅστις ὅδʼ Ὀρχομενός, κτεάνων Ἀθάμαντος ἕκητι	-u u -uu- uu- uu-u u--	dactylic hexameter	masculine penthemimeral, hepthemimeral
μητέρʼ ἑὴν ἀχέουσαν ἀποπρολιπόντες, ἵκοισθε;’	-u u- uu-u u-uu-u u--	dactylic hexameter	feminine penthemimeral, trithemimeral
ὧς ἔφατʼ· Αἰήτης δὲ πανύστατος ὦρτο θύραζε,	- uu --- u u-uu -u u--	dactylic hexameter	masculine penthemimeral
ἐκ δʼ αὐτὴ Εἰδυῖα δάμαρ κίεν Αἰήταο,	- -- --u u- uu ----	dactylic hexameter	feminine penthemimeral, hepthemimeral, trithemimeral
Χαλκιόπης ἀίουσα· τὸ δʼ αὐτίκα πᾶν ὁμάδοιο	-uu- uu-u u -uu - uu--	dactylic hexameter	feminine penthemimeral, trithemimeral
ἕρκος ἐπεπλήθει. τοὶ μὲν μέγαν ἀμφιπένοντο	-u u--- - - uu -uu--	dactylic hexameter	masculine penthemimeral, hepthemimeral
ταῦρον ἅλις δμῶες· τοὶ δὲ ξύλα κάγκανα χαλκῷ	-u u- -- - - uu -uu --	dactylic hexameter	masculine penthemimeral, hepthemimeral, trithemimeral
κόπτον· τοὶ δὲ λοετρὰ πυρὶ ζέον· οὐδέ τις ἦεν,	-- - u u-u u- uu -u u --	dactylic hexameter	feminine penthemimeral, hepthemimeral, trithemimeral
ὃς καμάτου μεθίεσκεν, ὑποδρήσσων βασιλῆι.	- uu- uu-u u--- uu--	dactylic hexameter	feminine penthemimeral, trithemimeral
τόφρα δʼ Ἔρως πολιοῖο διʼ ἠέρος ἷξεν ἄφαντος,	-u u- uu-u u -uu -u u--	dactylic hexameter	feminine penthemimeral, trithemimeral
τετρηχώς, οἷόν τε νέαις ἐπὶ φορβάσιν οἶστρος	--- -- u u- uu -uu --	dactylic hexameter	masculine penthemimeral, hepthemimeral, trithemimeral
τέλλεται, ὅν τε μύωπα βοῶν κλείουσι νομῆες.	-uu - u u-u u- --u u--	dactylic hexameter	feminine penthemimeral, hepthemimeral, trithemimeral
ὦκα δʼ ὑπὸ φλιὴν προδόμῳ ἔνι τόξα τανύσσας	-u u- -- uu- uu -u u--	dactylic hexameter	masculine penthemimeral, hepthemimeral, trithemimeral
ἰοδόκης ἀβλῆτα πολύστονον ἐξέλετʼ ἰόν.	-uu- --u u-uu -uu --	dactylic hexameter	feminine penthemimeral, trithemimeral
ἐκ δʼ ὅγε καρπαλίμοισι λαθὼν ποσὶν οὐδὸν ἄμειψεν	- uu -uu-u u- uu -u u--	dactylic hexameter	feminine penthemimeral, hepthemimeral
ὀξέα δενδίλλων· αὐτῷ ὑπὸ βαιὸς ἐλυσθεὶς	-uu --- -- uu -u u--	dactylic hexameter	masculine penthemimeral, hepthemimeral
Αἰσονίδῃ γλυφίδας μέσσῃ ἐνικάτθετο νευρῇ,	-uu- uu- -- uu-uu --	dactylic hexameter	masculine penthemimeral, hepthemimeral, trithemimeral
ἰθὺς δʼ ἀμφοτέρῃσι διασχόμενος παλάμῃσιν	-- -uu-u u-uu- uu--	dactylic hexameter	feminine penthemimeral
ἧκʼ ἐπὶ Μηδείῃ· τὴν δʼ ἀμφασίη λάβε θυμόν.	- uu --- - -uu- uu --	dactylic hexameter	masculine penthemimeral
αὐτὸς δʼ ὑψορόφοιο παλιμπετὲς ἐκ μεγάροιο	-- -uu-u u-uu - uu--	dactylic hexameter	feminine penthemimeral
καγχαλόων ἤιξε· βέλος δʼ ἐνεδαίετο κούρῃ	-uu- --u u- uu-uu --	dactylic hexameter	feminine penthemimeral, hepthemimeral, trithemimeral
νέρθεν ὑπὸ κραδίῃ, φλογὶ εἴκελον· ἀντία δʼ αἰεὶ	-u u- uu- uu -uu -uu --	dactylic hexameter	masculine penthemimeral, trithemimeral
βάλλεν ὑπʼ Αἰσονίδην ἀμαρύγματα, καί οἱ ἄηντο	-u u -uu- uu-uu - u u--	dactylic hexameter	masculine penthemimeral
στηθέων ἐκ πυκιναὶ καμάτῳ φρένες, οὐδέ τινʼ ἄλλην	-- - uu- uu- uu -u u --	dactylic hexameter	masculine penthemimeral, hepthemimeral, trithemimeral
μνῆστιν ἔχεν, γλυκερῇ δὲ κατείβετο θυμὸν ἀνίῃ.	-u u- uu- u u-uu -u u--	dactylic hexameter	masculine penthemimeral, trithemimeral
ὡς δὲ γυνὴ μαλερῷ περὶ κάρφεα χεύατο δαλῷ	- u u- uu- uu -uu -uu --	dactylic hexameter	masculine penthemimeral, trithemimeral
χερνῆτις, τῇπερ ταλασήια ἔργα μέμηλεν,	--- -- uu-uu -u u--	dactylic hexameter	masculine penthemimeral, trithemimeral
ὥς κεν ὑπωρόφιον νύκτωρ σέλας ἐντύναιτο,	- u u-uu- -- uu ----	dactylic hexameter	masculine penthemimeral, hepthemimeral
ἄγχι μάλʼ ἐγρομένη· τὸ δʼ ἀθέσφατον ἐξ ὀλίγοιο	-u u -uu- u u-uu - uu--	dactylic hexameter	masculine penthemimeral
δαλοῦ ἀνεγρόμενον σὺν κάρφεα πάντʼ ἀμαθύνει·	-u u-uu- - -uu - uu--	dactylic hexameter	masculine penthemimeral
τοῖος ὑπὸ κραδίῃ εἰλυμένος αἴθετο λάθρῃ	-u u- uu- --uu -uu --	dactylic hexameter	masculine penthemimeral, trithemimeral
οὖλος Ἔρως· ἁπαλὰς δὲ μετετρωπᾶτο παρειὰς	-u u- uu- u u---u u--	dactylic hexameter	masculine penthemimeral, trithemimeral
ἐς χλόον, ἄλλοτʼ ἔρευθος, ἀκηδείῃσι νόοιο.	- uu -u u-u u---u u--	dactylic hexameter	feminine penthemimeral
δμῶες δʼ ὁππότε δή σφιν ἐπαρτέα θῆκαν ἐδωδήν,	-- -uu - u u-uu -u u--	dactylic hexameter	masculine penthemimeral
αὐτοί τε λιαροῖσιν ἐφαιδρύναντο λοετροῖς,	-- - uu-u u---u u--	dactylic hexameter	feminine penthemimeral, trithemimeral
ἀσπασίως δόρπῳ τε ποτῆτί τε θυμὸν ἄρεσσαν.	-uu- -- u u-u u -u u--	dactylic hexameter	masculine penthemimeral, trithemimeral
ἐκ δὲ τοῦ Αἰήτης σφετέρης ἐρέεινε θυγατρὸς	- u u --- uu- uu-u u--	dactylic hexameter	masculine penthemimeral, hepthemimeral
υἱῆας τοίοισι παρηγορέων ἐπέεσσιν·	--- --u u-uu- uu--	dactylic hexameter	feminine penthemimeral, trithemimeral
‘παιδὸς ἐμῆς κοῦροι Φρίξοιό τε, τὸν περὶ πάντων	-u u- -- --u u - uu --	dactylic hexameter	masculine penthemimeral, trithemimeral
ξείνων ἡμετέροισιν ἐνὶ μεγάροισιν ἔτισα,	-- -uu-u u- uu-u u--	dactylic hexameter	feminine penthemimeral, hepthemimeral
πῶς Αἶάνδε νέεσθε παλίσσυτοι; ἦέ τις ἄτη	- --u u-u u-uu -u u --	dactylic hexameter	feminine penthemimeral
σωομένοις μεσσηγὺς ἐνέκλασεν; οὐ μὲν ἐμεῖο	-uu- --u u-uu - u u--	dactylic hexameter	feminine penthemimeral, trithemimeral
πείθεσθε προφέροντος ἀπείρονα μέτρα κελεύθου.	--- uu-u u-uu -u u--	dactylic hexameter	feminine penthemimeral, trithemimeral
ᾔδειν γάρ ποτε πατρὸς ἐν ἅρμασιν Ἠελίοιο	-- - uu -u u -uu -uu--	dactylic hexameter	feminine penthemimeral, trithemimeral
δινεύσας, ὅτʼ ἐμεῖο κασιγνήτην ἐκόμιζεν	--- u u-u u--- uu--	dactylic hexameter	feminine penthemimeral, trithemimeral
Κίρκην ἑσπερίης εἴσω χθονός, ἐκ δʼ ἱκόμεσθα	-- -uu- -- uu - uu--	dactylic hexameter	masculine penthemimeral, hepthemimeral
ἀκτὴν ἠπείρου Τυρσηνίδος, ἔνθʼ ἔτι νῦν περ	-- --- --uu - uu - -	dactylic hexameter	masculine penthemimeral
ναιετάει, μάλα πολλὸν ἀπόπροθι Κολχίδος αἴης.	-uu- uu -u u-uu -uu --	dactylic hexameter	feminine penthemimeral, trithemimeral
ἀλλὰ τί μύθων ἦδος; ἃ δʼ ἐν ποσὶν ὗμιν ὄρωρεν,	-u u -- -u u - uu -u u--	dactylic hexameter	feminine penthemimeral, hepthemimeral
εἴπατʼ ἀριφραδέως, ἠδʼ οἵτινες οἵδʼ ἐφέπονται	-u u-uu- - -uu - uu--	dactylic hexameter	masculine penthemimeral
ἀνέρες, ὅππῃ τε γλαφυρῆς ἐκ νηὸς ἔβητε.’	-uu -- - uu- - -u u--	dactylic hexameter	masculine penthemimeral, hepthemimeral
τοῖά μιν ἐξερέοντα κασιγνήτων προπάροιθεν	-u u -uu-u u--- uu--	dactylic hexameter	feminine penthemimeral
Ἄργος ὑποδδείσας ἀμφὶ στόλῳ Αἰσονίδαο	-u u--- -- uu -uu--	dactylic hexameter	masculine penthemimeral, hepthemimeral
μειλιχίως προσέειπεν, ἐπεὶ προγενέστερος ἦεν·	-uu- uu-u u- uu-uu --	dactylic hexameter	feminine penthemimeral, hepthemimeral, trithemimeral
‘Αἰήτη, κείνην μὲν ἄφαρ διέχευαν ἄελλαι	--- -- u u- uu-u u--	dactylic hexameter	masculine penthemimeral, hepthemimeral, trithemimeral
ζαχρηεῖς· αὐτοὺς δʼ ἐπὶ δούρασι πεπτηῶτας	--- -- uu -uu ----	dactylic hexameter	masculine penthemimeral, trithemimeral
νήσου Ἐνυαλίοιο ποτὶ ξερὸν ἔκβαλε κῦμα	-u u-uu-u u- uu -uu --	dactylic hexameter	feminine penthemimeral, hepthemimeral
λυγαίῃ ὑπὸ νυκτί· θεὸς δέ τις ἄμμʼ ἐσάωσεν.	--- uu -u u- u u - uu--	dactylic hexameter	feminine penthemimeral, hepthemimeral, trithemimeral
οὐδὲ γὰρ αἳ τὸ πάροιθεν ἐρημαίην κατὰ νῆσον	-u u - u u-u u--- uu --	dactylic hexameter	feminine penthemimeral, trithemimeral
ηὐλίζοντʼ ὄρνιθες Ἀρήιαι, οὐδʼ ἔτι κείνας	--- --u u-uu - uu --	dactylic hexameter	feminine penthemimeral, trithemimeral
εὕρομεν. ἀλλʼ οἵ γʼ ἄνδρες ἀπήλασαν, ἐξαποβάντες	-uu - - -u u-uu -uu--	dactylic hexameter	feminine penthemimeral, trithemimeral
νηὸς ἑῆς προτέρῳ ἐνὶ ἤματι· καί σφʼ ἀπέρυκεν	-u u- uu- uu -uu - uu--	dactylic hexameter	masculine penthemimeral, trithemimeral
ἡμέας οἰκτείρων Ζηνὸς νόος, ἠέ τις αἶσα,	-uu --- -- uu -u u --	dactylic hexameter	masculine penthemimeral, hepthemimeral
αὐτίκʼ ἐπεὶ καὶ βρῶσιν ἅλις καὶ εἵματʼ ἔδωκαν,	-u u- - -u u- - -u u--	dactylic hexameter	feminine penthemimeral, hepthemimeral, trithemimeral
οὔνομά τε Φρίξοιο περικλεὲς εἰσαΐοντες	-uu - --u u-uu -uu--	dactylic hexameter	feminine penthemimeral, trithemimeral
ἠδʼ αὐτοῖο σέθεν· μετὰ γὰρ τεὸν ἄστυ νέονται.	- --u u- uu - uu -u u--	dactylic hexameter	masculine penthemimeral, hepthemimeral
χρειὼ δʼ ἢν ἐθέλῃς ἐξίδμεναι, οὔ σ᾽ἐπικεύσω.	-- - uu- --uu - uu--	dactylic hexameter	masculine penthemimeral, trithemimeral
τόνδε τις ἱέμενος πάτρης ἀπάνευθεν ἐλάσσαι	-u u -uu- -- uu-u u--	dactylic hexameter	masculine penthemimeral, hepthemimeral
καὶ κτεάνων βασιλεὺς περιώσιον, οὕνεκεν ἀλκῇ	- uu- uu- uu-uu -uu --	dactylic hexameter	masculine penthemimeral, trithemimeral
σφωιτέρῃ τάντεσσι μετέπρεπεν Αἰολίδῃσιν,	-uu- --u u-uu -uu--	dactylic hexameter	feminine penthemimeral, trithemimeral
πέμπει δεῦρο νέεσθαι ἀμήχανον· οὐδʼ ὑπαλύξειν	-- -u u-u u-uu - uu--	dactylic hexameter	feminine penthemimeral
στεῦται ἀμειλίκτοιο Διὸς θυμαλγέα μῆνιν	-u u---u u- --uu --	dactylic hexameter	feminine penthemimeral, hepthemimeral
καὶ χόλον, οὐδʼ ἄτλητον ἄγος Φρίξοιό τε ποινὰς	- uu - --u u- --u u --	dactylic hexameter	feminine penthemimeral, hepthemimeral, trithemimeral
Αἰολιδέων γενεήν, πρὶν ἐς Ἑλλάδα κῶας ἱκέσθαι.	-uu- uu- u u -uu -u u--	dactylic hexameter	masculine penthemimeral, trithemimeral
νῆα δʼ Ἀθηναίη Παλλὰς κάμεν, οὐ μάλα τοίην,	-u u--- -- uu - uu --	dactylic hexameter	masculine penthemimeral, hepthemimeral
οἷαί περ Κόλχοισι μετʼ ἀνδράσι νῆες ἔασιν,	-- - --u u -uu -u u--	dactylic hexameter	feminine penthemimeral, trithemimeral
τάων αἰνοτάτης ἐπεκύρσαμεν. ἤλιθα γάρ μιν	-- -uu- uu-uu -uu - -	dactylic hexameter	masculine penthemimeral
λάβρον ὕδωρ πνοιή τε διέτμαγεν· ἡ δʼ ἐνὶ γόμφοις	-u u- -- u u-uu - uu --	dactylic hexameter	masculine penthemimeral, trithemimeral
ἴσχεται, ἢν καὶ πᾶσαι ἐπιβρίσωσιν ἄελλαι.	-uu - - -u u---u u--	dactylic hexameter	feminine penthemimeral, trithemimeral
ἶσον δʼ ἐξ ἀνέμοιο θέει καὶ ὅτʼ ἀνέρες αὐτοὶ	-- - uu-u u- u u -uu --	dactylic hexameter	feminine penthemimeral, hepthemimeral, trithemimeral
νωλεμέως χείρεσσιν ἐπισπέρχωσιν ἐρετμοῖς.	-uu- --u u---u u--	dactylic hexameter	feminine penthemimeral, trithemimeral
τῇ δʼ ἐναγειράμενος Παναχαιίδος εἴ τι φέριστον	- uu-uu- uu-uu - u u--	dactylic hexameter	masculine penthemimeral
ἡρώων, τεὸν ἄστυ μετήλυθε, πόλλʼ ἐπαληθεὶς	--- uu -u u-uu - uu--	dactylic hexameter	feminine penthemimeral, trithemimeral
ἄστεα καὶ πελάγη στυγερῆς ἁλός, εἴ οἱ ὀπάσσαις.	-uu - uu- uu- uu - u u--	dactylic hexameter	masculine penthemimeral, hepthemimeral, trithemimeral
αὐτῷ δʼ ὥς κεν ἅδῃ, τὼς ἔσσεται· οὐ γὰρ ἱκάνει	-- - u u- - -uu - u u--	dactylic hexameter	masculine penthemimeral, trithemimeral
χερσὶ βιησόμενος· μέμονεν δέ τοι ἄξια τίσειν	-u u-uu- uu- u u -uu --	dactylic hexameter	masculine penthemimeral, hepthemimeral
δωτίνης, ἀίων ἐμέθεν μέγα δυσμενέοντας	--- uu- uu- uu -uu--	dactylic hexameter	masculine penthemimeral, hepthemimeral, trithemimeral
Σαυρομάτας, τοὺς σοῖσιν ὑπὸ σκήπτροισι δαμάσσει.	-uu- - -u u- --u u--	dactylic hexameter	feminine penthemimeral, hepthemimeral, trithemimeral
εἰ δὲ καὶ οὔνομα δῆθεν ἐπιθύεις γενεήν τε	- u u -uu -u u--- uu- -	dactylic hexameter	feminine penthemimeral
ἴδμεναι, οἵτινές εἰσιν, ἕκαστά γε μυθησαίμην.	-uu -uu -u u-u u ----	dactylic hexameter	feminine penthemimeral
τόνδε μέν, οἷό περ οὕνεκʼ ἀφʼ Ἑλλάδος ὧλλοι ἄγερθεν,	-u u -u u -u u -uu -u u--	dactylic hexameter	feminine penthemimeral
κλείουσʼ Αἴσονος υἱὸν Ἰήσονα Κρηθεΐδαο.	-- -uu -u u-uu -uu--	dactylic hexameter	feminine penthemimeral
εἰ δʼ αὐτοῦ Κρηθῆος ἐτήτυμόν ἐστι γενέθλης,	- -- --u u-uu -u u--	dactylic hexameter	feminine penthemimeral, trithemimeral
οὕτω κεν γνωτὸς πατρώιος ἄμμι πέλοιτο.	-- - -- --uu -u u--	dactylic hexameter	masculine penthemimeral, trithemimeral
ἄμφω γὰρ Κρηθεὺς Ἀθάμας τʼ ἔσαν Αἰόλου υἷες·	-- - -- uu- uu -uu --	dactylic hexameter	masculine penthemimeral, hepthemimeral, trithemimeral
Φρίξος δʼ αὖτʼ Ἀθάμαντος ἔην πάις Αἰολίδαο.	-- - uu-u u- uu -uu--	dactylic hexameter	feminine penthemimeral, hepthemimeral, trithemimeral
τόνδε δʼ ἄρʼ, Ἠελίου γόνον ἔμμεναι εἴ τινʼ ἀκούεις,	-u u -uu- uu -uu - u u--	dactylic hexameter	masculine penthemimeral
δέρκεαι Αὐγείην· Τελαμὼν δʼ ὅγε, κυδίστοιο	-uu --- uu- uu ----	dactylic hexameter	masculine penthemimeral, hepthemimeral
Αἰακοῦ ἐκγεγαώς· Ζεὺς δʼ Αἰακὸν αὐτὸς ἔτικτεν.	-uu -uu- - -uu -u u--	dactylic hexameter	masculine penthemimeral
ὧς δὲ καὶ ὧλλοι πάντες, ὅσοι συνέπονται ἑταῖροι,	- u u -- -u u- uu-u u--	dactylic hexameter	feminine penthemimeral, hepthemimeral
ἀθανάτων υἷές τε καὶ υἱωνοὶ γεγάασιν.’	-uu- -- u u --- uu--	dactylic hexameter	masculine penthemimeral, trithemimeral
τοῖα παρέννεπεν Ἄργος· ἄναξ δʼ ἐπεχώσατο μύθοις	-u u-uu -u u- uu-uu --	dactylic hexameter	feminine penthemimeral, hepthemimeral
εἰσαΐων· ὑψοῦ δὲ χόλῳ φρένες ἠερέθοντο.	-uu- -- u u- uu -uu--	dactylic hexameter	masculine penthemimeral, hepthemimeral, trithemimeral
φῆ δʼ ἐπαλαστήσας· μενέαινε δὲ παισὶ μάλιστα	- uu--- uu-u u -u u--	dactylic hexameter	masculine penthemimeral
Χαλκιόπης· τῶν γάρ σφε μετελθέμεν οὕνεκʼ ἐώλπει·	-uu- - - u u-uu -u u--	dactylic hexameter	masculine penthemimeral, trithemimeral
ἐκ δέ οἱ ὄμματʼ ἔλαμψεν ὑπʼ ὀφρύσιν ἱεμένοιο·	- u u -u u-u u -uu -uu--	dactylic hexameter	feminine penthemimeral
‘οὐκ ἄφαρ ὀφθαλμῶν μοι ἀπόπροθι, λωβητῆρες,	- uu --- u u-uu ----	dactylic hexameter	masculine penthemimeral
νεῖσθʼ αὐτοῖσι δόλοισι παλίσσυτοι ἔκτοθι γαίης,	- --u u-u u-uu -uu --	dactylic hexameter	feminine penthemimeral
πρίν τινα λευγαλέον τε δέρος καὶ Φρίξον ἰδέσθαι;	- uu -uu- u u- - -u u--	dactylic hexameter	masculine penthemimeral, hepthemimeral
αὐτίχʼ ὁμαρτήσαντες ἀφʼ Ἑλλάδος, οὐκ ἐπὶ κῶας,	-u u---u u -uu - uu --	dactylic hexameter	feminine penthemimeral
σκῆπτρα δὲ καὶ τιμὴν βασιληίδα δεῦρο νέεσθε.	-u u - -- uu-uu -u u--	dactylic hexameter	masculine penthemimeral, trithemimeral
εἰ δέ κε μὴ προπάροιθεν ἐμῆς ἥψασθε τραπέζης,	- u u - uu-u u- --u u--	dactylic hexameter	feminine penthemimeral, hepthemimeral, trithemimeral
ἦ τʼ ἂν ἀπὸ γλώσσας τε ταμὼν καὶ χεῖρε κεάσσας	- u u- -- u u- - -u u--	dactylic hexameter	masculine penthemimeral, hepthemimeral, trithemimeral
ἀμφοτέρας, οἴοισιν ἐπιπροέηκα πόδεσσιν,	-uu- --u u-uu-u u--	dactylic hexameter	feminine penthemimeral, trithemimeral
ὥς κεν ἐρητύοισθε καὶ ὕστερον ὁρμηθῆναι,	- u u---u u -uu ----	dactylic hexameter	feminine penthemimeral
οἷα δὲ καὶ μακάρεσσιν ἐπεψεύσασθε θεοῖσιν.’	-u u - uu-u u---u u--	dactylic hexameter	feminine penthemimeral, trithemimeral
φῆ ῥα χαλεψάμενος· μέγα δὲ φρένες Αἰακίδαο	- u u-uu- uu - uu -uu--	dactylic hexameter	masculine penthemimeral, hepthemimeral
νειόθεν οἰδαίνεσκον· ἐέλδετο δʼ ἔνδοθι θυμὸς	-uu ---u u-uu -uu --	dactylic hexameter	feminine penthemimeral
ἀντιβίην ὀλοὸν φάσθαι ἔπος· ἀλλʼ ἀπέρυκεν	-uu- uu- -- uu - uu--	dactylic hexameter	masculine penthemimeral, hepthemimeral, trithemimeral
Αἰσονίδης· πρὸ γὰρ αὐτὸς ἀμείψατο μειλιχίοισιν·	-uu- u u -u u-uu -uu--	dactylic hexameter	feminine penthemimeral, trithemimeral
‘Αἰήτη, σχέο μοι τῷδε στόλῳ. οὔτι γὰρ αὔτως	--- uu - -- uu -u u --	dactylic hexameter	masculine penthemimeral, hepthemimeral, trithemimeral
ἄστυ τεὸν καὶ δώμαθʼ ἱκάνομεν, ὥς που ἔολπας,	-u u- - -u u-uu - u u--	dactylic hexameter	feminine penthemimeral, trithemimeral
οὐδὲ μὲν ἱέμενοι. τίς δʼ ἂν τόσον οἶδμα περῆσαι	-u u -uu- - - uu -u u--	dactylic hexameter	masculine penthemimeral, hepthemimeral
τλαίη ἑκὼν ὀθνεῖον ἐπὶ κτέρας; ἀλλά με δαίμων	-u u- --u u- uu -u u --	dactylic hexameter	feminine penthemimeral, hepthemimeral, trithemimeral
καὶ κρυερὴ βασιλῆος ἀτασθάλου ὦρσεν ἐφετμή.	- uu- uu-u u-uu -u u--	dactylic hexameter	feminine penthemimeral, trithemimeral
δὸς χάριν ἀντομένοισι· σέθεν δʼ ἐγὼ Ἑλλάδι πάσῃ	- uu -uu-u u- uu -uu --	dactylic hexameter	feminine penthemimeral, hepthemimeral
θεσπεσιην οἴσω κληηδόνα· καὶ δέ τοι ἤδη	-uu- -- --uu - u u --	dactylic hexameter	masculine penthemimeral, trithemimeral
πρόφρονές εἰμεν ἄρηι θοὴν ἀποτῖσαι ἀμοιβήν,	-uu -u u-u u- uu-u u--	dactylic hexameter	feminine penthemimeral, hepthemimeral
εἴτʼ οὖν Σαυρομάτας γε λιλαίεαι, εἴτε τινʼ ἄλλον	- - -uu- u u-uu -u u --	dactylic hexameter	masculine penthemimeral
δῆμον σφωιτέροισιν ὑπὸ σκήπτροισι δαμάσσαι.’	-- -uu-u u- --u u--	dactylic hexameter	feminine penthemimeral, hepthemimeral
Ἴσκεν ὑποσσαίνων ἀγανῇ ὀπί· τοῖο δὲ θυμὸς	-u u--- uu- uu -u u --	dactylic hexameter	masculine penthemimeral, hepthemimeral
διχθαδίην πόρφυρεν ἐνὶ στήθεσσι μενοινήν,	-uu- --u u- --u u--	dactylic hexameter	feminine penthemimeral, hepthemimeral, trithemimeral
ἤ σφεας ὁρμηθεὶς αὐτοσχεδὸν ἐξεναρίζοι,	- uu --- --uu -uu--	dactylic hexameter	masculine penthemimeral
ἦ ὅγε πειρήσαιτο βίης. τό οἱ εἴσατʼ ἄρειον	- uu ---u u- u u -u u--	dactylic hexameter	feminine penthemimeral, hepthemimeral
φραζομένῳ· καὶ δή μιν ὑποβλήδην προσέειπεν·	-uu- - - u u--- uu--	dactylic hexameter	masculine penthemimeral, trithemimeral
‘ξεῖνε, τί κεν τὰ ἕκαστα διηνεκέως ἀγορεύοις;	-u u - u u-u u-uu- uu--	dactylic hexameter	feminine penthemimeral, trithemimeral
εἰ γὰρ ἐτήτυμόν ἐστε θεῶν γένος, ἠὲ καὶ ἄλλως	- u u-uu -u u- uu -u u --	dactylic hexameter	feminine penthemimeral, hepthemimeral
οὐδὲν ἐμεῖο χέρηες ἐπʼ ὀθνείοισιν ἔβητε,	-u u-u u-u u ---u u--	dactylic hexameter	feminine penthemimeral
δώσω τοι χρύσειον ἄγειν δέρος, αἴ κʼ ἐθέλῃσθα,	-- - --u u- uu - uu--	dactylic hexameter	feminine penthemimeral, hepthemimeral, trithemimeral
πειρηθείς. ἐσθλοῖς γὰρ ἐπʼ ἀνδράσιν οὔτι μεγαίρω,	--- -- u u -uu -u u--	dactylic hexameter	masculine penthemimeral, trithemimeral
ὡς αὐτοὶ μυθεῖσθε τὸν Ἑλλάδι κοιρανέοντα.	- -- --u u -uu -uu--	dactylic hexameter	feminine penthemimeral, trithemimeral
πεῖρα δέ τοι μένεός τε καὶ ἀλκῆς ἔσσετʼ ἄεθλος,	-u u - uu- u u -- -u u--	dactylic hexameter	masculine penthemimeral, trithemimeral
τόν ῥʼ αὐτὸς περίειμι χεροῖν ὀλοόν περ ἐόντα.	- -- uu-u u- uu- u u--	dactylic hexameter	feminine penthemimeral, hepthemimeral, trithemimeral
δοιώ μοι πεδίον τὸ Ἀρήιον ἀμφινέμονται	-- - uu- u u-uu -uu--	dactylic hexameter	masculine penthemimeral, trithemimeral
ταύρω χαλκόποδε, στόματι φλόγα φυσιόωντες·	-- -uu- uu- uu -uu--	dactylic hexameter	masculine penthemimeral, hepthemimeral
τοὺς ἐλάω ζεύξας στυφελὴν κατὰ νειὸν Ἄρηος	- uu- -- uu- uu -u u--	dactylic hexameter	masculine penthemimeral, hepthemimeral, trithemimeral
τετράγυον, τὴν αἶψα ταμὼν ἐπὶ τέλσον ἀρότρῳ	-uu- - -u u- uu -u u--	dactylic hexameter	feminine penthemimeral, hepthemimeral, trithemimeral
οὐ σπόρον ὁλκοῖσιν Δηοῦς ἐνιβᾴλλομαι ἀκτήν,	- uu --- -- uu-uu --	dactylic hexameter	masculine penthemimeral, hepthemimeral
ἀλλʼ ὄφιος δεινοῖο μεταλδήσκοντας ὀδόντας	- uu- --u u---u u--	dactylic hexameter	feminine penthemimeral, trithemimeral
ἀνδράσι τευχηστῇσι δέμας. τοὺς δʼ αὖθι δαΐζων	-uu ---u u- - -u u--	dactylic hexameter	feminine penthemimeral, hepthemimeral
κείρω ἐμῷ ὑπὸ δουρὶ περισταδὸν ἀντιόωντας.	-u u- uu -u u-uu -uu--	dactylic hexameter	feminine penthemimeral, trithemimeral
ἠέριος ζεύγνυμι βόας, καὶ δείελον ὥρην	-uu- --u u- - -uu --	dactylic hexameter	feminine penthemimeral, hepthemimeral, trithemimeral
παύομαι ἀμήτοιο. σύ δʼ ,εἰ τάδε τοῖα τελέσσεις,	-uu ---u u - uu -u u--	dactylic hexameter	feminine penthemimeral, hepthemimeral
αὐτῆμαρ τόδε κῶας ἀποίσεαι εἰς βασιλῆος·	--- uu -u u-uu - uu--	dactylic hexameter	feminine penthemimeral, trithemimeral
πρὶν δέ κεν οὐ δοίην, μηδʼ ἔλπεο. δὴ γὰρ ἀεικὲς	- u u - -- - -uu - u u--	dactylic hexameter	masculine penthemimeral, trithemimeral
ἄνδρʼ ἀγαθὸν γεγαῶτα κακωτέρῳ ἀνέρι εἶξαι.’	- uu- uu-u u-uu -uu --	dactylic hexameter	feminine penthemimeral, trithemimeral
ὧς ἄρʼ ἔφη· ὁ δὲ σῖγα ποδῶν πάρος ὄμματα πήξας	- u u- u u -u u- uu -uu --	dactylic hexameter	feminine penthemimeral, hepthemimeral, trithemimeral
ἧστʼ αὔτως ἄφθογγος, ἀμηχανέων κακότητι.	- -- --u u-uu- uu--	dactylic hexameter	feminine penthemimeral, trithemimeral
βουλὴν δʼ ἀμφὶ πολὺν στρώφα χρόνον, οὐδέ πῃ εἶχεν	-- -u u- -- uu -u u --	dactylic hexameter	masculine penthemimeral, hepthemimeral
θαρσαλέως ὑποδέχθαι, ἐπεὶ μέγα φαίνετο ἔργον·	-uu- uu-u u- uu -uu --	dactylic hexameter	feminine penthemimeral, hepthemimeral, trithemimeral
ὀψε δʼ ἀμειβόμενος προσελέξατο κερδαλέοισιν·	-u u-uu- uu-uu -uu--	dactylic hexameter	masculine penthemimeral
‘Αἰήτη, μάλα τοί με δίκῃ περιπολλὸν ἐέργεις.	--- uu - u u- uu-u u--	dactylic hexameter	masculine penthemimeral, hepthemimeral, trithemimeral
τῶ καὶ ἐγὼ τὸν ἄεθλον ὑπερφίαλόν περ ἐόντα	- u u- u u-u u-uu- u u--	dactylic hexameter	feminine penthemimeral, trithemimeral
τλήσομαι, εἰ καί μοι θανέειν μόρος. οὐ γὰρ ἔτʼ ἄλλο	-uu - - - uu- uu - u u --	dactylic hexameter	masculine penthemimeral, hepthemimeral, trithemimeral
ῥίγιον ἀνθρώποισι κακῆς ἐπικείσετʼ ἀνάγκης,	-uu ---u u- uu-u u--	dactylic hexameter	feminine penthemimeral, hepthemimeral
ἥ με καὶ ἐνθάδε νεῖσθαι ἐπέχραεν ἐκ βασιλῆος.’	- u u -uu -u u-uu - uu--	dactylic hexameter	feminine penthemimeral
ὧς φάτʼ ἀμηχανίῃ βεβολημένος· αὐτὰρ ὁ τόνγε	- u u-uu- uu-uu -u u --	dactylic hexameter	masculine penthemimeral
σμερδαλέοις ἐπέεσσι προσέννεπεν ἀσχαλόωντα·	-uu- uu-u u-uu -uu--	dactylic hexameter	feminine penthemimeral, trithemimeral
‘ἔρχεο νῦν μεθʼ ὅμιλον, ἐπεὶ μέμονάς γε πόνοιο·	-uu - u u-u u- uu- u u--	dactylic hexameter	feminine penthemimeral, hepthemimeral, trithemimeral
εἰ δὲ σύ γε ζυγὰ βουσὶν ὑποδδείσαις ἐπαεῖραι,	- u u - uu -u u--- uu--	dactylic hexameter	feminine penthemimeral, trithemimeral
ἠὲ καὶ οὐλομένου μεταχάσσεαι ἀμήτοιο,	-u u -uu- uu-uu ----	dactylic hexameter	masculine penthemimeral
αὐτῷ κεν τὰ ἕκαστα μέλοιτό μοι, ὄφρα καὶ ἄλλος	-- - u u-u u-u u -u u --	dactylic hexameter	feminine penthemimeral, trithemimeral
ἀνὴρ ἐρρίγῃσιν ἀρείονα φῶτα μετελθεῖν.’	-- ---u u-uu -u u--	dactylic hexameter	feminine penthemimeral
Ἴσκεν ἀπηλεγέως· ὁ δʼ ἀπὸ θρόνου ὤρνυτʼ Ἰήσων,	-u u-uu- u u- uu -u u--	dactylic hexameter	masculine penthemimeral, hepthemimeral
Αὐγείης Τελαμών τε παρασχεδόν· εἵπετο δʼ Ἄργος	--- uu- u u-uu -uu --	dactylic hexameter	masculine penthemimeral, trithemimeral
οἶος, ἐπεὶ μεσσηγὺς ἔτʼ αὐτόθι νεῦσε λιπέσθαι	-u u- --u u -uu -u u--	dactylic hexameter	feminine penthemimeral, trithemimeral
αὐτοκασιγνήτοις· οἱ δʼ ἤισαν ἐκ μεγάροιο.	-uu--- - -uu - uu--	dactylic hexameter	masculine penthemimeral
θεσπέσιον δʼ ἐν πᾶσι μετέπρεπεν Αἴσονος υἱὸς	-uu- - -u u-uu -uu --	dactylic hexameter	feminine penthemimeral, trithemimeral
κάλλεϊ καὶ χαρίτεσσιν· ἐπʼ αὐτῷ δʼ ὄμματα κούρη	-uu - uu-u u -- -uu --	dactylic hexameter	feminine penthemimeral, trithemimeral
λοξὰ παρὰ λιπαρὴν σχομένη θηεῖτο καλύπτρην,	-u u- uu- uu- --u u--	dactylic hexameter	masculine penthemimeral, hepthemimeral, trithemimeral
κῆρ ἄχεϊ σμύχουσα· νόος δέ οἱ ἠύτʼ ὄνειρος	- uu- --u u- u u -u u--	dactylic hexameter	feminine penthemimeral, hepthemimeral, trithemimeral
ἑρπύζων πεπότητο μετʼ ἴχνια νισσομένοιο.	--- uu-u u -uu -uu--	dactylic hexameter	feminine penthemimeral, trithemimeral
καί ῥʼ οἱ μέν ῥα δόμων ἐξήλυθον ἀσχαλόωντες.	- - - u u- --uu -uu--	dactylic hexameter	masculine penthemimeral, trithemimeral
Χαλκιόπη δὲ χόλον πεφυλαγμένη Αἰήταο	-uu- u u- uu-uu ----	dactylic hexameter	masculine penthemimeral, trithemimeral
καρπαλίμως θάλαμόνδε σὺν υἱάσιν οἷσι βεβήκει.	-uu- uu-u u -uu -u u--	dactylic hexameter	feminine penthemimeral, trithemimeral
αὔτως δʼ αὖ Μήδεια μετέστιχε· πολλὰ δὲ θυμῷ	-- - --u u-uu -u u --	dactylic hexameter	feminine penthemimeral, trithemimeral
ὥρμαινʼ, ὅσσα τʼ Ἔρωτες ἐποτρύνουσι μέλεσθαι.	-- -u u-u u---u u--	dactylic hexameter	feminine penthemimeral
προπρὸ δʼ ἄρʼ ὀφθαλμῶν ἔτι οἱ ἰνδάλλετο πάντα,	-u u --- uu - --uu --	dactylic hexameter	masculine penthemimeral, hepthemimeral
αὐτός θ᾽οἷος ἔην, οἵοισί τε φάρεσιν ἕστο,	-- -u u- --u u -uu --	dactylic hexameter	masculine penthemimeral
οἷά τʼ ἔειφʼ, ὥς θ᾽ἕζετʼ ἐπὶ θρόνου, ὥς τε θύραζε	-u u- - -u u- uu - u u--	dactylic hexameter	feminine penthemimeral, hepthemimeral, trithemimeral
ἤιεν· οὐδέ τινʼ ἄλλον ὀίσσατο πορφύρουσα	-uu -u u -u u-uu ----	dactylic hexameter	feminine penthemimeral
ἔμμεναι ἀνέρα τοῖον· ἐν οὔασι δʼ αἰὲν ὀρώρει	-uu -uu -u u -uu -u u--	dactylic hexameter	feminine penthemimeral
αὐδή τε μῦθοί τε μελίφρονες, οὓς ἀγόρευσεν.	-- - -- u u-uu - uu--	dactylic hexameter	masculine penthemimeral, trithemimeral
τάρβει δʼ ἀμφʼ αὐτῷ, μή μιν βόες ἠὲ καὶ αὐτὸς	-- - -- - - uu -u u --	dactylic hexameter	masculine penthemimeral, hepthemimeral, trithemimeral
Αἰήτης φθίσειεν· ὀδύρετο δʼ ἠύτε πάμπαν	--- --u u-uu -uu --	dactylic hexameter	feminine penthemimeral, trithemimeral
ἤδη τεθνειῶτα, τέρεν δέ οἱ ἀμφὶ παρειὰς	-- ---u u- u u -u u--	dactylic hexameter	feminine penthemimeral, hepthemimeral
δάκρυον αἰνοτάτῳ ἐλέῳ ῥέε κηδοσύνῃσιν·	-uu -uu- uu- uu -uu--	dactylic hexameter	masculine penthemimeral, hepthemimeral
ἦκα δὲ μυρομένη λιγέως ἀνενείκατο μῦθον·	-u u -uu- uu- uu-uu --	dactylic hexameter	masculine penthemimeral, hepthemimeral
‘τίπτε με δειλαίην τόδʼ ἔχει ἄχος; εἴθʼ ὅγε πάντων	-u u --- u u- uu - uu --	dactylic hexameter	masculine penthemimeral, hepthemimeral
φθίσεται ἡρώων προφερέστατος, εἴτε χερείων,	-uu --- uu-uu -u u--	dactylic hexameter	masculine penthemimeral
ἐρρέτω. ἦ μὲν ὄφελλεν ἀκήριος ἐξαλέασθαι.	-uu - u u-u u-uu -uu--	dactylic hexameter	feminine penthemimeral, trithemimeral
ναὶ δὴ τοῦτό γε, πότνα θεὰ Περσηί, πέλοιτο,	- - -u u -u u- --u u--	dactylic hexameter	feminine penthemimeral, hepthemimeral
οἴκαδε νοστήσειε φυγὼν μόρον· εἰ δέ μιν αἶσα	-uu ---u u- uu - u u --	dactylic hexameter	feminine penthemimeral, hepthemimeral
δμηθῆναι ὑπὸ βουσί, τόδε προπάροιθε δαείη,	--- uu -u u- uu-u u--	dactylic hexameter	feminine penthemimeral, hepthemimeral, trithemimeral
οὕνεκεν οὔ οἱ ἔγωγε κακῇ ἐπαγαίομαι ἄτῃ.’	-uu - u u-u u- uu-uu --	dactylic hexameter	feminine penthemimeral, hepthemimeral, trithemimeral
ἡ μὲν ἄρʼ ὧς ἐόλητο νόον μελεδήμασι κούρη.	- u u - uu-u u- uu-uu --	dactylic hexameter	feminine penthemimeral, hepthemimeral, trithemimeral
οἱ δʼ ἐπεὶ οὖν δήμου τε καὶ ἄστεος ἐκτὸς ἔβησαν	- uu - -- u u -uu -u u--	dactylic hexameter	masculine penthemimeral, trithemimeral
τὴν ὁδόν, ἣν τὸ πάροιθεν ἀνήλυθον ἐκ πεδίοιο,	- uu - u u-u u-uu - uu--	dactylic hexameter	feminine penthemimeral, trithemimeral
δὴ τότʼ Ἰήσονα τοῖσδε προσέννεπεν Ἄργος ἔπεσσιν·	- u u-uu -u u-uu -u u--	dactylic hexameter	feminine penthemimeral
‘Αἰσονίδη, μῆτιν μὲν ὀνόσσεαι, ἥντινʼ ἐνίψω·	-uu- -- u u-uu -u u--	dactylic hexameter	masculine penthemimeral, trithemimeral
πείρης δʼ οὐ μάλʼ ἔοικε μεθιέμεν ἐν κακότητι.	-- - u u-u u-uu - uu--	dactylic hexameter	feminine penthemimeral, trithemimeral
κούρην δή τινα πρόσθεν ὑπέκλυες αὐτὸς ἐμεῖο	-- - uu -u u-uu -u u--	dactylic hexameter	feminine penthemimeral, trithemimeral
φαρμάσσειν Ἑκάτης Περσηίδος ἐννεσίῃσιν.	--- uu- --uu -uu--	dactylic hexameter	masculine penthemimeral, trithemimeral
τὴν εἴ κεν πεπίθοιμεν, ὀίομαι, οὐκέτι τάρβος	- - - uu-u u-uu -uu --	dactylic hexameter	feminine penthemimeral, trithemimeral
ἔσσετʼ ἀεθλεύοντι δαμήμεναι· ἀλλὰ μάλʼ αἰνῶς	-u u---u u-uu -u u --	dactylic hexameter	feminine penthemimeral
δείδω, μή πως οὔ μοι ὑποσταίη τόγε μήτηρ.	-- - - - u u--- uu --	dactylic hexameter	masculine penthemimeral, trithemimeral
ἔμπης δʼ ἐξαῦτις μετελεύσομαι ἀντιβολήσων,	-- --- uu-uu -uu--	dactylic hexameter	masculine penthemimeral
ξυνὸς ἐπεὶ πάντεσσιν ἐπικρέμαθʼ ἧμιν ὄλεθρος.’	-u u- --u u-uu -u u--	dactylic hexameter	feminine penthemimeral, trithemimeral
Ἴσκεν ἐυφρονέων· ὁ δʼ ἀμείβετο τοῖσδʼ ἐπέεσσιν·	-u u-uu- u u-uu - uu--	dactylic hexameter	masculine penthemimeral
‘ὦ πέπον, εἴ νύ τοι αὐτῷ ἐφανδάνει, οὔτι μεγαίρω.	- uu - u u -u u-uu -u u--	dactylic hexameter	feminine penthemimeral, trithemimeral
βάσκʼ ἴθι καὶ πυκινοῖσι τεὴν παρὰ μητέρα μύθοις	- uu - uu-u u- uu -uu --	dactylic hexameter	feminine penthemimeral, hepthemimeral, trithemimeral
ὄρνυθι λισσόμενος· μελέη γε μὲν ἧμιν ὄρωρεν	-uu -uu- uu- u u -u u--	dactylic hexameter	masculine penthemimeral, hepthemimeral
ἐλπωρή, ὅτε νόστον ἐπετραπόμεσθα γυναιξίν.’	--- uu -u u-uu-u u--	dactylic hexameter	feminine penthemimeral, trithemimeral
ὧς ἔφατʼ· ὦκα δʼ ἕλος μετεκίαθον. αὐτὰρ ἑταῖροι	- uu -u u- uu-uu -u u--	dactylic hexameter	masculine penthemimeral
γηθόσυνοι ἐρέεινον, ὅπως παρεόντας ἴδοντο·	-uu- uu-u u- uu-u u--	dactylic hexameter	feminine penthemimeral, hepthemimeral, trithemimeral
τοῖσιν δʼ Αἰσονίδης τετιημένος ἔκφατο μῦθον·	-- -uu- uu-uu -uu --	dactylic hexameter	masculine penthemimeral
‘ὦ φίλοι, Αἰήταο ἀπηνέος ἄμμι φίλον κῆρ	- uu ---u u-uu -u u- -	dactylic hexameter	feminine penthemimeral
ἀντικρὺ κεχόλωται, ἕκαστα γὰρ οὔ νύ τι τέκμωρ	--- uu-u u-u u - u u --	dactylic hexameter	feminine penthemimeral, trithemimeral
οὔτʼ ἐμοί, οὔτε κεν ὔμμι διειρομένοισι πέλοιτο.	- uu -u u -u u-uu-u u--	dactylic hexameter	feminine penthemimeral
φῆ δὲ δύω πεδίον τὸ Ἀρήιον ἀμφινέμεσθαι	- u u- uu- u u-uu -uu--	dactylic hexameter	masculine penthemimeral, trithemimeral
ταύρω χαλκόποδε, στόματι φλόγα φυσιόωντας.	-- -uu- uu- uu -uu--	dactylic hexameter	masculine penthemimeral, hepthemimeral
τετράγυον δʼ ἐπὶ τοῖσιν ἐφίετο νειὸν ἀρόσσαι·	-uu- uu -u u-uu -u u--	dactylic hexameter	feminine penthemimeral, trithemimeral
δώσειν δʼ ἐξ ὄφιος γενύων σπόρον, ὅς ῥʼ ἀνίῃσιν	-- - uu- uu- uu - uu--	dactylic hexameter	masculine penthemimeral, hepthemimeral, trithemimeral
γηγενέας χαλκέοις σὺν τεύχεσιν· ἤματι δʼ αὐτῷ	-uu- -- - -uu -uu --	dactylic hexameter	masculine penthemimeral, trithemimeral
χρειὼ τούσγε δαΐξαι. ὃ δή νύ οἱ (οὔτι γὰρ ἄλλο	-- -u u-u u - u u -u u --	dactylic hexameter	feminine penthemimeral, hepthemimeral
βέλτερον ἦν φράσσασθαι) ἀπηλεγέως ὑποέστην.’	-uu - --u u-uu- uu--	dactylic hexameter	feminine penthemimeral, trithemimeral
ὧς ἄρʼ ἔφη· πάντεσσι δʼ ἀνήνυτος εἴσατʼ ἄεθλος,	- u u- --u u-uu -u u--	dactylic hexameter	feminine penthemimeral, trithemimeral
δὴν δʼ ἄνεῳ καὶ ἄναυδοι ἐς ἀλλήλους ὁρόωντο,	- uu- u u-u u --- uu--	dactylic hexameter	feminine penthemimeral, trithemimeral
ἄτῃ ἀμηχανίῃ τε κατηφέες· ὀψὲ δὲ Πηλεὺς	-u u-uu- u u-uu -u u --	dactylic hexameter	masculine penthemimeral
θαρσαλέως μετὰ πᾶσιν ἀριστήεσσιν ἔειπεν·	-uu- uu -u u---u u--	dactylic hexameter	feminine penthemimeral, trithemimeral
‘ὥρη μητιάασθαι ὅ κʼ ἔρξομεν. οὐ μὲν ἔολπα	-- -uu-u u -uu - u u--	dactylic hexameter	feminine penthemimeral
βουλῆς εἶναι ὄνειαρ, ὅσον τʼ ἐπὶ κάρτεϊ χειρῶν.	-- -u u-u u- uu -uu --	dactylic hexameter	feminine penthemimeral, hepthemimeral
εἰ μέν νυν τύνη ζεῦξαι βόας Αἰήταο,	- - - -- -- uu ----	dactylic hexameter	masculine penthemimeral, hepthemimeral, trithemimeral
ἥρως Αἰσονίδη, φρονέεις, μέμονάς τε πόνοιο,	-- -uu- uu- uu- u u--	dactylic hexameter	masculine penthemimeral, hepthemimeral
ἦ τʼ ἂν ὑποσχεσίην πεφυλαγμένος ἐντύναιο·	- u u-uu- uu-uu ----	dactylic hexameter	masculine penthemimeral
εἰ δʼ οὔ τοι μάλα θυμὸς ἑῇ ἐπὶ πάγχυ πέποιθεν	- - - uu -u u- uu -u u--	dactylic hexameter	feminine penthemimeral, hepthemimeral, trithemimeral
ἠνορέῃ, μήτʼ αὐτὸς ἐπείγεο, μήτε τινʼ ἄλλον	-uu- - -u u-uu -u u --	dactylic hexameter	feminine penthemimeral, trithemimeral
τῶνδʼ ἀνδρῶν πάπταινε παρήμενος. οὐ γὰρ ἔγωγε	- -- --u u-uu - u u--	dactylic hexameter	feminine penthemimeral, trithemimeral
σχήσομʼ, ἐπεὶ θάνατός γε τὸ κύντατον ἔσσεται ἄλγος.’	-u u- uu- u u -uu -uu --	dactylic hexameter	masculine penthemimeral, trithemimeral
ὧς ἔφατʼ Αἰακίδης· Τελαμῶνι δὲ θυμὸς ὀρίνθη·	- uu -uu- uu-u u -u u--	dactylic hexameter	masculine penthemimeral
σπερχόμενος δʼ ἀνόρουσε θοῶς· ἐπὶ δὲ τρίτος Ἴδας	-uu- uu-u u- uu - uu --	dactylic hexameter	feminine penthemimeral, hepthemimeral, trithemimeral
ὦρτο μέγα φρονέων, ἐπὶ δʼ υἱέε Τυνδαρέοιο·	-u u- uu- uu -uu -uu--	dactylic hexameter	masculine penthemimeral, trithemimeral
σὺν δὲ καὶ Οἰνεΐδης ἐναρίθμιος αἰζηοῖσιν	- u u -uu- uu-uu ----	dactylic hexameter	masculine penthemimeral
ἀνδράσιν, οὐδέ περ ὅσσον ἐπανθιόωντας ἰούλους	-uu -u u -u u-uu-u u--	dactylic hexameter	feminine penthemimeral
ἀντέλλων· τοίῳ οἱ ἀείρετο κάρτεϊ θυμός.	--- -- u u-uu -uu --	dactylic hexameter	masculine penthemimeral, trithemimeral
οἱ δʼ ἄλλοι εἴξαντες ἀκὴν ἔχον. αὐτίκα δʼ Ἄργος	- -- --u u- uu -uu --	dactylic hexameter	feminine penthemimeral, hepthemimeral, trithemimeral
τοῖον ἔπος μετέειπεν ἐελδομένοισιν ἀέθλου·	-u u- uu-u u-uu-u u--	dactylic hexameter	feminine penthemimeral, trithemimeral
‘ὦ φίλοι, ἤτοι μὲν τόδε λοίσθιον. ἀλλά τινʼ οἴω	- uu -- - uu -uu -u u --	dactylic hexameter	masculine penthemimeral
μητρὸς ἐμῆς ἔσσεσθαι ἐναίσιμον ὔμμιν ἀρωγήν.	-u u- --u u-uu -u u--	dactylic hexameter	feminine penthemimeral, trithemimeral
τῶ καί περ μεμαῶτες, ἐρητύοισθʼ ἐνὶ νηὶ	- - - uu-u u--- uu --	dactylic hexameter	feminine penthemimeral, trithemimeral
τυτθὸν ἔθʼ, ὡς τὸ πάροιθεν, ἐπεὶ καὶ ἐπισχέμεν ἔμπης	-u u - u u-u u- u u-uu --	dactylic hexameter	feminine penthemimeral, hepthemimeral, trithemimeral
λώιον, ἢ κακὸν οἶτον ἀφειδήσαντας ἑλέσθαι.	-uu - uu -u u---u u--	dactylic hexameter	feminine penthemimeral, trithemimeral
κούρη τις μεγάροισιν ἐνιτρέφετʼ Αἰήταο,	-- - uu-u u-uu ----	dactylic hexameter	feminine penthemimeral, trithemimeral
τὴν Ἑκάτη περίαλλα θεὰ δάε τεχνήσασθαι	- uu- uu-u u- uu ----	dactylic hexameter	feminine penthemimeral, hepthemimeral, trithemimeral
φάρμαχʼ, ὅσʼ ἤπειρός τε φύει καὶ νήχυτον ὕδωρ,	-u u --- u u- - -uu --	dactylic hexameter	masculine penthemimeral, hepthemimeral
τοῖσι καὶ ἀκαμάτοιο πυρὸς μειλίσσετʼ ἀυτμή,	-u u -uu-u u- --u u--	dactylic hexameter	feminine penthemimeral, hepthemimeral
καὶ ποταμοὺς ἵστησιν ἄφαρ κελαδεινὰ ῥέοντας,	- uu- --u u- uu-u u--	dactylic hexameter	feminine penthemimeral, hepthemimeral, trithemimeral
ἄστρα τε καὶ μήνης ἱερῆς ἐπέδησε κελεύθους.	-u u - -- uu- uu-u u--	dactylic hexameter	masculine penthemimeral, hepthemimeral, trithemimeral
τῆς μὲν ἀπὸ μεγάροιο κατὰ στίβον ἐνθάδʼ ἰόντες	- u u- uu-u u- uu -u u--	dactylic hexameter	feminine penthemimeral, hepthemimeral, trithemimeral
μνησάμεθʼ, εἴ κε δύναιτο, κασιγνήτη γεγαυῖα,	-uu - u u-u u--- uu--	dactylic hexameter	feminine penthemimeral, trithemimeral
μήτηρ ἡμετέρη πεπιθεῖν ἐπαρῆξαι ἀέθλῳ.	-- -uu- uu- uu-u u--	dactylic hexameter	masculine penthemimeral, hepthemimeral
εἰ δὲ καὶ αὐτοῖσιν τόδʼ ἐφανδάνει, ἦ τʼ ἂν ἱκοίμην	- u u --- u u-uu - u u--	dactylic hexameter	masculine penthemimeral
ἤματι τῷδʼ αὐτῷ πάλιν εἰς δόμον Αἰήταο	-uu - -- uu - uu ----	dactylic hexameter	masculine penthemimeral, hepthemimeral, trithemimeral
πειρήσων· τάχα δʼ ἂν σὺν δαίμονι πειρηθείην.’	--- uu - - -uu ----	dactylic hexameter	masculine penthemimeral, trithemimeral
ὧς φάτο· τοῖσι δὲ σῆμα θεοὶ δόσαν εὐμενέοντες.	- uu -u u -u u- uu -uu--	dactylic hexameter	feminine penthemimeral, hepthemimeral
τρηρὼν μὲν φεύγουσα βίην κίρκοιο πελειὰς	-- - --u u- --u u--	dactylic hexameter	feminine penthemimeral, hepthemimeral, trithemimeral
ὑψόθεν Αἰσονίδεω πεφοβημένη ἔμπεσε κόλποις·	-uu -uu- uu-uu -uu --	dactylic hexameter	masculine penthemimeral
κίρκος δʼ ἀφλάστῳ περικάππεσεν. ὦκα δὲ Μόψος	-- --- uu-uu -u u --	dactylic hexameter	masculine penthemimeral
τοῖον ἔπος μετὰ πᾶσι θεοπροπέων ἀγόρευσεν·	-u u- uu -u u-uu- uu--	dactylic hexameter	feminine penthemimeral, trithemimeral
‘ὔμμι, φίλοι, τόδε σῆμα θεῶν ἰότητι τέτυκται·	-u u- uu -u u- uu-u u--	dactylic hexameter	feminine penthemimeral, hepthemimeral, trithemimeral
οὐδέ τῃ ἄλλως ἐστὶν ὑποκρίνασθαι ἄρειον,	-u u -- -u u---u u--	dactylic hexameter	feminine penthemimeral
παρθενικὴν δʼ ἐπέεσσι μετελθέμεν ἀμφιέποντας	-uu- uu-u u-uu -uu--	dactylic hexameter	feminine penthemimeral, trithemimeral
μήτι παντοίῃ. δοκέω δέ μιν οὐκ ἀθερίζειν,	-- --- uu- u u - uu--	dactylic hexameter	masculine penthemimeral, hepthemimeral
εἰ ἐτεὸν Φινεύς γε θεᾷ ἐνὶ Κύπριδι νόστον	- uu- -- u u- uu -uu --	dactylic hexameter	masculine penthemimeral, hepthemimeral, trithemimeral
πέφραδεν ἔσσεσθαι. κείνης δʼ ὅγε μείλιχος ὄρνις	-uu --- -- uu -uu --	dactylic hexameter	masculine penthemimeral, hepthemimeral
πότμον ὑπεξήλυξε· κέαρ δέ μοι ὡς ἐνὶ θυμῷ	-u u---u u- u u - uu --	dactylic hexameter	feminine penthemimeral, hepthemimeral
τόνδε κατʼ οἰωνὸν προτιόσσεται, ὧς δὲ πέλοιτο.	-u u --- uu-uu - u u--	dactylic hexameter	masculine penthemimeral
ἀλλά, φίλοι, Κυθέρειαν ἐπικλείοντες ἀμύνειν,	-u u- uu-u u---u u--	dactylic hexameter	feminine penthemimeral, trithemimeral
ἤδη νῦν Ἄργοιο παραιφασίῃσι πίθεσθε.’	-- - --u u-uu-u u--	dactylic hexameter	feminine penthemimeral, trithemimeral
Ἴσκεν· ἐπῄνησαν δὲ νέοι, Φινῆος ἐφετμὰς	-u u--- u u- --u u--	dactylic hexameter	masculine penthemimeral, hepthemimeral
μνησάμενοι· μοῦνος δʼ Ἀφαρήιος ἄνθορεν Ἴδας,	-uu- -- uu-uu -uu --	dactylic hexameter	masculine penthemimeral, trithemimeral
δείνʼ ἐπαλαστήσας μεγάλῃ ὀπί, φώνησέν τε·	- uu--- uu- uu --- -	dactylic hexameter	masculine penthemimeral, hepthemimeral
‘ὦ πόποι, ἦ ῥα γυναιξὶν ὁμόστολοι ἐνθάδʼ ἔβημεν,	- uu - u u-u u-uu -u u--	dactylic hexameter	feminine penthemimeral, trithemimeral
οἳ Κύπριν καλέουσιν ἐπίρροθον ἄμμι πέλεσθαι,	- -- uu-u u-uu -u u--	dactylic hexameter	feminine penthemimeral, trithemimeral
οὐκέτʼ Ἐνυαλίοιο μέγα σθένος; ἐς δὲ πελείας	-u u-uu-u u- uu - u u--	dactylic hexameter	feminine penthemimeral, hepthemimeral
καὶ κίρκους λεύσσοντες ἐρητύεσθε ἀέθλων;	- -- --u u---u u--	dactylic hexameter	feminine penthemimeral, trithemimeral
ἔρρετε, μηδʼ ὔμμιν πολεμήια ἔργα μέλοιτο,	-uu - -- uu-uu -u u--	dactylic hexameter	masculine penthemimeral, trithemimeral
παρθενικὰς δὲ λιτῇσιν ἀνάλκιδας ἠπεροπεύειν.’	-uu- u u-u u-uu -uu--	dactylic hexameter	feminine penthemimeral, trithemimeral
ὧς ηὔδα μεμαώς· πολέες δʼ ὁμάδησαν ἑταῖροι	- -- uu- uu- uu-u u--	dactylic hexameter	masculine penthemimeral, hepthemimeral, trithemimeral
ἦκα μάλʼ, οὐδʼ ἄρα τίς οἱ ἐναντίον ἔκφατο μῦθον.	-u u - uu - u u-uu -uu --	dactylic hexameter	masculine penthemimeral, trithemimeral
χωόμενος δʼ ὅ γʼ ἔπειτα καθέζετο· τοῖσι δʼ Ἰήσων	-uu- u u-u u-uu -u u--	dactylic hexameter	feminine penthemimeral, trithemimeral
αὐτίκʼ ἐποτρύνων τὸν ἑὸν νόον ὧδʼ ἀγόρευεν·	-u u--- u u- uu - uu--	dactylic hexameter	masculine penthemimeral, hepthemimeral
‘Ἄργος μὲν παρὰ νηός, ἐπεὶ τόδε πᾶσιν ἕαδεν,	-- - uu -u u- uu -u u--	dactylic hexameter	feminine penthemimeral, hepthemimeral, trithemimeral
στελλέσθω· ἀτὰρ αὐτοὶ ἐπὶ χθονὸς ἐκ ποταμοῖο	--- uu -u u- uu - uu--	dactylic hexameter	feminine penthemimeral, hepthemimeral, trithemimeral
ἀμφαδὸν ἤδη πείσματʼ ἀνάψομεν. ἦ γὰρ ἔοικεν	-uu -- -u u-uu - u u--	dactylic hexameter	feminine penthemimeral
μηκέτι δὴν κρύπτεσθαι ὑποπτήσσοντας ἀυτήν.’	-uu - --u u---u u--	dactylic hexameter	feminine penthemimeral, trithemimeral
ὧς ἄρʼ ἔφη· καὶ τὸν μὲν ἄφαρ προΐαλλε νέεσθαι	- u u- - - u u- uu-u u--	dactylic hexameter	masculine penthemimeral, hepthemimeral, trithemimeral
καρπαλίμως ἐξαῦτις ἀνὰ πτόλιν· οἱ δʼ ἐπὶ νηὸς	-uu- --u u- uu - uu --	dactylic hexameter	feminine penthemimeral, hepthemimeral, trithemimeral
εὐναίας ἐρύσαντες ἐφετμαῖς Αἰσονίδαο	--- uu-u u-- -uu--	dactylic hexameter	feminine penthemimeral, trithemimeral
τυτθὸν ὑπὲξ ἕλεος χέρσῳ ἐπέκελσαν ἐρετμοῖς.	-u u- uu- -- uu-u u--	dactylic hexameter	masculine penthemimeral, hepthemimeral, trithemimeral
αὐτίκα δʼ Αἰήτης ἀγορὴν ποιήσατο Κόλχων	-uu --- uu- --uu --	dactylic hexameter	masculine penthemimeral, hepthemimeral
νόσφιν ἑοῖο δόμου, τόθι περ καὶ πρόσθε κάθιζον,	-u u-u u- uu - - -u u--	dactylic hexameter	masculine penthemimeral, hepthemimeral
ἀτλήτους Μινύῃσι δόλους καὶ κήδεα τεύχων.	--- uu-u u- - -uu --	dactylic hexameter	feminine penthemimeral, hepthemimeral, trithemimeral
στεῦτο δʼ ,ἐπεί κεν πρῶτα βόες διαδηλήσωνται	-u u- - -u u- uu----	dactylic hexameter	feminine penthemimeral, hepthemimeral, trithemimeral
ἄνδρα τόν, ὅς ῥʼ ὑπέδεκτο βαρὺν καμέεσθαι ἄεθλον,	-u u - uu-u u- uu-u u--	dactylic hexameter	feminine penthemimeral, hepthemimeral, trithemimeral
δρυμὸν ἀναρρήξας λασίης καθύπερθε· κολώνης	-u u--- uu- uu-u u--	dactylic hexameter	masculine penthemimeral, hepthemimeral
αὔτανδρον φλέξειν δόρυ νήιον, ὄφρʼ ἀλεγεινὴν	--- -- uu -uu - uu--	dactylic hexameter	masculine penthemimeral, trithemimeral
ὕβριν ἀποφλύξωσιν ὑπέρβια μηχανόωντες.	-u u---u u-uu -uu--	dactylic hexameter	feminine penthemimeral
οὐδὲ γὰρ Αἰολίδην Φρίξον μάλα περ χατέοντα	-u u -uu- -- uu - uu--	dactylic hexameter	masculine penthemimeral, hepthemimeral
δέχθαι ἐνὶ μεγάροισιν ἐφέστιον, ὃς περὶ πάντων	-u u- uu-u u-uu - uu --	dactylic hexameter	feminine penthemimeral, trithemimeral
ξείνων μελιχίῃ τε θεουδείῃ τʼ ἐκέκαστο,	-- -uu- u u--- uu--	dactylic hexameter	masculine penthemimeral
εἰ μή οἱ Ζεὺς αὐτὸς ἀπʼ οὐρανοῦ ἄγγελον ἧκεν	- - - - -u u -uu -uu --	dactylic hexameter	feminine penthemimeral, trithemimeral
Ἑρμείαν, ὥς κεν προσκηδέος ἀντιάσειεν·	--- - - --uu -uu--	dactylic hexameter	masculine penthemimeral, trithemimeral
μὴ καὶ ληιστῆρας ἑὴν ἐς γαῖαν ἰόντας	- - ---u u- - -u u--	dactylic hexameter	feminine penthemimeral, hepthemimeral
ἔσσεσθαι δηναιὸν ἀπήμονας, οἷσι μέμηλεν	--- --u u-uu -u u--	dactylic hexameter	feminine penthemimeral, trithemimeral
ὀθνείοις ἐπὶ χεῖρα ἑὴν κτεάτεσσιν ἀείρειν,	--- uu -u u- uu-u u--	dactylic hexameter	feminine penthemimeral, hepthemimeral, trithemimeral
κρυπταδίους τε δόλους τεκταινέμεν, ἠδὲ βοτήρων	-uu- u u- --uu -u u--	dactylic hexameter	masculine penthemimeral, trithemimeral
αὔλια δυσκελάδοισιν ἐπιδρομίῃσι δαΐξαι.	-uu -uu-u u-uu-u u--	dactylic hexameter	feminine penthemimeral
νόσφι δὲ οἷ αὐτῷ φάτʼ ἐοικότα μείλια τίσειν	-u u - -- u u-uu -uu --	dactylic hexameter	masculine penthemimeral, trithemimeral
υἱῆας Φρίξοιο, κακορρέκτῃσιν ὀπηδοὺς	--- --u u---u u--	dactylic hexameter	feminine penthemimeral, trithemimeral
ἀνδράσι νοστήσαντας ὁμιλαδόν, ὄφρα ἑ τιμῆς	-uu ---u u-uu -u u --	dactylic hexameter	feminine penthemimeral
καὶ σκήπτρων ἐλάσειαν ἀκηδέες· ὥς ποτε βάξιν	- -- uu-u u-uu - uu --	dactylic hexameter	feminine penthemimeral, trithemimeral
λευγαλέην οὗ πατρὸς ἐπέκλυεν Ἠελίοιο,	-uu- - -u u-uu -uu--	dactylic hexameter	feminine penthemimeral, trithemimeral
χρειώ μιν πυκινόν τε δόλον βουλάς τε γενέθλης	-- - uu- u u- -- u u--	dactylic hexameter	masculine penthemimeral, hepthemimeral, trithemimeral
σφωιτέρης ἄτην τε πολύτροπον ἐξαλέασθαι·	-uu- -- u u-uu -uu--	dactylic hexameter	masculine penthemimeral, trithemimeral
τῶ καὶ ἐελδομένους πέμπειν ἐς Ἀχαιίδα γαῖαν	- u u-uu- -- u u-uu --	dactylic hexameter	masculine penthemimeral, hepthemimeral
πατρὸς ἐφημοσύνῃ, δολιχὴν ὁδόν. οὐδὲ θυγατρῶν	-u u-uu- uu- uu -u u--	dactylic hexameter	masculine penthemimeral, hepthemimeral
εἶναί οἱ τυτθόν γε δέος, μή πού τινα μῆτιν	-- - -- u u- - - uu --	dactylic hexameter	masculine penthemimeral, hepthemimeral, trithemimeral
φράσσωνται στυγερήν, οὐδʼ υἱέος Ἀψύρτοιο·	--- uu- - -uu ----	dactylic hexameter	masculine penthemimeral, trithemimeral
ἀλλʼ ἐνὶ Χαλκιόπης γενεῇ τάδε λυγρὰ τετύχθαι.	- uu -uu- uu- uu -u u--	dactylic hexameter	masculine penthemimeral, hepthemimeral
καί ῥʼ ὁ μὲν ἄσχετα ἔργα πιφαύσκετο δημοτέροισιν	- u u -uu -u u-uu -uu--	dactylic hexameter	feminine penthemimeral
χωόμενος· μέγα δέ σφιν ἀπείλεε νῆά τʼ ἔρυσθαι	-uu- uu - u u-uu -u u--	dactylic hexameter	masculine penthemimeral, trithemimeral
ἠδʼ αὐτούς, ἵνα μήτις ὑπὲκ κακότητος ἀλύξῃ.	- -- uu -u u- uu-u u--	dactylic hexameter	feminine penthemimeral, hepthemimeral, trithemimeral
τόφρα δὲ μητέρʼ ἑήν, μετιὼν δόμον Αἰήταο,	-u u -u u- uu- uu ----	dactylic hexameter	masculine penthemimeral, hepthemimeral
Ἄργος παντοίοισι παρηγορέεσκʼ ἐπέεσσιν,	-- ---u u-uu- uu--	dactylic hexameter	feminine penthemimeral
Μήδειαν λίσσεσθαι ἀμυνέμεν· ἡ δὲ καὶ αὐτὴ	--- --u u-uu - u u --	dactylic hexameter	feminine penthemimeral, trithemimeral
πρόσθεν μητιάασκε· δέος δέ μιν ἴσχανε θυμόν,	-- -uu-u u- u u -uu --	dactylic hexameter	feminine penthemimeral, hepthemimeral
μή πως ἠὲ παρʼ αἶσαν ἐτώσια μειλίξαιτο	- - -u u -u u-uu ----	dactylic hexameter	feminine penthemimeral
πατρὸς ἀτυζομένην ὀλοὸν χόλον, ἠὲ λιτῇσιν	-u u-uu- uu- uu -u u--	dactylic hexameter	masculine penthemimeral, hepthemimeral
ἑσπομένης ἀρίδηλα καὶ ἀμφαδὰ ἔργα πέλοιτο.	-uu- uu-u u -uu -u u--	dactylic hexameter	feminine penthemimeral, trithemimeral
κούρην δʼ ἐξ ἀχέων ἀδινὸς κατελώφεεν ὕπνος	-- - uu- uu- uu-uu --	dactylic hexameter	masculine penthemimeral, hepthemimeral, trithemimeral
λέκτρῳ ἀνακλινθεῖσαν. ἄφαρ δέ μιν ἠπεροπῆες,	-u u---u u- u u -uu--	dactylic hexameter	feminine penthemimeral, hepthemimeral
οἷά τʼ ἀκηχεμένην, ὀλοοὶ ἐρέθεσκον ὄνειροι.	-u u-uu- uu- uu-u u--	dactylic hexameter	masculine penthemimeral, hepthemimeral
τὸν ξεῖνον δʼ ἐδόκησεν ὑφεστάμεναι τὸν ἄεθλον,	- -- uu-u u-uu- u u--	dactylic hexameter	feminine penthemimeral, trithemimeral
οὔτι μάλʼ ὁρμαίνοντα δέρος κριοῖο κομίσσαι,	-u u ---u u- --u u--	dactylic hexameter	feminine penthemimeral, hepthemimeral
οὐδέ τι τοῖο ἕκητι μετὰ πτόλιν Αἰήταο	-u u -u u-u u- uu ----	dactylic hexameter	feminine penthemimeral, hepthemimeral
ἐλθέμεν, ὄφρα δέ μιν σφέτερον δόμον εἰσαγάγοιτο	-uu -u u - uu- uu -uu--	dactylic hexameter	masculine penthemimeral, hepthemimeral
κουριδίην παράκοιτιν· ὀίετο δʼ ἀμφὶ βόεσσιν	-uu- uu-u u-uu -u u--	dactylic hexameter	feminine penthemimeral, trithemimeral
αὐτὴ ἀεθλεύουσα μάλʼ εὐμαρέως πονέεσθαι·	-u u---u u -uu- uu--	dactylic hexameter	feminine penthemimeral
σφωιτέρους δὲ τοκῆας ὑποσχεσίης ἀθερίζειν,	-uu- u u-u u-uu- uu--	dactylic hexameter	feminine penthemimeral, trithemimeral
οὕνεκεν οὐ κούρῃ ζεῦξαι βόας, ἀλλά οἱ αὐτῷ	-uu - -- -- uu -u u --	dactylic hexameter	masculine penthemimeral, hepthemimeral, trithemimeral
προύθεσαν· ἐκ δʼ ἄρα τοῦ νεῖκος πέλεν ἀμφήριστον	-uu - uu - -- uu ----	dactylic hexameter	masculine penthemimeral, hepthemimeral, trithemimeral
πατρί τε καὶ ξείνοις· αὐτῇ δʼ ἐπιέτρεπον ἄμφω	-u u - -- -- uu-uu --	dactylic hexameter	masculine penthemimeral, hepthemimeral, trithemimeral
τὼς ἔμεν, ὥς κεν ἑῇσι μετὰ φρεσὶν ἰθύσειεν.	- uu - u u-u u- uu ----	dactylic hexameter	feminine penthemimeral, hepthemimeral, trithemimeral
ἡ δʼ ἄφνω τὸν ξεῖνον, ἀφειδήσασα τοκήων,	- -- - -u u---u u--	dactylic hexameter	feminine penthemimeral, trithemimeral
εἵλετο· τοὺς δʼ ἀμέγαρτον ἄχος λάβεν, ἐκ δʼ ἐβόησαν	-uu - uu-u u- uu - uu--	dactylic hexameter	feminine penthemimeral, hepthemimeral, trithemimeral
χωόμενοι· τὴν δʼ ὕπνος ἅμα κλαγγῇ μεθέηκεν.	-uu- - -u u- -- uu--	dactylic hexameter	feminine penthemimeral, hepthemimeral, trithemimeral
παλλομένη δʼ ἀνόρουσε φόβῳ, περί τʼ ἀμφί τε τοίχους	-uu- uu-u u- uu -u u --	dactylic hexameter	feminine penthemimeral, hepthemimeral, trithemimeral
πάπτηνεν θαλάμοιο· μόλις δʼ ἐσαγείρατο θυμὸν	--- uu-u u- uu-uu --	dactylic hexameter	feminine penthemimeral, hepthemimeral, trithemimeral
ὡς πάρος ἐν στέρνοις, ἀδινὴν δʼ ἀνενείκατο φωνήν·	- uu - -- uu- uu-uu --	dactylic hexameter	masculine penthemimeral, hepthemimeral, trithemimeral
‘δειλὴ ἐγών, οἷόν με βαρεῖς ἐφόβησαν ὄνειροι.	-u u- -- u u- uu-u u--	dactylic hexameter	masculine penthemimeral, hepthemimeral, trithemimeral
δείδια, μὴ μέγα δή τι φέρῃ κακὸν ἥδε κέλευθος	-uu - uu - u u- uu -u u--	dactylic hexameter	masculine penthemimeral, hepthemimeral, trithemimeral
ἡρώων. περί μοι ξείνῳ φρένες ἠερέθονται.	--- uu - -- uu -uu--	dactylic hexameter	masculine penthemimeral, hepthemimeral, trithemimeral
μνάσθω ἑὸν κατὰ δῆμον Ἀχαιίδα τηλόθι κούρην	-u u- uu -u u-uu -uu --	dactylic hexameter	feminine penthemimeral, trithemimeral
ἄμμι δὲ παρθενίη τε μέλοι καὶ δῶμα τοκήων.	-u u -uu- u u- - -u u--	dactylic hexameter	masculine penthemimeral, hepthemimeral
ἔμπα γε μὴν θεμένη κύνεον κέαρ, οὐκέτʼ ἄνευθεν	-u u - uu- uu- uu -u u--	dactylic hexameter	masculine penthemimeral, hepthemimeral, trithemimeral
αὐτοκασιγνήτης πειρήσομαι, εἴ κέ μ᾽ἀέθλῳ	-uu--- --uu - u u--	dactylic hexameter	masculine penthemimeral
χραισμεῖν ἀντιάσῃσιν, ἐπὶ σφετέροις ἀχέουσα	-- -uu-u u- uu- uu--	dactylic hexameter	feminine penthemimeral, hepthemimeral
παισί· τό κέν μοι λυγρὸν ἐνὶ κραδίῃ σβέσαι ἄλγος.’	-u u - - -u u- uu- uu --	dactylic hexameter	feminine penthemimeral, hepthemimeral, trithemimeral
ἦ ῥα, καὶ ὀρθωθεῖσα θύρας ὤιξε δόμοιο,	- u u ---u u- --u u--	dactylic hexameter	feminine penthemimeral, hepthemimeral
νήλιπος, οἰέανος· καὶ δὴ λελίητο νέεσθαι	-uu -uu- - - uu-u u--	dactylic hexameter	masculine penthemimeral, hepthemimeral
αὐτοκασιγνήτηνδε, καὶ ἕρκεος οὐδὸν ἄμειψεν.	-uu---u u -uu -u u--	dactylic hexameter	feminine penthemimeral
δὴν δὲ καταυτόθι μίμνεν ἐνὶ προδόμῳ θαλάμοιο,	- u u-uu -u u- uu- uu--	dactylic hexameter	feminine penthemimeral, hepthemimeral
αἰδοῖ ἐεργομένη· μετὰ δʼ ἐτράπετʼ αὖτις ὀπίσσω	-u u-uu- uu -uu -u u--	dactylic hexameter	masculine penthemimeral
στρεφθεῖσʼ· ἐκ δὲ πάλιν κίεν ἔνδοθεν, ἄψ τʼ ἀλέεινεν	-- - u u- uu -uu - uu--	dactylic hexameter	masculine penthemimeral, trithemimeral
εἴσω· τηΰσιοι δὲ πόδες φέρον ἔνθα καὶ ἔνθα·	-- -uu- u u- uu -u u --	dactylic hexameter	masculine penthemimeral, hepthemimeral
ἤτοι ὅτʼ ἰθύσειεν, ἔρυκέ μιν ἔνδοθεν αἰδώς·	-u u ---u u-u u -uu --	dactylic hexameter	feminine penthemimeral
αἰδοῖ δʼ ἐργομένην θρασὺς ἵμερος ὀτρύνεσκεν.	-- -uu- uu -uu ----	dactylic hexameter	masculine penthemimeral
τρὶς μὲν ἐπειρήθη, τρὶς δʼ ἔσχετο, τέτρατον αὖτις	- u u--- - -uu -uu --	dactylic hexameter	masculine penthemimeral
λέκτροισιν πρηνὴς ἐνικάππεσεν εἱλιχθεῖσα.	--- -- uu-uu ----	dactylic hexameter	masculine penthemimeral, trithemimeral
ὡς δʼ ὅτε τις νύμφη θαλερὸν πόσιν ἐν θαλάμοισιν	- uu - -- uu- uu - uu--	dactylic hexameter	masculine penthemimeral, hepthemimeral, trithemimeral
μύρεται, ᾧ μιν ὄπασσαν ἀδελφεοὶ ἠδὲ τοκῆες,	-uu - u u-u u-uu -u u--	dactylic hexameter	feminine penthemimeral, trithemimeral
οὐδέ τί πω πάσαις ἐπιμίσγεται ἀμφιπόλοισιν	-u u - -- uu-uu -uu--	dactylic hexameter	masculine penthemimeral, trithemimeral
αἰδοῖ ἐπιφροσύνῃ τε· μυχῷ δʼ ἀχέουσα θαάσσει·	-u u-uu- u u- uu-u u--	dactylic hexameter	masculine penthemimeral, hepthemimeral
τὸν δέ τις ὤλεσε μοῖρα, πάρος ταρπήμεναι ἄμφω	- u u -uu -u u- --uu --	dactylic hexameter	feminine penthemimeral, hepthemimeral
δήνεσιν ἀλλήλων· ἡ δʼ ἔνδοθι δαιομένη περ	-uu --- - -uu -uu- -	dactylic hexameter	masculine penthemimeral
σῖγα μάλα κλαίει χῆρον λέχος εἰσορόωσα,	-u u- -- -- uu -uu--	dactylic hexameter	masculine penthemimeral, hepthemimeral, trithemimeral
μή μιν κερτομέουσαι ἐπιστοβέωσι γυναῖκες·	- - -uu-u u-uu-u u--	dactylic hexameter	feminine penthemimeral
τῇ ἰκέλη Μήδεια κινύρετο. τὴν δέ τις ἄφνω	- uu- --u u-uu - u u --	dactylic hexameter	feminine penthemimeral, trithemimeral
μυρομένην μεσσηγὺς ἐπιπρομολοῦσʼ ἐνόησεν	-uu- --u u-uu- uu--	dactylic hexameter	feminine penthemimeral, trithemimeral
δμωάων, ἥ οἱ ἑπέτις πέλε κουρίζουσα·	--- - - uu- uu ----	dactylic hexameter	masculine penthemimeral, hepthemimeral, trithemimeral
Χαλκιόπῃ δʼ ἤγγειλε παρασχεδόν· ἡ δʼ ἐνὶ παισὶν	-uu- --u u-uu - uu --	dactylic hexameter	feminine penthemimeral, trithemimeral
ἧστʼ ἐπιμητιόωσα κασιγνήτην ἀρέσασθαι.	- uu-uu-u u--- uu--	dactylic hexameter	feminine penthemimeral
ἀλλʼ οὐδʼ ὧς ἀπίθησεν, ὅτʼ ἔκλυεν ἀμφιπόλοιο	- - - uu-u u -uu -uu--	dactylic hexameter	feminine penthemimeral, trithemimeral
μῦθον ἀνώιστον· διὰ δʼ ἔσσυτο θαμβήσασα	-u u--- uu -uu ----	dactylic hexameter	masculine penthemimeral
ἐκ θαλάμου θάλαμόνδε διαμπερές, ᾧ ἔνι κούρη	- uu- uu-u u-uu - uu --	dactylic hexameter	feminine penthemimeral, trithemimeral
κέκλιτʼ ἀκηχεμένη, δρύψεν δʼ ἑκάτερθε παρειάς·	-u u-uu- -- uu-u u--	dactylic hexameter	masculine penthemimeral, hepthemimeral
ὡς δʼ ἴδε δάκρυσιν ὄσσε πεφυρμένα, φώνησέν μιν·	- uu -uu -u u-uu --- -	dactylic hexameter	feminine penthemimeral
‘Ὤ μοι ἐγώ, Μήδεια, τί δὴ τάδε δάκρυα λείβεις;	- u u- --u u - uu -uu --	dactylic hexameter	feminine penthemimeral, hepthemimeral, trithemimeral
τίπτʼ ἔπαθες; τί τοι αἰνὸν ὑπὸ φρένας ἵκετο πένθος;	- uu- u u -u u- uu -uu --	dactylic hexameter	feminine penthemimeral, hepthemimeral, trithemimeral
ἤ νύ σε θευμορίη περιδέδρομεν ἅψεα νοῦσος,	- u u -uu- uu-uu -uu --	dactylic hexameter	masculine penthemimeral
ἦέ τινʼ οὐλομένην ἐδάης ἐκ πατρὸς ἐνιπὴν	-u u -uu- uu- - -u u--	dactylic hexameter	masculine penthemimeral, hepthemimeral
ἀμφί τʼ ἐμοὶ καὶ παισίν; ὄφελλέ με μήτε τοκήων	-u u- - -u u-u u -u u--	dactylic hexameter	feminine penthemimeral, trithemimeral
δῶμα τόδʼ εἰσοράαν, μηδὲ πτόλιν, ἀλλʼ ἐπὶ γαίης	-u u -uu- -- uu - uu --	dactylic hexameter	masculine penthemimeral, hepthemimeral
πείρασι ναιετάειν, ἵνα μηδέ περ οὔνομα Κόλχων.’	-uu -uu- uu -u u -uu --	dactylic hexameter	masculine penthemimeral
ὧς φάτο· τῆς δʼ ἐρύθηνε παρήια· δὴν δέ μιν αἰδὼς	- uu - uu-u u-uu - u u --	dactylic hexameter	feminine penthemimeral, trithemimeral
παρθενίη κατέρυκεν ἀμείψασθαι μεμαυῖαν.	-uu- uu-u u--- uu--	dactylic hexameter	feminine penthemimeral, trithemimeral
μῦθος δʼ ἄλλοτε μέν οἱ ἐπʼ ἀκροτάτης ἀνέτελλεν	-- -uu - u u -uu- uu--	dactylic hexameter	masculine penthemimeral
γλώσσης, ἄλλοτʼ ἔνερθε κατὰ στῆθος πεπότητο.	-- -u u-u u- -- uu--	dactylic hexameter	feminine penthemimeral, hepthemimeral
πολλάκι δʼ ἱμερόεν μὲν ἀνὰ στόμα θυῖεν ἐνισπεῖν·	-uu -uu- u u- uu -u u--	dactylic hexameter	masculine penthemimeral, hepthemimeral
φθογγῇ δʼ οὐ προύβαινε παροιτέρω· ὀψὲ δʼ ἔειπεν	-- - --u u-uu -u u--	dactylic hexameter	feminine penthemimeral, trithemimeral
τοῖα δόλῳ· θρασέες γὰρ ἐπεκλονέεσκον Ἔρωτες·	-u u- uu- u u-uu-u u--	dactylic hexameter	masculine penthemimeral, trithemimeral
‘Χαλκιόπη, περί μοι παίδων σέο θυμὸς ἄηται,	-uu- uu - -- uu -u u--	dactylic hexameter	masculine penthemimeral, hepthemimeral, trithemimeral
μή σφε πατὴρ ξείνοισι σὺν ἀνδράσιν αὐτίκʼ ὀλέσσῃ.	- u u- --u u -uu -u u--	dactylic hexameter	feminine penthemimeral, trithemimeral
τοῖα κατακνώσσουσα μινυνθαδίῳ νέον ὕπνῳ	-u u---u u-uu- uu --	dactylic hexameter	feminine penthemimeral
λεύσσω ὀνείρατα λυγρά, τά τις θεὸς ἀκράαντα	-u u-uu -u u - uu ----	dactylic hexameter	feminine penthemimeral, hepthemimeral
θείη, μηδʼ ἀλεγεινὸν ἐφʼ υἱάσι κῆδος ἕλοιο.’	-- - uu-u u -uu -u u--	dactylic hexameter	feminine penthemimeral, trithemimeral
φῆ ῥα, κασιγνήτης πειρωμένη, εἴ κέ μιν αὐτὴ	- u u--- --uu - u u --	dactylic hexameter	masculine penthemimeral
ἀντιάσειε πάροιθεν ἑοῖς τεκέεσσιν ἀμύνειν.	-uu-u u-u u- uu-u u--	dactylic hexameter	feminine penthemimeral, hepthemimeral
τὴν δʼ αἰνῶς ἄτλητος ἐπέκλυσε θυμὸν ἀνίη	- -- --u u-uu -u u--	dactylic hexameter	feminine penthemimeral, trithemimeral
δείματι, τοῖʼ ἐσάκουσεν· ἀμείβετο δʼ ὧδʼ ἐπέεσσιν·	-uu - uu-u u-uu - uu--	dactylic hexameter	feminine penthemimeral, trithemimeral
‘καὶ δʼ αὐτὴ τάδε πάντα μετήλυθον ὁρμαίνουσα,	- -- uu -u u-uu ----	dactylic hexameter	feminine penthemimeral, trithemimeral
εἴ τινα συμφράσσαιο καὶ ἀρτύνειας ἀρωγήν.	- uu ---u u ---u u--	dactylic hexameter	feminine penthemimeral
ἀλλʼ ὄμοσον Γαῖάν τε καὶ Οὐρανόν, ὅττι τοι εἴπω	- uu- -- u u -uu -u u --	dactylic hexameter	masculine penthemimeral, trithemimeral
σχήσειν ἐν θυμῷ, σύν τε δρήστειρα πέλεσθαι.	-- - -- - - --u u--	dactylic hexameter	masculine penthemimeral, hepthemimeral, trithemimeral
λίσσομʼ ὑπὲρ μακάρων σέο τʼ αὐτῆς ἠδὲ τοκήων,	-u u- uu- uu -- -u u--	dactylic hexameter	masculine penthemimeral, trithemimeral
μή σφε κακῇ ὑπὸ κηρὶ διαρραισθέντας ἰδέσθαι	- u u- uu -u u---u u--	dactylic hexameter	feminine penthemimeral, trithemimeral
λευγαλέως· ἢ σοίγε φίλοις σὺν παισὶ θανοῦσα	-uu- - -u u- - -u u--	dactylic hexameter	feminine penthemimeral, hepthemimeral, trithemimeral
εἴην ἐξ Ἀίδεω στυγερὴ μετόπισθεν Ἐρινύς.’	-- - uu- uu- uu-u u--	dactylic hexameter	masculine penthemimeral, hepthemimeral, trithemimeral
ὧς ἄρʼ ἔφη, τὸ δὲ πολλὸν ὑπεξέχυτʼ αὐτίκα δάκρυ·	- u u- u u -u u-uu -uu --	dactylic hexameter	feminine penthemimeral, trithemimeral
νειόθι θ᾽ἀμφοτέρῃσι περίσχετο γούνατα χερσίν,	-uu -uu-u u-uu -uu --	dactylic hexameter	feminine penthemimeral
σὺν δὲ κάρη κόλποις περικάββαλεν. ἔνθʼ ἐλεεινὸν	- u u- -- uu-uu - uu--	dactylic hexameter	masculine penthemimeral, trithemimeral
ἄμφω ἐπʼ ἀλλήλῃσι θέσαν γόον· ὦρτο δʼ ἰωὴ	-u u ---u u- uu -u u--	dactylic hexameter	feminine penthemimeral, hepthemimeral
λεπταλέη διὰ δώματʼ ὀδυρομένων ἀχέεσσιν.	-uu- uu -u u-uu- uu--	dactylic hexameter	feminine penthemimeral, trithemimeral
τὴν δὲ πάρος Μήδεια προσέννεπεν ἀσχαλόωσα·	- u u- --u u-uu -uu--	dactylic hexameter	feminine penthemimeral, trithemimeral
‘δαιμονίη, τί νύ τοι ῥέξω ἄκος, οἷʼ ἀγορεύεις,	-uu- u u - -- uu - uu--	dactylic hexameter	masculine penthemimeral, hepthemimeral, trithemimeral
ἀράς τε στυγερὰς καὶ Ἐρινύας; αἲ γὰρ ὄφελλεν	-- - uu- u u-uu - u u--	dactylic hexameter	masculine penthemimeral, trithemimeral
ἔμπεδον εἶναι ἐπʼ ἄμμι τεοὺς υἱῆας ἔρυσθαι.	-uu -u u -u u- --u u--	dactylic hexameter	feminine penthemimeral, hepthemimeral
ἴστω Κόλχων ὅρκος ὑπέρβιος ὅντινʼ ὀμόσσαι	-- -- -u u-uu -u u--	dactylic hexameter	feminine penthemimeral
αὐτὴ ἐποτρύνεις, μέγας Οὐρανός, ἥ θ᾽ὑπένερθεν	-u u--- uu -uu - uu--	dactylic hexameter	masculine penthemimeral
γαῖα, θεῶν μήτηρ, ὅσσον σθένος ἐστὶν ἐμεῖο,	-u u- -- -- uu -u u--	dactylic hexameter	masculine penthemimeral, hepthemimeral, trithemimeral
μή σ᾽ἐπιδευήσεσθαι, ἀνυστά περ ἀντιόωσαν.’	- uu---u u-u u -uu--	dactylic hexameter	feminine penthemimeral
φῆ ἄρα· Χαλκιόπη δʼ ἠμείβετο τοῖσδʼ ἐπέεσσιν·	- uu -uu- --uu - uu--	dactylic hexameter	masculine penthemimeral
‘οὐκ ἂν δὴ ξείνῳ τλαίης χατέοντι καὶ αὐτῷ	- - - -- -- uu-u u --	dactylic hexameter	masculine penthemimeral, hepthemimeral, trithemimeral
ἢ δόλον, ἤ τινα μῆτιν ἐπιφράσσασθαι ἀέθλου,	- uu - uu -u u---u u--	dactylic hexameter	feminine penthemimeral, trithemimeral
παίδων εἵνεκʼ ἐμεῖο; καὶ ἐκ κείνοιο δʼ ἱκάνει	-- -u u-u u - --u u--	dactylic hexameter	feminine penthemimeral, hepthemimeral
Ἄργος, ἐποτρύνων με τεῆς πειρῆσαι ἀρωγῆς·	-u u--- u u- --u u--	dactylic hexameter	masculine penthemimeral, hepthemimeral
μεσσηγὺς μὲν τόνγε δόμῳ λίπον ἐνθάδʼ ἰοῦσα.’	--- - -u u- uu -u u--	dactylic hexameter	feminine penthemimeral, hepthemimeral, trithemimeral
ὧς φάτο· τῇ δʼ ἔντοσθεν ἀνέπτατο χάρματι θυμός,	- uu - --u u-uu -uu --	dactylic hexameter	feminine penthemimeral, trithemimeral
φοινίχθη δʼ ἄμυδις καλὸν χρόα, κὰδ δέ μιν ἀχλὺς	--- uu- -- uu - u u --	dactylic hexameter	masculine penthemimeral, hepthemimeral, trithemimeral
εἷλεν ἰαινομένην, τοῖον δʼ ἐπὶ μῦθον ἔειπεν·	-u u-uu- -- uu -u u--	dactylic hexameter	masculine penthemimeral, hepthemimeral
‘Χαλκιόπη, ὡς ὔμμι φίλον τερπνόν τε τέτυκται,	-uu- - -u u- -- u u--	dactylic hexameter	feminine penthemimeral, hepthemimeral, trithemimeral
ὧς ἔρξω. μὴ γάρ μοι ἐν ὀφθαλμοῖσι φαείνοι	- -- - - u u ---u u--	dactylic hexameter	masculine penthemimeral, trithemimeral
ἠώς, μηδέ με δηρὸν ἔτι ζώουσαν ἴδοιο,	-- -u u -u u- --u u--	dactylic hexameter	feminine penthemimeral, hepthemimeral
εἴ γέ τι σῆς ψυχῆς προφερέστερον, ἠέ τι παίδων	- u u - -- uu-uu -u u --	dactylic hexameter	masculine penthemimeral, trithemimeral
σῶν θείην, οἳ δή μοι ἀδελφειοὶ γεγάασιν,	- -- - - u u--- uu--	dactylic hexameter	masculine penthemimeral, trithemimeral
κηδεμόνες τε φίλοι καὶ ὁμήλικες. ὧς δὲ καὶ αὐτὴ	-uu- u u- u u-uu - u u --	dactylic hexameter	masculine penthemimeral, trithemimeral
φημὶ κασιγνήτη τε σέθεν κούρη τε πέλεσθαι,	-u u--- u u- -- u u--	dactylic hexameter	masculine penthemimeral, hepthemimeral
ἶσον ἐπεὶ κείνοις με τεῷ ἐπαείραο μαζῷ	-u u- -- u u- uu-uu --	dactylic hexameter	masculine penthemimeral, hepthemimeral, trithemimeral
νηπυτίην, ὡς αἰὲν ἐγώ ποτε μητρὸς ἄκουον.	-uu- - -u u- uu -u u--	dactylic hexameter	feminine penthemimeral, hepthemimeral, trithemimeral
ἀλλʼ ἴθι, κεῦθε δʼ ἐμὴν σιγῇ χάριν, ὄφρα τοκῆας	- uu -u u- -- uu -u u--	dactylic hexameter	masculine penthemimeral, hepthemimeral
λήσομαι ἐντύνουσα ὑπόσχεσιν· ἦρι δὲ νηὸν	-uu ---u u-uu -u u --	dactylic hexameter	feminine penthemimeral
οἴσομαι εἰς Ἑκάτης θελκτήρια φάρμακα ταύρων.’	-uu - uu- --uu -uu --	dactylic hexameter	masculine penthemimeral, trithemimeral
ὧς ἥγʼ ἐκ θαλάμοιο πάλιν κίε, παισί τʼ ἀρωγὴν	- - - uu-u u- uu -u u--	dactylic hexameter	feminine penthemimeral, hepthemimeral, trithemimeral
αὐτοκασιγνήτης διεπέφραδε. τὴν δέ μιν αὖτις	-uu--- uu-uu - u u --	dactylic hexameter	masculine penthemimeral
αἰδώς τε στυγερόν τε δέος λάβε μουνωθεῖσαν,	-- - uu- u u- uu ----	dactylic hexameter	masculine penthemimeral, hepthemimeral, trithemimeral
τοῖα παρὲξ οὗ πατρὸς ἐπʼ ἀνέρι μητιάασθαι.	-u u- - -u u -uu -uu--	dactylic hexameter	feminine penthemimeral, trithemimeral
νὺξ μὲν ἔπειτʼ ἐπὶ γαῖαν ἄγεν κνέφας· οἱ δʼ ἐνὶ πόντῳ	- u u- uu -u u- uu - uu --	dactylic hexameter	feminine penthemimeral, hepthemimeral, trithemimeral
ναῦται εἰς Ἑλίκην τε καὶ ἀστέρας Ὠρίωνος	-- - uu- u u -uu ----	dactylic hexameter	masculine penthemimeral, trithemimeral
ἔδρακον ἐκ νηῶν· ὕπνοιο δὲ καί τις ὁδίτης	-uu - -- --u u - u u--	dactylic hexameter	masculine penthemimeral, trithemimeral
ἤδη καὶ πυλαωρὸς ἐέλδετο· καί τινα παίδων	-- - uu-u u-uu - uu --	dactylic hexameter	feminine penthemimeral, trithemimeral
μητέρα τεθνεώτων ἀδινὸν περὶ κῶμʼ ἐκάλυπτεν·	-uu --- uu- uu - uu--	dactylic hexameter	masculine penthemimeral, hepthemimeral
οὐδὲ κυνῶν ὑλακὴ ἔτʼ ἀνὰ πτόλιν, οὐ θρόος ἦεν	-u u- uu- u u- uu - uu --	dactylic hexameter	masculine penthemimeral, hepthemimeral, trithemimeral
ἠχήεις· σιγὴ δὲ μελαινομένην ἔχεν ὄρφνην.	--- -- u u-uu- uu --	dactylic hexameter	masculine penthemimeral, trithemimeral
ἀλλὰ μάλʼ οὐ Μήδειαν ἐπὶ γλυκερὸς λάβεν ὕπνος.	-u u - --u u- uu- uu --	dactylic hexameter	feminine penthemimeral, hepthemimeral, trithemimeral
πολλὰ γὰρ Αἰσονίδαο πόθῳ μελεδήματʼ ἔγειρεν	-u u -uu-u u- uu-u u--	dactylic hexameter	feminine penthemimeral, hepthemimeral
δειδυῖαν ταύρων κρατερὸν μένος, οἷσιν ἔμελλεν	--- -- uu- uu -u u--	dactylic hexameter	masculine penthemimeral, hepthemimeral, trithemimeral
φθίσθαι ἀεικελίῃ μοίρῃ κατὰ νειὸν Ἄρηος.	-u u-uu- -- uu -u u--	dactylic hexameter	masculine penthemimeral, hepthemimeral
πυκνὰ δέ οἱ κραδίη στηθέων ἔντοσθεν ἔθυιεν,	-u u - uu- -- --- ---	lyric	
ἠελίου ὥς τίς τε δόμοις ἐνιπάλλεται αἴγλη	-uu- - - u u- uu-uu --	dactylic hexameter	masculine penthemimeral, hepthemimeral, trithemimeral
ὕδατος ἐξανιοῦσα, τὸ δὴ νέον ἠὲ λέβητι	-uu -uu-u u - uu -u u--	dactylic hexameter	feminine penthemimeral, hepthemimeral
ἠέ που ἐν γαυλῷ κέχυται· ἡ δʼ ἔνθα καὶ ἔνθα	-u u - -- uu- - -u u --	dactylic hexameter	masculine penthemimeral, hepthemimeral, trithemimeral
ὠκείῃ στροφάλιγγι τινάσσεται ἀίσσουσα·	--- uu-u u-uu ----	dactylic hexameter	feminine penthemimeral, trithemimeral
ὧς δὲ καὶ ἐν στήθεσσι κέαρ ἐλελίζετο κούρης.	- u u - --u u- uu-uu --	dactylic hexameter	feminine penthemimeral, hepthemimeral, trithemimeral
δάκρυ δʼ ἀπʼ ὀφθαλμῶν ἐλέῳ ῥέεν· ἔνδοθι δʼ αἰεὶ	-u u --- uu- uu -uu --	dactylic hexameter	masculine penthemimeral, hepthemimeral
τεῖρʼ ὀδύνη σμύχουσα διὰ χροός, ἀμφί τʼ ἀραιὰς	- uu- --u u- uu -u u--	dactylic hexameter	feminine penthemimeral, hepthemimeral, trithemimeral
ἶνας καὶ κεφαλῆς ὑπὸ νείατον ἰνίον ἄχρις,	-- - uu- uu -uu -uu --	dactylic hexameter	masculine penthemimeral, trithemimeral
ἔνθʼ ἀλεγεινότατον δύνει ἄχος, ὁππότʼ ἀνίας	- uu-uu- uu -- -u u--	dactylic hexameter	masculine penthemimeral
ἀκάματοι πραπίδεσσιν ἐνισκίμψωσιν Ἔρωτες.	-uu- uu-u u---u u--	dactylic hexameter	feminine penthemimeral, trithemimeral
φῆ δέ οἱ ἄλλοτε μὲν θελκτήρια φάρμακα ταύρων	- u u -uu - --uu -uu --	dactylic hexameter	masculine penthemimeral
δωσέμεν, ἄλλοτε δʼ οὔτι· καταφθίσθαι δὲ καὶ αὐτή·	-uu -uu -u u--- u u --	dactylic hexameter	feminine penthemimeral
αὐτίκα δʼ οὔτʼ αὐτὴ θανέειν, οὐ φάρμακα δώσειν,	-uu - -- uu- - -uu --	dactylic hexameter	masculine penthemimeral, hepthemimeral, trithemimeral
ἀλλʼ αὔτως εὔκηλος ἑὴν ὀτλησέμεν ἄτην.	- -- --u u- --uu --	dactylic hexameter	feminine penthemimeral, hepthemimeral, trithemimeral
ἑζομένη δἤπειτα δοάσσατο, φώνησέν τε·	-uu- --u u-uu --- -	dactylic hexameter	feminine penthemimeral, trithemimeral
‘δειλὴ ἐγώ, νῦν ἔνθα κακῶν ἢ ἔνθα γένωμαι;	-u u- - -u u- - -u u--	dactylic hexameter	feminine penthemimeral, hepthemimeral, trithemimeral
πάντῃ μοι φρένες εἰσὶν ἀμήχανοι· οὐδέ τις ἀλκὴ	-- - uu -u u-uu -u u --	dactylic hexameter	feminine penthemimeral, trithemimeral
πήματος· ἀλλʼ αὔτως φλέγει ἔμπεδον. ὡς ὄφελόν γε	-uu - -- uu -uu - uu- -	dactylic hexameter	masculine penthemimeral, trithemimeral
Ἀρτέμιδος κραιπνοῖσι πάρος βελέεσσι δαμῆναι,	-uu- --u u- uu-u u--	dactylic hexameter	feminine penthemimeral, hepthemimeral, trithemimeral
πρὶν τόν γʼ εἰσιδέειν, πρὶν Ἀχαιίδα γαῖαν ἱκέσθαι	- - -uu- u u-uu -u u--	dactylic hexameter	masculine penthemimeral
Χαλκιόπης υἷας. τοὺς μὲν θεὸς ἤ τις Ἐρινὺς	-uu- -- - - uu - u u--	dactylic hexameter	masculine penthemimeral, hepthemimeral, trithemimeral
ἄμμι πολυκλαύτους δεῦρʼ ἤγαγε κεῖθεν ἀνίας.	-u u--- - -uu -u u--	dactylic hexameter	masculine penthemimeral
φθίσθω ἀεθλεύων, εἴ οἱ κατὰ νειὸν ὀλέσθαι	-u u--- - - uu -u u--	dactylic hexameter	masculine penthemimeral, hepthemimeral
μοῖρα πέλει. πῶς γάρ κεν ἐμοὺς λελάθοιμι τοκῆας	-u u- - - u u- uu-u u--	dactylic hexameter	masculine penthemimeral, hepthemimeral, trithemimeral
φάρμακα μησαμένη; ποῖον δʼ ἐπὶ μῦθον ἐνίψω;	-uu -uu- -- uu -u u--	dactylic hexameter	masculine penthemimeral, hepthemimeral
τίς δὲ δόλος, τίς μῆτις ἐπίκλοπος ἔσσετʼ ἀρωγῆς;	- u u- - -u u-uu -u u--	dactylic hexameter	feminine penthemimeral, trithemimeral
ἦ μιν ἄνευθʼ ἑτάρων προσπτύξομαι οἶον ἰδοῦσα;	- u u- uu- --uu -u u--	dactylic hexameter	masculine penthemimeral, trithemimeral
δύσμορος· οὐ μὲν ἔολπα καταφθιμένοιό περ ἔμπης	-uu - u u-u u-uu-u u --	dactylic hexameter	feminine penthemimeral, trithemimeral
λωφήσειν ἀχέων· τότε δʼ ἂν κακὸν ἄμμι πέλοιτο,	--- uu- uu - uu -u u--	dactylic hexameter	masculine penthemimeral, hepthemimeral, trithemimeral
κεῖνος ὅτε ζωῆς ἀπαμείρεται. ἐρρέτω αἰδώς,	-u u- -- uu-uu -uu --	dactylic hexameter	masculine penthemimeral, trithemimeral
ἐρρέτω ἀγλαΐη· ὁ δʼ ἐμῇ ἰότητι σαωθεὶς	-uu -uu- u u- uu-u u--	dactylic hexameter	masculine penthemimeral, hepthemimeral
ἀσκηθής, ἵνα οἱ θυμῷ φίλον, ἔνθα νέοιτο.	--- uu - -- uu -u u--	dactylic hexameter	masculine penthemimeral, hepthemimeral, trithemimeral
αὐτὰρ ἐγὼν αὐτῆμαρ, ὅτʼ ἐξανύσειεν ἄεθλον,	-u u- --u u -uu-u u--	dactylic hexameter	feminine penthemimeral, trithemimeral
τεθναίην, ἢ λαιμὸν ἀναρτήσασα μελάθρῳ,	--- - -u u---u u--	dactylic hexameter	feminine penthemimeral, trithemimeral
ἢ καὶ πασσαμένη ῥαιστήρια φάρμακα θυμοῦ.	- - -uu- --uu -uu --	dactylic hexameter	masculine penthemimeral
ἀλλὰ καὶ ὧς φθιμένῃ μοι ἐπιλλίξουσιν ὀπίσσω	-u u - uu- u u---u u--	dactylic hexameter	masculine penthemimeral, trithemimeral
κερτομίας· τηλοῦ δὲ πόλις περὶ πᾶσα βοήσει	-uu- -- u u- uu -u u--	dactylic hexameter	masculine penthemimeral, hepthemimeral, trithemimeral
πότμον ἐμόν· καί κέν με διὰ στόματος φορέουσαι	-u u- - - u u- uu- uu--	dactylic hexameter	masculine penthemimeral, hepthemimeral, trithemimeral
Κολχίδες ἄλλυδις ἄλλαι ἀεικέα μωμήσονται·	-uu -uu -u u-uu ----	dactylic hexameter	feminine penthemimeral
ἥτις κηδομένη τόσον ἀνέρος ἀλλοδαποῖο	-- -uu- uu -uu -uu--	dactylic hexameter	masculine penthemimeral
κάτθανεν, ἥτις δῶμα καὶ οὓς ᾔσχυνε τοκῆας,	-uu -- -u u - --u u--	dactylic hexameter	feminine penthemimeral, hepthemimeral
μαργοσύνῃ εἴξασα. τί δʼ οὐκ ἐμὸν ἔσσεται αἶσχος;	-uu- --u u - uu -uu --	dactylic hexameter	feminine penthemimeral, hepthemimeral, trithemimeral
ᾤ μοι ἐμῆς ἄτης. ἦ τʼ ἂν πολὺ κέρδιον εἴη	- u u- -- - - uu -uu --	dactylic hexameter	masculine penthemimeral, hepthemimeral, trithemimeral
τῇδʼ αὐτῇ ἐν νυκτὶ λιπεῖν βίον ἐν θαλάμοισιν	- -- - -u u- uu - uu--	dactylic hexameter	feminine penthemimeral, hepthemimeral, trithemimeral
πότμῳ ἀνωίστῳ, κάκʼ ἐλέγχεα πάντα φυγοῦσαν,	-u u--- u u-uu -u u--	dactylic hexameter	masculine penthemimeral
πρὶν τάδε λωβήεντα καὶ οὐκ ὀνομαστὰ τελέσσαι.’	- uu ---u u - uu-u u--	dactylic hexameter	feminine penthemimeral, hepthemimeral
ἦ, καὶ φωριαμὸν μετεκίαθεν, ᾗ ἔνι πολλὰ	- - -uu- uu-uu - uu --	dactylic hexameter	masculine penthemimeral
φάρμακά οἱ, τὰ μὲν ἐσθλά, τὰ δὲ ῥαιστήριʼ, ἔκειτο.	-uu - u u -u u - --u u--	dactylic hexameter	feminine penthemimeral, hepthemimeral, trithemimeral
ἐνθεμένη δʼ ἐπὶ γούνατʼ ὀδύρετο. δεῦε δὲ κόλπους	-uu- uu -u u-uu -u u --	dactylic hexameter	feminine penthemimeral, trithemimeral
ἄλληκτον δακρύοισι, τὰ δʼ ἔρρεεν ἀσταγὲς αὔτως,	--- uu-u u -uu -uu --	dactylic hexameter	feminine penthemimeral, trithemimeral
αἴνʼ ὀλοφυρομένης τὸν ἑὸν μόρον. ἵετο δʼ ἥγε	- uu-uu- u u- uu -uu --	dactylic hexameter	masculine penthemimeral, hepthemimeral
φάρμακα λέξασθαι θυμοφθόρα, τόφρα πάσαιτο.	-uu --- --uu -u u--	dactylic hexameter	masculine penthemimeral
ἤδη καὶ δεσμοὺς ἀνελύετο φωριαμοῖο,	-- - -- uu-uu -uu--	dactylic hexameter	masculine penthemimeral, trithemimeral
ἐξελέειν μεμαυῖα, δυσάμμορος. ἀλλά οἱ ἄφνω	-uu- uu-u u-uu -u u --	dactylic hexameter	feminine penthemimeral, trithemimeral
δεῖμʼ ὀλοὸν στυγεροῖο κατὰ φρένας ἦλθʼ Ἀίδαο.	- uu- uu-u u- uu - uu--	dactylic hexameter	feminine penthemimeral, hepthemimeral, trithemimeral
ἔσχετο δʼ ἀμφασίῃ δηρὸν χρόνον, ἀμφὶ δὲ πᾶσαι	-uu -uu- -- uu -u u --	dactylic hexameter	masculine penthemimeral, hepthemimeral
θυμηδεῖς βιότοιο μεληδόνες ἰνδάλλοντο.	--- uu-u u-uu ----	dactylic hexameter	feminine penthemimeral, trithemimeral
μνήσατο μὲν τερπνῶν, ὅσʼ ἐνὶ ζωοῖσι πέλονται,	-uu - -- u u- --u u--	dactylic hexameter	masculine penthemimeral, hepthemimeral, trithemimeral
μνήσαθʼ ὁμηλικίης περιγηθέος, οἷά τε κούρη·	-u u-uu- uu-uu -u u --	dactylic hexameter	masculine penthemimeral
καί τέ οἱ ἠέλιος γλυκίων γένετʼ εἰσοράασθαι,	- u u -uu- uu- uu -uu--	dactylic hexameter	masculine penthemimeral, hepthemimeral
ἢ πάρος, εἰ ἐτεόν γε νόῳ ἐπεμαίεθʼ ἕκαστα.	- uu - uu- u u- uu-u u--	dactylic hexameter	masculine penthemimeral, hepthemimeral, trithemimeral
καὶ τὴν μέν ῥα πάλιν σφετέρων ἀποκάτθετο γούνων,	- - - u u- uu- uu-uu --	dactylic hexameter	masculine penthemimeral, hepthemimeral, trithemimeral
Ἥρης ἐννεσίῃσι μετάτροπος, οὐδʼ ἔτι βουλὰς	-- -uu-u u-uu - uu --	dactylic hexameter	feminine penthemimeral
ἄλλῃ δοιάζεσκεν· ἐέλδετο δʼ αἶψα φανῆναι	-- ---u u-uu -u u--	dactylic hexameter	feminine penthemimeral
ἠῶ τελλομένην, ἵνα οἱ θελκτήρια δοίη	-- -uu- uu - --uu --	dactylic hexameter	masculine penthemimeral, hepthemimeral
φάρμακα συνθεσίῃσι, καὶ ἀντήσειεν ἐς ὠπήν.	-uu -uu-u u ---u u --	dactylic hexameter	feminine penthemimeral
πυκνὰ δʼ ἀνὰ κληῖδας ἑῶυ λύεσκε θυράων,	-u u- --u u-u u-u u--	dactylic hexameter	feminine penthemimeral, trithemimeral
αἴγλην σκεπτομένη· τῇ δʼ ἀσπάσιον βάλε φέγγος	-- -uu- - -uu- uu --	dactylic hexameter	masculine penthemimeral
Ἠριγενής, κίνυντο δʼ ἀνὰ πτολίεθρον ἕκαστοι.	-uu- --u u- uu-u u--	dactylic hexameter	feminine penthemimeral, hepthemimeral, trithemimeral
ἔνθα κασιγνήτους μὲν ἔτʼ αὐτόθι μεῖναι ἀνώγει	-u u--- u u -uu -u u--	dactylic hexameter	masculine penthemimeral
Ἄργος, ἵνα φράζοιντο νόον καὶ μήδεα κούρης·	-u u- --u u- - -uu --	dactylic hexameter	feminine penthemimeral, hepthemimeral, trithemimeral
αὐτὸς δʼ αὖτʼ ἐπὶ νῆα κίεν προπάροιθε λιασθείς.	-- - uu -u u- uu-u u--	dactylic hexameter	feminine penthemimeral, hepthemimeral, trithemimeral
ἡ δʼ ἐπεὶ οὖν τὰ πρῶτα φαεινομένην ἴδεν ἠῶ	- uu - - -u u-uu- uu --	dactylic hexameter	feminine penthemimeral, trithemimeral
παρθενική, ξανθὰς μὲν ἀνήψατο χερσὶν ἐθείρας,	-uu- -- u u-uu -u u--	dactylic hexameter	masculine penthemimeral, trithemimeral
αἵ οἱ ἀτημελίῃ καταειμέναι ἠερέθοντο,	- u u-uu- uu-uu -uu--	dactylic hexameter	masculine penthemimeral
αὐσταλέας δʼ ἔψησε παρηίδας· αὐτὰρ ἀλοιφῇ	-uu- --u u-uu -u u--	dactylic hexameter	feminine penthemimeral, trithemimeral
νεκταρέῃ φαιδρύνετʼ ἐπὶ χρόα· δῦνε δὲ πέπλον	-uu- --u u- uu -u u --	dactylic hexameter	feminine penthemimeral, hepthemimeral, trithemimeral
καλόν, ἐυγνάμπτοισιν ἀρηρέμενον περόνῃσιν·	-u u---u u-uu- uu--	dactylic hexameter	feminine penthemimeral
ἀμβροσίῳ δʼ ἐφύπερθε καρήατι βάλλε καλύπτρην	-uu- uu-u u-uu -u u--	dactylic hexameter	feminine penthemimeral, trithemimeral
ἀργυφέην. αὐτοῦ δὲ δόμοις ἔνι δινεύουσα	-uu- -- u u- uu ----	dactylic hexameter	masculine penthemimeral, hepthemimeral, trithemimeral
στεῖβε πέδον λήθῃ ἀχέων, τά οἱ ἐν ποσὶν ἦεν	-u u- -- uu- u u - uu --	dactylic hexameter	masculine penthemimeral, hepthemimeral, trithemimeral
θεσπέσιʼ, ἄλλα τʼ ἔμελλεν ἀεξήσεσθαι ὀπίσσω.	-uu -u u-u u---u u--	dactylic hexameter	feminine penthemimeral
κέκλετο δʼ ἀμφιπόλοις, αἵ οἱ δυοκαίδεκα πᾶσαι	-uu -uu- - - uu-uu --	dactylic hexameter	masculine penthemimeral, hepthemimeral
ἐν προδόμῳ θαλάμοιο θυώδεος ηὐλίζοντο	- uu- uu-u u-uu ----	dactylic hexameter	feminine penthemimeral, trithemimeral
ἥλικες, οὔπω λέκτρα σὺν ἀνδράσι πορσύνουσαι,	-uu -- -u u -uu ----	dactylic hexameter	feminine penthemimeral
ἐσσυμένως οὐρῆας ὑποζεύξασθαι ἀπήνῃ,	-uu- --u u---u u--	dactylic hexameter	feminine penthemimeral, trithemimeral
οἵ κέ μιν εἰς Ἑκάτης περικαλλέα νηὸν ἄγοιεν.	- u u - uu- uu-uu -u u--	dactylic hexameter	masculine penthemimeral, trithemimeral
ἔνθʼ αὖτʼ ἀμφίπολοι μὲν ἐφοπλίζεσκον ἀπήνην·	- - -uu- u u---u u--	dactylic hexameter	masculine penthemimeral
ἡ δὲ τέως γλαφυρῆς ἐξείλετο φωριαμοῖο	- u u- uu- --uu -uu--	dactylic hexameter	masculine penthemimeral, trithemimeral
φάρμακον, ὅ ῥά τέ φασι Προμήθειον καλέεσθαι.	-uu - u u -u u--- uu--	dactylic hexameter	feminine penthemimeral, trithemimeral
τῷ εἴ κʼ ἐννυχίοισιν ἀρεσσάμενος θυέεσσιν	- - -uu-u u-uu- uu--	dactylic hexameter	feminine penthemimeral
κούρην μουνογένειαν ἑὸν δέμας ἰκμαίνοιτο,	-- -uu-u u- uu ----	dactylic hexameter	feminine penthemimeral, hepthemimeral
ἦ τʼ ἂν ὅ γʼ οὔτε ῥηκτὸς ἔοι χαλκοῖο τυπῇσιν,	- u u -- -u u- --u u--	dactylic hexameter	feminine penthemimeral, hepthemimeral
οὔτε κεν αἰθομένῳ πυρὶ εἰκάθοι· ἀλλὰ καὶ ἀλκῇ	-u u -uu- uu -uu -u u --	dactylic hexameter	masculine penthemimeral
λωίτερος κεῖνʼ ἦμαρ ὁμῶς κάρτει τε πέλοιτο.	-uu- - -u u- -- u u--	dactylic hexameter	feminine penthemimeral, hepthemimeral, trithemimeral
πρωτοφυὲς τό γʼ ἀνέσχε καταστάξαντος ἔραζε	-uu- u u-u u---u u--	dactylic hexameter	feminine penthemimeral, trithemimeral
αἰετοῦ ὠμηστέω κνημοῖς ἔνι Καυκασίοισιν	-uu --- -- uu -uu--	dactylic hexameter	masculine penthemimeral, hepthemimeral
αἱματόεντʼ ἰχῶρα Προμηθῆος μογεροῖο.	-uu- --u u--- uu--	dactylic hexameter	feminine penthemimeral, trithemimeral
τοῦ δʼ ἤτοι ἄνθος μὲν ὅσον πήχυιον ὕπερθεν	- -- -- u u- --u u--	dactylic hexameter	masculine penthemimeral, hepthemimeral, trithemimeral
χροιῇ Κωρυκίῳ ἴκελον κρόκῳ ἐξεφαάνθη,	-- -uu- uu- uu -uu--	dactylic hexameter	masculine penthemimeral, hepthemimeral
καυλοῖσιν διδύμοισιν ἐπήορον· ἡ δʼ ἐνὶ γαίῃ	--- uu-u u-uu - uu --	dactylic hexameter	feminine penthemimeral, trithemimeral
σαρκὶ νεοτμήτῳ ἐναλιγκίη ἔπλετο ῥίζα.	-u u--- uu-uu -uu --	dactylic hexameter	masculine penthemimeral
τῆς οἵην τʼ ἐν ὄρεσσι κελαινὴν ἰκμάδα φηγοῦ	- -- u u-u u-- -uu --	dactylic hexameter	feminine penthemimeral, trithemimeral
Κασπίῃ ἐν κόχλῳ ἀμήσατο φαρμάσσεσθαι,	-uu - -- --uu ----	dactylic hexameter	masculine penthemimeral, trithemimeral
ἑπτὰ μὲν ἀενάοισι λοεσσαμένη ὑδάτεσσιν,	-u u -uu-u u-uu- uu--	dactylic hexameter	feminine penthemimeral
ἑπτάκι δὲ Βριμὼ κουροτρόφον ἀγκαλέσασα,	-uu - -- --uu -uu--	dactylic hexameter	masculine penthemimeral, trithemimeral
Βριμὼ νυκτιπόλον, χθονίην, ἐνέροισιν ἄνασσαν,	-- -uu- uu- uu-u u--	dactylic hexameter	masculine penthemimeral, hepthemimeral
λυγαίῃ ἐνὶ νυκτί, σὺν ὀρφναίοις φαρέεσσιν.	--- uu -u u --- uu--	dactylic hexameter	feminine penthemimeral, trithemimeral
μυκηθμῷ δʼ ὑπένερθεν ἐρεμνὴ σείετο γαῖα,	--- uu-u u-- -uu --	dactylic hexameter	feminine penthemimeral, trithemimeral
ῥίζης τεμνομένης Τιτηνίδος· ἔστενε δʼ αὐτὸς	-- -uu- --uu -uu --	dactylic hexameter	masculine penthemimeral
Ἰαπετοῖο πάις ὀδύνῃ πέρι θυμὸν ἀλύων.	-uu-u u- uu- uu -u u--	dactylic hexameter	masculine penthemimeral, hepthemimeral
τό ῥʼ ἥγʼ ἐξανελοῦσα θυώδεϊ κάτθετο μίτρῃ,	- - -uu-u u-uu -uu --	dactylic hexameter	feminine penthemimeral
ἥ τέ οἱ ἀμβροσίοισι περὶ στήθεσσιν ἔερτο.	- u u -uu-u u- --u u--	dactylic hexameter	feminine penthemimeral, hepthemimeral
ἐκ δὲ θύραζε κιοῦσα θοῆς ἐπεβήσατʼ ἀπήνης·	- u u-u u-u u- uu-u u--	dactylic hexameter	feminine penthemimeral, hepthemimeral
σὺν δέ οἱ ἀμφίπολοι δοιαὶ ἑκάτερθεν ἔβησαν.	- u u -uu- -- uu-u u--	dactylic hexameter	masculine penthemimeral, hepthemimeral
αὐτὴ δʼ ἡνίʼ ἔδεκτο καὶ εὐποίητον ἱμάσθλην	-- -u u-u u ---u u--	dactylic hexameter	feminine penthemimeral
δεξιτερῇ, ἔλαεν δὲ διʼ ἄστεος· αἱ δὲ δὴ ἄλλαι	-uu- uu- u u -uu - u u --	dactylic hexameter	masculine penthemimeral, trithemimeral
ἀμφίπολοι, πείρινθος ἐφαπτόμεναι μετόπισθεν,	-uu- --u u-uu- uu--	dactylic hexameter	feminine penthemimeral, trithemimeral
τρώχων εὐρεῖαν κατʼ ἀμαξιτόν· ἂν δὲ χιτῶνας	-- --- u u-uu - u u--	dactylic hexameter	masculine penthemimeral
λεπταλέους λευκῆς ἐπιγουνίδος ἄχρις ἄειρον.	-uu- -- uu-uu -u u--	dactylic hexameter	masculine penthemimeral, trithemimeral
οἵη δὲ λιαροῖσιν ἐφʼ ὕδασι Παρθενίοιο,	-- - uu-u u -uu -uu--	dactylic hexameter	feminine penthemimeral, trithemimeral
ἠὲ καὶ Ἀμνισοῖο λοεσσαμένη ποταμοῖο	-u u ---u u-uu- uu--	dactylic hexameter	feminine penthemimeral
χρυσείοις Λητωὶς ἐφʼ ἅρμασιν ἑστηκυῖα	--- --u u -uu ----	dactylic hexameter	feminine penthemimeral, trithemimeral
ὠκείαις κεμάδεσσι διεξελάσῃσι κολώνας,	--- uu-u u-uu-u u--	dactylic hexameter	feminine penthemimeral, trithemimeral
τηλόθεν ἀντιόωσα πολυκνίσου ἑκατόμβης·	-uu -uu-u u-uu ----	dactylic hexameter	feminine penthemimeral
τῇ δʼ ἅμα νύμφαι ἕπονται ἀμορβάδες, αἱ μὲν ἐπʼ αὐτῆς	- uu -u u-u u-uu - u u --	dactylic hexameter	feminine penthemimeral
ἀγρόμεναι πηγῆς Ἀμνισίδος, ἂν δὲ δὴ ἄλλαι	-uu- -- --uu - u u --	dactylic hexameter	masculine penthemimeral, trithemimeral
ἄλσεα καὶ σκοπιὰς πολυπίδακας· ἀμφὶ δὲ θῆρες	-uu - uu- uu-uu -u u --	dactylic hexameter	masculine penthemimeral, trithemimeral
κνυζηθμῷ σαίνουσιν ὑποτρομέοντες ἰοῦσαν·	--- --u u-uu-u u--	dactylic hexameter	feminine penthemimeral, trithemimeral
ὧς αἵ γʼ ἐσσεύοντο διʼ ἄστεος· ἀμφὶ δὲ λαοὶ	- - ---u u -uu -u u --	dactylic hexameter	feminine penthemimeral
εἶκον, ἀλευάμενοι βασιληίδος ὄμματα κούρης.	-u u-uu- uu-uu -uu --	dactylic hexameter	masculine penthemimeral
αὐτὰρ ἐπεὶ πόλιος μὲν ἐυδμήτους λίπʼ ἀγυιάς,	-u u- uu- u u--- u u--	dactylic hexameter	masculine penthemimeral, trithemimeral
νηὸν δʼ εἰσαφίκανε διὲκ πεδίων ἐλάουσα,	-- -uu-u u- uu- uu--	dactylic hexameter	feminine penthemimeral, hepthemimeral
δὴ τότʼ ἐυτροχάλοιο κατʼ αὐτόθι βήσατʼ ἀπήνης	- u u-uu-u u -uu -u u--	dactylic hexameter	feminine penthemimeral
ἱεμένη, καὶ τοῖα μετὰ δμωῇσιν ἔειπεν·	-uu- - -u u- --u u--	dactylic hexameter	feminine penthemimeral, hepthemimeral, trithemimeral
‘ὦ φίλαι, ἦ μέγα δή τι παρήλιτον, οὐδʼ ἐνόησα	- uu - uu - u u-uu - uu--	dactylic hexameter	masculine penthemimeral, trithemimeral
μὴ ἴμεν ἀλλοδαποῖσι μετʼ ἀνδράσιν, οἵ τʼ ἐπὶ γαῖαν	- uu -uu-u u -uu - uu --	dactylic hexameter	feminine penthemimeral
ἡμετέρην στρωφῶσιν. ἀμηχανίῃ βεβόληται	-uu- --u u-uu- uu--	dactylic hexameter	feminine penthemimeral, trithemimeral
πᾶσα πόλις· τὸ καὶ οὔτις ἀνήλυθε δεῦρο γυναικῶν	-u u- u u -u u-uu -u u--	dactylic hexameter	feminine penthemimeral, trithemimeral
τάων, αἳ τὸ πάροιθεν ἐπημάτιαι ἀγέρονται.	-- - u u-u u-uu- uu--	dactylic hexameter	feminine penthemimeral, trithemimeral
ἀλλʼ ἐπεὶ οὖν ἱκόμεσθα, καὶ οὔ νύ τις ἄλλος ἔπεισιν,	- uu - uu-u u - u u -u u--	dactylic hexameter	feminine penthemimeral, hepthemimeral, trithemimeral
εἰ δʼ ἄγε μολπῇ θυμὸν ἀφειδείως κορέσωμεν	- uu -- -u u--- uu--	dactylic hexameter	feminine penthemimeral
μειλιχίῃ, τὰ δὲ καλὰ τερείνης ἄνθεα ποίης	-uu- u u -u u-- -uu --	dactylic hexameter	feminine penthemimeral, trithemimeral
λεξάμεναι τότʼ ἔπειτʼ αὐτὴν ἀπονισσόμεθʼ ὥρην.	-uu- u u- -- uu-uu --	dactylic hexameter	masculine penthemimeral, hepthemimeral, trithemimeral
καὶ δέ κε σὺν πολέεσσιν ὀνείασιν οἴκαδʼ ἵκοισθε	- u u - uu-u u-uu -u u--	dactylic hexameter	feminine penthemimeral, trithemimeral
ἤματι τῷ, εἴ μοι συναρέσσετε τήνδε μενοινήν.	-uu - - - uu-uu -u u--	dactylic hexameter	masculine penthemimeral, trithemimeral
Ἄργος γάρ μ᾽ἐπέεσσι παρατρέπει, ὧς δὲ καὶ αὐτὴ	-- - uu-u u-uu - u u --	dactylic hexameter	feminine penthemimeral, trithemimeral
Χαλκιόπη· τὰ δὲ σῖγα νόῳ ἔχετʼ εἰσαΐουσαι	-uu- u u -u u- uu -uu--	dactylic hexameter	feminine penthemimeral, hepthemimeral, trithemimeral
ἐξ ἐμέθεν, μὴ πατρὸς ἐς οὔατα μῦθος ἵκηται.	- uu- - -u u -uu -u u--	dactylic hexameter	feminine penthemimeral, trithemimeral
τὸν ξεῖνόν με κέλονται, ὅτις περὶ βουσὶν ὑπέστη,	- -- u u-u u- uu -u u--	dactylic hexameter	feminine penthemimeral, hepthemimeral, trithemimeral
δῶρʼ ἀποδεξαμένην ὀλοῶν ῥύσασθαι ἀέθλων.	- uu-uu- uu- --u u--	dactylic hexameter	masculine penthemimeral, hepthemimeral
αὐτὰρ ἐγὼ τὸν μῦθον ἐπῄνεον, ἠδὲ καὶ αὐτὸν	-u u- - -u u-uu -u u --	dactylic hexameter	feminine penthemimeral, trithemimeral
κέκλομαι εἰς ὠπὴν ἑτάρων ἄπο μοῦνον ἱκέσθαι,	-uu - -- uu- uu -u u--	dactylic hexameter	masculine penthemimeral, hepthemimeral, trithemimeral
ὄφρα τὰ μὲν δασόμεσθα μετὰ σφίσιν, εἴ κεν ὀπάσσῃ	-u u - uu-u u- uu - u u--	dactylic hexameter	feminine penthemimeral, hepthemimeral, trithemimeral
δῶρα φέρων, τῷ δʼ αὖτε κακώτερον ἄλλο πόρωμεν	-u u- - -u u-uu -u u--	dactylic hexameter	feminine penthemimeral, trithemimeral
φάρμακον. ἀλλʼ ἀπονόσφι πέλεσθέ μοι, εὖτʼ ἂν ἵκηται.’	-uu - uu-u u-u u - u u--	dactylic hexameter	feminine penthemimeral, trithemimeral
ὧς ηὔδα· πάσῃσι δʼ ἐπίκλοπος ἥνδανε μῆτις.	- -- --u u-uu -uu --	dactylic hexameter	feminine penthemimeral, trithemimeral
αὐτίκα δʼ Αἰσονίδην ἑτάρων ἄπο μοῦνον ἐρύσσας	-uu -uu- uu- uu -u u--	dactylic hexameter	masculine penthemimeral, hepthemimeral
Ἄργος, ὅτʼ ἤδη τήνδε κασιγνήτων ἐσάκουσεν	-u u -- -u u--- uu--	dactylic hexameter	feminine penthemimeral
ἠερίην Ἑκάτης ἱερὸν μετὰ νηὸν ἰοῦσαν,	-uu- uu- uu- uu -u u--	dactylic hexameter	masculine penthemimeral, hepthemimeral, trithemimeral
ἦγε διὲκ πεδίου· ἅμα δέ σφισιν εἵπετο Μόψος	-u u- uu- uu - uu -uu --	dactylic hexameter	masculine penthemimeral, hepthemimeral, trithemimeral
Ἀμπυκίδης, ἐσθλὸς μὲν ἐπιπροφανέντας ἐνισπεῖν	-uu- -- u u-uu-u u--	dactylic hexameter	masculine penthemimeral, trithemimeral
οἰωνούς, ἐσθλὸς δὲ σὺν εὖ φράσσασθαι ἰοῦσιν.	--- -- u u - --u u--	dactylic hexameter	masculine penthemimeral, hepthemimeral, trithemimeral
ἔνθʼ οὔπω τις τοῖος ἐπὶ προτέρων γένετʼ ἀνδρῶν,	- -- - -u u- uu- uu --	dactylic hexameter	feminine penthemimeral, hepthemimeral, trithemimeral
οὔθʼ ὅσοι ἐξ αὐτοῖο Διὸς γένος, οὔθʼ ὅσοι ἄλλων	- uu - --u u- uu - uu --	dactylic hexameter	feminine penthemimeral, hepthemimeral, trithemimeral
ἀθανάτων ἥρωες ἀφʼ αἵματος ἐβλάστησαν,	-uu- --u u -uu ----	dactylic hexameter	feminine penthemimeral, trithemimeral
οἷον Ἰήσονα θῆκε Διὸς δάμαρ ἤματι κείνῳ	-u u-uu -u u- uu -uu --	dactylic hexameter	feminine penthemimeral, hepthemimeral
ἠμὲν ἐσάντα ἰδεῖν, ἠδὲ προτιμυθήσασθαι.	-u u-u u- -- uu----	dactylic hexameter	masculine penthemimeral, hepthemimeral
τὸν καὶ παπταίνοντες ἐθάμβεον αὐτοὶ ἑταῖροι	- - ---u u-uu -u u--	dactylic hexameter	feminine penthemimeral
λαμπόμενον χαρίτεσσιν· ἐγήθησεν δὲ κελεύθῳ	-uu- uu-u u--- u u--	dactylic hexameter	feminine penthemimeral, trithemimeral
Ἀμπυκίδης, ἤδη που ὀισσάμενος τὰ ἕκαστα.	-uu- -- u u-uu- u u--	dactylic hexameter	masculine penthemimeral, trithemimeral
ἔστι δέ τις πεδίοιο κατὰ στίβον ἐγγύθι νηοῦ	-u u - uu-u u- uu -uu --	dactylic hexameter	feminine penthemimeral, hepthemimeral, trithemimeral
αἴγειρος φύλλοισιν ἀπειρεσίοις κομόωσα,	--- --u u-uu- uu--	dactylic hexameter	feminine penthemimeral, trithemimeral
τῇ θαμὰ δὴ λακέρυζαι ἐπηυλίζοντο κορῶναι.	- uu - uu-u u---u u--	dactylic hexameter	feminine penthemimeral, trithemimeral
τάων τις μεσσηγὺς ἀνὰ πτερὰ κινήσασα	-- - --u u- uu ----	dactylic hexameter	feminine penthemimeral, hepthemimeral, trithemimeral
ὑψοῦ ἐπʼ ἀκρεμόνων Ἥρης ἠνίπαπε βουλάς·	-u u -uu- -- --uu --	dactylic hexameter	masculine penthemimeral, hepthemimeral
‘Ἀκλειὴς ὅδε μάντις, ὃς οὐδʼ ὅσα παῖδες ἴσασιν	--- uu -u u - uu -u u--	dactylic hexameter	feminine penthemimeral, hepthemimeral, trithemimeral
οἶδε νόῳ φράσσασθαι, ὁθούνεκεν οὔτε τι λαρὸν	-u u- --u u-uu -u u --	dactylic hexameter	feminine penthemimeral, trithemimeral
οὔτʼ ἐρατὸν κούρη κεν ἔπος προτιμυθήσαιτο	- uu- -- u u- uu----	dactylic hexameter	masculine penthemimeral, hepthemimeral, trithemimeral
ἠιθέῳ, εὖτʼ ἄν σφιν ἐπήλυδες ἄλλοι ἕπωνται.	-uu- - - u u-uu -u u--	dactylic hexameter	masculine penthemimeral, trithemimeral
ἔρροις, ὦ κακόμαντι, κακοφραδές· οὔτε σε Κύπρις,	-- - uu-u u-uu -u u --	dactylic hexameter	feminine penthemimeral, trithemimeral
οὔτʼ ἀγανοὶ φιλέοντες ἐπιπνείουσιν Ἔρωτες.’	- uu- uu-u u---u u--	dactylic hexameter	feminine penthemimeral, trithemimeral
Ἴσκεν ἀτεμβομένη· μείδησε δὲ Μόψος ἀκούσας	-u u-uu- --u u -u u--	dactylic hexameter	masculine penthemimeral
ὀμφὴν οἰωνοῖο θεήλατον, ὧδέ τʼ ἔειπεν·	-- ---u u-uu -u u--	dactylic hexameter	feminine penthemimeral
‘τύνη μὲν νηόνδε θεᾶς ἴθι, τῷ ἔνι κούρην	-- - --u u- uu - uu --	dactylic hexameter	feminine penthemimeral, hepthemimeral, trithemimeral
δήεις, Αἰσονίδη· μάλα δʼ ἠπίῃ ἀντιβολήσεις	-- -uu- uu -uu -uu--	dactylic hexameter	masculine penthemimeral
Κύπριδος ἐννεσίῃς, ἥ τοι συνέριθος ἀέθλων	-uu -uu- - - uu-u u--	dactylic hexameter	masculine penthemimeral, hepthemimeral
ἔσσεται, ὡς δὴ καὶ πρὶν Ἀγηνορίδης φάτο Φινεύς.	-uu - - - u u-uu- uu --	dactylic hexameter	masculine penthemimeral, trithemimeral
νῶι δʼ ,ἐγὼν Ἄργος τε, δεδεγμένοι, εὖτʼ ἂν ἵκηαι,	-u u- -- u u-uu - u u--	dactylic hexameter	masculine penthemimeral, trithemimeral
τῷδʼ αὐτῷ ἐνὶ χώρῳ ἀπεσσόμεθʼ· οἰόθι δʼ αὐτὸς	- -- uu -u u-uu -uu --	dactylic hexameter	feminine penthemimeral, trithemimeral
λίσσεό μιν πυκινοῖσι παρατροπέων ἐπέεσσιν.’	-uu - uu-u u-uu- uu--	dactylic hexameter	feminine penthemimeral, trithemimeral
ἦ ῥα περιφραδέως, ἐπὶ δὲ σχεδὸν ᾔνεον ἄμφω.	- u u-uu- uu - uu -uu --	dactylic hexameter	masculine penthemimeral, hepthemimeral
οὐδʼ ἄρα Μηδείης θυμὸς τράπετʼ ἄλλα νοῆσαι,	- uu --- -- uu -u u--	dactylic hexameter	masculine penthemimeral, hepthemimeral
μελπομένης περ ὅμως· πᾶσαι δέ οἱ, ἥντινʼ ἀθύροι	-uu- u u- -- u u -u u--	dactylic hexameter	masculine penthemimeral, hepthemimeral, trithemimeral
μολπήν, οὐκ ἐπὶ δηρὸν ἐφήνδανεν ἑψιάασθαι.	-- - uu -u u-uu -uu--	dactylic hexameter	feminine penthemimeral, trithemimeral
ἀλλὰ μεταλλήγεσκεν ἀμήχανος, οὐδέ ποτʼ ὄσσε	-u u---u u-uu -u u --	dactylic hexameter	feminine penthemimeral
ἀμφιπόλων μεθʼ ὅμιλον ἔχʼ ἀτρέμας· ἐς δὲ κελεύθους	-uu- u u-u u -uu - u u--	dactylic hexameter	feminine penthemimeral, trithemimeral
τηλόσε παπταίνεσκε, παρακλίνουσα παρειάς.	-uu ---u u---u u--	dactylic hexameter	feminine penthemimeral
ἦ θαμὰ δὴ στηθέων ἐάγη κέαρ, ὁππότε δοῦπον	- uu - -- uu- uu -uu --	dactylic hexameter	masculine penthemimeral, hepthemimeral, trithemimeral
ἢ ποδὸς ἢ ἀνέμοιο παραθρέξαντα δοάσσαι.	- uu - uu-u u---u u--	dactylic hexameter	feminine penthemimeral, trithemimeral
αὐτὰρ ὅ γʼ οὐ μετὰ δηρὸν ἐελδομένῃ ἐφαάνθη	-u u - uu -u u-uu- uu--	dactylic hexameter	feminine penthemimeral, trithemimeral
ὑψόσʼ ἀναθρώσκων ἅ τε Σείριος Ὠκεανοῖο,	-u u--- u u -uu -uu--	dactylic hexameter	masculine penthemimeral
ὃς δή τοι καλὸς μὲν ἀρίζηλός τʼ ἐσιδέσθαι	- - - -- u u--- uu--	dactylic hexameter	masculine penthemimeral, trithemimeral
ἀντέλλει, μήλοισι δʼ ἐν ἄσπετον ἧκεν ὀιζύν·	--- --u u -uu -u u--	dactylic hexameter	feminine penthemimeral, trithemimeral
ὧς ἄρα τῇ καλὸς μὲν ἐπήλυθεν εἰσοράασθαι	- uu - -- u u-uu -uu--	dactylic hexameter	masculine penthemimeral, trithemimeral
Αἰσονίδης, κάματον δὲ δυσίμερον ὦρσε φαανθείς.	-uu- uu- u u-uu -u u--	dactylic hexameter	masculine penthemimeral, trithemimeral
ἐκ δʼ ἄρα οἱ κραδίη στηθέων πέσεν, ὄμματα δʼ αὔτως	- uu - uu- -- uu -uu --	dactylic hexameter	masculine penthemimeral, hepthemimeral, trithemimeral
ἤχλυσαν· θερμὸν δὲ παρηίδας εἷλεν ἔρευθος.	--- -- u u-uu -u u--	dactylic hexameter	masculine penthemimeral, trithemimeral
γούνατα δʼ οὔτʼ ὀπίσω οὔτε προπάροιθεν ἀεῖραι	-uu - uu- -- uu-u u--	dactylic hexameter	masculine penthemimeral, hepthemimeral, trithemimeral
ἔσθενεν, ἀλλʼ ὑπένερθε πάγη πόδας. αἱ δʼ ἄρα τείως	-uu - uu-u u- uu - uu --	dactylic hexameter	feminine penthemimeral, hepthemimeral, trithemimeral
ἀμφίπολοι μάλα πᾶσαι ἀπὸ σφείων ἐλίασθεν.	-uu- uu -u u- -- uu--	dactylic hexameter	feminine penthemimeral, hepthemimeral, trithemimeral
τὼ δʼ ἄνεῳ καὶ ἄναυδοι ἐφέστασαν ἀλλήλοισιν,	- uu- u u-u u-uu ----	dactylic hexameter	feminine penthemimeral, trithemimeral
ἢ δρυσίν, ἢ μακρῇσιν ἐειδόμενοι ἐλάτῃσιν,	- uu - --u u-uu- uu--	dactylic hexameter	feminine penthemimeral, trithemimeral
αἵ τε παρᾶσσον ἕκηλοι ἐν οὔρεσιν ἐρρίζωνται,	- u u-u u-u u -uu ----	dactylic hexameter	feminine penthemimeral
νηνεμίῃ· μετὰ δʼ αὖτις ὑπὸ ῥιπῆς ἀνέμοιο	-uu- uu -u u- -- uu--	dactylic hexameter	feminine penthemimeral, hepthemimeral, trithemimeral
κινύμεναι ὁμάδησαν ἀπείριτον· ὧς ἄρα τώγε	-uu- uu-u u-uu - uu --	dactylic hexameter	feminine penthemimeral, trithemimeral
μέλλον ἅλις φθέγξασθαι ὑπὸ πνοιῇσιν Ἔρωτος.	-u u- --u u- --u u--	dactylic hexameter	feminine penthemimeral, hepthemimeral, trithemimeral
γνῶ δέ μιν Αἰσονίδης ἄτῃ ἐνιπεπτηυῖαν	- u u -uu- uu ------	dactylic hexameter	masculine penthemimeral
θευμορίῃ, καὶ τοῖον ὑποσσαίνων φάτο μῦθον·	-uu- - -u u--- uu --	dactylic hexameter	feminine penthemimeral, trithemimeral
‘τίπτε με, παρθενική, τόσον ἅζεαι, οἶον ἐόντα;	-u u -uu- uu -uu -u u--	dactylic hexameter	masculine penthemimeral
οὔ τοι ἐγών, οἷοί τε δυσαυχέες ἄλλοι ἔασιν	- u u- -- u u-uu -u u--	dactylic hexameter	masculine penthemimeral, trithemimeral
ἀνέρες, οὐδʼ ὅτε περ πάτρῃ ἔνι ναιετάασκον,	-uu - uu - -- uu -uu--	dactylic hexameter	masculine penthemimeral, hepthemimeral, trithemimeral
ἦα πάρος. τῶ μή με λίην ὑπεραίδεο, κούρη,	-u u- - - u u- uu-uu --	dactylic hexameter	masculine penthemimeral, hepthemimeral, trithemimeral
ἤ τι παρεξερέεσθαι, ὅ τοι φίλον, ἠέ τι φάσθαι.	- u u-uu-u u - uu -u u --	dactylic hexameter	feminine penthemimeral, hepthemimeral
ἀλλʼ ἐπεὶ ἀλλήλοισιν ἱκάνομεν εὐμενέοντες,	- uu ---u u-uu -uu--	dactylic hexameter	feminine penthemimeral
χώρῳ ἐν ἠγαθέῳ, ἵνα τʼ οὐ θέμις ἔστʼ ἀλιτέσθαι,	-u u -uu- uu - uu - uu--	dactylic hexameter	masculine penthemimeral, hepthemimeral
ἀμφαδίην ἀγόρευε καὶ εἴρεο· μηδέ με τερπνοῖς	-uu- uu-u u -uu -u u --	dactylic hexameter	feminine penthemimeral, trithemimeral
φηλώσῃς ἐπέεσσιν, ἐπεὶ τὸ πρῶτον ὑπέστης	--- uu-u u- - -u u--	dactylic hexameter	feminine penthemimeral, hepthemimeral, trithemimeral
αὐτοκασιγνήτῃ μενοεικέα φάρμακα δώσειν.	-uu--- uu-uu -uu --	dactylic hexameter	masculine penthemimeral
πρός σ᾽αὐτῆς Ἑκάτης μειλίσσομαι ἠδὲ τοκήων	- -- uu- --uu -u u--	dactylic hexameter	masculine penthemimeral, trithemimeral
καὶ Διός, ὃς ξείνοις ἱκέτῃσί τε χεῖρʼ ὑπερίσχει·	- uu - -- uu-u u - uu--	dactylic hexameter	masculine penthemimeral, trithemimeral
ἀμφότερον δʼ ,ἱκέτης ξεῖνός τέ τοι ἐνθάδʼ ἱκάνω,	-uu- uu- -- u u -u u--	dactylic hexameter	masculine penthemimeral, hepthemimeral, trithemimeral
χρειοῖ ἀναγκαίῃ γουνούμενος. οὐ γὰρ ἄνευθεν	-u u--- --uu - u u--	dactylic hexameter	masculine penthemimeral
ὑμείων στονόεντος ὑπέρτερος ἔσσομʼ ἀέθλου.	--- uu-u u-uu -u u--	dactylic hexameter	feminine penthemimeral, trithemimeral
σοὶ δʼ ἂν ἐγὼ τίσαιμι χάριν μετόπισθεν ἀρωγῆς,	- u u- --u u- uu-u u--	dactylic hexameter	feminine penthemimeral, hepthemimeral, trithemimeral
ἣ θέμις, ὡς ἐπέοικε διάνδιχα ναιετάοντας,	- uu - uu-u u-uu -uu--	dactylic hexameter	feminine penthemimeral, trithemimeral
οὔνομα καὶ καλὸν τεύχων κλέος· ὧς δὲ καὶ ὧλλοι	-uu - -- -- uu - u u --	dactylic hexameter	masculine penthemimeral, hepthemimeral, trithemimeral
ἥρωες κλῄσουσιν ἐς Ἑλλάδα νοστήσαντες	--- --u u -uu ----	dactylic hexameter	feminine penthemimeral, trithemimeral
ἡρώων τʼ ἄλοχοι καὶ μητέρες, αἵ νύ που ἤδη	--- uu- - -uu - u u --	dactylic hexameter	masculine penthemimeral, trithemimeral
ἡμέας ἠιόνεσσιν ἐφεζόμεναι γοάουσιν·	-uu -uu-u u-uu- uu--	dactylic hexameter	feminine penthemimeral
τάων ἀργαλέας κεν ἀποσκεδάσειας ἀνίας.	-- -uu- u u-uu-u u--	dactylic hexameter	masculine penthemimeral
δή ποτε καὶ Θησῆα κακῶν ὑπελύσατʼ ἀέθλων	- uu - --u u- uu-u u--	dactylic hexameter	feminine penthemimeral, hepthemimeral, trithemimeral
παρθενικὴ Μινωὶς ἐυφρονέουσʼ Ἀριάδνη,	-uu- --u u-uu- uu--	dactylic hexameter	feminine penthemimeral, trithemimeral
ἥν ῥά τε Πασιφάη κούρη τέκεν Ἠελίοιο.	- u u -uu- -- uu -uu--	dactylic hexameter	masculine penthemimeral, hepthemimeral
ἀλλʼ ἡ μὲν καὶ νηός, ἐπεὶ χόλον εὔνασε Μίνως,	- - - - -u u- uu -uu --	dactylic hexameter	feminine penthemimeral, hepthemimeral, trithemimeral
σὺν τῷ ἐφεζομένη πάτρην λίπε· τὴν δὲ καὶ αὐτοὶ	- u u-uu- -- uu - u u --	dactylic hexameter	masculine penthemimeral, hepthemimeral
ἀθάνατοι φίλαντο, μέσῳ δέ οἱ αἰθέρι τέκμαρ	-uu- --u u- u u -uu --	dactylic hexameter	feminine penthemimeral, hepthemimeral, trithemimeral
ἀστερόεις στέφανος, τόν τε κλείουσʼ Ἀριάδνης,	-uu- uu- - - -- uu--	dactylic hexameter	masculine penthemimeral, hepthemimeral, trithemimeral
πάννυχος οὐρανίοισιν ἑλίσσεται εἰδώλοισιν.	-uu -uu-u u-uu ----	dactylic hexameter	feminine penthemimeral
ὧς καὶ σοὶ θεόθεν χάρις ἔσσεται, εἴ κε σαώσῃς	- - - uu- uu -uu - u u--	dactylic hexameter	masculine penthemimeral, trithemimeral
τόσσον ἀριστήων ἀνδρῶν στόλον. ἦ γὰρ ἔοικας	-u u--- -- uu - u u--	dactylic hexameter	masculine penthemimeral, hepthemimeral
ἐκ μορφῆς ἀγανῇσιν ἐπητείῃσι κεκάσθαι.’	- -- uu-u u---u u--	dactylic hexameter	feminine penthemimeral, trithemimeral
ὧς φάτο κυδαίνων· ἡ δʼ ἐγκλιδὸν ὄσσε βαλοῦσα	- uu --- - -uu -u u--	dactylic hexameter	masculine penthemimeral
νεκτάρεον μείδησʼ ἐχύθη δέ οἱ ἔνδοθι θυμὸς	-uu- -- uu- u u -uu --	dactylic hexameter	masculine penthemimeral, hepthemimeral, trithemimeral
αἴνῳ ἀειρομένης, καὶ ἀνέδρακεν ὄμμασιν ἄντην·	-u u-uu- u u-uu -uu --	dactylic hexameter	masculine penthemimeral
οὐδʼ ἔχεν ὅττι πάροιθεν ἔπος προτιμυθήσαιτο,	- uu -u u-u u- uu----	dactylic hexameter	feminine penthemimeral, hepthemimeral
ἀλλʼ ἄμυδις μενέαινεν ἀολλέα πάντʼ ἀγορεῦσαι.	- uu- uu-u u-uu - uu--	dactylic hexameter	feminine penthemimeral, trithemimeral
προπρὸ δʼ ἀφειδήσασα θυώδεος ἔξελε μίτρης	-u u---u u-uu -uu --	dactylic hexameter	feminine penthemimeral
φάρμακον· αὐτὰρ ὅ γʼ αἶψα χεροῖν ὑπέδεκτο γεγηθώς.	-uu -u u -u u- uu-u u--	dactylic hexameter	feminine penthemimeral, hepthemimeral
καί νύ κέ οἱ καὶ πᾶσαν ἀπὸ στηθέων ἀρύσασα	- u u - - -u u- -- uu--	dactylic hexameter	feminine penthemimeral, hepthemimeral, trithemimeral
ψυχὴν ἐγγυάλιξεν ἀγαιομένη χατέοντι·	-- -uu-u u-uu- uu--	dactylic hexameter	feminine penthemimeral
τοῖος ἀπὸ ξανθοῖο καρήατος Αἰσονίδαο	-u u- --u u-uu -uu--	dactylic hexameter	feminine penthemimeral, trithemimeral
στράπτεν Ἔρως ἡδεῖαν ἀπὸ φλόγα· τῆς δʼ ἀμαρυγὰς	-u u- --u u- uu - uu--	dactylic hexameter	feminine penthemimeral, hepthemimeral, trithemimeral
ὀφθαλμῶν ἥρπαζεν· ἰαίνετο δὲ φρένας εἴσω	--- --u u-uu - uu --	dactylic hexameter	feminine penthemimeral, trithemimeral
τηκομένη, οἷόν τε περὶ ῥοδέῃσιν ἐέρση	-uu- -- u u- uu-u u--	dactylic hexameter	masculine penthemimeral, hepthemimeral, trithemimeral
τήκεται ἠῴοισιν ἰαινομένη φαέεσσιν.	-uu ---u u-uu- uu--	dactylic hexameter	feminine penthemimeral
ἄμφω δʼ ἄλλοτε μέν τε κατʼ οὔδεος ὄμματʼ ἔρειδον	-- -uu - u u -uu -u u--	dactylic hexameter	masculine penthemimeral
αἰδόμενοι, ὁτὲ δʼ αὖτις ἐπὶ σφίσι βάλλον ὀπωπάς,	-uu- uu -u u- uu -u u--	dactylic hexameter	feminine penthemimeral, hepthemimeral, trithemimeral
ἱμερόεν φαιδρῇσιν ὑπʼ ὀφρύσι μειδιόωντες.	-uu- --u u -uu -uu--	dactylic hexameter	feminine penthemimeral, trithemimeral
ὀψὲ δὲ δὴ τοίοισι μόλις προσπτύξατο κούρη·	-u u - --u u- --uu --	dactylic hexameter	feminine penthemimeral, hepthemimeral, trithemimeral
‘φράζεο νῦν, ὥς κέν τοι ἐγὼ μητίσομʼ ἀρωγήν.	-uu - - - u u- --u u--	dactylic hexameter	masculine penthemimeral, hepthemimeral, trithemimeral
εὖτʼ ἂν δὴ μετιόντι πατὴρ ἐμὸς ἐγγυαλίξῃ	- - - uu-u u- uu -uu--	dactylic hexameter	feminine penthemimeral, hepthemimeral, trithemimeral
ἐξ ὄφιος γενύων ὀλοοὺς σπείρασθαι ὀδόντας,	- uu- uu- uu- --u u--	dactylic hexameter	masculine penthemimeral, hepthemimeral, trithemimeral
δὴ τότε μέσσην νύκτα διαμμοιρηδὰ φυλάξας,	- uu -- -u u---u u--	dactylic hexameter	feminine penthemimeral
ἀκαμάτοιο ῥοῇσι λοεσσάμενος ποταμοῖο,	-uu-u u-u u-uu- uu--	dactylic hexameter	feminine penthemimeral
οἶος ἄνευθʼ ἄλλων ἐνὶ φάρεσι κυανέοισιν	-u u- -- uu -uu -uu--	dactylic hexameter	masculine penthemimeral, trithemimeral
βόθρον ὀρύξασθαι περιηγέα· τῷ δʼ ἔνι θῆλυν	-u u--- uu-uu - uu --	dactylic hexameter	masculine penthemimeral
ἀρνειὸν σφάζειν, καὶ ἀδαίετον ὠμοθετῆσαι,	--- -- u u-uu -uu--	dactylic hexameter	masculine penthemimeral, trithemimeral
αὐτῷ πυρκαϊὴν εὖ νηήσας ἐπὶ βόθρῳ.	-- -uu- - --- uu --	dactylic hexameter	masculine penthemimeral
μουνογενῆ δʼ Ἑκάτην Περσηίδα μειλίσσοιο,	-uu- uu- --uu ----	dactylic hexameter	masculine penthemimeral, trithemimeral
λείβων ἐκ δέπαος σιμβλήια ἔργα μελισσέων.	-- - uu- --uu -u u--	dactylic hexameter	masculine penthemimeral, trithemimeral
ἔνθα δʼ ἐπεί κε θεὰν μεμνημένος ἱλάσσηαι,	-u u- u u- --uu ----	dactylic hexameter	masculine penthemimeral, trithemimeral
ἂψ ἀπὸ πυρκαϊῆς ἀναχάζεο· μηδέ σε δοῦπος	- uu -uu- uu-uu -u u --	dactylic hexameter	masculine penthemimeral
ἠὲ ποδῶν ὄρσῃσι μεταστρεφθῆναι ὀπίσσω,	-u u- --u u---u u--	dactylic hexameter	feminine penthemimeral, trithemimeral
ἠὲ κυνῶν ὑλακή, μή πως τὰ ἕκαστα κολούσας	-u u- uu- - - u u-u u--	dactylic hexameter	masculine penthemimeral, hepthemimeral, trithemimeral
οὐδʼ αὐτὸς κατὰ κόσμον ἑοῖς ἑτάροισι πελάσσῃς.	- -- uu -u u- uu-u u--	dactylic hexameter	feminine penthemimeral, hepthemimeral, trithemimeral
ἦρι δὲ μυδήνας τόδε φάρμακον, ἠύτʼ ἀλοιφῇ	-u u --- uu -uu -u u--	dactylic hexameter	masculine penthemimeral
γυμνωθεὶς φαίδρυνε τεὸν δέμας· ἐν δέ οἱ ἀλκὴ	--- --u u- uu - u u --	dactylic hexameter	feminine penthemimeral, hepthemimeral, trithemimeral
ἔσσετʼ ἀπειρεσίη μέγα τε σθένος, οὐδέ κε φαίης	-u u-uu- uu - uu -u u --	dactylic hexameter	masculine penthemimeral, hepthemimeral
ἀνδράσιν, ἀλλὰ θεοῖσιν ἰσαζέμεν ἀθανάτοισιν.	-uu -u u-u u-uu -uu--	dactylic hexameter	feminine penthemimeral
πρὸς δὲ καὶ αὐτῷ δουρὶ σάκος πεπαλαγμένον ἔστω	- u u -- -u u- uu-uu --	dactylic hexameter	feminine penthemimeral, hepthemimeral
καὶ ξίφος. ἔνθʼ οὐκ ἄν σε διατμήξειαν ἀκωκαὶ	- uu - - - u u---u u--	dactylic hexameter	masculine penthemimeral, trithemimeral
γηγενέων ἀνδρῶν, οὐδʼ ἄσχετος ἀίσσουσα	-uu- -- - -uu ----	dactylic hexameter	masculine penthemimeral, trithemimeral
φλὸξ ὀλοῶν ταύρων. τοῖός γε μὲν οὐκ ἐπὶ δηρὸν	- uu- -- -- u u - uu --	dactylic hexameter	masculine penthemimeral, hepthemimeral, trithemimeral
ἔσσεαι, ἀλλʼ αὐτῆμαρ· ὅμως σύγε μή ποτʼ ἀέθλου	-uu - --u u- uu - u u--	dactylic hexameter	feminine penthemimeral, hepthemimeral, trithemimeral
χάζεο. καὶ δέ τοι ἄλλο παρὲξ ὑποθήσομʼ ὄνειαρ.	-uu - u u -u u- uu-u u--	dactylic hexameter	feminine penthemimeral, hepthemimeral, trithemimeral
αὐτίκʼ ἐπὴν κρατεροὺς ζεύξῃς βόας, ὦκα δὲ πᾶσαν	-u u- uu- -- uu -u u --	dactylic hexameter	masculine penthemimeral, hepthemimeral, trithemimeral
χερσὶ καὶ ἠνορέῃ στυφελὴν διὰ νειὸν ἀρόσσῃς,	-u u -uu- uu- uu -u u--	dactylic hexameter	masculine penthemimeral, hepthemimeral
οἱ δʼ ἤδη κατὰ ὦλκας ἀνασταχύωσι Γίγαντες	- -- uu -u u-uu-u u--	dactylic hexameter	feminine penthemimeral, trithemimeral
σπειρομένων ὄφιος δνοφερὴν ἐπὶ βῶλον ὀδόντων,	-uu- uu- uu- uu -u u--	dactylic hexameter	masculine penthemimeral, hepthemimeral, trithemimeral
αἴ κεν ὀρινομένους πολέας νειοῖο δοκεύσῃς,	- u u-uu- uu- --u u--	dactylic hexameter	masculine penthemimeral, hepthemimeral
λάθρῃ λᾶαν ἄφες στιβαρώτερον· οἱ δʼ ἂν ἐπʼ αὐτῷ,	-- -u u- uu-uu - u u --	dactylic hexameter	masculine penthemimeral
καρχαλέοι κύνες ὥστε περὶ βρώμης, ὀλέκοιεν	-uu- uu -u u- -- uu--	dactylic hexameter	feminine penthemimeral, hepthemimeral, trithemimeral
ἀλλήλους· καὶ δʼ αὐτὸς ἐπείγεο δηιοτῆτος	--- - -u u-uu -uu--	dactylic hexameter	feminine penthemimeral, trithemimeral
ἰθῦσαι. τὸ δὲ κῶας ἐς Ἑλλάδα τοῖό γ᾽ἕκητι	--- u u -u u -uu -u u--	dactylic hexameter	feminine penthemimeral, trithemimeral
οἴσεαι ἐξ Αἴης τηλοῦ ποθί· νίσσεο δʼ ἔμπης,	-uu - -- -- uu -uu --	dactylic hexameter	masculine penthemimeral, hepthemimeral, trithemimeral
ᾗ φίλον, ἤ τοι ἕαδεν ἀφορμηθέντι νέεσθαι.’	- uu - u u-u u---u u--	dactylic hexameter	feminine penthemimeral, trithemimeral
ὧς ἄρʼ ἔφη, καὶ σῖγα ποδῶν πάρος ὄσσε βαλοῦσα	- u u- - -u u- uu -u u--	dactylic hexameter	feminine penthemimeral, hepthemimeral, trithemimeral
θεσπέσιον λιαροῖσι παρηίδα δάκρυσι δεῦεν	-uu- uu-u u-uu -uu --	dactylic hexameter	feminine penthemimeral, trithemimeral
μυρομένη, ὅ τʼ ἔμελλεν ἀπόπροθι πολλὸν ἑοῖο	-uu- u u-u u-uu -u u--	dactylic hexameter	feminine penthemimeral, trithemimeral
πόντον ἐπιπλάγξεσθαι· ἀνιηρῷ δέ μιν ἄντην	-u u---u u--- u u --	dactylic hexameter	feminine penthemimeral
ἐξαῦτις μύθῳ προσεφώνεεν, εἷλέ τε χειρὸς	--- -- uu-uu -u u --	dactylic hexameter	masculine penthemimeral, trithemimeral
δεξιτερῆς· δὴ γάρ οἱ ἀπʼ ὀφθαλμοὺς λίπεν αἰδώς·	-uu- - - u u --- uu --	dactylic hexameter	masculine penthemimeral, trithemimeral
‘μνώεο δʼ ,ἢν ἄρα δή ποθʼ ὑπότροπος οἴκαδʼ ἵκηαι,	-uu - uu - u u-uu -u u--	dactylic hexameter	masculine penthemimeral, trithemimeral
οὔνομα Μηδείης· ὧς δʼ αὖτʼ ἐγὼ ἀμφὶς ἐόντος	-uu --- - - uu -u u--	dactylic hexameter	masculine penthemimeral, hepthemimeral
μνήσομαι. εἰπὲ δέ μοι πρόφρων τόδε, πῇ τοι ἔασιν	-uu -u u - -- uu - u u--	dactylic hexameter	masculine penthemimeral, hepthemimeral
δώματα, πῇ νῦν ἔνθεν ὑπεὶρ ἅλα νηὶ περήσεις·	-uu - - -u u- uu -u u--	dactylic hexameter	feminine penthemimeral, hepthemimeral, trithemimeral
ἤ νύ που ἀφνειοῦ σχεδὸν ἵξεαι Ὀρχομενοῖο,	- u u --- uu -uu -uu--	dactylic hexameter	masculine penthemimeral
ἦε καὶ Αἰαίης νήσου πέλας; εἰπὲ δὲ κούρην,	-u u --- -- uu -u u --	dactylic hexameter	masculine penthemimeral, hepthemimeral
ἥντινα τήνδʼ ὀνόμηνας ἀριγνώτην γεγαυῖαν	-uu - uu-u u--- uu--	dactylic hexameter	feminine penthemimeral, trithemimeral
Πασιφάης, ἣ πατρὸς ὁμόγνιός ἐστιν ἐμεῖο.’	-uu- - -u u-uu -u u--	dactylic hexameter	feminine penthemimeral, trithemimeral
ὧς φάτο· τὸν δὲ καὶ αὐτὸν ὑπήιε δάκρυσι κούρης	- uu - u u -u u-uu -uu --	dactylic hexameter	feminine penthemimeral, trithemimeral
οὖλος Ἔρως, τοῖον δὲ παραβλήδην ἔπος ηὔδα·	-u u- -- u u--- uu --	dactylic hexameter	masculine penthemimeral, trithemimeral
‘καὶ λίην οὐ νύκτας ὀίομαι, οὐδέ ποτʼ ἦμαρ	- -- - -u u-uu -u u --	dactylic hexameter	feminine penthemimeral, trithemimeral
σεῦ ἐπιλήσεσθαι, προφυγὼν μόρον, εἰ ἐτεόν γε	- uu--- uu- uu - uu- -	dactylic hexameter	masculine penthemimeral, hepthemimeral
φεύξομαι ἀσκηθὴς ἐς Ἀχαιίδα, μηδέ τινʼ ἄλλον	-uu --- u u-uu -u u --	dactylic hexameter	masculine penthemimeral
Αἰήτης προβάλῃσι κακώτερον ἄμμιν ἄεθλον.	--- uu-u u-uu -u u--	dactylic hexameter	feminine penthemimeral, trithemimeral
εἰ δέ τοι ἡμετέρην ἐξίδμεναι εὔαδε πάτρην,	- u u -uu- --uu -uu --	dactylic hexameter	masculine penthemimeral
ἐξερέω· μάλα γάρ με καὶ αὐτὸν θυμὸς ἀνώγει.	-uu- uu - u u -- -u u--	dactylic hexameter	masculine penthemimeral, trithemimeral
ἔστι τις αἰπεινοῖσι περίδρομος οὔρεσι γαῖα,	-u u ---u u-uu -uu --	dactylic hexameter	feminine penthemimeral
πάμπαν ἐύρρηνός τε καὶ εὔβοτος, ἔνθα Προμηθεὺς	-u u--- u u -uu -u u--	dactylic hexameter	masculine penthemimeral
Ἰαπετιονίδης ἀγαθὸν τέκε Δευκαλίωνα,	-uu-uu- uu- uu -uu--	dactylic hexameter	masculine penthemimeral, hepthemimeral
ὃς πρῶτος ποίησε πόλεις καὶ ἐδείματο νηοὺς	- -- --u u- u u-uu --	dactylic hexameter	feminine penthemimeral, hepthemimeral, trithemimeral
ἀθανάτοις, πρῶτος δὲ καὶ ἀνθρώπων βασίλευσεν.	-uu- -- u u --- uu--	dactylic hexameter	masculine penthemimeral, trithemimeral
Αἱμονίην δὴ τήνγε περικτίονες καλέουσιν.	-uu- - -u u-uu- uu--	dactylic hexameter	feminine penthemimeral, trithemimeral
ἐν δʼ αὐτῇ Ἰαωλκός, ἐμὴ πόλις, ἐν δὲ καὶ ἄλλαι	- -- uu-u u- uu - u u --	dactylic hexameter	feminine penthemimeral, hepthemimeral, trithemimeral
πολλαὶ ναιετάουσιν, ἵνʼ οὐδέ περ οὔνομʼ ἀκοῦσαι	-- -uu-u u -u u -u u--	dactylic hexameter	feminine penthemimeral
Αἰαίης νήσου· Μινύην γε μὲν ὁρμηθέντα,	--- -- uu- u u ----	dactylic hexameter	masculine penthemimeral, hepthemimeral, trithemimeral
Αἰολίδην Μινύην ἔνθεν φάτις Ὀρχομενοῖο	-uu- uu- -- uu -uu--	dactylic hexameter	masculine penthemimeral, hepthemimeral, trithemimeral
δή ποτε Καδμείοισιν ὁμούριον ἄστυ πολίσσαι.	- uu ---u u-uu -u u--	dactylic hexameter	feminine penthemimeral
ἀλλὰ τίη τάδε τοι μεταμώνια πάντʼ ἀγορεύω,	-u u- uu - uu-uu - uu--	dactylic hexameter	masculine penthemimeral, trithemimeral
ἡμετέρους τε δόμους τηλεκλείτην τʼ Ἀριάδνην,	-uu- u u- ---- uu--	dactylic hexameter	masculine penthemimeral, trithemimeral
κούρην Μίνωος, τόπερ ἀγλαὸν οὔνομα κείνην	-- --- uu -uu -uu --	dactylic hexameter	masculine penthemimeral
παρθενικὴν καλέεσκον ἐπήρατον, ἥν μ᾽ἐρεείνεις;	-uu- uu-u u-uu - uu--	dactylic hexameter	feminine penthemimeral, trithemimeral
αἴθε γάρ, ὡς Θησῆι τότε ξυναρέσσατο Μίνως	-u u - --u u- uu-uu --	dactylic hexameter	feminine penthemimeral, hepthemimeral, trithemimeral
ἀμφʼ αὐτῆς, ὧς ἄμμι πατὴρ τεὸς ἄρθμιος εἴη.’	- -- - -u u- uu -uu --	dactylic hexameter	feminine penthemimeral, hepthemimeral, trithemimeral
ὧς φάτο, μειλιχίοισι καταψήχων ὀάροισιν.	- uu -uu-u u--- uu--	dactylic hexameter	feminine penthemimeral
τῆς δʼ ἀλεγεινόταται κραδίην ἐρέθεσκον ἀνῖαι,	- uu-uu- uu- uu-u u--	dactylic hexameter	masculine penthemimeral, hepthemimeral
καί μιν ἀκηχεμένη ἀδινῷ προσπτύξατο μύθῳ·	- u u-uu- uu- --uu --	dactylic hexameter	masculine penthemimeral, hepthemimeral
‘Ἑλλάδι που τάδε καλά, συνημοσύνας ἀλεγύνειν.	-uu - uu -u u-uu- uu--	dactylic hexameter	feminine penthemimeral, trithemimeral
Αἰήτης δʼ οὐ τοῖος ἐν ἀνδράσιν, οἷον ἔειπας	--- - -u u -uu -u u--	dactylic hexameter	feminine penthemimeral, trithemimeral
Μίνω Πασιφάης πόσιν ἔμμεναι· οὐδʼ Ἀριάδνῃ	-- -uu- uu -uu - uu--	dactylic hexameter	masculine penthemimeral
ἰσοῦμαι· τῶ μήτι φιλοξενίην ἀγόρευε.	--- - -u u-uu- uu--	dactylic hexameter	feminine penthemimeral, trithemimeral
ἀλλʼ οἶον τύνη μὲν ἐμεῦ, ὅτʼ Ἰωλκὸν ἵκηαι,	- -- -- u u- u u-u u--	dactylic hexameter	masculine penthemimeral, hepthemimeral, trithemimeral
μνώεο· σεῖο δʼ ἐγὼ καὶ ἐμῶν ἀέκητι τοκήων	-uu -u u- u u- uu-u u--	dactylic hexameter	masculine penthemimeral, hepthemimeral
μνήσομαι. ἔλθοι δʼ ἧμιν ἀπόπροθεν ἠέ τις ὄσσα,	-uu -- -u u-uu -u u --	dactylic hexameter	feminine penthemimeral
ἠέ τις ἄγγελος ὄρνις, ὅτʼ ἐκλελάθοιο ἐμεῖο·	-u u -uu -u u -uu-u u--	dactylic hexameter	feminine penthemimeral
ἢ αὐτήν με ταχεῖαι ὑπὲρ πόντοιο φέροιεν	- -- u u-u u- --u u--	dactylic hexameter	feminine penthemimeral, hepthemimeral, trithemimeral
ἐνθένδʼ εἰς Ἰαωλκὸν ἀναρπάξασαι ἄελλαι,	-- - uu-u u---u u--	dactylic hexameter	feminine penthemimeral, trithemimeral
ὄφρα σ᾽,ἐν ὀφθαλμοῖσιν ἐλεγχείας προφέρουσα,	-u u ---u u--- uu--	dactylic hexameter	feminine penthemimeral
μνήσω ἐμῇ ἰότητι πεφυγμένον. αἴθε γὰρ εἴην	-u u- uu-u u-uu -u u --	dactylic hexameter	feminine penthemimeral, trithemimeral
ἀπροφάτως τότε σοῖσιν ἐφέστιος ἐν μεγάροισιν.’	-uu- uu -u u-uu - uu--	dactylic hexameter	feminine penthemimeral, trithemimeral
ὧς ἄρʼ ἔφη, ἐλεεινὰ καταπροχέουσα παρειῶν	- u u- uu-u u-uu-u u--	dactylic hexameter	feminine penthemimeral, trithemimeral
δάκρυα· τὴν δʼ ὅγε δῆθεν ὑποβλήδην προσέειπεν·	-uu - uu -u u--- uu--	dactylic hexameter	feminine penthemimeral, trithemimeral
‘δαιμονίη, κενεὰς μὲν ἔα πλάζεσθαι ἀέλλας,	-uu- uu- u u- --u u--	dactylic hexameter	masculine penthemimeral, hepthemimeral, trithemimeral
ὧς δὲ καὶ ἄγγελον ὄρνιν, ἐπεὶ μεταμώνια βάζεις.	- u u -uu -u u- uu-uu --	dactylic hexameter	feminine penthemimeral, hepthemimeral
εἰ δέ κεν ἤθεα κεῖνα καὶ Ἑλλάδα γαῖαν ἵκηαι,	- u u -uu -u u -uu -u u--	dactylic hexameter	feminine penthemimeral
τιμήεσσα γυναιξὶ καὶ ἀνδράσιν αἰδοίη τε	---u u-u u -uu --- -	dactylic hexameter	feminine penthemimeral
ἔσσεαι· οἱ δέ σε πάγχυ θεὸν ὣς πορσανέουσιν,	-uu - u u -u u- - -uu--	dactylic hexameter	feminine penthemimeral, hepthemimeral, trithemimeral
οὕνεκα τῶν μὲν παῖδες ὑπότροποι οἴκαδʼ ἵκοντο	-uu - - -u u-uu -u u--	dactylic hexameter	feminine penthemimeral, trithemimeral
σῇ βουλῇ, τῶν δʼ αὖτε κασίγνητοί τε ἔται τε	- -- - -u u--- u u- -	dactylic hexameter	feminine penthemimeral, trithemimeral
καὶ θαλεροὶ κακότητος ἄδην ἐσάωθεν ἀκοῖται.	- uu- uu-u u- uu-u u--	dactylic hexameter	feminine penthemimeral, hepthemimeral, trithemimeral
ἡμέτερον δὲ λέχος θαλάμοις ἔνι κουριδίοισιν	-uu- u u- uu- uu -uu--	dactylic hexameter	masculine penthemimeral, hepthemimeral, trithemimeral
πορσυνέεις· οὐδʼ ἄμμε διακρινέει φιλότητος	-uu- - -u u-uu- uu--	dactylic hexameter	feminine penthemimeral, trithemimeral
ἄλλο, πάρος θάνατόν γε μεμορμένον ἀμφικαλύψαι.’	-u u- uu- u u-uu -uu--	dactylic hexameter	masculine penthemimeral, trithemimeral
ὧς φάτο· τῇ δʼ ἔντοσθε κατείβετο θυμὸς ἀκουῇ,	- uu - --u u-uu -u u--	dactylic hexameter	feminine penthemimeral, trithemimeral
ἔμπης δʼ ἔρ γʼ ἀίδηλα κατερρίγησεν ἰδέσθαι.	-- - uu-u u---u u--	dactylic hexameter	feminine penthemimeral, trithemimeral
σχετλίη· οὐ μὲν δηρὸν ἀπαρνήσεσθαι ἔμελλεν	-uu - - -u u---u u--	dactylic hexameter	feminine penthemimeral, trithemimeral
Ἑλλάδα ναιετάειν. ὧς γὰρ τόδε μήδετο Ἥρη,	-uu -uu- - - uu -uu --	dactylic hexameter	masculine penthemimeral, hepthemimeral
ὄφρα κακὸν Πελίῃ ἱερὴν ἐς Ἰωλκὸν ἵκοιτο	-u u- uu- uu- u u-u u--	dactylic hexameter	masculine penthemimeral, hepthemimeral, trithemimeral
Αἰαίη Μήδεια, λιποῦσʼ ἄπο πατρίδα γαῖαν.	--- --u u- uu -uu --	dactylic hexameter	feminine penthemimeral, hepthemimeral, trithemimeral
ἤδη δʼ ἀμφίπολοι μὲν ὀπιπεύουσαι ἄπωθεν	-- -uu- u u---u u--	dactylic hexameter	masculine penthemimeral
σιγῇ ἀνιάζεσκον· ἐδεύετο δʼ ἤματος ὥρη	-u u---u u-uu -uu --	dactylic hexameter	feminine penthemimeral
ἂψ οἶκόνδε νέεσθαι ἑὴν μετὰ μητέρα κούρην.	- --u u-u u- uu -uu --	dactylic hexameter	feminine penthemimeral, hepthemimeral
ἡ δʼ οὔπω κομιδῆς μιμνήσκετο, τέρπετο γάρ οἱ	- -- uu- --uu -uu - -	dactylic hexameter	masculine penthemimeral, trithemimeral
θυμὸς ὁμῶς μορφῇ τε καὶ αἱμυλίοισι λόγοισιν,	-u u- -- u u -uu-u u--	dactylic hexameter	masculine penthemimeral, trithemimeral
εἰ μὴ ἄρʼ Αἰσονίδης πεφυλαγμένος ὀψέ περ ηὔδα·	- u u -uu- uu-uu -u u --	dactylic hexameter	masculine penthemimeral
‘ὥρη ἀποβλώσκειν, μὴ πρὶν φάος ἠελίοιο	-u u--- - - uu -uu--	dactylic hexameter	masculine penthemimeral, hepthemimeral
δύῃ ὑποφθάμενον, καί τις τὰ ἕκαστα νοήσῃ	-u u-uu- - - u u-u u--	dactylic hexameter	masculine penthemimeral, hepthemimeral
ὀθνείων· αὖτις δʼ ἀβολήσομεν ἐνθάδʼ ἰόντες.’	--- -- uu-uu -u u--	dactylic hexameter	masculine penthemimeral, trithemimeral
ὧς τώ γʼ ἀλλήλων ἀγανοῖς ἐπὶ τόσσον ἔπεσσιν	- - --- uu- uu -u u--	dactylic hexameter	masculine penthemimeral, hepthemimeral
πείρηθεν· μετὰ δʼ αὖτε διέτμαγεν. ἤτοι Ἰήσων	--- uu -u u-uu -u u--	dactylic hexameter	feminine penthemimeral, trithemimeral
εἰς ἑτάρους καὶ νῆα κεχαρμένος ὦρτο νέεσθαι·	- uu- - -u u-uu -u u--	dactylic hexameter	feminine penthemimeral, trithemimeral
ἡ δὲ μετʼ ἀμφιπόλους· αἱ δὲ σχεδὸν ἀντεβόλησαν	- u u -uu- - - uu -uu--	dactylic hexameter	masculine penthemimeral, hepthemimeral
πᾶσαι ὁμοῦ· τὰς δʼ οὔτι περιπλομένας ἐνόησεν.	-u u- - -u u-uu- uu--	dactylic hexameter	feminine penthemimeral, trithemimeral
ψυχὴ γὰρ νεφέεσσι μεταχρονίη πεπότητο.	-- - uu-u u-uu- uu--	dactylic hexameter	feminine penthemimeral, trithemimeral
αὐτομάτοις δὲ πόδεσσι θοῆς ἐπεβήσατʼ ἀπήνης,	-uu- u u-u u- uu-u u--	dactylic hexameter	feminine penthemimeral, hepthemimeral, trithemimeral
καί ῥʼ ἑτέρῃ μὲν χειρὶ λάβʼ ἡνία, τῇ δʼ ἄρʼ ἱμάσθλην	- uu- - -u u -uu - u u--	dactylic hexameter	feminine penthemimeral, trithemimeral
δαιδαλέην, οὐρῆας ἐλαυνέμεν· οἱ δὲ πόλινδε	-uu- --u u-uu - u u--	dactylic hexameter	feminine penthemimeral, trithemimeral
θῦνον ἐπειγόμενοι ποτὶ δώματα. τὴν δʼ ἄρʼ ἰοῦσαν	-u u-uu- uu -uu - u u--	dactylic hexameter	masculine penthemimeral
Χαλκιόπη περὶ παισὶν ἀκηχεμένη ἐρέεινεν·	-uu- uu -u u-uu- uu--	dactylic hexameter	feminine penthemimeral, trithemimeral
ἡ δὲ παλιντροπίῃσιν ἀμήχανος οὔτε τι μύθων	- u u-uu-u u-uu -u u --	dactylic hexameter	feminine penthemimeral
ἔκλυεν, οὔτʼ αὐδῆσαι ἀνειρομένῃ λελίητο.	-uu - --u u-uu- uu--	dactylic hexameter	feminine penthemimeral, trithemimeral
ἷζε δʼ ἐπὶ χθαμαλῷ σφέλαϊ κλιντῆρος ἔνερθεν	-u u- uu- uu- --u u--	dactylic hexameter	masculine penthemimeral, hepthemimeral, trithemimeral
λέχρις ἐρεισαμένη λαιῇ ἐπὶ χειρὶ παρειήν·	-u u-uu- -- uu -u u--	dactylic hexameter	masculine penthemimeral, hepthemimeral
ὑγρὰ δʼ ἐνὶ βλεφάροις ἔχεν ὄμματα, πορφύρουσα	-u u- uu- uu -uu ----	dactylic hexameter	masculine penthemimeral, trithemimeral
οἷον ἑῇ κακὸν ἔργον ἐπιξυνώσατο βουλῇ.	-u u- uu -u u---uu --	dactylic hexameter	feminine penthemimeral, trithemimeral
Αἰσονίδης δʼ ὅτε δὴ ἑτάροις ἐξαῦτις ἔμικτο	-uu- uu - uu- --u u--	dactylic hexameter	masculine penthemimeral, hepthemimeral, trithemimeral
ἐν χώρῃ, ὅθι τούσγε καταπρολιπὼν ἐλιάσθη,	- -- uu -u u-uu- uu--	dactylic hexameter	feminine penthemimeral, trithemimeral
ὦρτʼ ἰέναι σὺν τοῖσι, πιφαυσκόμενος τὰ ἕκαστα,	- uu- - -u u-uu- u u--	dactylic hexameter	feminine penthemimeral, trithemimeral
ἡρώων ἐς ὅμιλον· ὁμοῦ δʼ ἐπὶ νῆα πέλασσαν.	--- u u-u u- uu -u u--	dactylic hexameter	feminine penthemimeral, hepthemimeral, trithemimeral
οἱ δέ μιν ἀμφαγάπαζον, ὅπως ἴδον, ἔκ τʼ ἐρέοντο.	- u u -uu-u u- uu - uu--	dactylic hexameter	feminine penthemimeral, hepthemimeral
αὐτὰρ ὁ τοῖς πάντεσσι μετέννεπε δήνεα κούρης,	-u u - --u u-uu -uu --	dactylic hexameter	feminine penthemimeral, trithemimeral
δεῖξέ τε φάρμακον αἰνόν· ὁ δʼ οἰόθεν οἶος ἑταίρων	-u u -uu -u u -uu -u u--	dactylic hexameter	feminine penthemimeral
Ἴδας ἧστʼ ἀπάνευθε δακὼν χόλον· οἱ δὲ δὴ ἄλλοι	-- - uu-u u- uu - u u --	dactylic hexameter	feminine penthemimeral, hepthemimeral, trithemimeral
γηθόσυνοι τῆμος μέν, ἐπεὶ κνέφας ἔργαθε νυκτός,	-uu- -- u u- uu -uu --	dactylic hexameter	masculine penthemimeral, hepthemimeral, trithemimeral
εὔκηλοι ἐμέλοντο περὶ σφίσιν. αὐτὰρ ἅμʼ ἠοῖ	--- uu-u u- uu -u u --	dactylic hexameter	feminine penthemimeral, hepthemimeral, trithemimeral
πέμπον ἐς Αἰήτην ἰέναι σπόρον αἰτήσοντας	-u u --- uu- uu ----	dactylic hexameter	masculine penthemimeral, hepthemimeral
ἄνδρε δύω, πρὸ μὲν αὐτὸν ἀρηίφιλον Τελαμῶνα,	-u u- u u -u u-uu- uu--	dactylic hexameter	feminine penthemimeral, trithemimeral
σὺν δὲ καὶ Αἰθαλίδην, υἷα κλυτὸν Ἑρμείαο.	- u u -uu- -- uu ----	dactylic hexameter	masculine penthemimeral, hepthemimeral
βὰν δʼ ἴμεν, οὐδʼ ἁλίωσαν ὁδόν· πόρε δέ σφιν ἰοῦσιν	- uu - uu-u u- uu - u u--	dactylic hexameter	feminine penthemimeral, hepthemimeral, trithemimeral
κρείων Αἰήτης χαλεποὺς ἐς ἄεθλον ὀδόντας	-- --- uu- u u-u u--	dactylic hexameter	masculine penthemimeral, hepthemimeral
Ἀονίοιο δράκοντος, ὃν Ὠγυγίῃ ἐνὶ Θήβῃ	-uu-u u-u u -uu- uu --	dactylic hexameter	feminine penthemimeral
Κάδμος, ὅτʼ Εὐρώπην διζήμενος εἰσαφίκανεν,	-u u --- --uu -uu--	dactylic hexameter	masculine penthemimeral
πέφνεν Ἀρητιάδι κρήνῃ ἐπίουρον ἐόντα·	-u u-uu- -- uu-u u--	dactylic hexameter	masculine penthemimeral, hepthemimeral
ἔνθα καὶ ἐννάσθη πομπῇ βοός, ἥν οἱ Ἀπόλλων	-u u --- -- uu - u u--	dactylic hexameter	masculine penthemimeral, hepthemimeral
ὤπασε μαντοσύνῃσι προηγήτειραν ὁδοῖο.	-uu -uu-u u---u u--	dactylic hexameter	feminine penthemimeral
τοὺς δὲ θεὰ Τριτωνὶς ὑπὲκ γενύων ἐλάσασα	- u u- --u u- uu- uu--	dactylic hexameter	feminine penthemimeral, hepthemimeral, trithemimeral
Αἰήτῃ πόρε δῶρον ὁμῶς αὐτῷ τε φονῆι.	--- uu -u u- -- u u--	dactylic hexameter	feminine penthemimeral, hepthemimeral, trithemimeral
καί ῥʼ ὁ μὲν Ἀονίοισιν ἐνισπείρας πεδίοισιν	- u u -uu-u u--- uu--	dactylic hexameter	feminine penthemimeral
Κάδμος Ἀγηνορίδης γαιηγενῆ εἵσατο λαόν,	-u u-uu- --uu -uu --	dactylic hexameter	masculine penthemimeral
Ἄρεος ἀμώοντος ὅσοι ὑπὸ δουρὶ λίποντο·	-uu ---u u- uu -u u--	dactylic hexameter	feminine penthemimeral, hepthemimeral
τοὺς δὲ τότʼ Αἰήτης ἔπορεν μετὰ νῆα φέρεσθαι	- u u --- uu- uu -u u--	dactylic hexameter	masculine penthemimeral, hepthemimeral
προφρονέως, ἐπεὶ οὔ μιν ὀίσσατο πείρατʼ ἀέθλου	-uu- uu - u u-uu -u u--	dactylic hexameter	masculine penthemimeral, trithemimeral
ἐξανύσειν, εἰ καί περ ἐπὶ ζυγὰ βουσὶ βάλοιτο.	-uu- - - u u- uu -u u--	dactylic hexameter	masculine penthemimeral, hepthemimeral, trithemimeral
ἠέλιος μὲν ἄπωθεν ἐρεμνὴν δύετο γαῖαν	-uu- u u-u u-- -uu --	dactylic hexameter	feminine penthemimeral, trithemimeral
ἑσπέριος, νεάτας ὑπὲρ ἄκριας Αἰθιοπήων·	-uu- uu- uu -uu -uu--	dactylic hexameter	masculine penthemimeral, trithemimeral
νὺξ δʼ ἵπποισιν ἔβαλλεν ἔπι ζυγά· τοὶ δὲ χαμεύνας	- --u u-u u- uu - u u--	dactylic hexameter	feminine penthemimeral, hepthemimeral
ἔντυον ἥρωες παρὰ πείσμασιν. αὐτὰρ Ἰήσων	-uu --- uu -uu -u u--	dactylic hexameter	masculine penthemimeral
αὐτίκʼ ἐπεί ῥʼ Ἑλίκης εὐφεγγέος ἀστέρες Ἄρκτου	-u u- uu- --uu -uu --	dactylic hexameter	masculine penthemimeral, trithemimeral
ἔκλιθεν, οὐρανόθεν δὲ πανεύκηλος γένετʼ αἰθήρ,	-uu -uu- u u--- uu --	dactylic hexameter	masculine penthemimeral
βῆ ῥʼ ἐς ἐρημαίην, κλωπήιος ἠύτε τις φώρ,	- u u--- --uu -uu - -	dactylic hexameter	masculine penthemimeral
σὺν πᾶσιν χρήεσσι· πρὸ γάρ τʼ ἀλέγυνεν ἕκαστα	- -- --u u - uu-u u--	dactylic hexameter	feminine penthemimeral, hepthemimeral, trithemimeral
ἠμάτιος· θῆλυν μὲν ὄιν, γάλα τʼ ἔκτοθι ποίμνης	-uu- -- u u- uu -uu --	dactylic hexameter	masculine penthemimeral, hepthemimeral, trithemimeral
Ἄργος ἰὼν ἤνεικε· τὰ δʼ ἐξ αὐτῆς ἕλε νηός.	-u u- --u u - -- uu --	dactylic hexameter	feminine penthemimeral, hepthemimeral, trithemimeral
ἀλλʼ ὅτε δὴ ἴδε χῶρον, ὅτις πάτου ἔκτοθεν ἦεν	- uu - uu -u u- uu -uu --	dactylic hexameter	feminine penthemimeral, hepthemimeral, trithemimeral
ἀνθρώπων, καθαρῇσιν ὑπεύδιος εἱαμενῇσιν,	--- uu-u u-uu -uu--	dactylic hexameter	feminine penthemimeral, trithemimeral
ἔνθʼ ἤτοι πάμπρωτα λοέσσατο μὲν ποταμοῖο	- -- --u u-uu - uu--	dactylic hexameter	feminine penthemimeral, trithemimeral
εὐαγέως θείοιο τέρεν δέμας· ἀμφὶ δὲ φᾶρος	-uu- --u u- uu -u u --	dactylic hexameter	feminine penthemimeral, hepthemimeral, trithemimeral
ἕσσατο κυάνεον, τό ῥά οἱ πάρος ἐγγυάλιξεν	-uu -uu- u u - uu -uu--	dactylic hexameter	masculine penthemimeral, hepthemimeral
Λημνιὰς Ὑψιπύλη, ἀδινῆς μνημήιον εὐνῆς.	-uu -uu- uu- --uu --	dactylic hexameter	masculine penthemimeral, hepthemimeral
πήχυιον δʼ ἄρʼ ἔπειτα πέδῳ ἔνι βόθρον ὀρύξας	--- u u-u u- uu -u u--	dactylic hexameter	feminine penthemimeral, hepthemimeral, trithemimeral
νήησε σχίζας, ἐπὶ δʼ ἀρνειοῦ τάμε λαιμόν,	--- -- uu --- uu --	dactylic hexameter	masculine penthemimeral, trithemimeral
αὐτόν τʼ εὖ καθύπερθε τανύσσατο· δαῖε δὲ φιτρους	-- - uu-u u-uu -u u --	dactylic hexameter	feminine penthemimeral, trithemimeral
πῦρ ὑπένερθεν ἱείς, ἐπὶ δὲ μιγάδας χέε λοιβάς,	- uu-u u- uu - uu- uu --	dactylic hexameter	masculine penthemimeral, hepthemimeral
Βριμὼ κικλήσκων Ἑκάτην ἐπαρωγὸν ἀέθλων.	-- --- uu- uu-u u--	dactylic hexameter	masculine penthemimeral, hepthemimeral
καί ῥʼ ὁ μὲν ἀγκαλέσας πάλιν ἔστιχεν· ἡ δʼ ἀίουσα	- u u -uu- uu -uu - uu--	dactylic hexameter	masculine penthemimeral
κευθμῶν ἐξ ὑπάτων δεινὴ θεὸς ἀντεβόλησεν	-- - uu- -- uu -uu--	dactylic hexameter	masculine penthemimeral, hepthemimeral, trithemimeral
ἱροῖς Αἰσονίδαο· πέριξ δέ μιν ἐστεφάνωντο	-- -uu-u u- u u -uu--	dactylic hexameter	feminine penthemimeral, hepthemimeral
σμερδαλέοι δρυΐνοισι μετὰ πτόρθοισι δράκοντες.	-uu- uu-u u- --u u--	dactylic hexameter	feminine penthemimeral, hepthemimeral, trithemimeral
στράπτε δʼ ἀπειρέσιον δαΐδων σέλας· ἀμφὶ δὲ τήνγε	-u u-uu- uu- uu -u u --	dactylic hexameter	masculine penthemimeral, hepthemimeral
ὀξείῃ ὑλακῇ χθόνιοι κύνες ἐφθέγγοντο.	--- uu- uu- uu ----	dactylic hexameter	masculine penthemimeral, hepthemimeral, trithemimeral
πίσεα δʼ ἔτρεμε πάντα κατὰ στίβον· αἱ δʼ ὀλόλυξαν	-uu -uu -u u- uu - uu--	dactylic hexameter	feminine penthemimeral, hepthemimeral
νύμφαι ἑλειονόμοι ποταμηίδες, αἳ περὶ κείνην	-u u-uu- uu-uu - uu --	dactylic hexameter	masculine penthemimeral
Φάσιδος εἱαμενὴν Ἀμαραντίου εἱλίσσονται.	-uu -uu- uu-uu ----	dactylic hexameter	masculine penthemimeral
Αἰσονίδην δʼ ἤτοι μὲν ἕλεν δέος, ἀλλά μιν οὐδʼ ὧς	-uu- -- u u- uu -u u - -	dactylic hexameter	masculine penthemimeral, hepthemimeral, trithemimeral
ἐντροπαλιζόμενον πόδες ἔκφερον, ὄφρʼ ἑτάροισιν	-uu-uu- uu -uu - uu--	dactylic hexameter	masculine penthemimeral
μίκτο κιών· ἤδη δὲ φόως νιφόεντος ὕπερθεν	-u u- -- u u- uu-u u--	dactylic hexameter	masculine penthemimeral, hepthemimeral, trithemimeral
Καυκάσου ἠριγενὴς Ἠὼς βάλεν ἀντέλλουσα.	-uu -uu- -- uu ----	dactylic hexameter	masculine penthemimeral, hepthemimeral
καὶ τότʼ ἄρʼ Αἰήτης περὶ μὲν στήθεσσιν ἕεστο	- u u --- uu - --u u--	dactylic hexameter	masculine penthemimeral, hepthemimeral
θώρηκα στάδιον, τόν οἱ πόρεν ἐξεναρίξας	--- uu- - - uu -uu--	dactylic hexameter	masculine penthemimeral, hepthemimeral, trithemimeral
σφωιτέραις Φλεγραῖον Ἄρης ὑπὸ χερσὶ Μίμαντα·	-uu- --u u- uu -u u--	dactylic hexameter	feminine penthemimeral, hepthemimeral, trithemimeral
χρυσείην δʼ ἐπὶ κρατὶ κόρυν θέτο τετραφάληρον,	--- uu -u u- uu -uu--	dactylic hexameter	feminine penthemimeral, hepthemimeral, trithemimeral
λαμπομένην οἷόν τε περίτροχον ἔπλετο φέγγος	-uu- -- u u-uu -uu --	dactylic hexameter	masculine penthemimeral, trithemimeral
ἠελίου, ὅτε πρῶτον ἀνέρχεται Ὠκεανοῖο.	-uu- uu -u u-uu -uu--	dactylic hexameter	feminine penthemimeral, trithemimeral
ἂν δὲ πολύρρινον νώμα σάκος, ἂν δὲ καὶ ἔγχος	- u u--- -- uu - u u --	dactylic hexameter	masculine penthemimeral, hepthemimeral
δεινόν, ἀμαιμάκετον· τὸ μὲν οὔ κέ τις ἄλλος ὑπέστη	-u u-uu- u u - u u -u u--	dactylic hexameter	masculine penthemimeral, hepthemimeral
ἀνδρῶν ἡρώων, ὅτε κάλλιπον Ἡρακλῆα	-- --- uu -uu ----	dactylic hexameter	masculine penthemimeral
τῆλε παρέξ, ὅ κεν οἶος ἐναντίβιον πολέμιξεν.	-u u- u u -u u-uu- uu--	dactylic hexameter	feminine penthemimeral, trithemimeral
τῷ δὲ καὶ ὠκυπόδων ἵππων εὐπηγέα δίφρον	- u u -uu- -- --uu --	dactylic hexameter	masculine penthemimeral, hepthemimeral
ἔσχε πέλας Φαέθων ἐπιβήμεναι· ἂν δὲ καὶ αὐτὸς	-u u- uu- uu-uu - u u --	dactylic hexameter	masculine penthemimeral, trithemimeral
βήσατο, ῥυτῆρας δὲ χεροῖν ἔχεν. ἐκ δὲ πόληος	-uu --- u u- uu - u u--	dactylic hexameter	masculine penthemimeral, hepthemimeral
ἤλασεν εὐρεῖαν κατʼ ἀμαξιτόν, ὥς κεν ἀέθλῳ	-uu --- u u-uu - u u--	dactylic hexameter	masculine penthemimeral
παρσταίη· σὺν δέ σφιν ἀπείριτος ἔσσυτο λαός.	--- - - u u-uu -uu --	dactylic hexameter	masculine penthemimeral, trithemimeral
οἷος δʼ Ἴσθμιον εἶσι Ποσειδάων ἐς ἀγῶνα	-- -uu -u u--- u u--	dactylic hexameter	feminine penthemimeral
ἅρμασιν ἐμβεβαώς, ἢ Ταίναρον, ἢ ὅγε Λέρνης	-uu -uu- - -uu - uu --	dactylic hexameter	masculine penthemimeral
ὕδωρ, ἠὲ κατʼ ἄλσος Ὑαντίου Ὀγχηστοῖο,	-- -u u -u u-uu ----	dactylic hexameter	feminine penthemimeral
καί τε Καλαύρειαν μετὰ δῆθʼ ἅμα νίσσεται ἵπποις,	- u u--- uu - uu -uu --	dactylic hexameter	masculine penthemimeral, hepthemimeral
πέτρην θ᾽Αἱμονίην, ἢ δενδρήεντα Γεραιστόν·	-- -uu- - ---u u--	dactylic hexameter	masculine penthemimeral
τοῖος ἄρʼ Αἰήτης Κόλχων ἀγὸς ἦεν ἰδέσθαι.	-u u --- -- uu -u u--	dactylic hexameter	masculine penthemimeral, hepthemimeral
τόφρα δὲ Μηδείης ὑποθημοσύνῃσιν Ἰήσων	-u u --- uu-uu-u u--	dactylic hexameter	masculine penthemimeral
φάρμακα μυδήνας ἠμὲν σάκος ἀμφεπάλυνεν	-uu --- -- uu -uu--	dactylic hexameter	masculine penthemimeral, hepthemimeral
ἠδὲ δόρυ βριαρόν, περὶ δὲ ξίφος· ἀμφὶ δʼ ἑταῖροι	-u u- uu- uu - uu -u u--	dactylic hexameter	masculine penthemimeral, hepthemimeral, trithemimeral
πείρησαν τευχέων βεβιημένοι, οὐδʼ ἐδύναντο	--- -- uu-uu - uu--	dactylic hexameter	masculine penthemimeral, trithemimeral
κεῖνο δόρυ γνάμψαι τυτθόν γέ περ, ἀλλὰ μάλʼ αὔτως	-u u- -- -- u u -u u --	dactylic hexameter	masculine penthemimeral, hepthemimeral, trithemimeral
ἀαγὲς κρατερῇσιν ἐνεσκλήκει παλάμῃσιν.	--- uu-u u--- uu--	dactylic hexameter	feminine penthemimeral, trithemimeral
αὐτὰρ ὁ τοῖς ἄμοτον κοτέων Ἀφαρήιος Ἴδας	-u u - uu- uu- uu-uu --	dactylic hexameter	masculine penthemimeral, hepthemimeral, trithemimeral
κόψε παρʼ οὐρίαχον μεγάλῳ ξίφει· ἆλτο δʼ ἀκωκὴ	-u u -uu- uu- uu -u u--	dactylic hexameter	masculine penthemimeral, hepthemimeral
ῥαιστὴρ ἄκμονος ὥστε, παλιντυπές· οἱ δʼ ὁμάδησαν	-- -uu -u u-uu - uu--	dactylic hexameter	feminine penthemimeral
γηθόσυνοι ἥρωες ἐπʼ ἐλπωρῇσιν ἀέθλου.	-uu- --u u ---u u--	dactylic hexameter	feminine penthemimeral, trithemimeral
καὶ δʼ αὐτὸς μετέπειτα παλύνετο· δῦ δέ μιν ἀλκὴ	- -- uu-u u-uu - u u --	dactylic hexameter	feminine penthemimeral, trithemimeral
σμερδαλέη ἄφατός τε καὶ ἄτρομος· αἱ δʼ ἑκάτερθεν	-uu- uu- u u -uu - uu--	dactylic hexameter	masculine penthemimeral, trithemimeral
χεῖρες ἐπερρώσαντο περὶ σθένεϊ σφριγόωσαι.	-u u---u u- uu- uu--	dactylic hexameter	feminine penthemimeral, hepthemimeral
ὡς δʼ ὅτʼ ἀρήιος ἵππος ἐελδόμενος πολέμοιο	- u u-uu -u u-uu- uu--	dactylic hexameter	feminine penthemimeral
σκαρθμῷ ἐπιχρεμέθων κρούει πέδον, αὐτὰρ ὕπερθεν	-u u-uu- -- uu -u u--	dactylic hexameter	masculine penthemimeral, hepthemimeral
κυδιόων ὀρθοῖσιν ἐπʼ οὔασιν αὐχένʼ ἀείρει·	-uu- --u u -uu -u u--	dactylic hexameter	feminine penthemimeral, trithemimeral
τοῖος ἄρʼ Αἰσονίδης ἐπαγαίετο κάρτεϊ γυίων.	-u u -uu- uu-uu -uu --	dactylic hexameter	masculine penthemimeral
πολλὰ δʼ ἄρʼ ἔνθα καὶ ἔνθα μετάρσιον ἴχνος ἔπαλλεν,	-u u -u u -u u-uu -u u--	dactylic hexameter	feminine penthemimeral
ἀσπίδα χαλκείην μελίην τʼ ἐν χερσὶ τινάσσων.	-uu --- uu- - -u u--	dactylic hexameter	masculine penthemimeral, hepthemimeral
φαίης κε ζοφεροῖο κατʼ αἰθέρος ἀίσσουσαν	-- - uu-u u -uu ----	dactylic hexameter	feminine penthemimeral, trithemimeral
χειμερίην στεροπὴν θαμινὸν μεταπαιφάσσεσθαι	-uu- uu- uu- uu----	dactylic hexameter	masculine penthemimeral, hepthemimeral, trithemimeral
ἐκ νεφέων, ὅτʼ ἔπειτα μελάντατον ὄμβρον ἄγωνται.	- uu- u u-u u-uu -u u--	dactylic hexameter	feminine penthemimeral, trithemimeral
καὶ τότʼ ἔπειτʼ οὐ δηρὸν ἔτι σχήσεσθαι ἀέθλων	- u u- - -u u- --u u--	dactylic hexameter	feminine penthemimeral, hepthemimeral, trithemimeral
μέλλον· ἀτὰρ κληῖσιν ἐπισχερὼ ἱδρυνθέντες	-u u- --u u-uu ----	dactylic hexameter	feminine penthemimeral, trithemimeral
ῥίμφα μάλʼ ἐς πεδίον τὸ Ἀρήιον ἠπείγοντο.	-u u - uu- u u-uu ----	dactylic hexameter	masculine penthemimeral, trithemimeral
τόσσον δὲ προτέρω πέλεν ἄστεος ἀντιπέρηθεν,	-- - uu- uu -uu -uu--	dactylic hexameter	masculine penthemimeral, trithemimeral
ὅσσον τʼ ἐκ βαλβῖδος ἐπήβολος ἅρματι νύσσα	-- - --u u-uu -uu --	dactylic hexameter	feminine penthemimeral, trithemimeral
γίγνεται, ὁππότʼ ἄεθλα καταφθιμένοιο ἄνακτος	-uu -u u-u u-uu-u u--	dactylic hexameter	feminine penthemimeral
κηδεμόνες πεζοῖσι καὶ ἱππήεσσι τίθενται.	-uu- --u u ---u u--	dactylic hexameter	feminine penthemimeral, trithemimeral
τέτμον δʼ Αἰήτην τε καὶ ἄλλων ἔθνεα Κόλχων,	-- --- u u -- -uu --	dactylic hexameter	masculine penthemimeral
τοὺς μὲν Καυκασίοισιν ἐφεσταότας σκοπέλοισιν,	- - -uu-u u-uu- uu--	dactylic hexameter	feminine penthemimeral
τὸν δʼ αὐτοῦ παρὰ χεῖλος ἑλισσόμενον ποταμοῖο.	- -- uu -u u-uu- uu--	dactylic hexameter	feminine penthemimeral, trithemimeral
Αἰσονίδης δʼ ,ὅτε δὴ πρυμνήσια δῆσαν ἑταῖροι,	-uu- uu - --uu -u u--	dactylic hexameter	masculine penthemimeral, trithemimeral
δή ῥα τότε ξὺν δουρὶ καὶ ἀσπίδι βαῖνʼ ἐς ἄεθλον,	- u u- - -u u -uu - u u--	dactylic hexameter	feminine penthemimeral, trithemimeral
νηὸς ἀποπροθορών· ἄμυδις δʼ ἕλε παμφανόωσαν	-u u-uu- uu- uu -uu--	dactylic hexameter	masculine penthemimeral, hepthemimeral
χαλκείην πήληκα θοῶν ἔμπλειον ὀδόντων	--- --u u- --u u--	dactylic hexameter	feminine penthemimeral, hepthemimeral, trithemimeral
καὶ ξίφος ἀμφʼ ὤμοις, γυμνὸς δέμας, ἄλλα μὲν Ἄρει	- uu - -- -- uu -u u --	dactylic hexameter	masculine penthemimeral, hepthemimeral, trithemimeral
εἴκελος, ἄλλα δέ που χρυσαόρῳ Ἀπόλλωνι.	-uu -u u - --uu ----	dactylic hexameter	masculine penthemimeral
παπτήνας δʼ ἀνὰ νειὸν ἴδε ζυγὰ χάλκεα ταύρων	--- uu -u u- uu -uu --	dactylic hexameter	feminine penthemimeral, hepthemimeral, trithemimeral
αὐτόγυόν τʼ ἐπὶ τοῖς στιβαροῦ ἀδάμαντος ἄροτρον.	-uu- uu - uu- uu-u u--	dactylic hexameter	masculine penthemimeral, hepthemimeral, trithemimeral
χρίμψε δʼ ἔπειτα κιών, παρὰ δʼ ὄβριμον ἔγχος ἔπηξεν	-u u-u u- uu -uu -u u--	dactylic hexameter	masculine penthemimeral
ὀρθὸν ἐπʼ οὐριάχῳ, κυνέην δʼ ἀποκάτθετʼ ἐρείσας.	-u u -uu- uu- uu-u u--	dactylic hexameter	masculine penthemimeral, hepthemimeral
βῆ δʼ αὐτῇ προτέρωσε σὺν ἀσπίδι νήριτα ταύρων	- -- uu-u u -uu -uu --	dactylic hexameter	feminine penthemimeral, trithemimeral
ἴχνια μαστεύων· οἱ δʼ ἔκποθεν ἀφράστοιο	-uu --- - -uu ----	dactylic hexameter	masculine penthemimeral
κευθμῶνος χθονίου, ἵνα τέ σφισιν ἔσκε βόαυλα	--- uu- uu - uu -u u--	dactylic hexameter	masculine penthemimeral, hepthemimeral, trithemimeral
καρτερὰ λιγνυόεντι πέριξ εἰλυμένα καπνῷ,	-uu -uu-u u- --uu --	dactylic hexameter	feminine penthemimeral, hepthemimeral
ἄμφω ὁμοῦ προγένοντο πυρὸς σέλας ἀμπνείοντες.	-u u- uu-u u- uu ----	dactylic hexameter	feminine penthemimeral, hepthemimeral, trithemimeral
ἔδδεισαν δʼ ἥρωες, ὅπως ἴδον. αὐτὰρ ὁ τούσγε,	--- --u u- uu -u u --	dactylic hexameter	feminine penthemimeral, hepthemimeral, trithemimeral
εὖ διαβάς, ἐπιόντας, ἅ τε σπιλὰς εἰν ἁλὶ πέτρη	- uu- uu-u u - uu - uu --	dactylic hexameter	feminine penthemimeral, hepthemimeral, trithemimeral
μίμνει ἀπειρεσίῃσι δονεύμενα κύματʼ ἀέλλαις.	-u u-uu-u u-uu -u u--	dactylic hexameter	feminine penthemimeral
πρόσθε δέ οἱ σάκος ἔσχεν ἐναντίον· οἱ δέ μιν ἄμφω	-u u - uu -u u-uu - u u --	dactylic hexameter	feminine penthemimeral, trithemimeral
μυκηθμῷ κρατεροῖσιν ἐνέπληξαν κεράεσσιν·	--- uu-u u--- uu--	dactylic hexameter	feminine penthemimeral, trithemimeral
οὐδʼ ἄρα μιν τυτθόν περ ἀνώχλισαν ἀντιόωντες.	- uu - -- u u-uu -uu--	dactylic hexameter	masculine penthemimeral, trithemimeral
ὡς δʼ ὅτʼ ἐνὶ τρητοῖσιν ἐύρρινοι χοάνοισιν	- u u- --u u--- uu--	dactylic hexameter	feminine penthemimeral, trithemimeral
φῦσαι χαλκήων ὁτὲ μέν τʼ ἀναμαρμαίρουσιν,	-- --- uu - uu----	dactylic hexameter	masculine penthemimeral, hepthemimeral
πῦρ ὀλοόν πιμπρᾶσαι, ὅτʼ αὖ λήγουσιν ἀυτμῆς,	- uu- --u u - --u u--	dactylic hexameter	feminine penthemimeral, hepthemimeral, trithemimeral
δεινὸς δʼ ἐξ αὐτοῦ πέλεται βρόμος, ὁππότʼ ἀίξῃ	-- - -- uu- uu -u u--	dactylic hexameter	masculine penthemimeral, hepthemimeral, trithemimeral
νειόθεν· ὧς ἄρα τώγε θοὴν φλόγα φυσιόωντες	-uu - uu -u u- uu -uu--	dactylic hexameter	feminine penthemimeral, hepthemimeral, trithemimeral
ἐκ στομάτων ὁμάδευν, τὸν δʼ ἄμφεπε δήιον αἶθος	- uu- uu- - -uu -uu --	dactylic hexameter	masculine penthemimeral, trithemimeral
βάλλον ἅ τε στεροπή· κούρης δέ ἑ φάρμακʼ ἔρυτο.	-u u - uu- -- u u -u u--	dactylic hexameter	masculine penthemimeral, hepthemimeral, trithemimeral
καί ῥʼ ὅγε δεξιτεροῖο βοὸς κέρας ἄκρον ἐρύσσας	- uu -uu-u u- uu -u u--	dactylic hexameter	feminine penthemimeral, hepthemimeral
εἷλκεν ἐπικρατέως παντὶ σθένει, ὄφρα πελάσσῃ	-u u-uu- -- uu -u u--	dactylic hexameter	masculine penthemimeral, hepthemimeral
ζεύγλῃ χαλκείῃ, τὸν δʼ ἐν χθονὶ κάββαλεν ὀκλάξ,	-- --- - - uu -uu --	dactylic hexameter	masculine penthemimeral, hepthemimeral
ῥίμφα ποδὶ κρούσας πόδα χάλκεον. ὧς δὲ καὶ ἄλλον	-u u- -- uu -uu - u u --	dactylic hexameter	masculine penthemimeral, trithemimeral
σφῆλεν γνὺξ ἐπιόντα, μιῇ βεβολημένον ὁρμῇ.	-- - uu-u u- uu-uu --	dactylic hexameter	feminine penthemimeral, hepthemimeral, trithemimeral
εὐρὺ δʼ ἀποπροβαλὼν χαμάδις σάκος, ἔνθα καὶ ἔνθα	-u u-uu- uu- uu -u u --	dactylic hexameter	masculine penthemimeral, hepthemimeral
τῇ καὶ τῇ βεβαὼς ἄμφω ἔχε πεπτηῶτας	- - - uu- -- uu ----	dactylic hexameter	masculine penthemimeral, hepthemimeral, trithemimeral
γούνασιν ἐν προτέροισι, διὰ φλογὸς εἶθαρ ἐλυσθείς.	-uu - uu-u u- uu -u u--	dactylic hexameter	feminine penthemimeral, hepthemimeral, trithemimeral
θαύμασε δʼ Αἰήτης σθένος ἀνέρος. οἱ δʼ ἄρα τείως	-uu --- uu -uu - uu --	dactylic hexameter	masculine penthemimeral
Τυνδαρίδαι (δὴ γάρ σφι πάλαι προπεφραδμένον ἦεν)	-uu- - - u u- uu-uu --	dactylic hexameter	masculine penthemimeral, hepthemimeral, trithemimeral
ἀγχίμολον ζυγά οἱ πεδόθεν δόσαν ἀμφιβαλέσθαι.	-uu- uu - uu- uu -uu--	dactylic hexameter	masculine penthemimeral, hepthemimeral, trithemimeral
αὐτὰρ ὁ εὖ ἐνέδησε λόφους· μεσσηγὺ δʼ ἀείρας	-u u - uu-u u- --u u--	dactylic hexameter	feminine penthemimeral, hepthemimeral, trithemimeral
χάλκεον ἱστοβοῆα, θοῇ συνάρασσε κορώνῃ	-uu -uu-u u- uu-u u--	dactylic hexameter	feminine penthemimeral, hepthemimeral
ζεύγληθεν. καὶ τὼ μὲν ὑπὲκ πυρὸς ἂψ ἐπὶ νῆα	--- - - u u- uu - uu --	dactylic hexameter	masculine penthemimeral, hepthemimeral, trithemimeral
χαζέσθην. ὁ δʼ ἄρʼ αὖτις ἑλὼν σάκος ἔνθετο νώτῳ	--- u u -u u- uu -uu --	dactylic hexameter	feminine penthemimeral, hepthemimeral, trithemimeral
ἐξόπιθεν, καὶ γέντο θοῶν ἔμπλειον ὀδόντων	-uu- - -u u- --u u--	dactylic hexameter	feminine penthemimeral, hepthemimeral, trithemimeral
πήληκα βριαρὴν δόρυ τʼ ἄσχετον, ᾧ ῥ' ὑπὸ μέσσας	--- uu- uu -uu - uu --	dactylic hexameter	masculine penthemimeral, trithemimeral
ἐργατίνης ὥς τίς τε Πελασγίδι νύσσεν ἀκαίνῃ	-uu- - - u u-uu -u u--	dactylic hexameter	masculine penthemimeral, trithemimeral
οὐτάζων λαγόνας· μάλα δʼ ἔμπεδον εὖ ἀραρυῖαν	--- uu- uu -uu - uu--	dactylic hexameter	masculine penthemimeral, trithemimeral
τυκτὴν ἐξ ἀδάμαντος ἐπιθύνεσκεν ἐχέτλην.	-- - uu-u u---u u--	dactylic hexameter	feminine penthemimeral, trithemimeral
οἱ δʼ εἵως μὲν δὴ περιώσια θυμαίνεσκον,	- -- - - uu-uu ----	dactylic hexameter	masculine penthemimeral, trithemimeral
λάβρον ἐπιπνείοντε πυρὸς σέλας· ὦρτο δʼ ἀυτμὴ	-u u---u u- uu -u u--	dactylic hexameter	feminine penthemimeral, hepthemimeral
ἠύτε βυκτάων ἀνέμων βρόμος, οὕς τε μάλιστα	-uu --- uu- uu - u u--	dactylic hexameter	masculine penthemimeral, hepthemimeral
δειδιότες μέγα λαῖφος ἁλίπλοοι ἐστείλαντο.	-uu- uu -u u-uu ----	dactylic hexameter	feminine penthemimeral, trithemimeral
δηρὸν δʼ οὐ μετέπειτα κελευόμενοι ὑπὸ δουρὶ	-- - uu-u u-uu- uu --	dactylic hexameter	feminine penthemimeral, trithemimeral
ἤισαν· ὀκριόεσσα δʼ ἐρείκετο νειὸς ὀπίσσω,	-uu -uu-u u-uu -u u--	dactylic hexameter	feminine penthemimeral
σχιζομένη ταύρων τε βίῃ κρατερῷ τʼ ἀροτῆρι.	-uu- -- u u- uu- uu--	dactylic hexameter	masculine penthemimeral, hepthemimeral, trithemimeral
δεινὸν δʼ ἐσμαράγευν ἄμυδις κατὰ ὦλκας ἀρότρου	-- -uu- uu- uu -u u--	dactylic hexameter	masculine penthemimeral, hepthemimeral
βώλακες ἀγνύμεναι ἀνδραχθέες· εἵπετο δʼ αὐτὸς	-uu -uu- --uu -uu --	dactylic hexameter	masculine penthemimeral
λαῖον ἐπὶ στιβαρῷ πιέσας ποδί· τῆλε δʼ ἑοῖο	-u u- uu- uu- uu -u u--	dactylic hexameter	masculine penthemimeral, hepthemimeral, trithemimeral
βάλλεν ἀρηρομένην αἰεὶ κατὰ βῶλον ὀδόντας	-u u-uu- -- uu -u u--	dactylic hexameter	masculine penthemimeral, hepthemimeral
ἐντροπαλιζόμενος, μή οἱ πάρος ἀντιάσειεν	-uu-uu- - - uu -uu--	dactylic hexameter	masculine penthemimeral, hepthemimeral
γηγενέων ἀνδρῶν ὀλοὸς στάχυς· οἱ δʼ ἄρʼ ἐπιπρὸ	-uu- -- uu- uu - u u--	dactylic hexameter	masculine penthemimeral, hepthemimeral, trithemimeral
χαλκείῃς χηλῇσιν ἐρειδόμενοι πονέοντο.	--- --u u-uu- uu--	dactylic hexameter	feminine penthemimeral, trithemimeral
ἦμος δὲ τρίτατον λάχος ἤματος ἀνομένοιο	-- - uu- uu -uu -uu--	dactylic hexameter	masculine penthemimeral, trithemimeral
λείπεται ἐξ ἠοῦς, καλέουσι δὲ κεκμηῶτες	-uu - -- uu-u u ----	dactylic hexameter	masculine penthemimeral, trithemimeral
ἐργατίναι γλυκερόν σφιν ἄφαρ βουλυτὸν ἱκέσθαι,	-uu- uu- u u- --u u--	dactylic hexameter	masculine penthemimeral, hepthemimeral, trithemimeral
τῆμος ἀρήροτο νειὸς ὑπʼ ἀκαμάτῳ ἀροτῆρι,	-u u-uu -u u -uu- uu--	dactylic hexameter	feminine penthemimeral
τετράγυός περ ἐοῦσα· βοῶν τʼ ἀπελύετʼ ἄροτρα.	-uu- u u-u u- uu-u u--	dactylic hexameter	feminine penthemimeral, hepthemimeral, trithemimeral
καὶ τοὺς μὲν πεδίονδε διεπτοίησε φέβεσθαι·	- - - uu-u u---u u--	dactylic hexameter	feminine penthemimeral, trithemimeral
αὐτὰρ ὁ ἂψ ἐπὶ νῆα πάλιν κίεν, ὄφρʼ ἔτι κεινὰς	-u u - uu -u u- uu - uu --	dactylic hexameter	feminine penthemimeral, hepthemimeral, trithemimeral
γηγενέων ἀνδρῶν ἴδεν αὔλακας. ἀμφὶ δʼ ἑταῖροι	-uu- -- uu -uu -u u--	dactylic hexameter	masculine penthemimeral, trithemimeral
θάρσυνον μύθοισιν. ὁ δʼ ἐκ ποταμοῖο ῥοάων	--- --u u - uu-u u--	dactylic hexameter	feminine penthemimeral, hepthemimeral, trithemimeral
αὐτῇ ἀφυσσάμενος κυνέῃ σβέσεν ὕδατι δίψαν·	-u u-uu- uu- uu -uu --	dactylic hexameter	masculine penthemimeral, hepthemimeral
γνάμψε δὲ γούνατʼ ἐλαφρά, μέγαν δʼ ἐμπλήσατο θυμὸν	-u u -u u-u u- --uu --	dactylic hexameter	feminine penthemimeral, hepthemimeral
ἀλκῆς, μαιμώων συῒ εἴκελος, ὅς ῥά τʼ ὀδόντας	-- --- uu -uu - u u--	dactylic hexameter	masculine penthemimeral
θήγει θηρευτῇσιν ἐπʼ ἀνδράσιν, ἀμφὶ δὲ πολλὸς	-- ---u u -uu -u u --	dactylic hexameter	feminine penthemimeral
ἀφρὸς ἀπὸ στόματος χαμάδις ῥεῖ χωομένοιο.	-u u- uu- uu- - -uu--	dactylic hexameter	masculine penthemimeral, hepthemimeral, trithemimeral
οἱ δʼ ἤδη κατὰ πᾶσαν ἀνασταχύεσκον ἄρουραν	- -- uu -u u-uu-u u--	dactylic hexameter	feminine penthemimeral, trithemimeral
γηγενέες· φρίξεν δὲ περὶ στιβαροῖς σακέεσσιν	-uu- -- u u- uu- uu--	dactylic hexameter	masculine penthemimeral, hepthemimeral, trithemimeral
δούρασί τʼ ἀμφιγύοις κορύθεσσί τε λαμπομένῃσιν	-uu -uu- uu-u u -uu--	dactylic hexameter	masculine penthemimeral
Ἄρηος τέμενος φθισιμβρότου· ἵκετο δʼ αἴγλη	--- uu- --uu -uu --	dactylic hexameter	masculine penthemimeral, trithemimeral
νειόθεν Οὔλυμπόνδε διʼ ἠέρος ἀστράπτουσα.	-uu ---u u -uu ----	dactylic hexameter	feminine penthemimeral
ὡς δʼ ὁπότʼ ἐς γαῖαν πολέος νιφετοῖο πεσόντος	- uu - -- uu- uu-u u--	dactylic hexameter	masculine penthemimeral, hepthemimeral, trithemimeral
ἂψ ἀπὸ χειμερίας νεφέλας ἐκέσασσαν ἄελλαι	- uu -uu- uu- uu-u u--	dactylic hexameter	masculine penthemimeral, hepthemimeral
λυγαίῃ ὑπὸ νυκτί, τὰ δʼ ἀθρόα πάντʼ ἐφαάνθη	--- uu -u u -uu - uu--	dactylic hexameter	feminine penthemimeral, trithemimeral
τείρεα λαμπετόωντα διὰ κνέφας· ὧς ἄρα τοίγε	-uu -uu-u u- uu - uu --	dactylic hexameter	feminine penthemimeral, hepthemimeral
λάμπον ἀναλδήσκοντες ὑπὲρ χθονός. αὐτὰρ Ἰήσων	-u u---u u- uu -u u--	dactylic hexameter	feminine penthemimeral, hepthemimeral
μνήσατο Μηδείης πολυκερδέος ἐννεσιάων,	-uu --- uu-uu -uu--	dactylic hexameter	masculine penthemimeral
λάζετο δʼ ἐκ πεδίοιο μέγαν περιηγέα πέτρον,	-uu - uu-u u- uu-uu --	dactylic hexameter	feminine penthemimeral, hepthemimeral, trithemimeral
δεινὸν Ἐνυαλίου σόλον Ἄρεος· οὔ κέ μιν ἄνδρες	-u u-uu- uu -uu - u u --	dactylic hexameter	masculine penthemimeral
αἰζηοὶ πίσυρες γαίης ἄπο τυτθὸν ἄειραν.	--- uu- -- uu -u u--	dactylic hexameter	masculine penthemimeral, hepthemimeral, trithemimeral
τόν ῥʼ ἀνὰ χεῖρα λαβὼν μάλα τηλόθεν ἔμβαλε μέσσοις	- uu -u u- uu -uu -uu --	dactylic hexameter	masculine penthemimeral
ἀίξας· αὐτὸς δʼ ὑφʼ ἑὸν σάκος ἕζετο λάθρῃ	--- -- u u- uu -uu --	dactylic hexameter	masculine penthemimeral, hepthemimeral, trithemimeral
θαρσαλέως. Κόλχοι δὲ μέγʼ ἴαχον, ὡς ὅτε πόντος	-uu- -- u u -uu - uu --	dactylic hexameter	masculine penthemimeral, trithemimeral
ἴαχεν ὀξείῃσιν ἐπιβρομέων σπιλάδεσσιν·	-uu ---u u-uu- uu--	dactylic hexameter	feminine penthemimeral
τὸν δʼ ἕλεν ἀμφασίη ῥιπῇ στιβαροῖο σόλοιο	- uu -uu- -- uu-u u--	dactylic hexameter	masculine penthemimeral, hepthemimeral
Αἰήτην. οἱ δʼ ὥστε θοοὶ κύνες ἀμφιθορόντες	--- - -u u- uu -uu--	dactylic hexameter	feminine penthemimeral, hepthemimeral, trithemimeral
ἀλλήλους βρυχηδὸν ἐδήιον· οἱ δʼ ἐπὶ γαῖαν	--- --u u-uu - uu --	dactylic hexameter	feminine penthemimeral, trithemimeral
μητέρα πῖπτον ἑοῖς ὑπὸ δούρασιν, ἠύτε πεῦκαι	-uu -u u- uu -uu -uu --	dactylic hexameter	masculine penthemimeral
ἢ δρύες, ἅς τʼ ἀνέμοιο κατάικες δονέουσιν.	- uu - uu-u u--- uu--	dactylic hexameter	feminine penthemimeral, trithemimeral
οἷος δʼ οὐρανόθεν πυρόεις ἀναπάλλεται ἀστὴρ	-- -uu- uu- uu-uu --	dactylic hexameter	masculine penthemimeral, hepthemimeral
ὁλκὸν ὑπαυγάζων, τέρας ἀνδράσιν, οἵ μιν ἴδωντοι	-u u--- uu -uu - u u--	dactylic hexameter	masculine penthemimeral
μαρμαρυγῇ σκοτίοιο διʼ ἠέρος ἀίξαντα·	-uu- uu-u u -uu ----	dactylic hexameter	feminine penthemimeral, trithemimeral
τοῖος ἄρʼ Αἴσονος υἱὸς ἐπέσσυτο γηγενέεσσιν,	-u u -uu -u u-uu -uu--	dactylic hexameter	feminine penthemimeral
γυμνὸν δʼ ἐκ κολεοῖο φέρε ξίφος, οὖτα δὲ μίγδην	-- - uu-u u- uu -u u --	dactylic hexameter	feminine penthemimeral, hepthemimeral, trithemimeral
ἀμώων, πολέας μὲν ἔτʼ ἐς νηδὺν λαγόνας τε	--- uu- u u - -- uu- -	dactylic hexameter	masculine penthemimeral, hepthemimeral, trithemimeral
ἡμίσεας ἀνέχοντας ἐς ἠέρα· τοὺς δὲ καὶ ἄχρις	-uu- uu-u u -uu - u u --	dactylic hexameter	feminine penthemimeral, trithemimeral
ὤμων τελλομένους· τοὺς δὲ νέον ἑστηῶτας,	-- -uu- - - uu ----	dactylic hexameter	masculine penthemimeral, hepthemimeral
τοὺς δʼ ἤδη καὶ ποσσὶν ἐπειγομένους ἐς ἄρηα.	- -- - -u u-uu- u u--	dactylic hexameter	feminine penthemimeral, trithemimeral
ὡς δʼ ὁπότʼ ἀμφʼ οὔροισιν ἐγειρομένου πολέμοιο,	- uu - --u u-uu- uu--	dactylic hexameter	feminine penthemimeral, trithemimeral
δείσας γειομόρος, μή οἱ προτάμωνται ἀρούρας,	-- -uu- - - uu-u u--	dactylic hexameter	masculine penthemimeral, hepthemimeral
ἅρπην εὐκαμπῆ νεοθηγέα χερσὶ μεμαρπὼς	-- --- uu-uu -u u--	dactylic hexameter	masculine penthemimeral
ὠμὸν ἐπισπεύδων κείρει στάχυν, οὐδὲ βολῇσιν	-u u--- -- uu -u u--	dactylic hexameter	masculine penthemimeral, hepthemimeral
μίμνει ἐς ὡραίην τερσήμεναι ἠελίοιο·	-u u --- --uu -uu--	dactylic hexameter	masculine penthemimeral
ὧς τότε γηγενέων κεῖρε στάχυν· αἵματι δʼ ὁλκοὶ	- uu -uu- -- uu -uu --	dactylic hexameter	masculine penthemimeral, hepthemimeral
ἠύτε κρηναῖαι ἀμάραι πλήθοντο ῥοῇσιν.	-uu --- uu- --u u--	dactylic hexameter	masculine penthemimeral, hepthemimeral
πῖπτον δʼ ,οἱ μὲν ὀδὰξ τετρηχότα βῶλον ὀδοῦσιν	-- - u u- --uu -u u--	dactylic hexameter	masculine penthemimeral, trithemimeral
λαζόμενοι πρηνεῖς, οἱ δʼ ἔμπαλιν, οἱ δʼ ἐπʼ ἀγοστῷ	-uu- -- - -uu - u u--	dactylic hexameter	masculine penthemimeral, trithemimeral
καὶ πλευροῖς, κήτεσσι δομὴν ἀτάλαντοι ἰδέσθαι.	- -- --u u- uu-u u--	dactylic hexameter	feminine penthemimeral, hepthemimeral, trithemimeral
πολλοὶ δʼ οὐτάμενοι, πρὶν ὑπὸ χθονὸς ἴχνος ἀεῖραι,	-- -uu- u u- uu -u u--	dactylic hexameter	masculine penthemimeral, hepthemimeral
ὅσσον ἄνω προύτυψαν ἐς ἠέρα, τόσσον ἔραζε	-u u- --u u -uu -u u--	dactylic hexameter	feminine penthemimeral, trithemimeral
βριθόμενοι πλαδαροῖσι καρήασιν ἠρήρειντο.	-uu- uu-u u-uu ----	dactylic hexameter	feminine penthemimeral, trithemimeral
ἔρνεἀ που τοίως, Διὸς ἄσπετον ὀμβρήσαντος,	-uu - -- uu -uu ----	dactylic hexameter	masculine penthemimeral, trithemimeral
φυταλιῇ νεόθρεπτα κατημύουσιν ἔραζε	-uu- uu-u u---u u--	dactylic hexameter	feminine penthemimeral, trithemimeral
κλασθέντα ῥίζηθεν, ἀλωήων πόνος ἀνδρῶν·	--- --u u--- uu --	dactylic hexameter	feminine penthemimeral, trithemimeral
τὸν δὲ κατηφείη τε καὶ οὐλοὸν ἄλγος ἱκάνει	- u u--- u u -uu -u u--	dactylic hexameter	masculine penthemimeral
κλήρου σημαντῆρα φυτοτρόφον· ὧς τότʼ ἄνακτος	-- ---u u-uu - u u--	dactylic hexameter	feminine penthemimeral
Αἰήταο βαρεῖαι ὑπὸ φρένας ἦλθον ἀνῖαι.	---u u-u u- uu -u u--	dactylic hexameter	feminine penthemimeral, hepthemimeral
ἤιε δʼ ἐς πτολίεθρον ὑπότροπος ἄμμιγα Κόλχοις,	-uu - uu-u u-uu -uu --	dactylic hexameter	feminine penthemimeral, trithemimeral
πορφύρων, ᾗ κέ σφι θοώτερον ἀντιόῳτο.	--- - - u u-uu -uu--	dactylic hexameter	masculine penthemimeral, trithemimeral
ἦμαρ ἔδυ, καὶ τῷ τετελεσμένος ἦεν ἄεθλος.	-u u- - - uu-uu -u u--	dactylic hexameter	masculine penthemimeral, trithemimeral
