ἀρχόμενος σέο, Φοῖβε, παλαιγενέων κλέα φωτῶν	-uu- uu -u u-uu- uu --	dactylic hexameter	feminine penthemimeral, trithemimeral
μνήσομαι, οἳ Πόντοιο κατὰ στόμα καὶ διὰ πέτρας	-uu - --u u- uu - uu --	dactylic hexameter	feminine penthemimeral, hepthemimeral, trithemimeral
Κυανέας βασιλῆος ἐφημοσύνῃ Πελίαο	-uu- uu-u u-uu- uu--	dactylic hexameter	feminine penthemimeral, trithemimeral
χρύσειον μετὰ κῶας ἐύζυγον ἤλασαν Ἀργώ.	--- uu -u u-uu -uu --	dactylic hexameter	feminine penthemimeral, trithemimeral
τοίην γὰρ Πελίης φάτιν ἔκλυεν, ὥς μιν ὀπίσσω	-- - uu- uu -uu - u u--	dactylic hexameter	masculine penthemimeral, trithemimeral
μοῖρα μένει στυγερή, τοῦδʼ ἀνέρος, ὅντινʼ ἴδοιτο	-u u- uu- - -uu -u u--	dactylic hexameter	masculine penthemimeral, trithemimeral
δημόθεν οἰοπέδιλον, ὑπʼ ἐννεσίῃσι δαμῆναι.	-uu -uu-u u -uu-u u--	dactylic hexameter	feminine penthemimeral
δηρὸν δʼοὐ μετέπειτα τεὴν κατὰ βάξιν Ἰήσων	-- - uu-u u- uu -u u--	dactylic hexameter	feminine penthemimeral, hepthemimeral, trithemimeral
χειμερίοιο ῥέεθρα κιὼν διὰ ποσσὶν Ἀναύρου	-uu-u u-u u- uu -u u--	dactylic hexameter	feminine penthemimeral, hepthemimeral
ἄλλο μὲν ἐξεσάωσεν ὑπʼ ἰλύος, ἄλλο δʼ ἔνερθεν	-u u -uu-u u -uu -u u--	dactylic hexameter	feminine penthemimeral
κάλλιπεν αὖθι πέδιλον ἐνισχόμενον προχοῇσιν.	-uu -u u-u u-uu- uu--	dactylic hexameter	feminine penthemimeral
ἵκετο δʼ ἐς Πελίην αὐτοσχεδὸν ἀντιβολήσων	-uu - uu- --uu -uu--	dactylic hexameter	masculine penthemimeral, trithemimeral
εἰλαπίνης, ἣν πατρὶ Ποσειδάωνι καὶ ἄλλοις	-uu- - -u u---u u --	dactylic hexameter	feminine penthemimeral, trithemimeral
ῥέζε θεοῖς, Ἥρης δὲ Πελασγίδος οὐκ ἀλέγιζεν.	-u u- -- u u-uu - uu--	dactylic hexameter	masculine penthemimeral, trithemimeral
αἶψα δὲ τόνγʼ ἐσιδὼν ἐφράσσατο, καί οἱ ἄεθλον	-u u - uu- --uu - u u--	dactylic hexameter	masculine penthemimeral, trithemimeral
ἔντυε ναυτιλίης πολυκηδέος, ὄφρʼ ἐνὶ πόντῳ	-uu -uu- uu-uu - uu --	dactylic hexameter	masculine penthemimeral
ἠὲ καὶ ἀλλοδαποῖσι μετʼ ἀνδράσι νόστον ὀλέσσῃ.	-u u -uu-u u -uu -u u--	dactylic hexameter	feminine penthemimeral
νῆα μὲν οὖν οἱ πρόσθεν ἐπικλείουσιν ἀοιδοὶ	-u u - - -u u---u u--	dactylic hexameter	feminine penthemimeral, trithemimeral
Ἄργον Ἀθηναίης καμέειν ὑποθημοσύνῃσιν.	-u u--- uu- uu-uu--	dactylic hexameter	masculine penthemimeral, hepthemimeral
νῦν δʼ ἂν ἐγὼ γενεήν τε καὶ οὔνομα μυθησαίμην	- u u- uu- u u -uu ----	dactylic hexameter	masculine penthemimeral, trithemimeral
ἡρώων, δολιχῆς τε πόρους ἁλός, ὅσσα τʼ ἔρεξαν	--- uu- u u- uu -u u--	dactylic hexameter	masculine penthemimeral, hepthemimeral, trithemimeral
πλαζόμενοι· Μοῦσαι δʼ ὑποφήτορες εἶεν ἀοιδῆς.	-uu- -- uu-uu -u u--	dactylic hexameter	masculine penthemimeral, trithemimeral
πρῶτά νυν Ὀρφῆος μνησώμεθα, τόν ῥά ποτʼ αὐτὴ	-u u --- --uu - u u --	dactylic hexameter	masculine penthemimeral
Καλλιόπη Θρήικι φατίζεται εὐνηθεῖσα	-uu- --u u-uu ----	dactylic hexameter	feminine penthemimeral, trithemimeral
Οἰάγρῳ σκοπιῆς Πιμπληίδος ἄγχι τεκέσθαι	--- uu- --uu -u u--	dactylic hexameter	masculine penthemimeral, trithemimeral
αὐτὰρ τόν γʼ ἐνέπουσιν ἀτειρέας οὔρεσι πέτρας	-- - uu-u u-uu -uu --	dactylic hexameter	feminine penthemimeral, trithemimeral
θέλξαι ἀοιδάων ἐνοπῇ ποταμῶν τε ῥέεθρα.	-u u--- uu- uu- u u--	dactylic hexameter	masculine penthemimeral, hepthemimeral
φηγοὶ δʼ ἀγριάδες, κείνης ἔτι σήματα μολπῆς,	-- -uu- -- uu -uu --	dactylic hexameter	masculine penthemimeral, hepthemimeral
ἀκτῆς Θρηικίης Ζώνης ἔπι τηλεθόωσαι	-- -uu- -- uu -uu--	dactylic hexameter	masculine penthemimeral, hepthemimeral
ἑξείης στιχόωσιν ἐπήτριμοι, ἃς ὅ γʼ ἐπιπρὸ	--- uu-u u-uu - u u--	dactylic hexameter	feminine penthemimeral, trithemimeral
θελγομένας φόρμιγγι κατήγαγε Πιερίηθεν.	-uu- --u u-uu -uu--	dactylic hexameter	feminine penthemimeral, trithemimeral
Ὀρφέα μὲν δὴ τοῖον ἑῶν ἐπαρωγὸν ἀέθλων	-uu - - -u u- uu-u u--	dactylic hexameter	feminine penthemimeral, hepthemimeral, trithemimeral
Αἰσονίδης Χείρωνος ἐφημοσύνῃσι πιθήσας	-uu- --u u-uu-u u--	dactylic hexameter	feminine penthemimeral, trithemimeral
δέξατο, Πιερίῃ Βιστωνίδι κοιρανέοντα.	-uu -uu- --uu -uu--	dactylic hexameter	masculine penthemimeral
ἤλυθε δʼ Ἀστερίων αὐτοσχεδόν, ὅν ῥα Κομήτης	-uu -uu- --uu - u u--	dactylic hexameter	masculine penthemimeral
γείνατο δινήεντος ἐφʼ ὕδασιν Ἀπιδανοῖο,	-uu ---u u -uu -uu--	dactylic hexameter	feminine penthemimeral
Πειρεσιὰς ὄρεος Φυλληίου ἀγχόθι ναίων,	-uu- uu- --uu -uu --	dactylic hexameter	masculine penthemimeral, trithemimeral
ἔνθα μὲν Ἀπιδανός τε μέγας καὶ δῖος Ἐνιπεὺς	-u u -uu- u u- - -u u--	dactylic hexameter	masculine penthemimeral, hepthemimeral
ἄμφω συμφορέονται, ἀπόπροθεν εἰς ἓν ἰόντες.	-- -uu-u u-uu - u u--	dactylic hexameter	feminine penthemimeral
Λάρισαν δʼ ἐπὶ τοῖσι λιπὼν Πολύφημος ἵκανεν	--- uu -u u- uu-u u--	dactylic hexameter	feminine penthemimeral, hepthemimeral, trithemimeral
Εἰλατίδης, ὃς πρὶν μὲν ἐρισθενέων Λαπιθάων,	-uu- - - u u-uu- uu--	dactylic hexameter	masculine penthemimeral, trithemimeral
ὁππότε Κενταύροις Λαπίθαι ἐπὶ θωρήσσοντο,	-uu --- uu- uu ----	dactylic hexameter	masculine penthemimeral, hepthemimeral
ὁπλότερος πολέμιζε· τότʼ αὖ βαρύθεσκέ οἱ ἤδη	-uu- uu-u u - uu-u u --	dactylic hexameter	feminine penthemimeral, hepthemimeral, trithemimeral
γυῖα, μένεν δʼ ἔτι θυμὸς ἀρήιος, ὡς τὸ πάρος περ.	-u u- uu -u u-uu - u u- -	dactylic hexameter	feminine penthemimeral, trithemimeral
οὐδὲ μὲν Ἴφικλος Φυλάκῃ ἔνι δηρὸν ἔλειπτο,	-u u --- uu- uu -u u--	dactylic hexameter	masculine penthemimeral, hepthemimeral
μήτρως Αἰσονίδαο· κασιγνήτην γὰρ ὄπυιεν	-- -uu-u u--- u u--	dactylic hexameter	feminine penthemimeral
Αἴσων Ἀλκιμέδην Φυλακηίδα· τῆς μιν ἀνώγει	-- -uu- uu-uu - u u--	dactylic hexameter	masculine penthemimeral
πηοσύνη καὶ κῆδος ἐνικρινθῆναι ὁμίλῳ.	-uu- - -u u---u u--	dactylic hexameter	feminine penthemimeral, trithemimeral
οὐδὲ Φεραῖς Ἄδμητος ἐυρρήνεσσιν ἀνάσσων	-u u- --u u---u u--	dactylic hexameter	feminine penthemimeral, trithemimeral
μίμνεν ὑπὸ σκοπιὴν ὄρεος Χαλκωδονίοιο.	-u u- uu- uu- --uu--	dactylic hexameter	masculine penthemimeral, hepthemimeral, trithemimeral
οὐδʼ Ἀλόπῃ μίμνον πολυλήιοι Ἑρμείαο	- uu- -- uu-uu ----	dactylic hexameter	masculine penthemimeral, trithemimeral
υἱέες εὖ δεδαῶτε δόλους, Ἔρυτος καὶ Ἐχίων,	-uu - uu-u u- uu- u u--	dactylic hexameter	feminine penthemimeral, hepthemimeral, trithemimeral
τοῖσι δʼ ἐπὶ τρίτατος γνωτὸς κίε νισσομένοισιν	-u u- uu- -- uu -uu--	dactylic hexameter	masculine penthemimeral, hepthemimeral, trithemimeral
Αἰθαλίδης· καὶ τὸν μὲν ἐπʼ Ἀμφρυσσοῖο ῥοῇσιν	-uu- - - u u ---u u--	dactylic hexameter	masculine penthemimeral, trithemimeral
Μυρμιδόνος κούρη Φθιὰς τέκεν Εὐπολέμεια·	-uu- -- -- uu -uu--	dactylic hexameter	masculine penthemimeral, hepthemimeral, trithemimeral
τὼ δʼ αὖτʼ ἐκγεγάτην Μενετηίδος Ἀντιανείρης.	- - -uu- uu-uu -uu--	dactylic hexameter	masculine penthemimeral
ἤλυθε δʼ ἀφνειὴν προλιπὼν Γυρτῶνα Κόρωνος	-uu --- uu- --u u--	dactylic hexameter	masculine penthemimeral, hepthemimeral
Καινεΐδης, ἐσθλὸς μέν, ἑοῦ δʼ οὐ πατρὸς ἀμείνων.	-uu- -- u u- - -u u--	dactylic hexameter	masculine penthemimeral, hepthemimeral, trithemimeral
Καινέα γὰρ ζῶόν περ ἔτι κλείουσιν ἀοιδοὶ	-uu - -- u u- --u u--	dactylic hexameter	masculine penthemimeral, hepthemimeral, trithemimeral
Κενταύροισιν ὀλέσθαι, ὅτε σφέας οἶος ἀπʼ ἄλλων	---u u-u u- uu -u u --	dactylic hexameter	feminine penthemimeral, hepthemimeral
ἤλασʼ ἀριστήων· οἱ δʼ ἔμπαλιν ὁρμηθέντες	-u u--- - -uu ----	dactylic hexameter	masculine penthemimeral
οὔτε μιν ἐγκλῖναι προτέρω σθένον, οὔτε δαΐξαι·	-u u --- uu- uu -u u--	dactylic hexameter	masculine penthemimeral, hepthemimeral
ἀλλʼ ἄρρηκτος ἄκαμπτος ἐδύσετο νειόθι γαίης,	- --u u-u u-uu -uu --	dactylic hexameter	feminine penthemimeral
θεινόμενος στιβαρῇσι καταΐγδην ἐλάτῃσιν.	-uu- uu-u u--- uu--	dactylic hexameter	feminine penthemimeral, trithemimeral
ἤλυθε δʼ αὖ Μόψος Τιταρήσιος, ὃν περὶ πάντων	-uu - -- uu-uu - uu --	dactylic hexameter	masculine penthemimeral, trithemimeral
Λητοΐδης ἐδίδαξε θεοπροπίας οἰωνῶν·	-uu- uu-u u-uu- ---	dactylic hexameter	feminine penthemimeral, trithemimeral
ἠδὲ καὶ Εὐρυδάμας Κτιμένου πάις· ἄγχι δὲ λίμνης	-u u -uu- uu- uu -u u --	dactylic hexameter	masculine penthemimeral, hepthemimeral
Ξυνιάδος Κτιμένην Δολοπηίδα ναιετάασκεν.	-uu- uu- uu-uu -uu--	dactylic hexameter	masculine penthemimeral, trithemimeral
καὶ μὴν Ἄκτωρ υἷα Μενοίτιον ἐξ Ὀπόεντος	- - -- -u u-uu - uu--	dactylic hexameter	feminine penthemimeral
ὦρσεν, ἀριστήεσσι σὺν ἀνδράσιν ὄφρα νέοιτο.	-u u---u u -uu -u u--	dactylic hexameter	feminine penthemimeral
εἵπετο δʼ Εὐρυτίων τε καὶ ἀλκήεις Ἐρυβώτης,	-uu -uu- u u --- uu--	dactylic hexameter	masculine penthemimeral
υἷες ὁ μὲν Τελέοντος, ὁ δʼ Ἴρου Ἀκτορίδαο·	-u u - uu-u u -- -uu--	dactylic hexameter	feminine penthemimeral, trithemimeral
ἤτοι ὁ μὲν Τελέοντος ἐυκλειὴς Ἐρυβώτης,	-u u - uu-u u--- uu--	dactylic hexameter	feminine penthemimeral, trithemimeral
Ἴρου δʼ Εὐρυτίων. σὺν καὶ τρίτος ἦεν Ὀιλεύς,	-- -uu- - - uu -u u--	dactylic hexameter	masculine penthemimeral, hepthemimeral
ἔξοχος ἠνορέην καὶ ἐπαΐξαι μετόπισθεν	-uu -uu- u u--- uu--	dactylic hexameter	masculine penthemimeral
εὖ δεδαὼς δῄοισιν, ὅτε κλίνωσι φάλαγγας.	- uu- --u u- --u u--	dactylic hexameter	feminine penthemimeral, hepthemimeral, trithemimeral
αὐτὰρ ἀπʼ Εὐβοίης Κάνθος κίε, τόν ῥα Κάνηθος	-u u --- -- uu - u u--	dactylic hexameter	masculine penthemimeral, hepthemimeral
πέμπεν Ἀβαντιάδης λελιημένον· οὐ μὲν ἔμελλεν	-u u-uu- uu-uu - u u--	dactylic hexameter	masculine penthemimeral
νοστήσειν Κήρινθον ὑπότροπος. αισα γὰρ ἦεν	--- --u u-uu -u u --	dactylic hexameter	feminine penthemimeral, trithemimeral
αὐτὸν ὁμῶς Μόψον τε δαήμονα μαντοσυνάων	-u u- -- u u-uu -uu--	dactylic hexameter	masculine penthemimeral, trithemimeral
πλαγχθέντας Λιβύης ἐνὶ πείρασι δῃωθῆναι,	--- uu- uu -uu ----	dactylic hexameter	masculine penthemimeral, trithemimeral
ὡς οὐκ ἀνθρώποισι κακὸν μήκιστον ἐπαυρεῖν,	- - ---u u- --u u--	dactylic hexameter	feminine penthemimeral, hepthemimeral
ὁππότε κἀκείνους Λιβύῃ ἔνι ταρχύσαντο,	-uu --- uu- uu ----	dactylic hexameter	masculine penthemimeral, hepthemimeral
τόσσον ἑκὰς Κόλχων, ὅσσον τέ περ ἠελίοιο	-u u- -- -- u u -uu--	dactylic hexameter	masculine penthemimeral, hepthemimeral, trithemimeral
μεσσηγὺς δύσιές τε καὶ ἀντολαὶ εἰσορόωνται.	--- uu- u u -uu -uu--	dactylic hexameter	masculine penthemimeral, trithemimeral
τῷ δʼ ἄρʼ ἐπὶ Κλυτίος τε καὶ Ἴφιτος ἠγερέθοντο,	- u u- uu- u u -uu -uu--	dactylic hexameter	masculine penthemimeral, trithemimeral
Οἰχαλίης ἐπίουροι, ἀπηνέος Εὐρύτου υἷες,	-uu- uu-u u-uu -uu --	dactylic hexameter	feminine penthemimeral, trithemimeral
Εὐρύτου, ᾧ πόρε τόξον Ἑκηβόλος· οὐδʼ ἀπόνητο	-uu - uu -u u-uu - uu--	dactylic hexameter	feminine penthemimeral, trithemimeral
δωτίνης· αὐτῷ γὰρ ἑκὼν ἐρίδηνε δοτῆρι.	--- -- u u- uu-u u--	dactylic hexameter	masculine penthemimeral, hepthemimeral, trithemimeral
τοῖσι δʼ ἐπʼ Αἰακίδαι μετεκίαθον· οὐ μὲν ἅμʼ ἄμφω,	-u u -uu- uu-uu - u u --	dactylic hexameter	masculine penthemimeral
οὐδʼ ὁμόθεν· νόσφιν γὰρ ἀλευάμενοι κατένασθεν	- uu- -- u u-uu- uu--	dactylic hexameter	masculine penthemimeral, trithemimeral
Αἰγίνης, ὅτε Φῶκον ἀδελφεὸν ἐξενάριξαν	--- uu -u u-uu -uu--	dactylic hexameter	feminine penthemimeral, trithemimeral
ἀφραδίῃ. Τελαμὼν μὲν ἐν Ἀτθίδι νάσσατο νήσῳ·	-uu- uu- u u -uu -uu --	dactylic hexameter	masculine penthemimeral, trithemimeral
Πηλεὺς δὲ Φθίῃ ἐνὶ δώματα ναῖε λιασθείς.	-- - -- uu -uu -u u--	dactylic hexameter	masculine penthemimeral, trithemimeral
τοῖς δʼ ἐπὶ Κεκροπίηθεν ἀρήιος ἤλυθε Βούτης,	- uu -uu-u u-uu -uu --	dactylic hexameter	feminine penthemimeral
παῖς ἀγαθοῦ Τελέοντος, ἐυμμελίης τε Φάληρος.	- uu- uu-u u-uu- u u--	dactylic hexameter	feminine penthemimeral, trithemimeral
Ἄλκων μιν προέηκε πατὴρ ἑός· οὐ μὲν ἔτʼ ἄλλους	-- - uu-u u- uu - u u --	dactylic hexameter	feminine penthemimeral, hepthemimeral, trithemimeral
γήραος υἷας ἔχεν βιότοιό τε κηδεμονῆας.	-uu -u u- uu-u u -uu--	dactylic hexameter	masculine penthemimeral
ἀλλά ἑ τηλύγετόν περ ὁμῶς καὶ μοῦνον ἐόντα	-u u -uu- u u- - -u u--	dactylic hexameter	masculine penthemimeral, hepthemimeral
πέμπεν, ἵνα θρασέεσσι μεταπρέποι ἡρώεσσιν.	-u u- uu-u u-uu ----	dactylic hexameter	feminine penthemimeral, trithemimeral
Θησέα δʼ ,ὃς περὶ πάντας Ἐρεχθεΐδας ἐκέκαστο,	-uu - uu -u u-uu- uu--	dactylic hexameter	feminine penthemimeral, trithemimeral
Ταιναρίην ἀίδηλος ὑπὸ χθόνα δεσμὸς ἔρυκεν,	-uu- uu-u u- uu -u u--	dactylic hexameter	feminine penthemimeral, hepthemimeral, trithemimeral
Πειρίθῳ ἑσπόμενον κοινὴν ὁδόν· ἦ τέ κεν ἄμφω	-uu -uu- -- uu - u u --	dactylic hexameter	masculine penthemimeral, hepthemimeral
ῥηίτερον καμάτοιο τέλος πάντεσσιν ἔθεντο.	-uu- uu-u u- --u u--	dactylic hexameter	feminine penthemimeral, hepthemimeral, trithemimeral
Τῖφυς δʼ Ἁγνιάδης Σιφαέα κάλλιπε δῆμον	-- -uu- --uu -uu --	dactylic hexameter	masculine penthemimeral
Θεσπιέων, ἐσθλὸς μὲν ὀρινόμενον προδαῆναι	-uu- -- u u-uu- uu--	dactylic hexameter	masculine penthemimeral, trithemimeral
κῦμʼ ἁλὸς εὐρείης, ἐσθλὸς δʼ ἀνέμοιο θυέλλας	- uu --- -- uu-u u--	dactylic hexameter	masculine penthemimeral, hepthemimeral
καὶ πλόον ἠελίῳ τε καὶ ἀστέρι τεκμήρασθαι.	- uu -uu- u u -uu ----	dactylic hexameter	masculine penthemimeral
αὐτή μιν Τριτωνὶς ἀριστήων ἐς ὅμιλον	-- - --u u--- u u--	dactylic hexameter	feminine penthemimeral, trithemimeral
ὦρσεν Ἀθηναίη, μετὰ δʼ ἤλυθεν ἐλδομένοισιν.	-u u--- uu -uu -uu--	dactylic hexameter	masculine penthemimeral
αὐτὴ γὰρ καὶ νῆα θοὴν κάμε· σὺν δέ οἱ Ἄργος	-- - - -u u- uu - u u --	dactylic hexameter	feminine penthemimeral, hepthemimeral, trithemimeral
τεῦξεν Ἀρεστορίδης κείνης ὑποθημοσύνῃσιν.	-u u-uu- -- uu-uu--	dactylic hexameter	masculine penthemimeral, hepthemimeral
τῶ καὶ πασάων προφερεστάτη ἔπλετο νηῶν,	- - --- uu-uu -uu --	dactylic hexameter	masculine penthemimeral
ὅσσαι ὑπʼ εἰρεσίῃσιν ἐπειρήσαντο θαλάσσης.	-u u -uu-u u---u u--	dactylic hexameter	feminine penthemimeral
Φλίας δʼ αὖτʼ ἐπὶ τοῖσιν Ἀραιθυρέηθεν ἵκανεν,	-- - uu -u u-uu-u u--	dactylic hexameter	feminine penthemimeral, trithemimeral
ἔνθʼ ἀφνειὸς ἔναιε Διωνύσοιο ἕκητι,	- --u u-u u---u u--	dactylic hexameter	feminine penthemimeral
πατρὸς ἑοῦ, πηγῇσιν ἐφέστιος Ἀσωποῖο.	-u u- --u u-uu ----	dactylic hexameter	feminine penthemimeral, trithemimeral
Ἀργόθεν αὖ Ταλαὸς καὶ Ἀρήιος, υἷε Βίαντος,	-uu - uu- u u-uu -u u--	dactylic hexameter	masculine penthemimeral, trithemimeral
ἤλυθον ἴφθιμός τε Λεώδοκος, οὓς τέκε Πηρὼ	-uu --- u u-uu - uu --	dactylic hexameter	masculine penthemimeral
Νηληίς· τῆς δʼ ἀμφὶ δύην ἐμόγησε βαρεῖαν	--- - -u u- uu-u u--	dactylic hexameter	feminine penthemimeral, hepthemimeral, trithemimeral
Αἰολίδης σταθμοῖσιν ἐν Ἰφίκλοιο Μελάμπους.	-uu- --u u ---u u--	dactylic hexameter	feminine penthemimeral, trithemimeral
οὐδὲ μὲν οὐδὲ βίην κρατερόφρονος Ἡρακλῆος	-u u -u u- uu-uu ----	dactylic hexameter	masculine penthemimeral
πευθόμεθʼ Αἰσονίδαο λιλαιομένου ἀθερίξαι.	-uu -uu-u u-uu- uu--	dactylic hexameter	feminine penthemimeral
ἀλλʼ ἐπεὶ ἄιε βάξιν ἀγειρομένων ἡρώων,	- uu -uu -u u-uu- ---	dactylic hexameter	feminine penthemimeral
νεῖον ἀπʼ Ἀρκαδίης Λυρκήιον Ἄργος ἀμείψας	-u u -uu- --uu -u u--	dactylic hexameter	masculine penthemimeral
τὴν ὁδόν, ᾗ ζωὸν φέρε κάπριον, ὅς ῥʼ ἐνὶ βήσσῃς	- uu - -- uu -uu - uu --	dactylic hexameter	masculine penthemimeral, trithemimeral
φέρβετο Λαμπείης, Ἐρυμάνθιον ἂμ μέγα τῖφος,	-uu --- uu-uu - uu --	dactylic hexameter	masculine penthemimeral
τὸν μὲν ἐνὶ πρώτῃσι Μυκηναίων ἀγορῇσιν	- u u- --u u--- uu--	dactylic hexameter	feminine penthemimeral, trithemimeral
δεσμοῖς ἰλλόμενον μεγάλων ἀπεθήκατο νώτων·	-- -uu- uu- uu-uu --	dactylic hexameter	masculine penthemimeral, hepthemimeral
αὐτὸς δʼ ᾗ ἰότητι παρὲκ νόον Εὐρυσθῆος	-- - uu-u u- uu ----	dactylic hexameter	feminine penthemimeral, hepthemimeral, trithemimeral
ὡρμήθη· σὺν καί οἱ Ὕλας κίεν, ἐσθλὸς ὀπάων,	--- - - u u- uu -u u--	dactylic hexameter	masculine penthemimeral, hepthemimeral, trithemimeral
πρωθήβης, ἰῶν τε φορεὺς φύλακός τε βιοῖο.	--- -- u u- uu- u u--	dactylic hexameter	masculine penthemimeral, hepthemimeral, trithemimeral
τῷ δʼ ἐπὶ δὴ θείοιο κίεν Δαναοῖο γενέθλη,	- uu - --u u- uu-u u--	dactylic hexameter	feminine penthemimeral, hepthemimeral, trithemimeral
Ναύπλιος. ἦ γὰρ ἔην Κλυτονήου Ναυβολίδαο·	-uu - u u- uu-- -uu--	dactylic hexameter	masculine penthemimeral, trithemimeral
Ναύβολος αὖ Λέρνου· Λέρνον γε μὲν ἴδμεν ἐόντα	-uu - -- -- u u -u u--	dactylic hexameter	masculine penthemimeral, hepthemimeral, trithemimeral
Προίτου Ναυπλιάδαο· Ποσειδάωνι δὲ κούρη.	-- -uu-u u---u u --	dactylic hexameter	feminine penthemimeral
πρίν ποτʼ Ἀμυμώνη Δαναῒς τέκεν εὐνηθεῖσα	- u u--- uu- uu ----	dactylic hexameter	masculine penthemimeral, hepthemimeral
Ναύπλιον, ὃς περὶ πάντας ἐκαίνυτο ναυτιλίῃσιν.	-uu - uu -u u-uu -uu--	dactylic hexameter	feminine penthemimeral, trithemimeral
Ἴδμων δʼ ὑστάτιος μετεκίαθεν, ὅσσοι ἔναιον	-- -uu- uu-uu -u u--	dactylic hexameter	masculine penthemimeral
Ἄργος, ἐπεὶ δεδαὼς τὸν ἑὸν μόρον οἰωνοῖσιν	-u u- uu- u u- uu ----	dactylic hexameter	masculine penthemimeral, hepthemimeral, trithemimeral
ἤιε, μή οἱ δῆμος ἐυκλείης ἀγάσαιτο.	-uu - - -u u--- uu--	dactylic hexameter	feminine penthemimeral, trithemimeral
οὐ μὲν ὅ γʼ ἦεν Ἄβαντος ἐτήτυμον, ἀλλά μιν αὐτὸς	- u u -u u-u u-uu -u u --	dactylic hexameter	feminine penthemimeral
γείνατο κυδαλίμοις ἐναρίθμιον Αἰολίδῃσιν	-uu -uu- uu-uu -uu--	dactylic hexameter	masculine penthemimeral
Λητοΐδης· αὐτὸς δὲ θεοπροπίας ἐδίδαξεν	-uu- -- u u-uu- uu--	dactylic hexameter	masculine penthemimeral, trithemimeral
οἰωνούς τʼ ἀλέγειν ἠδʼ ἔμπυρα σήματʼ ἰδέσθαι.	--- uu- - -uu -u u--	dactylic hexameter	masculine penthemimeral, trithemimeral
καὶ μὴν Αἰτωλὶς κρατερὸν Πολυδεύκεα Λήδη	- - --- uu- uu-uu --	dactylic hexameter	masculine penthemimeral, hepthemimeral
Κάστορά τʼ ὠκυπόδων ὦρσεν δεδαημένον ἵππων	-uu -uu- -- uu-uu --	dactylic hexameter	masculine penthemimeral, hepthemimeral
Σπάρτηθεν· τοὺς δʼ ἥγε δόμοις ἔνι Τυνδαρέοιο	--- - -u u- uu -uu--	dactylic hexameter	feminine penthemimeral, hepthemimeral, trithemimeral
τηλυγέτους ὠδῖνι μιῇ τέκεν· οὐδʼ ἀπίθησεν	-uu- --u u- uu - uu--	dactylic hexameter	feminine penthemimeral, hepthemimeral, trithemimeral
νισσομένοις· Ζηνὸς γὰρ ἐπάξια μήδετο λέκτρων.	-uu- -- u u-uu -uu --	dactylic hexameter	masculine penthemimeral, trithemimeral
οἵ τʼ Ἀφαρητιάδαι Λυγκεὺς καὶ ὑπέρβιος Ἴδας	- uu-uu- -- u u-uu --	dactylic hexameter	masculine penthemimeral, hepthemimeral
Ἀρήνηθεν ἔβαν, μεγάλῃ περιθαρσέες ἀλκῇ	---u u- uu- uu-uu --	dactylic hexameter	masculine penthemimeral, hepthemimeral
ἀμφότεροι· Λυγκεὺς δὲ καὶ ὀξυτάτοις ἐκέκαστο	-uu- -- u u -uu- uu--	dactylic hexameter	masculine penthemimeral, trithemimeral
ὄμμασιν, εἰ ἐτεόν γε πέλει κλέος, ἀνέρα κεῖνον	-uu - uu- u u- uu -uu --	dactylic hexameter	masculine penthemimeral, hepthemimeral, trithemimeral
ῥηιδίως καὶ νέρθε κατὰ χθονὸς αὐγάζεσθαι.	-uu- - -u u- uu ----	dactylic hexameter	feminine penthemimeral, hepthemimeral, trithemimeral
σὺν δὲ Περικλύμενος Νηλήιος ὦρτο νέεσθαι,	- u u-uu- --uu -u u--	dactylic hexameter	masculine penthemimeral
πρεσβύτατος παίδων, ὅσσοι Πύλῳ ἐξεγένοντο	-uu- -- -- uu -uu--	dactylic hexameter	masculine penthemimeral, hepthemimeral, trithemimeral
Νηλῆος θείοιο· Ποσειδάων δέ οἱ ἀλκὴν	--- --u u--- u u --	dactylic hexameter	feminine penthemimeral, trithemimeral
δῶκεν ἀπειρεσίην ἠδʼ ὅττι κεν ἀρήσαιτο	-u u-uu- - -u u ----	dactylic hexameter	masculine penthemimeral
μαρνάμενος, τὸ πέλεσθαι ἐνὶ ξυνοχῇ πολέμοιο.	-uu- u u-u u- uu- uu--	dactylic hexameter	feminine penthemimeral, hepthemimeral, trithemimeral
καὶ μὴν Ἀμφιδάμας Κηφεύς τʼ ἴσαν Ἀρκαδίηθεν,	- - -uu- -- uu -uu--	dactylic hexameter	masculine penthemimeral, hepthemimeral
οἳ Τεγέην καὶ κλῆρον Ἀφειδάντειον ἔναιον,	- uu- - -u u---u u--	dactylic hexameter	feminine penthemimeral, trithemimeral
υἷε δύω Ἀλεοῦ· τρίτατός γε μὲν ἕσπετʼ ἰοῦσιν	-u u- uu- uu- u u -u u--	dactylic hexameter	masculine penthemimeral, hepthemimeral, trithemimeral
Ἀγκαῖος, τὸν μέν ῥα πατὴρ Λυκόοργος ἔπεμπεν,	--- - - u u- uu-u u--	dactylic hexameter	masculine penthemimeral, hepthemimeral, trithemimeral
τῶν ἄμφω γνωτὸς προγενέστερος. ἀλλʼ ὁ μὲν ἤδη	- -- -- uu-uu - u u --	dactylic hexameter	masculine penthemimeral, trithemimeral
γηράσκοντʼ Ἀλεὸν λίπετʼ ἂμ πόλιν ὄφρα κομίζοι,	--- uu- uu - uu -u u--	dactylic hexameter	masculine penthemimeral, hepthemimeral, trithemimeral
παῖδα δʼ ἑὸν σφετέροισι κασιγνήτοισιν ὄπασσεν.	-u u- uu-u u---u u--	dactylic hexameter	feminine penthemimeral, trithemimeral
βῆ δʼ ὅγε Μαιναλίης ἄρκτου δέρος, ἀμφίτομόν τε	- uu -uu- -- uu -uu- -	dactylic hexameter	masculine penthemimeral, hepthemimeral
δεξιτερῇ πάλλων πέλεκυν μέγαν. ἔντεα γάρ οἱ	-uu- -- uu- uu -uu - -	dactylic hexameter	masculine penthemimeral, hepthemimeral, trithemimeral
πατροπάτωρ Ἀλεὸς μυχάτῃ ἐνέκρυψε καλιῇ,	-uu- uu- uu- uu-u u--	dactylic hexameter	masculine penthemimeral, hepthemimeral, trithemimeral
αἴ κέν πως ἔτι καὶ τὸν ἐρητύσειε νέεσθαι.	- - - uu - u u---u u--	dactylic hexameter	masculine penthemimeral, trithemimeral
βῆ δὲ καὶ Αὐγείης, ὃν δὴ φάτις Ἠελίοιο	- u u --- - - uu -uu--	dactylic hexameter	masculine penthemimeral, hepthemimeral
ἔμμεναι· Ἠλείοισι δʼ ὅ γʼ ἀνδράσιν ἐμβασίλευεν,	-uu ---u u -uu -uu--	dactylic hexameter	feminine penthemimeral
ὄλβῳ κυδιόων· μέγα δʼ ἵετο Κολχίδα γαῖαν	-- -uu- uu -uu -uu --	dactylic hexameter	masculine penthemimeral
αὐτόν τʼ Αἰήτην ἰδέειν σημάντορα Κόλχων.	-- --- uu- --uu --	dactylic hexameter	masculine penthemimeral, hepthemimeral
Ἀστέριος δὲ καὶ Ἀμφίων Ὑπερασίου υἷες	-uu- u u --- uu-uu --	dactylic hexameter	hepthemimeral, trithemimeral
Πελλήνης ἀφίκανον Ἀχαιίδος, ἥν ποτε Πέλλης	--- uu-u u-uu - uu --	dactylic hexameter	feminine penthemimeral, trithemimeral
πατροπάτωρ ἐπόλισσεν ἐπʼ ὀφρύσιν Αἰγιαλοῖο.	-uu- uu-u u -uu -uu--	dactylic hexameter	feminine penthemimeral, trithemimeral
Ταίναρον αὖτʼ ἐπὶ τοῖσι λιπὼν Εὔφημος ἵκανεν,	-uu - uu -u u- --u u--	dactylic hexameter	feminine penthemimeral, hepthemimeral, trithemimeral
τόν ῥα Ποσειδάωνι ποδωκηέστατον ἄλλων	- u u---u u---uu --	dactylic hexameter	feminine penthemimeral
Εὐρώπη Τιτυοῖο μεγασθενέος τέκε κούρη.	--- uu-u u-uu- uu --	dactylic hexameter	feminine penthemimeral, trithemimeral
κεῖνος ἀνὴρ καὶ πόντου ἐπὶ γλαυκοῖο θέεσκεν	-u u- - -u u- --u u--	dactylic hexameter	feminine penthemimeral, hepthemimeral, trithemimeral
οἴδματος, οὐδὲ θοοὺς βάπτεν πόδας, ἀλλʼ ὅσον ἄκροις	-uu -u u- -- uu - uu --	dactylic hexameter	masculine penthemimeral, hepthemimeral
ἴχνεσι τεγγόμενος διερῇ πεφόρητο κελεύθῳ.	-uu -uu- uu- uu-u u--	dactylic hexameter	masculine penthemimeral, hepthemimeral
καὶ δʼ ἄλλω δύο παῖδε Ποσειδάωνος ἵκοντο·	- -- uu -u u---u u--	dactylic hexameter	feminine penthemimeral, trithemimeral
ἤτοι ὁ μὲν πτολίεθρον ἀγαυοῦ Μιλήτοιο	-u u - uu-u u-- ----	dactylic hexameter	feminine penthemimeral, trithemimeral
νοσφισθεὶς Ἐργῖνος, ὁ δʼ Ἰμβρασίης ἕδος Ἥρης,	--- --u u -uu- uu --	dactylic hexameter	feminine penthemimeral, trithemimeral
παρθενίην, Ἀγκαῖος ὑπέρβιος· ἴστορε δʼ ἄμφω	-uu- --u u-uu -uu --	dactylic hexameter	feminine penthemimeral, trithemimeral
ἠμὲν ναυτιλίης ἠδʼ ἄρεος εὐχετόωντο.	-- -uu- - -uu -uu--	dactylic hexameter	masculine penthemimeral
Οἰνεΐδης δʼ ἐπὶ τοῖσιν ἀφορμηθεὶς Καλυδῶνος	-uu- uu -u u--- uu--	dactylic hexameter	feminine penthemimeral, trithemimeral
ἀλκήεις Μελέαγρος ἀνήλυθε, Λαοκόων τε,	--- uu-u u-uu -uu- -	dactylic hexameter	feminine penthemimeral, trithemimeral
Λαοκόων Οἰνῆος ἀδελφεός, οὐ μὲν ἰῆς γε	-uu- --u u-uu - u u- -	dactylic hexameter	feminine penthemimeral, trithemimeral
μητέρος· ἀλλά ἑ θῆσσα γυνὴ τέκε· τὸν μὲν ἄρʼ Οἰνεὺς	-uu -u u -u u- uu - u u --	dactylic hexameter	feminine penthemimeral, hepthemimeral
ἤδη γηραλέον κοσμήτορα παιδὸς ἴαλλεν·	-- -uu- --uu -u u--	dactylic hexameter	masculine penthemimeral
ὧδʼ ἔτι κουρίζων περιθαρσέα δῦνεν ὅμιλον	- uu --- uu-uu -u u--	dactylic hexameter	masculine penthemimeral
ἡρώων. τοῦ δʼ οὔτινʼ ὑπέρτερον ἄλλον ὀίω,	--- - -u u-uu -u u--	dactylic hexameter	feminine penthemimeral, trithemimeral
νόσφιν γ᾽Ἡρακλῆος, ἐπελθέμεν, εἴ κʼ ἔτι μοῦνον	-- ---u u-uu - uu --	dactylic hexameter	feminine penthemimeral
αὖθι μένων λυκάβαντα μετετράφη Αἰτωλοῖσιν.	-u u- uu-u u-uu ----	dactylic hexameter	feminine penthemimeral, trithemimeral
καὶ μήν οἱ μήτρως αὐτὴν ὁδόν, εὖ μὲν ἄκοντι,	- - - -- -- uu - u u--	dactylic hexameter	masculine penthemimeral, hepthemimeral, trithemimeral
εὖ δὲ καὶ ἐν σταδίῃ δεδαημένος ἀντιφέρεσθαι,	- u u - uu- uu-uu -uu--	dactylic hexameter	masculine penthemimeral, trithemimeral
Θεστιάδης Ἴφικλος ἐφωμάρτησε κιόντι.	-uu- --u u---u u--	dactylic hexameter	feminine penthemimeral, trithemimeral
σὺν δὲ Παλαιμόνιος Λέρνου πάις Ὠλενίοιο,	- u u-uu- -- uu -uu--	dactylic hexameter	masculine penthemimeral, hepthemimeral
Λέρνου ἐπίκλησιν, γενεήν γε μὲν Ἡφαίστοιο·	-u u--- uu- u u ----	dactylic hexameter	masculine penthemimeral, hepthemimeral
τούνεκʼ ἔην πόδα σιφλός· ἀτὰρ δέμας οὔ κέ τις ἔτλη	-u u- uu -u u- uu - u u --	dactylic hexameter	feminine penthemimeral, hepthemimeral, trithemimeral
ἠνορέην τʼ ὀνόσασθαι, ὃ καὶ μεταρίθμιος ἦεν	-uu- uu-u u - uu-uu --	dactylic hexameter	feminine penthemimeral, hepthemimeral, trithemimeral
πᾶσιν ἀριστήεσσιν, Ἰήσονι κῦδος ἀέξων.	-u u---u u-uu -u u--	dactylic hexameter	feminine penthemimeral
ἐκ δʼ ἄρα Φωκήων κίεν Ἴφιτος Ὀρνυτίδαο	- uu --- uu -uu -uu--	dactylic hexameter	masculine penthemimeral
Ναυβόλου ἐκγεγαώς· ξεῖνος δέ οἱ ἔσκε πάροιθεν,	-uu -uu- -- u u -u u--	dactylic hexameter	masculine penthemimeral, hepthemimeral
ἦμος ἔβη Πυθώδε θεοπροπίας ἐρεείνων	-u u- --u u-uu- uu--	dactylic hexameter	feminine penthemimeral, trithemimeral
ναυτιλίης· τόθι γάρ μιν ἑοῖς ὑπέδεκτο δόμοισιν.	-uu- uu - u u- uu-u u--	dactylic hexameter	masculine penthemimeral, hepthemimeral, trithemimeral
Ζήτης αὖ Κάλαΐς τε Βορήιοι υἷες ἵκοντο,	-- - uu- u u-uu -u u--	dactylic hexameter	masculine penthemimeral, trithemimeral
οὕς ποτʼ Ἐρεχθηὶς Βορέῃ τέκεν Ὠρείθυια	- u u--- uu- uu ----	dactylic hexameter	masculine penthemimeral, hepthemimeral
ἐσχατιῇ Θρῄκης δυσχειμέρου· ἔνθʼ ἄρα τήν γε	-uu- -- --uu - uu - -	dactylic hexameter	masculine penthemimeral, trithemimeral
Θρηίκιος Βορέης ἀνερέψατο Κεκροπίηθεν	-uu- uu- uu-uu -uu--	dactylic hexameter	masculine penthemimeral, trithemimeral
Ἰλισσοῦ προπάροιθε χορῷ ἔνι δινεύουσαν.	--- uu-u u- uu ----	dactylic hexameter	feminine penthemimeral, hepthemimeral, trithemimeral
καί μιν ἄγων ἕκαθεν, Σαρπηδονίην ὅθι πέτρην	- u u- uu- --uu- uu --	dactylic hexameter	masculine penthemimeral, trithemimeral
κλείουσιν, ποταμοῖο παρὰ ῥόον Ἐργίνοιο,	--- uu-u u- uu ----	dactylic hexameter	feminine penthemimeral, hepthemimeral, trithemimeral
λυγαίοις ἐδάμασσε περὶ νεφέεσσι καλύψας.	--- uu-u u- uu-u u--	dactylic hexameter	feminine penthemimeral, hepthemimeral, trithemimeral
τὼ μὲν ἐπʼ ἀκροτάτοισι ποδῶν ἑκάτερθεν ἐρεμνὰς	- u u -uu-u u- uu-u u--	dactylic hexameter	feminine penthemimeral, hepthemimeral
σεῖον ἀειρομένω πτέρυγας, μέγα θάμβος ἰδέσθαι,	-u u-uu- uu- uu -u u--	dactylic hexameter	masculine penthemimeral, hepthemimeral
χρυσείαις φολίδεσσι διαυγέας· ἀμφὶ δὲ νώτοις	--- uu-u u-uu -u u --	dactylic hexameter	feminine penthemimeral, trithemimeral
κράατος ἐξ ὑπάτοιο καὶ αὐχένος ἔνθα καὶ ἔνθα	-uu - uu-u u -uu -u u --	dactylic hexameter	feminine penthemimeral, trithemimeral
κυάνεαι δονέοντο μετὰ πνοιῇσιν ἔθειραι.	-uu- uu-u u- --u u--	dactylic hexameter	feminine penthemimeral, hepthemimeral, trithemimeral
οὐδὲ μὲν οὐδʼ αὐτοῖο πάις μενέαινεν Ἄκαστος	-u u - --u u- uu-u u--	dactylic hexameter	feminine penthemimeral, hepthemimeral, trithemimeral
ἰφθίμου Πελίαο δόμοις ἔνι πατρὸς ἑῆος	--- uu-u u- uu -u u--	dactylic hexameter	feminine penthemimeral, hepthemimeral, trithemimeral
μιμνάζειν, Ἄργος τε θεᾶς ὑποεργὸς Ἀθήνης·	--- -- u u- uu-u u--	dactylic hexameter	masculine penthemimeral, hepthemimeral, trithemimeral
ἀλλʼ ἄρα καὶ τὼ μέλλον ἐνικρινθῆναι ὁμίλῳ.	- uu - - -u u---u u--	dactylic hexameter	feminine penthemimeral, trithemimeral
τόσσοι ἄρʼ Αἰσονίδῃ συμμήστορες ἠγερέθοντο.	-u u -uu- --uu -uu--	dactylic hexameter	masculine penthemimeral
τοὺς μὲν ἀριστῆας Μινύας περιναιετάοντες	- u u--- uu- uu-uu--	dactylic hexameter	masculine penthemimeral, hepthemimeral
κίκλησκον μάλα πάντας, ἐπεὶ Μινύαο θυγατρῶν	--- uu -u u- uu-u u--	dactylic hexameter	feminine penthemimeral, hepthemimeral, trithemimeral
οἱ πλεῖστοι καὶ ἄριστοι ἀφʼ αἵματος εὐχετόωντο	- -- u u-u u -uu -uu--	dactylic hexameter	feminine penthemimeral, trithemimeral
ἔμμεναι· ὧς δὲ καὶ αὐτὸν Ἰήσονα γείνατο μήτηρ	-uu - u u -u u-uu -uu --	dactylic hexameter	feminine penthemimeral, trithemimeral
Ἀλκιμέδη, Κλυμένης Μινυηίδος ἐκγεγαυῖα.	-uu- uu- uu-uu -uu--	dactylic hexameter	masculine penthemimeral, trithemimeral
αὐτὰρ ἐπεὶ δμώεσσιν ἐπαρτέα πάντʼ ἐτέτυκτο,	-u u- --u u-uu - uu--	dactylic hexameter	feminine penthemimeral, trithemimeral
ὅσσα περ ἐντύνονται ἐπαρτέες ἔνδοθι νῆες,	-u u ---u u-uu -uu --	dactylic hexameter	feminine penthemimeral
εὖτʼ ἂν ἄγῃ χρέος ἄνδρας ὑπεὶρ ἅλα ναυτίλλεσθαι,	- u u- uu -u u- uu ----	dactylic hexameter	feminine penthemimeral, hepthemimeral, trithemimeral
δὴ τότʼ ἴσαν μετὰ νῆα διʼ ἄστεος, ἔνθα περ ἀκταὶ	- u u- uu -u u -uu -u u --	dactylic hexameter	feminine penthemimeral, trithemimeral
κλείονται Παγασαὶ Μαγνήτιδες· ἀμφὶ δὲ λαῶν	--- uu- --uu -u u --	dactylic hexameter	masculine penthemimeral, trithemimeral
πληθὺς σπερχομένων ἄμυδις θέεν· οἱ δὲ φαεινοὶ	-- -uu- uu- uu - u u--	dactylic hexameter	masculine penthemimeral, hepthemimeral
ἀστέρες ὣς νεφέεσσι μετέπρεπον· ὧδε δʼ ἕκαστος	-uu - uu-u u-uu -u u--	dactylic hexameter	feminine penthemimeral, trithemimeral
ἔννεπεν εἰσορόων σὺν τεύχεσιν ἀίσσοντας·	-uu -uu- - -uu ----	dactylic hexameter	masculine penthemimeral
‘Ζεῦ ἄνα, τίς Πελίαο νόος; πόθι τόσσον ὅμιλον	- uu - uu-u u- uu -u u--	dactylic hexameter	feminine penthemimeral, hepthemimeral, trithemimeral
ἡρώων γαίης Παναχαιίδος ἔκτοθι βάλλει;	--- -- uu-uu -uu --	dactylic hexameter	masculine penthemimeral, trithemimeral
αὐτῆμάρ κε δόμους ὀλοῷ πυρὶ δῃώσειαν	--- u u- uu- uu ----	dactylic hexameter	masculine penthemimeral, hepthemimeral, trithemimeral
Αἰήτεω, ὅτε μή σφιν ἑκὼν δέρος ἐγγυαλίξῃ.	--- uu - u u- uu -uu--	dactylic hexameter	masculine penthemimeral, hepthemimeral, trithemimeral
ἀλλʼ οὐ φυκτὰ κέλευθα, πόνος δʼ ἄπρηκτος ἰοῦσιν.’	- - -u u-u u- --u u--	dactylic hexameter	feminine penthemimeral, hepthemimeral
ὧς φάσαν ἔνθα καὶ ἔνθα κατὰ πτόλιν· αἱ δὲ γυναῖκες	- uu -u u -u u- uu - u u--	dactylic hexameter	feminine penthemimeral, hepthemimeral
πολλὰ μάλʼ ἀθανάτοισιν ἐς αἰθέρα χεῖρας ἄειρον,	-u u -uu-u u -uu -u u--	dactylic hexameter	feminine penthemimeral
εὐχόμεναι νόστοιο τέλος θυμηδὲς ὀπάσσαι.	-uu- --u u- --u u--	dactylic hexameter	feminine penthemimeral, hepthemimeral, trithemimeral
ἄλλη δʼ εἰς ἑτέρην ὀλοφύρετο δακρυχέουσα·	-- - uu- uu-uu -uu--	dactylic hexameter	masculine penthemimeral, trithemimeral
‘δειλὴ Ἀλκιμέδη, καὶ σοὶ κακὸν ὀψέ περ ἔμπης	-- -uu- - - uu -u u --	dactylic hexameter	masculine penthemimeral, hepthemimeral
ἤλυθεν, οὐδʼ ἐτέλεσσας ἐπʼ ἀγλαΐῃ βιότοιο.	-uu - uu-u u -uu- uu--	dactylic hexameter	feminine penthemimeral, trithemimeral
Αἴσων αὖ μέγα δή τι δυσάμμορος. ἦ τέ οἱ ἦεν	-- - uu - u u-uu - u u --	dactylic hexameter	masculine penthemimeral, trithemimeral
βέλτερον, εἰ τὸ πάροιθεν ἐνὶ κτερέεσσιν ἐλυσθεὶς	-uu - u u-u u- uu-u u--	dactylic hexameter	feminine penthemimeral, hepthemimeral, trithemimeral
νειόθι γαίης κεῖτο, κακῶν ἔτι νῆις ἀέθλων.	-uu -- -u u- uu -u u--	dactylic hexameter	feminine penthemimeral, hepthemimeral
ὡς ὄφελεν καὶ Φρίξον, ὅτʼ ὤλετο παρθένος Ἕλλη,	- uu- - -u u -uu -uu --	dactylic hexameter	feminine penthemimeral, trithemimeral
κῦμα μέλαν κριῷ ἅμʼ ἐπικλύσαι· ἀλλὰ καὶ αὐδὴν	-u u- -- u u-uu -u u --	dactylic hexameter	masculine penthemimeral, trithemimeral
ἀνδρομέην προέηκε κακὸν τέρας, ὥς κεν ἀνίας	-uu- uu-u u- uu - u u--	dactylic hexameter	feminine penthemimeral, hepthemimeral, trithemimeral
Ἀλκιμέδῃ μετόπισθε καὶ ἄλγεα μυρία θείη.’	-uu- uu-u u -uu -uu --	dactylic hexameter	feminine penthemimeral, trithemimeral
αἱ μὲν ἄρʼ ὧς ἀγόρευον ἐπὶ προμολῇσι κιόντων.	- u u - uu-u u- uu-u u--	dactylic hexameter	feminine penthemimeral, hepthemimeral, trithemimeral
ἤδη δὲ δμῶές τε πολεῖς δμωαί τʼ ἀγέροντο·	-- - -- u u- -- uu--	dactylic hexameter	masculine penthemimeral, hepthemimeral, trithemimeral
μήτηρ δʼ ἀμφʼ αὐτὸν βεβολημένη. ὀξὺ δʼ ἑκάστην	-- - -- uu-uu -u u--	dactylic hexameter	masculine penthemimeral, trithemimeral
δῦνεν ἄχος· σὺν δέ σφι πατὴρ ὀλοῷ ὑπὸ γήραι	-u u- - - u u- uu- uu --	dactylic hexameter	masculine penthemimeral, hepthemimeral, trithemimeral
ἐντυπὰς ἐν λεχέεσσι καλυψάμενος γοάασκεν.	-uu - uu-u u-uu- uu--	dactylic hexameter	feminine penthemimeral, trithemimeral
αὐτὰρ ὁ τῶν μὲν ἔπειτα κατεπρήυνεν ἀνίας	-u u - u u-u u--- u--	lyric	
θαρσύνων, δμώεσσι δʼ ἀρήια τεύχεʼ ἀείρειν	--- --u u-uu -u u--	dactylic hexameter	feminine penthemimeral, trithemimeral
πέφραδεν· οἱ δέ τε σῖγα κατηφέες ἠείροντο.	-uu - u u -u u-uu ----	dactylic hexameter	feminine penthemimeral, trithemimeral
μήτηρ δʼ ὡς τὰ πρῶτʼ ἐπεχεύατο πήχεε παιδί,	-- - - - uu-uu -uu --	dactylic hexameter	masculine penthemimeral, trithemimeral
ὧς ἔχετο κλαίουσʼ ἀδινώτερον, ἠύτε κούρη	- uu- -- uu-uu -uu --	dactylic hexameter	masculine penthemimeral, trithemimeral
οἰόθεν ἀσπασίως πολιὴν τροφὸν ἀμφιπεσοῦσα	-uu -uu- uu- uu -uu--	dactylic hexameter	masculine penthemimeral, hepthemimeral
μύρεται, ᾗ οὐκ εἰσὶν ἔτʼ ἄλλοι κηδεμονῆες,	-uu - - -u u -- -uu--	dactylic hexameter	feminine penthemimeral, trithemimeral
ἀλλʼ ὑπὸ μητρυιῇ βίοτον βαρὺν ἡγηλάζει·	- uu --- uu- uu ----	dactylic hexameter	masculine penthemimeral, hepthemimeral
καί ἑ νέον πολέεσσιν ὀνείδεσιν ἐστυφέλιξεν,	- u u- uu-u u-uu -uu--	dactylic hexameter	feminine penthemimeral, trithemimeral
τῇ δέ τʼ ὀδυρομένῃ δέδεται κέαρ ἔνδοθεν ἄτῃ,	- u u-uu- uu- uu -uu --	dactylic hexameter	masculine penthemimeral, hepthemimeral
οὐδʼ ἔχει ἐκφλύξαι τόσσον γόον, ὅσσον ὀρεχθεῖ·	- uu --- -- uu -u u--	dactylic hexameter	masculine penthemimeral, hepthemimeral
ὧς ἀδινὸν κλαίεσκεν ἑὸν παῖδʼ ἀγκὰς ἔχουσα	- uu- --u u- - -u u--	dactylic hexameter	feminine penthemimeral, hepthemimeral, trithemimeral
Ἀλκιμέδη, καὶ τοῖον ἔπος φάτο κηδοσύνῃσιν·	-uu- - -u u- uu -uu--	dactylic hexameter	feminine penthemimeral, hepthemimeral, trithemimeral
‘αἴθʼ ὄφελον κεῖνʼ ἦμαρ, ὅτʼ ἐξειπόντος ἄκουσα	- uu- - -u u ---u u--	dactylic hexameter	feminine penthemimeral, trithemimeral
δειλὴ ἐγὼ Πελίαο κακὴν βασιλῆος ἐφετμήν,	-u u- uu-u u- uu-u u--	dactylic hexameter	feminine penthemimeral, hepthemimeral, trithemimeral
αὐτίκʼ ἀπὸ ψυχὴν μεθέμεν, κηδέων τε λαθέσθαι,	-u u- -- uu- -- u u--	dactylic hexameter	masculine penthemimeral, hepthemimeral, trithemimeral
ὄφρʼ αὐτός με τεῇσι φίλαις ταρχύσαο χερσίν,	- -- u u-u u- --uu --	dactylic hexameter	feminine penthemimeral, hepthemimeral, trithemimeral
τέκνον ἐμόν· τὸ γὰρ οἶον ἔην ἔτι λοιπὸν ἐέλδωρ	-u u- u u -u u- uu -u u--	dactylic hexameter	feminine penthemimeral, hepthemimeral, trithemimeral
ἐκ σέθεν, ἄλλα δὲ πάντα πάλαι θρεπτήρια πέσσω.	- uu -u u -u u- --uu --	dactylic hexameter	feminine penthemimeral, hepthemimeral
νῦν γε μὲν ἡ τὸ πάροιθεν Ἀχαιιάδεσσιν ἀγητὴ	- u u - u u-u u-uu-u u--	dactylic hexameter	feminine penthemimeral, trithemimeral
δμωὶς ὅπως κενεοῖσι λελείψομαι ἐν μεγάροισιν,	-u u- uu-u u-uu - uu--	dactylic hexameter	feminine penthemimeral, trithemimeral
σεῖο πόθῳ μινύθουσα δυσάμμορος, ᾧ ἔπι πολλὴν	-u u- uu-u u-uu - uu --	dactylic hexameter	feminine penthemimeral, trithemimeral
ἀγλαΐην καὶ κῦδος ἔχον πάρος, ᾧ ἔπι μούνῳ	-uu- - -u u- uu - uu --	dactylic hexameter	feminine penthemimeral, hepthemimeral, trithemimeral
μίτρην πρῶτον ἔλυσα καὶ ὕστατον. ἔξοχα γάρ μοι	-- -u u-u u -uu -uu - -	dactylic hexameter	feminine penthemimeral
Εἰλείθυια θεὰ πολέος ἐμέγηρε τόκοιο.	---u u- uu- uu-u u--	dactylic hexameter	masculine penthemimeral, hepthemimeral
ᾤ μοι ἐμῆς ἄτης· τὸ μὲν οὐδʼ ὅσον, οὐδʼ ἐν ὀνείρῳ	- u u- -- u u - uu - u u--	dactylic hexameter	masculine penthemimeral, hepthemimeral, trithemimeral
ὠισάμην, εἰ Φρίξος ἐμοὶ κακὸν ἔσσετʼ ἀλύξας.’	-uu- - -u u- uu -u u--	dactylic hexameter	feminine penthemimeral, hepthemimeral, trithemimeral
ὧς ἥ γε στενάχουσα κινύρετο· ταὶ δὲ γυναῖκες	- - - uu-u u-uu - u u--	dactylic hexameter	feminine penthemimeral, trithemimeral
ἀμφίπολοι γοάασκον ἐπισταδόν· αὐτὰρ ὁ τήν γε	-uu- uu-u u-uu -u u - -	dactylic hexameter	feminine penthemimeral, trithemimeral
μειλιχίοις ἐπέεσσι παρηγορέων προσέειπεν·	-uu- uu-u u-uu- uu--	dactylic hexameter	feminine penthemimeral, trithemimeral
‘μή μοι λευγαλέας ἐνιβάλλεο, μῆτερ, ἀνίας	- - -uu- uu-uu -u u--	dactylic hexameter	masculine penthemimeral
ὧδε λίην, ἐπεὶ οὐ μὲν ἐρητύσεις κακότητος	-u u- uu - u u--- uu--	dactylic hexameter	masculine penthemimeral, trithemimeral
δάκρυσιν, ἀλλʼ ἔτι κεν καὶ ἐπʼ ἄλγεσιν ἄλγος ἄροιο.	-uu - uu - u u -uu -u u--	dactylic hexameter	masculine penthemimeral, trithemimeral
πήματα γάρ τʼ ἀίδηλα θεοὶ θνητοῖσι νέμουσιν,	-uu - uu-u u- --u u--	dactylic hexameter	feminine penthemimeral, hepthemimeral, trithemimeral
τῶν μοῖραν κατὰ θυμὸν ἀνιάζουσά περ ἔμπης	- -- uu -u u---u u --	dactylic hexameter	feminine penthemimeral, trithemimeral
τλῆθι φέρειν· θάρσει δὲ συνημοσύνῃσιν Ἀθήνης,	-u u- -- u u-uu-u u--	dactylic hexameter	masculine penthemimeral, trithemimeral
ἠδὲ θεοπροπίοισιν, ἐπεὶ μάλα δεξιὰ Φοῖβος	-u u-uu-u u- uu -uu --	dactylic hexameter	feminine penthemimeral, hepthemimeral
ἔχρη, ἀτὰρ μετέπειτά γ᾽ἀριστήων ἐπαρωγῇ.	-u u- uu-u u--- uu--	dactylic hexameter	feminine penthemimeral, trithemimeral
ἀλλὰ σὺ μὲν νῦν αὖθι μετʼ ἀμφιπόλοισιν ἕκηλος	-u u - - -u u -uu-u u--	dactylic hexameter	feminine penthemimeral, trithemimeral
μίμνε δόμοις, μηδʼ ὄρνις ἀεικελίη πέλε νηί·	-u u- - -u u-uu- uu --	dactylic hexameter	feminine penthemimeral, trithemimeral
κεῖσε δʼ ὁμαρτήσουσιν ἔται δμῶές τε κιόντι.’	-u u---u u- -- u u--	dactylic hexameter	feminine penthemimeral, hepthemimeral
ἦ, καὶ ὁ μὲν προτέρωσε δόμων ἐξῶρτο νέεσθαι.	- u u - uu-u u- --u u--	dactylic hexameter	feminine penthemimeral, hepthemimeral, trithemimeral
οἷος δʼ ἐκ νηοῖο θυώδεος εἶσιν Ἀπόλλων	-- - --u u-uu -u u--	dactylic hexameter	feminine penthemimeral, trithemimeral
δῆλον ἀνʼ ἠγαθέην, ἠὲ Κλάρον, ἢ ὅγε Πυθώ,	-u u -uu- -- uu - uu --	dactylic hexameter	masculine penthemimeral, hepthemimeral
ἢ Αυκίην εὐρεῖαν, ἐπὶ Ξάνθοιο ῥοῇσιν,	--- --u u- --u u--	dactylic hexameter	feminine penthemimeral, hepthemimeral, trithemimeral
τοῖος ἀνὰ πληθὺν δήμου κίεν· ὦρτο δʼ ἀυτὴ	-u u- -- -- uu -u u--	dactylic hexameter	masculine penthemimeral, hepthemimeral, trithemimeral
κεκλομένων ἄμυδις. τῷ δὲ ξύμβλητο γεραιὴ	-uu- uu- - - --u u--	dactylic hexameter	masculine penthemimeral, hepthemimeral, trithemimeral
Ἰφιὰς Ἀρτέμιδος πολιηόχου ἀρήτειρα,	-uu -uu- uu-uu ----	dactylic hexameter	masculine penthemimeral
καί μιν δεξιτερῆς χειρὸς κύσεν, οὐδέ τι φάσθαι	- - -uu- -- uu -u u --	dactylic hexameter	masculine penthemimeral, hepthemimeral
ἔμπης ἱεμένη δύνατο, προθέοντος ὁμίλου·	-- -uu- uu- uu-u u--	dactylic hexameter	masculine penthemimeral, hepthemimeral
ἀλλʼ ἡ μὲν λίπετʼ αὖθι παρακλιδόν, οἷα γεραιὴ	- - - uu -u u-uu -u u--	dactylic hexameter	feminine penthemimeral, trithemimeral
ὁπλοτέρων, ὁ δὲ πολλὸν ἀποπλαγχθεὶς ἐλιάσθη.	-uu- u u -u u--- uu--	dactylic hexameter	feminine penthemimeral, trithemimeral
αὐτὰρ ἐπεί ῥα πόληος ἐυδμήτους λίπʼ ἀγυιάς,	-u u- u u-u u--- u u--	dactylic hexameter	feminine penthemimeral, trithemimeral
ἀκτὴν δʼ ἵκανεν Παγασηίδα, τῇ μιν ἑταῖροι	-- --- uu-uu - u u--	dactylic hexameter	masculine penthemimeral
δειδέχατʼ, Ἀργῴῃ ἄμυδις παρὰ νηὶ μένοντες.	-uu --- uu- uu -u u--	dactylic hexameter	masculine penthemimeral, hepthemimeral
στῆ δʼ ἄρʼ ἐπὶ προμολῇς· οἱ δʼ ἀντίοι ἠγερέθοντο.	- u u- uu- - -uu -uu--	dactylic hexameter	masculine penthemimeral, trithemimeral
ἐς δʼ ἐνόησαν Ἄκαστον ὁμῶς Ἄργον τε πόληος	- uu-u u-u u- -- u u--	dactylic hexameter	feminine penthemimeral, hepthemimeral
νόσφι καταβλώσκοντας, ἐθάμβησαν δʼ ἐσιδόντες	-u u---u u--- uu--	dactylic hexameter	feminine penthemimeral
πασσυδίῃ Πελίαο παρὲκ νόον ἰθύοντας.	-uu- uu-u u- uu ----	dactylic hexameter	feminine penthemimeral, hepthemimeral, trithemimeral
δέρμα δʼ ὁ μὲν ταύροιο ποδηνεκὲς ἀμφέχετʼ ὤμους	-u u - --u u-uu -uu --	dactylic hexameter	feminine penthemimeral, trithemimeral
Ἄργος Ἀρεστορίδης λάχνῃ μέλαν· αὐτὰρ ὁ καλὴν	-u u-uu- -- uu -u u --	dactylic hexameter	masculine penthemimeral, hepthemimeral
δίπλακα, τήν οἱ ὄπασσε κασιγνήτη Πελόπεια.	-uu - u u-u u--- uu--	dactylic hexameter	feminine penthemimeral, trithemimeral
ἀλλʼ ἔμπης τὼ μέν τε διεξερέεσθαι ἕκαστα	- -- - - u u-uu-u u--	dactylic hexameter	masculine penthemimeral, trithemimeral
ἔσχετο· τοὺς δʼ ἀγορήνδε συνεδριάασθαι ἄνωγεν.	-uu - uu-u u-uu-u u--	dactylic hexameter	feminine penthemimeral, trithemimeral
αὐτοῦ δʼ ἰλλομένοις ἐπὶ λαίφεσιν, ἠδὲ καὶ ἱστῷ	-- -uu- uu -uu -u u --	dactylic hexameter	masculine penthemimeral
κεκλιμένῳ μάλα πάντες ἐπισχερὼ ἑδριόωντο.	-uu- uu -u u-uu -uu--	dactylic hexameter	feminine penthemimeral, trithemimeral
τοῖσιν δʼ Αἴσονος υἱὸς ἐυφρονέων μετέειπεν·	-- -uu -u u-uu- uu--	dactylic hexameter	feminine penthemimeral
‘ἄλλα μὲν ὅσσα τε νηὶ ἐφοπλίσσασθαι ἔοικεν	-u u -u u -u u---u u--	dactylic hexameter	feminine penthemimeral
πάντα γὰρ εὖ κατὰ κόσμον ἐπαρτέα κεῖται ἰοῦσιν.	-u u - uu -u u-uu -u u--	dactylic hexameter	feminine penthemimeral, trithemimeral
τῶ οὐκ ἂν δηναιὸν ἐχοίμεθα τοῖο ἕκητι	- - - --u u-uu -u u--	dactylic hexameter	feminine penthemimeral, trithemimeral
ναυτιλίης, ὅτε μοῦνον ἐπιπνεύσουσιν ἀῆται.	-uu- uu -u u---u u--	dactylic hexameter	feminine penthemimeral, trithemimeral
ἀλλά, φίλοι, ξυνὸς γὰρ ἐς Ἑλλάδα νόστος ὀπίσσω,	-u u- -- u u -uu -u u--	dactylic hexameter	masculine penthemimeral, trithemimeral
ξυναὶ δʼ ἄμμι πέλονται ἐς Αἰήταο κέλευθοι	-- -u u-u u ---u u--	dactylic hexameter	feminine penthemimeral
τούνεκα νῦν τὸν ἄριστον ἀφειδήσαντες ἕλεσθε	-uu - u u-u u---u u--	dactylic hexameter	feminine penthemimeral, trithemimeral
ὄρχαμον ἡμείων, ᾧ κεν τὰ ἕκαστα μέλοιτο,	-uu --- - - u u-u u--	dactylic hexameter	masculine penthemimeral, hepthemimeral
νείκεα συνθεσίας τε μετὰ ξείνοισι βαλέσθαι.’	-uu -uu- u u- --u u--	dactylic hexameter	masculine penthemimeral, hepthemimeral
ὧς φάτο· πάπτηναν δὲ νέοι θρασὺν Ἡρακλῆα	- uu --- u u- uu ----	dactylic hexameter	masculine penthemimeral, hepthemimeral
ἥμενον ἐν μέσσοισι· μιῇ δέ ἑ πάντες ἀυτῇ	-uu - --u u- u u -u u--	dactylic hexameter	feminine penthemimeral, hepthemimeral, trithemimeral
σημαίνειν ἐπέτελλον· ὁ δʼ αὐτόθεν, ἔνθα περ ἧστο,	--- uu-u u -uu -u u --	dactylic hexameter	feminine penthemimeral, trithemimeral
δεξιτερὴν ἀνὰ χεῖρα τανύσσατο φώνησέν τε·	-uu- uu -u u-uu --- -	dactylic hexameter	feminine penthemimeral, trithemimeral
‘μήτις ἐμοὶ τόδε κῦδος ὀπαζέτω. οὐ γὰρ ἔγωγε	-u u- uu -u u-uu - u u--	dactylic hexameter	feminine penthemimeral, trithemimeral
πείσομαι· ὥστε καὶ ἄλλον ἀναστήσεσθαι ἐρύξω.	-uu -u u -u u---u u--	dactylic hexameter	feminine penthemimeral
αὐτός, ὅτις ξυνάγειρε, καὶ ἀρχεύοι ὁμάδοιο.’	-u u- uu-u u --- uu--	dactylic hexameter	feminine penthemimeral, trithemimeral
ἦ ῥα μέγα φρονέων, ἐπὶ δʼ ᾔνεον, ὡς ἐκέλευεν	- u u- uu- uu -uu - uu--	dactylic hexameter	masculine penthemimeral, trithemimeral
Ἡρακλέης· ἀνὰ δʼ αὐτὸς ἀρήιος ὤρνυτʼ Ἰήσων	-uu- uu -u u-uu -u u--	dactylic hexameter	feminine penthemimeral, trithemimeral
γηθόσυνος, καὶ τοῖα λιλαιομένοις ἀγόρευεν·	-uu- - -u u-uu- uu--	dactylic hexameter	feminine penthemimeral, trithemimeral
‘εἰ μὲν δή μοι κῦδος ἐπιτρωπᾶτε μέλεσθαι,	- - - - -u u---u u--	dactylic hexameter	feminine penthemimeral, trithemimeral
μηκέτʼ ἔπειθʼ, ὡς καὶ πρίν, ἐρητύοιτο κέλευθα.	-u u- - - u u---u u--	dactylic hexameter	masculine penthemimeral, trithemimeral
νῦν γε μὲν ἤδη Φοῖβον ἀρεσσάμενοι θυέεσσιν	- u u -- -u u-uu- uu--	dactylic hexameter	feminine penthemimeral
δαῖτʼ ἐντυνώμεσθα παρασχεδόν. ὄφρα δʼ ἴωσιν	- ----u u-uu -u u--	dactylic hexameter	feminine penthemimeral
δμῶες ἐμοὶ σταθμῶν σημάντορες, οἷσι μέμηλεν	-u u- -- --uu -u u--	dactylic hexameter	masculine penthemimeral, trithemimeral
δεῦρο βόας ἀγέληθεν ἐὺ κρίναντας ἐλάσσαι,	-u u- uu-- - --u u--	dactylic hexameter	hepthemimeral, trithemimeral
τόφρα κε νῆʼ ἐρύσαιμεν ἔσω ἁλός, ὅπλα δὲ πάντα	-u u - uu-u u- uu -u u --	dactylic hexameter	feminine penthemimeral, hepthemimeral, trithemimeral
ἐνθέμενοι πεπάλαχθε κατὰ κληῖδας ἐρετμά.	-uu- uu-u u- --u u--	dactylic hexameter	feminine penthemimeral, hepthemimeral, trithemimeral
τείως δʼ αὖ καὶ βωμὸν ἐπάκτιον Ἐμβασίοιο	-- - - -u u-uu -uu--	dactylic hexameter	feminine penthemimeral, trithemimeral
θείομεν Ἀπόλλωνος, ὅ μοι χρείων ὑπέδεκτο	-uu ---u u - -- uu--	dactylic hexameter	feminine penthemimeral, hepthemimeral
σημανέειν δείξειν τε πόρους ἁλός, εἴ κε θυηλαῖς	-uu- -- u u- uu - u u--	dactylic hexameter	masculine penthemimeral, hepthemimeral, trithemimeral
οὗ ἕθεν ἐξάρχωμαι ἀεθλεύων βασιλῆι.’	- uu ---u u--- uu--	dactylic hexameter	feminine penthemimeral
η ῥα, καὶ εἰς ἔργον πρῶτος τράπεθ̓· οἱ δʼ ἐπανέσταν	- u u - -- -- uu - uu--	dactylic hexameter	masculine penthemimeral, hepthemimeral, trithemimeral
πειθόμενοι· ἀπὸ δʼ εἵματʼ ἐπήτριμα νηήσαντο	-uu- uu -u u-uu ----	dactylic hexameter	feminine penthemimeral, trithemimeral
λείῳ ἐπὶ πλαταμῶνι, τὸν οὐκ ἐπέβαλλε θάλασσα	-u u- uu-u u - uu-u u--	dactylic hexameter	feminine penthemimeral, hepthemimeral, trithemimeral
κύμασι, χειμερίη δὲ πάλαι ἀποέκλυσεν ἅλμη.	-uu -uu- u u- uu-uu --	dactylic hexameter	masculine penthemimeral, hepthemimeral
νῆα δʼ ἐπικρατέως Ἄργου ὑποθημοσύνῃσιν	-u u-uu- -- uu-uu--	dactylic hexameter	masculine penthemimeral, hepthemimeral
ἔζωσαν πάμπρωτον ἐυστρεφεῖ ἔνδοθεν ὅπλῳ	--- --u u-uu -uu --	dactylic hexameter	feminine penthemimeral, trithemimeral
τεινάμενοι ἑκάτερθεν, ἵνʼ εὖ ἀραροίατο γόμφοις	-uu- uu-u u - uu-uu --	dactylic hexameter	feminine penthemimeral, hepthemimeral, trithemimeral
δούρατα καὶ ῥοθίοιο βίην ἔχοι ἀντιόωσαν.	-uu - uu-u u- uu -uu--	dactylic hexameter	feminine penthemimeral, hepthemimeral, trithemimeral
σκάπτον δʼ αἶψα κατʼ εὖρος ὅσον περιβάλλετο χῶρον,	-- -u u -u u- uu-uu --	dactylic hexameter	feminine penthemimeral, hepthemimeral
ἠδὲ κατὰ πρῴραν εἴσω ἁλὸς ὁσσάτιόν περ	-u u- -- -- uu -uu- -	dactylic hexameter	masculine penthemimeral, hepthemimeral, trithemimeral
ἑλκομένη χείρεσσιν ἐπιδραμέεσθαι ἔμελλεν.	-uu- --u u-uu-u u--	dactylic hexameter	feminine penthemimeral, trithemimeral
αἰεὶ δὲ προτέρω χθαμαλώτερον ἐξελάχαινον	-- - uu- uu-uu -uu--	dactylic hexameter	masculine penthemimeral, trithemimeral
στείρης, ἐν δʼ ὁλκῷ ξεστὰς στορέσαντο φάλαγγας·	-- - -- -- uu-u u--	dactylic hexameter	masculine penthemimeral, hepthemimeral, trithemimeral
τὴν δὲ κατάντη κλῖναν ἐπὶ πρώτῃσι φάλαγξιν,	- u u-- -u u- --u u--	dactylic hexameter	feminine penthemimeral, hepthemimeral
ὥς κεν ὀλισθαίνουσα διʼ αὐτάων φορέοιτο.	- u u---u u --- uu--	dactylic hexameter	feminine penthemimeral
ὕψι δʼ ἄρʼ ἔνθα καὶ ἔνθα μεταστρέψαντες ἐρετμὰ	-u u -u u -u u---u u--	dactylic hexameter	feminine penthemimeral
πήχυιον προύχοντα περὶ σκαλμοῖσιν ἔδησαν.	--- --u u- --u u--	dactylic hexameter	feminine penthemimeral, hepthemimeral, trithemimeral
τῶν δʼ ἐναμοιβαδὶς αὐτοὶ ἐνέσταθεν ἀμφοτέρωθεν,	- uu-uu -u u-uu -uu--	dactylic hexameter	feminine penthemimeral
στέρνα θ᾽ὁμοῦ καὶ χεῖρας ἐπήλασαν. ἐν δʼ ἄρα Τῖφυς	-u u- - -u u-uu - uu --	dactylic hexameter	feminine penthemimeral, trithemimeral
βήσαθʼ, ἵνʼ ὀτρύνειε νέους κατὰ καιρὸν ἐρύσσαι·	-u u ---u u- uu -u u--	dactylic hexameter	feminine penthemimeral, hepthemimeral
κεκλόμενος δʼ ἤυσε μάλα μέγα· τοὶ δὲ παρᾶσσον	-uu- -- uu -- - u u--	dactylic hexameter	masculine penthemimeral, trithemimeral
ᾧ κράτεϊ βρίσαντες ἰῇ στυφέλιξαν ἐρωῇ	- uu- --u u- uu-u u--	dactylic hexameter	feminine penthemimeral, hepthemimeral, trithemimeral
νειόθεν ἐξ ἕδρης, ἐπὶ δʼ ἐρρώσαντο πόδεσσιν	-uu - -- uu ---u u--	dactylic hexameter	masculine penthemimeral, trithemimeral
προπροβιαζόμενοι· ἡ δʼ ἕσπετο Πηλιὰς Ἀργὼ	-uu-uu- - -uu -uu --	dactylic hexameter	masculine penthemimeral
ῥίμφα μάλʼ· οἱ δʼ ἑκάτερθεν ἐπίαχον ἀίσσοντες.	-u u - uu-u u-uu ----	dactylic hexameter	feminine penthemimeral, trithemimeral
αἱ δʼ ἄρʼ ὑπὸ τρόπιδι στιβαρῇ στενάχοντο φάλαγγες	- u u- uu- uu- uu-u u--	dactylic hexameter	masculine penthemimeral, hepthemimeral, trithemimeral
τριβόμεναι περὶ δέ σφιν ἀιδνὴ κήκιε λιγνὺς	-uu- uu - u u-- -uu --	dactylic hexameter	masculine penthemimeral, trithemimeral
βριθοσύνῃ, κατόλισθε δʼ ἔσω ἁλός· οἱ δέ μιν αὖθι	-uu- uu-u u- uu - u u --	dactylic hexameter	feminine penthemimeral, hepthemimeral, trithemimeral
ἂψ ἀνασειράζοντες ἔχον προτέρωσε κιοῦσαν.	- uu---u u- uu-u u--	dactylic hexameter	feminine penthemimeral, hepthemimeral
σκαλμοῖς δʼ ἀμφὶς ἐρετμὰ κατήρτυον· ἐν δέ οἱ ἱστὸν	-- -u u-u u-uu - u u --	dactylic hexameter	feminine penthemimeral
λαίφεά τʼ εὐποίητα καὶ ἁρμαλιὴν ἐβάλοντο.	-uu ---u u -uu- uu--	dactylic hexameter	feminine penthemimeral
αὐτὰρ ἐπεὶ τὰ ἕκαστα περιφραδέως ἀλέγυναν,	-u u- u u-u u-uu- uu--	dactylic hexameter	feminine penthemimeral, trithemimeral
κληῖδας μὲν πρῶτα πάλῳ διεμοιρήσαντο,	--- - -u u- uu----	dactylic hexameter	feminine penthemimeral, hepthemimeral, trithemimeral
ἄνδρʼ ἐντυναμένω δοιὼ μίαν· ἐκ δʼ ἄρα μέσσην	- --uu- -- uu - uu --	dactylic hexameter	masculine penthemimeral, hepthemimeral
ᾕρεον Ἡρακλῆι καὶ ἡρώων ἄτερ ἄλλων	-uu ---u u --- uu --	dactylic hexameter	feminine penthemimeral
Ἀγκαίῳ, Τεγέης ὅς ῥα πτολίεθρον ἔναιεν.	--- uu- - - uu-u u--	dactylic hexameter	masculine penthemimeral, hepthemimeral, trithemimeral
τοῖς μέσσην οἴοισιν ἀπὸ κληῖδα λίποντο	- -- --u u- --u u--	dactylic hexameter	feminine penthemimeral, hepthemimeral, trithemimeral
αὔτως, οὔτι πάλῳ· ἐπὶ δʼ ἔτρεπον αἰνήσαντες	-- -u u- uu -uu ----	dactylic hexameter	masculine penthemimeral
Τῖφυν ἐυστείρης οἰήια νηὸς ἔρυσθαι.	-u u--- --uu -u u--	dactylic hexameter	masculine penthemimeral
ἔνθεν δʼ αὖ λάιγγας ἁλὸς σχεδὸν ὀχλίζοντες	-- - --u u- uu ----	dactylic hexameter	feminine penthemimeral, hepthemimeral, trithemimeral
νήεον αὐτόθι βωμὸν ἐπάκτιον Ἀπόλλωνος,	-uu -uu -u u-uu ----	dactylic hexameter	feminine penthemimeral
Ἀκτίου Ἐμβασίοιό τʼ ἐπώνυμον· ὦκα δέ τοί γε	-uu -uu-u u-uu -u u - -	dactylic hexameter	feminine penthemimeral
φιτροὺς ἀζαλέης στόρεσαν καθύπερθεν ἐλαίης.	-- -uu- uu- uu-u u--	dactylic hexameter	masculine penthemimeral, hepthemimeral
τείως δʼ αὖτʼ ἀγέληθεν ἐπιπροέηκαν ἄγοντες	-- - uu-u u-uu-u u--	dactylic hexameter	feminine penthemimeral, trithemimeral
βουκόλοι Αἰσονίδαο δύω βόε. τοὺς δʼ ἐρύσαντο	-uu -uu-u u- uu - uu--	dactylic hexameter	feminine penthemimeral, hepthemimeral
κουρότεροι ἑτάρων βωμοῦ σχεδόν. οἱ δʼ ἄρʼ ἔπειτα	-uu- uu- -- uu - u u--	dactylic hexameter	masculine penthemimeral, hepthemimeral, trithemimeral
χέρνιβά τʼ οὐλοχύτας τε παρέσχεθον. αὐτὰρ Ἰήσων	-uu -uu- u u-uu -u u--	dactylic hexameter	masculine penthemimeral
εὔχετο κεκλόμενος πατρώιον Ἀπόλλωνα·	-uu -uu- --uu ----	dactylic hexameter	masculine penthemimeral
‘κλῦθι ἄναξ, Παγασάς τε πόλιν τʼ Αἰσωνίδα ναίων,	-u u- uu- u u- --uu --	dactylic hexameter	masculine penthemimeral, hepthemimeral, trithemimeral
ἡμετέροιο τοκῆος ἐπώνυμον, ὅς μοι ὑπέστης	-uu-u u-u u-uu - u u--	dactylic hexameter	feminine penthemimeral
Πυθοῖ χρειομένῳ ἄνυσιν καὶ πείραθʼ ὁδοῖο	-- -uu- uu- - -u u--	dactylic hexameter	masculine penthemimeral, hepthemimeral
σημανέειν, αὐτὸς γὰρ ἐπαίτιος ἔπλευ ἀέθλων·	-uu- -- u u-uu -u u--	dactylic hexameter	masculine penthemimeral, trithemimeral
αὐτὸς νῦν ἄγε νῆα σὺν ἀρτεμέεσσιν ἑταίροις	-- - uu -u u -uu-u u--	dactylic hexameter	feminine penthemimeral, trithemimeral
κεῖσέ τε καὶ παλίνορσον ἐς Ἑλλάδα. σοὶ δʼ ἂν ὀπίσσω	-u u - uu-u u -uu - u u--	dactylic hexameter	feminine penthemimeral, trithemimeral
τόσσων, ὅσσοι κεν νοστήσομεν, ἀγλαὰ ταύρων	-- -- - --uu -uu --	dactylic hexameter	masculine penthemimeral
ἱρὰ πάλιν βωμῷ ἐπιθήσομεν· ἄλλα δὲ Πυθοῖ,	-u u- -- uu-uu -u u --	dactylic hexameter	masculine penthemimeral, trithemimeral
ἄλλα δʼ ἐς Ὀρτυγίην ἀπερείσια δῶρα κομίσσω.	-u u -uu- uu-uu -u u--	dactylic hexameter	masculine penthemimeral
νῦν δʼ ἴθι, καὶ τήνδʼ ἧμιν, Ἑκηβόλε, δέξο θυηλήν,	- uu - - -u u-uu -u u--	dactylic hexameter	feminine penthemimeral, trithemimeral
ἥν τοι τῆσδʼ ἐπίβαθρα χάριν προτεθείμεθα νηὸς	- - - uu-u u- uu-uu --	dactylic hexameter	feminine penthemimeral, hepthemimeral, trithemimeral
πρωτίστην· λύσαιμι δʼ ,ἄναξ, ἐπʼ ἀπήμονι μοίρῃ	--- --u u- u u-uu --	dactylic hexameter	feminine penthemimeral, hepthemimeral, trithemimeral
πείσματα σὴν διὰ μῆτιν· ἐπιπνεύσειε δʼ ἀήτης	-uu - uu -u u---u u--	dactylic hexameter	feminine penthemimeral, trithemimeral
μείλιχος, ᾧ κʼ ἐπὶ πόντον ἐλευσόμεθʼ εὐδιόωντες.’	-uu - uu -u u-uu -uu--	dactylic hexameter	feminine penthemimeral, trithemimeral
ἦ, καὶ ἅμʼ εὐχωλῇ προχύτας βάλε. τὼ δʼ ἐπὶ βουσὶν	- u u --- uu- uu - uu --	dactylic hexameter	masculine penthemimeral, hepthemimeral
ζωσάσθην, Ἀγκαῖος ὑπέρβιος, Ἡρακλέης τε.	--- --u u-uu -uu- -	dactylic hexameter	feminine penthemimeral, trithemimeral
ἤτοι ὁ μὲν ῥοπάλῳ μέσσον κάρη ἀμφὶ μέτωπα	-u u - uu- -- uu -u u--	dactylic hexameter	masculine penthemimeral, hepthemimeral, trithemimeral
πλῆξεν, ὁ δʼ ἀθρόος αὖθι πεσὼν ἐνερείσατο γαίῃ·	-u u -uu -u u- uu-uu --	dactylic hexameter	feminine penthemimeral, hepthemimeral
Ἀγκαῖος δʼ ἑτέροιο κατὰ πλατὺν αὐχένα κόψας	--- uu-u u- uu -uu --	dactylic hexameter	feminine penthemimeral, hepthemimeral, trithemimeral
χαλκείῳ πελέκει κρατεροὺς διέκερσε τένοντας·	--- uu- uu- uu-u u--	dactylic hexameter	masculine penthemimeral, hepthemimeral, trithemimeral
ἤριπε δʼ ἀμφοτέροισι περιρρηδὴς κεράεσσιν.	-uu -uu-u u--- uu--	dactylic hexameter	feminine penthemimeral
τοὺς δʼ ἔταροι σφάξαν τε θοῶς, δεῖράν τε βοείας,	- uu- -- u u- -- u u--	dactylic hexameter	masculine penthemimeral, hepthemimeral, trithemimeral
κόπτον, δαίτρευόν τε, καὶ ἱερὰ μῆρʼ ἐτάμοντο,	-- --- u u -uu - uu--	dactylic hexameter	masculine penthemimeral
κὰδ δʼ ἄμυδις τάγε πάντα καλύψαντες πύκα δημῷ	- uu- uu -u u--- uu --	dactylic hexameter	feminine penthemimeral, trithemimeral
καῖον ἐπὶ σχίζῃσιν· ὁ δʼ ἀκρήτους χέε λοιβὰς	-u u- --u u --- uu --	dactylic hexameter	feminine penthemimeral, trithemimeral
Αἰσονίδης, γήθει δὲ σέλας θηεύμενος Ἴδμων	-uu- -- u u- --uu --	dactylic hexameter	masculine penthemimeral, hepthemimeral, trithemimeral
πάντοσε λαμπόμενον θυέων ἄπο τοῖό τε λιγνὺν	-uu -uu- uu- uu -u u --	dactylic hexameter	masculine penthemimeral, hepthemimeral
πορφυρέαις ἑλίκεσσιν ἐναίσιμον ἀίσσουσαν·	-uu- uu-u u-uu ----	dactylic hexameter	feminine penthemimeral, trithemimeral
αἶψα δʼ ἀπηλεγέως νόον ἔκφατο Λητοΐδαο·	-u u-uu- uu -uu -uu--	dactylic hexameter	masculine penthemimeral
‘ὑμῖν μὲν δὴ μοῖρα θεῶν χρειώ τε περῆσαι	-- - - -u u- -- u u--	dactylic hexameter	feminine penthemimeral, hepthemimeral, trithemimeral
ἐνθάδε κῶας ἄγοντας· ἀπειρέσιοι δʼ ἐνὶ μέσσῳ	-uu -u u-u u-uu- uu --	dactylic hexameter	feminine penthemimeral
κεῖσέ τε δεῦρό τʼ ἔασιν ἀνερχομένοισιν ἄεθλοι.	-u u -u u-u u-uu-u u--	dactylic hexameter	feminine penthemimeral
αὐτὰρ ἐμοὶ θανέειν στυγερῇ ὑπὸ δαίμονος αἴσῃ	-u u- uu- uu- uu -uu --	dactylic hexameter	masculine penthemimeral, hepthemimeral, trithemimeral
τηλόθι που πέπρωται ἐπʼ Ἀσίδος ἠπείροιο.	-uu - --u u -uu ----	dactylic hexameter	feminine penthemimeral, trithemimeral
ὧδε κακοῖς δεδαὼς ἔτι καὶ πάρος οἰωνοῖσιν	-u u- uu- uu - uu ----	dactylic hexameter	masculine penthemimeral, hepthemimeral, trithemimeral
πότμον ἐμὸν πάτρης ἐξήιον, ὄφρʼ ἐπιβαίην	-u u- -- --uu - uu--	dactylic hexameter	masculine penthemimeral, trithemimeral
νηός, ἐυκλείη δὲ δόμοις ἐπιβάντι λίπηται.’	-u u--- u u- uu-u u--	dactylic hexameter	masculine penthemimeral, hepthemimeral
ὧς ἄρʼ ἔφη· κοῦροι δὲ θεοπροπίης ἀίοντες	- u u- -- u u-uu- uu--	dactylic hexameter	masculine penthemimeral, trithemimeral
νόστῳ μὲν γήθησαν, ἄχος δʼ ἕλεν Ἴδμονος αἴσῃ.	-- - --u u- uu -uu --	dactylic hexameter	feminine penthemimeral, hepthemimeral, trithemimeral
ἦμος δʼ ἠέλιος σταθερὸν παραμείβεται ἦμαρ,	-- -uu- uu- uu-uu --	dactylic hexameter	masculine penthemimeral, hepthemimeral
αἱ δὲ νέον σκοπέλοισιν ὑποσκιόωνται ἄρουραι,	- u u- uu-u u-uu-u u--	dactylic hexameter	feminine penthemimeral, trithemimeral
δειελινὸν κλίνοντος ὑπὸ ζόφον ἠελίοιο,	-uu- --u u- uu -uu--	dactylic hexameter	feminine penthemimeral, hepthemimeral, trithemimeral
τῆμος ἄρʼ ἤδη πάντες ἐπὶ ψαμάθοισι βαθεῖαν	-u u -- -u u- uu-u u--	dactylic hexameter	feminine penthemimeral, hepthemimeral
φυλλάδα χευάμενοι πολιοῦ πρόπαρ αἰγιαλοῖο	-uu -uu- uu- uu -uu--	dactylic hexameter	masculine penthemimeral, hepthemimeral
κέκλινθʼ ἑξείης· παρὰ δέ σφισι μυρίʼ ἔκειτο	-- --- uu - uu -u u--	dactylic hexameter	masculine penthemimeral, hepthemimeral
εἴδατα, καὶ μέθυ λαρόν, ἀφυσσαμένων προχόῃσιν	-uu - uu -u u-uu- uu--	dactylic hexameter	feminine penthemimeral, trithemimeral
οἰνοχόων· μετέπειτα δʼ ἀμοιβαδὶς ἀλλήλοισιν	-uu- uu-u u-uu ----	dactylic hexameter	feminine penthemimeral, trithemimeral
μυθεῦνθʼ, οἷά τε πολλὰ νέοι παρὰ δαιτὶ καὶ οἴνῳ	-- -u u -u u- uu -u u --	dactylic hexameter	feminine penthemimeral, hepthemimeral
τερπνῶς ἑψιόωνται, ὅτʼ ἄατος ὕβρις ἀπείη.	-- -uu-u u -uu -u u--	dactylic hexameter	feminine penthemimeral
ἔνθʼ αὖτʼ Αἰσονίδης μὲν ἀμήχανος εἰν ἑοῖ αὐτῷ	- - -uu- u u-uu - uu --	dactylic hexameter	masculine penthemimeral
πορφύρεσκεν ἕκαστα κατηφιόωντι ἐοικώς.	---u u-u u-uu-u u--	dactylic hexameter	feminine penthemimeral
τὸν δʼ ἄρʼ ὑποφρασθεὶς μεγάλῃ ὀπὶ νείκεσεν Ἴδας·	- u u--- uu- uu -uu --	dactylic hexameter	masculine penthemimeral, hepthemimeral
‘Αἰσονίδη, τίνα τήνδε μετὰ φρεσὶ μῆτιν ἑλίσσεις;	-uu- uu -u u- uu -u u--	dactylic hexameter	feminine penthemimeral, hepthemimeral, trithemimeral
αὔδα ἐνὶ μέσσοισι τεὸν νόον. ἦέ σε δαμνᾷ	-u u- --u u- uu -u u --	dactylic hexameter	feminine penthemimeral, hepthemimeral, trithemimeral
τάρβος ἐπιπλόμενον, τό τʼ ἀνάλκιδας ἄνδρας ἀτύζει;	-u u-uu- u u-uu -u u--	dactylic hexameter	masculine penthemimeral
ἴστω νῦν δόρυ θοῦρον, ὅτῳ περιώσιον ἄλλων	-- - uu -u u- uu-uu --	dactylic hexameter	feminine penthemimeral, hepthemimeral, trithemimeral
κῦδος ἐνὶ πτολέμοισιν ἀείρομαι, οὐδέ μ᾽ὀφέλλει	-u u- uu-u u-uu -u u--	dactylic hexameter	feminine penthemimeral, trithemimeral
Ζεὺς τόσον, ὁσσάτιόν περ ἐμὸν δόρυ, μή νύ τι πῆμα	- uu -uu- u u- uu - u u --	dactylic hexameter	masculine penthemimeral, hepthemimeral
λοίγιον ἔσσεσθαι, μηδʼ ἀκράαντον ἄεθλον	-uu --- - ---u u--	dactylic hexameter	masculine penthemimeral
Ἴδεω ἑσπομένοιο, καὶ εἰ θεὸς ἀντιόῳτο.	-uu -uu-u u - uu -uu--	dactylic hexameter	feminine penthemimeral, hepthemimeral
τοῖόν μ᾽Ἀρήνηθεν ἀοσσητῆρα κομίζεις.’	-- ---u u---u u--	dactylic hexameter	feminine penthemimeral
ἦ, καὶ ἐπισχόμενος πλεῖον δέπας ἀμφοτέρῃσιν	- u u-uu- -- uu -uu--	dactylic hexameter	masculine penthemimeral, hepthemimeral
πῖνε χαλίκρητον λαρὸν μέθυ· δεύετο δʼ οἴνῳ	-u u--- -- uu -uu --	dactylic hexameter	masculine penthemimeral, hepthemimeral
χείλεα, κυάνεαί τε γενειάδες· οἱ δʼ ὁμάδησαν	-uu -uu- u u-uu - uu--	dactylic hexameter	masculine penthemimeral
πάντες ὁμῶς, Ἴδμων δὲ καὶ ἀμφαδίην ἀγόρευσεν·	-u u- -- u u -uu- uu--	dactylic hexameter	masculine penthemimeral, trithemimeral
‘δαιμόνιε, φρονέεις ὀλοφώια καὶ πάρος αὐτῷ.	-uu- uu- uu-uu - uu --	dactylic hexameter	masculine penthemimeral, trithemimeral
ἦέ τοι εἰς ἄτην ζωρὸν μέθυ θαρσαλέον κῆρ	-u u - -- -- uu -uu- -	dactylic hexameter	masculine penthemimeral, hepthemimeral, trithemimeral
οἰδάνει ἐν στήθεσσι, θεοὺς δʼ ἀνέηκεν ἀτίζειν;	-uu - --u u- uu-u u--	dactylic hexameter	feminine penthemimeral, hepthemimeral, trithemimeral
ἄλλοι μῦθοι ἔασι παρήγοροι, οἷσί περ ἀνὴρ	-- -u u-u u-uu -u u --	dactylic hexameter	feminine penthemimeral
θαρσύνοι ἕταρον· σὺ δʼ ἀτάσθαλα πάμπαν ἔειπας,	-uu -uu - --uu -u u--	dactylic hexameter	masculine penthemimeral
τοῖα φάτις καὶ τοὺς πρὶν ἐπιφλύειν μακάρεσσιν	-u u- - - u u--- uu--	dactylic hexameter	masculine penthemimeral, trithemimeral
υἷας Ἀλωιάδας, οἷς οὐδʼ ὅσον ἰσοφαρίζεις	-u u-uu- - - uu -uu--	dactylic hexameter	masculine penthemimeral, hepthemimeral
ἠνορέην· ἔμπης δὲ θοοῖς ἐδάμησαν ὀιστοῖς	-uu- -- u u- uu-u u--	dactylic hexameter	masculine penthemimeral, hepthemimeral, trithemimeral
ἄμφω Λητοΐδαο, καὶ ἴφθιμοί περ ἐόντες.’	-- -uu-u u --- u u--	dactylic hexameter	feminine penthemimeral
ὧς ἔφατʼ· ἐκ δʼ ἐγέλασσεν ἄδην Ἀφαρήιος Ἴδας	- uu - uu-u u- uu-uu --	dactylic hexameter	feminine penthemimeral, hepthemimeral, trithemimeral
καί μιν ἐπιλλίζων ἠμείβετο κερτομίοισιν·	- u u--- --uu -uu--	dactylic hexameter	masculine penthemimeral
‘ἄγρει νυν τόδε σῇσι θεοπροπίῃσιν ἐνίσπες,	-- - uu -u u-uu-u u--	dactylic hexameter	feminine penthemimeral, trithemimeral
εἰ καὶ ἐμοὶ τοιόνδε θεοὶ τελέουσιν ὄλεθρον,	- u u- --u u- uu-u u--	dactylic hexameter	feminine penthemimeral, hepthemimeral, trithemimeral
οἷον Ἀλωιάδῃσι πατὴρ τεὸς ἐγγυάλιξεν.	-u u-uu-u u- uu -uu--	dactylic hexameter	feminine penthemimeral, hepthemimeral
φράζεο δʼ ὅππως χεῖρας ἐμὰς σόος ἐξαλέοιο,	-uu -- -u u- uu -uu--	dactylic hexameter	feminine penthemimeral, hepthemimeral
χρειὼ θεσπίζων μεταμώνιον εἴ κεν ἁλῴης.’	-- --- uu-uu - u u--	dactylic hexameter	masculine penthemimeral
Χώετʼ ἐνιπτάζων· προτέρω δέ κε νεῖκος ἐτύχθη,	-u u--- uu- u u -u u--	dactylic hexameter	masculine penthemimeral, hepthemimeral
εἰ μὴ δηριόωντας ὁμοκλήσαντες ἑταῖροι	- - -uu-u u---u u--	dactylic hexameter	feminine penthemimeral
αὐτός τʼ Αἰσονίδης κατερήτυεν· ἂν δὲ καὶ Ὀρφεὺς	-- -uu- uu-uu - u u --	dactylic hexameter	masculine penthemimeral
λαιῇ ἀνασχόμενος κίθαριν πείραζεν ἀοιδῆς.	-u u-uu- uu- --u u--	dactylic hexameter	masculine penthemimeral, hepthemimeral
ἤειδεν δʼ ὡς γαῖα καὶ οὐρανὸς ἠδὲ θάλασσα,	--- - -u u -uu -u u--	dactylic hexameter	feminine penthemimeral, trithemimeral
τὸ πρὶν ἐπʼ ἀλλήλοισι μιῇ συναρηρότα μορφῇ,	- u u ---u u- uu-uu --	dactylic hexameter	feminine penthemimeral, hepthemimeral
νείκεος ἐξ ὀλοοῖο διέκριθεν ἀμφὶς ἕκαστα·	-uu - uu-u u-uu -u u--	dactylic hexameter	feminine penthemimeral, trithemimeral
ἠδʼ ὡς ἔμπεδον αἰὲν ἐν αἰθέρι τέκμαρ ἔχουσιν	- - -uu -u u -uu -u u--	dactylic hexameter	feminine penthemimeral
ἄστρα σεληναίη τε καὶ ἠελίοιο κέλευθοι·	-u u--- u u -uu-u u--	dactylic hexameter	masculine penthemimeral
οὔρεά θ᾽ὡς ἀνέτειλε, καὶ ὡς ποταμοὶ κελάδοντες	-uu - uu-u u - uu- uu--	dactylic hexameter	feminine penthemimeral, hepthemimeral, trithemimeral
αὐτῇσιν νύμφῃσι καὶ ἑρπετὰ πάντʼ ἐγένοντο.	--- --u u -uu - uu--	dactylic hexameter	feminine penthemimeral, trithemimeral
ἤειδεν δʼ ὡς πρῶτον Ὀφίων Εὐρυνόμη τε	--- - -u u-- -uu- -	dactylic hexameter	feminine penthemimeral, trithemimeral
Ὠκεανὶς νιφόεντος ἔχον κράτος Οὐλύμποιο·	-uu- uu-u u- uu ----	dactylic hexameter	feminine penthemimeral, hepthemimeral, trithemimeral
ὥς τε βίῃ καὶ χερσὶν ὁ μὲν Κρόνῳ εἴκαθε τιμῆς,	- u u- - -u u - uu -uu --	dactylic hexameter	feminine penthemimeral, hepthemimeral, trithemimeral
ἡ δὲ Ῥέῃ, ἔπεσον δʼ ἐνὶ κύμασιν Ὠκεανοῖο·	- u u- uu- uu -uu -uu--	dactylic hexameter	masculine penthemimeral, trithemimeral
οἱ δὲ τέως μακάρεσσι θεοῖς Τιτῆσιν ἄνασσον,	- u u- uu-u u- --u u--	dactylic hexameter	feminine penthemimeral, hepthemimeral, trithemimeral
ὄφρα Ζεὺς ἔτι κοῦρος, ἔτι φρεσὶ νήπια εἰδώς,	-- - uu -u u- uu -uu --	dactylic hexameter	feminine penthemimeral, hepthemimeral, trithemimeral
Δικταῖον ναίεσκεν ὑπὸ σπέος· οἱ δέ μιν οὔπω	--- --u u- uu - u u --	dactylic hexameter	feminine penthemimeral, hepthemimeral, trithemimeral
γηγενέες Κύκλωπες ἐκαρτύναντο κεραυνῷ,	-uu- --u u---u u--	dactylic hexameter	feminine penthemimeral, trithemimeral
βροντῇ τε στεροπῇ τε· τὰ γὰρ Διὶ κῦδος ὀπάζει.	-- - uu- u u - uu -u u--	dactylic hexameter	masculine penthemimeral, hepthemimeral, trithemimeral
ἦ, καὶ ὁ μὲν φόρμιγγα σὺν ἀμβροσίῃ σχέθεν αὐδῇ.	- u u - --u u -uu- uu --	dactylic hexameter	feminine penthemimeral, trithemimeral
τοὶ δʼ ἄμοτον λήξαντος ἔτι προύχοντο κάρηνα	- uu- --u u- --u u--	dactylic hexameter	feminine penthemimeral, hepthemimeral, trithemimeral
πάντες ὁμῶς ὀρθοῖσιν ἐπʼ οὔασιν ἠρεμέοντες	-u u- --u u -uu -uu--	dactylic hexameter	feminine penthemimeral, trithemimeral
κηληθμῷ· τοῖόν σφιν ἐνέλλιπε θέλκτρον ἀοιδῆς.	--- -- u u-uu -u u--	dactylic hexameter	masculine penthemimeral, trithemimeral
οὐδʼ ἐπὶ δὴν μετέπειτα κερασσάμενοι Διὶ λοιβάς,	- uu - uu-u u-uu- uu --	dactylic hexameter	feminine penthemimeral, trithemimeral
ἣ θέμις, ἑστηῶτες ἐπὶ γλώσσῃσι χέοντο	- uu ---u u- --u u--	dactylic hexameter	feminine penthemimeral, hepthemimeral
αἰθομέναις, ὕπνου δὲ διὰ κνέφας ἐμνώοντο.	-uu- -- u u- uu ----	dactylic hexameter	masculine penthemimeral, hepthemimeral, trithemimeral
αὐτὰρ ὅτʼ αἰγλήεσσα φαεινοῖς ὄμμασιν Ἠὼς	-u u ---u u-- -uu --	dactylic hexameter	feminine penthemimeral
Πηλίου αἰπεινὰς ἴδεν ἄκριας, ἐκ δʼ ἀνέμοιο	-uu --- uu -uu - uu--	dactylic hexameter	masculine penthemimeral
εὔδιοι ἐκλύζοντο τινασσομένης ἁλὸς ἄκραι,	-uu ---u u-uu- uu --	dactylic hexameter	feminine penthemimeral
δὴ τότʼ ἀνέγρετο Τῖφυς· ἄφαρ δʼ ὀρόθυνεν ἑταίρους	- u u-uu -u u- uu-u u--	dactylic hexameter	feminine penthemimeral, hepthemimeral
βαινέμεναί τʼ ἐπὶ νῆα καὶ ἀρτύνασθαι ἐρετμά.	-uu- uu -u u ---u u--	dactylic hexameter	feminine penthemimeral, trithemimeral
σμερδαλέον δὲ λιμὴν Παγασήιος ἠδὲ καὶ αὐτὴ	-uu- u u- uu-uu -u u --	dactylic hexameter	masculine penthemimeral, trithemimeral
Πηλιὰς ἴαχεν Ἀργὼ ἐπισπέρχουσα νέεσθαι.	-uu -uu -u u---u u--	dactylic hexameter	feminine penthemimeral
ἐν γάρ οἱ δόρυ θεῖον ἐλήλατο, τό ῥʼ ἀνὰ μέσσην	- - - uu -u u-uu - uu --	dactylic hexameter	feminine penthemimeral, trithemimeral
στεῖραν Ἀθηναίη Δωδωνίδος ἥρμοσε φηγοῦ.	-u u--- --uu -uu --	dactylic hexameter	masculine penthemimeral
οἱ δʼ ἀνὰ σέλματα βάντες ἐπισχερὼ ἀλλήλοισιν,	- uu -uu -u u-uu ----	dactylic hexameter	feminine penthemimeral
ὡς ἐδάσαντο πάροιθεν ἐρεσσέμεν ᾧ ἐνὶ χώρῳ,	- uu-u u-u u-uu - uu --	dactylic hexameter	feminine penthemimeral
εὐκόσμως σφετέροισι παρʼ ἔντεσιν ἑδριόωντο.	--- uu-u u -uu -uu--	dactylic hexameter	feminine penthemimeral, trithemimeral
μέσσῳ δʼ Ἀγκαῖος μέγα τε σθένος Ἡρακλῆος	-- --- uu - uu ----	dactylic hexameter	masculine penthemimeral, hepthemimeral
ἵζανον· ἄγχι δέ οἱ ῥόπαλον θέτο, καί οἱ ἔνερθεν	-uu -u u - uu- uu - u u--	dactylic hexameter	masculine penthemimeral, hepthemimeral
ποσσὶν ὑπεκλύσθη νηὸς τρόπις.· εἵλκετο δʼ ἤδη	-u u--- -- uu -uu --	dactylic hexameter	masculine penthemimeral, hepthemimeral
πείσματα, καὶ μέθυ λεῖβον ὕπερθʼ ἁλός. αὐτὰρ Ἰήσων	-uu - uu -u u- uu -u u--	dactylic hexameter	feminine penthemimeral, hepthemimeral, trithemimeral
δακρυόεις γαίης ἀπὸ πατρίδος ὄμματʼ ἔνεικεν.	-uu- -- uu -uu -u u--	dactylic hexameter	masculine penthemimeral, trithemimeral
οἱ δʼ ,ὥστʼ ἠίθεοι Φοίβῳ χορὸν ἢ ἐνὶ Πυθοῖ	- - -uu- -- uu - uu --	dactylic hexameter	masculine penthemimeral, hepthemimeral
ᾔ που ἐν Ὀρτυγίῃ, ἢ ἐφʼ ὕδασιν Ἰσμηνοῖο	- u u -uu- u u -uu ----	dactylic hexameter	masculine penthemimeral
στησάμενοι, φόρμιγγος ὑπαὶ περὶ βωμὸν ὁμαρτῇ	-uu- --u u- uu -u u--	dactylic hexameter	feminine penthemimeral, hepthemimeral, trithemimeral
ἐμμελέως κραιπνοῖσι πέδον ῥήσσωσι πόδεσσιν·	-uu- --u u- --u u--	dactylic hexameter	feminine penthemimeral, hepthemimeral, trithemimeral
ὧς οἱ ὑπʼ Ὀρφῆος κιθάρῃ πέπληγον ἐρετμοῖς	- u u --- uu- --u u--	dactylic hexameter	masculine penthemimeral, hepthemimeral
πόντου λάβρον ὕδωρ, ἐπὶ δὲ ῥόθια κλύζοντο·	-- -u u- uu - uu- ---	dactylic hexameter	masculine penthemimeral, hepthemimeral
ἀφρῷ δʼ ἔνθα καὶ ἔνθα κελαινὴ κήκιεν ἅλμη	-- -u u -u u-- -uu --	dactylic hexameter	feminine penthemimeral
δεινὸν μορμύρουσα ἐρισθενέων μένει ἀνδρῶν.	-- ---u u-uu- uu --	dactylic hexameter	feminine penthemimeral
στράπτε δʼ ὑπʼ ἠελίῳ φλογὶ εἴκελα νηὸς ἰούσης	-u u -uu- uu -uu -u u--	dactylic hexameter	masculine penthemimeral
τεύχεα· μακραὶ δʼ αἰὲν ἐλευκαίνοντο κέλευθοι,	-uu -- -u u---u u--	dactylic hexameter	feminine penthemimeral
ἀτραπὸς ὣς χλοεροῖο διειδομένη πεδίοιο.	-uu - uu-u u-uu- uu--	dactylic hexameter	feminine penthemimeral, trithemimeral
πάντες δʼ οὐρανόθεν λεῦσσον θεοὶ ἤματι κείνῳ	-- -uu- -- uu -uu --	dactylic hexameter	masculine penthemimeral, hepthemimeral
νῆα καὶ ἡμιθέων ἀνδρῶν μένος, οἳ τότʼ ἄριστοι	-u u -uu- -- uu - u u--	dactylic hexameter	masculine penthemimeral, hepthemimeral
πόντον ἐπιπλώεσκον· ἐπʼ ἀκροτάτῃσι δὲ νύμφαι	-u u---u u -uu-u u --	dactylic hexameter	feminine penthemimeral
Πηλιάδες κορυφῇσιν ἐθάμβεον εἰσορόωσαι	-uu- uu-u u-uu -uu--	dactylic hexameter	feminine penthemimeral, trithemimeral
ἔργον Ἀθηναίης Ἰτωνίδος, ἠδὲ καὶ αὐτοὺς	-u u--- --uu -u u --	dactylic hexameter	masculine penthemimeral
ἥρωας χείρεσσιν ἐπικραδάοντας ἐρετμά.	--- --u u-uu-u u--	dactylic hexameter	feminine penthemimeral, trithemimeral
αὐτὰρ ὅ γʼ ἐξ ὑπάτου ὄρεος κίεν ἄγχι θαλάσσης	-u u - uu- uu- uu -u u--	dactylic hexameter	masculine penthemimeral, hepthemimeral, trithemimeral
χείρων Φιλλυρίδης, πολιῇ δʼ ἐπὶ κύματος ἀγῇ	-- -uu- uu- uu -uu --	dactylic hexameter	masculine penthemimeral, hepthemimeral
τέγγε πόδας, καὶ πολλὰ βαρείῃ χειρὶ κελεύων,	-u u- - -u u-- -u u--	dactylic hexameter	feminine penthemimeral, trithemimeral
νόστον ἐπευφήμησεν ἀκηδέα νισσομένοισιν.	-u u---u u-uu -uu--	dactylic hexameter	feminine penthemimeral
σὺν καί οἱ παράκοιτις ἐπωλένιον φορέουσα	- - - uu-u u-uu- uu--	dactylic hexameter	feminine penthemimeral, trithemimeral
Πηλεΐδην Ἀχιλῆα, φίλῳ δειδίσκετο πατρί.	-uu- uu-u u- --uu --	dactylic hexameter	feminine penthemimeral, hepthemimeral, trithemimeral
οἱ δʼ ὅτε δὴ λιμένος περιηγέα κάλλιπον ἀκτὴν	- uu - uu- uu-uu -uu --	dactylic hexameter	masculine penthemimeral, trithemimeral
φραδμοσύνῃ μήτι τε δαΐφρονος Ἁγνιάδαο	-uu- -- u u-uu -uu--	dactylic hexameter	masculine penthemimeral, trithemimeral
Τίφυος, ὅς ῥʼ ἐνὶ χερσὶν ἐύξοα τεχνηέντως	-uu - uu -u u-uu ----	dactylic hexameter	feminine penthemimeral, trithemimeral
πηδάλιʼ ἀμφιέπεσκʼ, ὄφρʼ ἔμπεδον ἐξιθύνοι,	-uu -uu- - -uu ----	dactylic hexameter	masculine penthemimeral
δή ῥα τότε μέγαν ἱστὸν ἐνεστήσαντο μεσόδμῃ,	- u u- uu -u u---u u--	dactylic hexameter	feminine penthemimeral, trithemimeral
δῆσαν δὲ προτόνοισι, τανυσσάμενοι ἑκάτερθεν,	-- - uu-u u-uu- uu--	dactylic hexameter	feminine penthemimeral, trithemimeral
κὰδ δʼ αὐτοῦ λίνα χεῦαν, ἐπʼ ἠλακάτην ἐρύσαντες.	- -- uu -u u -uu- uu--	dactylic hexameter	feminine penthemimeral, trithemimeral
ἐν δὲ λιγὺς πέσεν οὖρος· ἐπʼ ἰκριόφιν δὲ κάλωας	- u u- uu -u u -uu- u u--	dactylic hexameter	feminine penthemimeral, trithemimeral
ξεστῇσιν περόνῃσι διακριδὸν ἀμφιβαλόντες	--- uu-u u-uu -uu--	dactylic hexameter	feminine penthemimeral, trithemimeral
Τισαίην εὔκηλοι ὑπὲρ δολιχὴν θέον ἄκρην.	--- --u u- uu- uu --	dactylic hexameter	feminine penthemimeral, hepthemimeral, trithemimeral
τοῖσι δὲ φορμίζων εὐθήμονι μέλπεν ἀοιδῇ	-u u --- --uu -u u--	dactylic hexameter	masculine penthemimeral
Οἰάγροιο πάις νηοσσόον εὐπατέρειαν	---u u- --uu -uu--	dactylic hexameter	masculine penthemimeral
Ἄρτεμιν, ἣ κείνας σκοπιὰς ἁλὸς ἀμφιέπεσκεν	-uu - -- uu- uu -uu--	dactylic hexameter	masculine penthemimeral, hepthemimeral, trithemimeral
ῥυομένη καὶ γαῖαν Ἰωλκίδα· τοὶ δὲ βαθείης	-uu- - -u u-uu - u u--	dactylic hexameter	feminine penthemimeral, trithemimeral
ἰχθύες ἀίσσοντες ὕπερθʼ ἁλός, ἄμμιγα παύροις	-uu ---u u- uu -uu --	dactylic hexameter	feminine penthemimeral, hepthemimeral
ἄπλετοι, ὑγρὰ κέλευθα διασκαίροντες ἕποντο.	-uu -u u-u u---u u--	dactylic hexameter	feminine penthemimeral
ὡς δʼ ὁπότʼ ἀγραύλοιο κατʼ ἴχνια σημαντῆρος	- uu ---u u -uu ----	dactylic hexameter	feminine penthemimeral
μυρία μῆλʼ ἐφέπονται ἄδην κεκορημένα ποίης	-uu - uu-u u- uu-uu --	dactylic hexameter	feminine penthemimeral, hepthemimeral, trithemimeral
εἰς αὖλιν, ὁ δέ τʼ εἶσι πάρος σύριγ γι λιγείῃ	- -- u u -u u- -- u u--	dactylic hexameter	feminine penthemimeral, hepthemimeral, trithemimeral
καλὰ μελιζόμενος νόμιον μέλος, ὧς ἄρα τοί γε	-u u-uu- uu- uu - uu - -	dactylic hexameter	masculine penthemimeral, hepthemimeral
ὡμάρτευν· τὴν δʼ αἰὲν ἐπασσύτερος φέρεν οὖρος.	--- - -u u-uu- uu --	dactylic hexameter	feminine penthemimeral, trithemimeral
αὐτίκα δʼ ἠερίη πολυλήιος αἶα Πελασγῶν	-uu -uu- uu-uu -u u--	dactylic hexameter	masculine penthemimeral
δύετο, Πηλιάδας δὲ παρεξήμειβον ἐρίπνας	-uu -uu- u u---u u--	dactylic hexameter	masculine penthemimeral
αἰὲν ἐπιπροθέοντες· ἔδυνε δὲ Σηπιὰς ἄκρη,	-u u-uu-u u-u u -uu --	dactylic hexameter	feminine penthemimeral
φαίνετο δʼ εἰναλίη Σκίαθος, φαίνοντο δʼ ἄπωθεν	-uu -uu- uu- --u u--	dactylic hexameter	masculine penthemimeral, hepthemimeral
Πειρεσιαὶ Μάγνησά θ᾽ὑπεύδιος ἠπείροιο	-uu- --u u-uu ----	dactylic hexameter	feminine penthemimeral, trithemimeral
ἀκτὴ καὶ τύμβος Δολοπήιος· ἔνθʼ ἄρα τοί γε	-- - -- uu-uu - uu - -	dactylic hexameter	masculine penthemimeral, trithemimeral
ἑσπέριοι ἀνέμοιο παλιμπνοίῃσιν ἔκελσαν,	-uu- uu-u u---u u--	dactylic hexameter	feminine penthemimeral, trithemimeral
καί μιν κυδαίνοντες ὑπὸ κνέφας ἔντομα μήλων	- - ---u u- uu -uu --	dactylic hexameter	feminine penthemimeral, hepthemimeral
κεῖαν, ὀρινομένης ἁλὸς οἴδματι· διπλόα δʼ ἀκταῖς	-u u-uu- uu -uu -uu --	dactylic hexameter	masculine penthemimeral
ἤματʼ ἐλινύεσκον· ἀτὰρ τριτάτῳ προέηκαν	-u u---u u- uu- uu--	dactylic hexameter	feminine penthemimeral, hepthemimeral
νῆα, τανυσσάμενοι περιώσιον ὑψόθι λαῖφος.	-u u-uu- uu-uu -uu --	dactylic hexameter	masculine penthemimeral
τὴν δʼ ἀκτὴν Ἀφέτας Ἀργοῦς ἔτι κικλήσκουσιν.	- -- uu- -- uu ----	dactylic hexameter	masculine penthemimeral, hepthemimeral, trithemimeral
ἔνθεν δὲ προτέρωσε παρεξέθεον Μελίβοιαν.	-- - uu-u u-uu- uu--	dactylic hexameter	feminine penthemimeral, trithemimeral
[ἀκτήν τʼ αἰγιαλόν τε δυσήνεμον εἰσορόωντες.	-- -uu- u u-uu -uu--	dactylic hexameter	masculine penthemimeral
ἠῶθεν δʼ Ὁμόλην αὐτοσχεδὸν εἰσορόωντες	--- uu- --uu -uu--	dactylic hexameter	masculine penthemimeral, trithemimeral
πόντῳ κεκλιμένην παρεμέτρεον· οὐδʼ ἔτι δηρὸν	-- -uu- uu-uu - uu --	dactylic hexameter	masculine penthemimeral
μέλλον ὑπὲκ ποταμοῖο βαλεῖν Ἀμύροιο ῥέεθρα.	-u u- uu-u u- uu-u u--	dactylic hexameter	feminine penthemimeral, hepthemimeral, trithemimeral
κεῖθεν δʼ Εὐρυμενάς τε πολυκλύστους τε φάραγγας	-- -uu- u u--- u u--	dactylic hexameter	masculine penthemimeral
Ὄσσης Οὐλύμποιό τʼ ἐσέδρακον· αὐτὰρ ἔπειτα	-- ---u u-uu -u u--	dactylic hexameter	feminine penthemimeral
κλίτεα Παλλήναια, Καναστραίην ὑπὲρ ἄκρην,	-uu ---u u--- uu --	dactylic hexameter	feminine penthemimeral
ἤνυσαν ἐννύχιοι πνοιῇ ἀνέμοιο θέοντες.	-uu -uu- -- uu-u u--	dactylic hexameter	masculine penthemimeral, hepthemimeral
ἦρι δὲ νισσομένοισιν Ἄθω ἀνέτελλε κολώνη	-u u -uu-u u- uu-u u--	dactylic hexameter	feminine penthemimeral, hepthemimeral
Θρηικίη, ἣ τόσσον ἀπόπροθι Λῆμνον ἐοῦσαν,	-uu- - -u u-uu -u u--	dactylic hexameter	feminine penthemimeral, trithemimeral
ὅσσον ἐς ἔνδιόν κεν ἐύστολος ὁλκὰς ἀνύσσαι,	-u u --- u u-uu -u u--	dactylic hexameter	masculine penthemimeral
ἀκροτάτῃ κορυφῇ σκιάει, καὶ ἐσάχρι Μυρίνης.	-uu- uu- uu- u u-u u--	dactylic hexameter	masculine penthemimeral, hepthemimeral, trithemimeral
τοῖσιν δʼ αὐτῆμαρ μὲν ἄεν καὶ ἐπι κνέφας οὖρος	-- --- u u- u u- uu --	dactylic hexameter	masculine penthemimeral, hepthemimeral
πάγχυ μάλʼ ἀκραής, τετάνυστο δὲ λαίφεα νηός.	-u u --- uu-u u -uu --	dactylic hexameter	masculine penthemimeral
αὐτὰρ ἅμʼ ἠελίοιο βολαῖς ἀνέμοιο λιπόντος	-u u -uu-u u- uu-u u--	dactylic hexameter	feminine penthemimeral, hepthemimeral
εἰρεσίῃ κραναὴν Σιντηίδα Λῆμνον ἵκοντο.	-uu- uu- --uu -u u--	dactylic hexameter	masculine penthemimeral, trithemimeral
ἔνθʼ ἄμυδις πᾶς δῆμος ὑπερβασίῃσι γυναικῶν	- uu- - -u u-uu-u u--	dactylic hexameter	feminine penthemimeral, trithemimeral
νηλειῶς δέδμητο παροιχομένῳ λυκάβαντι.	--- --u u-uu- uu--	dactylic hexameter	feminine penthemimeral, trithemimeral
δὴ γὰρ κουριδίας μὲν ἀπηνήναντο γυναῖκας	- - -uu- u u---u u--	dactylic hexameter	masculine penthemimeral
ἀνέρες ἐχθήραντες, ἔχον δʼ ἐπὶ ληιάδεσσιν	-uu ---u u- uu -uu--	dactylic hexameter	feminine penthemimeral, hepthemimeral
τρηχὺν ἔρον, ἃς αὐτοὶ ἀγίνεον ἀντιπέρηθεν	-u u- - -u u-uu -uu--	dactylic hexameter	feminine penthemimeral, trithemimeral
Θρηικίην δῃοῦντες· ἐπεὶ χόλος αἰνὸς ὄπαζεν	-uu- --u u- uu -u u--	dactylic hexameter	feminine penthemimeral, hepthemimeral, trithemimeral
Κύπιδος, οὕνεκά μιν γεράων ἐπὶ δηρὸν ἄτισσαν.	-uu -uu - uu- uu -u u--	dactylic hexameter	masculine penthemimeral, hepthemimeral
ὦ μέλεαι, ζήλοιό τʼ ἐπισμυγερῶς ἀκόρητοι.	- uu- --u u-uu- uu--	dactylic hexameter	feminine penthemimeral, trithemimeral
οὐκ οἶον σὺν τῇσιν ἑοὺς ἔρραισαν ἀκοίτας	- -- - -u u- --u u--	dactylic hexameter	feminine penthemimeral, hepthemimeral, trithemimeral
ἀμφʼ εὐνῇ, πᾶν δʼ ἄρσεν ὁμοῦ γένος, ὥς κεν ὀπίσσω	- -- - -u u- uu - u u--	dactylic hexameter	feminine penthemimeral, hepthemimeral, trithemimeral
μήτινα λευγαλέοιο φόνου τίσειαν ἀμοιβήν.	-uu -uu-u u- --u u--	dactylic hexameter	feminine penthemimeral, hepthemimeral
οἴη δʼ ἐκ πασέων γεραροῦ περιφείσατο πατρὸς	-- - uu- uu- uu-uu --	dactylic hexameter	masculine penthemimeral, hepthemimeral, trithemimeral
Ὑψιπύλεια Θόαντος, ὃ δὴ κατὰ δῆμον ἄνασσεν·	-uu-u u-u u - uu -u u--	dactylic hexameter	feminine penthemimeral, hepthemimeral
λάρνακι δʼ ἐν κοίλῃ μιν ὕπερθʼ ἁλὸς ἧκε φέρεσθαι,	-uu - -- u u- uu -u u--	dactylic hexameter	masculine penthemimeral, hepthemimeral, trithemimeral
αἴ κε φύγῃ. καὶ τὸν μὲν ἐς Οἰνοίην ἐρύσαντο	- u u- - - u u --- uu--	dactylic hexameter	masculine penthemimeral, trithemimeral
πρόσθεν, ἀτὰρ Σίκινόν γε μεθύστερον αὐδηθεῖσαν	-u u- uu- u u-uu ----	dactylic hexameter	masculine penthemimeral, trithemimeral
νῆσον, ἐπακτῆρες, Σικίνου ἄπο, τόν ῥα Θόαντι	-u u--- uu- uu - u u--	dactylic hexameter	masculine penthemimeral, hepthemimeral
νηιὰς Οἰνοίη νύμφη τέκεν εὐνηθεῖσα.	-uu --- -- uu ----	dactylic hexameter	masculine penthemimeral, hepthemimeral
τῇσι δὲ βουκόλιαί τε βοῶν χάλκειά τε δύνειν	-u u -uu- u u- --u u --	dactylic hexameter	masculine penthemimeral, hepthemimeral
τεύχεα, πυροφόρους τε διατμήξασθαι ἀροὔρας	-uu -uu- u u---u u--	dactylic hexameter	masculine penthemimeral
ῥηίτερον πάσῃσιν Ἀθηναίης πέλεν ἔργων,	-uu- --u u--- uu --	dactylic hexameter	feminine penthemimeral, trithemimeral
οἷς αἰεὶ τὸ πάροιθεν ὁμίλεον. ἀλλὰ γὰρ ἔμπης	- -- u u-u u-uu -u u --	dactylic hexameter	feminine penthemimeral, trithemimeral
ἦ θαμὰ δὴ πάπταινον ἐπὶ πλατὺν ὄμμασι πόντον	- uu - --u u- uu -uu --	dactylic hexameter	feminine penthemimeral, hepthemimeral, trithemimeral
δείματι λευγαλέῳ, ὁπότε Θρήικες ἴασιν.	-uu -uu- uu- --u u--	dactylic hexameter	masculine penthemimeral, hepthemimeral
τῶ καὶ ὅτʼ ἐγγύθι νήσου ἐρεσσομένην ἴδον Ἀργώ,	- u u -uu -u u-uu- uu --	dactylic hexameter	feminine penthemimeral
αὐτίκα πασσυδίῃ πυλέων ἔκτοσθε Μυρίνης	-uu -uu- uu- --u u--	dactylic hexameter	masculine penthemimeral, hepthemimeral
δήια τεύχεα δῦσαι ἐς αἰγιαλὸν προχέοντο,	-uu -uu -u u -uu- uu--	dactylic hexameter	feminine penthemimeral
Θυιάσιν ὠμοβόροις ἴκελαι· φὰν γάρ που ἱκάνειν	-uu -uu- uu- - - u u--	dactylic hexameter	masculine penthemimeral, hepthemimeral
Θρήικας· ἡ δʼ ἅμα τῇσι Θοαντιὰς Ὑψιπύλεια	-uu - uu -u u-uu -uu--	dactylic hexameter	feminine penthemimeral, trithemimeral
δῦνʼ ἐνὶ τεύχεσι πατρός. ἀμηχανίῃ δʼ ἐχέοντο	- uu -uu -u u-uu- uu--	dactylic hexameter	feminine penthemimeral
ἄφθογγοι· τοῖόν σφιν ἐπὶ δέος ᾐωρεῖτο.	--- -- u u- uu ----	dactylic hexameter	masculine penthemimeral, hepthemimeral, trithemimeral
τείως δʼ αὖτʼ ἐκ νηὸς ἀριστῆες προέηκαν	-- - - -u u--- uu--	dactylic hexameter	feminine penthemimeral, trithemimeral
Αἰθαλίδην κήρυκα θοόν, τῷπέρ τε μέλεσθαι	-uu- --u u- -- u u--	dactylic hexameter	feminine penthemimeral, hepthemimeral, trithemimeral
ἀγγελίας καὶ σκῆπτρον ἐπέτρεπον Ἑρμείαο,	-uu- - -u u-uu ----	dactylic hexameter	feminine penthemimeral, trithemimeral
σφωιτέροιο τοκῆος, ὅ οἱ μνῆστιν πόρε πάντων	-uu-u u-u u - -- uu --	dactylic hexameter	feminine penthemimeral, hepthemimeral
ἄφθιτον· οὐδʼ ἔτι νῦν περ ἀποιχομένου Ἀχέροντος	-uu - uu - u u-uu- uu--	dactylic hexameter	masculine penthemimeral, trithemimeral
δίνας ἀπροφάτους ψυχὴν ἐπιδέδρομε λήθη·	-- -uu- -- uu-uu --	dactylic hexameter	masculine penthemimeral, hepthemimeral
ἀλλʼ ἥγʼ ἔμπεδον αἰὲν ἀμειβομένη μεμόρηται,	- - -uu -u u-uu- uu--	dactylic hexameter	feminine penthemimeral
ἄλλοθʼ ὑποχθονίοις ἐναρίθμιος, ἄλλοτʼ ἐς αὐγὰς	-u u-uu- uu-uu -u u --	dactylic hexameter	masculine penthemimeral
ἠελίου ζωοῖσι μετʼ ἀνδράσιν. ἀλλὰ τί μύθους	-uu- --u u -uu -u u --	dactylic hexameter	feminine penthemimeral, trithemimeral
Αἰθαλίδεω χρειώ με διηνεκέως ἀγορεύειν;	-uu- -- u u-uu- uu--	dactylic hexameter	masculine penthemimeral, trithemimeral
ὅς ῥα τόθʼ Ὑψιπύλην μειλίξατο δέχθαι ἰόντας	- u u -uu- --uu -u u--	dactylic hexameter	masculine penthemimeral
ἤματος ἀνομένοιο διὰ κνέφας· οὐδὲ μὲν ἠοῖ	-uu -uu-u u- uu -u u --	dactylic hexameter	feminine penthemimeral, hepthemimeral
πείσματα νηὸς ἔλυσαν ἐπὶ πνοιῇ βορέαο.	-uu -u u-u u- -- uu--	dactylic hexameter	feminine penthemimeral, hepthemimeral
Λημνιάδες δὲ γυναῖκες ἀνὰ πτόλιν ἷζον ἰοῦσαι	-uu- u u-u u- uu -u u--	dactylic hexameter	feminine penthemimeral, hepthemimeral, trithemimeral
εἰς ἀγορήν· αὐτὴ γὰρ ἐπέφραδεν Ὑψιπύλεια.	- uu- -- u u-uu -uu--	dactylic hexameter	masculine penthemimeral, trithemimeral
καί ῥʼ ὅτε δὴ μάλα πᾶσαι ὁμιλαδὸν ἠγερέθοντο,	- uu - uu -u u-uu -uu--	dactylic hexameter	feminine penthemimeral, trithemimeral
αὐτίκʼ ἄρʼ ἥ γʼ ἐνὶ τῇσιν ἐποτρύνουσʼ ἀγόρευεν·	-u u - uu -u u--- uu--	dactylic hexameter	feminine penthemimeral, trithemimeral
‘Ὦφιλαι, εἰ δʼ ἄγε δὴ μενοεικέα δῶρα πόρωμεν	-uu - uu - uu-uu -u u--	dactylic hexameter	masculine penthemimeral, trithemimeral
ἀνδράσιν, οἷά τʼ ἔοικεν ἄγειν ἐπὶ νηὸς ἔχοντας,	-uu -u u-u u- uu -u u--	dactylic hexameter	feminine penthemimeral, hepthemimeral
ἤια, καὶ μέθυ λαρόν, ἵνʼ ἔμπεδον ἔκτοθι πύργων	-uu - uu -u u -uu -uu --	dactylic hexameter	feminine penthemimeral, trithemimeral
μίμνοιεν, μηδʼ ἄμμε κατὰ χρειὼ μεθέποντες	--- - -u u- -- uu--	dactylic hexameter	feminine penthemimeral, hepthemimeral, trithemimeral
ἀτρεκέως γνώωσι, κακὴ δʼ ἐπὶ πολλὸν ἵκηται	-uu- --u u- uu -u u--	dactylic hexameter	feminine penthemimeral, hepthemimeral, trithemimeral
βάξις· ἐπεὶ μέγα ἔργον ἐρέξαμεν, οὐδέ τι πάμπαν	-u u- uu -u u-uu -u u --	dactylic hexameter	feminine penthemimeral, trithemimeral
θυμηδὲς καὶ τοῖσι τό γʼ ἔσσεται, εἴ κε δαεῖεν.	--- - -u u -uu - u u--	dactylic hexameter	feminine penthemimeral, trithemimeral
ἡμετέρη μὲν νῦν τοίη παρενήνοθε μῆτις·	-uu- - - -- uu-uu --	dactylic hexameter	masculine penthemimeral, hepthemimeral, trithemimeral
ὑμέων δʼ εἴ τις ἄρειον ἔπος μητίσεται ἄλλη,	-- - u u-u u- --uu --	dactylic hexameter	feminine penthemimeral, hepthemimeral, trithemimeral
ἐγρέσθω· τοῦ γάρ τε καὶ εἵνεκα δεῦρʼ ἐκάλεσσα.’	--- - - u u -uu - uu--	dactylic hexameter	masculine penthemimeral, trithemimeral
ὧς ἄρʼ ἔφη, καὶ θῶκον ἐφίζανε πατρὸς ἑοῖο	- u u- - -u u-uu -u u--	dactylic hexameter	feminine penthemimeral, trithemimeral
λάινον· αὐτὰρ ἔπειτα φίλη τροφὸς ὦρτο Πολυξώ,	-uu -u u-u u- uu -u u--	dactylic hexameter	feminine penthemimeral, hepthemimeral
γήραϊ δὴ ῥικνοῖσιν ἐπισκάζουσα πόδεσσιν,	-uu - --u u---u u--	dactylic hexameter	feminine penthemimeral, trithemimeral
βάκτρῳ ἐρειδομένη, περὶ δὲ μενέαινʼ ἀγορεῦσαι.	-u u-uu- uu - uu- uu--	dactylic hexameter	masculine penthemimeral, hepthemimeral
τῇ καὶ παρθενικαὶ πίσυρες σχεδὸν ἑδριόωντο	- - -uu- uu- uu -uu--	dactylic hexameter	masculine penthemimeral, hepthemimeral
ἀδμῆτες λευκῇσιν ἐπιχνοαούσῃ ἐθείραις.	--- --u u-uu-u u--	dactylic hexameter	feminine penthemimeral, trithemimeral
στῆ δʼ ἄρʼ ἐνὶ μέσσῃ ἀγορῇ, ἀνὰ δʼ ἔσχεθε δειρὴν	- u u- -- uu- uu -uu --	dactylic hexameter	masculine penthemimeral, hepthemimeral, trithemimeral
ἦκα μόλις κυφοῖο μεταφρένου, ὧδέ τʼ ἔειπεν·	-u u- --u u-uu -u u--	dactylic hexameter	feminine penthemimeral, trithemimeral
‘δῶρα μέν, ὡς αὐτῇ περ ἐφανδάνει Ὑψιπυλείῃ,	-u u - -- u u-uu -uu--	dactylic hexameter	masculine penthemimeral, trithemimeral
πέμπωμεν ξείνοισιν, ἐπεὶ καὶ ἄρειον ὀπάσσαι.	--- --u u- u u-u u--	dactylic hexameter	feminine penthemimeral, hepthemimeral, trithemimeral
ὔμμι γε μὴν τίς μῆτις ἐπαύρεσθαι βιότοιο,	-u u - - -u u--- uu--	dactylic hexameter	feminine penthemimeral, trithemimeral
αἴ κεν ἐπιβρίσῃ Θρήιξ στρατός, ἠέ τις ἄλλος	- u u--- -- uu -u u --	dactylic hexameter	masculine penthemimeral, hepthemimeral
δυσμενέων, ἅ τε πολλὰ μετʼ ἀνθρώποισι πέλονται;	-uu- u u -u u ---u u--	dactylic hexameter	feminine penthemimeral, trithemimeral
ὡς καὶ νῦν ὅδʼ ὅμιλος ἀνωίστως ἐφικάνει.	- - - u u-u u--- uu--	dactylic hexameter	feminine penthemimeral, trithemimeral
εἰ δὲ τὸ μὲν μακάρων τις ἀποτρέποι, ἄλλα δʼ ὀπίσσω	- u u - uu- u u-uu -u u--	dactylic hexameter	masculine penthemimeral, trithemimeral
μυρία δηιοτῆτος ὑπέρτερα πήματα μίμνει,	-uu -uu-u u-uu -uu --	dactylic hexameter	feminine penthemimeral
εὖτʼ ἂν δὴ γεραραὶ μὲν ἀποφθινύθωσι γυναῖκες,	- - - uu- u u-uu-u u--	dactylic hexameter	masculine penthemimeral, trithemimeral
κουρότεραι δʼ ἄγονοι στυγερὸν ποτὶ γῆρας ἵκησθε.	-uu- uu- uu- uu -u u--	dactylic hexameter	masculine penthemimeral, hepthemimeral, trithemimeral
πῶς τῆμος βώσεσθε δυσάμμοροι; ἦε βαθείαις	- -- --u u-uu -u u--	dactylic hexameter	feminine penthemimeral, trithemimeral
αὐτόματοι βόες ὔμμιν ἐνιζευχθέντες ἀρούραις	-uu- uu -u u---u u--	dactylic hexameter	feminine penthemimeral, trithemimeral
γειοτόμον νειοῖο διειρύσσουσιν ἄροτρον,	-uu- --u u---u u--	dactylic hexameter	feminine penthemimeral, trithemimeral
καὶ πρόκα τελλομένου ἔτεος στάχυν ἀμήσονται;	- uu -uu- uu- uu ----	dactylic hexameter	masculine penthemimeral, hepthemimeral
ἦ μὲν ἐγών, εἰ καί με τὰ νῦν ἔτι πεφρίκασιν	- u u- - - u u - uu -u--	lyric	
κῆρες, ἐπερχόμενόν που ὀίομαι εἰς ἔτος ἤδη	-u u-uu- u u-uu - uu --	dactylic hexameter	masculine penthemimeral
γαῖαν ἐφέσσεσθαι, κτερέων ἀπὸ μοῖραν ἑλοῦσαν	-u u--- uu- uu -u u--	dactylic hexameter	masculine penthemimeral, hepthemimeral
αὔτως, ἣ θέμις ἐστί, πάρος κακότητα πελάσσαι.	-- - uu -u u- uu-u u--	dactylic hexameter	feminine penthemimeral, hepthemimeral, trithemimeral
ὁπλοτέρῃσι δὲ πάγχυ τάδε φράζεσθαι ἄνωγα.	-uu-u u -u u- --u u--	dactylic hexameter	feminine penthemimeral, hepthemimeral
νῦν γὰρ δὴ παρὰ ποσσὶν ἐπήβολός ἐστʼ ἀλεωρή,	- - - uu -u u-uu - uu--	dactylic hexameter	feminine penthemimeral, trithemimeral
εἴ κεν ἐπιτρέψητε δόμους καὶ ληίδα πᾶσαν	- u u---u u- - -uu --	dactylic hexameter	feminine penthemimeral, hepthemimeral
ὑμετέρην ξείνοισι καὶ ἀγλαὸν ἄστυ μέλεσθαι.’	-uu- --u u -uu -u u--	dactylic hexameter	feminine penthemimeral, trithemimeral
ὧς ἔφατʼ· ἐν δʼ ἀγορὴ πλῆτο θρόου. εὔαδε γάρ σφιν	- uu - uu- -- uu -uu - -	dactylic hexameter	masculine penthemimeral, hepthemimeral, trithemimeral
μῦθος. ἀτὰρ μετὰ τήνγε παρασχεδὸν αὖτις ἀνῶρτο	-u u- uu -u u-uu -u u--	dactylic hexameter	feminine penthemimeral, trithemimeral
Ὑψιπύλη, καὶ τοῖον ὑποβλήδην ἔπος ηὔδα·	-uu- - -u u--- uu --	dactylic hexameter	feminine penthemimeral, trithemimeral
‘εἰ μὲν δὴ πάσῃσιν ἐφανδάνει ἥδε μενοινή,	- - - --u u-uu -u u--	dactylic hexameter	feminine penthemimeral, trithemimeral
ἤδη κεν μετὰ νῆα καὶ ἄγγελον ὀτρύναιμι.’	-- - uu -u u -uu ----	dactylic hexameter	feminine penthemimeral, trithemimeral
ἦ ῥα, καὶ Ἰφινόην μετεφώνεεν ἆσσον ἐοῦσαν·	- u u -uu- uu-uu -u u--	dactylic hexameter	masculine penthemimeral
‘ὄρσο μοι, Ἰφινόη, τοῦδʼ ἀνέρος ἀντιόωσα,	-u u -uu- - -uu -uu--	dactylic hexameter	masculine penthemimeral
ἡμέτερόνδε μολεῖν, ὅστις στόλου ἡγεμονεύει,	-uu-u u- -- uu -uu--	dactylic hexameter	masculine penthemimeral, hepthemimeral
ὄφρα τί οἱ δήμοιο ἔπος θυμῆρες ἐνίσπω·	-u u - --u u- --u u--	dactylic hexameter	feminine penthemimeral, hepthemimeral, trithemimeral
καὶ δʼ αὐτοὺς γαίης τε καὶ ἄστεος, αἴ κʼ ἐθέλωσιν,	- -- -- u u -uu - uu--	dactylic hexameter	masculine penthemimeral, trithemimeral
κέκλεο θαρσαλέως ἐπιβαινέμεν εὐμενέοντας.’	-uu -uu- uu-uu -uu--	dactylic hexameter	masculine penthemimeral
ἦ, καὶ ἔλυσʼ ἀγορήν, μετὰ δʼ εἰς ἑὸν ὦρτο νέεσθαι.	- u u- uu- uu - uu -u u--	dactylic hexameter	masculine penthemimeral, hepthemimeral, trithemimeral
ὧς δὲ καὶ Ἰφινόη Μινύας ἵκεθʼ· οἱ δʼ ἐρέεινον,	- u u -uu- uu- uu - uu--	dactylic hexameter	masculine penthemimeral, hepthemimeral
χρεῖος ὅ τι φρονέουσα μετήλυθεν. ὦκα δὲ τούς γε	-u u - uu-u u-uu -u u - -	dactylic hexameter	feminine penthemimeral, trithemimeral
πασσυδίῃ μύθοισι προσέννεπεν ἐξερέοντας·	-uu- --u u-uu -uu--	dactylic hexameter	feminine penthemimeral, trithemimeral
‘κούρη τοί μ᾽ἐφέηκε Θοαντιὰς ἐνθάδʼ ἰοῦσαν,	-- - ---u u-uu -u u--	lyric	
Ὑψιπύλη, καλέειν νηὸς πρόμον, ὅστις ὄρωρεν,	-uu- uu- -- uu -u u--	dactylic hexameter	masculine penthemimeral, hepthemimeral, trithemimeral
ὄφρα τί οἱ δήμοιο ἔπος θυμῆρες ἐνίσπῃ·	-u u - --u u- --u u--	dactylic hexameter	feminine penthemimeral, hepthemimeral, trithemimeral
καὶ δʼ αὐτοὺς γαίης τε καὶ ἄστεος, αἴ κʼ ἐθέλητε,	- -- -- u u -uu - uu--	dactylic hexameter	masculine penthemimeral, trithemimeral
κέκλεται αὐτίκα νῦν ἐπιβαινέμεν εὐμενέοντας.’	-uu -uu - uu-uu -uu--	dactylic hexameter	masculine penthemimeral
ὧς ἄρʼ ἔφη· πάντεσσι δʼ ἐναίσιμος ἥνδανε μῦθος.	- u u- --u u-uu -uu --	dactylic hexameter	feminine penthemimeral, trithemimeral
Υψιπύλην δʼ εἴσαντο καταφθιμένοιο Θόαντος	-uu- --u u-uu-u u--	dactylic hexameter	feminine penthemimeral, trithemimeral
τηλυγέτην γεγαυῖαν ἀνασσέμεν· ὦκα δὲ τόν γε	-uu- uu-u u-uu -u u - -	dactylic hexameter	feminine penthemimeral, trithemimeral
πέμπον ἴμεν, καὶ δʼ αὐτοὶ ἐπεντύνοντο νέεσθαι.	-u u- - -u u---u u--	dactylic hexameter	feminine penthemimeral, trithemimeral
αὐτὰρ ὅ γʼ ἀμφʼ ὤμοισι θεᾶς Τριτωνίδος ἔργον,	-u u - --u u- --uu --	dactylic hexameter	feminine penthemimeral, hepthemimeral, trithemimeral
δίπλακα πορφυρέην περονήσατο, τήν οἱ ὄπασσεν	-uu -uu- uu-uu - u u--	dactylic hexameter	masculine penthemimeral
Παλλάς, ὅτε πρῶτον δρυόχους ἐπεβάλλετο νηὸς	-u u- -- uu- uu-uu --	dactylic hexameter	masculine penthemimeral, hepthemimeral, trithemimeral
Ἀργοῦς, καὶ κανόνεσσι δάε ζυγὰ μετρήσασθαι.	-- - uu-u u- uu ----	dactylic hexameter	feminine penthemimeral, hepthemimeral, trithemimeral
τῆς μὲν ῥηίτερόν κεν ἐς ἠέλιον ἀνιόντα	- - -uu- u u -uu- uu--	dactylic hexameter	masculine penthemimeral
ὄσσε βάλοις, ἢ κεῖνο μεταβλέψειας ἔρευθος.	-u u- - -u u---u u--	dactylic hexameter	feminine penthemimeral, trithemimeral
δὴ γάρ τοι μέσση μὲν ἐρευθήεσσʼ ἐτέτυκτο,	- - - -- u u--- uu--	dactylic hexameter	masculine penthemimeral, trithemimeral
ἄκρα δὲ πορφυρέη πάντῃ πέλεν· ἐν δʼ ἄρʼ ἑκάστῳ	-u u -uu- -- uu - u u--	dactylic hexameter	masculine penthemimeral, hepthemimeral
τέρματι δαίδαλα πολλὰ διακριδὸν εὖ ἐπέπαστο.	-uu -uu -u u-uu - uu--	dactylic hexameter	feminine penthemimeral
ἐν μὲν ἔσαν Κύκλωπες ἐπʼ ἀφθίτῳ ἥμενοι ἔργῳ,	- u u- --u u -uu -uu --	dactylic hexameter	feminine penthemimeral, trithemimeral
Ζηνὶ κεραυνὸν ἄνακτι πονεύμενοι· ὃς τόσον ἤδη	-u u-u u-u u-uu - uu --	dactylic hexameter	feminine penthemimeral
παμφαίνων ἐτέτυκτο, μιῆς δʼ ἔτι δεύετο μοῦνον	--- uu-u u- uu -uu --	dactylic hexameter	feminine penthemimeral, hepthemimeral, trithemimeral
ἀκτῖνος, τὴν οἵδε σιδηρείῃς ἐλάασκον	--- - -u u--- uu--	dactylic hexameter	feminine penthemimeral, trithemimeral
σφύρῃσιν, μαλεροῖο πυρὸς ζείουσαν ἀυτμήν.	--- uu-u u- --u u--	dactylic hexameter	feminine penthemimeral, hepthemimeral, trithemimeral
ἐν δʼ ἔσαν Ἀντιόπης Ἀσωπίδος υἱέε δοιώ,	- uu -uu- --uu -uu --	dactylic hexameter	masculine penthemimeral
Ἀμφίων καὶ Ζῆθος· ἀπύργωτος δʼ ἔτι Θήβη	--- - -u u--- uu --	dactylic hexameter	feminine penthemimeral, trithemimeral
κεῖτο πέλας, τῆς οἵγε νέον βάλλοντο δομαίους	-u u- - -u u- --u u--	dactylic hexameter	feminine penthemimeral, hepthemimeral, trithemimeral
ἱέμενοι. Ζῆθος μὲν ἐπωμαδὸν ἠέρταζεν	-uu- -- u u-uu ----	dactylic hexameter	masculine penthemimeral, trithemimeral
οὔρεος ἠλιβάτοιο κάρη, μογέοντι ἐοικώς·	-uu -uu-u u- uu-u u--	dactylic hexameter	feminine penthemimeral, hepthemimeral
Ἀμφίων δʼ ἐπί οἱ χρυσέῃ φόρμιγγι λιγαίνων	--- uu - uu- --u u--	dactylic hexameter	masculine penthemimeral, hepthemimeral, trithemimeral
ἤιε, δὶς τόσση δὲ μετʼ ἴχνια νίσσετο πέτρη	-uu - -- u u -uu -uu --	dactylic hexameter	masculine penthemimeral, trithemimeral
ἑξείης δʼ ἤσκητο βαθυπλόκαμος Κυθέρεια	--- --u u-uu- uu--	dactylic hexameter	feminine penthemimeral, trithemimeral
Ἄρεος ὀχμάζουσα θοὸν σάκος· ἐκ δέ οἱ ὤμου	-uu ---u u- uu - u u --	dactylic hexameter	feminine penthemimeral, hepthemimeral
πῆχυν ἔπι σκαιὸν ξυνοχὴ κεχάλαστο χιτῶνος	-u u- -- uu- uu-u u--	dactylic hexameter	masculine penthemimeral, hepthemimeral, trithemimeral
νέρθεν ὑπὲκ μαζοῖο· τὸ δʼ ἀντίον ἀτρεκὲς αὔτως	-u u- --u u -uu -uu --	dactylic hexameter	feminine penthemimeral, trithemimeral
χαλκείῃ δείκηλον ἐν ἀσπίδι φαίνετʼ ἰδέσθαι.	--- --u u -uu -u u--	dactylic hexameter	feminine penthemimeral, trithemimeral
ἐν δὲ βοῶν ἔσκεν λάσιος νομός· ἀμφὶ δὲ βουσὶν	- u u- -- uu- uu -u u --	dactylic hexameter	masculine penthemimeral, hepthemimeral, trithemimeral
Τηλεβόαι μάρναντο καὶ υἱέες Ἠλεκτρύωνος·	-uu- --u u -uu -uu--	dactylic hexameter	feminine penthemimeral, trithemimeral
οἱ μὲν ἀμυνόμενοι, ἀτὰρ οἵ γʼ ἐθέλοντες ἀμέρσαι,	- u u-uu- uu - uu-u u--	dactylic hexameter	masculine penthemimeral, hepthemimeral
ληισταὶ Τάφιοι· τῶν δʼ αἵματι δεύετο λειμὼν	--- uu- - -uu -uu --	dactylic hexameter	masculine penthemimeral, trithemimeral
ἑρσήεις, πολέες δʼ ὀλίγους βιόωντο νομῆας.	--- uu- uu- uu-u u--	dactylic hexameter	masculine penthemimeral, hepthemimeral, trithemimeral
ἐν δὲ δύω δίφροι πεπονήατο δηριόωντες.	- u u- -- uu-uu -uu--	dactylic hexameter	masculine penthemimeral, trithemimeral
καὶ τὸν μὲν προπάροιθε Πέλοψ ἴθυνε, τινάσσων	- - - uu-u u- uu- ---	dactylic hexameter	feminine penthemimeral, hepthemimeral, trithemimeral
ἡνία, σὺν δέ οἱ ἔσκε παραιβάτις Ἱπποδάμεια·	-uu - u u -u u-uu -uu--	dactylic hexameter	feminine penthemimeral, trithemimeral
τὸν δὲ μεταδρομάδην ἐπὶ Μυρτίλος ἤλασεν ἵππους,	- u u-uu- uu -uu -uu --	dactylic hexameter	masculine penthemimeral
σὺν τῷ δʼ Οἰνόμαος προτενὲς δόρυ χειρὶ μεμαρπὼς	- - -uu- uu- uu -u u--	dactylic hexameter	masculine penthemimeral, hepthemimeral
ἄξονος ἐν πλήμνῃσι παρακλιδὸν ἀγνυμένοιο	-uu - --u u-uu -uu--	dactylic hexameter	feminine penthemimeral, trithemimeral
πῖπτεν, ἐπεσσύμενος Πελοπήια νῶτα δαΐξαι.	-u u-uu- uu-uu -u u--	dactylic hexameter	masculine penthemimeral
ἐν καὶ Ἀπόλλων Φοῖβος ὀιστεύων ἐτέτυκτο,	- u u-- -u u--- uu--	dactylic hexameter	feminine penthemimeral
βούπαις οὔπω πολλός, ἑὴν ἐρύοντα καλύπτρης	-- -- -u u- uu-u u--	dactylic hexameter	feminine penthemimeral, hepthemimeral
μητέρα θαρσαλέως Τιτυὸν μέγαν, ὅν ῥʼ ἔτεκέν γε	-uu -uu- uu- uu - uu- -	dactylic hexameter	masculine penthemimeral, hepthemimeral
δῖʼ Ἐλάρη, θρέψεν δὲ καὶ ἂψ ἐλοχεύσατο Γαῖα.	- uu- -- u u - uu-uu --	dactylic hexameter	masculine penthemimeral, hepthemimeral, trithemimeral
ἐν καὶ Φρίξος ἔην Μινυήιος ὡς ἐτεόν περ	- - -u u- uu-uu - uu- -	dactylic hexameter	masculine penthemimeral
εἰσαΐων κριοῦ, ὁ δʼ ἄρʼ ἐξενέποντι ἐοικώς.	-uu- -- u u -uu-u u--	dactylic hexameter	masculine penthemimeral, trithemimeral
κείνους κʼ εἰσορόων ἀκέοις, ψεύδοιό τε θυμόν,	-- -uu- uu- --u u --	dactylic hexameter	masculine penthemimeral, hepthemimeral
ἐλπόμενος πυκινήν τινʼ ἀπὸ σφείων ἐσακοῦσαι	-uu- uu- u u- -- uu--	dactylic hexameter	masculine penthemimeral, hepthemimeral, trithemimeral
βάξιν, ὃ καὶ δηρόν περ ἐπʼ ἐλπίδι θηήσαιο.	-u u - -- u u -uu ----	dactylic hexameter	masculine penthemimeral, trithemimeral
τοῖʼ ἄρα δῶρα θεᾶς Τριτωνίδος ἦεν Ἀθήνης.	- uu -u u- --uu -u u--	dactylic hexameter	masculine penthemimeral
δεξιτερῇ δʼ ἕλεν ἔγχος ἑκηβόλον, ὅ ῥʼ Ἀταλάντη	-uu- uu -u u-uu - uu--	dactylic hexameter	feminine penthemimeral, trithemimeral
Μαινάλῳ ἔν ποτέ οἱ ξεινήιον ἐγγυάλιξεν,	-uu - uu - --uu -uu--	dactylic hexameter	masculine penthemimeral, trithemimeral
πρόφρων ἀντομένη· περὶ γὰρ μενέαινεν ἕπεσθαι	-- -uu- uu - uu-u u--	dactylic hexameter	masculine penthemimeral, hepthemimeral
τὴν ὁδόν· ἀλλὰ γὰρ αὐτὸς ἑκὼν ἀπερήτυε κούρην,	- uu -u u -u u- uu-uu --	dactylic hexameter	feminine penthemimeral, hepthemimeral
δεῖσεν δʼ ἀργαλέας ἔριδας φιλότητος ἕκητι.	-- -uu- uu- uu-u u--	dactylic hexameter	masculine penthemimeral, hepthemimeral
βῆ δʼ ἴμεναι προτὶ ἄστυ, φαεινῷ ἀστέρι ἶσος,	- uu- uu -u u-- -uu --	dactylic hexameter	feminine penthemimeral, trithemimeral
ὅν ῥά τε νηγατέῃσιν ἐεργόμεναι καλύβῃσιν	- u u -uu-u u-uu- uu--	dactylic hexameter	feminine penthemimeral
νύμφαι θηήσαντο δόμων ὕπερ ἀντέλλοντα,	-- ---u u- uu ----	dactylic hexameter	feminine penthemimeral, hepthemimeral
καί σφισι κυανέοιο διʼ ἠέρος ὄμματα θέλγει	- uu -uu-u u -uu -uu --	dactylic hexameter	feminine penthemimeral
καλὸν ἐρευθόμενος, γάνυται δέ τε ἠιθέοιο	-u u-uu- uu- u u -uu--	dactylic hexameter	masculine penthemimeral, hepthemimeral
παρθένος ἱμείρουσα μετʼ ἀλλοδαποῖσιν ἐόντος	-uu ---u u -uu-u u--	dactylic hexameter	feminine penthemimeral
ἀνδράσιν, ᾧ καί μιν μνηστὴν κομέουσι τοκῆες·	-uu - - - -- uu-u u--	dactylic hexameter	masculine penthemimeral, hepthemimeral, trithemimeral
τῷ ἴκελος πρὸ πόληος ἀνὰ στίβον ἤιεν ἥρως.	- uu- u u-u u- uu -uu --	dactylic hexameter	feminine penthemimeral, hepthemimeral, trithemimeral
καί ῥʼ ὅτε δὴ πυλέων τε καὶ ἄστεος ἐντὸς ἔβησαν,	- uu - uu- u u -uu -u u--	dactylic hexameter	masculine penthemimeral, trithemimeral
δημότεραι μὲν ὄπισθεν ἐπεκλονέοντο γυναῖκες,	-uu- u u-u u-uu-u u--	dactylic hexameter	feminine penthemimeral, trithemimeral
γηθόσυναι ξείνῳ· ὁ δʼ ἐπὶ χθονὸς ὄμματʼ ἐρείσας	-uu- -- u u- uu -u u--	dactylic hexameter	masculine penthemimeral, hepthemimeral, trithemimeral
νίσσετʼ ἀπηλεγέως, ὄφρʼ ἀγλαὰ δώμαθʼ ἵκανεν	-u u-uu- - -uu -u u--	dactylic hexameter	masculine penthemimeral
Ὑψιπύλης· ἄνεσαν δὲ πύλας προφανέντι θεράπναι	-uu- uu- u u- uu-u u--	dactylic hexameter	masculine penthemimeral, hepthemimeral, trithemimeral
δικλίδας, εὐτύκτοισιν ἀρηρεμένας σανίδεσσιν.	-uu ---u u-uu- uu--	dactylic hexameter	feminine penthemimeral
ἔνθα μιν Ἰφινόη κλισμῷ ἔνι παμφανόωντι	-u u -uu- -- uu -uu--	dactylic hexameter	masculine penthemimeral, hepthemimeral
ἐσσυμένως καλῆς διὰ παστάδος εἷσεν ἄγουσα	-uu- -- uu -uu -u u--	dactylic hexameter	masculine penthemimeral, trithemimeral
ἀντία δεσποίνης· ἡ δʼ ἐγκλιδὸν ὄσσε βαλοῦσα	-uu --- - -uu -u u--	dactylic hexameter	masculine penthemimeral
παρθενικὰς ἐρύθηνε παρηίδας· ἔμπα δὲ τόν γε	-uu- uu-u u-uu -u u - -	dactylic hexameter	feminine penthemimeral, trithemimeral
αἰδομένη μύθοισι προσέννεπεν αἱμυλίοισιν·	-uu- --u u-uu -uu--	dactylic hexameter	feminine penthemimeral, trithemimeral
‘ξεῖνε, τίη μίμνοντες ἐπὶ χρόνον ἔκτοθι πύργων	-u u- --u u- uu -uu --	dactylic hexameter	feminine penthemimeral, hepthemimeral, trithemimeral
ἧσθʼ αὔτως; ἐπεὶ οὐ μὲν ὑπʼ ἀνδράσι ναίεται ἄστυ,	- -- uu - u u -uu -uu --	dactylic hexameter	masculine penthemimeral, trithemimeral
ἀλλὰ Θρηικίης ἐπινάστιοι ἠπείροιο	-- -uu- uu-uu ----	dactylic hexameter	masculine penthemimeral
πυροφόρους ἀρόωσι γύας. κακότητα δὲ πᾶσαν	-uu- uu-u u- uu-u u --	dactylic hexameter	feminine penthemimeral, hepthemimeral, trithemimeral
ἐξερέω νημερτές, ἵνʼ εὖ γνοίητε καὶ αὐτοί.	-uu- --u u - --u u --	dactylic hexameter	feminine penthemimeral, hepthemimeral, trithemimeral
εὖτε Θόας ἀστοῖσι πατὴρ ἐμὸς ἐμβασίλευεν,	-u u- --u u- uu -uu--	dactylic hexameter	feminine penthemimeral, hepthemimeral, trithemimeral
τηνίκα Θρηικίην, οἵ τʼ ἀντία ναιετάουσιν,	-uu -uu- - -uu -uu--	dactylic hexameter	masculine penthemimeral
δήμου ἀπορνύμενοι λαοὶ πέρθεσκον ἐπαύλους	-u u-uu- -- --u u--	dactylic hexameter	masculine penthemimeral, hepthemimeral
ἐκ νηῶν, αὐτῇσι δʼ ἀπείρονα ληίδα κούραις	- -- --u u-uu -uu --	dactylic hexameter	feminine penthemimeral, trithemimeral
δεῦρʼ ἄγον· οὐλομένης δὲ θεᾶς πορσύνετο μῆτις	- uu -uu- u u- --uu --	dactylic hexameter	masculine penthemimeral, hepthemimeral
Κύπριδος, ἥ τέ σφιν θυμοφθόρον ἔμβαλεν ἄτην.	-uu - - - --uu -uu --	dactylic hexameter	masculine penthemimeral, trithemimeral
δὴ γὰρ κουριδίας μὲν ἀπέστυγον, ἐκ δὲ μελάθρων,	- - -uu- u u-uu - u u--	dactylic hexameter	masculine penthemimeral
ᾗ ματίῃ εἴξαντες, ἀπεσσεύοντο γυναῖκας·	- uu- --u u---u u--	dactylic hexameter	feminine penthemimeral, trithemimeral
αὐτὰρ ληιάδεσσι δορικτήταις παρίαυον,	-- -uu-u u--- uu--	dactylic hexameter	feminine penthemimeral
σχέτλιοι. ἦ μὲν δηρὸν ἐτέτλαμεν, εἴ κέ ποτʼ αὖτις	-uu - - -u u-uu - u u --	dactylic hexameter	feminine penthemimeral, trithemimeral
ὀψὲ μεταστρέψωσι νόον· τὸ δὲ διπλόον αἰεὶ	-u u---u u- u u -uu --	dactylic hexameter	feminine penthemimeral, hepthemimeral
πῆμα κακὸν προύβαινεν. ἀτιμάζοντο δὲ τέκνα	-u u- --u u---u u --	dactylic hexameter	feminine penthemimeral, trithemimeral
γνήσιʼ ἐνὶ μεγάροις, σκοτίη δʼ ἀνέτελλε γενέθλη.	-u u- uu- uu- uu-u u--	dactylic hexameter	masculine penthemimeral, hepthemimeral, trithemimeral
αὔτως δʼ ἀδμῆτές τε κόραι, χῆραί τʼ ἐπὶ τῇσιν	-- --- u u- -- uu --	dactylic hexameter	masculine penthemimeral, hepthemimeral
μητέρες ἂμ πτολίεθρον ἀτημελέες ἀλάληντο.	-uu - uu-u u-uu- uu--	dactylic hexameter	feminine penthemimeral, trithemimeral
οὐδὲ πατὴρ ὀλίγον περ ἑῆς ἀλέγιζε θυγατρός,	-u u- uu- u u- uu-u u--	dactylic hexameter	masculine penthemimeral, hepthemimeral, trithemimeral
εἰ καὶ ἐν ὀφθαλμοῖσι δαϊζομένην ὁρόῳτο	- u u ---u u-uu- uu--	dactylic hexameter	feminine penthemimeral
μητρυιῆς ὑπὸ χερσὶν ἀτασθάλου· οὐδʼ ἀπὸ μητρὸς	--- uu -u u-uu - uu --	dactylic hexameter	feminine penthemimeral, trithemimeral
λώβην, ὡς τὸ πάροιθεν, ἀεικέα παῖδες ἄμυνον·	-- - u u-u u-uu -u u--	dactylic hexameter	feminine penthemimeral, trithemimeral
οὐδὲ κασιγνήτοισι κασιγνήτη μελε θυμῷ.	-u u---u u--- uu --	dactylic hexameter	feminine penthemimeral
ἀλλʼ οἶαι κοῦραι ληίτιδες ἔν τε δόμοισιν	- -- -- --uu - u u--	dactylic hexameter	masculine penthemimeral, trithemimeral
ἔν τε χοροῖς ἀγορῇ τε καὶ εἰλαπίνῃσι μέλοντο·	- u u- uu- u u -uu-u u--	dactylic hexameter	masculine penthemimeral, trithemimeral
εἰσόκε τις θεὸς ἄμμιν ὑπέρβιον ἔμβαλε θάρσος,	-uu - uu -u u-uu -uu --	dactylic hexameter	feminine penthemimeral, trithemimeral
ἂψ ἀναερχομένους Θρῃκῶν ἄπο μηκέτι πύργοις	- uu-uu- -- uu -uu --	dactylic hexameter	masculine penthemimeral, hepthemimeral
δέχθαι, ἵνʼ ἢ φρονέοιεν ἅπερ θέμις, ἠέ πῃ ἄλλῃ	-u u - uu-u u- uu -u u --	dactylic hexameter	feminine penthemimeral, hepthemimeral, trithemimeral
αὐταῖς ληιάδεσσιν ἀφορμηθέντες ἵκοιντο.	-- -uu-u u---u u--	dactylic hexameter	feminine penthemimeral
οἱ δʼ ἄρα θεσσάμενοι παίδων γένος, ὅσσον ἔλειπτο	- uu -uu- -- uu -u u--	dactylic hexameter	masculine penthemimeral, hepthemimeral
ἄρσεν ἀνὰ πτολίεθρον, ἔβαν πάλιν, ἔνθʼ ἔτι νῦν περ	-u u- uu-u u- uu - uu - -	dactylic hexameter	feminine penthemimeral, hepthemimeral, trithemimeral
Θρηικίης ἄροσιν χιονώδεα ναιετάουσιν.	-uu- uu- uu-uu -uu--	dactylic hexameter	masculine penthemimeral, trithemimeral
τῶ ὑμεῖς στρωφᾶσθʼ ἐπιδήμιοι· εἰ δέ κεν αὖθι	- -- -- uu-uu - u u --	dactylic hexameter	masculine penthemimeral, trithemimeral
ναιετάειν ἐθέλοις, καί τοι ἅδοι, ἦ τʼ ἂν ἔπειτα	-uu- uu- - - uu - u u--	dactylic hexameter	masculine penthemimeral, hepthemimeral, trithemimeral
πατρὸς ἐμεῖο Θόαντος ἔχοις γέρας· οὐδέ τί σ᾽οἴω	-u u-u u-u u- uu -u u --	dactylic hexameter	feminine penthemimeral, hepthemimeral
γαῖαν ὀνόσσεσθαι· περὶ γὰρ βαθυλήιος ἄλλων	-u u--- uu - uu-uu --	dactylic hexameter	masculine penthemimeral, hepthemimeral
νήσων, Αἰγαίῃ ὅσαι εἰν ἁλὶ ναιετάουσιν.	-- --- uu - uu -uu--	dactylic hexameter	masculine penthemimeral, hepthemimeral
ἀλλʼ ἄγε νῦν ἐπὶ νῆα κιὼν ἑτάροισιν ἐνίσπες	- uu - uu -u u- uu-u u--	dactylic hexameter	feminine penthemimeral, hepthemimeral, trithemimeral
μύθους ἡμετέρους, μηδʼ ἔκτοθι μίμνε πόληος.’	-- -uu- - -uu -u u--	dactylic hexameter	masculine penthemimeral
Ἴσκεν, ἀμαλδύνουσα φόνου τέλος, οἷον ἐτύχθη	-u u---u u- uu -u u--	dactylic hexameter	feminine penthemimeral, hepthemimeral
ἀνδράσιν· αὐτὰρ ὁ τήνγε παραβλήδην προσέειπεν	-uu -u u -u u--- uu--	dactylic hexameter	feminine penthemimeral
‘Ὑψιπύλη, μάλα κεν θυμηδέος ἀντιάσαιμεν	-uu- uu - --uu -uu--	dactylic hexameter	masculine penthemimeral, trithemimeral
χρησμοσύνης, ἣν ἄμμι σέθεν χατέουσιν ὀπάζεις.	-uu- - -u u- uu-u u--	dactylic hexameter	feminine penthemimeral, hepthemimeral, trithemimeral
εἶμι δʼ ὑπότροπος αὖτις ἀνὰ πτόλιν, εὖτʼ ἂν ἕκαστα	-u u-uu -u u- uu - u u--	dactylic hexameter	feminine penthemimeral, hepthemimeral
ἐξείπω κατὰ κόσμον. ἀνακτορίη δὲ μελέσθω	--- uu -u u-uu- u u--	dactylic hexameter	feminine penthemimeral, trithemimeral
σοί γʼ αὐτῇ καὶ νῆσος· ἔγωγε μὲν οὐκ ἀθερίζων	- -- - -u u-u u - uu--	dactylic hexameter	feminine penthemimeral, trithemimeral
χάζομαι, ἀλλά με λυγροὶ ἐπισπέρχουσιν ἄεθλοι.’	-uu -u u -u u---u u--	dactylic hexameter	feminine penthemimeral
ἦ, καὶ δεξιτερῆς χειρὸς θίγεν· αἶψα δʼ ὀπίσσω	- - -uu- -- uu -u u--	dactylic hexameter	masculine penthemimeral, hepthemimeral
βῆ ῥʼ ἴμεν, ἀμφὶ δὲ τόνγε νεήνιδες ἄλλοθεν ἄλλαι	- uu -u u -u u-uu -uu --	dactylic hexameter	feminine penthemimeral
μυρίαι εἱλίσσοντο κεχαρμέναι, ὄφρα πυλάων	-uu ---u u-uu -u u--	dactylic hexameter	feminine penthemimeral
ἐξέμολεν. μετέπειτα δʼ ἐυτροχάλοισιν ἀμάξαις	-uu- uu-u u-uu-u u--	dactylic hexameter	feminine penthemimeral, trithemimeral
ἀκτὴν εἰσαπέβαν, ξεινήια πολλὰ φέρουσαι,	-- -uu- --uu -u u--	dactylic hexameter	masculine penthemimeral
μῦθον ὅτʼ ἤδη πάντα διηνεκέως ἀγόρευσεν,	-u u -- -u u-uu- uu--	dactylic hexameter	feminine penthemimeral
τόν ῥα καλεσσαμένη διεπέφραδεν Ὑψιπύλεια·	- u u-uu- uu-uu -uu--	dactylic hexameter	masculine penthemimeral
καὶ δʼ αὐτοὺς ξεινοῦσθαι ἐπὶ σφέα δώματʼ ἄγεσκον	- -- --u u- uu -u u--	dactylic hexameter	feminine penthemimeral, hepthemimeral, trithemimeral
ῥηιδίως. Κύπρις γὰρ ἐπὶ γλυκὺν ἵμερον ὦρσεν	-uu- -- u u- uu -uu --	dactylic hexameter	masculine penthemimeral, hepthemimeral, trithemimeral
Ἡφαίστοιο χάριν πολυμήτιος, ὄφρα κεν αὖτις	---u u- uu-uu -u u --	dactylic hexameter	masculine penthemimeral
ναίηται μετόπισθεν ἀκήρατος ἀνδράσι Λῆμνος.	--- uu-u u-uu -uu --	dactylic hexameter	feminine penthemimeral, trithemimeral
ἔνθʼ ὁ μὲν Ὑψιπύλης βασιλήιον ἐς δόμον ὦρτο	- u u -uu- uu-uu - uu --	dactylic hexameter	masculine penthemimeral
Αἰσονίδης· οἱ δʼ ἄλλοι ὅπῃ καὶ ἔκυρσαν ἕκαστος,	-uu- - -u u- u u-u u--	dactylic hexameter	feminine penthemimeral, hepthemimeral, trithemimeral
Ἡρακλῆος ἄνευθεν, ὁ γὰρ παρὰ νηὶ λέλειπτο	---u u-u u - uu -u u--	dactylic hexameter	feminine penthemimeral, hepthemimeral
αὐτὸς ἑκὼν παῦροί τε διακρινθέντες ἑταῖροι.	-u u- -- u u---u u--	dactylic hexameter	masculine penthemimeral, trithemimeral
αὐτίκα δʼ ἄστυ χοροῖσι καὶ εἰλαπίνῃσι γεγήθει	-uu -u u-u u -uu-u u--	dactylic hexameter	feminine penthemimeral
καπνῷ κνισήεντι περίπλεον· ἔξοχα δʼ ἄλλων	-- ---u u-uu -uu --	dactylic hexameter	feminine penthemimeral
ἀθανάτων Ἥρης υἷα κλυτὸν ἠδὲ καὶ αὐτὴν	-uu- -- -- uu -u u --	dactylic hexameter	masculine penthemimeral, hepthemimeral, trithemimeral
Κύπριν ἀοιδῇσιν θυέεσσί τε μειλίσσοντο.	-u u--- uu-u u ----	dactylic hexameter	masculine penthemimeral
ἀμβολίη δʼ εἰς ἦμαρ ἀεὶ ἐξ ἤματος ἦεν	-uu- - -u u- - -uu --	dactylic hexameter	feminine penthemimeral, hepthemimeral, trithemimeral
ναυτιλίης· δηρὸν δʼ ἂν ἐλίνυον αὖθι μένοντες,	-uu- -- u u-uu -u u--	dactylic hexameter	masculine penthemimeral, trithemimeral
εἰ μὴ ἀολλίσσας ἑτάρους ἀπάνευθε γυναικῶν	- u u--- uu- uu-u u--	dactylic hexameter	masculine penthemimeral, hepthemimeral
Ἡρακλέης τοίοισιν ἐνιπτάζων μετέειπεν·	-uu- --u u--- uu--	dactylic hexameter	feminine penthemimeral, trithemimeral
‘δαιμόνιοι, πάτρης ἐμφύλιον αἷμʼ ἀποέργει	-uu- -- --uu - uu--	dactylic hexameter	masculine penthemimeral, trithemimeral
ἡμέας; ἦε γάμων ἐπιδευέες ἐνθάδʼ ἔβημεν	-uu -u u- uu-uu -u u--	dactylic hexameter	masculine penthemimeral
κεῖθεν, ὀνοσσάμενοι πολιήτιδας; αὖθι δʼ ἕαδεν	-u u-uu- uu-uu -u u--	dactylic hexameter	masculine penthemimeral
ναίοντας λιπαρὴν ἄροσιν Λήμνοιο ταμέσθαι;	--- uu- uu- --u u--	dactylic hexameter	masculine penthemimeral, hepthemimeral, trithemimeral
οὐ μὰν εὐκλειεῖς γε σὺν ὀθνείῃσι γυναιξὶν	- - --- u u ---u u--	dactylic hexameter	masculine penthemimeral
ἐσσόμεθʼ ὧδʼ ἐπὶ δηρὸν ἐελμένοι· οὐδέ τι κῶας	-uu - uu -u u-uu -u u --	dactylic hexameter	feminine penthemimeral, trithemimeral
αὐτόματον δώσει τις ἑλὼν θεὸς εὐξαμένοισιν.	-uu- -- u u- uu -uu--	dactylic hexameter	masculine penthemimeral, hepthemimeral, trithemimeral
ἴομεν αὖτις ἕκαστοι ἐπὶ σφέα· τὸν δʼ ἐνὶ λέκτροις	-uu -u u-u u- uu - uu --	dactylic hexameter	feminine penthemimeral, hepthemimeral
Ὑψιπύλης εἰᾶτε πανήμερον, εἰσόκε Λῆμνον	-uu- --u u-uu -uu --	dactylic hexameter	feminine penthemimeral, trithemimeral
παισὶν ἐσανδρώσῃ, μεγάλη τέ ἑ βάξις ἵκηται.’	-u u--- uu- u u -u u--	dactylic hexameter	masculine penthemimeral, hepthemimeral
ὧς νείκεσσεν ὅμιλον· ἐναντία δʼ οὔ νύ τις ἔτλη	- --u u-u u-uu - u u --	dactylic hexameter	feminine penthemimeral
ὄμματʼ ἀνασχεθέειν, οὐδὲ προτιμυθήσασθαι·	-u u-uu- -- uu----	dactylic hexameter	masculine penthemimeral, hepthemimeral
ἀλλʼ αὔτως ἀγορῆθεν ἐπαρτίζοντο νέεσθαι	- -- uu-u u---u u--	dactylic hexameter	feminine penthemimeral, trithemimeral
σπερχόμενοι. ταὶ δέ σφιν ἐπέδραμον, εὖτʼ ἐδάησαν.	-uu- - - u u-uu - uu--	dactylic hexameter	masculine penthemimeral, trithemimeral
ὡς δʼ ὅτε λείρια καλὰ περιβρομέουσι μέλισσαι	- uu -uu -u u-uu-u u--	dactylic hexameter	feminine penthemimeral
πέτρης ἐκχύμεναι σιμβληίδος, ἀμφὶ δὲ λειμὼν	-- -uu- --uu -u u --	dactylic hexameter	masculine penthemimeral
ἑρσήεις γάνυται, ταὶ δὲ γλυκὺν ἄλλοτε ἄλλον	--- uu- - - uu -uu --	dactylic hexameter	masculine penthemimeral, hepthemimeral, trithemimeral
καρπὸν ἀμέργουσιν πεποτημέναι· ὧς ἄρα ταί γε	-u u--- uu-uu - uu - -	dactylic hexameter	masculine penthemimeral
ἐνδυκὲς ἀνέρας ἀμφὶ κινυρόμεναι προχέοντο,	-uu -uu -u u-uu- uu--	dactylic hexameter	feminine penthemimeral
χερσί τε καὶ μύθοισιν ἐδεικανόωντο ἕκαστον,	-u u - --u u-uu-u u--	dactylic hexameter	feminine penthemimeral, trithemimeral
εὐχόμεναι μακάρεσσιν ἀπήμονα νόστον ὀπάσσαι.	-uu- uu-u u-uu -u u--	dactylic hexameter	feminine penthemimeral, trithemimeral
ὧς δὲ καὶ Ὑψιπύλη ἠρήσατο χεῖρας ἑλοῦσα	- u u -uu- --uu -u u--	dactylic hexameter	masculine penthemimeral
Αἰσονίδεω, τὰ δέ οἱ ῥέε δάκρυα χήτει ἰόντος·	-uu- u u - uu -uu -u u--	dactylic hexameter	masculine penthemimeral, trithemimeral
‘Νίσσεο, καὶ σὲ θεοὶ σὺν ἀπηρέσιν αὖτις ἑταίροις	-uu - u u- u u-uu -u u--	dactylic hexameter	masculine penthemimeral, trithemimeral
χρύσειον βασιλῆι δέρος κομίσειαν ἄγοντα	--- uu-u u- uu-u u--	dactylic hexameter	feminine penthemimeral, hepthemimeral, trithemimeral
αὔτως, ὡς ἐθέλεις καί τοι φίλον. ἥδε δὲ νῆσος	-- - uu- - - uu -u u --	dactylic hexameter	masculine penthemimeral, hepthemimeral, trithemimeral
σκῆπτρά τε πατρὸς ἐμεῖο παρέσσεται, ἢν καὶ ὀπίσσω	-u u -u u-u u-uu - u u--	dactylic hexameter	feminine penthemimeral
δή ποτε νοστήσας ἐθέλῃς ἄψορρον ἱκέσθαι.	- uu --- uu- --u u--	dactylic hexameter	masculine penthemimeral, hepthemimeral
ῥηιδίως δʼ ἂν ἑοῖ καὶ ἀπείρονα λαὸν ἀγείραις	-uu- u u- u u-uu -u u--	dactylic hexameter	masculine penthemimeral, trithemimeral
ἄλλων ἐκ πολίων· ἀλλʼ οὐ σύγε τήνδε μενοινὴν	-- - uu- - - uu -u u--	dactylic hexameter	masculine penthemimeral, hepthemimeral, trithemimeral
σχήσεις, οὔτʼ αὐτὴ προτιόσσομαι ὧδε τελεῖσθαι.	-- - -- uu-uu -u u--	dactylic hexameter	masculine penthemimeral, trithemimeral
μνώεο μὴν ἀπεών περ ὁμῶς καὶ νόστιμος ἤδη	-uu - uu- u u- - -uu --	dactylic hexameter	masculine penthemimeral, hepthemimeral, trithemimeral
Ὑψιπύλης· λίπε δʼ ἧμιν ἔπος, τό κεν ἐξανύσαιμι	-uu- uu -u u- u u -uu--	dactylic hexameter	feminine penthemimeral, hepthemimeral, trithemimeral
πρόφρων, ἢν ἄρα δή με θεοὶ δώωσι τεκέσθαι.’	-- - uu - u u- --u u--	dactylic hexameter	masculine penthemimeral, hepthemimeral, trithemimeral
τὴν δʼ αὖτʼ Αἴσονος υἱὸς ἀγαιόμενος προσέειπεν·	- - -uu -u u-uu- uu--	dactylic hexameter	feminine penthemimeral
‘Ὑψιπύλη, τὰ μὲν οὕτω ἐναίσιμα πάντα γένοιτο	-uu- u u -u u-uu -u u--	dactylic hexameter	feminine penthemimeral, trithemimeral
ἐκ μακάρων· τύνη δʼ ἐμέθεν πέρι θυμὸν ἀρείω	- uu- -- uu- uu -u u--	dactylic hexameter	masculine penthemimeral, hepthemimeral, trithemimeral
ἴσχανʼ, ἐπεὶ πάτρην μοι ἅλις Πελίαο ἕκητι	-u u- -- u u- uu-u u--	dactylic hexameter	masculine penthemimeral, hepthemimeral, trithemimeral
ναιετάειν· μοῦνόν με θεοὶ λύσειαν ἀέθλων.	-uu- -- u u- --u u--	dactylic hexameter	masculine penthemimeral, hepthemimeral, trithemimeral
εἰ δʼ οὔ μοι πέπρωται ἐς Ἑλλάδα γαῖαν ἱκέσθαι	- - - --u u -uu -u u--	dactylic hexameter	feminine penthemimeral, trithemimeral
τηλοῦ ἀναπλώοντι, σὺ δʼ ἄρσενα παῖδα τέκηαι,	-u u---u u -uu -u u--	dactylic hexameter	feminine penthemimeral
πέμπε μιν ἡβήσαντα Πελασγίδος ἔνδον Ἰωλκοῦ	-u u ---u u-uu -u u--	dactylic hexameter	feminine penthemimeral
πατρί τʼ ἐμῷ καὶ μητρὶ δύης ἄκος, ἢν ἄρα τούς γε	-u u- - -u u- uu - uu - -	dactylic hexameter	feminine penthemimeral, hepthemimeral, trithemimeral
τέτμῃ ἔτι ζώοντας, ἵνʼ ἄνδιχα τοῖο ἄνακτος	-u u- --u u -uu -u u--	dactylic hexameter	feminine penthemimeral, trithemimeral
σφοῖσιν πορσύνωνται ἐφέστιοι ἐν μεγάροισιν.’	-- ---u u-uu - uu--	dactylic hexameter	feminine penthemimeral
ἦ, καὶ ἔβαινʼ ἐπὶ νῆα παροίτατος· ὧς δὲ καὶ ἄλλοι	- u u- uu -u u-uu - u u --	dactylic hexameter	feminine penthemimeral, trithemimeral
βαῖνον ἀριστῆες· λάζοντο δὲ χερσὶν ἐρετμὰ	-u u--- --u u -u u--	dactylic hexameter	masculine penthemimeral
ἐνσχερὼ ἑζόμενοι· πρυμνήσια δέ σφισιν Ἄργος	-uu -uu- --uu - uu --	dactylic hexameter	masculine penthemimeral
λῦσεν ὑπὲκ πέτρης ἁλιμυρέος. ἔνθʼ ἄρα τοί γε	-u u- -- uu-uu - uu - -	dactylic hexameter	masculine penthemimeral, trithemimeral
κόπτον ὕδωρ δολιχῇσιν ἐπικρατέως ἐλάτῃσιν.	-u u- uu-u u-uu- uu--	dactylic hexameter	feminine penthemimeral, trithemimeral
ἑσπέριοι δʼ Ὀρφῆος ἐφημοσύνῃσιν ἔκελσαν	-uu- --u u-uu-u u--	dactylic hexameter	feminine penthemimeral, trithemimeral
νῆσον ἐς Ἠλέκτρης Ἀτλαντίδος, ὄφρα δαέντες	-u u --- --uu -u u--	dactylic hexameter	masculine penthemimeral
ἀρρήτους ἀγανῇσι τελεσφορίῃσι θέμιστας	--- uu-u u-uu-u u--	dactylic hexameter	feminine penthemimeral, trithemimeral
σωότεροι κρυόεσσαν ὑπεὶρ ἅλα ναυτίλλοιντο.	-uu- uu-u u- uu ----	dactylic hexameter	feminine penthemimeral, hepthemimeral, trithemimeral
τῶν μὲν ἔτʼ οὐ προτέρω μυθήσομαι· ἀλλὰ καὶ αὐτὴ	- u u - uu- --uu -u u --	dactylic hexameter	masculine penthemimeral, trithemimeral
νῆσος ὁμῶς κεχάροιτο καὶ οἳ λάχον ὄργια κεῖνα	-u u- uu-u u - uu -uu --	dactylic hexameter	feminine penthemimeral, hepthemimeral, trithemimeral
δαίμονες ἐνναέται, τὰ μὲν οὐ θέμις ἄμμιν ἀείδειν.	-uu -uu- u u - uu -u u--	dactylic hexameter	masculine penthemimeral, hepthemimeral
κεῖθεν δʼ εἰρεσίῃ Μέλανος διὰ βένθεα πόντου	-- -uu- uu- uu -uu --	dactylic hexameter	masculine penthemimeral, hepthemimeral
ἱέμενοι τῇ μὲν Θρῃκῶν χθόνα, τῇ δὲ περαίην	-uu- - - -- uu - u u--	dactylic hexameter	masculine penthemimeral, hepthemimeral, trithemimeral
Ἴμβρον ἔχον καθύπερθε· νέον γε μὲν ἠελίοιο	-u u- uu-u u- u u -uu--	dactylic hexameter	feminine penthemimeral, hepthemimeral, trithemimeral
δυομένου Χερόνησον ἐπὶ προύχουσαν ἵκοντο.	-uu- uu-u u- --u u--	dactylic hexameter	feminine penthemimeral, hepthemimeral, trithemimeral
ἔνθα σφιν λαιψηρὸς ἄη νότος, ἱστία δʼ οὔρῳ	-- - --u u- uu -uu --	dactylic hexameter	feminine penthemimeral, hepthemimeral, trithemimeral
στησάμενοι κούρης Ἀθαμαντίδος αἰπὰ ῥέεθρα	-uu- -- uu-uu -u u--	dactylic hexameter	masculine penthemimeral, trithemimeral
εἰσέβαλον· πέλαγος δὲ τὸ μὲν καθύπερθε λέλειπτο	-uu- uu- u u - uu-u u--	dactylic hexameter	masculine penthemimeral, hepthemimeral, trithemimeral
ἦρι, τὸ δʼ ἐννύχιοι Ῥοιτειάδος ἔνδοθεν ἀκτῆς	-u u -uu- --uu -uu --	dactylic hexameter	masculine penthemimeral
μέτρεον, Ἰδαίην ἐπὶ δεξιὰ γαῖαν ἔχοντες.	-uu --- uu -uu -u u--	dactylic hexameter	masculine penthemimeral
Δαρδανίην δὲ λιπόντες ἐπιπροσέβαλλον Ἀβύδῳ,	-uu- u u-u u-uu-u u--	dactylic hexameter	feminine penthemimeral, trithemimeral
Περκώτην δʼ ἐπὶ τῇ καὶ Ἀβαρνίδος ἠμαθόεσσαν	--- uu - u u-uu -uu--	dactylic hexameter	masculine penthemimeral, trithemimeral
ἠιόνα ζαθέην τε παρήμειβον Πιτύειαν.	-uu- uu- u u--- uu--	dactylic hexameter	masculine penthemimeral, trithemimeral
καὶ δὴ τοί γʼ ἐπὶ νυκτὶ διάνδιχα νηὸς ἰούσης	- - - uu -u u-uu -u u--	dactylic hexameter	feminine penthemimeral, trithemimeral
δίνῃ πορφύροντα διήνυσαν Ἑλλήσποντον.	-- ---u u-uu ----	dactylic hexameter	feminine penthemimeral
ἔστι δέ τις αἰπεῖα Προποντίδος ἔνδοθι νῆσος	-u u - --u u-uu -uu --	dactylic hexameter	feminine penthemimeral, trithemimeral
τυτθὸν ἀπὸ Φρυγίης πολυληίου ἠπείροιο	-u u- uu- uu-uu ----	dactylic hexameter	masculine penthemimeral, trithemimeral
εἰς ἅλα κεκλιμένη, ὅσσον τʼ ἐπιμύρεται ἰσθμὸς	- uu -uu- -- uu-uu --	dactylic hexameter	masculine penthemimeral, hepthemimeral
χέρσῳ ἐπιπρηνὴς καταειμένος· ἐν δέ οἱ ἀκταὶ	-u u--- uu-uu - u u --	dactylic hexameter	masculine penthemimeral
ἀμφίδυμοι, κεῖνται δʼ ὑπὲρ ὕδατος Αἰσήποιο.	-uu- -- uu -uu ----	dactylic hexameter	masculine penthemimeral, trithemimeral
Ἄρκτων μιν καλέουσιν ὄρος περιναιετάοντες·	-- - uu-u u- uu-uu--	dactylic hexameter	feminine penthemimeral, hepthemimeral, trithemimeral
καὶ τὸ μὲν ὑβρισταί τε καὶ ἄγριοι ἐνναίουσιν	- u u --- u u -uu ----	dactylic hexameter	masculine penthemimeral
Γηγενέες, μέγα θαῦμα περικτιόνεσσιν ἰδέσθαι.	-uu- uu -u u-uu-u u--	dactylic hexameter	feminine penthemimeral, trithemimeral
ἓξ γὰρ ἑκάστῳ χεῖρες ὑπέρβιοι ἠερέθονται,	- u u-- -u u-uu -uu--	dactylic hexameter	feminine penthemimeral
αἱ μὲν ἀπὸ στιβαρῶν ὤμων δύο, ταὶ δʼ ὑπένερθεν	- u u- uu- -- uu - uu--	dactylic hexameter	masculine penthemimeral, hepthemimeral, trithemimeral
τέσσαρες αἰνοτάτῃσιν ἐπὶ πλευρῇς ἀραρυῖαι.	-uu -uu-u u- -- uu--	dactylic hexameter	feminine penthemimeral, hepthemimeral
ἰσθμὸν δʼ αὖ πεδίον τε Δολίονες ἀμφενέμοντο	-- - uu- u u-uu -uu--	dactylic hexameter	masculine penthemimeral, trithemimeral
ἀνέρες· ἐν δʼ ἥρως Λἰνήιος υἱὸς ἄνασσεν	-uu - -- --uu -u u--	dactylic hexameter	masculine penthemimeral, trithemimeral
Κύζικος, ὃν κούρη δίου τέκεν Εὐσώροιο	-uu - -- -- uu ----	dactylic hexameter	masculine penthemimeral, hepthemimeral, trithemimeral
Αἰνήτη. τοὺς δʼ οὔτι καὶ ἔκπαγλοί περ ἐόντες	--- - -u u --- u u--	dactylic hexameter	feminine penthemimeral, trithemimeral
Γηγενέες σίνοντο, Ποσειδάωνος ἀρωγῇ·	-uu- --u u---u u--	dactylic hexameter	feminine penthemimeral, trithemimeral
τοῦ γὰρ ἔσαν τὰ πρῶτα Δολίονες ἐκγεγαῶτες.	- u u- - -u u-uu -uu--	dactylic hexameter	feminine penthemimeral, trithemimeral
ἔνθʼ Ἀργὼ προύτυψεν ἐπειγομένη ἀνέμοισιν	- -- --u u-uu- uu--	dactylic hexameter	feminine penthemimeral, trithemimeral
Θρηικίοις, Καλὸς δὲ λιμὴν ὑπέδεκτο θέουσαν.	-uu- -- u u- uu-u u--	dactylic hexameter	masculine penthemimeral, hepthemimeral, trithemimeral
κεῖσε καὶ εὐναίης ὀλίγον λίθον ἐκλύσαντες	-u u --- uu- uu ----	dactylic hexameter	masculine penthemimeral, hepthemimeral
Τίφυος ἐννεσίῃσιν ὑπὸ κρήνῃ ἐλίποντο,	-uu -uu-u u- -- uu--	dactylic hexameter	feminine penthemimeral, hepthemimeral
κρήνῃ ὑπʼ Ἀρτακίῃ· ἕτερον δʼ ἔλον, ὅστις ἀρήρει,	-u u -uu- uu- uu -u u--	dactylic hexameter	masculine penthemimeral, hepthemimeral
βριθύν· ἀτὰρ κεῖνόν γε θεοπροπίαις Ἑκάτοιο	-u u- -- u u-uu- uu--	dactylic hexameter	masculine penthemimeral, trithemimeral
Νηλεΐδαι μετόπισθεν Ἰάονες ἱδρύσαντο	-uu- uu-u u-uu ----	dactylic hexameter	feminine penthemimeral, trithemimeral
ἱερόν, ἣ θέμις ἦεν, Ἰησονίης ἐν Ἀθήνης.	-uu - uu -u u-uu- u u--	dactylic hexameter	feminine penthemimeral, trithemimeral
τοὺς δʼ ἄμυδις φιλότητι Δολίονες ἠδὲ καὶ αὐτὸς	- uu- uu-u u-uu -u u --	dactylic hexameter	feminine penthemimeral, trithemimeral
Κύζικος ἀντήσαντες ὅτε στόλον ἠδὲ γενέθλην	-uu ---u u- uu -u u--	dactylic hexameter	feminine penthemimeral, hepthemimeral
ἔκλυον, οἵτινες εἶεν, ἐυξείνως ἀρέσαντο,	-uu -uu -u u--- uu--	dactylic hexameter	feminine penthemimeral
καί σφεας εἰρεσίῃ πέπιθον προτέρωσε κιόντας	- uu -uu- uu- uu-u u--	dactylic hexameter	masculine penthemimeral, hepthemimeral
ἄστεος ἐν λιμένι πρυμνήσια νηὸς ἀνάψαι,	-uu - uu- --uu -u u--	dactylic hexameter	masculine penthemimeral, trithemimeral
ἔνθʼ οἵ γʼ Ἐκβασίῳ βωμὸν θέσαν Ἀπόλλωνι	- - -uu- -- uu ----	dactylic hexameter	masculine penthemimeral, hepthemimeral
εἱσάμενοι παρὰ θῖνα, θυηπολίης τʼ ἐμελοντο.	-uu- uu -u u-uu- uu--	dactylic hexameter	feminine penthemimeral, trithemimeral
δῶκεν δʼ αὐτὸς ἄναξ λαρὸν μέθυ δευομένοισιν	-- -u u- -- uu -uu--	dactylic hexameter	masculine penthemimeral, hepthemimeral
μῆλά θ᾽ὁμοῦ· δὴ γάρ οἱ ἔην φάτις, εὖτʼ ἂν ἵκωνται	-u u- - - u u- uu - u u--	dactylic hexameter	masculine penthemimeral, hepthemimeral, trithemimeral
ἀνδρῶν ἡρώων θεῖος στόλος, αὐτίκα τόν γε	-- --- -- uu -uu - -	dactylic hexameter	masculine penthemimeral, hepthemimeral
μείλιχον ἀντιάαν, μηδὲ πτολέμοιο μέλεσθαι.	-uu -uu- -- uu-u u--	dactylic hexameter	masculine penthemimeral, hepthemimeral
ἶσόν που κἀκείνῳ ἐπισταχύεσκον ἴουλοι,	-- - --u u-uu-u u--	dactylic hexameter	feminine penthemimeral, trithemimeral
οὐδέ νύ πω παίδεσσιν ἀγαλλόμενος μεμόρητο·	-u u - --u u-uu- uu--	dactylic hexameter	feminine penthemimeral, trithemimeral
ἀλλʼ ἔτι οἱ κατὰ δώματʼ ἀκήρατος ἦεν ἄκοιτις	- uu - uu -u u-uu -u u--	dactylic hexameter	feminine penthemimeral, trithemimeral
ὠδίνων, Μέροπος Περκωσίου ἐκγεγαυῖα,	--- uu- --uu -uu--	dactylic hexameter	masculine penthemimeral, trithemimeral
Κλείτη ἐυπλόκαμος, τὴν μὲν νέον ἐξέτι πατρὸς	-u u-uu- - - uu -uu --	dactylic hexameter	masculine penthemimeral, hepthemimeral
θεσπεσίοις ἕδνοισιν ἀνήγαγεν ἀντιπέρηθεν.	-uu- --u u-uu -uu--	dactylic hexameter	feminine penthemimeral, trithemimeral
ἀλλὰ καὶ ὧς θάλαμόν τε λιπὼν καὶ δέμνια νύμφης	-u u - uu- u u- - -uu --	dactylic hexameter	masculine penthemimeral, hepthemimeral, trithemimeral
τοῖς μέτα δαῖτʼ ἀλέγυνε, βάλεν δʼ ἀπὸ δείματα θυμοῦ.	- uu - uu-u u- uu -uu --	dactylic hexameter	feminine penthemimeral, hepthemimeral, trithemimeral
ἀλλήλους δʼ ἐρέεινον ἀμοιβαδίς· ἤτοι ὁ μέν σφεων	--- uu-u u-uu -u u - -	dactylic hexameter	feminine penthemimeral, trithemimeral
πεύθετο ναυτιλίης ἄνυσιν, Πελίαό τʼ ἐφετμάς·	-uu -uu- uu- uu-u u--	dactylic hexameter	masculine penthemimeral, hepthemimeral
οἱ δὲ περικτιόνων πόλιας καὶ κόλπον ἅπαντα	- u u-uu- uu- - -u u--	dactylic hexameter	masculine penthemimeral, hepthemimeral
εὐρείης πεύθοντο Προποντίδος· οὐ μὲν ἐπιπρὸ	--- --u u-uu - u u--	dactylic hexameter	feminine penthemimeral, trithemimeral
ἠείδει καταλέξαι ἐελδομένοισι δαῆναι.	--- uu-u u-uu-u u--	dactylic hexameter	feminine penthemimeral, trithemimeral
ἠοῖ δʼ εἰσανέβαν μέγα Δίνδυμον, ὄφρα καὶ αὐτοὶ	-- -uu- uu -uu -u u --	dactylic hexameter	masculine penthemimeral
θηήσαιντο πόρους κείνης ἁλός· ἐκ δʼ ἄρα τοί γε	---u u- -- uu - uu - -	dactylic hexameter	masculine penthemimeral, hepthemimeral
νῆα Χυτοῦ λιμένος προτέρω ἐξήλασαν ὅρμον·	-u u- uu- uu- --uu --	dactylic hexameter	masculine penthemimeral, hepthemimeral, trithemimeral
ἥδε δʼ Ἰησονίη πέφαται ὁδός, ἥνπερ ἔβησαν.	-u u-uu- uu- uu -u u--	dactylic hexameter	masculine penthemimeral, hepthemimeral
Γηγενέες δʼ ἑτέρωθεν ἀπʼ οὔρεος ἀίξαντες	-uu- uu-u u -uu ----	dactylic hexameter	feminine penthemimeral, trithemimeral
φράξαν ἀπειρεσίοιο Χυτοῦ στόμα νειόθι πέτρῃς	-u u-uu-u u- uu -uu --	dactylic hexameter	feminine penthemimeral, hepthemimeral
πόντιον, οἷά τε θῆρα λοχώμενοι ἔνδον ἐόντα.	-uu -u u -u u-uu -u u--	dactylic hexameter	feminine penthemimeral
ἀλλὰ γὰρ αὖθι λέλειπτο σὺν ἀνδράσιν ὁπλοτέροισιν	-u u -u u-u u -uu -uu--	dactylic hexameter	feminine penthemimeral
Ἡρακλέης, ὃς δή σφι παλίντονον αἶψα τανύσσας	-uu- - - u u-uu -u u--	dactylic hexameter	masculine penthemimeral, trithemimeral
τόξον ἐπασσυτέρους πέλασε χθονί· τοὶ δὲ καὶ αὐτοὶ	-u u-uu- uu- uu - u u --	dactylic hexameter	masculine penthemimeral, hepthemimeral
πέτρας ἀμφιρρῶγας ἀερτάζοντες ἔβαλλον.	-- ---u u---u u--	dactylic hexameter	feminine penthemimeral
δὴ γάρ που κἀκεῖνα θεὰ τρέφεν αἰνὰ πέλωρα	- - - --u u- uu -u u--	dactylic hexameter	feminine penthemimeral, hepthemimeral, trithemimeral
Ἥρη, Ζηνὸς ἄκοιτις, ἀέθλιον Ἡρακλῆι.	-- -u u-u u-uu ----	dactylic hexameter	feminine penthemimeral
σὺν δὲ καὶ ὧλλοι δῆθεν ὑπότροποι ἀντιόωντες,	- u u -- -u u-uu -uu--	dactylic hexameter	feminine penthemimeral
πρίν περ ἀνελθέμεναι σκοπιήν, ἥπτοντο φόνοιο	- u u-uu- uu- --u u--	dactylic hexameter	masculine penthemimeral, hepthemimeral
γηγενέων ἥρωες ἀρήιοι, ἠμὲν ὀιστοῖς	-uu- --u u-uu -u u--	dactylic hexameter	feminine penthemimeral, trithemimeral
ἠδὲ καὶ ἐγχείῃσι δεδεγμένοι, εἰσόκε πάντας	-u u ---u u-uu -uu --	dactylic hexameter	feminine penthemimeral
ἀντιβίην ἀσπερχὲς ὀρινομένους ἐδάιξαν.	-uu- --u u-uu- uu--	dactylic hexameter	feminine penthemimeral, trithemimeral
ὡς δʼ ὅτε δούρατα μακρὰ νέον πελέκεσσι τυπέντα	- uu -uu -u u- uu-u u--	dactylic hexameter	feminine penthemimeral, hepthemimeral
ὑλοτόμοι στοιχηδὸν ἐπὶ ῥηγμῖνι βάλωσιν,	-uu- --u u- --u u--	dactylic hexameter	feminine penthemimeral, hepthemimeral, trithemimeral
ὄφρα νοτισθέντα κρατεροὺς ἀνεχοίατο γόμφους·	-u u--- uu- uu-uu --	dactylic hexameter	masculine penthemimeral, hepthemimeral
ὧς οἱ ἐνὶ ξυνοχῇ λιμένος πολιοῖο τέταντο	- u u- uu- uu- uu-u u--	dactylic hexameter	masculine penthemimeral, hepthemimeral, trithemimeral
ἑξείης, ἄλλοι μὲν ἐς ἁλμυρὸν ἀθρόοι ὕδωρ	--- -- u u -uu -uu --	dactylic hexameter	masculine penthemimeral, trithemimeral
δύπτοντες κεφαλὰς καὶ στήθεα, γυῖα δʼ ὕπερθεν	--- uu- - -uu -u u--	dactylic hexameter	masculine penthemimeral, trithemimeral
χέρσῳ τεινάμενοι· τοὶ δʼ ἔμπαλιν, αἰγιαλοῖο	-- -uu- - -uu -uu--	dactylic hexameter	masculine penthemimeral
κράατα μὲν ψαμάθοισι, πόδας δʼ εἰς βένθος ἔρειδον,	-uu - uu-u u- - -u u--	dactylic hexameter	feminine penthemimeral, hepthemimeral, trithemimeral
ἄμφω ἅμʼ οἰωνοῖσι καὶ ἰχθύσι κύρμα γενέσθαι.	-u u ---u u -uu -u u--	dactylic hexameter	feminine penthemimeral
ἥρωες δʼ ,ὅτε δή σφιν ἀταρβὴς ἔπλετʼ ἄεθλος,	--- uu - u u-- -u u--	dactylic hexameter	masculine penthemimeral, trithemimeral
δὴ τότε πείσματα νηὸς ἐπὶ πνοιῇς ἀνέμοιο	- uu -uu -u u- -- uu--	dactylic hexameter	feminine penthemimeral, hepthemimeral
λυσάμενοι προτέρωσε διὲξ ἁλὸς οἶδμα νέοντο.	-uu- uu-u u- uu -u u--	dactylic hexameter	feminine penthemimeral, hepthemimeral, trithemimeral
ἡ δʼ ἔθεεν λαίφεσσι πανήμερος· οὐ μὲν ἰούσης	- uu- --u u-uu - u u--	dactylic hexameter	feminine penthemimeral, trithemimeral
νυκτὸς ἔτι ῥιπὴ μένεν ἔμπεδον, ἀλλὰ θύελλαι	-u u- -- uu -uu -u u--	dactylic hexameter	masculine penthemimeral, trithemimeral
ἀντίαι ἁρπάγδην ὀπίσω φέρον, ὄφρʼ ἐπέλασσαν	-uu --- uu- uu - uu--	dactylic hexameter	masculine penthemimeral, hepthemimeral
αὖτις ἐυξείνοισι Δολίοσιν ἐκ δʼ ἄρʼ ἔβησαν	-u u---u u-uu - u u--	dactylic hexameter	feminine penthemimeral
αὐτονυχί· ἱερὴ δὲ φατίζεται ἥδʼ ἔτι πέτρη,	-uu- uu- u u-uu - uu --	dactylic hexameter	masculine penthemimeral, trithemimeral
ᾗ πέρι πείσματα νηὸς ἐπεσσύμενοι ἐβάλοντο.	- uu -uu -u u-uu- uu--	dactylic hexameter	feminine penthemimeral
οὐδέ τις αὐτὴν νῆσον ἐπιφραδέως ἐνόησεν	-u u -- -u u-uu- uu--	dactylic hexameter	feminine penthemimeral
ἔμμεναι· οὐδʼ ὑπὸ νυκτὶ Δολίονες ἂψ ἀνιόντας	-uu - uu -u u-uu - uu--	dactylic hexameter	feminine penthemimeral, trithemimeral
ἥρωας νημερτὲς ἐπήισαν· ἀλλά που ἀνδρῶν	--- --u u-uu -u u --	dactylic hexameter	feminine penthemimeral, trithemimeral
Μακριέων εἴσαντο Πελασγικὸν ἄρεα κέλσαι.	-uu- --u u-uu -uu --	dactylic hexameter	feminine penthemimeral, trithemimeral
τῶ καὶ τεύχεα δύντες ἐπὶ σφίσι χεῖρας ἄειραν.	- - -uu -u u- uu -u u--	dactylic hexameter	feminine penthemimeral, hepthemimeral
σὺν δʼ ἔλασαν μελίας τε καὶ ἀσπίδας ἀλλήλοισιν	- uu- uu- u u -uu ----	dactylic hexameter	masculine penthemimeral, trithemimeral
ὀξείῃ ἴκελοι ῥιπῇ πυρός, ἥ τʼ ἐνὶ θάμνοις	--- uu- -- uu - uu --	dactylic hexameter	masculine penthemimeral, hepthemimeral, trithemimeral
αὐαλέοισι πεσοῦσα κορύσσεται· ἐν δὲ κυδοιμὸς	-uu-u u-u u-uu - u u--	dactylic hexameter	feminine penthemimeral
δεινός τε ζαμενής τε Δολιονίῳ πέσε δήμῳ.	-- - uu- u u-uu- uu --	dactylic hexameter	masculine penthemimeral, trithemimeral
οὐδʼ ὅγε δηιοτῆτος ὑπὲρ μόρον αὖτις ἔμελλεν	- uu -uu-u u- uu -u u--	dactylic hexameter	feminine penthemimeral, hepthemimeral
οἴκαδε νυμφιδίους θαλάμους καὶ λέκτρον ἱκέσθαι.	-uu -uu- uu- - -u u--	dactylic hexameter	masculine penthemimeral, hepthemimeral
ἀλλά μιν Αἰσονίδης τετραμμένον ἰθὺς ἑοῖο	-u u -uu- --uu -u u--	dactylic hexameter	masculine penthemimeral
πλῆξεν ἐπαΐξας στῆθος μέσον, ἀμφὶ δὲ δουρὶ	-u u--- -- uu -u u --	dactylic hexameter	masculine penthemimeral, hepthemimeral
ὀστέον ἐρραίσθη· ὁ δʼ ἐνὶ ψαμάθοισιν ἐλυσθεὶς	-uu --- u u- uu-u u--	dactylic hexameter	masculine penthemimeral, hepthemimeral
μοῖραν ἀνέπλησεν. τὴν γὰρ θέμις οὔποτʼ ἀλύξαι	-u u--- - - uu -u u--	dactylic hexameter	masculine penthemimeral, hepthemimeral
θνητοῖσιν· πάντῃ δὲ περὶ μέγα πέπταται ἕρκος.	--- -- u u- uu -uu --	dactylic hexameter	masculine penthemimeral, hepthemimeral, trithemimeral
ὧς τὸν ὀιόμενόν που ἀδευκέος ἔκτοθεν ἄτης	- u u-uu- u u-uu -uu --	dactylic hexameter	masculine penthemimeral
εἶναι ἀριστήων αὐτῇ ὑπὸ νυκτὶ πέδησεν	-u u--- -- uu -u u--	dactylic hexameter	masculine penthemimeral, hepthemimeral
μαρνάμενον κείνοισι· πολεῖς δʼ ἐπαρηγόνες ἄλλοι	-uu- --u u- uu-uu --	dactylic hexameter	feminine penthemimeral, hepthemimeral, trithemimeral
ἔκταθεν· Ἡρακλέης μὲν ἐνήρατο Τηλεκλῆα	-uu -uu- u u-uu ----	dactylic hexameter	masculine penthemimeral
ἠδὲ Μεγαβρόντην· Σφόδριν δʼ ἐνάριξεν Ἄκαστος·	-u u--- -- uu-u u--	dactylic hexameter	masculine penthemimeral, hepthemimeral
Πηλεὺς δὲ Ζέλυν εἷλεν ἀρηίθοόν τε Γέφυρον.	-- - uu -u u-uu- u u--	dactylic hexameter	feminine penthemimeral, trithemimeral
αὐτὰρ ἐυμμελίης Τελαμὼν Βασιλῆα κατέκτα.	-u u-uu- uu- uu-u u--	dactylic hexameter	masculine penthemimeral, hepthemimeral
Ἴδας δʼ αὖ Προμέα, Κλυτίος δʼ Ὑάκινθον ἔπεφνεν,	-- - uu- uu- uu-u u--	dactylic hexameter	masculine penthemimeral, hepthemimeral, trithemimeral
Τυνδαρίδαι δʼ ἄμφω Μεγαλοσσάκεα Φλογίον τε.	-uu- -- uu-uu- uu- -	dactylic hexameter	masculine penthemimeral, trithemimeral
Οἰνεΐδης δʼ ἐπὶ τοῖσιν ἕλεν θρασὺν Ἰτυμονῆα	-uu- uu -u u- uu -uu--	dactylic hexameter	feminine penthemimeral, hepthemimeral, trithemimeral
ἠδὲ καὶ Ἀρτακέα, πρόμον ἀνδρῶν· οὓς ἔτι πάντας	-u u -uu- uu -- - uu --	dactylic hexameter	masculine penthemimeral
ἐνναέται τιμαῖς ἡρωίσι κυδαίνουσιν.	-uu- -- --uu ----	dactylic hexameter	masculine penthemimeral, trithemimeral
οἱ δʼ ἄλλοι εἴξαντες ὑπέτρεσαν, ἠύτε κίρκους	- -- --u u-uu -uu --	dactylic hexameter	feminine penthemimeral, trithemimeral
ὠκυπέτας ἀγεληδὸν ὑποτρέσσωσι πέλειαι.	-uu- uu-u u---u u--	dactylic hexameter	feminine penthemimeral, trithemimeral
ἐς δὲ πύλας ὁμάδῳ πέσον ἀθρόοι· αἶψα δʼ ἀυτῆς	- u u- uu- uu -uu -u u--	dactylic hexameter	masculine penthemimeral, trithemimeral
πλῆτο πόλις στονόεντος ὑποτροπίῃ πολέμοιο.	-u u- uu-u u-uu- uu--	dactylic hexameter	feminine penthemimeral, trithemimeral
ἠῶθεν δʼ ὀλοὴν καὶ ἀμήχανον εἰσενόησαν	--- uu- u u-uu -uu--	dactylic hexameter	masculine penthemimeral, trithemimeral
ἀμπλακίην ἄμφω· στυγερὸν δʼ ἄχος εἷλεν ἰδόντας	-uu- -- uu- uu -u u--	dactylic hexameter	masculine penthemimeral, hepthemimeral, trithemimeral
ἥρωας Μινύας Αἰνήιον υἷα πάροιθεν	--- uu- --uu -u u--	dactylic hexameter	masculine penthemimeral, trithemimeral
Κύζικον ἐν κονίῃσι καὶ αἵματι πεπτηῶτα.	-uu - uu-u u -uu ----	dactylic hexameter	feminine penthemimeral, trithemimeral
ἤματα δὲ τρία πάντα γόων, τίλλοντό τε χαίτας	-uu - uu -u u- --u u --	dactylic hexameter	feminine penthemimeral, hepthemimeral, trithemimeral
αὐτοὶ ὁμῶς λαοί τε Δολίονες. αὐτὰρ ἔπειτα	-u u- -- u u-uu -u u--	dactylic hexameter	masculine penthemimeral, trithemimeral
τρὶς περὶ χαλκείοις σὺν τεύχεσι δινηθέντες	- uu --- - -uu ----	dactylic hexameter	masculine penthemimeral
τύμβῳ ἐνεκτερέιξαν, ἐπειρήσαντό τʼ ἀέθλων,	-u u-uu-u u---u u--	dactylic hexameter	feminine penthemimeral
ἣ θέμις, ἂμ πεδίον λειμώνιον, ἔνθʼ ἔτι νῦν περ	- uu - uu- --uu - uu - -	dactylic hexameter	masculine penthemimeral, trithemimeral
ἀγκέχυται τόδε σῆμα καὶ ὀψιγόνοισιν ἰδέσθαι.	-uu- uu -u u -uu-u u--	dactylic hexameter	feminine penthemimeral, trithemimeral
οὐδὲ μὲν οὐδʼ ἄλοχος Κλείτη φθιμένοιο λέλειπτο	-u u - uu- -- uu-u u--	dactylic hexameter	masculine penthemimeral, hepthemimeral, trithemimeral
οὗ πόσιος μετόπισθε· κακῷ δʼ ἐπὶ κύντερον ἄλλο	- uu- uu-u u- uu -uu --	dactylic hexameter	feminine penthemimeral, hepthemimeral, trithemimeral
ἤνυσεν, ἁψαμένη βρόχον αὐχένι. τὴν δὲ καὶ αὐταὶ	-uu -uu- uu -uu - u u --	dactylic hexameter	masculine penthemimeral
νύμφαι ἀποφθιμένην ἀλσηίδες ὠδύραντο·	-u u-uu- --uu ----	dactylic hexameter	masculine penthemimeral
καί οἱ ἀπὸ βλεφάρων ὅσα δάκρυα χεῦαν ἔραζε,	- u u- uu- uu -uu -u u--	dactylic hexameter	masculine penthemimeral, trithemimeral
πάντα τά γε κρήνην τεῦξαν θεαί, ἣν καλέουσιν	-u u - -- -- uu - uu--	dactylic hexameter	masculine penthemimeral, hepthemimeral, trithemimeral
Κλείτην, δυστήνοιο περικλεὲς οὔνομα νύμφης.	-- ---u u-uu -uu --	dactylic hexameter	feminine penthemimeral
αἰνότατον δὴ κεῖνο Δολιονίῃσι γυναιξὶν	-uu- - -u u-uu-u u--	dactylic hexameter	feminine penthemimeral, trithemimeral
ἀνδράσι τʼ ἐκ Διὸς ἦμαρ ἐπήλυθεν· οὐδὲ γὰρ αὐτῶν	-uu - uu -u u-uu -u u --	dactylic hexameter	feminine penthemimeral, trithemimeral
ἔτλη τις πάσσασθαι ἐδητύος, οὐδʼ ἐπὶ δηρὸν	-- - --u u-uu - uu --	dactylic hexameter	feminine penthemimeral, trithemimeral
ἐξ ἀχέων ἔργοιο μυληφάτου ἐμνώοντο·	- uu- --u u-uu ----	dactylic hexameter	feminine penthemimeral, trithemimeral
ἀλλʼ αὔτως ἄφλεκτα διαζώεσκον ἔδοντες.	- -- --u u---u u--	dactylic hexameter	feminine penthemimeral, trithemimeral
ἔνθʼ ἔτι νῦν, εὖτʼ ἄν σφιν ἐτήσια χύτλα χέωνται	- uu - - - u u-uu -u u--	dactylic hexameter	masculine penthemimeral, trithemimeral
Κύζικον ἐνναίοντες Ἰάονες, ἔμπεδον αἰεὶ	-uu ---u u-uu -uu --	dactylic hexameter	feminine penthemimeral
πανδήμοιο μύλης πελάνους ἐπαλετρεύουσιν.	---u u- uu- uu----	dactylic hexameter	masculine penthemimeral, hepthemimeral
ἐκ δὲ τόθεν τρηχεῖαι ἀνηέρθησαν ἄελλαι	- u u- --u u---u u--	dactylic hexameter	feminine penthemimeral, trithemimeral
ἤμαθʼ ὁμοῦ νύκτας τε δυώδεκα, τοὺς δὲ καταῦθι	-u u- -- u u-uu - u u--	dactylic hexameter	masculine penthemimeral, trithemimeral
ναυτίλλεσθαι ἔρυκον. ἐπιπλομένῃ δʼ ἐνὶ νυκτὶ	---u u-u u-uu- uu --	dactylic hexameter	feminine penthemimeral
ὧλλοι μέν ῥα πάρος δεδμημένοι εὐνάζοντο	-- - u u- --uu ----	dactylic hexameter	masculine penthemimeral, trithemimeral
ὕπνῳ ἀριστῆες πύματον λάχος· αὐτὰρ Ἄκαστος	-u u--- uu- uu -u u--	dactylic hexameter	masculine penthemimeral, hepthemimeral
Μόψος τʼ Ἀμπυκίδης ἀδινὰ κνώσσοντας ἔρυντο.	-- -uu- uu- --u u--	dactylic hexameter	masculine penthemimeral, hepthemimeral
ἡ δʼ ἄρʼ ὑπὲρ ξανθοῖο καρήατος Αἰσονίδαο	- u u- --u u-uu -uu--	dactylic hexameter	feminine penthemimeral, trithemimeral
πωτᾶτʼ ἀλκυονὶς λιγυρῇ ὀπὶ θεσπίζουσα	-- -uu- uu- uu ----	dactylic hexameter	masculine penthemimeral, hepthemimeral
λῆξιν ὀρινομένων ἀνέμων· συνέηκε δὲ Μόψος	-u u-uu- uu- uu-u u --	dactylic hexameter	masculine penthemimeral, hepthemimeral
ἀκταίης ὄρνιθος ἐναίσιμον ὄσσαν ἀκούσας.	--- --u u-uu -u u--	dactylic hexameter	feminine penthemimeral, trithemimeral
καὶ τὴν μὲν θεὸς αὖτις ἀπέτραπεν, ἷζε δʼ ὕπερθεν	- - - uu -u u-uu -u u--	dactylic hexameter	feminine penthemimeral, trithemimeral
νηίου ἀφλάστοιο μετήορος ἀίξασα.	-uu ---u u-uu ----	dactylic hexameter	feminine penthemimeral
τὸν δʼ ὅγε κεκλιμένον μαλακοῖς ἐνὶ κώεσιν οἰῶν.	- uu -uu- uu- uu -uu --	dactylic hexameter	masculine penthemimeral, hepthemimeral
κινήσας ἀνέγειρε παρασχεδόν, ὧδέ τʼ ἔειπεν·	--- uu-u u-uu -u u--	dactylic hexameter	feminine penthemimeral, trithemimeral
‘Αἰσονίδη, χρειώ σε τόδʼ ἱερὸν εἰσανιόντα	-uu- -- u u -uu -uu--	dactylic hexameter	masculine penthemimeral, trithemimeral
Δινδύμου ὀκριόεντος ἐύθρονον ἱλάξασθαι	-uu -uu-u u-uu ----	dactylic hexameter	feminine penthemimeral
μητέρα συμπάντων μακάρων· λήξουσι δʼ ἄελλαι	-uu --- uu- --u u--	dactylic hexameter	masculine penthemimeral, hepthemimeral
ζαχρηεῖς· τοίην γὰρ ἐγὼ νέον ὄσσαν ἄκουσα	--- -- u u- uu -u u--	dactylic hexameter	masculine penthemimeral, hepthemimeral, trithemimeral
ἀλκυόνος ἁλίης, ἥ τε κνώσσοντος ὕπερθεν	-uu- uu- - - --u u--	dactylic hexameter	masculine penthemimeral, hepthemimeral, trithemimeral
σεῖο πέριξ τὰ ἕκαστα πιφαυσκομένη πεπότηται.	-u u- u u-u u-uu- uu--	dactylic hexameter	feminine penthemimeral, trithemimeral
ἐκ γὰρ τῆς ἄνεμοί τε θάλασσά τε νειόθι τε χθὼν	- - - uu- u u-u u -uu - -	dactylic hexameter	masculine penthemimeral, trithemimeral
πᾶσα πεπείρανται νιφόεν θ᾽ἕδος Οὐλύμποιο·	-u u--- uu- uu ----	dactylic hexameter	masculine penthemimeral, hepthemimeral
καί οἱ, ὅτʼ ἐξ ὀρέων μέγαν οὐρανὸν εἰσαναβαίνῃ,	- u u - uu- uu -uu -uu--	dactylic hexameter	masculine penthemimeral, trithemimeral
Ζεὺς αὐτὸς Κρονίδης ὑποχάζεται. ὧς δὲ καὶ ὧλλοι	- -- uu- uu-uu - u u --	dactylic hexameter	masculine penthemimeral, trithemimeral
ἀθάνατοι μάκαρες δεινὴν θεὸν ἀμφιέπουσιν.’	-uu- uu- -- uu -uu--	dactylic hexameter	masculine penthemimeral, hepthemimeral, trithemimeral
ὧς φάτο· τῷ δʼ ἀσπαστὸν ἔπος γένετʼ εἰσαΐοντι.	- uu - --u u- uu -uu--	dactylic hexameter	feminine penthemimeral, hepthemimeral, trithemimeral
ὤρνυτο δʼ ἐξ εὐνῆς κεχαρημένος· ὦρσε δʼ ἑταίρους	-uu - -- uu-uu -u u--	dactylic hexameter	masculine penthemimeral, trithemimeral
πάντας ἐπισπέρχων, καί τέ σφισιν ἐγρομένοισιν	-u u--- - - uu -uu--	dactylic hexameter	masculine penthemimeral, hepthemimeral
Ἀμπυκίδεω Μόψοιο θεοπροπίας ἀγόρευεν.	-uu- --u u-uu- uu--	dactylic hexameter	feminine penthemimeral, trithemimeral
αἶψα δὲ κουρότεροι μὲν ἀπὸ σταθμῶν ἐλάσαντες	-u u -uu- u u- -- uu--	dactylic hexameter	masculine penthemimeral, hepthemimeral
ἔνθεν ἐς αἰπεινὴν ἄναγον βόας οὔρεος ἄκρην.	-u u --- uu- uu -uu --	dactylic hexameter	masculine penthemimeral, hepthemimeral
οἱ δʼ ἄρα λυσάμενοι Ἱερῆς ἐκ πείσματα πέτρης	- uu -uu- uu- - -uu --	dactylic hexameter	masculine penthemimeral, hepthemimeral
ἤρεσαν ἐς λιμένα Θρηίκιον· ἂν δὲ καὶ αὐτοὶ	-uu - uu- --uu - u u --	dactylic hexameter	masculine penthemimeral, trithemimeral
βαῖνον, παυροτέρους ἑτάρων ἐν νηὶ λιπόντες.	-- -uu- uu- - -u u--	dactylic hexameter	masculine penthemimeral, hepthemimeral
τοῖσι δὲ Μακριάδες σκοπιαὶ καὶ πᾶσα περαίη	-u u -uu- uu- - -u u--	dactylic hexameter	masculine penthemimeral, hepthemimeral
Θρηικίης ἐνὶ χερσὶν ἑαῖς προυφαίνετʼ ἰδέσθαι·	-uu- uu -u u- --u u--	dactylic hexameter	feminine penthemimeral, hepthemimeral, trithemimeral
φαίνετο δʼ ἠερόεν στόμα Βοσπόρου ἠδὲ κολῶναι	-uu -uu- uu -uu -u u--	dactylic hexameter	masculine penthemimeral
Μυσίαι· ἐκ δʼ ἑτέρης ποταμοῦ ῥόος Αἰσήποιο	-uu - uu- uu- uu ----	dactylic hexameter	masculine penthemimeral, hepthemimeral, trithemimeral
ἄστυ τε καὶ πεδίον Νηπήιον Ἀδρηστείης.	-u u - uu- --uu ----	dactylic hexameter	masculine penthemimeral, trithemimeral
ἔσκε δέ τι στιβαρὸν στύπος ἀμπέλου ἔντροφον ὕλῃ,	-u u - uu- uu -uu -uu --	dactylic hexameter	masculine penthemimeral, trithemimeral
πρόχνυ γεράνδρυον· τὸ μὲν ἔκταμον, ὄφρα πέλοιτο	-u u-uu - - -uu -u u--	dactylic hexameter	masculine penthemimeral
δαίμονος οὐρείης ἱερὸν βρέτας· ἔξεσε δʼ Ἄργος	-uu --- uu- uu -uu --	dactylic hexameter	masculine penthemimeral, hepthemimeral
εὐκόσμως, καὶ δή μιν ἐπʼ ὀκριόεντι κολωνῷ	--- - - u u -uu-u u--	dactylic hexameter	masculine penthemimeral, trithemimeral
ἵδρυσαν φηγοῖσιν ἐπηρεφὲς ἀκροτάτῃσιν,	--- --u u-uu -uu--	dactylic hexameter	feminine penthemimeral, trithemimeral
αἵ ῥά τε πασάων πανυπέρταται ἐρρίζωνται.	- u u --- uu-uu ----	dactylic hexameter	masculine penthemimeral
βωμὸν δʼ αὖ χέραδος παρενήνεον· ἀμφὶ δὲ φύλλοις	-- - uu- uu-uu -u u --	dactylic hexameter	masculine penthemimeral, trithemimeral
στεψάμενοι δρυΐνοισι θυηπολίης ἐμέλοντο	-uu- uu-u u-uu- uu--	dactylic hexameter	feminine penthemimeral, trithemimeral
μητέρα Δινδυμίην πολυπότνιαν ἀγκαλέοντες,	-uu -uu- uu-uu -uu--	dactylic hexameter	masculine penthemimeral
ἐνναέτιν Φρυγίης, Τιτίην θ᾽ἅμα Κύλληνόν τε,	-uu- uu- uu- uu --- -	dactylic hexameter	masculine penthemimeral, hepthemimeral, trithemimeral
οἳ μοῦνοι πολέων μοιρηγέται ἠδὲ πάρεδροι	- -- uu- --uu -u u--	dactylic hexameter	masculine penthemimeral, trithemimeral
μητέρος Ἰδαίης κεκλήαται, ὅσσοι ἔασιν	-uu --- --uu -u u--	dactylic hexameter	masculine penthemimeral
δάκτυλοι Ἰδαῖοι Κρηταιέες, οὕς ποτε νύμφη	-uu --- --uu - uu --	dactylic hexameter	masculine penthemimeral
Ἀγχιάλη Δικταῖον ἀνὰ σπέος ἀμφοτέρῃσιν	-uu- --u u- uu -uu--	dactylic hexameter	feminine penthemimeral, hepthemimeral, trithemimeral
δραξαμένη γαίης Οἰαξίδος ἐβλάστησεν.	-uu- -- --uu ----	dactylic hexameter	masculine penthemimeral, trithemimeral
πολλὰ δὲ τήνγε λιτῇσιν ἀποστρέψαι ἐριώλας	-u u -u u-u u--- uu--	dactylic hexameter	feminine penthemimeral
Λἰσονίδης γουνάζετʼ ἐπιλλείβων ἱεροῖσιν	-uu- --u u--- uu--	dactylic hexameter	feminine penthemimeral, trithemimeral
αἰθομένοις· ἄμυδις δὲ νέοι Ὀρφῆος ἀνωγῇ	-uu- uu- u u- --u u--	dactylic hexameter	masculine penthemimeral, hepthemimeral, trithemimeral
σκαίροντες βηταρμὸν ἐνόπλιον ὠρχήσαντο,	--- --u u-uu ----	dactylic hexameter	feminine penthemimeral, trithemimeral
καὶ σάκεα ξιφέεσσιν ἐπέκτυπον, ὥς κεν ἰωὴ	- uu- uu-u u-uu - u u--	dactylic hexameter	feminine penthemimeral, trithemimeral
δύσφημος πλάζοιτο διʼ ἠέρος, ἣν ἔτι λαοὶ	--- --u u -uu - uu --	dactylic hexameter	feminine penthemimeral, trithemimeral
κηδείῃ βασιλῆος ἀνέστενον. ἔνθεν ἐσαιεὶ	--- uu-u u-uu -u u--	dactylic hexameter	feminine penthemimeral, trithemimeral
ῥόμβῳ καὶ τυπάνῳ Ῥείην Φρύγες ἱλάσκονται.	-- - uu- -- uu ----	dactylic hexameter	masculine penthemimeral, hepthemimeral, trithemimeral
ἡ δέ που εὐαγέεσσιν ἐπὶ φρένα θῆκε θυηλαῖς	- u u -uu-u u- uu -u u--	dactylic hexameter	feminine penthemimeral, hepthemimeral
ἀνταίη δαίμων· τὰ δʼ ἐοικότα σήματʼ ἔγεντο.	--- -- u u-uu -u u--	dactylic hexameter	masculine penthemimeral, trithemimeral
δένδρεα μὲν καρπὸν χέον ἄσπετον, ἀμφὶ δὲ ποσσὶν	-uu - -- uu -uu -u u --	dactylic hexameter	masculine penthemimeral, trithemimeral
αὐτομάτη φύε γαῖα τερείνης ἄνθεα ποίης.	-uu- uu -u u-- -uu --	dactylic hexameter	feminine penthemimeral, trithemimeral
θῆρες δʼ εἰλυούς τε κατὰ ξυλόχους τε λιπόντες	-- --- u u- uu- u u--	dactylic hexameter	masculine penthemimeral, hepthemimeral
οὐρῇσιν σαίνοντες ἐπήλυθον. ἡ δὲ καὶ ἄλλο	--- --u u-uu - u u --	dactylic hexameter	feminine penthemimeral, trithemimeral
θῆκε τέρας· ἐπεὶ οὔτι παροίτερον ὕδατι νᾶεν	-u u- uu -u u-uu -uu --	dactylic hexameter	feminine penthemimeral, trithemimeral
Δίνδυμον· ἀλλά σφιν τότʼ ἀνέβραχε διψάδος αὔτως	-uu -- - u u-uu -uu --	dactylic hexameter	masculine penthemimeral
ἐκ κορυφῆς ἄλληκτον· Ἰησονίην δʼ ἐνέπουσιν	- uu- --u u-uu- uu--	dactylic hexameter	feminine penthemimeral, trithemimeral
κεῖνο ποτὸν κρήνην περιναιέται ἄνδρες ὀπίσσω.	-u u- -- uu-uu -u u--	dactylic hexameter	masculine penthemimeral, trithemimeral
καὶ τότε μὲν δαῖτʼ ἀμφὶ θεᾶς θέσαν οὔρεσιν Ἄρκτων,	- uu - - -u u- uu -uu --	dactylic hexameter	feminine penthemimeral, hepthemimeral, trithemimeral
μέλποντες Ῥείην πολυπότνιαν· αὐτὰρ ἐς ἠὼ	--- -- uu-uu -u u --	dactylic hexameter	masculine penthemimeral, trithemimeral
ληξάντων ἀνέμων νῆσον λίπον εἰρεσίῃσιν.	--- uu- -- uu -uu--	dactylic hexameter	masculine penthemimeral, hepthemimeral, trithemimeral
ἔνθʼ ἔρις ἄνδρα ἕκαστον ἀριστήων ὀρόθυνεν,	- uu -u u-u u--- uu--	dactylic hexameter	feminine penthemimeral
ὅστις ἀπολλήξειε πανύστατος. ἀμφὶ γὰρ αἰθὴρ	-u u---u u-uu -u u --	dactylic hexameter	feminine penthemimeral
νήνεμος ἐστόρεσεν δίνας, κατὰ δʼ εὔνασε πόντον.	-uu -uu- -- uu -uu --	dactylic hexameter	masculine penthemimeral, hepthemimeral
οἱ δὲ γαληναίῃ πίσυνοι ἐλάασκον ἐπιπρὸ	- u u--- uu- uu-u u--	dactylic hexameter	masculine penthemimeral, hepthemimeral
νῆα βίῃ· τὴν δʼ οὔ κε διὲξ ἁλὸς ἀίσσουσαν	-u u- - - u u- uu ----	dactylic hexameter	masculine penthemimeral, hepthemimeral, trithemimeral
οὐδὲ Ποσειδάωνος ἀελλόποδες κίχον ἵπποι.	-u u---u u-uu- uu --	dactylic hexameter	feminine penthemimeral
ἔμπης δʼ ἐγρομένοιο σάλου ζαχρηεσιν αὔραις,	-- -uu-u u- --uu --	dactylic hexameter	feminine penthemimeral, hepthemimeral
αἳ νέον ἐκ ποταμῶν ὑπὸ δείελον ἠερέθονται,	- uu - uu- uu -uu -uu--	dactylic hexameter	masculine penthemimeral, trithemimeral
τειρόμενοι καὶ δὴ μετελώφεον· αὐτὰρ ὁ τούς γε	-uu- - - uu-uu -u u - -	dactylic hexameter	masculine penthemimeral, trithemimeral
πασσυδίῃ μογέοντας ἐφέλκετο κάρτεϊ χειρῶν	-uu- uu-u u-uu -uu --	dactylic hexameter	feminine penthemimeral, trithemimeral
Ἡρακλέης, ἐτίνασσε δʼ ἀρηρότα δούρατα νηός.	-uu- uu-u u-uu -uu --	dactylic hexameter	feminine penthemimeral, trithemimeral
ἀλλʼ ὅτε δὴ Μυσῶν λελιημένοι ἠπείροιο	- uu - -- uu-uu ----	dactylic hexameter	masculine penthemimeral, trithemimeral
Ῥυνδακίδας προχοὰς μέγα τʼ ἠρίον Αἰγαίωνος	-uu- uu- uu -uu ----	dactylic hexameter	masculine penthemimeral, trithemimeral
τυτθὸν ὑπὲκ Φρυγίης παρεμέτρεον εἰσορόωντες,	-u u- uu- ---uu -uu--	lyric	
δὴ τότʼ ἀνοχλίζων τετρηχότος οἴδματος ὁλκοὺς	- u u--- --uu -uu --	dactylic hexameter	masculine penthemimeral
μεσσόθεν ἆξεν ἐρετμόν. ἀτὰρ τρύφος ἄλλο μὲν αὐτὸς	-uu -u u-u u- uu -u u --	dactylic hexameter	feminine penthemimeral, hepthemimeral
ἄμφω χερσὶν ἔχων πέσε δόχμιος, ἄλλο δὲ πόντος	-- -u u- uu -uu -u u --	dactylic hexameter	masculine penthemimeral
κλύζε παλιρροθίοισι φέρων. ἀνὰ δʼ ἕζετο σιγῇ	-u u-uu-u u- uu -uu --	dactylic hexameter	feminine penthemimeral, hepthemimeral
παπταίνων· χεῖρες γὰρ ἀήθεον ἠρεμέουσαι.	--- -- u u-uu -uu--	dactylic hexameter	masculine penthemimeral, trithemimeral
ἦμος δʼ ἀγρόθεν εἶσι φυτοσκάφος ἤ τις ἀροτρεὺς	-- -uu -u u-uu - u u--	dactylic hexameter	feminine penthemimeral
ἀσπασίως εἰς αὖλιν ἑήν, δόρποιο χατίζων,	-uu- - -u u- --u u--	dactylic hexameter	feminine penthemimeral, hepthemimeral, trithemimeral
αὐτοῦ δʼ ἐν προμολῇ τετρυμένα γούνατʼ ἔκαμψεν	-- - uu- --uu -u u--	dactylic hexameter	masculine penthemimeral, trithemimeral
αὐσταλέος κονίῃσι, περιτριβέας δέ τε χεῖρας	-uu- uu-u u-uu- u u --	dactylic hexameter	feminine penthemimeral, trithemimeral
εἰσορόων κακὰ πολλὰ ἑῇ ἠρήσατο γαστρί·	-uu- uu -u u- --uu --	dactylic hexameter	feminine penthemimeral, hepthemimeral, trithemimeral
τῆμος ἄρʼ οἵ γʼ ἀφίκοντο Κιανίδος ἤθεα γαίης	-u u - uu-u u-uu -uu --	dactylic hexameter	feminine penthemimeral, trithemimeral
ἀμφʼ Ἀργανθώνειον ὄρος προχοάς τε Κίοιο.	- ----u u- uu- u u--	dactylic hexameter	feminine penthemimeral, hepthemimeral
τοὺς μὲν ἐυξείνως Μυσοὶ φιλότητι κιόντας	- u u--- -- uu-u u--	dactylic hexameter	masculine penthemimeral, hepthemimeral
δειδέχατʼ, ἐνναέται κείνης χθονός, ἤιά τέ σφιν	-uu -uu- -- uu -uu - -	dactylic hexameter	masculine penthemimeral, hepthemimeral
μῆλά τε δευομένοις μέθυ τʼ ἄσπετον ἐγγυάλιξαν.	-u u -uu- uu -uu -uu--	dactylic hexameter	masculine penthemimeral
ἔνθα δʼ ἔπειθʼ οἱ μὲν ξύλα κάγκανα, τοὶ δὲ λεχαίην	-u u- - - uu -uu - u u--	dactylic hexameter	masculine penthemimeral, trithemimeral
φυλλάδα λειμώνων φέρον ἄσπετον ἀμήσαντες,	-uu --- uu -uu ----	dactylic hexameter	masculine penthemimeral
στόρνυσθαι· τοὶ δʼ ἀμφὶ πυρήια δινεύεσκον·	--- - -u u-uu ----	dactylic hexameter	feminine penthemimeral, trithemimeral
οἱ δʼ οἶνον κρητῆρσι κέρων, πονέοντο τε δαῖτα,	- -- --u u- uu-u u --	dactylic hexameter	feminine penthemimeral, hepthemimeral, trithemimeral
Ἐκβασίῳ ῥέξαντες ὑπὸ κνέφας Ἀπόλλωνι.	-uu- --u u- uu ----	dactylic hexameter	feminine penthemimeral, hepthemimeral, trithemimeral
αὐτὰρ ὁ δαίνυσθαι ἑτάροις οἷς εὖ ἐπιτείλας	-u u --- uu- - - uu--	dactylic hexameter	masculine penthemimeral, hepthemimeral
βῆ ῥ̓᾽ ἴμεν εἰς ὕλην υἱὸς Διός, ὥς κεν ἐρετμὸν	- uu - -- -- uu - u u--	dactylic hexameter	masculine penthemimeral, hepthemimeral, trithemimeral
οἷ αὐτῷ φθαίη καταχείριον ἐντύνασθαι.	- -- -- uu-uu ----	dactylic hexameter	masculine penthemimeral, trithemimeral
εὗρεν ἔπειτʼ ἐλάτην ἀλαλήμενος, οὔτε τι πολλοῖς	-u u- uu- uu-uu -u u --	dactylic hexameter	masculine penthemimeral, trithemimeral
ἀχθομένην ὄζοις, οὐδὲ μέγα τηλεθόωσαν,	-uu- -- -- uu -uu--	dactylic hexameter	masculine penthemimeral, hepthemimeral, trithemimeral
ἀλλʼ οἷον ταναῆς ἔρνος πέλει αἰγείροιο·	- -- uu- -- uu ----	dactylic hexameter	masculine penthemimeral, hepthemimeral, trithemimeral
τόσση ὁμῶς μῆκός τε καὶ ἐς πάχος ἦεν ἰδέσθαι.	-u u- -- u u - uu -u u--	dactylic hexameter	masculine penthemimeral, hepthemimeral, trithemimeral
ῥίμφα δʼ ὀιστοδόκην μὲν ἐπὶ χθονὶ θῆκε φαρέτρην	-- -uu- u u- uu -u u--	dactylic hexameter	masculine penthemimeral, hepthemimeral
αὐτοῖσιν τόξοισιν, ἔδυ δʼ ἀπὸ δέρμα λέοντος.	--- --u u- uu -u u--	dactylic hexameter	feminine penthemimeral, hepthemimeral, trithemimeral
τὴν δʼ ὅγε χαλκοβαρεῖ ῥοπάλῳ δαπέδοιο τινάξας	- uu -uu- uu- uu-u u--	dactylic hexameter	masculine penthemimeral, hepthemimeral
νειόθεν ἀμφοτέρῃσι περὶ στύπος ἔλλαβε χερσίν,	-uu -uu-u u- uu -uu --	dactylic hexameter	feminine penthemimeral, hepthemimeral
ἠνορέῃ πίσυνος· ἐν δὲ πλατὺν ὦμον ἔρεισεν	-uu- uu- - - uu -u u--	dactylic hexameter	masculine penthemimeral, hepthemimeral, trithemimeral
εὖ διαβάς· πεδόθεν δὲ βαθύρριζόν περ ἐοῦσαν	- uu- uu- u u--- u u--	dactylic hexameter	masculine penthemimeral, trithemimeral
προσφὺς ἐξήειρε σὺν αὐτοῖς ἔχμασι γαίης.	-- ---u u -- -uu --	dactylic hexameter	feminine penthemimeral
ὡς δʼ ὅταν ἀπροφάτως ἱστόν νεός, εὖτε μάλιστα	- uu -uu- -- uu -u u--	dactylic hexameter	masculine penthemimeral, hepthemimeral
χειμερίη ὀλοοῖο δύσις πέλει Ὠρίωνος,	-uu- uu-u u- uu ----	dactylic hexameter	feminine penthemimeral, hepthemimeral, trithemimeral
ὑψόθεν ἐμπλήξασα θοὴ ἀνέμοιο κατάιξ	-uu ---u u- uu-u u--	dactylic hexameter	feminine penthemimeral, hepthemimeral
αὐτοῖσι σφήνεσσιν ὑπὲκ προτόνων ἐρύσηται·	--- --u u- uu- uu--	dactylic hexameter	feminine penthemimeral, hepthemimeral, trithemimeral
ὧς ὅγε τὴν ἤειρεν. ὁμοῦ δʼ ἀνὰ τόξα καὶ ἰοὺς	- uu - --u u- uu -u u --	dactylic hexameter	feminine penthemimeral, hepthemimeral, trithemimeral
δέρμα θ᾽ἑλὼν ῥόπαλόν τε παλίσσυτος ὦρτο νέεσθαι.	-u u- uu- u u-uu -u u--	dactylic hexameter	masculine penthemimeral, trithemimeral
τόφρα δʼ Ὕλας χαλκέῃ σὺν κάλπιδι νόσφιν ὁμίλου	-u u- -- - -uu -u u--	dactylic hexameter	masculine penthemimeral, trithemimeral
δίζητο κρήνης ἱερὸν ῥόον, ὥς κέ οἱ ὕδωρ	--- -- uu- uu - u u --	dactylic hexameter	masculine penthemimeral, hepthemimeral, trithemimeral
φθαίη ἀφυσσάμενος ποτιδόρπιον, ἄλλα τε πάντα	-u u-uu- uu-uu -u u --	dactylic hexameter	masculine penthemimeral
ὀτραλέως κατὰ κόσμον ἐπαρτίσσειεν ἰόντι.	-uu- uu -u u---u u--	dactylic hexameter	feminine penthemimeral, trithemimeral
δὴ γάρ μιν τοίοισιν ἐν ἤθεσιν αὐτὸς ἔφερβεν,	- - - --u u -uu -u u--	dactylic hexameter	feminine penthemimeral, trithemimeral
νηπίαχον τὰ πρῶτα δόμων ἐκ πατρὸς ἀπούρας,	-uu- - -u u- - -u u--	dactylic hexameter	feminine penthemimeral, hepthemimeral, trithemimeral
δίου Θειοδάμαντος, ὃν ἐν Δρυόπεσσιν ἔπεφνεν	-- -uu-u u - uu-u u--	dactylic hexameter	feminine penthemimeral, hepthemimeral
νηλειῶς, βοὸς ἀμφὶ γεωμόρου ἀντιόωντα.	--- uu -u u-uu -uu--	dactylic hexameter	feminine penthemimeral, trithemimeral
ἤτοι ὁ μὲν νειοῖο γύας τέμνεσκεν ἀρότρῳ	-u u - --u u- --u u--	dactylic hexameter	feminine penthemimeral, hepthemimeral, trithemimeral
Θειοδάμας ἀνίῃ βεβολημένος· αὐτὰρ ὁ τόν γε	-uu- uu- uu-uu -u u - -	dactylic hexameter	masculine penthemimeral, trithemimeral
βοῦν ἀρότην ἤνωγε παρασχέμεν οὐκ ἐθέλοντα.	- uu- --u u-uu - uu--	dactylic hexameter	feminine penthemimeral, trithemimeral
ἵετο γὰρ πρόφασιν πολέμου Δρυόπεσσι βαλέσθαι	-uu - uu- uu- uu-u u--	dactylic hexameter	masculine penthemimeral, hepthemimeral, trithemimeral
λευγαλέην, ἐπεὶ οὔτι δίκης ἀλέγοντες ἔναιον.	-uu- uu -u u- uu-u u--	dactylic hexameter	feminine penthemimeral, hepthemimeral, trithemimeral
ἀλλὰ τὰ μὲν τηλοῦ κεν ἀποπλάγξειεν ἀοιδῆς.	-u u - -- u u---u u--	dactylic hexameter	masculine penthemimeral, trithemimeral
αἶψα δʼ ὅ γε κρήνην μετεκίαθεν, ἣν καλέουσιν	-u u - -- uu-uu - uu--	dactylic hexameter	masculine penthemimeral, trithemimeral
πηγὰς ἀγχίγυοι περιναιέται. οἱ δέ που ἄρτι	-- -uu- uu-uu - u u --	dactylic hexameter	masculine penthemimeral
νυμφάων ἵσταντο χοροί· μέλε γάρ σφισι πάσαις,	--- --u u- uu - uu --	dactylic hexameter	feminine penthemimeral, hepthemimeral, trithemimeral
ὅσσαι κεῖσʼ ἐρατὸν νύμφαι ῥίον ἀμφενέμοντο,	-- - uu- -- uu -uu--	dactylic hexameter	masculine penthemimeral, hepthemimeral, trithemimeral
Ἄρτεμιν ἐννυχίῃσιν ἀεὶ μέλπεσθαι ἀοιδαῖς.	-uu -uu-u u- --u u--	dactylic hexameter	feminine penthemimeral, hepthemimeral
αἱ μέν, ὅσαι σκοπιὰς ὀρέων λάχον ἢ καὶ ἐναύλους,	- u u- uu- uu- uu - u u--	dactylic hexameter	masculine penthemimeral, hepthemimeral, trithemimeral
αἵγε μὲν ὑλήωροι ἀπόπροθεν ἐστιχόωντο,	-u u ---u u-uu -uu--	dactylic hexameter	feminine penthemimeral
ἡ δὲ νέον κρήνης ἀνεδύετο καλλινάοιο	- u u- -- uu-uu -uu--	dactylic hexameter	masculine penthemimeral, trithemimeral
νύμφη ἐφυδατίη· τὸν δὲ σχεδὸν εἰσενόησεν	-u u-uu- - - uu -uu--	dactylic hexameter	masculine penthemimeral, hepthemimeral
κάλλεϊ καὶ γλυκερῇσιν ἐρευθόμενον χαρίτεσσιν.	-uu - uu-u u-uu- uu--	dactylic hexameter	feminine penthemimeral, trithemimeral
πρὸς γάρ οἱ διχόμηνις ἀπʼ αἰθέρος αὐγάζουσα	- - - uu-u u -uu ----	dactylic hexameter	feminine penthemimeral, trithemimeral
βάλλε σεληναίη. τὴν δὲ φρένας ἐπτοίησεν	-u u--- - - uu ----	dactylic hexameter	masculine penthemimeral, hepthemimeral
Κύπρις, ἀμηχανίῃ δὲ μόλις συναγείρατο θυμόν.	-u u-uu- u u- uu-uu --	dactylic hexameter	masculine penthemimeral, hepthemimeral
αὐτὰρ ὅ γʼ ὡς τὰ πρῶτα ῥόῳ ἔνι κάλπιν ἔρεισεν	-u u - - -u u- uu -u u--	dactylic hexameter	feminine penthemimeral, hepthemimeral, trithemimeral
λέχρις ἐπιχριμφθείς, περὶ δʼ ἄσπετον ἔβραχεν ὕδωρ	-u u--- uu -uu -uu --	dactylic hexameter	masculine penthemimeral
χαλκὸν ἐς ἠχήεντα φορεύμενον, αὐτίκα δʼ ἥ γε	-u u ---u u-uu -uu - -	dactylic hexameter	feminine penthemimeral
λαιὸν μὲν καθύπερθεν ἐπʼ αὐχένος ἄνθετο πῆχυν	-- - uu-u u -uu -uu --	dactylic hexameter	feminine penthemimeral, trithemimeral
κύσσαι ἐπιθύουσα τέρεν στόμα· δεξιτερῇ δὲ	-u u---u u- uu -uu- -	dactylic hexameter	feminine penthemimeral, hepthemimeral
ἀγκῶνʼ ἔσπασε χειρί, μέσῃ δʼ ἐνικάββαλε δίνῃ.	-- -uu -u u- uu-uu --	dactylic hexameter	feminine penthemimeral, hepthemimeral
τοῦ δʼ ἥρως ἰάχοντος ἐπέκλυεν οἶος ἑταίρων	- -- uu-u u-uu -u u--	dactylic hexameter	feminine penthemimeral, trithemimeral
Εἰλατίδης Πολύφημος, ἰὼν προτέρωσε κελεύθου,	-uu- uu-u u- uu-u u--	dactylic hexameter	feminine penthemimeral, hepthemimeral, trithemimeral
δέκτο γὰρ Ἡρακλῆα πελώριον, ὁππόθʼ ἵκοιτο.	-u u ---u u-uu -u u--	dactylic hexameter	feminine penthemimeral
βῆ δὲ μεταΐξας Πηγέων σχεδόν, ἠύτε τις θὴρ	- u u--- -- uu -uu - -	dactylic hexameter	masculine penthemimeral, hepthemimeral
ἄγριος, ὅν ῥά τε γῆρυς ἀπόπροθεν ἵκετο μήλων,	-uu - u u -u u-uu -uu --	dactylic hexameter	feminine penthemimeral, trithemimeral
λιμῷ δʼ αἰθόμενος μετανίσσεται, οὐδʼ ἐπέκυρσεν	-- -uu- uu-uu - uu--	dactylic hexameter	masculine penthemimeral
ποίμνῃσιν· πρὸ γὰρ αὐτοὶ ἐνὶ σταθμοῖσι νομῆες	--- u u -u u- --u u--	dactylic hexameter	feminine penthemimeral, hepthemimeral, trithemimeral
ἔλσαν· ὁ δὲ στενάχων βρέμει ἄσπετον, ὄφρα κάμῃσιν·	-u u - uu- uu -uu -u u--	dactylic hexameter	masculine penthemimeral, trithemimeral
ὧς τότʼ ἄρʼ Εἰλατίδης μεγάλʼ ἔστενεν, ἀμφὶ δὲ χῶρον	- u u -uu- uu -uu -u u --	dactylic hexameter	masculine penthemimeral
φοίτα κεκληγώς· μελέη δέ οἱ ἔπλετο φωνή.	-- --- uu- u u -uu --	dactylic hexameter	masculine penthemimeral, hepthemimeral
αἶψα δʼ ἐρυσσάμενος μέγα φάσγανον ὦρτο δίεσθαι,	-u u-uu- uu -uu -u u--	dactylic hexameter	masculine penthemimeral
μήπως ἢ θήρεσσιν ἕλωρ πέλοι, ἠέ μιν ἄνδρες	-- - --u u- uu -u u --	dactylic hexameter	feminine penthemimeral, hepthemimeral, trithemimeral
μοῦνον ἐόντʼ ἐλόχησαν, ἄγουσι δὲ ληίδʼ ἑτοίμην.	-u u- uu-u u-u u -u u--	dactylic hexameter	feminine penthemimeral, trithemimeral
ἔνθʼ αὐτῷ ξύμβλητο κατὰ στίβον Ἡρακλῆι	- -- --u u- uu ----	dactylic hexameter	feminine penthemimeral, hepthemimeral, trithemimeral
γυμνὸν ἐπαΐσσων παλάμῃ ξίφος· εὖ δέ μιν ἔγνω	-u u--- uu- uu - u u --	dactylic hexameter	masculine penthemimeral, hepthemimeral
σπερχόμενον μετὰ νῆα διὰ κνέφας. αὐτίκα δʼ ἄτην	-uu- uu -u u- uu -uu --	dactylic hexameter	feminine penthemimeral, hepthemimeral, trithemimeral
ἔκφατο λευγαλέην, βεβαρημένος ἄσθματι θυμόν·	-uu -uu- uu-uu -uu --	dactylic hexameter	masculine penthemimeral
‘δαιμόνιε, στυγερόν τοι ἄχος πάμπρωτος ἐνίψω.	-uu- uu- u u- --u u--	dactylic hexameter	masculine penthemimeral, hepthemimeral, trithemimeral
οὐ γὰρ Ὕλας κρήνηνδε κιὼν σόος αὖτις ἱκάνει.	- u u- --u u- uu -u u--	dactylic hexameter	feminine penthemimeral, hepthemimeral, trithemimeral
ἀλλά ἑ ληιστῆρες ἐνιχρίμψαντες ἄγουσιν,	-u u ---u u---u u--	dactylic hexameter	feminine penthemimeral
ἢ θῆρες σίνονται· ἐγὼ δʼ ἰάχοντος ἄκουσα.’	- -- --u u- uu-u u--	dactylic hexameter	feminine penthemimeral, hepthemimeral, trithemimeral
ὧς φάτο· τῷ δʼ ἀίοντι κατὰ κροτάφων ἅλις ἱδρὼς	- uu - uu-u u- uu- uu --	dactylic hexameter	feminine penthemimeral, hepthemimeral, trithemimeral
κήκιεν, ἐν δὲ κελαινὸν ὑπὸ σπλάγχνοις ζέεν αἷμα.	-uu - u u-u u- -- uu --	dactylic hexameter	feminine penthemimeral, hepthemimeral, trithemimeral
χωόμενος δʼ ἐλάτην χαμάδις βάλεν, ἐς δὲ κέλευθον	-uu- uu- uu- uu - u u--	dactylic hexameter	masculine penthemimeral, hepthemimeral, trithemimeral
τὴν θέεν, ᾗ πόδες αὐτὸν ὑπέκφερον ἀίσσοντα.	- uu - uu -u u-uu ----	dactylic hexameter	feminine penthemimeral, trithemimeral
ὡς δʼ ὅτε τίς τε μύωπι τετυμμένος ἔσσυτο ταῦρος	- uu - u u-u u-uu -uu --	dactylic hexameter	feminine penthemimeral, trithemimeral
πίσεά τε προλιπὼν καὶ ἑλεσπίδας, οὐδὲ νομήων	-uu - uu- u u-uu -u u--	dactylic hexameter	masculine penthemimeral, trithemimeral
οὐδʼ ἀγέλης ὄθεται, πρήσσει δʼ ὁδόν, ἄλλοτʼ ἄπαυστος,	- uu- uu- -- uu -u u--	dactylic hexameter	masculine penthemimeral, hepthemimeral, trithemimeral
ἄλλοτε δʼ ἱστάμενος, καὶ ἀνὰ πλατὺν αὐχένʼ ἀείρων	-uu -uu- u u- uu -u u--	dactylic hexameter	masculine penthemimeral, hepthemimeral
ἵησιν μύκημα, κακῷ βεβολημένος οἴστρῳ·	--- --u u- uu-uu --	dactylic hexameter	feminine penthemimeral, hepthemimeral, trithemimeral
ὧς ὅγε μαιμώων ὁτὲ μὲν θοὰ γούνατʼ ἔπαλλεν	- uu --- uu - uu -u u--	dactylic hexameter	masculine penthemimeral, hepthemimeral
συνεχέως, ὁτὲ δʼ αὖτε μεταλλήγων καμάτοιο	-uu- uu -u u--- uu--	dactylic hexameter	feminine penthemimeral, trithemimeral
τῆλε διαπρύσιον μεγάλῃ βοάασκεν ἀυτῇ.	-u u-uu- uu- uu-u u--	dactylic hexameter	masculine penthemimeral, hepthemimeral
αὐτίκα δʼ ἀκροτάτας ὑπερέσχεθεν ἄκριας ἀστὴρ	-uu -uu- uu-uu -uu --	dactylic hexameter	masculine penthemimeral
ἠῷος, πνοιαὶ δὲ κατήλυθον· ὦκα δὲ Τῖφυς	--- -- u u-uu -u u --	dactylic hexameter	masculine penthemimeral, trithemimeral
ἐσβαίνειν ὀρόθυνεν, ἐπαύρεσθαί τʼ ἀνέμοιο.	--- uu-u u--- uu--	dactylic hexameter	feminine penthemimeral, trithemimeral
οἱ δʼ εἴσβαινον ἄφαρ λελιημένοι· ὕψι δὲ νηὸς	- --u u- uu-uu -u u --	dactylic hexameter	masculine penthemimeral
εὐναίας ἐρύσαντες ἀνεκρούσαντο κάλωας.	--- uu-u u---u u--	dactylic hexameter	feminine penthemimeral, trithemimeral
κυρτώθη δʼ ἀνέμῳ λίνα μεσσόθι, τῆλε δʼ ἀπʼ ἀκτῆς	--- uu- uu -uu -u u --	dactylic hexameter	masculine penthemimeral, trithemimeral
γηθόσυνοι φορέοντο παραὶ Ποσιδήιον ἄκρην.	-uu- uu-u u- uu-uu --	dactylic hexameter	feminine penthemimeral, hepthemimeral, trithemimeral
ἦμος δʼ οὐρανόθεν χαροπὴ ὑπολάμπεται ἠὼς	-- -uu- uu- uu-uu --	dactylic hexameter	masculine penthemimeral, hepthemimeral
ἐκ περάτης ἀνιοῦσα, διαγλαύσσουσι δʼ ἀταρποί,	- uu- uu-u u---u u--	dactylic hexameter	feminine penthemimeral, trithemimeral
καὶ πεδία δροσόεντα φαεινῇ λάμπεται αἴγλῃ,	- uu- uu-u u-- -uu --	dactylic hexameter	feminine penthemimeral, trithemimeral
τῆμος τούσ γʼ ἐνόησαν ἀιδρείῃσι λιπόντες.	-- - uu-u u---u u--	dactylic hexameter	feminine penthemimeral, trithemimeral
ἐν δέ σφιν κρατερὸν νεῖκος πέσεν, ἐν δὲ κολῳὸς	- - - uu- -- uu - u u--	dactylic hexameter	masculine penthemimeral, hepthemimeral, trithemimeral
ἄσπετος, εἰ τὸν ἄριστον ἀποπρολιπόντες ἔβησαν	-uu - u u-u u-uu-u u--	dactylic hexameter	feminine penthemimeral, trithemimeral
σφωιτέρων ἑτάρων. ὁ δʼ ἀμηχανίῃσιν ἀτυχθεὶς	-uu- uu- u u-uu-u u--	dactylic hexameter	masculine penthemimeral, trithemimeral
οὔτε τι τοῖον ἔπος μετεφώνεεν, οὔτε τι τοῖον	-u u -u u- uu-uu -u u --	dactylic hexameter	masculine penthemimeral
Αἰσονίδης· ἀλλʼ ἧστο βαρείῃ νειόθεν ἄτῃ	-uu- - -u u-- -uu --	dactylic hexameter	feminine penthemimeral, trithemimeral
θυμὸν ἔδων· Τελαμῶνα δʼ ἕλεν χόλος, ὧδέ τʼ ἔειπεν·	-u u- uu-u u- uu -u u--	dactylic hexameter	feminine penthemimeral, hepthemimeral, trithemimeral
‘ἧσʼ αὔτως εὔκηλος, ἐπεί νύ τοι ἄρμενον ἦεν	- -- --u u- u u -uu --	dactylic hexameter	feminine penthemimeral, hepthemimeral, trithemimeral
Ἡρακλῆα λιπεῖν· σέο δʼ ἔκτοθι μῆτις ὄρωρεν,	---u u- uu -uu -u u--	dactylic hexameter	masculine penthemimeral
ὄφρα τὸ κείνου κῦδος ἀνʼ Ἑλλάδα μή σε καλύψῃ,	-u u -- -u u -uu - u u--	dactylic hexameter	feminine penthemimeral
αἴ κε θεοὶ δώωσιν ὑπότροπον οἴκαδε νόστον.	- u u- --u u-uu -uu --	dactylic hexameter	feminine penthemimeral, trithemimeral
ἀλλὰ τί μύθων ἦδος; ἐπεὶ καὶ νόσφιν ἑταίρων	-u u -- -u u- - -u u--	dactylic hexameter	feminine penthemimeral, hepthemimeral
εἶμι τεῶν, οἳ τόνγε δόλον συνετεκτήναντο.’	-u u- - -u u- uu----	dactylic hexameter	feminine penthemimeral, hepthemimeral, trithemimeral
ἦ, καὶ ἐς Ἁγνιάδην Τῖφυν θόρε· τὼ δέ οἱ ὄσσε	- u u -uu- -- uu - u u --	dactylic hexameter	masculine penthemimeral, hepthemimeral
ὄστλιγγες μαλεροῖο πυρὸς ὣς ἰνδάλλοντο.	--- uu-u u- - ----	dactylic hexameter	feminine penthemimeral, hepthemimeral, trithemimeral
καί νύ κεν ἂψ ὀπίσω Μυσῶν ἐπὶ γαῖαν ἵκοντο	- u u - uu- -- uu -u u--	dactylic hexameter	masculine penthemimeral, hepthemimeral, trithemimeral
λαῖτμα βιησάμενοι ἀνέμου τʼ ἄλληκτον ἰωήν,	-u u-uu- uu- --u u--	dactylic hexameter	masculine penthemimeral, hepthemimeral
εἰ μὴ Θρηικίοιο δύω υἷες Βορέαο	- - -uu-u u- -- uu--	dactylic hexameter	feminine penthemimeral, hepthemimeral
Αἰακίδην χαλεποῖσιν ἐρητύεσκον ἔπεσσιν,	-uu- uu-u u---u u--	dactylic hexameter	feminine penthemimeral, trithemimeral
σχέτλιοι· ἦ τέ σφιν στυγερὴ τίσις ἔπλετʼ ὀπίσσω	-uu - - - uu- uu -u u--	dactylic hexameter	masculine penthemimeral, hepthemimeral, trithemimeral
χερσὶν ὑφʼ Ἡρακλῆος, ὅ μιν δίζεσθαι ἔρυκον.	-u u ---u u - --u u--	dactylic hexameter	feminine penthemimeral, hepthemimeral
ἄθλων γὰρ Πελίαο δεδουπότος ἂψ ἀνιόντας	-- - uu-u u-uu - uu--	dactylic hexameter	feminine penthemimeral, trithemimeral
τήνῳ ἐν ἀμφιρύτῃ πέφνεν, καὶ ἀμήσατο γαῖαν	-u u -uu- -- u u-uu --	dactylic hexameter	masculine penthemimeral, hepthemimeral
ἀμφʼ αὐτοῖς, στήλας τε δύω καθύπερθεν ἔτευξεν,	- -- -- u u- uu-u u--	dactylic hexameter	masculine penthemimeral, hepthemimeral, trithemimeral
ὧν ἑτέρη, θάμβος περιώσιον ἀνδράσι λεύσσειν,	- uu- -- uu-uu -uu --	dactylic hexameter	masculine penthemimeral, trithemimeral
κίνυται ἠχήεντος ὑπὸ πνοιῇ βορέαο.	-uu ---u u- -- uu--	dactylic hexameter	feminine penthemimeral, hepthemimeral
καὶ τὰ μὲν ὧς ἤμελλε μετὰ χρόνον ἐκτελέεσθαι.	- u u - --u u- uu -uu--	dactylic hexameter	feminine penthemimeral, hepthemimeral, trithemimeral
τοῖσιν δὲ Γλαῦκος βρυχίης ἁλὸς ἐξεφαάνθη,	-- - -- uu- uu -uu--	dactylic hexameter	masculine penthemimeral, hepthemimeral, trithemimeral
Νηρῆος θείοιο πολυφράδμων ὑποφήτης·	--- --u u--- uu--	dactylic hexameter	feminine penthemimeral, trithemimeral
ὕψι δὲ λαχνῆέν τε κάρη καὶ στήθεʼ ἀείρας	-u u --- u u- - -u u--	dactylic hexameter	masculine penthemimeral, hepthemimeral
νειόθεν ἐκ λαγόνων στιβαρῇ ἐπορέξατο χειρὶ	-uu - uu- uu- uu-uu --	dactylic hexameter	masculine penthemimeral, hepthemimeral, trithemimeral
νηίου ὁλκαίοιο, καὶ ἴαχεν ἐσσυμένοισιν·	-uu ---u u -uu -uu--	dactylic hexameter	feminine penthemimeral
‘τίπτε παρὲκ μεγάλοιο Διὸς μενεαίνετε βουλὴν	-u u- uu-u u- uu-uu --	dactylic hexameter	feminine penthemimeral, hepthemimeral, trithemimeral
Αἰήτεω πτολίεθρον ἄγειν θρασὺν Ἡρακλῆα;	--- uu-u u- uu ----	dactylic hexameter	feminine penthemimeral, hepthemimeral, trithemimeral
Ἄργεΐ οἱ μοῖρʼ ἐστὶν ἀτασθάλῳ Εὐρυσθῆι	-uu - - -u u-uu ----	dactylic hexameter	feminine penthemimeral, trithemimeral
ἐκπλῆσαι μογέοντα δυώδεκα πάντας ἀέθλους,	--- uu-u u-uu -u u--	dactylic hexameter	feminine penthemimeral, trithemimeral
ναίειν δʼ ἀθανάτοισι συνέστιον, εἴ κʼ ἔτι παύρους	-- -uu-u u-uu - uu --	dactylic hexameter	feminine penthemimeral
ἐξανύσῃ· τῶ μή τι ποθὴ κείνοιο πελέσθω.	-uu- - - u u- --u u--	dactylic hexameter	masculine penthemimeral, hepthemimeral, trithemimeral
αὔτως δʼ αὖ Πολύφημον ἐπὶ προχοῇσι Κίοιο	-- - uu-u u- uu-u u--	dactylic hexameter	feminine penthemimeral, hepthemimeral, trithemimeral
πέπρωται Μυσοῖσι περικλεὲς ἄστυ καμόντα	--- --u u-uu -u u--	dactylic hexameter	feminine penthemimeral, trithemimeral
μοῖραν ἀναπλήσειν Χαλύβων ἐν ἀπείρονι γαίῃ.	-u u--- uu- u u-uu --	dactylic hexameter	masculine penthemimeral, hepthemimeral
αὐτὰρ Ὕλαν φιλότητι θεὰ ποιήσατο νύμφη	-u u- uu-u u- --uu --	dactylic hexameter	feminine penthemimeral, hepthemimeral, trithemimeral
ὃν πόσιν, οἷό περ οὕνεκʼ ἀποπλαγχθέντες ἔλειφθεν.’	- uu -u u -u u---u u--	dactylic hexameter	feminine penthemimeral
ἦ, καὶ κῦμʼ ἀλίαστον ἐφέσσατο νειόθι δύψας·	- - - uu-u u-uu -uu --	dactylic hexameter	feminine penthemimeral, trithemimeral
ἀμφὶ δέ οἱ δίνῃσι κυκώμενον ἄφρεεν ὕδωρ	-u u - --u u-uu -uu --	dactylic hexameter	feminine penthemimeral, trithemimeral
πορφύρεον, κοίλην δὲ διὲξ ἁλὸς ἔκλυσε νῆα.	-uu- -- u u- uu -uu --	dactylic hexameter	masculine penthemimeral, hepthemimeral, trithemimeral
γήθησαν δʼ ἥρωες· ὁ δʼ ἐσσυμένως ἐβεβήκει	--- --u u -uu- uu--	dactylic hexameter	feminine penthemimeral, trithemimeral
Αἰακίδης Τελαμὼν ἐς Ἰήσονα, χεῖρα δὲ χειρὶ	-uu- uu- u u-uu -u u --	dactylic hexameter	masculine penthemimeral, trithemimeral
ἄκρην ἀμφιβαλὼν προσπτύξατο, φώνησέν τε·	-- -uu- --uu --- -	dactylic hexameter	masculine penthemimeral
‘Αἰσονίδη, μή μοί τι χολώσεαι, ἀφραδίῃσιν	-uu- - - u u-uu -uu--	dactylic hexameter	masculine penthemimeral, trithemimeral
εἴ τί περ ἀασάμην· πέρι γάρ μ᾽ἄχος εἷλεν ἐνισπεῖν	- u u -uu- uu - uu -u u--	dactylic hexameter	masculine penthemimeral, hepthemimeral
μῦθον ὑπερφίαλόν τε καὶ ἄσχετον, ἀλλʼ ἀνέμοισιν	-u u-uu- u u -uu - uu--	dactylic hexameter	masculine penthemimeral
δώομεν ἀμπλακίην, ὡς καὶ πάρος εὐμενέοντες.’	-uu -uu- - - uu -uu--	dactylic hexameter	masculine penthemimeral, hepthemimeral
τὸν δʼ αὖτʼ Αἴσονος υἱὸς ἐπιφραδέως προσέειπεν·	- - -uu -u u-uu- uu--	dactylic hexameter	feminine penthemimeral
‘ὦ πέπον, ἦ μάλα δή με κακῷ ἐκυδάσσαο μύθῳ,	- uu - uu - u u- uu-uu --	dactylic hexameter	masculine penthemimeral, hepthemimeral, trithemimeral
φὰς ἐνὶ τοῖσιν ἅπασιν ἐνηέος ἀνδρὸς ἀλείτην	- uu -u u-u u-uu -u u--	dactylic hexameter	feminine penthemimeral
ἔμμεναι. ἀλλʼ οὐ θήν τοι ἀδευκέα μῆνιν ἀέξω,	-uu - - - u u-uu -u u--	dactylic hexameter	masculine penthemimeral, trithemimeral
πρίν περ ἀνιηθείς· ἐπεὶ οὐ περὶ πώεσι μήλων,	- u u--- uu - uu -uu --	dactylic hexameter	masculine penthemimeral, hepthemimeral
οὐδὲ περὶ κτεάτεσσι χαλεψάμενος μενέηνας,	-u u- uu-u u-uu- uu--	dactylic hexameter	feminine penthemimeral, trithemimeral
ἀλλʼ ἑτάρου περὶ φωτός. ἔολπα δέ τοι σὲ καὶ ἄλλῳ	- uu- uu -u u-u u - u u --	dactylic hexameter	feminine penthemimeral, trithemimeral
ἀμφʼ ἐμεῦ, εἰ τοιόνδε πέλοι ποτέ, δηρίσασθαι.’	- uu - --u u- uu ----	dactylic hexameter	feminine penthemimeral, hepthemimeral, trithemimeral
ἦ ῥα, καὶ ἀρθμηθέντες, ὅπῃ πάρος, ἑδριόωντο.	- u u ---u u- uu -uu--	dactylic hexameter	feminine penthemimeral, hepthemimeral
τὼ δὲ Διὸς βουλῇσιν, ὁ μὲν Μυσοῖσι βαλέσθαι	- u u- --u u - --u u--	dactylic hexameter	feminine penthemimeral, hepthemimeral, trithemimeral
μέλλεν ἐπώνυμον ἄστυ πολισσάμενος ποταμοῖο	-u u-uu -u u-uu- uu--	dactylic hexameter	feminine penthemimeral
Εἰλατίδης Πολύφημος· ὁ δʼ Εὐρυσθῆος ἀέθλους	-uu- uu-u u ---u u--	dactylic hexameter	feminine penthemimeral, trithemimeral
αὖτις ἰὼν πονέεσθαι. ἐπηπείλησε δὲ γαῖαν	-u u- uu-u u---u u --	dactylic hexameter	feminine penthemimeral, trithemimeral
Μυσίδʼ ἀναστήσειν αὐτοσχεδόν, ὁππότε μή οἱ	-u u--- --uu -uu - -	dactylic hexameter	masculine penthemimeral
ἢ ζωοῦ εὕροιεν Ὕλα μόρον, ἠὲ θανόντος.	- -- --u u- uu -u u--	dactylic hexameter	feminine penthemimeral, hepthemimeral, trithemimeral
τοῖο δὲ ῥύσιʼ ὄπασσαν ἀποκρίναντες ἀρίστους	-u u -u u-u u---u u--	dactylic hexameter	feminine penthemimeral
υἱέας ἐκ δήμοιο, καὶ ὅρκια ποιήσαντο,	-uu - --u u -uu ----	dactylic hexameter	feminine penthemimeral, trithemimeral
μήποτε μαστεύοντες ἀπολλήξειν καμάτοιο.	-uu ---u u--- uu--	dactylic hexameter	feminine penthemimeral
τούνεκεν εἰσέτι νῦν περ Ὕλαν ἐρέουσι Κιανοί,	-uu -uu - u u- uu-u u--	dactylic hexameter	masculine penthemimeral, hepthemimeral
κοῦρον Θειοδάμαντος, ἐυκτιμένης τε μέλονται	-- -uu-u u-uu- u u--	dactylic hexameter	feminine penthemimeral
Τρηχῖνος. δὴ γάρ ῥα κατʼ αὐτόθι νάσσατο παῖδας,	--- - - u u -uu -uu --	dactylic hexameter	masculine penthemimeral, trithemimeral
οὕς οἱ ῥύσια κεῖθεν ἐπιπροέηκαν ἄγεσθαι.	- - -uu -u u-uu-u u--	dactylic hexameter	feminine penthemimeral
Νηῦν δὲ πανημερίην ἄνεμος φέρε νυκτί τε πάσῃ	- u u-uu- uu- uu -u u --	dactylic hexameter	masculine penthemimeral, hepthemimeral
λάβρος ἐπιπνείων· ἀτὰρ οὐδʼ ἐπὶ τυτθὸν ἄητο	-u u--- uu - uu -u u--	dactylic hexameter	masculine penthemimeral, hepthemimeral
ἠοῦς τελλομένης, οἱ δὲ χθονὸς εἰσανέχουσαν	-- -uu- - - uu -uu--	dactylic hexameter	masculine penthemimeral, hepthemimeral
ἀκτὴν ἐκ κόλποιο μάλʼ εὐρεῖαν ἐσιδέσθαι	-- - --u u --- uu--	dactylic hexameter	feminine penthemimeral, trithemimeral
φρασσαμενοι, κώπῃσιν ἅμʼ ἠελίῳ ἐπέκελσαν.	-uu- --u u -uu- uu--	dactylic hexameter	feminine penthemimeral, trithemimeral
