ἔνθα δʼ ἔσαν σταθμοί τε βοῶν αὖλίς τʼ Ἀμύκοιο,	-u u- -- u u- -- uu--	dactylic hexameter	masculine penthemimeral, hepthemimeral, trithemimeral
Βεβρύκων βασιλῆος ἀγήνορος, ὅν ποτε νύμφη	--- uu-u u-uu - uu --	dactylic hexameter	feminine penthemimeral, trithemimeral
τίκτε Ποσειδάωνι Γενεθλίῳ εὐνηθεῖσα	-u u---u u-uu ----	dactylic hexameter	feminine penthemimeral
Βιθυνὶς Μελίη, ὑπεροπληέστατον ἀνδρῶν·	--- uu- uu---uu --	dactylic hexameter	masculine penthemimeral, trithemimeral
ὅς τʼ ἐπὶ καὶ ξείνοισιν ἀεικέα θεσμὸν ἔθηκεν,	- uu - --u u-uu -u u--	dactylic hexameter	feminine penthemimeral, trithemimeral
μήτινʼ ἀποστείχειν, πρὶν πειρήσασθαι ἑοῖο	-u u--- - ---u u--	dactylic hexameter	masculine penthemimeral
πυγμαχίης· πολέας δὲ περικτιόνων ἐδάιξεν.	-uu- uu- u u-uu- uu--	dactylic hexameter	masculine penthemimeral, trithemimeral
καὶ δὲ τότε προτὶ νῆα κιών, χρειώ μιν ἐρέσθαι	- u u- uu -u u- -- u u--	dactylic hexameter	feminine penthemimeral, hepthemimeral, trithemimeral
ναυτιλίης, οἵ τʼ εἶεν, ὑπερβασίῃσιν ἄτισσεν,	-uu- - -u u-uu-u u--	dactylic hexameter	feminine penthemimeral, trithemimeral
τοῖον δʼ ἐν πάντεσσι παρασχεδὸν ἔκφατο μῦθον·	-- - --u u-uu -uu --	dactylic hexameter	feminine penthemimeral, trithemimeral
‘Κέκλυθʼ, ἁλίπλαγκτοι, τάπερ ἴδμεναι ὔμμιν ἔοικεν.	-u u--- uu -uu -u u--	dactylic hexameter	masculine penthemimeral
οὔτινα θέσμιόν ἐστιν ἀφορμηθέντα νέεσθαι	-uu -uu -u u---u u--	dactylic hexameter	feminine penthemimeral
ἀνδρῶν ὀθνείων, ὅς κεν Βέβρυξι πελάσσῃ,	-- --- - - --u u--	dactylic hexameter	masculine penthemimeral, hepthemimeral
πρὶν χείρεσσιν ἐμῇσιν ἑὰς ἀνὰ χεῖρας ἀεῖραι.	- --u u-u u- uu -u u--	dactylic hexameter	feminine penthemimeral, hepthemimeral
τῶ καί μοι τὸν ἄριστον ἀποκριδὸν οἶον ὁμίλου	- - - u u-u u-uu -u u--	dactylic hexameter	feminine penthemimeral, trithemimeral
πυγμαχίῃ στήσασθε καταυτόθι δηρινθῆναι.	-uu- --u u-uu ----	dactylic hexameter	feminine penthemimeral, trithemimeral
εἰ δʼ ἂν ἀπηλεγέοντες ἐμὰς πατέοιτε θέμιστας,	- u u-uu-u u- uu-u u--	dactylic hexameter	feminine penthemimeral, hepthemimeral
ἧ κέν τις στυγερῶς κρατερὴ ἐπιέψετʼ ἀνάγκη.’	- - - uu- uu- uu-u u--	dactylic hexameter	masculine penthemimeral, hepthemimeral, trithemimeral
ἦ ῥα μέγα φρονέων· τοὺς δʼ ἄγριος εἰσαΐοντας	- u u- uu- - -uu -uu--	dactylic hexameter	masculine penthemimeral, trithemimeral
εἷλε χόλος· περὶ δʼ αὖ Πολυδεύκεα τύψεν ὁμοκλη	-u u- uu - uu-uu -u u--	dactylic hexameter	masculine penthemimeral, trithemimeral
αἶψα δʼ ἑῶν ἑτάρων πρόμος ἵστατο, φώνησέν τε·	-u u- uu- uu -uu --- -	dactylic hexameter	masculine penthemimeral, trithemimeral
‘ἴσχεο νῦν, μηδʼ ἄμμι κακήν, ὅτις εὔχεαι εἶναι,	-uu - - -u u- uu -uu --	dactylic hexameter	feminine penthemimeral, hepthemimeral, trithemimeral
φαῖνε βίην· θεσμοῖς γὰρ ὑπείξομεν, ὡς ἀγορεύεις.	-u u- -- u u-uu - uu--	dactylic hexameter	masculine penthemimeral, trithemimeral
αὐτὸς ἑκὼν ἤδη τοι ὑπίσχομαι ἀντιάασθαι.’	-u u- -- u u-uu -uu--	dactylic hexameter	masculine penthemimeral, trithemimeral
ὧς φάτʼ ἀπηλεγέως· ὁ δʼ ἐσέδρακεν ὄμμαθʼ ἑλίξας,	- u u-uu- u u-uu -u u--	dactylic hexameter	masculine penthemimeral
ὥστε λέων ὑπʼ ἄκοντι τετυμμένος, ὅν τʼ ἐν ὄρεσσιν	-u u- u u-u u-uu - u u--	dactylic hexameter	feminine penthemimeral, trithemimeral
ἀνέρες ἀμφιπένονται· ὁ δʼ ἰλλόμενός περ ὁμίλῳ	-uu -uu-u u -uu- u u--	dactylic hexameter	feminine penthemimeral
τῶν μὲν ἔτʼ οὐκ ἀλέγει, ἐπὶ δʼ ὄσσεται οἰόθεν οἶον	- u u - uu- uu -uu -uu --	dactylic hexameter	masculine penthemimeral, trithemimeral
ἄνδρα τόν, ὅς μιν ἔτυψε παροίτατος, οὐδʼ ἐδάμασσεν.	-u u - u u-u u-uu - uu--	dactylic hexameter	feminine penthemimeral, trithemimeral
ἔνθʼ ἀπὸ Τυνδαρίδης μὲν ἐύστιπτον θέτο φᾶρος	- uu -uu- u u--- uu --	dactylic hexameter	masculine penthemimeral
λεπταλέον, τό ῥά οἵ τις ἑὸν ξεινήιον εἶναι	-uu- u u - u u- --uu --	dactylic hexameter	masculine penthemimeral, hepthemimeral, trithemimeral
ὤπασε Λημνιάδων· ὁ δʼ ἐρεμνὴν δίπτυχα λώπην	-uu -uu- u u-- -uu --	dactylic hexameter	masculine penthemimeral
αὐτῇσιν περόνῃσι καλαύροπά τε τρηχεῖαν	--- uu-u u-uu - ---	dactylic hexameter	feminine penthemimeral, trithemimeral
κάββαλε, τὴν φορέεσκεν, ὀριτρεφέος κοτίνοιο.	-uu - uu-u u-uu- uu--	dactylic hexameter	feminine penthemimeral, trithemimeral
αὐτίκα δʼ ἐγγύθι χῶρον ἑαδότα παπτήναντες	-uu -uu -u u-uu ----	dactylic hexameter	feminine penthemimeral
ἷζον ἑοὺς δίχα πάντας ἐνὶ ψαμάθοισιν ἑταίρους,	-u u- uu -u u- uu-u u--	dactylic hexameter	feminine penthemimeral, hepthemimeral, trithemimeral
οὐ δέμας, οὐδὲ φυὴν ἐναλίγκιοι εἰσοράασθαι.	- uu -u u- uu-uu -uu--	dactylic hexameter	masculine penthemimeral
ἀλλʼ ὁ μὲν ἢ ὀλοοῖο Τυφωέος, ἠὲ καὶ αὐτῆς	- u u - uu-u u-uu -u u --	dactylic hexameter	feminine penthemimeral, trithemimeral
γαίης εἶναι ἔικτο πέλωρ τέκος, οἷα πάροιθεν	-- -u u-u u- uu -u u--	dactylic hexameter	feminine penthemimeral, hepthemimeral
χωομένη Διὶ τίκτεν· ὁ δʼ οὐρανίῳ ἀτάλαντος	-uu- uu -u u -uu- uu--	dactylic hexameter	feminine penthemimeral, trithemimeral
ἀστέρι Τυνδαρίδης, οὗπερ κάλλισται ἔασιν	-uu -uu- -- --u u--	dactylic hexameter	masculine penthemimeral, hepthemimeral
ἑσπερίην διὰ νύκτα φαεινομένου ἀμαρυγαί.	-uu- uu -u u-uu- uu--	dactylic hexameter	feminine penthemimeral, trithemimeral
τοῖος ἔην Διὸς υἱός, ἔτι χνοάοντας ἰούλους	-u u- uu -u u- uu-u u--	dactylic hexameter	feminine penthemimeral, hepthemimeral, trithemimeral
ἀντέλλων, ἔτι φαιδρὸς ἐν ὄμμασιν. ἀλλά οἱ ἀλκὴ	--- uu -u u -uu -u u --	dactylic hexameter	feminine penthemimeral, trithemimeral
καὶ μένος ἠύτε θηρὸς ἀέξετο· πῆλε δὲ χεῖρας	- uu -uu -u u-uu -u u --	dactylic hexameter	feminine penthemimeral
πειράζων, εἴθʼ ὡς πρὶν ἐυτρόχαλοι φορέονται,	--- - - u u-uu- uu--	dactylic hexameter	masculine penthemimeral, trithemimeral
μηδʼ ἄμυδις καμάτῳ τε καὶ εἰρεσίῃ βαρύθοιεν	- uu- uu- u u -uu- uu--	dactylic hexameter	masculine penthemimeral, trithemimeral
οὐ μὰν αὖτʼ Ἄμυκος πειρήσατο· σῖγα δʼ ἄπωθεν	- - - uu- --uu -u u--	dactylic hexameter	masculine penthemimeral, trithemimeral
ἑστηὼς εἰς αὐτὸν ἔχʼ ὄμματα, καί οἱ ὀρέχθει	--- - -u u -uu - u u--	dactylic hexameter	feminine penthemimeral, trithemimeral
θυμὸς ἐελδομένῳ στηθέων ἐξ αἷμα κεδάσσαι.	-u u-uu- -- - -u u--	dactylic hexameter	masculine penthemimeral, hepthemimeral
τοῖσι δὲ μεσσηγὺς θεράπων Ἀμύκοιο Λυκωρεὺς	-u u --- uu- uu-u u--	dactylic hexameter	masculine penthemimeral, hepthemimeral
θῆκε πάροιθε ποδῶν δοιοὺς ἑκάτερθεν ἱμάντας	-u u-u u- -- uu-u u--	dactylic hexameter	masculine penthemimeral, hepthemimeral
ὠμούς, ἀζαλέους, περὶ δʼ οἵ γʼ ἔσαν ἐσκληῶτες.	-- -uu- uu - uu ----	dactylic hexameter	masculine penthemimeral, hepthemimeral
αὐτὰρ ὁ τόν γʼ ἐπέεσσιν ὑπερφιάλοισι μετηύδα·	-u u - uu-u u-uu-u u--	dactylic hexameter	feminine penthemimeral, trithemimeral
‘τῶνδέ τοι ὅν κʼ ἐθέλῃσθα, πάλου ἄτερ ἐγγυαλίξω	-u u - uu-u u- uu -uu--	dactylic hexameter	feminine penthemimeral, hepthemimeral, trithemimeral
αὐτὸς ἑκών, ἵνα μή μοι ἀτέμβηαι μετόπισθεν.	-u u- uu - u u--- uu--	dactylic hexameter	masculine penthemimeral, trithemimeral
ἀλλὰ βάλευ περὶ χειρί· δαεὶς δέ κεν ἄλλῳ ἐνίσποις,	-u u- uu -u u- u u -u u--	dactylic hexameter	feminine penthemimeral, hepthemimeral, trithemimeral
ὅσσον ἐγὼ ῥινούς τε βοῶν περίειμι ταμέσθαι	-u u- -- u u- uu-u u--	dactylic hexameter	masculine penthemimeral, hepthemimeral, trithemimeral
ἀζαλέας, ἀνδρῶν τε παρηίδας αἵματι φύρσαι.’	-uu- -- u u-uu -uu --	dactylic hexameter	masculine penthemimeral, trithemimeral
ὧς ἔφατʼ· αὐτὰρ ὅ γʼ οὔτι παραβλήδην ἐρίδηνεν.	- uu -u u -u u--- uu--	dactylic hexameter	feminine penthemimeral
ἦκα δὲ μειδήσας, οἵ οἱ παρὰ ποσσὶν ἔκειντο,	-u u --- - - uu -u u--	dactylic hexameter	masculine penthemimeral, hepthemimeral
τοὺς ἕλεν ἀπροφάτως· τοῦ δʼ ἀντίος ἤλυθε Κάστωρ	- uu -uu- - -uu -uu --	dactylic hexameter	masculine penthemimeral
ἠδὲ Βιαντιάδης Ταλαὸς μέγας· ὦκα δʼ ἱμάντας	-u u-uu- uu- uu -u u--	dactylic hexameter	masculine penthemimeral, hepthemimeral
ἀμφέδεον, μάλα πολλὰ παρηγορέοντες ἐς ἀλκήν.	-uu- uu -u u-uu-u u --	dactylic hexameter	feminine penthemimeral, trithemimeral
τῷ δʼ αὖτʼ Ἄρητός τε καὶ Ὄρνυτος, οὐδέ τι ᾔδειν	- - --- u u -uu -u u --	dactylic hexameter	masculine penthemimeral
νήπιοι ὕστατα κεῖνα κακῇ δήσαντες ἐν αἴσῃ.	-uu -uu -u u- --u u --	dactylic hexameter	feminine penthemimeral, hepthemimeral
οἱ δʼ ἐπεὶ οὖν ἱμᾶσι διασταδὸν ἠρτύναντο,	- uu - --u u-uu ----	dactylic hexameter	feminine penthemimeral, trithemimeral
αὐτίκʼ ἀνασχόμενοι ῥεθέων προπάροιθε βαρείας	-u u-uu- uu- uu-u u--	dactylic hexameter	masculine penthemimeral, hepthemimeral
χεῖρας, ἐπʼ ἀλλήλοισι μένος φέρον ἀντιόωντες.	-u u ---u u- uu -uu--	dactylic hexameter	feminine penthemimeral, hepthemimeral
ἔνθα δὲ Βεβρύκων μὲν ἄναξ, ἅ τε κῦμα θαλάσσης	-u u --- u u- u u -u u--	dactylic hexameter	masculine penthemimeral, hepthemimeral
τρηχὺ θοὴν ἐπὶ νῆα κορύσσεται, ἡ δʼ ὑπὸ τυτθὸν	-u u- uu -u u-uu - uu --	dactylic hexameter	feminine penthemimeral, trithemimeral
ἰδρείῃ πυκινοῖο κυβερνητῆρος ἀλύσκει,	--- uu-u u---u u--	dactylic hexameter	feminine penthemimeral, trithemimeral
ἱεμένου φορέεσθαι ἔσω τοίχοιο κλύδωνος,	-uu- uu-u u- --u u--	dactylic hexameter	feminine penthemimeral, hepthemimeral, trithemimeral
ὧς ὅγε Τυνδαρίδην φοβέων ἕπετʼ, οὐδέ μιν εἴα	- uu -uu- uu- uu -u u --	dactylic hexameter	masculine penthemimeral, hepthemimeral
δηθύνειν. ὁ δʼ ἄρʼ αἰὲν ἀνούτατος ἣν διὰ μῆτιν	--- u u -u u-uu - uu --	dactylic hexameter	feminine penthemimeral, trithemimeral
ἀίσσοντʼ ἀλέεινεν· ἀπηνέα δʼ αἶψα νοήσας	--- uu-u u-uu -u u--	dactylic hexameter	feminine penthemimeral, trithemimeral
πυγμαχίην, ᾗ κάρτος ἀάατος, ᾗ τε χερείων,	-uu- - -u u-uu - u u--	dactylic hexameter	feminine penthemimeral, trithemimeral
στῆ ῥʼ ἄμοτον καὶ χερσὶν ἐναντία χεῖρας ἔμιξεν.	- uu- - -u u-uu -u u--	dactylic hexameter	feminine penthemimeral, trithemimeral
ὡς δʼ ὅτε νήια δοῦρα θοοῖς ἀντίξοα γόμφοις	- uu -uu -u u- --uu --	dactylic hexameter	feminine penthemimeral, hepthemimeral
ἀνέρες ὑληουργοὶ ἐπιβλήδην ἐλάοντες	-uu ---u u--- uu--	dactylic hexameter	feminine penthemimeral
θείνωσι σφύρῃσιν, ἐπʼ ἄλλῳ δʼ ἄλλος ἄηται	--- --u u -- -u u--	dactylic hexameter	feminine penthemimeral, trithemimeral
δοῦπος ἄδην· ὧς τοῖσι παρήιά τʼ ἀμφοτέρωθεν	-u u- - -u u-uu -uu--	dactylic hexameter	feminine penthemimeral, trithemimeral
καὶ γένυες κτύπεον· βρυχὴ δʼ ὑπετέλλετʼ ὀδόντων	- uu- uu- -- uu-u u--	dactylic hexameter	masculine penthemimeral, hepthemimeral, trithemimeral
ἄσπετος, οὐδʼ ἔλληξαν ἐπισταδὸν οὐτάζοντες,	-uu - --u u-uu ----	dactylic hexameter	feminine penthemimeral, trithemimeral
ἔστε περ οὐλοὸν ἆσθμα καὶ ἀμφοτέρους ἐδάμασσεν.	-u u -uu -u u -uu- uu--	dactylic hexameter	feminine penthemimeral
στάντε δὲ βαιὸν ἄπωθεν ἀπωμόρξαντο μετώπων	-u u -u u-u u---u u--	dactylic hexameter	feminine penthemimeral
ἱδρῶ ἅλις, καματηρὸν ἀυτμένα φυσιόωντε.	-u u- uu-u u-uu -uu--	dactylic hexameter	feminine penthemimeral, trithemimeral
ἂψ δʼ αὖτις συνόρουσαν ἐναντίοι, ἠύτε ταύρω	- -- uu-u u-uu -uu --	dactylic hexameter	feminine penthemimeral, trithemimeral
φορβάδος ἀμφὶ βοὸς κεκοτηότε δηριάασθον.	-uu -u u- uu-uu -uu--	dactylic hexameter	masculine penthemimeral
ἔνθα δʼ ἔπειτʼ Ἄμυκος μὲν ἐπʼ ἀκροτάτοισιν ἀερθείς,	-u u- uu- u u -uu-u u--	dactylic hexameter	masculine penthemimeral, trithemimeral
βουτύπος οἷα, πόδεσσι τανύσσατο, κὰδ δὲ βαρεῖαν	-uu -u u-u u-uu - u u--	dactylic hexameter	feminine penthemimeral
χεῖρʼ ἐπὶ οἷ πελέμιξεν· ὁ δʼ ἀίξαντος ὑπέστη,	- uu - uu-u u ---u u--	dactylic hexameter	feminine penthemimeral, trithemimeral
κρᾶτα παρακλίνας, ὤμῳ δʼ ἀνεδέξατο πῆχυν	-u u-uu -- ---uu --	dactylic hexameter	
τυτθόν· ὁ δʼ ἄγχʼ αὐτοῖο παρὲκ γόνυ γουνὸς ἀμείβων	-u u - --u u- uu -u u--	dactylic hexameter	feminine penthemimeral, hepthemimeral, trithemimeral
κόψε μεταΐγδην ὑπὲρ οὔατος, ὀστέα δʼ εἴσω	-u u--- uu -uu -uu --	dactylic hexameter	masculine penthemimeral
ῥῆξεν· ὁ δʼ ἀμφʼ ὀδύνῃ γνὺξ ἤριπεν· οἱ δʼ ἰάχησαν	-u u - uu- - -uu - uu--	dactylic hexameter	masculine penthemimeral, trithemimeral
ἥρωες Μινύαι· τοῦ δʼ ἀθρόος ἔκχυτο θυμός.	--- uu- - -uu -uu --	dactylic hexameter	masculine penthemimeral, trithemimeral
οὐδʼ ἄρα Βέβρυκες ἄνδρες ἀφείδησαν βασιλῆος·	- uu -uu -u u--- uu--	dactylic hexameter	feminine penthemimeral
ἀλλʼ ἄμυδις κορύνας ἀζηχέας ἠδὲ σιγύννους	- uu- uu- --uu -u u--	dactylic hexameter	masculine penthemimeral, trithemimeral
ἰθὺς ἀνασχόμενοι Πολυδεύκεος ἀντιάασκον.	-u u-uu- uu-uu -uu--	dactylic hexameter	masculine penthemimeral
τοῦ δὲ πάρος κολεῶν εὐήκεα φάσγανʼ ἑταῖροι	- u u- uu- --uu -u u--	dactylic hexameter	masculine penthemimeral, trithemimeral
ἔσταν ἐρυσσάμενοι. πρῶτός γε μὲν ἀνέρα Κάστωρ	-u u-uu- -- u u -uu --	dactylic hexameter	masculine penthemimeral, hepthemimeral
ἤλασʼ ἐπεσσύμενον κεφαλῆς ὕπερ· ἡ δʼ ἑκάτερθεν	-u u-uu- uu- uu - uu--	dactylic hexameter	masculine penthemimeral, hepthemimeral
ἔνθα καὶ ἔνθʼ ὤμοισιν ἐπʼ ἀμφοτέροις ἐκεάσθη.	-u u - --u u -uu- uu--	dactylic hexameter	feminine penthemimeral, trithemimeral
αὐτὸς δʼ Ἰτυμονῆα πελώριον ἠδὲ Μίμαντα,	-- -uu-u u-uu -u u--	dactylic hexameter	feminine penthemimeral
τὸν μὲν ὑπὸ στέρνοιο θοῷ ποδὶ λὰξ ἐπορούσας	- u u- --u u- uu - uu--	dactylic hexameter	feminine penthemimeral, hepthemimeral, trithemimeral
πλῆξε, καὶ ἐν κονίῃσι βάλεν· τοῦ δʼ ἆσσον ἰόντος	-u u - uu-u u- - -u u--	dactylic hexameter	feminine penthemimeral, hepthemimeral, trithemimeral
δεξιτερῇ σκαιῆς ὑπὲρ ὀφρύος ἤλασε χειρί,	-uu- -- uu -uu -uu --	dactylic hexameter	masculine penthemimeral, trithemimeral
δρύψε δέ οἱ βλέφαρον, γυμνὴ δʼ ὑπελείπετʼ ὀπωπή.	-u u - uu- -- uu-u u--	dactylic hexameter	masculine penthemimeral, hepthemimeral, trithemimeral
Ὠρεΐδης δʼ Ἀμύκοιο βίην ὑπέροπλος ὀπάων	-uu- uu-u u- uu-u u--	dactylic hexameter	feminine penthemimeral, hepthemimeral, trithemimeral
οὖτα Βιαντιάδαο κατὰ λαπάρην Ταλαοῖο,	-u u-uu-u u- uu- uu--	dactylic hexameter	feminine penthemimeral, hepthemimeral
ἀλλά μιν οὐ κατέπεφνεν, ὅσον δʼ ἐπὶ δέρματι μοῦνον	-u u - uu-u u- uu -uu --	dactylic hexameter	feminine penthemimeral, hepthemimeral, trithemimeral
νηδυίων ἄψαυστος ὑπὸ ζώνην θόρε χαλκός.	--- --u u- -- uu --	dactylic hexameter	feminine penthemimeral, hepthemimeral, trithemimeral
αὔτως δʼ Ἄρητος μενεδήιον Εὐρύτου υἷα	-- --- uu-uu -uu --	dactylic hexameter	masculine penthemimeral
Ἴφιτον ἀζαλέῃ κορύνῃ στυφέλιξεν ἐλάσσας,	-uu -uu- uu- uu-u u--	dactylic hexameter	masculine penthemimeral, hepthemimeral
οὔπω κηρὶ κακῇ πεπρωμένον· ἦ τάχʼ ἔμελλεν	-- -u u- --uu - u u--	dactylic hexameter	masculine penthemimeral
αὐτὸς δῃώσεσθαι ὑπὸ ξίφεϊ Κλυτίοιο.	-- ---u u- uu- uu--	dactylic hexameter	feminine penthemimeral, hepthemimeral
καὶ τότʼ ἄρʼ Ἀγκαῖος Λυκοόργοιο θρασὺς υἱὸς	- u u --- uu--- uu --	dactylic hexameter	masculine penthemimeral
αἶψα μάλʼ ἀντεταγὼν πέλεκυν μέγαν ἠδὲ κελαινὸν	-u u -uu- uu- uu -u u--	dactylic hexameter	masculine penthemimeral, hepthemimeral
ἄρκτου προσχόμενος σκαιῇ δέρος ἔνθορε μέσσῳ	-- -uu- -- uu -uu --	dactylic hexameter	masculine penthemimeral, hepthemimeral
ἐμμεμαὼς Βέβρυξιν· ὁμοῦ δέ οἱ ἐσσεύοντο	-uu- --u u- u u ----	dactylic hexameter	feminine penthemimeral, hepthemimeral, trithemimeral
Αἰακίδαι, σὺν δέ σφιν ἀρήιος ὤρνυτʼ Ἰήσων.	-uu- - - u u-uu -u u--	dactylic hexameter	masculine penthemimeral, trithemimeral
ὡς δʼ ὅτʼ ἐνὶ σταθμοῖσιν ἀπείρονα μῆλʼ ἐφόβησαν	- u u- --u u-uu - uu--	dactylic hexameter	feminine penthemimeral, trithemimeral
ἤματι χειμερίῳ πολιοὶ λύκοι ὁρμηθέντες	-uu -uu- uu- uu ----	dactylic hexameter	masculine penthemimeral, hepthemimeral
λάθρῃ ἐυρρίνων τε κυνῶν αὐτῶν τε νομήων,	-u u--- u u- -- u u--	dactylic hexameter	masculine penthemimeral, hepthemimeral
μαίονται δʼ ὅ τι πρῶτον ἐπαΐξαντες ἕλωσιν,	--- u u -u u---u u--	dactylic hexameter	feminine penthemimeral, trithemimeral
πόλλʼ ἐπιπαμφαλόωντες ὁμοῦ· τὰ δὲ πάντοθεν αὔτως	- uu-uu-u u- u u -uu --	dactylic hexameter	feminine penthemimeral, hepthemimeral
στείνονται πίπτοντα περὶ σφίσιν· ὧς ἄρα τοίγε	--- --u u- uu - uu --	dactylic hexameter	feminine penthemimeral, hepthemimeral, trithemimeral
λευγαλέως Βέβρυκας ὑπερφιάλους ἐφόβησαν.	-uu- --u u-uu- uu--	dactylic hexameter	feminine penthemimeral, trithemimeral
ὡς δὲ μελισσάων σμῆνος μέγα μηλοβοτῆρες	- u u--- -- uu -uu--	dactylic hexameter	masculine penthemimeral, hepthemimeral
ἠὲ μελισσοκόμοι πέτρῃ ἔνι καπνιόωσιν,	-u u-uu- -- uu -uu--	dactylic hexameter	masculine penthemimeral, hepthemimeral
αἱ δʼ ἤτοι τείως μὲν ἀολλέες ᾧ ἐνὶ σίμβλῳ	- -- -- u u-uu - uu --	dactylic hexameter	masculine penthemimeral, trithemimeral
βομβηδὸν κλονέονται, ἐπιπρὸ δὲ λιγνυόεντι	--- uu-u u-u u -uu--	dactylic hexameter	feminine penthemimeral, trithemimeral
καπνῷ τυφόμεναι πέτρης ἑκὰς ἀίσσουσιν·	-- -uu- -- uu ----	dactylic hexameter	masculine penthemimeral, hepthemimeral
ὧς οἵ γʼ οὐκέτι δὴν μένον ἔμπεδον, ἀλλʼ ἐκέδασθεν	- - -uu - uu -uu - uu--	dactylic hexameter	masculine penthemimeral
εἴσω Βεβρυκίης, Ἀμύκου μόρον ἀγγελέοντες·	-- -uu- uu- uu -uu--	dactylic hexameter	masculine penthemimeral, hepthemimeral
νήπιοι, οὐδʼ ἐνόησαν ὃ δή σφισιν ἐγγύθεν ἄλλο	-uu - uu-u u - uu -uu --	dactylic hexameter	feminine penthemimeral, hepthemimeral, trithemimeral
πῆμʼ ἀίδηλον ἔην. πέρθοντο γὰρ ἠμὲν ἀλωαὶ	- uu-u u- --u u -u u--	dactylic hexameter	masculine penthemimeral
ἠδʼ οἶαι τῆμος δῄῳ ὑπὸ δουρὶ Λύκοιο	- -- -- -- uu -u u--	dactylic hexameter	masculine penthemimeral, hepthemimeral, trithemimeral
καὶ Μαριανδυνῶν ἀνδρῶν, ἀπεόντος ἄνακτος.	- uu--- -- uu-u u--	dactylic hexameter	masculine penthemimeral, hepthemimeral
αἰεὶ γὰρ μάρναντο σιδηροφόρου περὶ γαίης.	-- - --u u-uu- uu --	dactylic hexameter	feminine penthemimeral, trithemimeral
οἱ δʼ ἤδη σταθμούς τε καὶ αὔλια δηιάασκον·	- -- -- u u -uu -uu--	dactylic hexameter	masculine penthemimeral, trithemimeral
ἤδη δʼ ἄσπετα μῆλα περιτροπάδην ἐτάμοντο	-- -uu -u u-uu- uu--	dactylic hexameter	feminine penthemimeral
ἥρωες, καὶ δή τις ἔπος μετὰ τοῖσιν ἔειπεν·	--- - - u u- uu -u u--	dactylic hexameter	masculine penthemimeral, hepthemimeral, trithemimeral
‘Φράζεσθʼ ὅττι κεν ᾗσιν ἀναλκείῃσιν ἔρεξαν,	-- -u u -u u---u u--	dactylic hexameter	feminine penthemimeral
εἴ πως Ἡρακλῆα θεὸς καὶ δεῦρʼ ἐκόμισσε??.	- - ---u u- - - uu--	dactylic hexameter	feminine penthemimeral, hepthemimeral
ἤτοι μὲν γὰρ ἐγὼ κείνου παρεόντος ἔολπα	-- - u u- -- uu-u u--	dactylic hexameter	masculine penthemimeral, hepthemimeral, trithemimeral
οὐδʼ ἂν πυγμαχίῃ κρινθήμεναι· ἀλλʼ ὅτε θεσμοὺς	- - -uu- --uu - uu --	dactylic hexameter	masculine penthemimeral
ἤλυθεν ἐξερέων, αὐτοῖς ἄφαρ οἷς ἀγόρευεν	-uu -uu- -- uu - uu--	dactylic hexameter	masculine penthemimeral, hepthemimeral
θεσμοῖσιν ῥοπάλῳ μιν ἀγηνορίης λελαθέσθαι.	--- uu- u u-uu- uu--	dactylic hexameter	masculine penthemimeral, trithemimeral
ναὶ μὲν ἀκήδεστον γαίῃ ἔνι τόνγε λιπόντες	- u u--- -- uu -u u--	dactylic hexameter	masculine penthemimeral, hepthemimeral
πόντον ἐπέπλωμεν· μάλα δʼ ἡμέων αὐτὸς ἕκαστος	-u u--- uu -- -u u--	dactylic hexameter	masculine penthemimeral
εἴσεται οὐλομένην ἄτην, ἀπάνευθεν ἐόντος.’	-uu -uu- -- uu-u u--	dactylic hexameter	masculine penthemimeral, hepthemimeral
ὧς ἄρʼ ἔφη· τὰ δὲ πάντα Διὸς βουλῇς ἐτέτυκτο.	- u u- u u -u u- -- uu--	dactylic hexameter	feminine penthemimeral, hepthemimeral, trithemimeral
καὶ τότε μὲν μένον αὖθι διὰ κνέφας, ἕλκεά τʼ ἀνδρῶν	- uu - uu -u u- uu -uu --	dactylic hexameter	feminine penthemimeral, hepthemimeral, trithemimeral
οὐταμένων ἀκέοντο, καὶ ἀθανάτοισι θυηλὰς	-uu- uu-u u -uu-u u--	dactylic hexameter	feminine penthemimeral, trithemimeral
ῥέξαντες μέγα δόρπον ἐφώπλισαν· οὐδέ τινʼ ὕπνος	--- uu -u u-uu -u u --	dactylic hexameter	feminine penthemimeral, trithemimeral
εἷλε παρὰ κρητῆρι καὶ αἰθομένοις ἱεροῖσιν.	-u u- --u u -uu- uu--	dactylic hexameter	feminine penthemimeral, trithemimeral
ξανθὰ δʼ ἐρεψάμενοι δάφνῃ καθύπερθε μέτωπα	-u u-uu- -- uu-u u--	dactylic hexameter	masculine penthemimeral, hepthemimeral
ἀγχιάλῳ, τῇ, ἀκτῇ ἔπι, πρυμνήσιʼ ἀνῆπτο,	-uu- - -u u- --u u--	dactylic hexameter	feminine penthemimeral, hepthemimeral, trithemimeral
Ὀρφείῃ φόρμιγγι συνοίμιον ὕμνον ἄειδον	--- --u u-uu -u u--	dactylic hexameter	feminine penthemimeral, trithemimeral
ἐμμελέως· περὶ δέ σφιν ἰαίνετο νήνεμος ἀκτὴ	-uu- uu - u u-uu -uu --	dactylic hexameter	masculine penthemimeral, trithemimeral
μελπομένοις· κλεῖον δὲ Θεραπναῖον Διὸς υἷα.	-uu- -- u u--- uu --	dactylic hexameter	masculine penthemimeral, trithemimeral
ἦμος δʼ ἠέλιος δροσερὰς ἐπέλαμψε κολώνας	-- -uu- uu- uu-u u--	dactylic hexameter	masculine penthemimeral, hepthemimeral
ἐκ περάτων ἀνιών, ἤγειρε δὲ μηλοβοτῆρας,	- uu- uu- --u u -uu--	dactylic hexameter	masculine penthemimeral, trithemimeral
δὴ τότε λυσάμενοι νεάτης ἐκ πείσματα δάφνης,	- uu -uu- uu- - -uu --	dactylic hexameter	masculine penthemimeral, hepthemimeral
ληίδα τʼ εἰσβήσαντες ὅσην χρεὼ ἦεν ἄγεσθαι,	-uu ---u u- uu -u u--	dactylic hexameter	feminine penthemimeral, hepthemimeral
πνοιῇ δινήεντʼ ἀνὰ Βόσπορον ἰθύνοντο.	-- --- uu -uu ----	dactylic hexameter	masculine penthemimeral
ἔνθα μὲν ἠλιβάτῳ ἐναλίγκιον οὔρεϊ κῦμα	-u u -uu- uu-uu -uu --	dactylic hexameter	masculine penthemimeral
ἀμφέρεται προπάροιθεν ἐπαΐσσοντι ἐοικός,	-uu- uu-u u---u u--	dactylic hexameter	feminine penthemimeral, trithemimeral
αἰὲν ὑπὲρ νεφέων ἠερμένον· οὐδέ κε φαίης	-u u- uu- --uu -u u --	dactylic hexameter	masculine penthemimeral, trithemimeral
φεύξεσθαι κακὸν οἶτον, ἐπεὶ μάλα μεσσόθι νηὸς	--- uu -u u- uu -uu --	dactylic hexameter	feminine penthemimeral, hepthemimeral, trithemimeral
λάβρον ἐπικρέμαται, καθάπερ νέφος. ἀλλὰ τό γʼ ἔμπης	-u u-uu- uu- uu -u u --	dactylic hexameter	masculine penthemimeral, hepthemimeral
στόρνυται, εἴ κʼ ἐσθλοῖο κυβερνητῆρος ἐπαύρῃ.	-uu - --u u---u u--	dactylic hexameter	feminine penthemimeral, trithemimeral
τῶ καὶ Τίφυος οἵδε δαημοσύνῃσι νέοντο,	- - -uu -u u-uu-u u--	dactylic hexameter	feminine penthemimeral
ἀσκηθεῖς μέν, ἀτὰρ πεφοβημένοι. ἤματι δʼ ἄλλῳ	--- u u- uu-uu -uu --	dactylic hexameter	masculine penthemimeral, trithemimeral
ἀντιπέρην γαίῃ Βιθυνίδι πείσματʼ ἀνῆψαν.	-uu- -- --uu -u u--	dactylic hexameter	masculine penthemimeral, trithemimeral
ἔνθα δʼ ἐπάκτιον οἶκον Ἀγηνορίδης ἔχε Φινεύς,	-u u-uu -u u-uu- uu --	dactylic hexameter	feminine penthemimeral
ὃς περὶ δὴ πάντων ὀλοώτατα πήματʼ ἀνέτλη	- uu - -- uu-uu -u u--	dactylic hexameter	masculine penthemimeral, trithemimeral
εἵνεκα μαντοσύνης, τήν οἱ πάρος ἐγγυάλιξεν	-uu -uu- - - uu -uu--	dactylic hexameter	masculine penthemimeral, hepthemimeral
Λητοΐδης· οὐδʼ ὅσσον ὀπίζετο καὶ Διὸς αὐτοῦ	-uu- - -u u-uu - uu --	dactylic hexameter	feminine penthemimeral, trithemimeral
χρείων ἀτρεκέως ἱερὸν νόον ἀνθρώποισιν.	-- -uu- uu- uu ----	dactylic hexameter	masculine penthemimeral, hepthemimeral
τῶ καί οἱ γῆρας μὲν ἐπὶ δηναιὸν ἴαλλεν,	- - - -- u u- --u u--	dactylic hexameter	masculine penthemimeral, hepthemimeral, trithemimeral
ἐκ δʼ ἕλετʼ ὀφθαλμῶν γλυκερὸν φάος· οὐδὲ γάνυσθαι	- uu --- uu- uu -u u--	dactylic hexameter	masculine penthemimeral, hepthemimeral
εἴα ἀπειρεσίοισιν ὀνείασιν, ὅσσα οἱ αἰεὶ	-u u-uu-u u-uu -u u --	dactylic hexameter	feminine penthemimeral
θέσφατα πευθόμενοι περιναιέται οἴκαδʼ ἄγειρον.	-uu -uu- uu-uu -u u--	dactylic hexameter	masculine penthemimeral
ἀλλὰ διὰ νεφέων ἄφνω πέλας ἀίσσουσαι	-u u- uu- -- uu ----	dactylic hexameter	masculine penthemimeral, hepthemimeral, trithemimeral
ἅρπυιαι στόματος χειρῶν τʼ ἀπὸ γαμφηλῇσιν	--- uu- -- uu ----	dactylic hexameter	masculine penthemimeral, hepthemimeral, trithemimeral
συνεχέως ἥρπαζον. ἐλείπετο δʼ ἄλλοτε φορβῆς	-uu- --u u-uu -uu --	dactylic hexameter	feminine penthemimeral, trithemimeral
οὐδʼ ὅσον, ἄλλοτε τυτθόν, ἵνα ζώων ἀκάχοιτο.	- uu -uu -u u- -- uu--	dactylic hexameter	feminine penthemimeral, hepthemimeral
καὶ δʼ ἐπὶ μυδαλέην ὀδμὴν χέον· οὐδέ τις ἔτλη	- uu -uu- -- uu -u u --	dactylic hexameter	masculine penthemimeral, hepthemimeral
μὴ καὶ λευκανίηνδε φορεύμενος, ἀλλʼ ἀποτηλοῦ	- - -uu-u u-uu - uu--	dactylic hexameter	feminine penthemimeral
ἑστηώς· τοῖόν οἱ ἀπέπνεε λείψανα δαιτός.	--- -- u u-uu -uu --	dactylic hexameter	masculine penthemimeral, trithemimeral
αὐτίκα δʼ εἰσαΐων ἐνοπὴν καὶ δοῦπον ὁμίλου	-uu -uu- uu- - -u u--	dactylic hexameter	masculine penthemimeral, hepthemimeral
τούσδʼ αὐτοὺς παριόντας ἐπήισεν, ὧν οἱ ἰόντων	- -- uu-u u-uu - u u--	dactylic hexameter	feminine penthemimeral, trithemimeral
θέσφατον ἐκ Διὸς ἦεν ἑῆς ἀπόνασθαι ἐδωδῆς.	-uu - uu -u u- uu-u u--	dactylic hexameter	feminine penthemimeral, hepthemimeral, trithemimeral
ὀρθωθεὶς δʼ εὐνῆθεν, ἀκήριον ἠύτʼ ὄνειρον,	--- --u u-uu -u u--	dactylic hexameter	feminine penthemimeral, trithemimeral
βάκτρῳ σκηπτόμενος ῥικνοῖς ποσὶν ᾖε θύραζε,	-- -uu- -- uu -u u--	dactylic hexameter	masculine penthemimeral, hepthemimeral
τοίχους ἀμφαφόων· τρέμε δʼ ἅψεα νισσομένοιο	-- -uu- uu -uu -uu--	dactylic hexameter	masculine penthemimeral
ἀδρανίῃ γήραι τε· πίνῳ δέ οἱ αὐσταλέος χρὼς	-uu- -- u u- u u -uu- -	dactylic hexameter	masculine penthemimeral, hepthemimeral, trithemimeral
ἐσκλήκει, ῥινοὶ δὲ σὺν ὀστέα μοῦνον ἔεργον.	--- -- u u -uu -u u--	dactylic hexameter	masculine penthemimeral, trithemimeral
ἐκ δʼ ἐλθὼν μεγάροιο καθέζετο γοῦνα βαρυνθεὶς	- -- uu-u u-uu -u u--	dactylic hexameter	feminine penthemimeral, trithemimeral
οὐδοῦ ἐπʼ αὐλείοιο· κάρος δέ μιν ἀμφεκάλυψεν	-u u ---u u- u u -uu--	dactylic hexameter	feminine penthemimeral, hepthemimeral
πορφύρεος, γαῖαν δὲ πέριξ ἐδόκησε φέρεσθαι	-uu- -- u u- uu-u u--	dactylic hexameter	masculine penthemimeral, hepthemimeral, trithemimeral
νειόθεν, ἀβληχρῷ δʼ ἐπὶ κώματι κέκλιτʼ ἄναυδος.	-uu --- uu -uu -u u--	dactylic hexameter	masculine penthemimeral
οἱ δέ μιν ὡς εἴδοντο, περισταδὸν ἠγερέθοντο	- u u - --u u-uu -uu--	dactylic hexameter	feminine penthemimeral, trithemimeral
καὶ τάφον. αὐτὰρ ὁ τοῖσι μάλα μόλις ἐξ ὑπάτοιο	- uu -u u -u u- uu - uu--	dactylic hexameter	feminine penthemimeral, hepthemimeral
στήθεος ἀμπνεύσας μετεφώνεε μαντοσύνῃσιν·	-uu --- uu-uu -uu--	dactylic hexameter	masculine penthemimeral
‘κλῦτε, Πανελλήνων προφερέστατοι, εἰ ἐτεὸν δὴ	-u u--- uu-uu - uu- -	dactylic hexameter	masculine penthemimeral
οἵδʼ ὑμεῖς, οὓς δή κρυερῇ βασιλῆος ἐφετμῇ	- -- - - uu- uu-u u--	dactylic hexameter	masculine penthemimeral, hepthemimeral, trithemimeral
Ἁργῴης ἐπὶ νηὸς ἄγει μετὰ κῶας Ἰήσων.	--- uu -u u- uu -u u--	dactylic hexameter	feminine penthemimeral, hepthemimeral, trithemimeral
ὑμεῖς ἀτρεκέως. ἔτι μοι νόος οἶδεν ἕκαστα	-- -uu- uu - uu -u u--	dactylic hexameter	masculine penthemimeral, hepthemimeral
ᾗσι θεοπροπίῃσι. χάριν νύ τοι, ὦ ἄνα Λητοῦς	-u u-uu-u u- u u - uu --	dactylic hexameter	feminine penthemimeral, hepthemimeral
υἱέ, καὶ ἀργαλέοισιν ἀνάπτομαι ἐν καμάτοισιν.	-u u -uu-u u-uu - uu--	dactylic hexameter	feminine penthemimeral
Ἱκεσίου πρὸς Ζηνός, ὅτις ῥίγιστος ἀλιτροῖς	-uu- - -u u- --u u--	dactylic hexameter	feminine penthemimeral, hepthemimeral, trithemimeral
ἀνδράσι, Φοίβου τʼ ἀμφὶ καὶ αὐτῆς εἵνεκεν Ἥρης	-uu -- -u u -- -uu --	dactylic hexameter	feminine penthemimeral
λίσσομαι, ᾗ περίαλλα θεῶν μέμβλεσθε κιόντες,	-uu - uu-u u- --u u--	dactylic hexameter	feminine penthemimeral, hepthemimeral, trithemimeral
χραίσμετέ μοι, ῥύσασθε δυσάμμορον ἀνέρα λύμης,	-uu - --u u-uu -uu --	dactylic hexameter	feminine penthemimeral, trithemimeral
μηδέ μ᾽ἀκηδείῃσιν ἀφορμήθητε λιπόντες	-u u---u u---u u--	dactylic hexameter	feminine penthemimeral
αὔτως. οὐ γὰρ μοῦνον ἐπʼ ὀφθαλμοῖσιν Ἐρινὺς	-- - - -u u ---u u--	dactylic hexameter	feminine penthemimeral, trithemimeral
λὰξ ἐπέβη, καὶ γῆρας ἀμήρυτον ἐς τέλος ἕλκω·	- uu- - -u u-uu - uu --	dactylic hexameter	feminine penthemimeral, trithemimeral
πρὸς δʼ ἔτι πικρότατον κρέμαται κακὸν ἄλλο κακοῖσιν.	- uu -uu- uu- uu -u u--	dactylic hexameter	masculine penthemimeral, hepthemimeral
ἅρπυιαι στόματός μοι ἀφαρπάζουσιν ἐδωδὴν	--- uu- u u---u u--	dactylic hexameter	masculine penthemimeral, trithemimeral
ἔκποθεν ἀφράστοιο καταΐσσουσαι ὄλεθροι.	-uu ---u u---u u--	dactylic hexameter	feminine penthemimeral
ἴσχω δʼ οὔτινα μῆτιν ἐπίρροθον. ἀλλά κε ῥεῖα	-- -uu -u u-uu -u u --	dactylic hexameter	feminine penthemimeral
αὐτὸς ἑὸν λελάθοιμι νόον δόρποιο μεμηλώς,	-u u- uu-u u- --u u--	dactylic hexameter	feminine penthemimeral, hepthemimeral, trithemimeral
ἢ κείνας· ὧδʼ αἶψα διηέριαι ποτέονται.	- -- - -u u-uu- uu--	dactylic hexameter	feminine penthemimeral, trithemimeral
τυτθὸν δʼ ἢν ἄρα δήποτʼ ἐδητύος ἄμμι λίπωσιν,	-- - uu -u u-uu -u u--	dactylic hexameter	feminine penthemimeral, trithemimeral
πνεῖ τόδε μυδαλέον τε καὶ οὐ τλητὸν μένος ὀδμῆς·	- uu -uu- u u - -- uu --	dactylic hexameter	masculine penthemimeral, hepthemimeral
οὔ κέ τις οὐδὲ μίνυνθα βροτῶν ἄνσχοιτο πελάσσας,	- u u -u u-u u- --u u--	dactylic hexameter	feminine penthemimeral, hepthemimeral
οὐδʼ εἴ οἱ ἀδάμαντος ἐληλάμενον κέαρ εἴη.	- - - uu-u u-uu- uu --	dactylic hexameter	feminine penthemimeral, trithemimeral
ἀλλά με πικρὴ δῆτα καὶ ἄατος ἴσχει ἀνάγκη	-u u -- -u u -uu -u u--	dactylic hexameter	feminine penthemimeral
μίμνειν καὶ μίμνοντα κακῇ ἐνὶ γαστέρι θέσθαι.	-- - --u u- uu -uu --	dactylic hexameter	feminine penthemimeral, hepthemimeral, trithemimeral
τὰς μὲν θέσφατόν ἐστιν ἐρητῦσαι Βορέαο	- - -uu -u u--- uu--	dactylic hexameter	feminine penthemimeral
υἱέας. οὐδʼ ὀθνεῖοι ἀλαλκήσουσιν ἐόντες,	-uu - --u u---u u--	dactylic hexameter	feminine penthemimeral, trithemimeral
εἰ δὴ ἐγὼν ὁ πρίν ποτʼ ἐπικλυτὸς ἀνδράσι Φινεὺς	- u u- - - u u-uu -uu --	dactylic hexameter	masculine penthemimeral, trithemimeral
ὄλβῳ μαντοσύνῃ τε, πατὴρ δέ με γείνατʼ Ἀγήνωρ·	-- -uu- u u- u u -u u--	dactylic hexameter	masculine penthemimeral, hepthemimeral
τῶν δὲ κασιγνήτην, ὅτʼ ἐνὶ Θρῄκεσσιν ἄνασσον,	- u u--- u u- --u u--	dactylic hexameter	masculine penthemimeral, hepthemimeral
Κλειοπάτρην ἕδνοισιν ἐμὸν δόμον ἦγον ἄκοιτιν.’	-uu- --u u- uu -u u--	dactylic hexameter	feminine penthemimeral, hepthemimeral, trithemimeral
Ἴσκεν Ἀγηνορίδης· ἀδινὸν δʼ ἕλε κῆδος ἕκαστον	-u u-uu- uu- uu -u u--	dactylic hexameter	masculine penthemimeral, hepthemimeral
ἡρώων, πέρι δʼ αὖτε δύω υἷας Βορέαο.	--- uu -u u- -- uu--	dactylic hexameter	feminine penthemimeral, hepthemimeral, trithemimeral
δάκρυ δʼ ὀμορξαμένω σχεδὸν ἤλυθον, ὧδέ τʼ ἔειπεν	-u u-uu- uu -uu -u u--	dactylic hexameter	masculine penthemimeral
Ζήτης, ἀσχαλόωντος ἑλὼν χερὶ χεῖρα γέροντος·	-- -uu-u u- uu -u u--	dactylic hexameter	feminine penthemimeral, hepthemimeral
‘Ἆ δείλʼ, οὔτινά φημι σέθεν σμυγερώτερον ἄλλον	- - -uu -u u- uu-uu --	dactylic hexameter	feminine penthemimeral, hepthemimeral
ἔμμεναι ἀνθρώπων. τί νύ τοι τόσα κήδεʼ ἀνῆπται;	-uu --- u u - uu -u u--	dactylic hexameter	masculine penthemimeral, hepthemimeral
ἦ ῥα θεοὺς ὀλοῇσι παρήλιτες ἀφραδίῃσιν	- u u- uu-u u-uu -uu--	dactylic hexameter	feminine penthemimeral, trithemimeral
μαντοσύνας δεδαώς; τῶ τοι μέγα μηνιόωσιν;	-uu- uu- - - uu -uu--	dactylic hexameter	masculine penthemimeral, hepthemimeral, trithemimeral
ἄμμι γε μὴν νόος ἔνδον ἀτύζεται ἱεμένοισιν	-u u - uu -u u-uu -uu--	dactylic hexameter	feminine penthemimeral, trithemimeral
χραισμεῖν, εἰ δὴ πρόχνυ γέρας τόδε πάρθετο δαίμων	-- - - -u u- uu -uu --	dactylic hexameter	feminine penthemimeral, hepthemimeral, trithemimeral
νῶιν. ἀρίζηλοι γὰρ ἐπιχθονίοισιν ἐνιπαὶ	-u u--- u u-uu-u u--	dactylic hexameter	masculine penthemimeral
ἀθανάτων. οὐδʼ ἂν πρὶν ἐρητύσαιμεν ἰούσας	-uu- - - u u---u u--	dactylic hexameter	masculine penthemimeral, trithemimeral
Ἁρπυίας, μάλα περ λελιημένοι, ἔστʼ ἂν ὀμόσσῃς,	--- uu - uu-uu - u u--	dactylic hexameter	masculine penthemimeral, trithemimeral
μὴ μὲν τοῖό γ᾽ἕκητι θεοῖς ἀπὸ θυμοῦ ἔσεσθαι.’	- - -u u-u u- uu -u u--	dactylic hexameter	feminine penthemimeral, hepthemimeral
ὧς φάτο· τοῦ δʼ ἰθὺς κενεὰς ὁ γεραιὸς ἀνέσχεν	- uu - -- uu- u u-u u--	dactylic hexameter	masculine penthemimeral, hepthemimeral, trithemimeral
γλήνας ἀμπετάσας, καὶ ἀμείψατο τοῖσδʼ ἐπέεσσιν·	-- -uu- u u-uu - uu--	dactylic hexameter	masculine penthemimeral
‘σίγα· μή μοι ταῦτα νόῳ ἔνι βάλλεο, τέκνον.	-- - - -u u- uu -uu --	dactylic hexameter	feminine penthemimeral, hepthemimeral, trithemimeral
ἴστω Λητοῦς υἱός, ὅ με πρόφρων ἐδίδαξεν	-- -- -u u - -- uu--	dactylic hexameter	feminine penthemimeral, hepthemimeral
μαντοσύνας· ἴστω δὲ δυσώνυμος, ἥ μ᾽ἔλαχεν, κὴρ	-uu- -- u u-uu - uu- -	dactylic hexameter	masculine penthemimeral, trithemimeral
καὶ τόδʼ ἐπʼ ὀφθαλμῶν ἀλαὸν νέφος, οἵ θ᾽ὑπένερθεν	- u u --- uu- uu - uu--	dactylic hexameter	masculine penthemimeral, hepthemimeral
δαίμονες, οἳ μηδʼ ὧδε θανόντι περ εὐμενέοιεν,	-uu - - -u u-u u -uu--	dactylic hexameter	feminine penthemimeral, trithemimeral
ὡς οὔ τις θεόθεν χόλος ἔσσεται εἵνεκʼ ἀρωγῆς.’	- - - uu- uu -uu -u u--	dactylic hexameter	masculine penthemimeral, trithemimeral
τὼ μὲν ἔπειθʼ ὅρκοισιν ἀλαλκέμεναι μενέαινον.	- u u- --u u-uu- uu--	dactylic hexameter	feminine penthemimeral, trithemimeral
αἶψα δὲ κουρότεροι πεπονήατο δαῖτα γέροντι,	-u u -uu- uu-uu -u u--	dactylic hexameter	masculine penthemimeral
λοίσθιον Ἁρπυίῃσιν ἑλώριον· ἐγγύθι δʼ ἄμφω	-uu ---u u-uu -uu --	dactylic hexameter	feminine penthemimeral
στῆσαν, ἵνα ξιφέεσσιν ἐπεσσυμένας ἐλάσειαν.	-u u- uu-u u-uu- uu--	dactylic hexameter	feminine penthemimeral, trithemimeral
καὶ δὴ τὰ πρώτισθʼ ὁ γέρων ἔψαυεν ἐδωδῆς·	- - - -- u u- --u u--	dactylic hexameter	masculine penthemimeral, hepthemimeral, trithemimeral
αἱ δʼ ἄφαρ ἠύτʼ ἄελλαι ἀδευκέες, ἢ στεροπαὶ ὥς,	- uu -u u-u u-uu - uu- -	dactylic hexameter	feminine penthemimeral
ἀπρόφατοι νεφέων ἐξάλμεναι ἐσσεύοντο	-uu- uu- --uu ----	dactylic hexameter	masculine penthemimeral, trithemimeral
κλαγγῇ μαιμώωσαι ἐδητύος· οἱ δʼ ἐσιδόντες	-- ---u u-uu - uu--	dactylic hexameter	feminine penthemimeral
ἥρωες μεσσηγὺς ἀνίαχον· αἱ δʼ ἅμʼ ἀυτῇ	--- --u u-uu - u u--	dactylic hexameter	feminine penthemimeral, trithemimeral
πάντα καταβρόξασαι ὑπὲρ πόντοιο φέροντο	-u u---u u- --u u--	dactylic hexameter	feminine penthemimeral, hepthemimeral
τῆλε παρέξ· ὀδμὴ δὲ δυσάσχετος αὖθι λέλειπτο.	-u u- -- u u-uu -u u--	dactylic hexameter	masculine penthemimeral, trithemimeral
τάων δʼ αὖ κατόπισθε δύω υἷες Βορέαο	-- - uu-u u- -- uu--	dactylic hexameter	feminine penthemimeral, hepthemimeral, trithemimeral
φάσγανʼ ἐπισχόμενοι ὀπίσω θέον. ἐν γὰρ ἕηκεν	-u u-uu- uu- uu - u u--	dactylic hexameter	masculine penthemimeral, hepthemimeral
Ζεὺς μένος ἀκάματόν σφιν· ἀτὰρ Διὸς οὔ κεν ἑπέσθην	- uu -uu- u u- uu - u u--	dactylic hexameter	masculine penthemimeral, hepthemimeral
νόσφιν, ἐπεὶ ζεφύροιο παραΐσσεσκον ἀέλλας	-u u- uu-u u---u u--	dactylic hexameter	feminine penthemimeral, trithemimeral
αἰέν. ὅτʼ ἐς Φινῆα καὶ ἐκ Φινῆος ἴοιεν.	-u u - --u u - --u u--	dactylic hexameter	feminine penthemimeral, hepthemimeral, trithemimeral
ὡς δʼ ὅτʼ ἐνὶ κνημοῖσι κύνες δεδαημένοι ἄγρη;	- u u- --u u- uu-uu --	dactylic hexameter	feminine penthemimeral, hepthemimeral, trithemimeral
ἢ αἶγας κεραοὺς ἠὲ πρόκας ἰχνεύοντες	- -- uu- -- uu ----	dactylic hexameter	masculine penthemimeral, hepthemimeral, trithemimeral
θείωσιν, τυτθὸν δὲ τιταινόμενοι μετόπισθεν	--- -- u u-uu- uu--	dactylic hexameter	masculine penthemimeral, trithemimeral
ἄκρῃς ἐν γενύεσσι μάτην ἀράβησαν ὀδόντας·	-- - uu-u u- uu-u u--	dactylic hexameter	feminine penthemimeral, hepthemimeral, trithemimeral
ὧς Ζήτης Κάλαΐς τε μάλα σχεδὸν ἀίσσοντες	- -- uu- u u- uu ----	dactylic hexameter	masculine penthemimeral, hepthemimeral, trithemimeral
τάων ἀκροτάτῃσιν ἐπέχραον ἤλιθα χερσίν.	-- -uu-u u-uu -uu --	dactylic hexameter	feminine penthemimeral
καί νύ κε δή σφʼ ἀέκητι θεῶν διεδηλήσαντο	- u u - uu-u u- uu----	dactylic hexameter	feminine penthemimeral, hepthemimeral, trithemimeral
πολλὸν ἑκὰς νήσοισιν ἔπι Πλωτῇσι κιχόντες,	-u u- --u u- --u u--	dactylic hexameter	feminine penthemimeral, hepthemimeral, trithemimeral
εἰ μὴ ἄρʼ ὠκέα Ἶρις ἴδεν, κατὰ δʼ αἰθέρος ἆλτο	- u u -uu -u u- uu -uu --	dactylic hexameter	feminine penthemimeral, hepthemimeral
οὐρανόθεν, καὶ τοῖα παραιφαμένη κατέρυκεν·	-uu- - -u u-uu- uu--	dactylic hexameter	feminine penthemimeral, trithemimeral
‘οὐ θέμις, ὦ υἱεῖς Βορέω, ξιφέεσσιν ἐλάσσαι	- uu - -- uu- uu-u u--	dactylic hexameter	masculine penthemimeral, hepthemimeral, trithemimeral
Ἁρπυίας, μεγάλοιο Διὸς κύνας· ὅρκια δʼ αὐτὴ	--- uu-u u- uu -uu --	dactylic hexameter	feminine penthemimeral, hepthemimeral, trithemimeral
δώσω ἐγών, ὡς οὔ οἱ ἔτι χρίμψουσιν ἰοῦσαι.’	-u u- - - u u- --u u--	dactylic hexameter	masculine penthemimeral, hepthemimeral, trithemimeral
ὧς φαμένη λοιβὴν Στυγὸς ὤμοσεν, ἥ τε θεοῖσιν	- uu- -- uu -uu - u u--	dactylic hexameter	masculine penthemimeral, trithemimeral
ῥιγίστη πάντεσσιν ὀπιδνοτάτη τε τέτυκται,	--- --u u-uu- u u--	dactylic hexameter	feminine penthemimeral, trithemimeral
μὴ μὲν Ἀγηνορίδαο δόμοις ἔτι τάσδε πελάσσαι	- u u-uu-u u- uu -u u--	dactylic hexameter	feminine penthemimeral, hepthemimeral
εἰσαῦτις Φινῆος, ἐπεὶ καὶ μόρσιμον ἦεν.	--- --u u- - -uu --	dactylic hexameter	feminine penthemimeral, hepthemimeral, trithemimeral
οἱ δʼ ὅρκῳ εἴξαντες ὑπέστρεφον ἂψ ἐπὶ νῆα	- -- --u u-uu - uu --	dactylic hexameter	feminine penthemimeral, trithemimeral
σώεσθαι. Στροφάδας δὲ μετακλείουσʼ ἄνθρωποι	--- uu- u u--- ---	dactylic hexameter	masculine penthemimeral, trithemimeral
νήσους τοῖό γ᾽ἕκητι, πάρος Πλωτὰς καλέοντες.	-- -u u-u u- -- uu--	dactylic hexameter	feminine penthemimeral, hepthemimeral
Ἄρπυιαί τʼ Ἶρίς τε διέτμαγεν. αἱ μὲν ἔδυσαν	--- -- u u-uu - u u--	dactylic hexameter	masculine penthemimeral, trithemimeral
κευθμῶνα Κρήτης Μινωίδος· ἡ δʼ ἀνόρουσεν	--- -- --uu - uu--	dactylic hexameter	masculine penthemimeral, trithemimeral
Οὔλυμπόνδε, θοῇσι μεταχρονίη πτερύγεσσιν.	---u u-u u-uu- uu--	dactylic hexameter	feminine penthemimeral
τόφρα δʼ ἀριστῆες πινόεν περὶ δέρμα γέροντος	-u u--- uu- uu -u u--	dactylic hexameter	masculine penthemimeral, hepthemimeral
πάντῃ φοιβήσαντες ἐπικριδὸν ἱρεύσαντο	-- ---u u-uu ----	dactylic hexameter	feminine penthemimeral
μῆλα, τά τʼ ἐξ Ἀμύκοιο λεηλασίης ἐκόμισσαν.	-u u - uu-u u-uu- uu--	dactylic hexameter	feminine penthemimeral, trithemimeral
αὐτὰρ ἐπεὶ μέγα δόρπον ἐνὶ μεγάροισιν ἔθεντο,	-u u- uu -u u- uu-u u--	dactylic hexameter	feminine penthemimeral, hepthemimeral, trithemimeral
δαίνυνθʼ ἑζόμενοι· σὺν δέ σφισι δαίνυτο Φινεὺς	-- -uu- - - uu -uu --	dactylic hexameter	masculine penthemimeral, hepthemimeral
ἁρπαλέως, οἷόν τʼ ἐν ὀνείρασι θυμὸν ἰαίνων.	-uu- -- u u-uu -u u--	dactylic hexameter	masculine penthemimeral, trithemimeral
ἔνθα δʼ ,ἐπεὶ δόρποιο κορέσσαντʼ ἠδὲ ποτῆτος,	-u u- --u u-- -u u--	dactylic hexameter	feminine penthemimeral, trithemimeral
παννύχιοι Βορέω μένον υἱέας ἐγρήσσοντες.	-uu- uu- uu -uu ----	dactylic hexameter	masculine penthemimeral, trithemimeral
αὐτὸς δʼ ἐν μέσσοισι παρʼ ἐσχάρῃ ἧστο γεραιὸς	-- - --u u -uu -u u--	dactylic hexameter	feminine penthemimeral, trithemimeral
πείρατα ναυτιλίης ἐνέπων ἄνυσίν τε κελεύθου·	-uu -uu- uu- uu- u u--	dactylic hexameter	masculine penthemimeral, hepthemimeral
‘κλῦτέ νυν. οὐ μὲν πάντα πέλει θέμις ὔμμι δαῆναι	-u u - - -u u- uu -u u--	dactylic hexameter	feminine penthemimeral, hepthemimeral, trithemimeral
ἀτρεκές· ὅσσα δʼ ὄρωρε θεοῖς φίλον, οὐκ ἐπικεύσω.	-uu -u u-u u- uu - uu--	dactylic hexameter	feminine penthemimeral, hepthemimeral
ἀασάμην καὶ πρόσθε Διὸς νόον ἀφραδίῃσιν	-uu- - -u u- uu -uu--	dactylic hexameter	feminine penthemimeral, hepthemimeral, trithemimeral
χρείων ἑξείης τε καὶ ἐς τέλος. ὧδε γὰρ αὐτὸς	-- --- u u - uu -u u --	dactylic hexameter	masculine penthemimeral, hepthemimeral
βούλεται ἀνθρώποις ἐπιδευέα θέσφατα φαίνειν	-uu --- uu-uu -uu --	dactylic hexameter	masculine penthemimeral
μαντοσύνης, ἵνα καί τι θεῶν χατέωσι νόοιο.	-uu- uu - u u- uu-u u--	dactylic hexameter	masculine penthemimeral, hepthemimeral, trithemimeral
πέτρας μὲν πάμπρωτον, ἀφορμηθέντες ἐμεῖο,	-- - --u u---u u--	dactylic hexameter	feminine penthemimeral, trithemimeral
Κυανέας ὄψεσθε δύω ἁλὸς ἐν ξυνοχῇσιν,	-uu- --u u- uu - uu--	dactylic hexameter	feminine penthemimeral, hepthemimeral, trithemimeral
τάων οὔτινά φημι διαμπερὲς ἐξαλέασθαι.	-- -uu -u u-uu -uu--	dactylic hexameter	feminine penthemimeral
οὐ γάρ τε ῥίζῃσιν ἐρήρεινται νεάτῃσιν,	- - - --u u--- uu--	dactylic hexameter	feminine penthemimeral, trithemimeral
ἀλλὰ θαμὰ ξυνίασιν ἐναντίαι ἀλλήλῃσιν	-u u- uu-u u-uu ----	dactylic hexameter	feminine penthemimeral, trithemimeral
εἰς ἕν, ὕπερθε δὲ πολλὸν ἁλὸς κορθύεται ὕδωρ	- u u-u u -u u- --uu --	dactylic hexameter	feminine penthemimeral, hepthemimeral
βρασσόμενον· στρηνὲς δὲ περὶ στυφελῇ βρέμει ἀκτῇ.	-uu- -- u u- uu- uu --	dactylic hexameter	masculine penthemimeral, hepthemimeral, trithemimeral
τῶ νῦν ἡμετέρῃσι παραιφασίῃσι πίθεσθε,	- - -uu-u u-uu-u u--	dactylic hexameter	feminine penthemimeral
εἰ ἐτεὸν πυκινῷ τε νόῳ μακάρων τʼ ἀλέγοντες	- uu- uu- u u- uu- uu--	dactylic hexameter	masculine penthemimeral, hepthemimeral, trithemimeral
πείρετε· μηδʼ αὔτως αὐτάγρετον οἶτον ὄλησθε	-uu - -- --uu -u u--	dactylic hexameter	masculine penthemimeral, trithemimeral
ἀφραδέως, ἢ θύνετʼ ἐπισπόμενοι νεότητι.	-uu- - -u u-uu- uu--	dactylic hexameter	feminine penthemimeral, trithemimeral
οἰωνῷ δή πρόσθε πελειάδι πειρήσασθαι	--- - -u u-uu ----	dactylic hexameter	feminine penthemimeral, trithemimeral
νηὸς ἄπο προμεθέντες ἐφιέμεν. ἢν δὲ διʼ αὐτῶν	-u u- uu-u u-uu - u u --	dactylic hexameter	feminine penthemimeral, trithemimeral
πετράων πόντονδε σόη πτερύγεσσι δίηται,	--- --u u- uu-u u--	dactylic hexameter	feminine penthemimeral, hepthemimeral, trithemimeral
μηκέτι δὴν μηδʼ αὐτοὶ ἐρητύεσθε κελεύθου,	-uu - - -u u---u u--	dactylic hexameter	feminine penthemimeral, trithemimeral
ἀλλʼ εὖ καρτύναντες ἑαῖς ἐνὶ χερσὶν ἐρετμὰ	- - ---u u- uu -u u--	dactylic hexameter	feminine penthemimeral, hepthemimeral
τέμνεθʼ ἁλὸς στεινωπόν· ἐπεὶ φάος οὔ νύ τι τόσσον	-u u- --u u- uu - u u --	dactylic hexameter	feminine penthemimeral, hepthemimeral, trithemimeral
ἔσσετʼ ἐν εὐχωλῇσιν, ὅσον τʼ ἐνὶ κάρτεϊ χειρῶν.	-u u ---u u- uu -uu --	dactylic hexameter	feminine penthemimeral, hepthemimeral
τῶ καὶ τἆλλα μεθέντες ὀνήιστον πονέεσθαι	- - -u u-u u--- uu--	dactylic hexameter	feminine penthemimeral
θαρσαλέως· πρὶν δʼ οὔτι θεοὺς λίσσεσθαι ἐρύκω.	-uu- - -u u- --u u--	dactylic hexameter	feminine penthemimeral, hepthemimeral, trithemimeral
εἰ δέ κεν ἀντικρὺ πταμένη μεσσηγὺς ὄληται,	- u u --- uu- --u u--	dactylic hexameter	masculine penthemimeral, hepthemimeral
ἄψορροι στέλλεσθαι ἐπεὶ πολὺ βέλτερον εἶξαι	--- --u u- uu -uu --	dactylic hexameter	feminine penthemimeral, hepthemimeral, trithemimeral
ἀθανάτοις. οὐ γάρ κε κακὸν μόρον ἐξαλέαισθε	-uu- - - u u- uu -uu--	dactylic hexameter	masculine penthemimeral, hepthemimeral, trithemimeral
πετράων, οὐδʼ εἴ κε σιδηρείη πέλοι Ἀργώ.	--- - - u u--- uu --	dactylic hexameter	masculine penthemimeral, trithemimeral
ὦ μέλεοι, μὴ τλῆτε παρὲξ ἐμὰ θέσφατα βῆναι,	- uu- - -u u- uu -uu --	dactylic hexameter	feminine penthemimeral, hepthemimeral, trithemimeral
εἰ καί με τρὶς τόσσον ὀίεσθʼ Οὐρανίδῃσιν,	- - - - -u u-- -uu--	dactylic hexameter	feminine penthemimeral, trithemimeral
ὅσσον ἀνάρσιός εἰμι, καὶ εἰ πλεῖον στυγέεσθαι·	-u u-uu -u u - -- uu--	dactylic hexameter	feminine penthemimeral, hepthemimeral
μὴ τλῆτʼ οἰωνοῖο πάρεξ ἔτι νηὶ περῆσαι.	- - ---u u- uu -u u--	dactylic hexameter	feminine penthemimeral, hepthemimeral
καὶ τὰ μὲν ὥς κε πέλῃ, τὼς ἔσσεται. ἢν δὲ φύγητε	- u u - u u- - -uu - u u--	dactylic hexameter	masculine penthemimeral, trithemimeral
σύνδρομα πετράων ἀσκηθέες ἔνδοθι Πόντου,	-uu --- --uu -uu --	dactylic hexameter	masculine penthemimeral
αὐτίκα Βιθυνῶν ἐπὶ δεξιὰ γαῖαν ἔχοντες	-uu --- uu -uu -u u--	dactylic hexameter	masculine penthemimeral
πλώετε ῥηγμῖνας πεφυλαγμένοι, εἰσόκεν αὖτε	-uu --- uu-uu -uu --	dactylic hexameter	masculine penthemimeral
Ῥήβαν ὠκυρόην ποταμὸν ἄκρην τε Μέλαιναν	-- -uu- uu- -- u u--	dactylic hexameter	masculine penthemimeral, hepthemimeral
γνάμψαντες νήσου Θυνηίδος ὅρμον ἵκησθε.	--- -- --uu -u u--	dactylic hexameter	masculine penthemimeral, trithemimeral
κεῖθεν δʼ οὐ μάλα πουλὺ διὲξ ἁλὸς ἀντιπέραιαν	-- - uu -u u- uu -uu--	dactylic hexameter	feminine penthemimeral, hepthemimeral, trithemimeral
γῆν Μαριανδυνῶν ἐπικέλσετε νοστήσαντες.	- uu--- uu-uu ----	dactylic hexameter	masculine penthemimeral
ἔνθα μὲν εἰς Ἀίδαο καταιβάτις ἐστὶ κέλευθος,	-u u - uu-u u-uu -u u--	dactylic hexameter	feminine penthemimeral, trithemimeral
ἄκρη τε προβλὴς Ἀχερουσιὰς ὑψόθι τείνει,	-- - -- uu-uu -uu --	dactylic hexameter	masculine penthemimeral, trithemimeral
δινήεις τʼ Ἀχέρων αὐτὴν διὰ νειόθι τέμνων	--- uu- -- uu -uu --	dactylic hexameter	masculine penthemimeral, hepthemimeral, trithemimeral
ἄκρην ἐκ μεγάλης προχοὰς ἵησι φάραγγος.	-- - uu- uu- --u u--	dactylic hexameter	masculine penthemimeral, hepthemimeral, trithemimeral
ἀγχίμολον δʼ ἐπὶ τῇ πολέας παρανεῖσθε κολωνοὺς	-uu- uu - uu- uu-u u--	dactylic hexameter	masculine penthemimeral, hepthemimeral, trithemimeral
Παφλαγόνων, τοῖσίν τʼ Ἐνετήιος ἐμβασίλευσεν	-uu- -- uu-uu -uu--	dactylic hexameter	masculine penthemimeral, trithemimeral
πρῶτα Πέλοψ, τοῦ καί περ ἀφʼ αἵματος εὐχετόωνται.	-u u- - - u u -uu -uu--	dactylic hexameter	masculine penthemimeral, trithemimeral
ἔστι δέ τις ἄκρη Ἑλίκης κατεναντίον Ἄρκτου,	-u u - -- uu- uu-uu --	dactylic hexameter	masculine penthemimeral, hepthemimeral, trithemimeral
πάντοθεν ἠλίβατος, καί μιν καλέουσι Κάραμβιν,	-uu -uu- - - uu-u u--	dactylic hexameter	masculine penthemimeral, hepthemimeral
τῆς καὶ ὑπὲρ βορέαο περισχίζονται ἄελλαι·	- u u- uu-u u---u u--	dactylic hexameter	feminine penthemimeral, trithemimeral
ὧδε μάλʼ ἂμ πέλαγος τετραμμένη αἰθέρι κύρει.	-u u - uu- --uu -uu --	dactylic hexameter	masculine penthemimeral, trithemimeral
τήνδε περιγνάμψαντι πολὺς παρακέκλιται· ἤδη	-u u---u u- uu-uu --	dactylic hexameter	feminine penthemimeral, hepthemimeral
αἰγιαλός· πολέος δʼ ἐπὶ πείρασιν Αἰγιαλοῖο	-uu- uu- uu -uu -uu--	dactylic hexameter	masculine penthemimeral, trithemimeral
ἀκτῇ ἐπὶ προβλῆτι ῥοαὶ Ἅλυος ποταμοῖο	-u u- --u u- uu- uu--	dactylic hexameter	feminine penthemimeral, hepthemimeral, trithemimeral
δεινὸν ἐρεύγονται· μετὰ τὸν δʼ ἀγχίροος Ἶρις	-u u--- uu - --uu --	dactylic hexameter	masculine penthemimeral, hepthemimeral
μειότερος λευκῇσιν ἑλίσσεται εἰς ἅλα δίναις.	-uu- --u u-uu - uu --	dactylic hexameter	feminine penthemimeral, trithemimeral
κεῖθεν δὲ προτέρωσε μέγας καὶ ὑπείροχος ἀγκὼν	-- - uu-u u- u u-uu --	dactylic hexameter	feminine penthemimeral, hepthemimeral, trithemimeral
ἐξανέχει γαίης· ἐπὶ δὲ στόμα Θερμώδοντος	-uu- -- uu - uu ----	dactylic hexameter	masculine penthemimeral, hepthemimeral, trithemimeral
κόλπῳ ἐν εὐδιόωντι Θεμισκύρειον ὑπʼ ἄκρην	-u u -uu-u u---u u --	dactylic hexameter	feminine penthemimeral
μύρεται, εὐρείης διαειμένος ἠπείροιο.	-uu --- uu-uu ----	dactylic hexameter	masculine penthemimeral
ἔνθα δὲ Δοίαντος πεδίον, σχεδόθεν δὲ πόληες	-u u --- uu- uu- u u--	dactylic hexameter	masculine penthemimeral, hepthemimeral
τρισσαὶ Ἀμαζονίδων, μετά τε σμυγερώτατοι ἀνδρῶν	-u u-uu- uu - uu-uu --	dactylic hexameter	masculine penthemimeral, hepthemimeral
τρηχεῖαν Χάλυβες καὶ ἀτειρέα γαῖαν ἔχουσιν,	--- uu- u u-uu -u u--	dactylic hexameter	masculine penthemimeral, trithemimeral
ἐργατίναι· τοὶ δʼ ἀμφὶ σιδήρεα ἔργα μέλονται.	-uu- - -u u-uu -u u--	dactylic hexameter	feminine penthemimeral, trithemimeral
ἄγχι δὲ ναιετάουσι πολύρρηνες Τιβαρηνοὶ	-u u -uu-u u--- uu--	dactylic hexameter	feminine penthemimeral
Ζηνὸς Ἐυξείνοιο Γενηταίην ὑπὲρ ἄκρην.	-u u---u u--- uu --	dactylic hexameter	feminine penthemimeral
τῇ δʼ ἐπὶ Μοσσύνοικοι ὁμούριοι ὑλήεσσαν	- uu ---u u-uu ----	dactylic hexameter	feminine penthemimeral
ἑξείης ἤπειρον, ὑπωρείας τε νέμονται,	--- --u u--- u u--	dactylic hexameter	feminine penthemimeral, trithemimeral
δουρατέοις πύργοισιν ἐν οἰκία τεκτήναντες	-uu- --u u -uu ----	dactylic hexameter	feminine penthemimeral, trithemimeral
[κάλινα καὶ πύργους εὐπηγέας, οὓς καλέουσιν	-uu - -- --uu - uu--	dactylic hexameter	masculine penthemimeral, trithemimeral
[μόσσυνας· καὶ δʼ αὐτοὶ ἐπώνυμοι ἔνθεν ἔασιν.	--- - -u u-uu -u u--	dactylic hexameter	feminine penthemimeral, trithemimeral
τοὺς παραμειβόμενοι λισσῇ ἐπικέλσετε νήσῳ,	- uu-uu- -- uu-uu --	dactylic hexameter	masculine penthemimeral, hepthemimeral
μήτι παντοίῃ μέ γʼ ἀναιδέας ἐξελάσαντες	-- --- u u-uu -uu--	dactylic hexameter	masculine penthemimeral
οἰωνούς, οἳ δῆθεν ἀπειρέσιοι ἐφέπουσιν	--- - -u u-uu- uu--	dactylic hexameter	feminine penthemimeral, trithemimeral
νῆσον ἐρημαίην. τῇ μέν τʼ ἐνὶ νηὸν Ἄρηος	-u u--- - - uu -u u--	dactylic hexameter	masculine penthemimeral, hepthemimeral
λαΐνεον ποίησαν Ἀμαζονίδων βασίλειαι	-uu- --u u-uu- uu--	dactylic hexameter	feminine penthemimeral, trithemimeral
Ὀτρηρή τε καὶ Ἀντιόπη, ὁπότε στρατόωντο.	--- u u -uu- uu- uu--	dactylic hexameter	hepthemimeral, trithemimeral
ἔνθα γὰρ ὔμμιν ὄνειαρ ἀδευκέος ἐξ ἁλὸς εἶσιν	-u u -u u-u u-uu - uu --	dactylic hexameter	feminine penthemimeral
ἄρρητον· τῶ καί τε φίλα φρονέων ἀγορεύω	--- - - u u- uu- uu--	dactylic hexameter	masculine penthemimeral, hepthemimeral, trithemimeral
ἰσχέμεν. ἀλλὰ τίη με πάλιν χρειὼ ἀλιτέσθαι	-uu -u u- u u- -- uu--	dactylic hexameter	masculine penthemimeral, hepthemimeral
μαντοσύνῃ τὰ ἕκαστα διηνεκὲς ἐξενέποντα;	-uu- u u-u u-uu -uu--	dactylic hexameter	feminine penthemimeral, trithemimeral
νήσου δὲ προτέρωσε καὶ ἠπείροιο περαίης	-- - uu-u u ---u u--	dactylic hexameter	feminine penthemimeral, trithemimeral
φέρβονται Φίλυρες· Φιλύρων δʼ ἐφύπερθεν ἔασιν	--- uu- uu- uu-u u--	dactylic hexameter	masculine penthemimeral, hepthemimeral, trithemimeral
Μάκρωνες· μετὰ δʼ αὖ περιώσια φῦλα Βεχείρων.	--- uu - uu-uu -u u--	dactylic hexameter	masculine penthemimeral, trithemimeral
ἑξείης δὲ Σάπειρες ἐπὶ σφίσι ναιετάουσιν·	--- u u-u u- uu -uu--	dactylic hexameter	feminine penthemimeral, hepthemimeral, trithemimeral
Βύζηρες δʼ ἐπὶ τοῖσιν ὁμώλακες, ὧν ὕπερ ἤδη	--- uu -u u-uu - uu --	dactylic hexameter	feminine penthemimeral, trithemimeral
αὐτοὶ Κόλχοι ἔχονται ἀρήιοι. ἀλλʼ ἐνὶ νηὶ	-- -u u-u u-uu - uu --	dactylic hexameter	feminine penthemimeral
πείρεθʼ, ἕως μυχάτῃ κεν ἐνιχρίμψητε θαλάσσῃ.	-u u- uu- u u---u u--	dactylic hexameter	masculine penthemimeral, trithemimeral
ἔνθα δʼ ἐπʼ ἠπείροιο Κυταιίδος, ἠδʼ Ἀμαραντῶν	-u u ---u u-uu - uu--	dactylic hexameter	feminine penthemimeral
τηλόθεν ἐξ ὀρέων πεδίοιό τε Κιρκαίοιο	-uu - uu- uu-u u ----	dactylic hexameter	masculine penthemimeral, trithemimeral
Φᾶσις δινήεις εὐρὺν ῥόον εἰς ἅλα βάλλει.	-- --- -- uu - uu --	dactylic hexameter	masculine penthemimeral, hepthemimeral
κείνου νῆʼ ἐλάοντες ἐπὶ προχοὰς ποταμοῖο	-- - uu-u u- uu- uu--	dactylic hexameter	feminine penthemimeral, hepthemimeral, trithemimeral
πύργους εἰσόψεσθε Κυταιέος Αἰήταο,	-- ---u u-uu ----	dactylic hexameter	feminine penthemimeral
ἄλσος τε σκιόειν Ἄρεος, τόθι κῶας ἐπʼ ἄκρης	-- - uu- uu- uu -u u --	dactylic hexameter	masculine penthemimeral, hepthemimeral, trithemimeral
πεπτάμενον φηγοῖο δράκων, τέρας αἰνὸν ἰδέσθαι,	-uu- --u u- uu -u u--	dactylic hexameter	feminine penthemimeral, hepthemimeral, trithemimeral
ἀμφὶς ὀπιπεύει δεδοκημένος· οὐδέ οἱ ἦμαρ,	-u u--- uu-uu -u u --	dactylic hexameter	masculine penthemimeral
οὐ κνέφας ἥδυμος ὕπνος ἀναιδέα δάμναται ὄσσε.’	- uu -uu -u u-uu -uu --	dactylic hexameter	feminine penthemimeral
ὧς ἄρʼ ἔφη· τοὺς δʼ εἶθαρ ἕλεν δέος εἰσαΐοντας.	- u u- - -u u- uu -uu--	dactylic hexameter	feminine penthemimeral, hepthemimeral, trithemimeral
δὴν δʼ ἔσαν ἀμφασίῃ βεβολημένοι· ὀψὲ δʼ ἔειπεν	- uu -uu- uu-uu -u u--	dactylic hexameter	masculine penthemimeral
ἥρως Αἴσονος υἱὸς ἀμηχανέων κακότητι·	-- -uu -u u-uu- uu--	dactylic hexameter	feminine penthemimeral
‘ὦ γέρον, ἤδη μέν τε διίκεο πείρατʼ ἀέθλων	- uu -- - u u-uu -u u--	dactylic hexameter	masculine penthemimeral
ναυτιλίης καὶ τέκμαρ, ὅτῳ στυγερὰς διὰ πέτρας	-uu- - -u u- uu- uu --	dactylic hexameter	feminine penthemimeral, hepthemimeral, trithemimeral
πειθόμενοι Πόντονδε περήσομεν· εἰ δέ κεν αὖτις	-uu- --u u-uu - u u --	dactylic hexameter	feminine penthemimeral, trithemimeral
τάσδʼ ἡμῖν προφυγοῦσιν ἐς Ἑλλάδα νόστος ὀπίσσω	- -- uu-u u -uu -u u--	dactylic hexameter	feminine penthemimeral, trithemimeral
ἔσσεται, ἀσπαστῶς κε παρὰ σέο καὶ τὸ δαείην.	-uu --- u u- uu - u u--	dactylic hexameter	masculine penthemimeral, hepthemimeral
πῶς ἔρδω, πῶς αὖτε τόσην ἁλὸς εἶμι κέλευθον,	- -- - -u u- uu -u u--	dactylic hexameter	feminine penthemimeral, hepthemimeral, trithemimeral
νῆις ἐὼν ἑτάροις ἅμα νήισιν; αἶα δὲ Κολχὶς	-u u- uu- uu -uu -u u --	dactylic hexameter	masculine penthemimeral, trithemimeral
Πόντου καὶ γαίης ἐπικέκλιται ἐσχατιῇσιν.’	-- - -- uu-uu -uu--	dactylic hexameter	masculine penthemimeral, trithemimeral
ὧς φάτο· τὸν δʼ ὁ γεραιὸς ἀμειβόμενος προσέειπεν·	- uu - u u-u u-uu- uu--	dactylic hexameter	feminine penthemimeral, trithemimeral
‘ὦ τέκος, εὖτʼ ἂν πρῶτα φύγῃς ὀλοὰς διὰ πέτρας,	- uu - - -u u- uu- uu --	dactylic hexameter	feminine penthemimeral, hepthemimeral, trithemimeral
θάρσει· ἐπεὶ δαίμων ἕτερον πλόον ἡγεμονεύσει	-u u- -- uu- uu -uu--	dactylic hexameter	masculine penthemimeral, hepthemimeral, trithemimeral
ἐξ Αἴης· μετὰ δʼ Αἶαν ἅλις πομπῆες ἔσονται.	- -- uu -u u- --u u--	dactylic hexameter	feminine penthemimeral, hepthemimeral, trithemimeral
ἀλλά, φίλοι, φράζεσθε θεᾶς δολόεσσαν ἀρωγὴν	-u u- --u u- uu-u u--	dactylic hexameter	feminine penthemimeral, hepthemimeral, trithemimeral
Κύπριδος. ἐκ γὰρ τῆς κλυτὰ πείρατα κεῖται ἀέθλων.	-uu - - - uu -uu -u u--	dactylic hexameter	masculine penthemimeral, trithemimeral
καὶ δέ με μηκέτι τῶνδε περαιτέρω ἐξερέεσθε.’	- u u -uu -u u-uu -uu--	dactylic hexameter	feminine penthemimeral
ὧς φάτʼ Ἀγηνορίδης· ἐπὶ δὲ σχεδὸν υἱέε δοιὼ	- u u-uu- uu - uu -uu --	dactylic hexameter	masculine penthemimeral, hepthemimeral
Θρηικίου Βορέαο κατʼ αἰθέρος ἀίξαντε	-uu- uu-u u -uu ----	dactylic hexameter	feminine penthemimeral, trithemimeral
οὐδῷ ἔπι κραιπνοὺς ἔβαλον πόδας· οἱ δʼ ἀνόρουσαν	-u u- -- uu- uu - uu--	dactylic hexameter	masculine penthemimeral, hepthemimeral, trithemimeral
ἐξ ἑδέων ἥρωες, ὅπως παρεόντας ἴδοντο.	- uu- --u u- uu-u u--	dactylic hexameter	feminine penthemimeral, hepthemimeral, trithemimeral
Ζήτης δʼ ἱεμένοισιν, ἔτʼ ἄσπετον ἐκ καμάτοιο	-- -uu-u u -uu - uu--	dactylic hexameter	feminine penthemimeral
ἆσθμʼ ἀναφυσιόων, μετεφώνεεν, ὅσσον ἄπωθεν	- uu-uu- uu-uu -u u--	dactylic hexameter	masculine penthemimeral
ἤλασαν, ἠδʼ ὡς Ἶρις ἐρύκακε τάσδε δαΐξαι,	-uu - - -u u-uu -u u--	dactylic hexameter	feminine penthemimeral, trithemimeral
ὅρκιά τʼ εὐμενέουσα θεὰ πόρεν, αἱ δʼ ὑπέδυσαν	-uu -uu-u u- uu - uu--	dactylic hexameter	feminine penthemimeral, hepthemimeral
δείματι Δικταίης περιώσιον ἄντρον ἐρίπνης.	-uu --- uu-uu -u u--	dactylic hexameter	masculine penthemimeral
γηθόσυνοι δἤπειτα δόμοις ἔνι πάντες ἑταῖροι	-uu- --u u- uu -u u--	dactylic hexameter	feminine penthemimeral, hepthemimeral, trithemimeral
αὐτός τʼ ἀγγελίῃ Φινεὺς πέλεν. ὦκα δὲ τόνγε	-- -uu- -- uu -u u --	dactylic hexameter	masculine penthemimeral, hepthemimeral
Αἰσονίδης περιπολλὸν ἐυφρονέων προσέειπεν·	-uu- uu-u u-uu- uu--	dactylic hexameter	feminine penthemimeral, trithemimeral
‘ἦ ἄρα δή τις ἔην, Φινεῦ, θεός, ὃς σέθεν ἄτης	- uu - u u- -- uu - uu --	dactylic hexameter	masculine penthemimeral, hepthemimeral, trithemimeral
κήδετο λευγαλέης, καὶ δʼ ἡμέας αὖθι πέλασσεν	-uu -uu- - -uu -u u--	dactylic hexameter	masculine penthemimeral
τηλόθεν, ὄφρα τοι υἷες ἀμύνειαν Βορέαο·	-uu -u u -u u--- uu--	dactylic hexameter	feminine penthemimeral
εἰ δὲ καὶ ὀφθαλμοῖσι φόως πόροι ἦ τʼ ἂν ὀίω	- u u ---u u- uu - u u--	dactylic hexameter	feminine penthemimeral, hepthemimeral
γηθήσειν, ὅσον εἴπερ ὑπότροπος οἴκαδʼ ἱκοίμην.’	--- uu -u u-uu -u u--	dactylic hexameter	feminine penthemimeral, trithemimeral
ὧς ἔφατʼ· αὐτὰρ ὁ τόνγε κατηφήσας προσέειπεν·	- uu -u u -u u--- uu--	dactylic hexameter	feminine penthemimeral
‘Αἰσονίδη, τὸ μὲν οὐ παλινάγρετον, οὐδέ τι μῆχος	-uu- u u - uu-uu -u u --	dactylic hexameter	masculine penthemimeral, trithemimeral
ἔστʼ ὀπίσω· κενεαὶ γὰρ ὑποσμύχονται ὀπωπαί.	- uu- uu- u u---u u--	dactylic hexameter	masculine penthemimeral, trithemimeral
ἀντὶ δὲ τοῦ θάνατόν μοι ἄφαρ θεὸς ἐγγυαλίξαι,	-u u - uu- u u- uu -uu--	dactylic hexameter	masculine penthemimeral, hepthemimeral, trithemimeral
καί τε θανὼν πάσῃσι μετέσσομαι ἀγλαΐῃσιν.’	- u u- --u u-uu -uu--	dactylic hexameter	feminine penthemimeral, trithemimeral
ὧς τώ γʼ ἀλλήλοισι παραβλήδην ἀγόρευον.	- - ---u u--- uu--	dactylic hexameter	feminine penthemimeral
αὐτίκα δʼ οὐ μετὰ δηρὸν ἀμειβομένων ἐφαάνθη	-uu - uu -u u-uu- uu--	dactylic hexameter	feminine penthemimeral, trithemimeral
Ἠριγενής· τὸν δʼ ἀμφὶ περικτίται ἠγερέθοντο	-uu- - -u u-uu -uu--	dactylic hexameter	feminine penthemimeral, trithemimeral
ἀνέρες, οἳ καὶ πρόσθεν ἐπʼ ἤματι κεῖσε θάμιζον,	-uu - - -u u -uu -u u--	dactylic hexameter	feminine penthemimeral, trithemimeral
αἰὲν ὁμῶς φορέοντες ἑῆς ἀπὸ μοῖραν ἐδωδῆς.	-u u- uu-u u- uu -u u--	dactylic hexameter	feminine penthemimeral, hepthemimeral, trithemimeral
τοῖς ὁ γέρων πάντεσσιν, ὅτις καὶ ἀφαυρὸς ἵκοιτο,	- u u- --u u- u u-u u--	dactylic hexameter	feminine penthemimeral, hepthemimeral, trithemimeral
ἔχραεν ἐνδυκέως, πολέων δʼ ἀπὸ πήματʼ ἔλυσεν	-uu -uu- uu- uu -u u--	dactylic hexameter	masculine penthemimeral, hepthemimeral
μαντοσύνῃ· τῶ καί μιν ἐποιχόμενοι κομέεσκον.	-uu- - - u u-uu- uu--	dactylic hexameter	masculine penthemimeral, trithemimeral
σὺν τοῖσιν δʼ ἵκανε Παραίβιος, ὅς ῥά οἱ ἦεν	- -- uu- --uu - u u --	dactylic hexameter	masculine penthemimeral, trithemimeral
φίλτατος· ἀσπάσιος δὲ δόμοις ἔνι τούσ γʼ ἐνόησεν.	-uu -uu- u u- uu - uu--	dactylic hexameter	masculine penthemimeral, hepthemimeral
πρὶν γὰρ δή νύ ποτʼ αὐτὸς ἀριστήων στόλον ἀνδρῶν	- - - u u -u u--- uu --	dactylic hexameter	feminine penthemimeral, trithemimeral
Ἑλλάδος ἐξανιόντα μετὰ πτόλιν Αἰήταο	-uu -uu-u u- uu ----	dactylic hexameter	feminine penthemimeral, hepthemimeral
πείσματʼ ἀνάψασθαι μυθήσατο Θυνίδι γαίῃ,	-u u--- --uu -uu --	dactylic hexameter	masculine penthemimeral
οἵ τέ οἱ Ἁρπυίας Διόθεν σχήσουσιν ἰούσας.	- u u --- uu- --u u--	dactylic hexameter	masculine penthemimeral, hepthemimeral
τοὺς μὲν ἔπειτʼ ἐπέεσσιν ἀρεσσάμενος πυκινοῖσιν	- u u- uu-u u-uu- uu--	dactylic hexameter	feminine penthemimeral, trithemimeral
πέμφʼ ὁ γέρων· οἶον δὲ Παραίβιον αὐτόθι μίμνειν	- u u- -- u u-uu -uu --	dactylic hexameter	masculine penthemimeral, trithemimeral
κέκλετʼ ἀριστήεσσι σὺν ἀνδράσιν· αἶψα δὲ τόνγε	-u u---u u -uu -u u --	dactylic hexameter	feminine penthemimeral
σφωιτέρων ὀίων ὅτις ἔξοχος, εἰς ἓ κομίσσαι	-uu- uu- uu -uu - u u--	dactylic hexameter	masculine penthemimeral, trithemimeral
ἧκεν ἐποτρύνας. τοῦ δʼ ἐκ μεγάροιο κιόντος	-u u-uu - - ---u u--	dactylic hexameter	masculine penthemimeral
μειλιχίως ἐρέτῃσιν ὁμηγερέεσσι μετηύδα·	-uu- uu-u u-uu-u u--	dactylic hexameter	feminine penthemimeral, trithemimeral
‘ὦ φίλοι, οὐκ ἄρα πάντες ὑπέρβιοι ἄνδρες ἔασιν,	- uu - uu -u u-uu -u u--	dactylic hexameter	feminine penthemimeral, trithemimeral
οὐδʼ εὐεργεσίης ἀμνήμονες. ὡς καὶ ὅδʼ ἀνὴρ	- --uu- --uu - u u --	dactylic hexameter	masculine penthemimeral
τοῖος ἐὼν δεῦρʼ ἦλθεν, ἑὸν μόρον ὄφρα δαείη.	-u u- - -u u- uu -u u--	dactylic hexameter	feminine penthemimeral, hepthemimeral, trithemimeral
εὖτε γὰρ οὖν ὡς πλεῖστα κάμοι καὶ πλεῖστα μογήσαι,	-u u - - -u u- - -u u--	dactylic hexameter	feminine penthemimeral, hepthemimeral, trithemimeral
δὴ τότε μιν περιπολλὸν ἐπασσυτέρη βιότοιο	- uu - uu-u u-uu- uu--	dactylic hexameter	feminine penthemimeral, trithemimeral
χρησμοσύνη τρύχεσκεν· ἐπʼ ἤματι δʼ ἦμαρ ὀρώρει	-uu- --u u -uu -u u--	dactylic hexameter	feminine penthemimeral, trithemimeral
κύντερον, οὐδέ τις ἦεν ἀνάπνευσις μογέοντι.	-uu -u u -u u--- uu--	dactylic hexameter	feminine penthemimeral
ἀλλʼ ὅγε πατρὸς ἑοῖο κακὴν τίνεσκεν ἀμοιβὴν	- uu -u u-u u- --u u--	dactylic hexameter	feminine penthemimeral, hepthemimeral
ἀμπλακίης. ὁ γὰρ οἶος ἐν οὔρεσι δένδρεα τέμνων	-uu- u u -u u -uu -uu --	dactylic hexameter	feminine penthemimeral, trithemimeral
δή ποθʼ ἁμαδρυάδος νύμφης ἀθέριξε λιτάων,	- u u-uu- -- uu-u u--	dactylic hexameter	masculine penthemimeral, hepthemimeral
ἥ μιν ὀδυρομένη ἀδινῷ μειλίσσετο μύθῳ,	- u u-uu- uu- --uu --	dactylic hexameter	masculine penthemimeral, hepthemimeral
μὴ ταμέειν πρέμνον δρυὸς ἥλικος, ᾗ ἔπι πουλὺν	- uu- -- uu -uu - uu --	dactylic hexameter	masculine penthemimeral, trithemimeral
αἰῶνα τρίβεσκε διηνεκές· αὐτὰρ ὁ τήνγε	--- --u u-uu -u u --	dactylic hexameter	feminine penthemimeral, trithemimeral
ἀφραδέως ἔτμηξεν ἀγηνορίῃ νεότητος.	-uu- --u u-uu- uu--	dactylic hexameter	feminine penthemimeral, trithemimeral
τῷ δʼ ἄρα νηκερδῆ νύμφη πόρεν οἶτον ὀπίσσω	- uu --- -- uu -u u--	dactylic hexameter	masculine penthemimeral, hepthemimeral
αὐτῷ καὶ τεκέεσσιν. ἔγωγε μέν, εὖτʼ ἀφίκανεν,	-- - uu-u u-u u - uu--	dactylic hexameter	feminine penthemimeral, trithemimeral
ἀμπλακίην ἔγνων· βωμὸν δʼ ἐκέλευσα καμόντα	-uu- -- -- uu-u u--	dactylic hexameter	masculine penthemimeral, hepthemimeral, trithemimeral
Θυνιάδος νύμφης, λωφήια ῥέξαι ἐπʼ αὐτῷ	-uu- -- --uu -u u --	dactylic hexameter	masculine penthemimeral, trithemimeral
ἱερά, πατρῴην αἰτεύμενον αἶσαν ἀλύξαι.	-uu --- --uu -u u--	dactylic hexameter	masculine penthemimeral
ἔνθʼ ἐπεὶ ἔκφυγε κῆρα θεήλατον, οὔποτʼ ἐμεῖο	- uu -uu -u u-uu -u u--	dactylic hexameter	feminine penthemimeral
ἐκλάθετʼ, οὐδʼ ἀθέρισσε· μόλις δʼ ἀέκοντα θύραζε	-uu - uu-u u- uu-u u--	dactylic hexameter	feminine penthemimeral, hepthemimeral, trithemimeral
πέμπω, ἐπεὶ μέμονέν γε παρέμμεναι ἀσχαλόωντι.’	-u u- uu- u u-uu -uu--	dactylic hexameter	masculine penthemimeral, trithemimeral
ὧς φάτʼ Ἀγηνορίδης· ὁ δʼ ἐπισχεδὸν αὐτίκα δοιὼ	- u u-uu- u u-uu -uu --	dactylic hexameter	masculine penthemimeral
ἤλυθʼ ἄγων ποίμνηθεν ὄις. ἀνὰ δʼ ἵστατʼ Ἰήσων,	-u u- --u u- uu -u u--	dactylic hexameter	feminine penthemimeral, hepthemimeral, trithemimeral
ἂν δὲ Βορήιοι υἷες ἐφημοσύνῃσι γέροντος.	- u u-uu -u u-uu-u u--	dactylic hexameter	feminine penthemimeral
ὦκα δὲ κεκλόμενοι μαντήιον Ἀπόλλωνα	-u u -uu- --uu ----	dactylic hexameter	masculine penthemimeral
ῥέζον ἐπʼ ἐσχαρόφιν νέον ἤματος ἀνομένοιο.	-u u -uu- uu -uu -uu--	dactylic hexameter	masculine penthemimeral
κουρότεροι δʼ ἑτάρων μενοεικέα δαῖτʼ ἀλέγυνον.	-uu- uu- uu-uu - uu--	dactylic hexameter	masculine penthemimeral, trithemimeral
ἔνθʼ εὖ δαισάμενοι, τοὶ μὲν παρὰ πείσμασι νηός,	- - -uu- - - uu -uu --	dactylic hexameter	masculine penthemimeral, hepthemimeral
τοὶ δʼ αὐτοῦ κατὰ δώματʼ ἀολλέες εὐνάζοντο.	- -- uu -u u-uu ----	dactylic hexameter	feminine penthemimeral, trithemimeral
ἦρι δʼ ἐτήσιαι αὖραι ἐπέχραον, αἵ τʼ ἀνὰ πᾶσαν	-u u-uu -u u-uu - uu --	dactylic hexameter	feminine penthemimeral
γαῖαν ὁμῶς τοιῇδε Διὸς πνείουσιν ἀρωγῇ.	-u u- --u u- --u u--	dactylic hexameter	feminine penthemimeral, hepthemimeral, trithemimeral
Κυρήνη πέφαταί τις ἕλος πάρα Πηνειοῖο	--- uu- u u- uu ----	dactylic hexameter	masculine penthemimeral, hepthemimeral, trithemimeral
μῆλα νέμειν προτέροισι παρʼ ἀνδράσιν· εὔαδε γάρ οἱ	-u u- uu-u u -uu -uu - -	dactylic hexameter	feminine penthemimeral, trithemimeral
παρθενίη καὶ λέκτρον ἀκήρατον. αὐτὰρ Ἀπόλλων	-uu- - -u u-uu -u u--	dactylic hexameter	feminine penthemimeral, trithemimeral
τήν γʼ ἀνερεψάμενος ποταμῷ ἔπι ποιμαίνουσαν	- uu-uu- uu- uu ----	dactylic hexameter	masculine penthemimeral, hepthemimeral
τηλόθεν Αἱμονίης, χθονίῃς παρακάτθετο νύμφαις,	-uu -uu- uu- uu-uu --	dactylic hexameter	masculine penthemimeral, hepthemimeral
αἳ Λιβύην ἐνέμοντο παραὶ Μυρτώσιον αἶπος.	- uu- uu-u u- --uu --	dactylic hexameter	feminine penthemimeral, hepthemimeral, trithemimeral
ἔνθα δʼ Ἀρισταῖον Φοίβῳ τέκεν, ὃν καλέουσιν	-u u--- -- uu - uu--	dactylic hexameter	masculine penthemimeral, hepthemimeral
Ἀγρέα καὶ Νόμιον πολυλήιοι Αἱμονιῆες.	-uu - uu- uu-uu -uu--	dactylic hexameter	masculine penthemimeral, trithemimeral
τὴν μὲν γὰρ φιλότητι θεὸς ποιήσατο νύμφην	- - - uu-u u- --uu --	dactylic hexameter	feminine penthemimeral, hepthemimeral, trithemimeral
αὐτοῦ μακραίωνα καὶ ἀγρότιν· υἷα δʼ ἔνεικεν	-- ---u u -uu -u u--	dactylic hexameter	feminine penthemimeral
νηπίαχον Χείρωνος ὑπʼ ἄντροισιν κομέεσθαι.	-uu- --u u --- uu--	dactylic hexameter	feminine penthemimeral, trithemimeral
τῷ καὶ ἀεξηθέντι θεαὶ γάμον ἐμνήστευσαν	- u u---u u- uu ----	dactylic hexameter	feminine penthemimeral, hepthemimeral
Μοῦσαι, ἀκεστορίην τε θεοπροπίας τʼ ἐδίδαξαν·	-u u-uu- u u-uu- uu--	dactylic hexameter	masculine penthemimeral
καί μιν ἑῶν μήλων θέσαν ἤρανον, ὅσσʼ ἐνέμοντο	- u u- -- uu -uu - uu--	dactylic hexameter	masculine penthemimeral, trithemimeral
ἂμ πεδίον Φθίης Ἀθαμάντιον ἀμφί τʼ ἐρυμνὴν	- uu- -- uu-uu -u u--	dactylic hexameter	masculine penthemimeral, trithemimeral
Ὄθρυν καὶ ποταμοῦ ἱερὸν ῥόον Ἀπιδανοῖο.	-- - uu- uu- uu -uu--	dactylic hexameter	masculine penthemimeral, hepthemimeral, trithemimeral
ἦμος δʼ οὐρανόθεν Μινωίδας ἔφλεγε νήσους	-- -uu- --uu -uu --	dactylic hexameter	masculine penthemimeral
Σείριος, οὐδʼ ἐπὶ δηρὸν ἔην ἄκος ἐνναέτῃσιν,	-uu - uu -u u- uu -uu--	dactylic hexameter	feminine penthemimeral, hepthemimeral, trithemimeral
τῆμος τόν γʼ ἐκάλεσσαν ἐφημοσύναις Ἑκάτοιο	-- - uu-u u-uu- uu--	dactylic hexameter	feminine penthemimeral, trithemimeral
λοιμοῦ ἀλεξητῆρα. λίπεν δʼ ὅγε πατρὸς ἐφετμῇ	-u u---u u- uu -u u--	dactylic hexameter	feminine penthemimeral, hepthemimeral
Φθίην, ἐν δὲ Κέῳ κατενάσσατο, λαὸν ἀγείρας	-- - u u- uu-uu -u u--	dactylic hexameter	masculine penthemimeral, trithemimeral
Παρράσιον, τοίπερ τε Λυκάονός εἰσι γενέθλης,	-uu- -- u u-uu -u u--	dactylic hexameter	masculine penthemimeral, trithemimeral
καὶ βωμὸν ποίησε μέγαν Διὸς Ἰκμαίοιο,	- -- --u u- uu ----	dactylic hexameter	feminine penthemimeral, hepthemimeral, trithemimeral
ἱερά τʼ εὖ ἔρρεξεν ἐν οὔρεσιν ἀστέρι κείνῳ	-uu - --u u -uu -uu --	dactylic hexameter	feminine penthemimeral, trithemimeral
Σειρίῳ αὐτῷ τε Κρονίδῃ Διί. τοῖο δʼ ἕκητι	-uu -- - uu- uu -u u--	dactylic hexameter	masculine penthemimeral, hepthemimeral
γαῖαν ἐπιψύχουσιν ἐτήσιαι ἐκ Διὸς αὖραι	-u u---u u-uu - uu --	dactylic hexameter	feminine penthemimeral
ἤματα τεσσαράκοντα· Κέῳ δʼ ἔτι νῦν ἱερῆες	-uu -uu-u u- uu - uu--	dactylic hexameter	feminine penthemimeral, hepthemimeral
ἀντολέων προπάροιθε Κυνὸς ῥέζουσι θυηλάς.	-uu- uu-u u- --u u--	dactylic hexameter	feminine penthemimeral, hepthemimeral, trithemimeral
καὶ τὰ μὲν ὧς ὑδέονται· ἀριστῆες δὲ καταῦθι	- u u - uu-u u--- u u--	dactylic hexameter	feminine penthemimeral, trithemimeral
μίμνον ἐρυκόμενοι· ξεινήια δʼ ἄσπετα Θυνοὶ	-u u-uu- --uu -uu --	dactylic hexameter	masculine penthemimeral
πᾶν ἦμαρ Φινῆι χαριζόμενοι προΐαλλον.	- -- --u u-uu- uu--	dactylic hexameter	feminine penthemimeral, trithemimeral
ἐκ δὲ τόθεν μακάρεσσι δυώδεκα δωμήσαντες	- u u- uu-u u-uu ----	dactylic hexameter	feminine penthemimeral, trithemimeral
βωμὸν ἁλὸς ῥηγμῖνι πέρην καὶ ἐφʼ ἱερὰ θέντες,	-u u- --u u- u u -uu --	dactylic hexameter	feminine penthemimeral, hepthemimeral, trithemimeral
νῆα θοὴν εἴσβαινον ἐρεσσέμεν, οὐδὲ πελείης	-u u- --u u-uu -u u--	dactylic hexameter	feminine penthemimeral, trithemimeral
τρήρωνος λήθοντο μετὰ σφίσιν· ἀλλʼ ἄρα τήνγε	--- --u u- uu - uu --	dactylic hexameter	feminine penthemimeral, hepthemimeral, trithemimeral
δείματι πεπτηυῖαν ἑῇ φέρε χειρὶ μεμαρπὼς	-uu ---- -- uu -u u--	lyric	
Εὔφημος, γαίης δʼ ἀπὸ διπλόα πείσματʼ ἔλυσαν.	--- -- uu -uu -u u--	dactylic hexameter	masculine penthemimeral, trithemimeral
οὐδʼ ἄρʼ Ἀθηναίην προτέρω λάθον ὁρμηθέντες·	- u u--- uu- uu ----	dactylic hexameter	masculine penthemimeral, hepthemimeral
αὐτίκα δʼ ἐσσυμένως νεφέλης ἐπιβᾶσα πόδεσσιν	-uu -uu- uu- uu-u u--	dactylic hexameter	masculine penthemimeral, hepthemimeral
κούφης, ἥ κε φέροι μιν ἄφαρ βριαρήν περ ἐοῦσαν,	-- - u u- u u- uu- u u--	dactylic hexameter	masculine penthemimeral, hepthemimeral, trithemimeral
σεύατʼ ἴμεν πόντονδε, φίλα φρονέουσʼ ἐρέτῃσιν.	-u u- --u u- uu- uu--	dactylic hexameter	feminine penthemimeral, hepthemimeral, trithemimeral
ὡς δʼ ὅτε τις πάτρηθεν ἀλώμενος, οἷά τε πολλὰ	- uu - --u u-uu -u u --	dactylic hexameter	feminine penthemimeral, trithemimeral
πλαζόμεθʼ ἄνθρωποι τετληότες, οὐδέ τις αἶα	-uu --- --uu -u u --	dactylic hexameter	masculine penthemimeral
τηλουρός, πᾶσαι δὲ κατόψιοί εἰσι κέλευθοι,	--- -- u u-uu -u u--	dactylic hexameter	masculine penthemimeral, trithemimeral
σφωιτέρους δʼ ἐνόησε δόμους, ἄμυδις δὲ κέλευθος	-uu- uu-u u- uu- u u--	dactylic hexameter	feminine penthemimeral, hepthemimeral, trithemimeral
ὑγρή τε τραφερή τʼ ἰνδάλλεται, ἄλλοτε δʼ ἄλλῃ	-- - uu- --uu -uu --	dactylic hexameter	masculine penthemimeral, trithemimeral
ὀξέα πορφύρων ἐπιμαίεται ὀφθαλμοῖσιν·	-uu --- uu-uu ----	dactylic hexameter	masculine penthemimeral
ὧς ἄρα καρπαλίμως κούρη Διὸς ἀίξασα	- uu -uu- -- uu ----	dactylic hexameter	masculine penthemimeral, hepthemimeral
θῆκεν ἐπʼ ἀξείνοιο πόδας Θυνηίδος ἀκτῆς.	-u u ---u u- --uu --	dactylic hexameter	feminine penthemimeral, hepthemimeral
οἱ δʼ ὅτε δὴ σκολιοῖο πόρου στεινωπὸν ἵκοντο	- uu - uu-u u- --u u--	dactylic hexameter	feminine penthemimeral, hepthemimeral, trithemimeral
τρηχείῃς σπιλάδεσσιν ἐεργμένον ἀμφοτέρωθεν,	--- uu-u u-uu -uu--	dactylic hexameter	feminine penthemimeral, trithemimeral
δινήεις δʼ ὑπένερθεν ἀνακλύζεσκεν ἰοῦσαν	--- uu-u u---u u--	dactylic hexameter	feminine penthemimeral, trithemimeral
νῆα ῥόος, πολλὸν δὲ φόβῳ προτέρωσε νέοντο,	-u u- -- u u- uu-u u--	dactylic hexameter	masculine penthemimeral, hepthemimeral, trithemimeral
ἤδη δέ σφισι δοῦπος ἀρασσομένων πετράων	-- - uu -u u-uu- ---	dactylic hexameter	feminine penthemimeral, trithemimeral
νωλεμὲς οὔατʼ ἔβαλλε, βόων δʼ ἁλιμυρέες ἀκταί,	-uu -u u-u u- uu-uu --	dactylic hexameter	feminine penthemimeral, hepthemimeral
δὴ τότʼ ἔπειθʼ ὁ μὲν ὦρτο πελειάδα χειρὶ μεμαρπὼς	- u u- u u -u u-uu -u u--	dactylic hexameter	feminine penthemimeral, trithemimeral
Εὔφημος πρῴρης ἐπιβήμεναι· οἱ δʼ ὑπʼ ἀνωγῇ	--- -- uu-uu - u u--	dactylic hexameter	masculine penthemimeral, trithemimeral
Τίφυος Ἁγνιάδαο θελήμονα ποιήσαντο	-uu -uu-u u-uu ----	dactylic hexameter	feminine penthemimeral
εἰρεσίην, ἵνʼ ἔπειτα διὲκ πέτρας ἐλάσειαν,	-uu- u u-u u- -- uu--	dactylic hexameter	feminine penthemimeral, hepthemimeral, trithemimeral
κάρτεϊ ᾧ πίσυνοι. τὰς δʼ αὐτίκα λοίσθιον ἄλλων	-uu - uu- - -uu -uu --	dactylic hexameter	masculine penthemimeral, trithemimeral
οἰγομένας ἀγκῶνα περιγνάμψαντες ἴδοντο.	-uu- --u u---u u--	dactylic hexameter	feminine penthemimeral, trithemimeral
σὺν δέ σφιν χύτο θυμός· ὁ δʼ ἀίξαι πτερύγεσσιν	- - - uu -u u --- uu--	dactylic hexameter	feminine penthemimeral, trithemimeral
Εὔφημος προέηκε πελειάδα· τοὶ δʼ ἅμα πάντες	--- uu-u u-uu - uu --	dactylic hexameter	feminine penthemimeral, trithemimeral
ἤειραν κεφαλὰς ἐσορώμενοι· ἡ δὲ διʼ αὐτῶν	--- uu- uu-uu - u u --	dactylic hexameter	masculine penthemimeral, trithemimeral
ἔπτατο· ταὶ δʼ ἄμυδις πάλιν ἀντίαι ἀλλήλῃσιν	-uu - uu- uu -uu ----	dactylic hexameter	masculine penthemimeral, trithemimeral
ἄμφω ὁμοῦ ξυνιοῦσαι ἐπέκτυπον. ὦρτο δὲ πολλὴ	-u u- uu-u u-uu -u u --	dactylic hexameter	feminine penthemimeral, trithemimeral
ἅλμη ἀναβρασθεῖσα, νέφος ὥς· αὖε δὲ πόντος	-u u---u u- - -u u --	dactylic hexameter	feminine penthemimeral, hepthemimeral
σμερδαλέον· πάντῃ δὲ περὶ μέγας ἔβρεμεν αἰθήρ.	-uu- -- u u- uu -uu --	dactylic hexameter	masculine penthemimeral, hepthemimeral, trithemimeral
κοῖλαι δὲ σπήλυγγες ὑπὸ σπιλάδας τρηχείας	-- - --u u- uu- ---	dactylic hexameter	feminine penthemimeral, hepthemimeral, trithemimeral
κλυζούσης ἁλὸς ἔνδον ἐβόμβεον· ὑψόθι δʼ ὄχθης	--- uu -u u-uu -uu --	dactylic hexameter	feminine penthemimeral, trithemimeral
λευκὴ καχλάζοντος ἀνέπτυε κύματος ἄχνη.	-- ---u u-uu -uu --	dactylic hexameter	feminine penthemimeral
νῆα δʼ ἔπειτα πέριξ εἴλει ῥόος. ἄκρα δʼ ἔκοψαν	-u u-u u- -- uu -u u--	dactylic hexameter	masculine penthemimeral, hepthemimeral
οὐραῖα πτερὰ ταίγε πελειάδος· ἡ δʼ ἀπόρουσεν	--- uu -u u-uu - uu--	dactylic hexameter	feminine penthemimeral, trithemimeral
ἀσκηθής. ἐρέται δὲ μέγʼ ἴαχον· ἔβραχε δʼ αὐτὸς	--- uu- u u -uu -uu --	dactylic hexameter	masculine penthemimeral, trithemimeral
Τῖφυς ἐρεσσέμεναι κρατερῶς. οἴγοντο γὰρ αὖτις	-u u-uu- uu- --u u --	dactylic hexameter	masculine penthemimeral, hepthemimeral
ἄνδιχα. τοὺς δʼ ἐλάοντας ἔχεν τρόμος, ὄφρα μιν αὐτὴ	-uu - uu-u u- uu -u u --	dactylic hexameter	feminine penthemimeral, hepthemimeral, trithemimeral
πλημμυρὶς παλίνορσος ἀνερχομένη κατένεικεν	--- uu-u u-uu- uu--	dactylic hexameter	feminine penthemimeral, trithemimeral
εἴσω πετράων. τότε δʼ αἰνότατον δέος εἷλεν	-- --- uu -uu- uu --	dactylic hexameter	masculine penthemimeral
πάντας· ὑπὲρ κεφαλῆς γὰρ ἀμήχανος ἦεν ὄλεθρος.	-u u- uu- u u-uu -u u--	dactylic hexameter	masculine penthemimeral, trithemimeral
ἤδη δʼ ἔνθα καὶ ἔνθα διὰ πλατὺς εἴδετο Πόντος,	-- -u u -u u- uu -uu --	dactylic hexameter	feminine penthemimeral, hepthemimeral
καί σφισιν ἀπροφάτως ἀνέδυ μέγα κῦμα πάροιθεν	- uu -uu- uu- uu -u u--	dactylic hexameter	masculine penthemimeral, hepthemimeral
κυρτόν, ἀποτμῆγι σκοπιῇ ἴσον· οἱ δʼ ἐσιδόντες	-u u--- uu- uu - uu--	dactylic hexameter	masculine penthemimeral, hepthemimeral
ἤμυσαν λοξοῖσι καρήασιν. εἴσατο γάρ ῥα	--- --u u-uu -uu - -	dactylic hexameter	feminine penthemimeral, trithemimeral
νηὸς ὑπὲρ πάσης κατεπάλμενον ἀμφικαλύψειν.	-u u- -- uu-uu -uu--	dactylic hexameter	masculine penthemimeral, trithemimeral
ἀλλά μιν ἔφθη Τῖφυς ὑπʼ εἰρεσίῃ βαρύθουσαν	-u u -- -u u -uu- uu--	dactylic hexameter	feminine penthemimeral
ἀγχαλάσας· τὸ δὲ πολλὸν ὑπὸ τρόπιν ἐξεκυλίσθη,	-uu- u u -u u- uu -uu--	dactylic hexameter	feminine penthemimeral, hepthemimeral, trithemimeral
ἐκ δʼ αὐτὴν πρύμνηθεν ἀνείρυσε τηλόθι νῆα	- -- --u u-uu -uu --	dactylic hexameter	feminine penthemimeral, trithemimeral
πετράων· ὑψοῦ δὲ μεταχρονίη πεφόρητο.	--- -- u u-uu- uu--	dactylic hexameter	masculine penthemimeral, trithemimeral
Εὔφημος δʼ ἀνὰ πάντας ἰὼν βοάασκεν ἑταίρους,	--- uu -u u- uu-u u--	dactylic hexameter	feminine penthemimeral, hepthemimeral, trithemimeral
ἐμβαλέειν κώπῃσιν ὅσον σθένος· οἱ δʼ ἀλαλητῷ	-uu- --u u- uu - uu--	dactylic hexameter	feminine penthemimeral, hepthemimeral, trithemimeral
κόπτον ὕδωρ. ὅσσον δʼ ἂν ὑπείκαθε νηῦς ἐρέτῃσιν,	-u u- -- u u-uu - uu--	dactylic hexameter	masculine penthemimeral, trithemimeral
δὶς τόσον ἂψ ἀπόρουσεν· ἐπεγνάμπτοντο δὲ κῶπαι	- uu - uu-u u---u u --	dactylic hexameter	feminine penthemimeral, trithemimeral
ἠύτε καμπύλα τόξα, βιαζομένων ἡρώων.	-uu -uu -u u-uu- ---	dactylic hexameter	feminine penthemimeral
ἔνθεν δʼ αὐτίκʼ ἔπειτα κατηρεφὲς ἔσσυτο κῦμα,	-- -u u-u u-uu -uu --	dactylic hexameter	feminine penthemimeral
ἡ δʼ ἄφαρ ὥστε κύλινδρος ἐπέτρεχε κύματι λάβρῳ	- uu -u u-u u-uu -uu --	dactylic hexameter	feminine penthemimeral
προπροκαταΐγδην κοίλης ἁλός. ἐν δʼ ἄρα μέσσαις	-uu--- -- uu - uu --	dactylic hexameter	masculine penthemimeral, hepthemimeral
Πληγάσι δινήεις εἶχεν ῥόος· αἱ δʼ ἑκάτερθεν	-uu --- -- uu - uu--	dactylic hexameter	masculine penthemimeral, hepthemimeral
σειόμεναι βρόμεον· πεπέδητο δὲ νήια δοῦρα.	-uu- uu- uu-u u -uu --	dactylic hexameter	masculine penthemimeral, trithemimeral
καὶ τότʼ Ἀθηναίη στιβαρῆς ἀντέσπασε πέτρης	- u u--- uu- --uu --	dactylic hexameter	masculine penthemimeral, hepthemimeral
σκαιῇ, δεξιτερῇ δὲ διαμπερὲς ὦσε φέρεσθαι.	-- -uu- u u-uu -u u--	dactylic hexameter	masculine penthemimeral
ἡ δʼ ἰκέλη πτερόεντι μετήορος ἔσσυτʼ ὀιστῷ.	- uu- uu-u u-uu -u u--	dactylic hexameter	feminine penthemimeral, trithemimeral
ἔμπης δʼ ἀφλάστοιο παρέθρισαν ἄκρα κόρυμβα	-- ---u u-uu -u u--	dactylic hexameter	feminine penthemimeral
νωλεμὲς ἐμπλήξασαι ἐναντίαι. αὐτὰρ Ἀθήνη	-uu ---u u-uu -u u--	dactylic hexameter	feminine penthemimeral
Οὔλυμπόνδʼ ἀνόρουσεν, ὅτʼ ἀσκηθεῖς ὑπάλυξαν.	--- uu-u u --- uu--	dactylic hexameter	feminine penthemimeral, trithemimeral
πέτραι δʼ εἰς ἕνα χῶρον ἐπισχεδὸν ἀλλήλῃσιν	-- - uu -u u-uu ----	dactylic hexameter	feminine penthemimeral, trithemimeral
νωλεμὲς ἐρρίζωθεν, ὃ δὴ καὶ μόρσιμον ἦεν	-uu ---u u - - -uu --	dactylic hexameter	feminine penthemimeral, hepthemimeral
ἐκ μακάρων, εὖτʼ ἄν τις ἰδὼν διὰ νηὶ περήσῃ.	- uu- - - u u- uu -u u--	dactylic hexameter	masculine penthemimeral, hepthemimeral, trithemimeral
οἱ δέ που ὀκρυόεντος ἀνέπνεον ἄρτι φόβοιο	- u u -uu-u u-uu -u u--	dactylic hexameter	feminine penthemimeral
ἠέρα παπταίνοντες ὁμοῦ πέλαγός τε θαλάσσης	-uu ---u u- uu- u u--	dactylic hexameter	feminine penthemimeral, hepthemimeral
τῆλʼ ἀναπεπτάμενον. δὴ γὰρ φάσαν ἐξ Ἀίδαο	- uu-uu- - - uu - uu--	dactylic hexameter	masculine penthemimeral, hepthemimeral
σώεσθαι· Τῖφυς δὲ παροίτατος ἤρχετο μύθων·	--- -- u u-uu -uu --	dactylic hexameter	masculine penthemimeral, trithemimeral
‘ἔλπομαι αὐτῇ νηὶ τό γʼ ἔμπεδον ἐξαλέασθαι	-uu -- -u u -uu -uu--	dactylic hexameter	feminine penthemimeral
ἡμέας· οὐδέ τις ἄλλος ἐπαίτιος, ὅσσον Ἀθήνη,	-uu -u u -u u-uu -u u--	dactylic hexameter	feminine penthemimeral
ἥ οἱ ἐνέπνευσεν θεῖον μένος, εὖτέ μιν Ἄργος	- u u--- -- uu -u u --	dactylic hexameter	masculine penthemimeral, hepthemimeral
γόμφοισιν συνάρασσε· θέμις δʼ οὐκ ἔστιν ἁλῶναι.	--- uu-u u- - -u u--	dactylic hexameter	feminine penthemimeral, hepthemimeral, trithemimeral
Αἰσονίδη, τύνη δὲ τεοῦ βασιλῆος ἐφετμήν,	-uu- -- u u- uu-u u--	dactylic hexameter	masculine penthemimeral, hepthemimeral, trithemimeral
εὖτε διὲκ πέτρας φυγέειν θεὸς ἧμιν ὄπασσεν,	-u u- -- uu- uu -u u--	dactylic hexameter	masculine penthemimeral, hepthemimeral, trithemimeral
μηκέτι δείδιθι τοῖον· ἐπεὶ μετόπισθεν ἀέθλους	-uu -uu -u u- uu-u u--	dactylic hexameter	feminine penthemimeral, hepthemimeral
εὐπαλέας τελέεσθαι Ἀγηνορίδης φάτο Φινεύς.’	-uu- uu-u u-uu- uu --	dactylic hexameter	feminine penthemimeral, trithemimeral
ἦ ῥʼ ἅμα, καὶ προτέρωσε παραὶ Βιθυνίδα γαῖαν	- uu - uu-u u- --uu --	dactylic hexameter	feminine penthemimeral, hepthemimeral, trithemimeral
νῆα διὲκ πέλαγος σεῦεν μέσον. αὐτὰρ ὁ τόνγε	-u u- uu- -- uu -u u --	dactylic hexameter	masculine penthemimeral, hepthemimeral, trithemimeral
μειλιχίοις ἐπέεσσι παραβλήδην προσέειπεν·	-uu- uu-u u--- uu--	dactylic hexameter	feminine penthemimeral, trithemimeral
‘Τῖφυ, τίη μοι ταῦτα παρηγορέεις ἀχέοντι;	-u u- - -u u-uu- uu--	dactylic hexameter	feminine penthemimeral, trithemimeral
ἤμβροτον ἀασάμην τε κακὴν καὶ ἀμήχανον ἄτην.	-uu -uu- u u- u u-uu --	dactylic hexameter	masculine penthemimeral, hepthemimeral
χρῆν γὰρ ἐφιεμένοιο καταντικρὺ Πελίαο	- u u-uu-u u--- uu--	dactylic hexameter	feminine penthemimeral
αὐτίκʼ ἀνήνασθαι τόνδε στόλον, εἰ καὶ ἔμελλον	-u u--- -- uu - u u--	dactylic hexameter	masculine penthemimeral, hepthemimeral
νηλειῶς μελεϊστὶ κεδαιόμενος θανέεσθαι·	--- uu-u u-uu- uu--	dactylic hexameter	feminine penthemimeral, trithemimeral
νῦν δὲ περισσὸν δεῖμα καὶ ἀτλήτους μελεδῶνας	- u u-- -u u --- uu--	dactylic hexameter	feminine penthemimeral
ἄγκειμαι, στυγέων μὲν ἁλὸς κρυόεντα κέλευθα	--- uu- u u- uu-u u--	dactylic hexameter	masculine penthemimeral, hepthemimeral, trithemimeral
νηὶ διαπλώειν, στυγέων δʼ ,ὅτʼ ἐπʼ ἠπείροιο	-u u--- uu- u u ----	dactylic hexameter	masculine penthemimeral, hepthemimeral
βαίνωμεν. πάντῃ γὰρ ἀνάρσιοι ἄνδρες ἔασιν.	--- -- u u-uu -u u--	dactylic hexameter	masculine penthemimeral, trithemimeral
αἰεὶ δὲ στονόεσσαν ἐπʼ ἤματι νύκτα φυλάσσω,	-- - uu-u u -uu -u u--	dactylic hexameter	feminine penthemimeral, trithemimeral
ἐξότε τὸ πρώτιστον ἐμὴν χάριν ἠγερέθεσθε,	-uu - --u u- uu -uu--	dactylic hexameter	feminine penthemimeral, hepthemimeral, trithemimeral
φραζόμενος τὰ ἕκαστα σὺ δʼ εὐμαρέως ἀγορεύεις	-uu- u u-u u -uu- uu--	dactylic hexameter	feminine penthemimeral, trithemimeral
οἶον ἑῆς ψυχῆς ἀλέγων ὕπερ· αὐτὰρ ἔγωγε	-u u- -- uu- uu -u u--	dactylic hexameter	masculine penthemimeral, hepthemimeral, trithemimeral
εἷο μὲν οὐδʼ ἠβαιὸν ἀτύζομαι· ἀμφὶ δὲ τοῖο	-u u - --u u-uu -u u --	dactylic hexameter	feminine penthemimeral, trithemimeral
καὶ τοῦ ὁμῶς, καὶ σεῖο, καὶ ἄλλων δείδιʼ ἑταίρων	- u u- - -u u -- -u u--	dactylic hexameter	feminine penthemimeral, trithemimeral
εἰ μὴ ἐς Ἑλλάδα γαῖαν ἀπήμονας ὔμμε κομίσσω.’	- u u -uu -u u-uu -u u--	dactylic hexameter	feminine penthemimeral
ὧς φάτʼ ἀριστήων πειρώμενος· οἱ δʼ ὁμάδησαν	- u u--- --uu - uu--	dactylic hexameter	masculine penthemimeral
θαρσαλέοις ἐπέεσσιν. ὁ δὲ φρένας ἔνδον ἰάνθη	-uu- uu-u u - uu -u u--	dactylic hexameter	feminine penthemimeral, hepthemimeral, trithemimeral
κεκλομένων, καί ῥʼ αὖτις ἐπιρρήδην μετέειπεν·	-uu- - -u u--- uu--	dactylic hexameter	feminine penthemimeral, trithemimeral
‘ὦ φίλοι, ὑμετέρῃ ἀρετῇ ἔνι θάρσος ἀέξω.	- uu -uu- uu- uu -u u--	dactylic hexameter	masculine penthemimeral, hepthemimeral
τούνεκα νῦν οὐδʼ εἴ κε διὲξ Ἀίδαο βερέθρων	-uu - - - u u- uu-u u--	dactylic hexameter	masculine penthemimeral, hepthemimeral, trithemimeral
στελλοίμην, ἔτι τάρβος ἀνάψομαι, εὖτε πέλεσθε	--- uu -u u-uu -u u--	dactylic hexameter	feminine penthemimeral, trithemimeral
ἔμπεδοι ἀργαλέοις ἐνὶ δείμασιν. ἀλλʼ ὅτε πέτρας	-uu -uu- uu -uu - uu --	dactylic hexameter	masculine penthemimeral
Πληγάδας ἐξέπλωμεν, ὀίομαι οὐκ ἔτʼ ὀπίσσω	-uu ---u u-uu - u u--	dactylic hexameter	feminine penthemimeral
ἔσσεσθαι τοιόνδʼ ἕτερον φόβον, εἰ ἐτεόν γε	--- -- uu- uu - uu- -	dactylic hexameter	masculine penthemimeral, hepthemimeral, trithemimeral
φραδμοσύνῃ Φινῆος ἐπισπόμενοι νεόμεσθα.’	-uu- --u u-uu- uu--	dactylic hexameter	feminine penthemimeral, trithemimeral
ὧς φάτο, καὶ τοίων μὲν ἐλώφεον αὐτίκα μύθων,	- uu - -- u u-uu -uu --	dactylic hexameter	masculine penthemimeral, trithemimeral
εἰρεσίῃ δʼ ἀλίαστον ἔχον πόνον· αἶψα δὲ τοίγε	-uu- uu-u u- uu -u u --	dactylic hexameter	feminine penthemimeral, hepthemimeral, trithemimeral
Ῥήβαν ὠκυρόην ποταμὸν σκόπελόν τε Κολώνης,	-- -uu- uu- uu- u u--	dactylic hexameter	masculine penthemimeral, hepthemimeral
ἄκρην δʼ οὐ μετὰ δηθὰ παρεξενέοντο Μέλαιναν,	-- - uu -u u-uu-u u--	dactylic hexameter	feminine penthemimeral, trithemimeral
τῇ δʼ ἄρʼ ἐπὶ προχοὰς Φυλληίδας, ἔνθα πάροιθεν	- u u- uu- --uu -u u--	dactylic hexameter	masculine penthemimeral, trithemimeral
Διψακὸς υἷʼ Ἀθάμαντος ἑοῖς ὑπέδεκτο δόμοισιν,	-uu - uu-u u- uu-u u--	dactylic hexameter	feminine penthemimeral, hepthemimeral, trithemimeral
ὁππόθʼ ἅμα κριῷ φεῦγεν πόλιν Ὀρχομενοῖο·	-u u- -- -- uu -uu--	dactylic hexameter	masculine penthemimeral, hepthemimeral, trithemimeral
τίκτε δέ μιν νύμφη λειμωνιάς· οὐδέ οἱ ὕβρις	-u u - -- --uu -u u --	dactylic hexameter	masculine penthemimeral, trithemimeral
ἥνδανεν, ἀλλʼ ἐθελημὸς ἐφʼ ὕδασι πατρὸς ἑοῖο	-uu - uu-u u -uu -u u--	dactylic hexameter	feminine penthemimeral, trithemimeral
μητέρι συνναίεσκεν ἐπάκτια πώεα φέρβων.	-uu ---u u-uu -uu --	dactylic hexameter	feminine penthemimeral
τοῦ μέν θ᾽ἱερὸν αἶψα, καὶ εὐρείας ποταμοῖο	- - -uu -u u --- uu--	dactylic hexameter	feminine penthemimeral
ἠιόνας πεδίον τε, βαθυρρείοντά τε Κάλπην	-uu- uu- u u---u u --	dactylic hexameter	masculine penthemimeral, trithemimeral
δερκόμενοι παράμειβον, ὁμῶς δʼ ἐπὶ ἤματι νύκτα	-uu- uu-u u- uu -uu --	dactylic hexameter	feminine penthemimeral, hepthemimeral, trithemimeral
νήνεμον ἀκαμάτῃσιν ἐπερρώοντʼ ἐλάτῃσιν.	-uu -uu-u u--- uu--	dactylic hexameter	feminine penthemimeral
οἷον δὲ πλαδόωσαν ἐπισχίζοντες ἄρουραν	-- - uu-u u---u u--	dactylic hexameter	feminine penthemimeral, trithemimeral
ἐργατίναι μογέουσι βόες, περὶ δʼ ἄσπετος ἱδρὼς	-uu- uu-u u- uu -uu --	dactylic hexameter	feminine penthemimeral, hepthemimeral, trithemimeral
εἴβεται ἐκ λαγόνων τε καὶ αὐχένος· ὄμματα δέ σφιν	-uu - uu- u u -uu -uu - -	dactylic hexameter	masculine penthemimeral, trithemimeral
λοξὰ παραστρωφῶνται ὑπὸ ζυγοῦ· αὐτὰρ ἀυτμὴ	-u u---u u- uu -u u--	dactylic hexameter	feminine penthemimeral, hepthemimeral
αὐαλέη στομάτων ἄμοτον βρέμει· οἱ δʼ ἐνὶ γαίῃ	-uu- uu- uu- uu - uu --	dactylic hexameter	masculine penthemimeral, hepthemimeral, trithemimeral
χηλὰς σκηρίπτοντε πανημέριοι πονέονται.	-- ---u u-uu- uu--	dactylic hexameter	feminine penthemimeral
τοῖς ἴκελοι ἥρωες ὑπὲξ ἁλὸς εἷλκον ἐρετμά.	- uu- --u u- uu -u u--	dactylic hexameter	feminine penthemimeral, hepthemimeral, trithemimeral
ἦμος δʼ οὔτʼ ἄρ πω φάος ἄμβροτον, οὔτʼ ἔτι λίην	-- - - - uu -uu - uu --	dactylic hexameter	masculine penthemimeral, trithemimeral
ὀρφναίη πέλεται, λεπτὸν δʼ ἐπιδέδρομε νυκτὶ	--- uu- -- uu-uu --	dactylic hexameter	masculine penthemimeral, hepthemimeral, trithemimeral
φέγγος, ὅτʼ ἀμφιλύκην μιν ἀνεγρόμενοι καλέουσιν,	-u u -uu- u u-uu- uu--	dactylic hexameter	masculine penthemimeral
τῆμος ἐρημαίης νήσου λιμένʼ εἰσελάσαντες	-u u--- -- uu -uu--	dactylic hexameter	masculine penthemimeral, hepthemimeral
Θυνιάδος, καμάτῳ πολυπήμονι βαῖνον ἔραζε.	-uu- uu- uu-uu -u u--	dactylic hexameter	masculine penthemimeral, trithemimeral
τοῖσι δὲ Λητοῦς υἱός, ἀνερχόμενος Λυκίηθεν	-u u -- -u u-uu- uu--	dactylic hexameter	feminine penthemimeral
τῆλʼ ἐπʼ ἀπείρονα δῆμον Ὑπερβορέων ἀνθρώπων,	- u u-uu -u u-uu- ---	dactylic hexameter	feminine penthemimeral
ἐξεφάνη· χρύσεοι δὲ παρειάων ἑκάτερθεν	-uu- uu- u u--- uu--	dactylic hexameter	masculine penthemimeral, trithemimeral
πλοχμοὶ βοτρυόεντες ἐπερρώοντο κιόντι·	-- -uu-u u---u u--	dactylic hexameter	feminine penthemimeral
λαιῇ δʼ ἀργύρεον νώμα βιόν, ἀμφὶ δὲ νώτοις	-- -uu- -- uu -u u --	dactylic hexameter	masculine penthemimeral, hepthemimeral
ἰοδόκη τετάνυστο κατωμαδόν· ἡ δʼ ὑπὸ ποσσὶν	-uu- uu-u u-uu - uu --	dactylic hexameter	feminine penthemimeral, trithemimeral
σείετο νῆσος ὅλη, κλύζεν δʼ ἐπὶ κύματα χέρσῳ.	-uu -u u- -- uu -uu --	dactylic hexameter	masculine penthemimeral, hepthemimeral
τοὺς δʼ ἕλε θάμβος ἰδόντας ἀμήχανον· οὐδέ τις ἔτλη	- uu -u u-u u-uu -u u --	dactylic hexameter	feminine penthemimeral
ἀντίον αὐγάσσασθαι ἐς ὄμματα καλὰ θεοῖο.	-uu ---u u -uu -u u--	dactylic hexameter	feminine penthemimeral
στὰν δὲ κάτω νεύσαντες ἐπὶ χθονός· αὐτὰρ ὁ τηλοῦ	- u u- --u u- uu -u u --	dactylic hexameter	feminine penthemimeral, hepthemimeral, trithemimeral
βῆ ῥʼ ἴμεναι πόντονδε διʼ ἠέρος· ὀψὲ δὲ τοῖον	- uu- --u u -uu -u u --	dactylic hexameter	feminine penthemimeral, trithemimeral
Ὀρφεὺς ἔκφατο μῦθον ἀριστήεσσι πιφαύσκων·	-- -uu -u u---u u--	dactylic hexameter	feminine penthemimeral
‘εἰ δʼ ἄγε δὴ νῆσον μὲν Ἑωίου Ἀπόλλωνος	- uu - -- u u-uu ----	dactylic hexameter	masculine penthemimeral, trithemimeral
τήνδʼ ἱερὴν κλείωμεν, ἐπεὶ πάντεσσι φαάνθη	- uu- --u u- --u u--	dactylic hexameter	feminine penthemimeral, hepthemimeral, trithemimeral
ἠῷος μετιών· τὰ δὲ ῥέξομεν οἷα πάρεστιν,	--- uu- u u -uu -u u--	dactylic hexameter	masculine penthemimeral, trithemimeral
βωμὸν ἀναστήσαντες ἐπάκτιον· εἰ δʼ ἂν ὀπίσσω	-u u---u u-uu - u u--	dactylic hexameter	feminine penthemimeral
γαῖαν ἐς Αἱμονίην ἀσκηθέα νόστον ὀπάσσῃ,	-u u -uu- --uu -u u--	dactylic hexameter	masculine penthemimeral
δὴ τότε οἱ κεραῶν ἐπὶ μηρία θήσομεν αἰγῶν.	- uu - uu- uu -uu -uu --	dactylic hexameter	masculine penthemimeral, trithemimeral
νῦν δʼ αὔτως κνίσῃ λοιβῇσί τε μειλίξασθαι	- -- -- --u u ----	dactylic hexameter	masculine penthemimeral, trithemimeral
κέκλομαι. ἀλλʼ ἵληθι ἄναξ, ἵληθι φαανθείς.’	-uu - --u u- --u u--	dactylic hexameter	feminine penthemimeral, hepthemimeral, trithemimeral
ὧς ἄρʼ ἔφη· καὶ τοὶ μὲν ἄφαρ βωμὸν τετύκοντο	- u u- - - u u- -- uu--	dactylic hexameter	masculine penthemimeral, hepthemimeral, trithemimeral
χερμάσιν· οἱ δʼ ἀνὰ νῆσον ἐδίνεον, ἐξερέοντες	-uu - uu -u u-uu -uu--	dactylic hexameter	feminine penthemimeral, trithemimeral
εἴ κέ τινʼ ἢ κεμάδων, ἢ ἀγροτέρων ἐσίδοιεν	- u u - uu- - -uu- uu--	dactylic hexameter	masculine penthemimeral, trithemimeral
αἰγῶν, οἷά τε πολλὰ βαθείῃ βόσκεται ὕλῃ.	-- -u u -u u-- -uu --	dactylic hexameter	feminine penthemimeral
τοῖσι δὲ Λητοΐδης ἄγρην πόρεν· ἐκ δέ νυ πάντων	-u u -uu- -- uu - u u --	dactylic hexameter	masculine penthemimeral, hepthemimeral
εὐαγέως ἱερῷ ἀνὰ διπλόα μηρία βωμῷ	-uu- uu- uu -uu -uu --	dactylic hexameter	masculine penthemimeral, trithemimeral
καῖον, ἐπικλείοντες Ἑώιον Ἀπόλλωνα.	-u u---u u-uu ----	dactylic hexameter	feminine penthemimeral
ἀμφὶ δὲ δαιομένοις εὐρὺν χορὸν ἐστήσαντο,	-u u -uu- -- uu ----	dactylic hexameter	masculine penthemimeral, hepthemimeral
καλὸν Ἰηπαιήονʼ Ἰηπαιήονα Φοῖβον	-u u---u u---uu --	dactylic hexameter	feminine penthemimeral
μελπόμενοι· σὺν δέ σφιν ἐὺς πάις Οἰάγροιο	-uu- - - - - uu ----	dactylic hexameter	masculine penthemimeral, hepthemimeral, trithemimeral
Βιστονίῃ φόρμιγγι λιγείης ἦρχεν ἀοιδῆς·	-uu- --u u-- -u u--	dactylic hexameter	feminine penthemimeral, trithemimeral
ὥς ποτε πετραίῃ ὑπὸ δειράδι Παρνησσοῖο	- uu --- uu -uu ----	dactylic hexameter	masculine penthemimeral
Δελφύνην τόξοισι πελώριον ἐξενάριξεν,	--- --u u-uu -uu--	dactylic hexameter	feminine penthemimeral, trithemimeral
κοῦρος ἐὼν ἔτι γυμνός, ἔτι πλοκάμοισι γεγηθώς.	-u u- uu -u u- uu-u u--	dactylic hexameter	feminine penthemimeral, hepthemimeral, trithemimeral
ἱλήκοις· αἰεί τοι, ἄναξ, ἄτμητοι ἔθειραι,	--- -- u u- --u u--	dactylic hexameter	masculine penthemimeral, hepthemimeral, trithemimeral
αἰὲν ἀδήλητοι· τὼς γὰρ θέμις. οἰόθι δʼ αὐτὴ	-u u--- - - uu -uu --	dactylic hexameter	masculine penthemimeral, hepthemimeral
Λητὼ Κοιογένεια φίλαις ἐν χερσὶν ἀφάσσει.	-- -uu-u u- - -u u--	dactylic hexameter	feminine penthemimeral, hepthemimeral
πολλὰ δὲ Κωρύκιαι νύμφαι, Πλείστοιο θύγατρες,	-u u -uu- -- --u u--	dactylic hexameter	masculine penthemimeral, hepthemimeral
θαρσύνεσκον ἔπεσσιν, Ἰήιε κεκληγυῖαι·	---u u-u u-uu ----	dactylic hexameter	feminine penthemimeral
ἔνθεν δὴ τόδε καλὸν ἐφύμνιον ἔπλετο Φοίβῳ.	-- - uu -u u-uu -uu --	dactylic hexameter	feminine penthemimeral, trithemimeral
αὐτὰρ ἐπειδὴ τόνγε χορείῃ μέλψαν ἀοιδῇ,	-u u-- -u u-- -u u--	dactylic hexameter	feminine penthemimeral
λοιβαῖς εὐαγέεσσιν ἐπώμοσαν, ἦ μὲν ἀρήξειν	-- -uu-u u-uu - u u--	dactylic hexameter	feminine penthemimeral
ἀλλήλοις εἰσαιὲν ὁμοφροσύνῃσι νόοιο,	--- --u u-uu-u u--	dactylic hexameter	feminine penthemimeral, trithemimeral
ἁπτόμενοι θυέων· καί τʼ εἰσέτι νῦν γε τέτυκται	-uu- uu- - -uu - u u--	dactylic hexameter	masculine penthemimeral, trithemimeral
κεῖσʼ Ὁμονοίης ἱρὸν ἐύφρονος, ὅ ῥʼ ἐκάμοντο	- uu-- -u u-uu - uu--	dactylic hexameter	feminine penthemimeral
αὐτοὶ κυδίστην τότε δαίμονα πορσαίνοντες.	-- --- uu -uu ----	dactylic hexameter	masculine penthemimeral
ἦμος δὲ τρίτατον φάος ἤλυθε, δὴ τότʼ ἔπειτα	-- - uu- uu -uu - u u--	dactylic hexameter	masculine penthemimeral, trithemimeral
ἀκραεῖ ζεφύρῳ νῆσον λίπον αἰπήεσσαν.	--- uu- -- uu ----	dactylic hexameter	masculine penthemimeral, hepthemimeral, trithemimeral
ἔνθεν δʼ ἀντιπέρην ποταμοῦ στόμα Σαγγαρίοιο	-- -uu- uu- uu -uu--	dactylic hexameter	masculine penthemimeral, hepthemimeral
καὶ Μαριανδυνῶν ἀνδρῶν ἐριθηλέα γαῖαν	- uu--- -- uu-uu --	dactylic hexameter	masculine penthemimeral, hepthemimeral
ἠδὲ Λύκοιο ῥέεθρα καὶ Ἀνθεμοεισίδα λίμνην	-u u-u u-u u -uu-uu --	dactylic hexameter	feminine penthemimeral
δερκόμενοι παράμειβον· ὑπὸ πνοιῇ δὲ κάλωες	-uu- uu-u u- -- u u--	dactylic hexameter	feminine penthemimeral, hepthemimeral, trithemimeral
ὅπλα τε νήια πάντα τινάσσετο νισσομένοισιν.	-u u -uu -u u-uu -uu--	dactylic hexameter	feminine penthemimeral
ἠῶθεν δʼ ἀνέμοιο διὰ κνέφας εὐνηθέντος	--- uu-u u- uu ----	dactylic hexameter	feminine penthemimeral, hepthemimeral, trithemimeral
ἀσπασίως ἄκρης Ἀχερουσίδος ὅρμον ἵκοντο.	-uu- -- uu-uu -u u--	dactylic hexameter	masculine penthemimeral, trithemimeral
ἡ μέν τε κρημνοῖσιν ἀνίσχεται ἠλιβάτοισιν,	- - - --u u-uu -uu--	dactylic hexameter	feminine penthemimeral, trithemimeral
εἰς ἅλα δερκομένη Βιθυνίδα· τῇ δʼ ὑπὸ πέτραι	- uu -uu- --uu - uu --	dactylic hexameter	masculine penthemimeral
λισσάδες ἐρρίζωνται ἁλίβροχοι· ἀμφὶ δὲ τῇσιν	-uu ---u u-uu -u u --	dactylic hexameter	feminine penthemimeral
κῦμα κυλινδόμενον μεγάλα βρέμει· αὐτὰρ ὕπερθεν	-u u-uu- uu- uu -u u--	dactylic hexameter	masculine penthemimeral, hepthemimeral
ἀμφιλαφεῖς πλατάνιστοι ἐπʼ ἀκροτάτῃ πεφύασιν.	-uu- uu-u u -uu- uu--	dactylic hexameter	feminine penthemimeral, trithemimeral
ἐκ δʼ αὐτῆς εἴσω κατακέκλιται ἤπειρόνδε	- -- -- uu-uu ----	dactylic hexameter	masculine penthemimeral, trithemimeral
κοίλη ὕπαιθα νάπη, ἵνα τε σπέος ἔστʼ Ἀίδαο	-u u-u u- uu - uu - uu--	dactylic hexameter	masculine penthemimeral, hepthemimeral
ὕλῃ καὶ πέτρῃσιν ἐπηρεφές, ἔνθεν ἀυτμὴ	-- - --u u-uu -u u--	dactylic hexameter	feminine penthemimeral, trithemimeral
πηγυλίς, ὀκρυόεντος ἀναπνείουσα μυχοῖο	-uu -uu-u u---u u--	dactylic hexameter	feminine penthemimeral
συνεχές, ἀργινόεσσαν ἀεὶ περιτέτροφε πάχνην,	-uu -uu-u u- uu-uu --	dactylic hexameter	feminine penthemimeral, hepthemimeral
ἥ τε μεσημβριόωντος ἰαίνεται ἠελίοιο.	- u u-uu-u u-uu -uu--	dactylic hexameter	feminine penthemimeral
σιγὴ δʼ οὔποτε τήνγε κατὰ βλοσυρὴν ἔχει ἄκρην,	-- -uu -u u- uu- uu --	dactylic hexameter	feminine penthemimeral, hepthemimeral
ἀλλʼ ἄμυδις πόντοιό θ᾽ὑπὸ στένει ἠχήεντος,	- uu- --u u- uu ----	dactylic hexameter	feminine penthemimeral, hepthemimeral, trithemimeral
φύλλων τε πνοιῇσι τινασσομένων μυχίῃσιν.	-- - --u u-uu- uu--	dactylic hexameter	feminine penthemimeral, trithemimeral
ἔνθα δὲ καὶ προχοαὶ ποταμοῦ Ἀχέροντος ἔασιν,	-u u - uu- uu- uu-u u--	dactylic hexameter	masculine penthemimeral, hepthemimeral, trithemimeral
ὅς τε διὲξ ἄκρης ἀνερεύγεται εἰς ἅλα βάλλων	- u u- -- uu-uu - uu --	dactylic hexameter	masculine penthemimeral, trithemimeral
ἠῴην· κοίλη δὲ φάραγξ κατάγει μιν ἄνωθεν.	--- -- u u- uu- u u--	dactylic hexameter	masculine penthemimeral, hepthemimeral, trithemimeral
τὸν μὲν ἐν ὀψιγόνοισι Σοωναύτην ὀνόμηναν	- u u -uu-u u--- uu--	dactylic hexameter	feminine penthemimeral
Νισαῖοι Μεγαρῆες, ὅτε νάσσεσθαι ἔμελλον	--- uu-u u- --u u--	dactylic hexameter	feminine penthemimeral, hepthemimeral, trithemimeral
γῆν Μαριανδυνῶν. δὴ γάρ σφεας ἐξεσάωσεν	- uu--- - - uu -uu--	dactylic hexameter	masculine penthemimeral, hepthemimeral
αὐτῇσιν νήεσσι, κακῇ χρίμψαντας ἀέλλῃ.	--- --u u- --u u--	dactylic hexameter	feminine penthemimeral, hepthemimeral, trithemimeral
τῇ ῥʼ οἵ γʼ αὐτίκα νηὶ διὲξ Ἀχερουσίδος ἄκρης	- - -uu -u u- uu-uu --	dactylic hexameter	feminine penthemimeral, hepthemimeral
εἰσωποὶ ἀνέμοιο νέον λήγοντος ἔκελσαν.	--- uu-u u- --u u--	dactylic hexameter	feminine penthemimeral, hepthemimeral, trithemimeral
οὐδʼ ἄρα δηθὰ Λύκον, κείνης πρόμον ἠπείροιο,	- uu -u u- -- uu ----	dactylic hexameter	masculine penthemimeral, hepthemimeral
καὶ Μαριανδυνοὺς λάθον ἀνέρας ὁρμισθέντες	- uu--- uu -uu ----	dactylic hexameter	masculine penthemimeral
αὐθένται Ἀμύκοιο κατὰ κλέος, ὃ πρὶν ἄκουον·	--- uu-u u- uu - u u--	dactylic hexameter	feminine penthemimeral, hepthemimeral, trithemimeral
ἀλλὰ καὶ ἀρθμὸν ἔθεντο μετὰ σφίσι τοῖο ἕκητι.	-u u -u u-u u- uu -u u--	dactylic hexameter	feminine penthemimeral, hepthemimeral
αὐτὸν δʼ ὥστε θεὸν Πολυδεύκεα δεξιόωντο	-- -u u- uu-uu -uu--	dactylic hexameter	masculine penthemimeral
πάντοθεν ἀγρόμενοι· ἐπεὶ ἦ μάλα τοί γʼ ἐπὶ δηρὸν	-uu -uu- uu - uu - uu --	dactylic hexameter	masculine penthemimeral, hepthemimeral
ἀντιβίην Βέβρυξιν ὑπερφιάλοις πολέμιζον.	-uu- --u u-uu- uu--	dactylic hexameter	feminine penthemimeral, trithemimeral
καὶ δὴ πασσυδίῃ μεγάρων ἔντοσθε Λύκοιο	- - -uu- uu- --u u--	dactylic hexameter	masculine penthemimeral, hepthemimeral
κεῖνʼ ἦμαρ φιλότητι, μετὰ πτολίεθρον ἰόντες,	- -- uu-u u- uu-u u--	dactylic hexameter	feminine penthemimeral, hepthemimeral, trithemimeral
δαίτην ἀμφίεπον, τέρποντό τε θυμὸν ἔπεσσιν.	-- -uu- --u u -u u--	dactylic hexameter	masculine penthemimeral
Αἰσονίδης μέν οἱ γενεὴν καὶ οὔνομʼ ἑκάστου	-uu- - - uu- - -u u--	dactylic hexameter	masculine penthemimeral, hepthemimeral, trithemimeral
σφωιτέρων μυθεῖθʼ ἑτάρων, Πελίαό τʼ ἐφετμάς,	-uu- -- uu- uu-u u--	dactylic hexameter	masculine penthemimeral, hepthemimeral, trithemimeral
ἠδʼ ὡς Λημνιάδεσσιν ἐπεξεινοῦντο γυναιξίν,	- - -uu-u u---u u--	dactylic hexameter	feminine penthemimeral
ὅσσα τε Κύζικον ἀμφὶ Δολιονίην ἐτελεσσαν·	-u u -uu -u u-uu- uu--	dactylic hexameter	feminine penthemimeral
Μυσίδα δʼ ὡς ἀφίκοντο Κίον θ᾽,ὅθι κάλλιπον ἥρω	-uu - uu-u u- uu -uu --	dactylic hexameter	feminine penthemimeral, hepthemimeral, trithemimeral
Ἡρακλέην ἀέκοντι νόῳ, Γλαύκοιό τε βάξιν	-uu- uu-u u- --u u --	dactylic hexameter	feminine penthemimeral, hepthemimeral, trithemimeral
πέφραδε, καὶ Βέβρυκας ὅπως Ἄμυκόν τʼ ἐδάιξαν,	-uu - --u u- uu- uu--	dactylic hexameter	feminine penthemimeral, hepthemimeral, trithemimeral
καὶ Φινῆος ἔειπε θεοπροπίας τε δύην τε,	- --u u-u u-uu- u u- -	dactylic hexameter	feminine penthemimeral
ἠδʼ ὡς Κυανέας πέτρας φύγον, ὥς τʼ ἀβόλησαν	- - -uu- -- uu - uu--	dactylic hexameter	masculine penthemimeral, hepthemimeral
Λητοΐδῃ κατὰ νῆσον. ὁ δʼ ἑξείης ἐνέποντος	-uu- uu -u u --- uu--	dactylic hexameter	feminine penthemimeral, trithemimeral
θέλγετʼ ἀκουῇ θυμόν· ἄχος δʼ ἕλεν Ἡρακλῆι	-u u-- -u u- uu ----	dactylic hexameter	feminine penthemimeral, hepthemimeral
λειπομένῳ, καὶ τοῖον ἔπος πάντεσσι μετηύδα·	-uu- - -u u- --u u--	dactylic hexameter	feminine penthemimeral, hepthemimeral, trithemimeral
‘ὦ φίλοι, οἵου φωτὸς ἀποπλαγχθέντες ἀρωγῆς	- uu -- -u u---u u--	dactylic hexameter	feminine penthemimeral
πείρετʼ ἐς Αἰήτην τόσσον πλόον. εὖ γὰρ ἐγώ μιν	-u u --- -- uu - u u- -	dactylic hexameter	masculine penthemimeral, hepthemimeral
Δασκύλου ἐν μεγάροισι καταυτόθι πατρὸς ἐμοῖο	-uu - uu-u u-uu -u u--	dactylic hexameter	feminine penthemimeral, trithemimeral
οἶδʼ ἐσιδών, ὅτε δεῦρο διʼ Ἀσίδος ἠπείροιο	- uu- uu -u u -uu ----	dactylic hexameter	feminine penthemimeral, trithemimeral
πεζὸς ἔβη ζωστῆρα φιλοπτολέμοιο κομίζων	-u u- --u u-uu-u u--	dactylic hexameter	feminine penthemimeral, trithemimeral
Ἱππολύτης· ἐμὲ δʼ εὗρε νέον χνοάοντα ἰούλους.	-uu- uu -u u- uu-u u--	dactylic hexameter	feminine penthemimeral, hepthemimeral, trithemimeral
ἔνθα δʼ ἐπὶ Πριόλαο κασιγνήτοιο θανόντος	-u u- uu-u u---u u--	dactylic hexameter	feminine penthemimeral, trithemimeral
ἡμετέρου Μυσοῖσιν ὑπʼ ἀνδράσιν, ὅντινα λαὸς	-uu- --u u -uu -uu --	dactylic hexameter	feminine penthemimeral, trithemimeral
οἰκτίστοις ἐλέγοισιν ὀδύρεται ἐξέτι κείνου,	--- uu-u u-uu -uu --	dactylic hexameter	feminine penthemimeral, trithemimeral
ἀθλεύων Τιτίην ἀπεκαίνυτο πυγμαχέοντα	--- uu- uu-uu -uu--	dactylic hexameter	masculine penthemimeral, trithemimeral
καρτερόν, ὃς πάντεσσι μετέπρεπεν ἠιθέοισιν	-uu - --u u-uu -uu--	dactylic hexameter	feminine penthemimeral, trithemimeral
εἶδός τʼ ἠδὲ βίην· χαμάδις δέ οἱ ἤλασʼ ὀδόντας.	-- -u u- uu- u u -u u--	dactylic hexameter	masculine penthemimeral, hepthemimeral
αὐτὰρ ὁμοῦ Μυσοῖσιν ἐμῷ ὑπὸ πατρὶ δάμασσεν	-u u- --u u- uu -u u--	dactylic hexameter	feminine penthemimeral, hepthemimeral, trithemimeral
καὶ Φρύγας, οἳ ναίουσιν ὁμώλακας ἧμιν ἀρούρας,	- uu - --u u-uu -u u--	dactylic hexameter	feminine penthemimeral, trithemimeral
φῦλά τε Βιθυνῶν αὐτῇ κτεατίσσατο γαίῃ,	-u u --- -- uu-uu --	dactylic hexameter	masculine penthemimeral, hepthemimeral
ἔστʼ ἐπὶ Ῥηβαίου προχοὰς σκόπελόν τε Κολώνης·	- uu --- uu- uu- u u--	dactylic hexameter	masculine penthemimeral, hepthemimeral
Παφλαγόνες τʼ ἐπὶ τοῖς Πελοπήιοι εἴκαθον αὔτως,	-uu- uu - uu-uu -uu --	dactylic hexameter	masculine penthemimeral, trithemimeral
ὅσσους Βιλλαίοιο μέλαν περιάγνυται ὕδωρ.	-- ---u u- uu-uu --	dactylic hexameter	feminine penthemimeral, hepthemimeral
ἀλλά με νῦν Βέβρυκες ὑπερβασίη τʼ Ἀμύκοιο	-u u - --u u-uu- uu--	dactylic hexameter	feminine penthemimeral, trithemimeral
τηλόθι ναιετάοντος, ἐνόσφισαν, Ἡρακλῆος,	-uu -uu-u u-uu ----	dactylic hexameter	feminine penthemimeral
δὴν ἀποτεμνόμενοι γαίης ἅλις, ὄφρʼ ἐβάλοντο	- uu-uu- -- uu - uu--	dactylic hexameter	masculine penthemimeral, hepthemimeral
οὖρα βαθυρρείοντος ὑφʼ εἱαμεναῖς Ὑπίοιο.	-u u---u u -uu- uu--	dactylic hexameter	feminine penthemimeral
ἔμπης δʼ ἐξ ὑμέων ἔδοσαν τίσιν· οὐδέ ἕ φημι	-- - uu- uu- uu -u u --	dactylic hexameter	masculine penthemimeral, hepthemimeral, trithemimeral
ἤματι τῷδʼ ἀέκητι θεῶν ἐπελάσσαι ἄρηα,	-uu - uu-u u- uu-u u--	dactylic hexameter	feminine penthemimeral, hepthemimeral, trithemimeral
Τυνδαρίδην Βέβρυξιν, ὅτʼ ἀνέρα κεῖνον ἔπεφνεν.	-uu- --u u -uu -u u--	dactylic hexameter	feminine penthemimeral, trithemimeral
τῶ νῦν ἥντινʼ ἐγὼ τῖσαι χάριν ἄρκιός εἰμι,	- - -u u- -- uu -uu --	dactylic hexameter	masculine penthemimeral, hepthemimeral
τίσω προφρονέως. ἡ γὰρ θέμις ηπεδανοισιν	-- -uu- - - uu -uu--	dactylic hexameter	masculine penthemimeral, hepthemimeral
ἀνδράσιν, εὖτʼ ἄρξωσιν ἀρείονες ἄλλοι ὀφέλλειν.	-uu - --u u-uu -u u--	dactylic hexameter	feminine penthemimeral, trithemimeral
ξυνῇ μὲν πάντεσσιν ὁμόστολον ὔμμιν ἕπεσθαι	-- - --u u-uu -u u--	dactylic hexameter	feminine penthemimeral, trithemimeral
Δάσκυλον ὀτρυνέω, ἐμὸν υἱέα· τοῖο δʼ ἰόντος,	-uu -uu- uu -uu -u u--	dactylic hexameter	masculine penthemimeral
ἦ τʼ ἂν ἐυξείνοισι διὲξ ἁλὸς ἀντιάοιτε	- u u---u u- uu -uu--	dactylic hexameter	feminine penthemimeral, hepthemimeral
ἀνδράσιν, ὄφρʼ αὐτοῖο ποτὶ στόμα Θερμώδοντος.	-uu - --u u- uu ----	dactylic hexameter	feminine penthemimeral, hepthemimeral, trithemimeral
νόσφι δὲ Τυνδαρίδαις Ἀχερουσίδος ὑψόθεν ἄκρης	-u u -uu- uu-uu -uu --	dactylic hexameter	masculine penthemimeral
εἵσομαι ἱερὸν αἰπύ· τὸ μὲν μάλα τηλόθι πάντες	-uu -uu -u u - uu -uu --	dactylic hexameter	feminine penthemimeral, hepthemimeral
ναυτίλοι ἂμ πέλαγος θηεύμενοι ἱλάξονται·	-uu - uu- --uu ----	dactylic hexameter	masculine penthemimeral, trithemimeral
καί κέ σφιν μετέπειτα πρὸ ἄστεος, οἷα θεοῖσιν,	- - - uu-u u -uu -u u--	dactylic hexameter	feminine penthemimeral, trithemimeral
πίονας εὐα·ρότοιο γύας πεδίοιο ταμοίμην.’	-uu -uu-u u- uu-u u--	dactylic hexameter	feminine penthemimeral, hepthemimeral
ὧς τότε μὲν δαῖτʼ ἀμφὶ πανήμεροι ἑψιόωντο.	- uu - - -u u-uu -uu--	dactylic hexameter	feminine penthemimeral, trithemimeral
ἦρί γε μὴν ἐπὶ νῆα κατήισαν ἐγκονέοντες·	-u u - uu -u u-uu -uu--	dactylic hexameter	feminine penthemimeral, trithemimeral
καὶ δʼ αὐτὸς σὺν τοῖσι Λύκος κίε, μυρίʼ ὀπάσσας	- -- - -u u- uu -u u--	dactylic hexameter	feminine penthemimeral, hepthemimeral, trithemimeral
δῶρα φέρειν· ἅμα δʼ υἷα δόμων ἔκπεμπε νέεσθαι.	-u u- uu -u u- --u u--	dactylic hexameter	feminine penthemimeral, hepthemimeral, trithemimeral
ἔνθα δʼ Ἀβαντιάδην πεπρωμένη ἤλασε μοῖρα	-u u-uu- --uu -uu --	dactylic hexameter	masculine penthemimeral
Ἴδμονα, μαντοσύνῃσι κεκασμένον. ἀλλά μιν οὔτι	-uu -uu-u u-uu -u u --	dactylic hexameter	feminine penthemimeral
μαντοσύναι ἐσάωσαν, ἐπεὶ χρεὼ ἦγε δαμῆναι·	-uu- uu-u u- uu -u u--	dactylic hexameter	feminine penthemimeral, hepthemimeral, trithemimeral
κεῖτο γὰρ εἱαμενῇ δονακώδεος ἐν ποταμοῖο	-u u -uu- uu-uu - uu--	dactylic hexameter	masculine penthemimeral
ψυχόμενος λαγόνας τε καὶ ἄσπετον ἰλύι νηδὺν	-uu- uu- u u -uu -- --	dactylic hexameter	masculine penthemimeral, trithemimeral
κάπριος ἀργιόδων, ὀλοὸν τέρας, ὅν ῥα καὶ αὐταὶ	-uu -uu- uu- uu - u u --	dactylic hexameter	masculine penthemimeral, hepthemimeral
νύμφαι ἑλειονόμοι ὑπεδείδισαν· οὐδέ τις ἀνδρῶν	-u u-uu- uu-uu -u u --	dactylic hexameter	masculine penthemimeral
ἠείδει· οἶος δὲ κατὰ πλατὺ βόσκετο τῖφος.	--- -- u u- uu -uu --	dactylic hexameter	masculine penthemimeral, hepthemimeral, trithemimeral
αὐτὰρ ὅ γʼ ἰλυόεντος ἀνὰ θρωσμοὺς ποταμοῖο	-u u -uu-u u- -- uu--	dactylic hexameter	feminine penthemimeral, hepthemimeral
νίσσετʼ Ἀβαντιάδης· ὁ δʼ ἄρʼ ἔκποθεν ἀφράστοιο	-u u-uu- u u -uu ----	dactylic hexameter	masculine penthemimeral
ὕψι μάλʼ ἐκ δονάκων ἀνεπάλμενος ἤλασε μηρὸν	-u u - uu- uu-uu -uu --	dactylic hexameter	masculine penthemimeral, trithemimeral
ἀίγδην, μέσσας δὲ σὺν ὀστέῳ ἶνας ἔκερσεν.	--- -- u u -uu -u u--	dactylic hexameter	masculine penthemimeral, trithemimeral
ὀξὺ δʼ ὅ γε κλάγξας οὔδει πέσεν· οἱ δὲ τυπέντος	-u u - -- -- uu - u u--	dactylic hexameter	masculine penthemimeral, hepthemimeral, trithemimeral
ἀθρόοι ἀντιάχησαν. ὀρέξατο δʼ αἶψʼ ὀλοοῖο	-uu -uu-u u-uu - uu--	dactylic hexameter	feminine penthemimeral
Πηλεὺς αἰγανέῃ φύγαδʼ εἰς ἕλος ὁρμηθέντος	-- -uu- uu - uu ----	dactylic hexameter	masculine penthemimeral, hepthemimeral
καπρίου· ἔσσυτο δʼ αὖτις ἐναντίος· ἀλλά μιν Ἴδας	-uu -uu -u u-uu -u u --	dactylic hexameter	feminine penthemimeral
οὔτασε, βεβρυχὼς δὲ θοῷ περικάππεσε δουρί.	-uu --- u u- uu-uu --	dactylic hexameter	masculine penthemimeral, hepthemimeral
καὶ τὸν μὲν χαμάδις λίπον αὐτόθι πεπτηῶτα·	- - - uu- uu -uu ----	dactylic hexameter	masculine penthemimeral, trithemimeral
τὸν δʼ ἕταροι ἐπὶ νῆα φέρον ψυχορραγέοντα,	- uu- uu -u u- --uu--	dactylic hexameter	feminine penthemimeral, hepthemimeral, trithemimeral
ἀχνύμενοι, χείρεσσι δʼ ἑῶν ἐνικάτθανʼ ἑταίρων.	-uu- --u u- uu-u u--	dactylic hexameter	feminine penthemimeral, hepthemimeral, trithemimeral
ἔνθα δὲ ναυτιλίης μὲν ἐρητύοντο μέλεσθαι,	-u u -uu- u u---u u--	dactylic hexameter	masculine penthemimeral
ἀμφὶ δὲ κηδείῃ νέκυος μένον ἀσχαλόωντες.	-u u --- uu- uu -uu--	dactylic hexameter	masculine penthemimeral, hepthemimeral
ἤματα δὲ τρία πάντα γόων· ἑτέρῳ δέ μιν ἤδη	-uu - uu -u u- uu- u u --	dactylic hexameter	feminine penthemimeral, hepthemimeral, trithemimeral
τάρχυον μεγαλωστί· συνεκτερέιζε δὲ λαὸς	--- uu-u u-uu-u u --	dactylic hexameter	feminine penthemimeral, trithemimeral
αὐτῷ ὁμοῦ βασιλῆι Λύκῳ· παρὰ δʼ ἄσπετα μῆλα,	-u u- uu-u u- uu -uu --	dactylic hexameter	feminine penthemimeral, hepthemimeral, trithemimeral
ἣ θέμις οἰχομένοισι, ταφήια λαιμοτόμησαν.	- uu -uu-u u-uu -uu--	dactylic hexameter	feminine penthemimeral
καὶ δή τοι κέχυται τοῦδʼ ἀνέρος ἐν χθονὶ κείνῃ	- - - uu- - -uu - uu --	dactylic hexameter	masculine penthemimeral, trithemimeral
τύμβος· σῆμα δʼ ἔπεστι καὶ ὀψιγόνοισιν ἰδέσθαι,	-- -u u-u u -uu-u u--	dactylic hexameter	feminine penthemimeral
νηίου ἐκ κοτίνοιο φάλαγξ· θαλέθει δέ τε φύλλοις	-uu - uu-u u- uu- u u --	dactylic hexameter	feminine penthemimeral, hepthemimeral, trithemimeral
ἄκρης τυτθὸν ἔνερθʼ Ἀχερουσίδος. εἰ δέ με καὶ τὸ	-- -u u- uu-uu - u u - -	dactylic hexameter	masculine penthemimeral
χρειὼ ἀπηλεγέως Μουσέων ὕπο γηρύσασθαι,	-u u-uu- -- uu ----	dactylic hexameter	masculine penthemimeral, hepthemimeral
τόνδε πολισσοῦχον διεπέφραδε Βοιωτοῖσιν	-u u--- uu-uu ----	dactylic hexameter	masculine penthemimeral
Νισαίοισί τε Φοῖβος ἐπιρρήδην ἱλάεσθαι,	---u u -u u--- uu--	dactylic hexameter	feminine penthemimeral
ἀμφὶ δὲ τήνγε φάλαγγα παλαιγενέος κοτίνοιο	-u u -u u-u u-uu- uu--	dactylic hexameter	feminine penthemimeral
ἄστυ βαλεῖν· οἱ δʼ ἀντὶ θεουδέος Αἰολίδαο	-u u- - -u u-uu -uu--	dactylic hexameter	feminine penthemimeral, trithemimeral
Ἴδμονος εἰσέτι νῦν Ἀγαμήστορα κυδαίνουσιν.	-uu -uu - uu-uu ----	dactylic hexameter	masculine penthemimeral
τίς γὰρ δὴ θάνεν ἄλλος; ἐπεὶ καὶ ἔτʼ αὖτις ἔχευαν	- - - uu -u u- u u -u u--	dactylic hexameter	feminine penthemimeral, hepthemimeral, trithemimeral
ἥρωες τότε τύμβον ἀποφθιμένου ἑτάροιο.	--- uu -u u-uu- uu--	dactylic hexameter	feminine penthemimeral, trithemimeral
δοιὰ γὰρ οὖν κείνων ἔτι σήματα φαίνεται ἀνδρῶν.	-u u - -- uu -uu -uu --	dactylic hexameter	masculine penthemimeral, trithemimeral
Ἁγνιάδην Τῖφυν θανέειν φάτις· οὐδέ οἱ ἦεν	-uu- -- uu- uu -u u --	dactylic hexameter	masculine penthemimeral, hepthemimeral, trithemimeral
μοῖρʼ ἔτι ναυτίλλεσθαι ἑκαστέρω. ἀλλά νυ καὶ τὸν	- uu ---u u-uu -u u - -	dactylic hexameter	feminine penthemimeral
αὖθι μινυνθαδίη πάτρης ἑκὰς εὔνασε νοῦσος,	-u u-uu- -- uu -uu --	dactylic hexameter	masculine penthemimeral, hepthemimeral
εἰσότʼ Ἀβαντιάδαο νέκυν κτερέιξεν ὅμιλος.	-u u-uu-u u- uu-u u--	dactylic hexameter	feminine penthemimeral, hepthemimeral
ἄτλητον δʼ ὀλοῷ ἐπὶ πήματι κῆδος ἕλοντο.	--- uu- uu -uu -u u--	dactylic hexameter	masculine penthemimeral, trithemimeral
δὴ γὰρ ἐπεὶ καὶ τόνδε παρασχεδὸν ἐκτερέιξαν	- u u- - -u u-uu -uu--	dactylic hexameter	feminine penthemimeral, trithemimeral
αὐτοῦ, ἀμηχανίῃσιν ἁλὸς προπάροιθε πεσόντες,	-u u-uu-u u- uu-u u--	dactylic hexameter	feminine penthemimeral, hepthemimeral
ἐντυπὰς εὐκήλως εἰλυμένοι οὔτε τι σίτου	-uu --- --uu -u u --	dactylic hexameter	masculine penthemimeral
μνώοντʼ οὔτε ποτοῖο· κατήμυσαν δʼ ἀχέεσσιν	-- -u u-u u--- uu--	dactylic hexameter	feminine penthemimeral
θυμόν, ἐπεὶ μάλα πολλὸν ἀπʼ ἐλπίδος ἔπλετο νόστος.	-u u- uu -u u -uu -uu --	dactylic hexameter	feminine penthemimeral, trithemimeral
καί νύ κʼ ἔτι προτέρω τετιημένοι ἰσχανόωντο,	- u u- uu- uu-uu -uu--	dactylic hexameter	masculine penthemimeral, trithemimeral
εἰ μὴ ἄρʼ Ἀγκαίῳ περιώσιον ἔμβαλεν Ἥρη	- u u --- uu-uu -uu --	dactylic hexameter	masculine penthemimeral
θάρσος, ὃν Ἰμβρασίοισι παρʼ ὕδασιν Ἀστυπάλαια	-u u -uu-u u -uu -uu--	dactylic hexameter	feminine penthemimeral
τίκτε Ποσειδάωνι· περιπρὸ γὰρ εὖ ἐκέκαστο	-u u---u u-u u - uu--	dactylic hexameter	feminine penthemimeral
ἰθύνειν, Πηλῆα δʼ ἐπεσσύμενος προσέειπεν·	--- --u u-uu- uu--	dactylic hexameter	feminine penthemimeral, trithemimeral
‘Αἰακίδη, πῶς καλὸν ἀφειδήσαντας ἀέθλων	-uu- - -u u---u u--	dactylic hexameter	feminine penthemimeral, trithemimeral
γαίῃ ἐν ἀλλοδαπῇ δὴν ἔμμεναι; οὐ μὲν ἄρηος	-u u -uu- - -uu - u u--	dactylic hexameter	masculine penthemimeral
ἴδριν ἐόντά με τόσσον ἄγει μετὰ κῶας Ἰήσων	-u u-u u -u u- uu -u u--	dactylic hexameter	feminine penthemimeral, hepthemimeral
παρθενίης ἀπάνευθεν, ὅσον τʼ ἐπιίστορα νηῶν.	-uu- uu-u u- uu-uu --	dactylic hexameter	feminine penthemimeral, hepthemimeral, trithemimeral
τῶ μή μοι τυτθόν γε δέος περὶ νηὶ πελέσθω.	- - - -- u u- uu -u u--	dactylic hexameter	masculine penthemimeral, hepthemimeral, trithemimeral
ὧς δὲ καὶ ὧλλοι δεῦρο δαήμονες ἄνδρες ἔασιν,	- u u -- -u u-uu -u u--	dactylic hexameter	feminine penthemimeral
τῶν ὅτινα πρύμνης ἐπιβήσομεν, οὔτις ἰάψει	- uu- -- uu-uu -u u--	dactylic hexameter	masculine penthemimeral, trithemimeral
ναυτιλίην. ἀλλʼ ὦκα, παραιφάμενος τάδε πάντα,	-uu- - -u u-uu- uu --	dactylic hexameter	feminine penthemimeral, trithemimeral
θαρσαλέως ὀρόθυνον ἐπιμνήσασθαι ἀέθλου.’	-uu- uu-u u---u u--	dactylic hexameter	feminine penthemimeral, trithemimeral
ὧς φάτο· τοῖο δὲ θυμὸς ὀρέξατο γηθοσύνῃσιν.	- uu -u u -u u-uu -uu--	dactylic hexameter	feminine penthemimeral
αὐτίκα δʼ οὐ μετὰ δηρὸν ἐνὶ μέσσοις ἀγόρευσεν·	-uu - uu -u u- -- uu--	dactylic hexameter	feminine penthemimeral, hepthemimeral, trithemimeral
‘δαιμόνιοι, τί νυ πένθος ἐτώσιον ἴσχομεν αὔτως;	-uu- u u -u u-uu -uu --	dactylic hexameter	feminine penthemimeral, trithemimeral
οἱ μὲν γάρ ποθι τοῦτον, ὃν ἔλλαχον, οἶτον ὄλοντο·	- - - uu -u u -uu -u u--	dactylic hexameter	feminine penthemimeral, trithemimeral
ἡμῖν δʼ ἐν γὰρ ἔασι κυβερνητῆρες ὁμίλῳ,	-- - u u-u u---u u--	dactylic hexameter	feminine penthemimeral, trithemimeral
καὶ πολέες. τῶ μή τι διατριβώμεθα πείρης·	- uu- - - u u---uu --	dactylic hexameter	masculine penthemimeral, trithemimeral
ἀλλʼ ἔγρεσθʼ εἰς ἔργον, ἀπορρίψαντες ἀνίας.’	- -- - -u u---u u--	dactylic hexameter	feminine penthemimeral, trithemimeral
τὸν δʼ αὖτʼ Αἴσονος υἱὸς ἀμηχανέων προσέειπεν·	- - -uu -u u-uu- uu--	dactylic hexameter	feminine penthemimeral
‘Αἰακίδη, πῇ δʼ οἵδε κυβερνητῆρες ἔασιν;	-uu- - -u u---u u--	dactylic hexameter	feminine penthemimeral, trithemimeral
οὓς μὲν γὰρ τὸ πάροιθε δαήμονας εὐχόμεθʼ εἶναι,	- - - u u-u u-uu -uu --	dactylic hexameter	feminine penthemimeral, trithemimeral
οἱ δὲ κατηφήσαντες ἐμεῦ πλέον ἀσχαλόωσιν.	- u u---u u- uu -uu--	dactylic hexameter	feminine penthemimeral, hepthemimeral
τῶ καὶ ὁμοῦ φθιμένοισι κακὴν προτιόσσομαι ἄτην,	- u u- uu-u u- uu-uu --	dactylic hexameter	feminine penthemimeral, hepthemimeral, trithemimeral
εἰ δὴ μήτʼ ὀλοοῖο μετὰ πτόλιν Αἰήταο	- - - uu-u u- uu ----	dactylic hexameter	feminine penthemimeral, hepthemimeral, trithemimeral
ἔσσεται, ἠὲ καὶ αὖτις ἐς Ἑλλάδα γαῖαν ἱκέσθαι	-uu -u u -u u -uu -u u--	dactylic hexameter	feminine penthemimeral
πετράων ἔκτοσθε, κατʼ αὐτόθι δʼ ἄμμε καλύψει	--- --u u -uu -u u--	dactylic hexameter	feminine penthemimeral, trithemimeral
ἀκλειῶς κακὸς οἶτος, ἐτώσια γηράσκοντας.’	--- uu -u u-uu ----	dactylic hexameter	feminine penthemimeral, trithemimeral
ὧς ἔφατʼ· Ἀγκαῖος δὲ μάλʼ ἐσσυμένως ὑπέδεκτο	- uu --- u u -uu- uu--	dactylic hexameter	masculine penthemimeral
νῆα θοὴν ἄξειν· δὴ γὰρ θεοῦ ἐτράπεθʼ ὁρμῇ.	-u u- -- - - uu -uu --	dactylic hexameter	masculine penthemimeral, hepthemimeral, trithemimeral
τὸν δὲ μετʼ Ἐργῖνος καὶ Ναύπλιος Εὔφημός τε	- u u --- - -uu --- -	dactylic hexameter	masculine penthemimeral
ὤρνυντʼ, ἰθύνειν λελιημένοι. ἀλλʼ ἄρα τούς γε	-- --- uu-uu - uu - -	dactylic hexameter	masculine penthemimeral
ἔσχεθον· Ἀγκαίῳ δὲ πολεῖς ᾔνησαν ἑταίρων.	-uu --- u u- --u u--	dactylic hexameter	masculine penthemimeral, hepthemimeral
Ἠῷοι δἤπειτα δυωδεκάτῳ ἐπέβαινον	--- --u u-uu- uu--	dactylic hexameter	feminine penthemimeral, trithemimeral
ἤματι· δὴ γάρ σφιν ζεφύρου μέγας οὖρος ἄητο.	-uu - - - uu- uu -u u--	dactylic hexameter	masculine penthemimeral, hepthemimeral, trithemimeral
καρπαλίμως δʼ Ἀχέροντα διεξεπέρησαν ἐρετμοῖς,	-uu- uu-u u-uu-u u--	dactylic hexameter	feminine penthemimeral, trithemimeral
ἐκ δʼ ἔχεαν πίσυνοι ἀνέμῳ λίνα, πουλὺ δʼ ἐπιπρὸ	- uu- uu- uu- uu -u u--	dactylic hexameter	masculine penthemimeral, hepthemimeral, trithemimeral
λαιφέων πεπταμένων τέμνον πλόον εὐδιόωντες.	-- -uu- -- uu -uu--	dactylic hexameter	masculine penthemimeral, hepthemimeral
ὦκα δὲ Καλλιχόροιο παρὰ προχοὰς ποταμοῖο	-u u -uu-u u- uu- uu--	dactylic hexameter	feminine penthemimeral, hepthemimeral
ἤλυθον, ἔνθʼ ἐνέπουσι Διὸς Νυσήιον υἷα,	-uu - uu-u u- --uu --	dactylic hexameter	feminine penthemimeral, hepthemimeral, trithemimeral
Ἰνδῶν ἡνίκα φῦλα λιπὼν κατενάσσατο Θήβας,	-- -uu -u u- uu-uu --	dactylic hexameter	feminine penthemimeral, hepthemimeral
ὀργιάσαι, στῆσαί τε χοροὺς ἄντροιο πάροιθεν,	-uu- -- u u- --u u--	dactylic hexameter	masculine penthemimeral, hepthemimeral, trithemimeral
ᾧ ἐν ἀμειδήτους ἁγίας ηὐλίζετο νύκτας,	- u u--- uu- --uu --	dactylic hexameter	masculine penthemimeral, hepthemimeral
ἐξ οὗ Καλλίχορον ποταμὸν περιναιετάοντες	- - -uu- uu- uu-uu--	dactylic hexameter	masculine penthemimeral, hepthemimeral
ἠδὲ καὶ Αὐλίον ἄντρον ἐπωνυμίην καλέουσιν.	-u u -uu -u u-uu- uu--	dactylic hexameter	feminine penthemimeral
ἔνθεν δὲ Σθενέλου τάφον ἔδρακον Ἀκτορίδαο,	-- - uu- uu -uu -uu--	dactylic hexameter	masculine penthemimeral, trithemimeral
ὅς ῥά τʼ Ἀμαζονίδων πολυθαρσέος ἐκ πολέμοιο	- u u-uu- uu-uu - uu--	dactylic hexameter	masculine penthemimeral
ἂψ ἀνιὼν (δὴ γὰρ συνανήλυθεν Ἡρακλῆι)	- uu- - - uu-uu ----	dactylic hexameter	masculine penthemimeral, trithemimeral
βλήμενος ἰῷ κεῖθεν ἐπʼ ἀγχιάλου θάνεν ἀκτῆς.	-uu -- -u u -uu- uu --	dactylic hexameter	feminine penthemimeral
οὐ μέν θην προτέρω ἔτʼ ἐμέτρεον. ἧκε γὰρ αὐτὴ	- - - uu- u u-uu -u u --	dactylic hexameter	masculine penthemimeral, trithemimeral
Φερσεφόνη ψυχὴν πολυδάκρυον Ἀκτορίδαο	-uu- -- uu-uu -uu--	dactylic hexameter	masculine penthemimeral, trithemimeral
λισσομένην τυτθόν περ ὁμήθεας ἄνδρας ἰδέσθαι.	-uu- -- u u-uu -u u--	dactylic hexameter	masculine penthemimeral, trithemimeral
τύμβου δὲ στεφάνης ἐπιβὰς σκοπιάζετο νῆα	-- - uu- uu- uu-uu --	dactylic hexameter	masculine penthemimeral, hepthemimeral, trithemimeral
τοῖος ἐών, οἷος πόλεμόνδʼ ἴεν· ἀμφὶ δὲ καλὴ	-u u- -- uu- uu -u u --	dactylic hexameter	masculine penthemimeral, hepthemimeral, trithemimeral
τετράφαλος φοίνικι λόφῳ ἐπελάμπετο πήληξ.	-uu- --u u- uu-uu --	dactylic hexameter	feminine penthemimeral, hepthemimeral, trithemimeral
καί ῥʼ ὁ μὲν αὖτις ἔδυνε μέγαν ζόφον· οἱ δʼ ἐσιδόντες	- u u -u u-u u- uu - uu--	dactylic hexameter	feminine penthemimeral, hepthemimeral
θάμβησαν· τοὺς δʼ ὦρσε θεοπροπέων ἐπικέλσαι	--- - -u u-uu- uu--	dactylic hexameter	feminine penthemimeral, trithemimeral
Ἀμπυκίδης Μόψος λοιβῇσί τε μειλίξασθαι.	-uu- -- --u u ----	dactylic hexameter	masculine penthemimeral, trithemimeral
οἱ δʼ ἀνὰ μὲν κραιπνῶς λαῖφος σπάσαν, ἐκ δὲ βαλόντες	- uu - -- -- uu - u u--	dactylic hexameter	masculine penthemimeral, hepthemimeral, trithemimeral
πείσματʼ ἐν αἰγιαλῷ Σθενέλου τάφον ἀμφεπένοντο,	-u u -uu- uu- uu -uu--	dactylic hexameter	masculine penthemimeral, hepthemimeral
χύτλα τέ οἱ χεύοντο, καὶ ἥγνισαν ἔντομα μήλων.	-u u - --u u -uu -uu --	dactylic hexameter	feminine penthemimeral, trithemimeral
ἄνδιχα δʼ αὖ χύτλων νηοσσόῳ Ἀπόλλωνι	-uu - -- --uu ----	dactylic hexameter	masculine penthemimeral, trithemimeral
βωμὸν δειμάμενοι μῆρʼ ἔφλεγον ἂν δὲ καὶ Ὀρφεὺς	-- -uu- - -uu - u u --	dactylic hexameter	masculine penthemimeral
θῆκε λύρην· ἐκ τοῦ δὲ Λύρη πέλει οὔνομα χώρῳ.	-u u- - - u u- uu -uu --	dactylic hexameter	masculine penthemimeral, hepthemimeral, trithemimeral
αὐτίκα δʼ οἵ γʼ ἀνέμοιο κατασπέρχοντος ἔβησαν	-uu - uu-u u---u u--	dactylic hexameter	feminine penthemimeral, trithemimeral
νῆʼ ἔπι· κὰδ δʼ ἄρα λαῖφος ἐρυσσάμενοι τανύοντο	- uu - uu -u u-uu- uu--	dactylic hexameter	feminine penthemimeral, trithemimeral
ἐς πόδας ἀμφοτέρους· ἡ δʼ ἐς πέλαγος πεφόρητο	- uu -uu- - - uu- uu--	dactylic hexameter	masculine penthemimeral, hepthemimeral
ἐντενές, ἠύτε τίς τε διʼ ἠέρος ὑψόθι κίρκος	-uu -uu - u u -uu -uu --	dactylic hexameter	masculine penthemimeral
ταρσὸν ἐφεὶς πνοιῇ φέρεται ταχύς, οὐδὲ τινάσσει	-u u- -- uu- uu -u u--	dactylic hexameter	masculine penthemimeral, hepthemimeral, trithemimeral
ῥιπήν, εὐκήλοισιν ἐνευδιόων πτερύγεσσιν.	-- ---u u-uu- uu--	dactylic hexameter	feminine penthemimeral
καὶ δὴ Παρθενίοιο ῥοὰς ἁλιμυρήεντος,	- - -uu-u u- uu----	dactylic hexameter	feminine penthemimeral, hepthemimeral
πρηυτάτου ποταμοῦ, παρεμέτρεον, ᾧ ἔνι κούρη	--- uu- uu-uu - uu --	dactylic hexameter	masculine penthemimeral, trithemimeral
Λητωίς, ἄγρηθεν ὅτʼ οὐρανὸν εἰσαναβαίνῃ,	--- --u u -uu -uu--	dactylic hexameter	feminine penthemimeral, trithemimeral
ὃν δέμας ἱμερτοῖσιν ἀναψύχει ὑδάτεσσιν.	- uu ---u u-uu ----	dactylic hexameter	feminine penthemimeral
νυκτί δʼ ἔπειτʼ ἄλληκτον ἐπιπροτέρωσε θέοντες	-u u- --u u-uu-u u--	dactylic hexameter	feminine penthemimeral, trithemimeral
σήσαμον αἰπεινούς τε παρεξενέοντʼ Ἐρυθίνους,	-uu --- u u-uu- uu--	dactylic hexameter	masculine penthemimeral
Κρωβίαλον, Κρώμναν τε καὶ ὑλήεντα Κύτωρον.	-uu- -- u u ---u u--	dactylic hexameter	masculine penthemimeral, trithemimeral
ἔνθεν δʼ αὖτε Κάραμβιν ἅμʼ ἠελίοιο βολῇσιν	-- -u u-u u -uu-u u--	dactylic hexameter	feminine penthemimeral
γνάμψαντες παρὰ πουλὺν ἔπειτʼ ἤλαυνον ἐρετμοῖς	--- uu -u u- --u u--	dactylic hexameter	feminine penthemimeral, hepthemimeral, trithemimeral
αἰγιαλὸν πρόπαν ἦμαρ ὁμῶς καὶ ἐπʼ ἤματι νύκτα.	-uu- uu -u u- u u -uu --	dactylic hexameter	feminine penthemimeral, hepthemimeral, trithemimeral
αὐτίκα δʼ Ἀσσυρίης ἐπέβαν χθονός, ἔνθα Σινώπην,	-uu -uu- uu- uu -u u--	dactylic hexameter	masculine penthemimeral, hepthemimeral
θυγατέρʼ Ἀσωποῖο, καθίσσατο, καί οἱ ὄπασσεν	-uu ---u u-uu - u u--	dactylic hexameter	feminine penthemimeral
παρθενίην Ζεὺς αὐτός, ὑποσχεσίῃσι δολωθείς.	-uu- - -u u-uu-u u--	dactylic hexameter	feminine penthemimeral, trithemimeral
δὴ γὰρ ὁ μὲν φιλότητος ἐέλδετο· νεῦσε δʼ ὅ γʼ αὐτῇ	- u u - uu-u u-uu -u u --	dactylic hexameter	feminine penthemimeral, trithemimeral
δωσέμεναι, ὅ κεν ᾗσι μετὰ φρεσὶν ἰθύσειεν.	-uu- u u -u u- uu ----	dactylic hexameter	feminine penthemimeral, hepthemimeral, trithemimeral
ἡ δέ ἑ παρθενίην ᾐτήσατο κερδοσύνῃσιν.	- u u -uu- --uu -uu--	dactylic hexameter	masculine penthemimeral
ὧς δὲ καὶ Ἀπόλλωνα παρήπαφεν εὐνηθῆναι	- u u ---u u-uu ----	dactylic hexameter	feminine penthemimeral
ἱέμενον, ποταμόν τʼ ἐπὶ τοῖς Ἅλυν· οὐδὲ μὲν ἀνδρῶν	-uu- uu- uu - uu -u u --	dactylic hexameter	masculine penthemimeral, hepthemimeral, trithemimeral
τήνγε τις ἱμερτῇσιν ἐν ἀγκοίνῃσι δάμασσεν.	-u u ---u u ---u u--	dactylic hexameter	feminine penthemimeral
ἔνθα δὲ Τρικκαίοιο ἀγαυοῦ Δηιμάχοιο	-u u ---u u-- -uu--	dactylic hexameter	feminine penthemimeral
υἷες, Δηιλέων τε καὶ Αὐτόλυκος Φλογίος τε	-- -uu- u u -uu- uu- -	dactylic hexameter	masculine penthemimeral
τῆμος ἔθʼ, Ἡρακλῆος ἀποπλαγχθέντες, ἔναιον·	-u u ---u u---u u--	dactylic hexameter	feminine penthemimeral
οἵ ῥα τόθʼ, ὡς ἐνόησαν ἀριστήων στόλον ἀνδρῶν,	- u u - uu-u u--- uu --	dactylic hexameter	feminine penthemimeral, trithemimeral
σφᾶς αὐτοὺς νημερτὲς ἐπέφραδον ἀντιάσαντες·	- -- --u u-uu -uu--	dactylic hexameter	feminine penthemimeral, trithemimeral
οὐδʼ ἔτι μιμνάζειν θέλον ἔμπεδον, ἀλλʼ ἐνὶ νηί,	- uu --- uu -uu - uu --	dactylic hexameter	masculine penthemimeral
Ἀργέσταο παρᾶσσον ἐπιπνείοντος, ἔβησαν.	---u u-u u---u u--	dactylic hexameter	feminine penthemimeral
τοῖσι δʼ ὁμοῦ μετέπειτα θοῇ πεφορημένοι αὔρῃ	-u u- uu-u u- uu-uu --	dactylic hexameter	feminine penthemimeral, hepthemimeral, trithemimeral
λεῖπον Ἅλυν ποταμόν, λεῖπον δʼ ἀγχίρροον Ἶριν,	-u u- uu- -- --uu --	dactylic hexameter	masculine penthemimeral, hepthemimeral, trithemimeral
ἠδὲ καὶ Ἀσσυρίης πρόχυσιν χθονός· ἤματι δʼ αὐτῷ	-u u -uu- uu- uu -uu --	dactylic hexameter	masculine penthemimeral, hepthemimeral
γνάμψαν Ἀμαζονίδων ἕκαθεν λιμενήοχον ἄκρην.	-u u-uu- uu- uu-uu --	dactylic hexameter	masculine penthemimeral, hepthemimeral
ἔνθα ποτὲ προμολοῦσαν Ἀρητιάδα Μελανίππην	-u u- uu-u u-uu- uu--	dactylic hexameter	feminine penthemimeral, trithemimeral
ἥρως Ἡρακλέης ἐλοχήσατο, καί οἱ ἄποινα	-- -uu- uu-uu - u u--	dactylic hexameter	masculine penthemimeral
Ἱππολύτη ζωστῆρα παναίολον ἐγγυάλιξεν	-uu- --u u-uu -uu--	dactylic hexameter	feminine penthemimeral, trithemimeral
ἀμφὶ κασιγνήτης· ὁ δʼ ἀπήμονα πέμψεν ὀπίσσω.	-u u--- u u-uu -u u--	dactylic hexameter	masculine penthemimeral
τῆς οἵ γʼ ἐν κόλπῳ, προχοαῖς ἔπι Θερμώδοντος,	- - - -- uu- uu ----	dactylic hexameter	masculine penthemimeral, hepthemimeral, trithemimeral
κέλσαν, ἐπεὶ καὶ πόντος ὀρίνετο νισσομένοισιν.	-u u- - -u u-uu -uu--	dactylic hexameter	feminine penthemimeral, trithemimeral
τῷ δʼ οὔτις ποταμῶν ἐναλίγκιος, οὐδὲ ῥέεθρα	- -- uu- uu-uu -u u--	dactylic hexameter	masculine penthemimeral, trithemimeral
τόσσʼ ἐπὶ γαῖαν ἵησι παρὲξ ἕθεν ἄνδιχα βάλλων.	- uu -u u-u u- uu -uu --	dactylic hexameter	feminine penthemimeral, hepthemimeral
τετράκις εἰς ἑκατὸν δεύοιτό κεν, εἴ τις ἕκαστα	-uu - uu- --u u - u u--	dactylic hexameter	masculine penthemimeral, trithemimeral
πεμπάζοι· μία δʼ οἴη ἐτήτυμος ἔπλετο πηγή.	--- uu -u u-uu -uu --	dactylic hexameter	feminine penthemimeral, trithemimeral
ἡ μέν τʼ ἐξ ὀρέων κατανίσσεται ἤπειρόνδε	- - - uu- uu-uu ----	dactylic hexameter	masculine penthemimeral, trithemimeral
ὑψηλῶν, ἅ τέ φασιν Ἀμαζόνια κλείεσθαι.	--- u u -u u-uu- ---	dactylic hexameter	feminine penthemimeral, trithemimeral
ἔνθεν δʼ αἰπυτέρην ἐπικίδναται ἔνδοθι γαῖαν	-- -uu- uu-uu -uu --	dactylic hexameter	masculine penthemimeral
ἀντικρύ· τῶ καί οἱ ἐπίστροφοί εἰσι κέλευθοι·	--- - - u u-uu -u u--	dactylic hexameter	masculine penthemimeral, trithemimeral
αἰεὶ δʼ ἄλλυδις ἄλλη, ὅπῃ κύρσειε μάλιστα	-- -uu -u u- --u u--	dactylic hexameter	feminine penthemimeral, hepthemimeral
ἠπείρου χθαμαλῆς, εἱλίσσεται· ἡ μὲν ἄπωθεν,	--- uu- --uu - u u--	dactylic hexameter	masculine penthemimeral, trithemimeral
ἡ δὲ πέλας· πολέες δὲ πόροι νώνυμνοι ἔασιν,	- u u- uu- u u- --u u--	dactylic hexameter	masculine penthemimeral, hepthemimeral, trithemimeral
ὅππῃ ὑπεξαφύονται· ὁ δʼ ἀμφαδὸν ἄμμιγα παύροις	-u u-uu-u u -uu -uu --	dactylic hexameter	feminine penthemimeral
πόντον ἐς Ἄξεινον κυρτὴν ὑπερεύγεται ἄκρην.	-u u --- -- uu-uu --	dactylic hexameter	masculine penthemimeral, hepthemimeral
καί νύ κε δηθύνοντες Ἀμαζονίδεσσιν ἔμιξαν	- u u ---u u-uu-u u--	dactylic hexameter	feminine penthemimeral
ὑσμίνην, καὶ δʼ οὔ κεν ἀναιμωτί γ᾽ἐρίδηναν	--- - - u u--- uu---	lyric	
οὐ γὰρ Ἀμαζονίδες μάλʼ ἐπήτιδες, οὐδὲ θέμιστας	- u u-uu- u u-uu -u u--	dactylic hexameter	masculine penthemimeral
τίουσαι πεδίον Δοιάντιον ἀμφενέμοντο·	--- uu- --uu -uu--	dactylic hexameter	masculine penthemimeral, trithemimeral
ἀλλʼ ὕβρις στονόεσσα καὶ Ἄρεος ἔργα μεμήλει·	- -- uu-u u -uu -u u--	dactylic hexameter	feminine penthemimeral, trithemimeral
δὴ γὰρ καὶ γενεὴν ἔσαν Ἄρεος Ἁρμονίης τε	- - - uu- uu -uu -uu- -	dactylic hexameter	masculine penthemimeral, trithemimeral
νύμφης, ἥ τʼ Ἄρηϊ φιλοπτολέμους τέκε κούρας,	-- - --u u-uu- uu --	dactylic hexameter	feminine penthemimeral, trithemimeral
ἄλσεος Ἀκμονίοιο κατὰ πτύχας εὐνηθεῖσα	-uu -uu-u u- uu -----	lyric	
εἰ μὴ ἄρʼ ἐκ Διόθεν πνοιαὶ πάλιν Ἀργέσταο	- u u - uu- -- uu ----	dactylic hexameter	masculine penthemimeral, hepthemimeral, trithemimeral
ἤλυθον· οἱ δʼ ἀνέμῳ περιηγέα κάλλιπον ἀκτήν,	-uu - uu- uu-uu -uu --	dactylic hexameter	masculine penthemimeral, trithemimeral
ἔνθα Θεμισκύρειαι Ἀμαζόνες ὡπλίζοντο.	-u u---u u-uu ----	dactylic hexameter	feminine penthemimeral
οὐ γὰρ ὁμηγερέες μίαν ἂμ πόλιν, ἀλλʼ ἀνὰ γαῖαν	- u u-uu- uu - uu - uu --	dactylic hexameter	masculine penthemimeral, hepthemimeral
κεκριμέναι κατὰ φῦλα διάτριχα ναιετάασκον·	-uu- uu -u u-uu -uu--	dactylic hexameter	feminine penthemimeral, trithemimeral
νόσφι μὲν αἵδʼ αὐταί, τῇσιν τότε κοιρανέεσκεν	-u u - -- -- uu -uu--	dactylic hexameter	masculine penthemimeral, hepthemimeral, trithemimeral
Ἱππολύτη, νόσφιν δὲ Λυκάστιαι ἀμφενέμοντο,	-uu- -- u u-uu -uu--	dactylic hexameter	masculine penthemimeral, trithemimeral
νόσφι δʼ ἀκοντοβόλοι Χαδήσιαι. ἤματι δʼ ἄλλῳ	-u u-uu- --uu -uu --	dactylic hexameter	masculine penthemimeral
νυκτί τʼ ἐπιπλομένῃ Χαλύβων παρὰ γαῖαν ἵκοντο.	-u u-uu- uu- uu -u u--	dactylic hexameter	masculine penthemimeral, hepthemimeral
τοῖσι μὲν οὔτε βοῶν ἄροτος μέλει, οὔτε τις ἄλλη	-u u -u u- uu- uu -u u --	dactylic hexameter	masculine penthemimeral, hepthemimeral
φυταλιὴ καρποῖο μελίφρονος· οὐδὲ μὲν οἵγε	-uu- --u u-uu -u u --	dactylic hexameter	feminine penthemimeral, trithemimeral
ποίμνας ἑρσήεντι νομῷ ἔνι ποιμαίνουσιν.	-- ---u u- uu ----	dactylic hexameter	feminine penthemimeral, hepthemimeral
ἀλλὰ σιδηροφόρον στυφελὴν χθόνα γατομέοντες	-u u-uu- uu- uu -uu--	dactylic hexameter	masculine penthemimeral, hepthemimeral
ὦνον ἀμείβονται βιοτήσιον, οὐδέ ποτέ σφιν	-u u--- uu-uu -u u- -	dactylic hexameter	masculine penthemimeral
ἠὼς ἀντέλλει καμάτων ἄτερ, ἀλλὰ κελαινῇ	-- --- uu- uu -u u--	dactylic hexameter	masculine penthemimeral, hepthemimeral
λιγνύι καὶ καπνῷ κάματον βαρὺν ὀτλεύουσιν.	-- - -- uu- uu ----	dactylic hexameter	masculine penthemimeral, hepthemimeral, trithemimeral
τοὺς δὲ μετʼ αὐτίκʼ ἔπειτα Γενηταίου Διὸς ἄκρην	- u u -u u-u u--- uu --	dactylic hexameter	feminine penthemimeral
γνάμψαντες σώοντο παρὲκ Τιβαρηνίδα γαῖαν.	--- --u u- uu-uu --	dactylic hexameter	feminine penthemimeral, hepthemimeral, trithemimeral
ἔνθʼ ἐπεὶ ἄρ κε τέκωνται ὑπʼ ἀνδράσι τέκνα γυναῖκες,	- uu - u u-u u -uu -u u--	dactylic hexameter	feminine penthemimeral, trithemimeral
αὐτοὶ μὲν στενάχουσιν ἐνὶ λεχέεσσι πεσόντες,	-- - uu-u u- uu-u u--	dactylic hexameter	feminine penthemimeral, hepthemimeral, trithemimeral
κράατα δησάμενοι· ταὶ δʼ εὖ κομέουσιν ἐδωδῇ	-uu -uu- - - uu-u u--	dactylic hexameter	masculine penthemimeral, hepthemimeral
ἀνέρας, ἠδὲ λοετρὰ λεχώια τοῖσι πένονται.	-uu -u u-u u-uu -u u--	dactylic hexameter	feminine penthemimeral
ἱρὸν δʼ αὖτʼ ἐπὶ τοῖσιν ὄρος καὶ γαῖαν ἄμειβον,	-- - uu -u u- - -u u--	dactylic hexameter	feminine penthemimeral, hepthemimeral, trithemimeral
ᾗ ἔνι Μοσσύνοικοι ἀνʼ οὔρεα ναιετάουσιν	- uu ---u u -uu -uu--	dactylic hexameter	feminine penthemimeral
μόσσυνας, καὶ δʼ αὐτοὶ ἐπώνυμοι ἔνθεν ἔασιν.	--- - -u u-uu -u u--	dactylic hexameter	feminine penthemimeral, trithemimeral
ἀλλοίη δὲ δίκη καὶ θέσμια τοῖσι τέτυκται.	--- u u- - -uu -u u--	dactylic hexameter	masculine penthemimeral, trithemimeral
ὅσσα μὲν ἀμφαδίην ῥέζειν θέμις, ἢ ἐνὶ δήμῳ,	-u u -uu- -- uu - uu --	dactylic hexameter	masculine penthemimeral, hepthemimeral
ἢ ἀγορῇ, τάδε πάντα δόμοις ἔνι μηχανόωνται·	- uu- uu -u u- uu -uu--	dactylic hexameter	feminine penthemimeral, hepthemimeral, trithemimeral
ὅσσα δʼ ἐνὶ μεγάροις πεπονήμεθα, κεῖνα θύραζε	-u u- uu- uu-uu -u u--	dactylic hexameter	masculine penthemimeral, trithemimeral
ἀψεγέως μέσσῃσιν ἐνὶ ῥέζουσιν ἀγυιαῖς.	-uu- --u u- --u u--	dactylic hexameter	feminine penthemimeral, hepthemimeral, trithemimeral
οὐδʼ εὐνῆς αἰδὼς ἐπιδήμιος, ἀλλά, σύες ὣς	- -- -- uu-uu -u u- -	dactylic hexameter	masculine penthemimeral, trithemimeral
φορβάδες, οὐδʼ ἠβαιὸν ἀτυζόμενοι παρεόντας,	-uu - --u u-uu- uu--	dactylic hexameter	feminine penthemimeral, trithemimeral
μίσγονται χαμάδις ξυνῇ φιλότητι γυναικῶν.	--- uu- -- uu-u u--	dactylic hexameter	masculine penthemimeral, hepthemimeral, trithemimeral
αὐτὰρ ἐν ὑψίστῳ βασιλεὺς μόσσυνι θαάσσων	-u u --- uu- --u u--	dactylic hexameter	masculine penthemimeral, hepthemimeral
ἰθείας πολέεσσι δίκας λαοῖσι δικάζει,	--- uu-u u- --u u--	dactylic hexameter	feminine penthemimeral, hepthemimeral, trithemimeral
σχέτλιος. ἢν γάρ πού τί θεμιστεύων ἀλίτηται,	-uu - - - u u--- uu--	dactylic hexameter	masculine penthemimeral, trithemimeral
λιμῷ μιν κεῖνʼ ἦμαρ ἐνικλείσαντες ἔχουσιν.	-- - - -u u---u u--	dactylic hexameter	feminine penthemimeral, trithemimeral
τοὺς παρανισσόμενοι καὶ δὴ σχεδὸν ἀντιπέρηθεν	- uu-uu- - - uu -uu--	dactylic hexameter	masculine penthemimeral, hepthemimeral
νήσου Ἀρητιάδος τέμνον πλόον εἰρεσίῃσιν	-u u-uu- -- uu -uu--	dactylic hexameter	masculine penthemimeral, hepthemimeral
ἠμάτιοι· λιαρὴ γὰρ ὑπὸ κνέφας ἔλλιπεν αὔρη.	-uu- uu- u u- uu -uu --	dactylic hexameter	masculine penthemimeral, hepthemimeral, trithemimeral
ἤδη καί τινʼ ὕπερθεν Ἀρήιον ἀίσσοντα	-- - u u-u u-uu ----	dactylic hexameter	feminine penthemimeral, trithemimeral
ἐνναέτην νήσοιο διʼ ἠέρος ὄρνιν ἴδοντο,	-uu- --u u -uu -u u--	dactylic hexameter	feminine penthemimeral, trithemimeral
ὅς ῥα τιναξάμενος πτέρυγας κατὰ νῆα θέουσαν	- u u-uu- uu- uu -u u--	dactylic hexameter	masculine penthemimeral, hepthemimeral
ἧκʼ ἐπί οἱ πτερὸν ὀξύ· τὸ δʼ ἐν λαιῷ πέσεν ὤμῳ	- uu - uu -u u - -- uu --	dactylic hexameter	feminine penthemimeral, hepthemimeral, trithemimeral
δίου Ὀιλῆος· μεθέηκε δὲ χερσὶν ἐρετμὸν	-u u--- uu-u u -u u--	dactylic hexameter	masculine penthemimeral
βλήμενος· οἱ δὲ τάφον πτερόεν βέλος εἰσορόωντες.	-uu - u u- uu- uu -uu--	dactylic hexameter	masculine penthemimeral, hepthemimeral, trithemimeral
καὶ τὸ μὲν ἐξείρυσσε παρεδριόων Ἐρυβώτης,	- u u ---u u-uu- uu--	dactylic hexameter	feminine penthemimeral
ἕλκος δὲ ξυνέδησεν, ἀπὸ σφετέρου κολεοῖο	-- - uu-u u- uu- uu--	dactylic hexameter	feminine penthemimeral, hepthemimeral, trithemimeral
λυσάμενος τελαμῶνα κατήορον· ἐκ δʼ ἐφαάνθη	-uu- uu-u u-uu - uu--	dactylic hexameter	feminine penthemimeral, trithemimeral
ἄλλος ἐπὶ προτέρῳ πεποτημένος· ἀλλά μιν ἥρως	-u u- uu- uu-uu -u u --	dactylic hexameter	masculine penthemimeral, trithemimeral
Εὐρυτίδης Κλυτίος (πρὸ γὰρ ἀγκύλα τείνατο τόξα,	-uu- uu- u u -uu -uu --	dactylic hexameter	masculine penthemimeral, trithemimeral
ἧκε δʼ ἐπʼ οἰωνὸν ταχινὸν βέλος) αὐτὰρ ἔπειτα	-u u --- uu- uu -u u--	dactylic hexameter	masculine penthemimeral, hepthemimeral
πλῆξεν· δινηθεὶς δὲ θοῆς πέσεν ἀγχόθι νηός.	-- --- u u- uu -uu --	dactylic hexameter	masculine penthemimeral, hepthemimeral
τοῖσιν δʼ Ἀμφιδάμας μυθήσατο, παῖς Ἀλεοῖο·	-- -uu- --uu - uu--	dactylic hexameter	masculine penthemimeral
‘νῆσος μὲν πέλας ἧμιν Ἀρητιάς· ἴστε καὶ αὐτοὶ	-- - uu -u u-uu -u u --	dactylic hexameter	feminine penthemimeral, trithemimeral
τούσδʼ ὄρνιθας ἰδόντες. ἐγὼ δʼ οὐκ ἔλπομαι ἰοὺς	- --u u-u u- - -uu --	dactylic hexameter	feminine penthemimeral, hepthemimeral
τόσσον ἐπαρκέσσειν εἰς ἔκβασιν. ἀλλά τινʼ ἄλλην	-u u--- - -uu -u u --	dactylic hexameter	masculine penthemimeral
μῆτιν πορσύνωμεν ἐπίρροθον, εἴ γ᾽ἐπικέλσαι	-- ---u u-uu - uu--	dactylic hexameter	feminine penthemimeral
μέλλετε, Φινῆος μεμνημένοι, ὡς ἐπέτελλεν.	-uu --- --uu - uu--	dactylic hexameter	masculine penthemimeral
οὐδὲ γὰρ Ἡρακλέης, ὁπότʼ ἤλυθεν Ἀρκαδίηνδε,	-u u -uu- uu -uu -uu--	dactylic hexameter	masculine penthemimeral
πλωίδας ὄρνιθας Στυμφαλίδας ἔσθενε λίμνης	-uu --- --uu -uu --	dactylic hexameter	masculine penthemimeral
ὤσασθαι τόξοισι, τὸ μέν τʼ ἐγὼ αὐτὸς ὄπωπα.	--- --u u - uu -u u--	dactylic hexameter	feminine penthemimeral, hepthemimeral, trithemimeral
ἀλλʼ ὅγε χαλκείην πλατάγην ἐνὶ χερσὶ τινάσσων	- uu --- uu- uu -u u--	dactylic hexameter	masculine penthemimeral, hepthemimeral
δούπει ἐπὶ σκοπιῆς περιμήκεος· αἱ δʼ ἐφέβοντο	-u u- uu- uu-uu - uu--	dactylic hexameter	masculine penthemimeral, trithemimeral
τηλοῦ, ἀτυζηλῷ ὑπὸ δείματι κεκληγυῖαι.	-u u--- uu -uu ----	dactylic hexameter	masculine penthemimeral
τῶ καὶ νῦν τοίην τινʼ ἐπιφραζώμεθα μῆτιν·	- - - -- u u---uu --	dactylic hexameter	masculine penthemimeral, trithemimeral
αὐτὸς δʼ ἂν τὸ πάροιθεν ἐπιφρασθεὶς ἐνέποιμι.	-- - u u-u u--- uu--	dactylic hexameter	feminine penthemimeral, trithemimeral
ἀνθέμενοι κεφαλῇσιν ἀερσιλόφους τρυφαλείας,	-uu- uu-u u-uu- uu--	dactylic hexameter	feminine penthemimeral, trithemimeral
ἡμίσεες μὲν ἐρέσσετʼ ἀμοιβαδίς, ἡμίσεες δὲ	-uu- u u-u u-uu -uu- -	dactylic hexameter	feminine penthemimeral, trithemimeral
δούρασί τε ξυστοῖσι καὶ ἀσπίσιν ἄρσετε νῆα.	-uu - --u u -uu -uu --	dactylic hexameter	feminine penthemimeral, trithemimeral
αὐτὰρ πασσυδίῃ περιώσιον ὄρνυτʼ ἀυτὴν	-- -uu- uu-uu -u u--	dactylic hexameter	masculine penthemimeral
ἀθρόοι, ὄφρα κολῳὸν ἀηθείῃ φοβέωνται	-uu -u u-u u--- uu--	dactylic hexameter	feminine penthemimeral
νεύοντάς τε λόφους καὶ ἐπήορα δούραθʼ ὕπερθεν.	--- u u- u u-uu -u u--	dactylic hexameter	masculine penthemimeral, trithemimeral
εἰ δέ κεν αὐτὴν νῆσον ἱκώμεθα, δὴ τότʼ ἔπειτα	- u u -- -u u-uu - u u--	dactylic hexameter	feminine penthemimeral
σὺν κελάδῳ σακέεσσι πελώριον ὄρσετε δοῦπον.’	- uu- uu-u u-uu -uu --	dactylic hexameter	feminine penthemimeral, trithemimeral
ὧς ἄρʼ ἔφη· πάντεσσι δʼ ἐπίρροθος ἥνδανε μῆτις.	- u u- --u u-uu -uu --	dactylic hexameter	feminine penthemimeral, trithemimeral
ἀμφὶ δὲ χαλκείας κόρυθας κεφαλῇσιν ἔθεντο	-u u --- uu- uu-u u--	dactylic hexameter	masculine penthemimeral, hepthemimeral
δεινὸν λαμπομένας, ἐπὶ δὲ λόφοι ἐσσείοντο	-- -uu- uu - uu ----	dactylic hexameter	masculine penthemimeral, hepthemimeral
φοινίκεοι. καὶ τοὶ μὲν ἀμοιβήδην ἐλάασκον·	-uu- - - u u--- uu--	dactylic hexameter	masculine penthemimeral, trithemimeral
τοὶ δʼ αὖτʼ ἐγχείῃσι καὶ ἀσπίσι νῆʼ ἐκάλυψαν.	- - ---u u -uu - uu--	dactylic hexameter	feminine penthemimeral
ὡς δʼ ὅτε τις κεράμῳ κατερέψεται ἑρκίον ἀνήρ,	- uu - uu- uu-uu -uu --	dactylic hexameter	masculine penthemimeral, trithemimeral
δώματος ἀγλαΐην τε καὶ ὑετοῦ ἔμμεναι ἄλκαρ,	-uu -uu- u u -uu -uu --	dactylic hexameter	masculine penthemimeral
ἄλλῳ δʼ ἔμπεδον ἄλλος ὁμῶς ἐπαμοιβὸς ἄρηρεν·	-- -uu -u u- uu-u u--	dactylic hexameter	feminine penthemimeral, hepthemimeral
ὧς οἵ γʼ ἀσπίσι νῆα συναρτύναντες ἔρεψαν.	- - -uu -u u---u u--	dactylic hexameter	feminine penthemimeral
οἵη δὲ κλαγγὴ δῄου πέλει ἐξ ὁμάδοιο	-- - -- -- uu - uu--	dactylic hexameter	masculine penthemimeral, hepthemimeral, trithemimeral
ἀνδρῶν κινυμένων, ὁπότε ξυνίωσι φάλαγγες,	-- -uu- uu- uu-u u--	dactylic hexameter	masculine penthemimeral, hepthemimeral
τοίη ἄρʼ ὑψόθι νηὸς ἐς ἠέρα κίδνατʼ ἀυτή.	-u u -uu -u u -uu -u u--	dactylic hexameter	feminine penthemimeral
οὐδέ τινʼ οἰωνῶν ἔτʼ ἐσέδρακον, ἀλλʼ ὅτε νήσῳ	-u u --- u u-uu - uu --	dactylic hexameter	masculine penthemimeral
χρίμψαντες σακέεσσιν ἐπέκτυπον, αὐτίκʼ ἄρʼ οἵγε	--- uu-u u-uu -u u --	dactylic hexameter	feminine penthemimeral, trithemimeral
μυρίοι ἔνθα καὶ ἔνθα πεφυζότες ἠερέθοντο.	-uu -u u -u u-uu -uu--	dactylic hexameter	feminine penthemimeral
ὡς δʼ ὁπότε Κρονίδης πυκινὴν ἐφέηκε χάλαζαν	- uu- uu- uu- uu-u u--	dactylic hexameter	masculine penthemimeral, hepthemimeral, trithemimeral
ἐκ νεφέων ἀνά τʼ ἄστυ καὶ οἰκία, τοὶ δʼ ὑπὸ τοῖσιν	- uu- uu -u u -uu - uu --	dactylic hexameter	feminine penthemimeral, trithemimeral
ἐνναέται κόναβον τεγέων ὕπερ εἰσαΐοντες	-uu- uu- uu- uu -uu--	dactylic hexameter	masculine penthemimeral, hepthemimeral, trithemimeral
ἧνται ἀκήν, ἐπεὶ οὔ σφε κατέλλαβε χείματος ὥρη	-u u- uu - u u-uu -uu --	dactylic hexameter	masculine penthemimeral, trithemimeral
ἀπροφάτως, ἀλλὰ πρὶν ἐκαρτύναντο μέλαθρον·	-uu- -- u u---u u--	dactylic hexameter	masculine penthemimeral, trithemimeral
ὧς πυκινὰ πτερὰ τοῖσιν ἐφίεσαν ἀίσσοντες	- uu- uu -u u-uu ----	dactylic hexameter	feminine penthemimeral, trithemimeral
ὕψι μάλʼ ἂμ πέλαγος περάτης εἰς οὔρεα γαίης.	-u u - uu- uu- - -uu --	dactylic hexameter	masculine penthemimeral, hepthemimeral, trithemimeral
τίς γὰρ δὴ Φινῆος ἔην νόος, ἐνθάδε κέλσαι	- - - --u u- uu -uu --	dactylic hexameter	feminine penthemimeral, hepthemimeral, trithemimeral
ἀνδρῶν ἡρώων θεῖον στόλον; ἢ καὶ ἔπειτα	-- --- -- uu - u u--	dactylic hexameter	masculine penthemimeral, hepthemimeral
ποῖον ὄνειαρ ἔμελλεν ἐελδομένοισιν ἱκέσθαι;	-u u-u u-u u-uu-u u--	dactylic hexameter	feminine penthemimeral
υἱῆες Φρίξοιο μετὰ πτόλιν Ὀρχομενοῖο	--- --u u- uu -uu--	dactylic hexameter	feminine penthemimeral, hepthemimeral, trithemimeral
ἐξ Αἴης ἐνέοντο παρʼ Αἰήταο Κυταίου,	- -- uu-u u ---u u--	dactylic hexameter	feminine penthemimeral, trithemimeral
Κολχίδα νῆʼ ἐπιβάντες, ἵνʼ ἄσπετον ὄλβον ἄρωνται	-uu - uu-u u -uu -u u--	dactylic hexameter	feminine penthemimeral, trithemimeral
πατρός· ὁ γὰρ θνῄσκων ἐπετείλατο τήνδε κέλευθον.	-u u - -- uu-uu -u u--	dactylic hexameter	masculine penthemimeral, trithemimeral
καὶ δὴ ἔσαν νήσοιο μάλα σχεδὸν ἤματι κείνῳ.	- u u- --u u- uu -uu --	dactylic hexameter	feminine penthemimeral, hepthemimeral, trithemimeral
Ζεὺς δʼ ἀνέμου βορέαο μένος κίνησεν ἀῆναι,	- uu- uu-u u- --u u--	dactylic hexameter	feminine penthemimeral, hepthemimeral, trithemimeral
ὕδατι σημαίνων διερὴν ὁδὸν Ἀρκτούροιο·	-uu --- uu- uu ----	dactylic hexameter	masculine penthemimeral, hepthemimeral
αὐτὰρ ὅ γʼ ἠμάτιος μὲν ἐν οὔρεσι φύλλʼ ἐτίνασσεν	-u u -uu- u u -uu - uu--	dactylic hexameter	masculine penthemimeral
τυτθὸν ἐπʼ ἀκροτάτοισιν ἀήσυρος ἀκρεμόνεσσιν·	-u u -uu-u u-uu -uu--	dactylic hexameter	feminine penthemimeral
νυκτὶ δʼ ἔβη πόντονδε πελώριος, ὦρσε δὲ κῦμα	-u u- --u u-uu -u u --	dactylic hexameter	feminine penthemimeral, trithemimeral
κεκληγὼς πνοιῇσι· κελαινὴ δʼ οὐρανὸν ἀχλὺς	--- --u u-- -uu --	dactylic hexameter	feminine penthemimeral, trithemimeral
ἄμπεχεν, οὐδέ πῃ ἄστρα διαυγέα φαίνετʼ ἰδέσθαι	-uu -u u -u u-uu -u u--	dactylic hexameter	feminine penthemimeral
ἐκ νεφέων, σκοτόεις δὲ περὶ ζόφος ἠρήρειστο.	- uu- uu- u u- uu ----	dactylic hexameter	masculine penthemimeral, hepthemimeral, trithemimeral
οἱ δʼ ἄρα μυδαλέοι, στυγερὸν τρομέοντες ὄλεθρον,	- uu -uu- uu- uu-u u--	dactylic hexameter	masculine penthemimeral, hepthemimeral
υἱῆες Φρίξοιο φέρονθʼ ὑπὸ κύμασιν αὔτως.	--- --u u- uu -uu --	dactylic hexameter	feminine penthemimeral, hepthemimeral, trithemimeral
ἱστία δʼ ἐξήρπαξʼ ἀνέμου μένος, ἠδὲ καὶ αὐτὴν	-uu --- uu- uu -u u --	dactylic hexameter	masculine penthemimeral, hepthemimeral
νῆα διάνδιχʼ ἔαξε τινασσομένην ῥοθίοισιν.	-u u-u u-u u-uu- uu--	dactylic hexameter	feminine penthemimeral
ἔνθα δʼ ὑπʼ ἐννεσίῃσι θεῶν πίσυρές περ ἐόντες	-u u -uu-u u- uu- u u--	dactylic hexameter	feminine penthemimeral, hepthemimeral
δούρατος ὠρέξαντο πελωρίου, οἷά τε πολλὰ	-uu ---u u-uu -u u --	dactylic hexameter	feminine penthemimeral
ῥαισθείσης κεκέδαστο θόοις συναρηρότα γόμφοις.	--- uu-u u- uu-uu --	dactylic hexameter	feminine penthemimeral, hepthemimeral, trithemimeral
καὶ τοὺς μὲν νῆσόνδε, παρὲξ ὀλίγον θανάτοιο,	- - - --u u- uu- uu--	dactylic hexameter	feminine penthemimeral, hepthemimeral, trithemimeral
κύματα καὶ ῥιπαὶ ἀνέμου φέρον ἀσχαλόωντας.	-uu - uu --- uu -uu--	dactylic hexameter	hepthemimeral, trithemimeral
αὐτίκα δʼ ἐρράγη ὄμβρος ἀθέσφατος, ὗε δὲ πόντον	-uu -uu -u u-uu -u u --	dactylic hexameter	feminine penthemimeral
καὶ νῆσον καὶ πᾶσαν ὅσην κατεναντία νήσου	- -- - -u u- uu-uu --	dactylic hexameter	feminine penthemimeral, hepthemimeral, trithemimeral
χώρην Μοσσύνοικοι ὑπέρβιοι ἀμφενέμοντο.	-- ---u u-uu -uu--	dactylic hexameter	feminine penthemimeral
τοὺς δʼ ἄμυδις κρατερῷ σὺν δούρατι κύματος ὁρμὴ	- uu- uu- - -uu -uu --	dactylic hexameter	masculine penthemimeral, trithemimeral
υἱῆας Φρίξοιο μετʼ ἠιόνας βάλε νήσου	--- --u u -uu- uu --	dactylic hexameter	feminine penthemimeral, trithemimeral
νύχθʼ ὕπο λυγαίην· τὸ δὲ μυρίον ἐκ Διὸς ὕδωρ	- uu --- u u -uu - uu --	dactylic hexameter	masculine penthemimeral
λῆξεν ἅμʼ ἠελίω·ͅ τάχα δʼ ἐγγύθεν ἀντεβόλησαν	-u u -uu- uu -uu -uu--	dactylic hexameter	masculine penthemimeral
ἀλλήλοις, Ἄργος δὲ παροίτατος ἔκφατο μῦθον·	--- -- u u-uu -uu --	dactylic hexameter	masculine penthemimeral, trithemimeral
‘Ἀντόμεθα πρὸς Ζηνὸς Ἐποψίου, οἵτινές ἐστε	-uu- - -u u-uu -uu --	dactylic hexameter	feminine penthemimeral, trithemimeral
ἀνδρῶν, εὐμενέειν τε καὶ ἀρκέσσαι χατέουσιν.	-- -uu- u u --- uu--	dactylic hexameter	masculine penthemimeral
πόντῳ γὰρ τρηχεῖαι ἐπιβρίσασαι ἄελλαι	-- - --u u-uu- ---	dactylic hexameter	feminine penthemimeral, trithemimeral
νηὸς ἀεικελίης διὰ δούρατα πάντʼ ἐκέδασσαν,	-u u-uu- uu -uu - uu--	dactylic hexameter	masculine penthemimeral
ᾗ ἔνι πείρομεν οἶμον ἐπὶ χρέος ἐμβεβαῶτες.	- uu -uu -u u- uu -uu--	dactylic hexameter	feminine penthemimeral, hepthemimeral
τούνεκα νῦν ὑμέας γουναζόμεθʼ, αἴ κε πίθησθε,	-uu - uu- --uu - u u--	dactylic hexameter	masculine penthemimeral, trithemimeral
δοῦναι ὅσον τʼ εἴλυμα περὶ χροός, ἠδὲ κομίσσαι	-u u- --u u- uu -u u--	dactylic hexameter	feminine penthemimeral, hepthemimeral, trithemimeral
ἀνέρας οἰκτείραντας ὁμήλικας ἐν κακότητι.	-uu ---u u-uu - uu--	dactylic hexameter	feminine penthemimeral
ἀλλʼ ἱκέτας ξείνους Διὸς εἵνεκεν αἰδέσσασθε	- uu- -- uu -uu ----	dactylic hexameter	masculine penthemimeral, trithemimeral
ξεινίου Ἱκεσίου τε· Διὸς δʼ ἄμφω ἱκέται τε	-uu -uu- u u- -- uu- -	dactylic hexameter	masculine penthemimeral, hepthemimeral
καὶ ξεῖνοι· ὁ δέ που καὶ ἐπόψιος ἄμμι τέτυκται.’	- -- u u - u u-uu -u u--	dactylic hexameter	masculine penthemimeral, trithemimeral
τὸν δʼ αὖτʼ Αἴσονος υἱὸς ἐπιφραδέως ἐρέεινεν,	- - -uu -u u-uu- uu--	dactylic hexameter	feminine penthemimeral
μαντοσύνας Φινῆος ὀισσάμενος τελέεσθαι·	-uu- --u u-uu- uu--	dactylic hexameter	feminine penthemimeral, trithemimeral
‘ταῦτα μὲν αὐτίκα πάντα παρέξομεν εὐμενέοντες.	-u u -uu -u u-uu -uu--	dactylic hexameter	feminine penthemimeral
ἀλλʼ ἄγε μοι κατάλεξον ἐτήτυμον, ὁππόθι γαίης	- uu - uu-u u-uu -uu --	dactylic hexameter	feminine penthemimeral, trithemimeral
ναίετε, καὶ χρέος οἷον ὑπεὶρ ἅλα νεῖσθαι ἀνώγει,	-uu - uu -u u- uu -u u--	dactylic hexameter	feminine penthemimeral, hepthemimeral, trithemimeral
αὐτῶν θ᾽ὑμείων ὄνομα κλυτόν, ἠδὲ γενέθλην.’	-- --- uu- uu -u u--	dactylic hexameter	masculine penthemimeral, hepthemimeral
τὸν δʼ Ἄργος προσέειπεν ἀμηχανέων κακότητι·	- -- uu-u u-uu- uu--	dactylic hexameter	feminine penthemimeral, trithemimeral
‘Αἰολίδην Φρίξον τινʼ ἀφʼ Ἑλλάδος Αἶαν ἱκέσθαι	-uu- -- u u -uu -u u--	dactylic hexameter	masculine penthemimeral, trithemimeral
ἀτρεκέως δοκέω που ἀκούετε καὶ πάρος αὐτοί,	-uu- uu- u u-uu - uu --	dactylic hexameter	masculine penthemimeral, trithemimeral
Φρίξον, ὅτις πτολίεθρον ἀνήλυθεν Αἰήταο,	-u u- uu-u u-uu ----	dactylic hexameter	feminine penthemimeral, trithemimeral
κριοῦ ἐπεμβεβαώς, τόν ῥα χρύσειον ἔθηκεν	-u u-uu- - - --u u--	dactylic hexameter	masculine penthemimeral, hepthemimeral
Ἑρμείας· κῶας δὲ καὶ εἰσέτι νῦν κεν ἴδοισθε.	--- -- u u -uu - u u--	dactylic hexameter	masculine penthemimeral, trithemimeral
τὸν μὲν ἔπειτʼ ἔρρεξεν ἑῇς ὑποθημοσύνῃσιν	- u u- --u u- uu-uu--	dactylic hexameter	feminine penthemimeral, hepthemimeral, trithemimeral
Φυξίῳ ἐκ πάντων Κρονίδῃ Διί. καί μιν ἔδεκτο	-uu - -- uu- uu - u u--	dactylic hexameter	masculine penthemimeral, hepthemimeral, trithemimeral
Αἰήτης μεγάρῳ, κούρην τέ οἱ ἐγγυάλιξεν	--- uu- -- u u -uu--	dactylic hexameter	masculine penthemimeral, hepthemimeral, trithemimeral
Χαλκιόπην ἀνάεδνον ἐυφροσύνῃσι νόοιο.	-uu- uu-u u-uu-u u--	dactylic hexameter	feminine penthemimeral, trithemimeral
τῶν ἐξ ἀμφοτέρων εἰμὲν γένος. ἀλλʼ ὁ μὲν ἤδη	- - -uu- -- uu - u u --	dactylic hexameter	masculine penthemimeral, hepthemimeral
γηραιὸς θάνε Φρίξος ἐν Αἰήταο δόμοισιν·	--- uu -u u ---u u--	dactylic hexameter	feminine penthemimeral, trithemimeral
ἡμεῖς δʼ αὐτίκα πατρὸς ἐφετμάων ἀλέγοντες	-- -uu -u u--- uu--	dactylic hexameter	feminine penthemimeral
νεύμεθʼ ἐς Ὀρχομενὸν κτεάνων Ἀθάμαντος ἕκητι.	-u u -uu- uu- uu-u u--	dactylic hexameter	masculine penthemimeral, hepthemimeral
εἰ δὲ καὶ οὔνομα δῆθεν ἐπιθύεις δεδαῆσθαι,	- u u -uu -u u--- uu--	dactylic hexameter	feminine penthemimeral
τῷδε Κυτίσσωρος πέλει οὔνομα, τῷ δέ τε Φρόντις,	-u u--- uu -uu - u u --	dactylic hexameter	masculine penthemimeral
τῷ δὲ Μέλας· ἐμὲ δʼ αὐτὸν ἐπικλείοιτέ κεν Ἄργον.’	- u u- uu -u u---u u --	dactylic hexameter	feminine penthemimeral, trithemimeral
ὧς φάτʼ· ἀριστῆες δὲ συνηβολίῃ κεχάροντο,	- u u--- u u-uu- uu--	dactylic hexameter	masculine penthemimeral
καί σφεας ἀμφίεπον περιθαμβέες. αὐτὰρ Ἰήσων	- uu -uu- uu-uu -u u--	dactylic hexameter	masculine penthemimeral
ἐξαῦτις κατὰ μοῖραν ἀμείψατο τοῖσδʼ ἐπέεσσιν·	--- uu -u u-uu - uu--	dactylic hexameter	feminine penthemimeral, trithemimeral
‘ἦ ἄρα δὴ γνωτοὶ πατρώιοι ἄμμιν ἐόντες	- uu - -- --uu -u u--	dactylic hexameter	masculine penthemimeral, trithemimeral
λίσσεσθʼ εὐμενέοντας ἐπαρκέσσαι κακότητα.	-- -uu-u u--- uu--	dactylic hexameter	feminine penthemimeral
Κρηθεὺς γάρ ῥʼ Ἀθάμας τε κασίγνητοι γεγάασιν.	-- - uu- u u--- uu--	dactylic hexameter	masculine penthemimeral, trithemimeral
Κρηθῆος δʼ υἱωνὸς ἐγὼ σὺν τοισίδʼ ἑταίροις	--- --u u- - -u u--	dactylic hexameter	feminine penthemimeral, hepthemimeral, trithemimeral
Ἑλλάδος ἐξ αὐτῆς νέομʼ ἐς πόλιν Αἰήταο.	-uu - -- uu - uu ----	dactylic hexameter	masculine penthemimeral, hepthemimeral, trithemimeral
ἀλλὰ τὰ μὲν καὶ ἐσαῦτις ἐνίψομεν ἀλλήλοισιν.	-u u - u u-u u-uu ----	dactylic hexameter	feminine penthemimeral, trithemimeral
νῦν δʼ ἕσσασθε πάροιθεν· ὑπʼ ἐννεσίῃσι δʼ ὀίω	- --u u-u u -uu-u u--	dactylic hexameter	feminine penthemimeral
ἀθανάτων ἐς χεῖρας ἐμὰς χατέοντας ἱκέσθαι.’	-uu- - -u u- uu-u u--	dactylic hexameter	feminine penthemimeral, hepthemimeral, trithemimeral
ἦ ῥα, καὶ ἐκ νηὸς δῶκέ σφισιν εἵματα δῦναι.	- u u - -- -- uu -uu --	dactylic hexameter	masculine penthemimeral, hepthemimeral, trithemimeral
πασσυδίῃ δἤπειτα κίον μετὰ νηὸν Ἄρηος,	-uu- --u u- uu -u u--	dactylic hexameter	feminine penthemimeral, hepthemimeral, trithemimeral
μῆλʼ ἱερευσόμενοι· περὶ δʼ ἐσχάρῃ ἐστήσαντο	- uu-uu- uu -uu ----	dactylic hexameter	masculine penthemimeral
ἐσσυμένως, ἥ τʼ ἐκτὸς ἀνηρεφέος πέλε νηοῦ	-uu- - -u u-uu- uu --	dactylic hexameter	feminine penthemimeral, trithemimeral
στιάων· εἴσω δὲ μέλας λίθος ἠρήρειστο	--- -- u u- uu ----	dactylic hexameter	masculine penthemimeral, hepthemimeral, trithemimeral
ἱερός, ᾧ ποτε πᾶσαι Ἀμαζόνες εὐχετόωντο.	-uu - uu -u u-uu -uu--	dactylic hexameter	feminine penthemimeral, trithemimeral
οὐδέ σφιν θέμις ἦεν, ὅτʼ ἀντιπέρηθεν ἵκοιντο,	-- - uu -u u -uu-u u--	dactylic hexameter	feminine penthemimeral, trithemimeral
μήλων τʼ ἠδὲ βοῶν τῇδʼ ἐσχάρῃ ἱερὰ καίειν·	-- -u u- - -uu -uu --	dactylic hexameter	masculine penthemimeral
ἀλλʼ ἵππους δαίτρευον, ἐπηετανὸν κομέουσαι.	- -- --u u-uu- uu--	dactylic hexameter	feminine penthemimeral, trithemimeral
αὐτὰρ ἐπεὶ ῥέξαντες ἐπαρτέα δαῖτʼ ἐπάσαντο,	-u u- --u u-uu - uu--	dactylic hexameter	feminine penthemimeral, trithemimeral
δὴ τότ ἄρʼ Αἰσονίδης μετεφώνεεν, ἦρχέ τε μύθων·	- u u -uu- uu-uu -u u --	dactylic hexameter	masculine penthemimeral
‘Ζεὺς ἐτεῇ τὰ ἕκαστʼ ἐπιδέρκεται· οὐδέ μιν ἄνδρες	- uu- u u- uu-uu -u u --	dactylic hexameter	masculine penthemimeral, trithemimeral
λήθομεν ἔμπεδον, οἵ τε θεουδέες οὐδὲ δίκαιοι.	-uu -uu - u u-uu -u u--	dactylic hexameter	masculine penthemimeral
ὡς μὲν γὰρ πατέρʼ ὑμὸν ὑπεξείρυτο φόνοιο	- - - uu -u u---u u--	dactylic hexameter	feminine penthemimeral, trithemimeral
μητρυιῆς, καὶ νόσφιν ἀπειρέσιον πόρεν ὄλβον·	--- - -u u-uu- uu --	dactylic hexameter	feminine penthemimeral, trithemimeral
ὧς δὲ καὶ ὑμέας αὖτις ἀπήμονας ἐξεσάωσεν	- u u -uu -u u-uu -uu--	dactylic hexameter	feminine penthemimeral
χείματος οὐλομένοιο. πάρεστι δὲ τῆσδʼ ἐπὶ νηὸς	-uu -uu-u u-u u - uu --	dactylic hexameter	feminine penthemimeral
ἔνθα καὶ ἔνθα νέεσθαι, ὅπῃ φίλον, εἴτε μετʼ Αἶαν,	-u u -u u-u u- uu -u u --	dactylic hexameter	feminine penthemimeral, hepthemimeral
εἶτε μετʼ ἀφνειὴν θείου πόλιν Ὀρχομενοῖο.	-u u --- -- uu -uu--	dactylic hexameter	masculine penthemimeral, hepthemimeral
τὴν γὰρ Ἀθηναίη τεχνήσατο, καὶ τάμε χαλκῷ	- u u--- --uu - uu --	dactylic hexameter	masculine penthemimeral
δούρατα Πηλιάδος κορυφῆς πέρι· σὺν δέ οἱ Ἄργος	-uu -uu- uu- uu - u u --	dactylic hexameter	masculine penthemimeral, hepthemimeral
τεῦξεν. ἀτὰρ κείνην γε κακὸν διὰ κῦμʼ ἐκέδασσεν,	-u u- -- u u- uu - uu--	dactylic hexameter	masculine penthemimeral, hepthemimeral, trithemimeral
πρὶν καὶ πετράων σχεδὸν ἐλθεῖν, αἵ τʼ ἐνὶ πόντῳ	- - --- uu -- - uu --	dactylic hexameter	masculine penthemimeral
στεινωπῷ συνίασι πανήμεροι ἀλλήλῃσιν.	--- uu-u u-uu ----	dactylic hexameter	feminine penthemimeral, trithemimeral
ἀλλʼ ἄγεθʼ ὧδε καὶ αὐτοὶ ἐς Ἑλλάδα μαιομένοισιν	- uu -u u -u u -uu -uu--	dactylic hexameter	feminine penthemimeral
κῶας ἄγειν χρύσειον ἐπίρροθοι ἄμμι πέλεσθε	-u u- --u u-uu -u u--	dactylic hexameter	feminine penthemimeral, trithemimeral
καὶ πλόου ἡγεμονῆες, ἐπεὶ Φρίξοιο θυηλὰς	- uu -uu-u u- --u u--	dactylic hexameter	feminine penthemimeral, hepthemimeral
στέλλομαι ἀμπλήσων, Ζηνὸς χόλον Αἰολίδῃσιν.’	-uu --- -- uu -uu--	dactylic hexameter	masculine penthemimeral, hepthemimeral
ἴσκε παρηγορέων· οἱ δʼ ἔστυγον εἰσαΐοντες.	-u u-uu- - -uu -uu--	dactylic hexameter	masculine penthemimeral
οὐ γὰρ ἔφαν τεύξεσθαι ἐνηέος Αἰήταο	- u u- --u u-uu ----	dactylic hexameter	feminine penthemimeral, trithemimeral
κῶας ἄγειν κριοῖο μεμαότας, ὧδε δʼ ἔειπεν	-u u- --u u-uu -u u--	dactylic hexameter	feminine penthemimeral, trithemimeral
Ἄργος, ἀτεμβόμενος τοῖον στόλον ἀμφιπένεσθαι·	-u u-uu- -- uu -uu--	dactylic hexameter	masculine penthemimeral, hepthemimeral
‘ὦ φίλοι, ἡμέτερον μὲν ὅσον σθένος, οὔποτʼ ἀρωγῆς	- uu -uu- u u- uu -u u--	dactylic hexameter	masculine penthemimeral, hepthemimeral
σχήσεται, οὐδʼ ἠβαιόν, ὅτε χρειώ τις ἵκηται.	-uu - --u u- -- u u--	dactylic hexameter	feminine penthemimeral, hepthemimeral, trithemimeral
ἀλλʼ αἰνῶς ὀλοῇσιν ἀπηνείῃσιν ἄρηρεν	- -- uu-u u---u u--	dactylic hexameter	feminine penthemimeral, trithemimeral
Αἰήτης· τῶ καὶ περιδείδια ναυτίλλεσθαι.	--- - - uu-uu ----	dactylic hexameter	masculine penthemimeral, trithemimeral
στεῦται δʼ Ἠελίου γόνος ἔμμεναι· ἀμφὶ δὲ Κόλχων	-- -uu- uu -uu -u u --	dactylic hexameter	masculine penthemimeral
ἔθνεα ναιετάουσιν ἀπείρονα· καὶ δέ κεν Ἄρει	-uu -uu-u u-uu - u u --	dactylic hexameter	feminine penthemimeral
σμερδαλέην ἐνοπὴν μέγα τε σθένος ἰσοφαρίζοι.	-uu- uu- uu - uu -uu--	dactylic hexameter	masculine penthemimeral, hepthemimeral, trithemimeral
οὐ μὰν οὐδʼ ἀπάνευθεν ἑλεῖν δέρος Αἰήταο	- - - uu-u u- uu ----	dactylic hexameter	feminine penthemimeral, hepthemimeral, trithemimeral
ῥηίδιον, τοῖός μιν ὄφις περί τʼ ἀμφί τʼ ἔρυται	-uu- -- u u- uu -u u--	dactylic hexameter	masculine penthemimeral, hepthemimeral, trithemimeral
ἀθάνατος καὶ ἄυπνος, ὃν αὐτὴ Γαῖʼ ἀνέφυσεν	-uu- u u-u u -- - uu--	dactylic hexameter	feminine penthemimeral, trithemimeral
Καυκάσου ἐν κνημοῖσι, Τυφαονίη ὅθι πέτρη,	-uu - --u u-uu- uu --	dactylic hexameter	feminine penthemimeral, trithemimeral
ἔνθα Τυφάονά φασι Διὸς Κρονίδαο κεραυνῷ	-u u-uu -u u- uu-u u--	dactylic hexameter	feminine penthemimeral, hepthemimeral
βλήμενον, ὁππότε οἱ στιβαρὰς ἐπορέξατο χεῖρας,	-uu -uu - uu- uu-uu --	dactylic hexameter	masculine penthemimeral, hepthemimeral
θερμὸν ἀπὸ κρατὸς στάξαι φόνον· ἵκετο δʼ αὔτως	-u u- -- -- uu -uu --	dactylic hexameter	masculine penthemimeral, hepthemimeral, trithemimeral
οὔρεα καὶ πεδίον Νυσήιον, ἔνθʼ ἔτι νῦν περ	-uu - uu- --uu - uu - -	dactylic hexameter	masculine penthemimeral, trithemimeral
κεῖται ὑποβρύχιος Σερβωνίδος ὕδασι λίμνης.’	-u u-uu- --uu -uu --	dactylic hexameter	masculine penthemimeral
ὧς ἄρʼ ἔφη· πολέεσσι δʼ ἐπὶ χλόος εἷλε παρειὰς	- u u- uu-u u- uu -u u--	dactylic hexameter	feminine penthemimeral, hepthemimeral, trithemimeral
αὐτίκα, τοῖον ἄεθλον ὅτʼ ἔκλυον. αἶψα δὲ Πηλεὺς	-uu -u u-u u -uu -u u --	dactylic hexameter	feminine penthemimeral
θαρσαλέοις ἐπέεσσιν ἀμείψατο, φώνησέν τε·	-uu- uu-u u-uu --- -	dactylic hexameter	feminine penthemimeral, trithemimeral
‘μηδʼ οὕτως, ἠθεῖε, λίην δειδίσσεο θυμῷ.	- -- --u u- --uu --	dactylic hexameter	feminine penthemimeral, hepthemimeral, trithemimeral
οὔτε γὰρ ὧδʼ ἀλκὴν ἐπιδευόμεθʼ, ὥστε χερείους	-u u - -- uu-uu -u u--	dactylic hexameter	masculine penthemimeral, trithemimeral
ἔμμεναι Αἰήταο σὺν ἔντεσι πειρηθῆναι.	-uu ---u u -uu ----	dactylic hexameter	feminine penthemimeral
ἀλλὰ καὶ ἡμέας οἴω ἐπισταμένους πολέμοιο	-u u -uu -u u-uu- uu--	dactylic hexameter	feminine penthemimeral
κεῖσε μολεῖν, μακάρων σχεδὸν αἵματος ἐκγεγαῶτας.	-u u- uu- uu -uu -uu--	dactylic hexameter	masculine penthemimeral, trithemimeral
τῶ εἰ μὴ φιλότητι δέρος χρύσειον ὀπάσσει,	- - - uu-u u- --u u--	dactylic hexameter	feminine penthemimeral, hepthemimeral, trithemimeral
οὔ οἱ χραισμήσειν ἐπιέλπομαι ἔθνεα Κόλχων.’	- - --- uu-uu -uu --	dactylic hexameter	masculine penthemimeral
ὧς οἵ γʼ ἀλλήλοισιν ἀμοιβαδὸν ἠγορόωντο,	- - ---u u-uu -uu--	dactylic hexameter	feminine penthemimeral
μέσφʼ αὖτις δόρποιο κορεσσάμενοι κατέδαρθεν.	- -- --u u-uu- uu--	dactylic hexameter	feminine penthemimeral, trithemimeral
ἦρι δʼ ἀνεγρομένοισιν ἐυκραὴς ἄεν οὖρος·	-u u-uu-u u--- uu --	dactylic hexameter	feminine penthemimeral
ἱστία δʼ ἤειραν, τὰ δʼ ὑπαὶ ῥιπῆς ἀνέμοιο	-uu --- u u- -- uu--	dactylic hexameter	masculine penthemimeral, hepthemimeral
τείνετο· ῥίμφα δὲ νῆσον ἀποπροέλειπον Ἄρηος.	-uu -u u -u u-uu-u u--	dactylic hexameter	feminine penthemimeral
νυκτὶ δʼ ἐπιπλομένῃ Φιλυρηίδα νῆσον ἄμειβον·	-u u-uu- uu-uu -u u--	dactylic hexameter	masculine penthemimeral
ἔνθα μὲν Οὐρανίδης Φιλύρῃ Κρόνος, εὖτʼ ἐν Ὀλύμπῳ	-u u -uu- uu- uu - u u--	dactylic hexameter	masculine penthemimeral, hepthemimeral
Τιτήνων ἤνασσεν, ὁ δὲ Κρηταῖον ὑπʼ ἄντρον	--- --u u - --u u --	dactylic hexameter	feminine penthemimeral, hepthemimeral, trithemimeral
Ζεὺς ἔτι Κουρήτεσσι μετετρέφετʼ Ἰδαίοισιν,	- uu ---u u-uu ----	dactylic hexameter	feminine penthemimeral
Ῥείην ἐξαπαφών παρελέξατο· τοὺς δʼ ἐνὶ λέκτροις	-- -uu- uu-uu - uu --	dactylic hexameter	masculine penthemimeral
τέτμε θεὰ μεσσηγύς· ὁ δʼ ἐξ εὐνῆς ἀνορούσας	-u u- --u u - -- uu--	dactylic hexameter	feminine penthemimeral, hepthemimeral, trithemimeral
ἔσσυτο χαιτήεντι φυὴν ἐναλίγκιος ἵππῳ·	-uu ---u u- uu-uu --	dactylic hexameter	feminine penthemimeral, hepthemimeral
ἡ δʼ αἰδοῖ χῶρόν τε καὶ ἤθεα κεῖνα λιποῦσα	- -- -- u u -uu -u u--	dactylic hexameter	masculine penthemimeral, trithemimeral
Ὠκεανὶς Φιλύρη εἰς οὔρεα μακρὰ Πελασγῶν	-uu- uu- - -uu -u u--	dactylic hexameter	masculine penthemimeral, trithemimeral
ἦλθʼ, ἵνα δὴ Χείρωνα πελώριον, ἄλλα μὲν ἵππῳ,	- uu - --u u-uu -u u --	dactylic hexameter	feminine penthemimeral, trithemimeral
ἄλλα θεῷ ἀτάλαντον, ἀμοιβαίῃ τέκεν εὐνῇ.	-u u- uu-u u--- uu --	dactylic hexameter	feminine penthemimeral, trithemimeral
κεῖθεν δʼ αὖ Μάκρωνας ἀπειρεσίην τε Βεχείρων	-- - --u u-uu- u u--	dactylic hexameter	feminine penthemimeral, trithemimeral
γαῖαν ὑπερφιάλους τε παρεξενέοντο Σάπειρας,	-u u-uu- u u-uu-u u--	dactylic hexameter	masculine penthemimeral
Βύζηράς τʼ ἐπὶ τοῖσιν· ἐπιπρὸ γὰρ αἰὲν ἔτεμνον	--- uu -u u-u u -u u--	dactylic hexameter	feminine penthemimeral, trithemimeral
ἐσσυμένως, λιαροῖο φορεύμενοι ἐξ ἀνέμοιο.	-uu- uu-u u-uu - uu--	dactylic hexameter	feminine penthemimeral, trithemimeral
καὶ δὴ νισσομένοισι μυχὸς διεφαίνετο Πόντου.	- - -uu-u u- uu-uu --	dactylic hexameter	feminine penthemimeral, hepthemimeral
καὶ δὴ Καυκασίων ὀρέων ἀνέτελλον ἐρίπναι	- - -uu- uu- uu-u u--	dactylic hexameter	masculine penthemimeral, hepthemimeral
ἠλίβατοι, τόθι γυῖα περὶ στυφελοῖσι πάγοισιν	-uu- uu -u u- uu-u u--	dactylic hexameter	feminine penthemimeral, hepthemimeral, trithemimeral
ἰλλόμενος χαλκέῃσιν ἀλυκτοπέδῃσι Προμηθεὺς	-uu- --u u-uu-u u--	dactylic hexameter	feminine penthemimeral, trithemimeral
αἰετὸν ἥπατι φέρβε παλιμπετὲς ἀίσσοντα.	-uu -uu -u u-uu ----	dactylic hexameter	feminine penthemimeral
τὸν μὲν ἐπʼ ἀκροτάτης ἴδον ἕσπερον ὀξέι ῥοίζῳ	- u u -uu- uu -uu -uu --	dactylic hexameter	masculine penthemimeral
νηὸς ὑπερπτάμενον νεφέων σχεδόν· ἀλλὰ καὶ ἔμπης	-u u-uu- uu- uu -u u --	dactylic hexameter	masculine penthemimeral, hepthemimeral
λαίφεα πάντʼ ἐτίναξε, παραιθύξας πτερύγεσσιν.	-uu - uu-u u--- uu--	dactylic hexameter	feminine penthemimeral, trithemimeral
οὐ γὰρʼ ὅ γʼ αἰθερίοιο φυὴν ἔχεν οἰωνοῖο,	- u u -uu-u u- uu ----	dactylic hexameter	feminine penthemimeral, hepthemimeral
ἶσα δʼ ἐυξέστοις ὠκύπτερα πάλλεν ἐρετμοῖς,	-u u--- --uu -u u--	dactylic hexameter	masculine penthemimeral
δηρὸν δʼ. οὐ μετέπειτα πολύστονον ἄιον αὐδὴν	-- - uu-u u-uu -uu --	dactylic hexameter	feminine penthemimeral, trithemimeral
ἧπαρ ἀνελκομένοιο Προμηθέος· ἔκτυπε δʼ αἰθὴρ	-u u-uu-u u-uu -uu --	dactylic hexameter	feminine penthemimeral
οἰμωγῇ, μέσφʼ αὖτις ἀπʼ οὔρεος ἀίσσοντα	--- - -u u -uu ----	dactylic hexameter	feminine penthemimeral, trithemimeral
αἰετὸν ὠμηστὴν αὐτὴν ὁδὸν εἰσενόησαν.	-uu --- -- uu -uu--	dactylic hexameter	masculine penthemimeral, hepthemimeral
ἐννύχιοι δʼ Ἄργοιο δαημοσύνῃσιν ἵκοντο	-uu- --u u-uu-u u--	dactylic hexameter	feminine penthemimeral, trithemimeral
Φᾶσίν τʼ εὐρὺ ῥέοντα, καὶ ἔσχατα πείρατα πόντοι	-- -u u-u u -uu -uu --	dactylic hexameter	feminine penthemimeral
αὐτίκα δʼ ἱστία μὲν καὶ ἐπίκριον ἔνδοθι κοίλης	-uu -uu - u u-uu -uu --	dactylic hexameter	masculine penthemimeral
ἱστοδόκης στείλαντες ἐκόσμεον· ἐν δὲ καὶ αὐτὸν	-uu- --u u-uu - u u --	dactylic hexameter	feminine penthemimeral, trithemimeral
ἱστὸν ἄφαρ χαλάσαντο παρακλιδόν· ὦκα δʼ ἐρετμοῖς	-u u- uu-u u-uu -u u--	dactylic hexameter	feminine penthemimeral, trithemimeral
εἰσέλασαν ποταμοῖο μέγαν ῥόον· αὐτὰρ ὁ πάντῃ	-uu- uu-u u- uu -u u --	dactylic hexameter	feminine penthemimeral, hepthemimeral, trithemimeral
καχλάζων ὑπόεικεν. ἔχον δʼ ἐπʼ ἀριστερὰ χειρῶν	--- uu-u u- u u-uu --	dactylic hexameter	feminine penthemimeral, hepthemimeral, trithemimeral
Καύκασον αἰπήεντα Κυταιίδα τε πτόλιν Αἴης,	-uu ---u u-uu - uu --	dactylic hexameter	feminine penthemimeral
ἔνθεν δʼ αὖ πεδίον τὸ Ἀρήιον ἱερά τʼ ἄλση	-- - uu- u u-uu -uu --	dactylic hexameter	masculine penthemimeral, trithemimeral
τοῖο θεοῦ, τόθι κῶας ὄφις εἴρυτο δοκεύων	-u u- uu -u u- --u u--	dactylic hexameter	feminine penthemimeral, hepthemimeral, trithemimeral
πεπτάμενον λασίοισιν ἐπὶ δρυὸς ἀκρεμόνεσσιν.	-uu- uu-u u- uu -uu--	dactylic hexameter	feminine penthemimeral, hepthemimeral, trithemimeral
αὐτὸς δʼ Αἰσονίδης χρυσέῳ ποταμόνδε κυπέλλῳ	-- -uu- uu- uu-u u--	dactylic hexameter	masculine penthemimeral, hepthemimeral
οἴνου ἀκηρασίοιο μελισταγέας χέε λοιβὰς	-u u-uu-u u-uu- uu --	dactylic hexameter	feminine penthemimeral
γαίῃ τʼ ἐνναέταις τε θεοῖς ψυχαῖς τε καμόντων	-- -uu- u u- -- u u--	dactylic hexameter	masculine penthemimeral, hepthemimeral
ἡρώων· γουνοῦτο δʼ ἀπήμονας εἶναι ἀρωγοὺς	--- --u u-uu -u u--	dactylic hexameter	feminine penthemimeral, trithemimeral
εὐμενέως, καὶ νηὸς ἐναίσιμα πείσματα δέχθαι.	-uu- - -u u-uu -uu --	dactylic hexameter	feminine penthemimeral, trithemimeral
αὐτίκα δʼ Ἀγκαῖος τοῖον μετὰ μῦθον ἔειπεν·	-uu --- -- uu -u u--	dactylic hexameter	masculine penthemimeral, hepthemimeral
‘Κολχίδα μὲν δὴ γαῖαν ἱκάνομεν ἠδὲ ῥέεθρα	-uu - - -u u-uu -u u--	dactylic hexameter	feminine penthemimeral, trithemimeral
Φάσιδος· ὥρη δʼ ἧμιν ἐνὶ σφίσι μητιάασθαι,	-uu -- -u u- uu -uu--	dactylic hexameter	feminine penthemimeral, hepthemimeral
εἴτʼ οὖν μειλιχίῃ πειρησόμεθʼ Αἰήταο,	- - -uu- --uu ----	dactylic hexameter	masculine penthemimeral
εἴτε καὶ ἀλλοίη τις ἐπήβολος ἔσσεται ὁρμή.’	-u u --- u u-uu -uu --	dactylic hexameter	masculine penthemimeral
ὧς ἔφατʼ· Ἄργου δʼ αὖτε παρηγορίῃσιν Ἰήσων	- uu -- -u u-uu-u u--	dactylic hexameter	feminine penthemimeral
ὑψόθι νῆʼ ἐκέλευσεν ἐπʼ εὐναίῃσιν ἐρύσσαι	-uu - uu-u u ---u u--	dactylic hexameter	feminine penthemimeral, trithemimeral
δάσκιον εἰσελάσαντας ἕλος· τὸ δʼ ἐπισχεδὸν ἦεν	-uu -uu-u u- u u-uu --	dactylic hexameter	feminine penthemimeral, hepthemimeral
νισσομένων, ἔνθʼ οἵγε διὰ κνέφας ηὐλίζοντο.	-uu- - -u u- uu ----	dactylic hexameter	feminine penthemimeral, hepthemimeral, trithemimeral
ἠὼς δʼ οὐ μετὰ δηρὸν ἐελδομένοις ἐφαάνθη.	-- - uu -u u-uu- uu--	dactylic hexameter	feminine penthemimeral, trithemimeral
