ἐκ Διὸς ἀρχώμεσθα, τὸν οὐδέποτ᾽ ἄνδρες ἐῶμεν	- uu ---u u -uu -u u--	dactylic hexameter	feminine penthemimeral
ἄρρητον· μεσταὶ δέ Διὸς πᾶσαι μὲν ἀγυιαί,	--- -- u u- -- u u--	dactylic hexameter	masculine penthemimeral, hepthemimeral, trithemimeral
πᾶσαι δ᾽ἀνθρώπων ἀγοραί, μεστὴ δὲ θάλασσα	-- --- uu- -- u u--	dactylic hexameter	masculine penthemimeral, hepthemimeral
καὶ λιμένες· πάντη δὲ Διὸς κεχρήμεθα πάντες.	- uu- -- u u- --uu --	dactylic hexameter	masculine penthemimeral, hepthemimeral, trithemimeral
τοῦ γάρ καὶ γένος εἰμέν· ὁ δ᾽ἤπιος ἀνθρώποισιν	- - - uu -u u -uu ----	dactylic hexameter	feminine penthemimeral, trithemimeral
δεξιὰ σημαίνει, λαοὺς δ᾽ἐπὶ ἔργον ἐγείρει,	-uu --- -- uu -u u--	dactylic hexameter	masculine penthemimeral, hepthemimeral
μιμνῄσκων βιότοιο, λέγει δ᾽ὅτε βῶλος ἀρίστη	--- uu-u u- uu -u u--	dactylic hexameter	feminine penthemimeral, hepthemimeral, trithemimeral
βουσί τε καὶ μακέλῃσι, λέγει δ᾽ὅτε δεξιαὶ ὧραι	-u u - uu-u u- uu -uu --	dactylic hexameter	feminine penthemimeral, hepthemimeral, trithemimeral
καὶ φυτὰ γυρῶσαι καὶ σπέρματα πάντα βαλέσθαι.	- uu --- - -uu -u u--	dactylic hexameter	masculine penthemimeral
αὐτὸς γὰρ τά γε σήματ᾽ ἐν οὐρανῷ ἐστήριξεν,	-- - u u -u u -uu ----	dactylic hexameter	feminine penthemimeral, trithemimeral
ἄστρα διακρίνας, ἐσκέψατο δ᾽εἰς ἐνιαυτὸν	-u u-uu ---- - uu--	dactylic hexameter	
ἀστέρας οἵ κε μάλιστα τετυγμένα σημαίνοιεν	-uu - u u-u u-uu ----	dactylic hexameter	feminine penthemimeral, trithemimeral
ἀνδράσιν ὡράων, ὄφρ᾽ ἔμπεδα πάντα φύωνται.	-uu --- - -uu -u u--	dactylic hexameter	masculine penthemimeral
τῶ μιν ἀεὶ πρῶτόν τε καὶ ὕστατον ἱλάσκονται.	- u u- -- u u -uu ----	dactylic hexameter	masculine penthemimeral, trithemimeral
χαῖρε, πάτερ, μέγα θαῦμα, μέγ᾽ ἀνθρώποισιν ὄνειαρ,	-u u- uu -u u ---u u--	dactylic hexameter	feminine penthemimeral, trithemimeral
αὐτὸς καὶ προτέρη γενεή. Χαίροιτε δὲ Μοῦσαι	-- - uu- uu- --u u --	dactylic hexameter	masculine penthemimeral, hepthemimeral, trithemimeral
μειλίχιαι μάλα πᾶσαι· ἐμοί γε μὲν ἀστέρας εἰπεῖν	-uu- uu -u u- u u -uu --	dactylic hexameter	feminine penthemimeral, hepthemimeral, trithemimeral
ᾗ θέμις εὐχομένῳ τεκμήρατε πᾶσαν ἀοιδήν.	- uu -uu- --uu -u u--	dactylic hexameter	masculine penthemimeral
οἱ μὲν ὁμῶς πολέες τε καὶ ἄλλυδις ἄλλοι ἐόντες	- u u- uu- u u -uu -u u--	dactylic hexameter	masculine penthemimeral, trithemimeral
οὐρανῷ ἕλκονται πάντ᾽ ἤματα συνεχὲς αἰεί·	-uu --- - -uu -uu --	dactylic hexameter	masculine penthemimeral
αὐτὰρ ὅ γ᾽οὐδ᾽ ὀλίγον μετανίσσεται, ἀλλὰ μάλ᾽ αὕτως	-u u - uu- uu-uu -u u --	dactylic hexameter	masculine penthemimeral, trithemimeral
ἄξων αἰὲν ἄρηρεν, ἔχει δ᾽ἀτάλαντον ἁπάντη	-- -u u-u u- uu-u u--	dactylic hexameter	feminine penthemimeral, hepthemimeral
μεσσηγὺς γαῖαν, περὶ δ᾽οὐρανὸν αὐτὸν ἀγινεῖ.	--- -- uu -uu -u u--	dactylic hexameter	masculine penthemimeral, trithemimeral
καί μιν πειραίνουσι δύω πόλοι ἀμφοτέρωθεν·	- - ---u u- uu -uu--	dactylic hexameter	feminine penthemimeral, hepthemimeral
ἀλλ᾽ ὁ μὲν οὐκ ἐπίοπτος, ὁ δ᾽ἀντίος ἐκ βορέαο	- u u - uu-u u -uu - uu--	dactylic hexameter	feminine penthemimeral, trithemimeral
ὑψόθεν ὠκεανοῖο· δύς δέ μιν ἀμφὶς ἔχουσαι	-uu -uu-- - u u -u u--	dactylic hexameter	hepthemimeral
Ἄρκτοι ἅμα τροχόωσι, τὸ δὴ καλέονται ἅμαξαι.	-u u- uu-u u - uu-u u--	dactylic hexameter	feminine penthemimeral, hepthemimeral, trithemimeral
αἱ δ᾽ἤτοι κεφαλὰς μὲν ἐπ᾽ ἰξύας αἰέν ἔχουσιν	- -- uu- u u -uu -u u--	dactylic hexameter	masculine penthemimeral, trithemimeral
ἀλλήλων, αἰεὶ δέ κατωμάδιαι φορέονται,	--- -- u u-uu- uu--	dactylic hexameter	masculine penthemimeral, trithemimeral
ἔμπαλιν εἰς ὤμους τετραμμέναι. εἰ ἐτεὸν δή,	-uu - -- --uu - uu- -	dactylic hexameter	masculine penthemimeral, trithemimeral
Κρήτηθεν κεῖναί γε Διὸς μεγάλου ἰότητι	--- -- u u- uu- uu--	dactylic hexameter	masculine penthemimeral, hepthemimeral, trithemimeral
οὐρανὸν εἰσανέβησαν, ὅ μιν τότε κουρίζοντα	-uu -uu-u u - uu ----	dactylic hexameter	feminine penthemimeral, hepthemimeral
Δίκτῳ ἐν εὐώδει, ὄρεος σχεδὸν Ἰδαίοιο,	-u u --- uu- uu ----	dactylic hexameter	masculine penthemimeral, hepthemimeral
ἄντρῳ ἐγκατέθεντο καὶ ἔτρεφον εἰς ἐνιαυτόν,	-- -uu-u u -uu - uu--	dactylic hexameter	feminine penthemimeral
Δικταῖοι Κούρητες ὅτε Κρόνον ἐψεύδοντο.	--- --u u- uu ----	dactylic hexameter	feminine penthemimeral, hepthemimeral, trithemimeral
καὶ τὴν μὲν Κυνόσουραν ἐπίκλησιν καλέουσιν,	- - - uu-u u--- uu--	dactylic hexameter	feminine penthemimeral, trithemimeral
τὴν δ᾽ἑτέρην Ἑλίκην. Ἑλίκῃ γε μὲν ἄνδρες Ἀχαιοὶ	- uu- uu- uu- u u -u u--	dactylic hexameter	masculine penthemimeral, hepthemimeral, trithemimeral
εἰν ἁλὶ τεκμαίρονται ἵνα χρὴ νῆας ἀγινεῖν,	- uu ---u u- - -u u--	dactylic hexameter	feminine penthemimeral, hepthemimeral
τῇ δ᾽ἄρα Φοίνικες πίσυνοι περόωσι θάλασσαν.	- uu --- uu- uu-u u--	dactylic hexameter	masculine penthemimeral, hepthemimeral
ἀλλ᾽ ἡ μὲν καθαρὴ καὶ ἐπιφράσσασθαι ἑτοίμη	- - - uu- u u---u u--	dactylic hexameter	masculine penthemimeral, trithemimeral
πολλὴ φαινομένη Ἑλίκη πρώτης ἀπὸ νυκτός·	-- -uu- uu- -- uu --	dactylic hexameter	masculine penthemimeral, hepthemimeral
ἡ δ᾽ἑτέρη ὀλίγη μέν, ἀτὰρ ναύτῃσιν ἀρείων·	- uu- uu- u u- --u u--	dactylic hexameter	masculine penthemimeral, hepthemimeral, trithemimeral
μειοτέρῃ γὰρ πᾶσα περιστρέφεται στροφάλιγγι·	-uu- - -u u-uu- uu--	dactylic hexameter	feminine penthemimeral, trithemimeral
τῇ καὶ Σιδόνιοι ἰθύντατα ναυτίλλονται.	- - -uu- --uu ----	dactylic hexameter	masculine penthemimeral
τὰς δέ δι᾽ ἀμφοτέρας οἵη ποταμοῖο ἀπορρώξ	- u u -uu- -- uu-u u--	dactylic hexameter	masculine penthemimeral, hepthemimeral
εἰλεῖται μέγα θαῦμα, δράκων, περί τ᾽ἀμφί τ᾽ἐαγώς	--- uu -u u- uu -u u--	dactylic hexameter	feminine penthemimeral, hepthemimeral, trithemimeral
μυρίος· αἱ δ᾽ἄρα οἱ σπείρης ἑκάτερθε φέρονται	-uu - uu - -- uu-u u--	dactylic hexameter	masculine penthemimeral, hepthemimeral, trithemimeral
ἄρκτοι, κυανέου πεφυλαγμέναι ὠκεανοῖο.	-- -uu- uu-uu -uu--	dactylic hexameter	masculine penthemimeral
αὐτὰρ ὅ γ᾽ἄλλην μὲν νεάτῃ ἐπιτείνεται οὐρῇ,	-u u -- - uu- uu-uu --	dactylic hexameter	masculine penthemimeral, hepthemimeral
ἄλλην δέ σπείρῃ περιτέμνεται. ἡ μέν οἱ ἄκρη	-- - -- uu-uu - u u --	dactylic hexameter	masculine penthemimeral, trithemimeral
οὐρὴ πὰρ κεφαλὴν Ἑλίκης ἀποπαύεται Ἄρκτου·	-- - uu- uu- uu-uu --	dactylic hexameter	masculine penthemimeral, hepthemimeral, trithemimeral
σπείρῃ δ᾽ἐν Κυνόσουρα κάρη ἔχει· ἡ δέ κατ᾽ αὐτὴν	-- - uu-u u- uu - u u --	dactylic hexameter	feminine penthemimeral, hepthemimeral, trithemimeral
εἰλεῖται κεφαλὴν καί οἱ ποδὸς ἔρχεται ἄχρις,	--- uu- - - uu -uu --	dactylic hexameter	masculine penthemimeral, hepthemimeral, trithemimeral
ἐκ δ᾽αὖτις παλίνορσος ἀνατρέχει. οὐ μέν ἐκείνῃ	- -- uu-u u-uu - u u--	dactylic hexameter	feminine penthemimeral, trithemimeral
οἰόθεν οὐδ᾽ οἶος κεφαλῇ ἐπιλάμπεται ἀστήρ,	-uu - -- uu- uu-uu --	dactylic hexameter	masculine penthemimeral, hepthemimeral, trithemimeral
ἀλλὰ δύο κροτάφοις, δύο δ᾽ὄμμασιν· εἷς δ᾽ὑπένερθεν	-u u- uu- uu -uu - uu--	dactylic hexameter	masculine penthemimeral, trithemimeral
ἐσχατιὴν ἐπέχει γένυος δεινοῖο πελώρου.	-uu- uu- uu- --u u--	dactylic hexameter	masculine penthemimeral, hepthemimeral, trithemimeral
λοξὸν δ᾽ἐστὶ κάρη, νεύοντι δὲ πάμπαν ἔοικεν	-- -u u- --u u -u u--	dactylic hexameter	masculine penthemimeral
ἄκρην εἰς Ἑλίκης οὐρήν· μάλα δ᾽ἐστὶ κατ᾽ ἰθύ	-- - uu- -- uu -u u --	dactylic hexameter	masculine penthemimeral, hepthemimeral, trithemimeral
καὶ στόμα καὶ κροτάφοιο τὰ δεξιὰ νειάτῳ οὐρῇ.	- uu - uu-u u -uu -uu --	dactylic hexameter	feminine penthemimeral, trithemimeral
κείνη που κεφαλὴ τῇ νίσσεται, ἧχί περ ἄκραι	-- - uu- - -uu -u u --	dactylic hexameter	masculine penthemimeral, trithemimeral
μίσγονται δύσιές τε καὶ ἀντολαὶ ἀλλήλῃσιν.	--- uu- u u -uu ----	dactylic hexameter	masculine penthemimeral, trithemimeral
Τῇδ᾽ αὐτοῦ μογέοντι κυλίνδεται ἀνδρὶ ἐοικὸς	- -- uu-u u-uu -u u--	dactylic hexameter	feminine penthemimeral, trithemimeral
εἴδωλον. τὸ μέν οὔτις ἐπίσταται ἀμφαδὸν εἰπεῖν,	--- u u -u u-uu -uu --	dactylic hexameter	feminine penthemimeral, trithemimeral
οὐδ᾽ ὅτινι κρέμαται κεῖνος πόνῳ, ἀλλά μιν αὕτως	- uu- uu- -- uu -u u --	dactylic hexameter	masculine penthemimeral, hepthemimeral, trithemimeral
ἐγγόνασιν καλέουσι. τὸ δ᾽αὖτ᾽ ἐν γούνασι κάμνον	-uu- uu-u u - - -uu --	dactylic hexameter	feminine penthemimeral, hepthemimeral, trithemimeral
ὀκλάζοντι ἔοικεν· ἀπ᾽ ἀμφοτέρων δέ οἱ ὤμων	---u u-u u -uu- u u --	dactylic hexameter	feminine penthemimeral
χεῖρες ἀείρονται· τάνυταί γε μέν ἄλλυδις ἄλλη	-u u--- uu- u u -uu --	dactylic hexameter	masculine penthemimeral, hepthemimeral
ὅσσον ἐς ὀργυιήν· μέσσῳ δ᾽ἐφύπερθε καρήνῳ	-u u --- -- uu-u u--	dactylic hexameter	masculine penthemimeral, hepthemimeral
δεξιτεροῦ ποδὸς ἄκρον ἔχει σκολιοῖο Δράκοντος.	-uu- uu -u u- uu-u u--	dactylic hexameter	feminine penthemimeral, hepthemimeral, trithemimeral
αὐτοῦ κἀκεῖνος στέφανος, τὸν ἀγανὸς ἔθηκεν	-- --- uu- u u-u u--	dactylic hexameter	masculine penthemimeral, hepthemimeral
σῆμ᾽ ἔμεναι Διόνυσος ἀποιχομένης Ἀριάδνης,	- uu- uu-u u-uu- uu--	dactylic hexameter	feminine penthemimeral, trithemimeral
νώτῳ ὑποστρέφεται κεκμηότος Εἰδώλοιο.	-u u-uu- --uu ----	dactylic hexameter	masculine penthemimeral
νώτῳ μὲν Στέφανος πελάει, κεφαλῇ γε μὲν ἄκρῃ	-- - uu- uu- uu- u u --	dactylic hexameter	masculine penthemimeral, hepthemimeral, trithemimeral
σκέπτεο πὰρ κεφαλὴν Ὀφιούχεον, ἐκ δ᾽ἄρ᾽ ἐκείνης	-uu - uu- uu-uu - u u--	dactylic hexameter	masculine penthemimeral, trithemimeral
αὐτὸν ἐπιφράσσαιο φαεινόμενον Ὀφιοῦχον·	-u u---u u-uu- uu--	dactylic hexameter	feminine penthemimeral
τοῖοί οἱ κεφαλῇ ὑποκείμενοι ἀγλαοὶ ὦμοι	-- - uu- uu-uu -uu --	dactylic hexameter	masculine penthemimeral, trithemimeral
εἴδονται· κεῖνοί γε καὶ ἂν διχόμηνι σελήνῃ	--- -- u u - uu-u u--	dactylic hexameter	masculine penthemimeral, hepthemimeral, trithemimeral
εἰσωποὶ τελέθοιεν· ἀτὰρ χέρες οὐ μάλα ἶσαι·	--- uu-u u- uu - uu --	dactylic hexameter	feminine penthemimeral, hepthemimeral, trithemimeral
λεπτὴ γὰρ καὶ τῇ καὶ τῇ ἐπιδέδρομεν αἴγλη.	-- - - - - - uu-uu --	dactylic hexameter	masculine penthemimeral, hepthemimeral, trithemimeral
ἀλλ᾽ ἔμπης κἀκεῖναι ἐπόψιαι· οὐ γὰρ ἐλαφραί·	- -- --u u-uu - u u--	dactylic hexameter	feminine penthemimeral, trithemimeral
ἀμφότεραι δ᾽Ὄφιος πεπονήαται, ὅς ῥά τε μέσσον	-uu- uu- uu-uu - u u --	dactylic hexameter	masculine penthemimeral, trithemimeral
δινεύει Ὀφιοῦχον· ὁ δ᾽ἐμμενές εὖ ἐπαρηρὼς	--- uu-u u -uu - uu--	dactylic hexameter	feminine penthemimeral, trithemimeral
ποσσὶν ἐπιθλίβει μέγα θηρίον ἀμφοτέροισιν,	-u u--- uu -uu -uu--	dactylic hexameter	masculine penthemimeral
σκορπίον, ὀφθαλμῷ τε καὶ ἐν θώρηκι βεβηκὼς	-uu --- u u - --u u--	dactylic hexameter	masculine penthemimeral, hepthemimeral
ὀρθός. ἀτάρ οἱ ὄφις γε δύω στρέφεται μετὰ χερσίν,	-u u- u u- u u- uu- uu --	dactylic hexameter	masculine penthemimeral, hepthemimeral, trithemimeral
δεξιτερῇ ὀλίγος, σκαιῇ γε μὲν ὑψόθι πολλός.	-uu- uu- -- u u -uu --	dactylic hexameter	masculine penthemimeral, hepthemimeral, trithemimeral
καὶ δή οἱ Στεφάνῳ παρακέκλιται ἄκρα γένεια,	- - - uu- uu-uu -u u--	dactylic hexameter	masculine penthemimeral, trithemimeral
νειόθι δὲ σπείρης μεγάλας ἐπιμαίεο χηλάς.	-uu - -- uu- uu-uu --	dactylic hexameter	masculine penthemimeral, hepthemimeral, trithemimeral
ἀλλ᾽ αἱ μέν φαέων ἐπιδευέες, οὐδὲν ἀγαυαί.	- - - uu- uu-uu -u u--	dactylic hexameter	masculine penthemimeral, trithemimeral
ἐξόπιθεν δ᾽Ἑλίκης φέρεται ἐλάοντι ἐοικὼς	-uu- uu- uu- uu-u u--	dactylic hexameter	masculine penthemimeral, hepthemimeral, trithemimeral
Ἀρκτοφύλαξ, τόν ῥ᾽ἄνδρες ἐπικλείουσι βοώτην,	-uu- - -u u---u u--	dactylic hexameter	feminine penthemimeral, trithemimeral
οὕνεχ᾽ ἁμαξαίης ἐπαφώμενος εἴδεται Ἄρκτου.	-u u--- uu-uu -uu --	dactylic hexameter	masculine penthemimeral
καὶ μάλα πᾶς ἀρίδηλος· ὑπὸ ζώνῃ δέ οἱ αὐτὸς	- uu - uu-u u- -- u u --	dactylic hexameter	feminine penthemimeral, hepthemimeral, trithemimeral
ἐξ ἄλλων Ἀρκτοῦρος ἑλίσσεται ἀμφαδὸν ἀστήρ.	- -- --u u-uu -uu --	dactylic hexameter	feminine penthemimeral, trithemimeral
ἀμφοτέροισι δὲ ποσσὶν ὕπο σκέπτοιο Βοώτεω	-uu-u u -u u- --u u--	dactylic hexameter	feminine penthemimeral, hepthemimeral
παρθένον, ἥ ῥ᾽ἐν χερσὶ φέρει Στάχυν αἰγλήεντα.	-uu - - -u u- uu ----	dactylic hexameter	feminine penthemimeral, hepthemimeral, trithemimeral
εἴτ᾽ οὖν Ἀστραίου κείνη γένος, ὅν ῥά τέ φασιν	- - --- -- uu - u u --	dactylic hexameter	masculine penthemimeral, hepthemimeral
ἄστρων ἀρχαῖον πατέρ᾽ ἔμμεναι, εἴτε τευ ἄλλου,	-- --- uu -uu -u u --	dactylic hexameter	masculine penthemimeral
εὔκηλος φορέοιτο· λόγος γε μὲν ἐντρέχει ἄλλος	--- uu-u u- u u -uu --	dactylic hexameter	feminine penthemimeral, hepthemimeral, trithemimeral
ἀνθρώποις, ὡς δῆθεν ἐπιχθονίη πάρος ἦεν,	--- - -u u-uu- uu --	dactylic hexameter	feminine penthemimeral, trithemimeral
ἤρχετο δ᾽ἀνθρώπων κατεναντίη, οὐδέ ποτ᾽ ἀνδρῶν	-uu --- uu-uu -u u --	dactylic hexameter	masculine penthemimeral
οὐδέ ποτ᾽ ἀρχαίων ἠνήνατο φῦλα γυναικῶν,	-u u --- --uu -u u--	dactylic hexameter	masculine penthemimeral
ἀλλ᾽ ἀναμὶξ ἐκάθητο, καὶ ἀθανάτη περ ἐοῦσα.	- uu- uu-u u -uu- u u--	dactylic hexameter	feminine penthemimeral, trithemimeral
καί ἑ Δίκην καλέεσκον· ἀγειρομένη δὲ γέροντας,	- u u- uu-u u-uu- u u--	dactylic hexameter	feminine penthemimeral, trithemimeral
ἠέ που εἰν ἀγορῇ ἢ εὐρυχόρῳ ἐν ἀγυιῇ,	-u u - uu- - -uu- u u--	dactylic hexameter	masculine penthemimeral, trithemimeral
δημοτέρας ἤειδεν ἐπισπέρχουσα θέμιστας.	-uu- --u u---u u--	dactylic hexameter	feminine penthemimeral, trithemimeral
οὔπω λευγαλέου τότε νείκεος ἠπίσταντο	-- -uu- uu -uu ----	dactylic hexameter	masculine penthemimeral
οὐδέ διακρίσιος πολυμεμφέος οὐδέ κυδοιμοῦ,	-u u-uu- uu-uu -u u--	dactylic hexameter	masculine penthemimeral
αὕτως δ᾽ἔζωον· χαλεπὴ δ᾽ἀπέκειτο θάλασσα,	-- --- uu- uu-u u--	dactylic hexameter	masculine penthemimeral, hepthemimeral
καὶ βίον οὔπω νῆες ἀπόπροθεν ἠγίνεσκον,	- uu -- -u u-uu ----	dactylic hexameter	feminine penthemimeral
ἀλλὰ βόες καὶ ἄροτρα καὶ αὐτή, πότνια λαῶν,	-u u- u u-u u -- -uu --	dactylic hexameter	feminine penthemimeral, trithemimeral
μυρία πάντα παρεῖχε Δίκη, δώτειρα δικαίων.	-uu -u u-u u- --u u--	dactylic hexameter	feminine penthemimeral, hepthemimeral
τόφρ᾽ ἦν, ὄφρ᾽ ἔτι γαῖα γένος χρύσειον ἔφερβεν.	- - - uu -u u- --u u--	dactylic hexameter	feminine penthemimeral, hepthemimeral, trithemimeral
ἀργυρέῳ δ᾽ὀλίγη τε καὶ οὐκέτι πάμπαν ἑτοίμη	-uu- uu- u u -uu -u u--	dactylic hexameter	masculine penthemimeral, trithemimeral
ὡμίλει, ποθέουσα παλαιῶν ἤθεα λαῶν.	--- uu-u u-- -uu --	dactylic hexameter	feminine penthemimeral, trithemimeral
ἀλλ᾽ ἔμπης ἔτι κεῖνο κατ᾽ ἀργύρεον γένος ἦεν·	- -- uu -u u -uu- uu --	dactylic hexameter	feminine penthemimeral, trithemimeral
ἤρχετο δ᾽ἐξ ὀρέων ὑποδείελος ἠχηέντων	-uu - uu- uu-uu ----	dactylic hexameter	masculine penthemimeral, trithemimeral
μουνάξ, οὐδέ τεῳ ἐπεμίσγετο μειλιχίοισιν·	-- -u u- uu-uu -uu--	dactylic hexameter	masculine penthemimeral
ἀλλ᾽ ὁπότ᾽ ἀνθρώπων μεγάλας πλήσαιτο κολώνας,	- uu --- uu- --u u--	dactylic hexameter	masculine penthemimeral, hepthemimeral
ἠπείλει δὴ ἔπειτα καθαπτομένη κακότητος,	--- u u-u u-uu- uu--	dactylic hexameter	feminine penthemimeral, trithemimeral
οὐδ᾽ ἔτ᾽ ἔφη εἰσωπὸς ἐλεύσεσθαι καλέουσιν·	- u u- --u u--- uu--	dactylic hexameter	feminine penthemimeral, trithemimeral
"οἵην χρύσειοι πατέρες γενεὴν ἐλίποντο	-- --- uu- uu- uu--	dactylic hexameter	masculine penthemimeral, hepthemimeral
χειροτέρην· ὑμεῖς δὲ κακώτερα τεξείεσθε.	-uu- -- u u-uu ----	dactylic hexameter	masculine penthemimeral, trithemimeral
καὶ δή που πόλεμοι, καὶ δὴ καὶ ἀνάρσιον αἷμα	- - - uu- - - u u-uu --	dactylic hexameter	masculine penthemimeral, hepthemimeral, trithemimeral
ἔσσεται ἀνθρώποισι, κακὸν δ᾽ἐπικείσεται ἄλγος."	-uu ---u u- uu-uu --	dactylic hexameter	feminine penthemimeral, hepthemimeral
ὣς εἰποῦσ᾽ ὀρέων ἐπεμαίετο, τοὺς δ᾽ἄρα λαοὺς	- -- uu- uu-uu - uu --	dactylic hexameter	masculine penthemimeral, trithemimeral
εἰς αὐτὴν ἔτι πάντας ἐλίμπανε παπταίνοντας.	- -- uu -u u-uu ----	dactylic hexameter	feminine penthemimeral, trithemimeral
ἀλλ᾽ ὅτε δὴ κἀκεῖνοι ἐτέθνασαν, οἱ δ᾽ἐγένοντο,	- uu - --u u-uu - uu--	dactylic hexameter	feminine penthemimeral, trithemimeral
χαλκείη γενεή, προτέρων ὀλοώτεροι ἄνδρες,	--- uu- uu- uu-uu --	dactylic hexameter	masculine penthemimeral, hepthemimeral, trithemimeral
οἳ πρῶτοι κακόεργον ἐχαλκεύσαντο μάχαιραν	- -- uu-u u---u u--	dactylic hexameter	feminine penthemimeral, trithemimeral
εἰνοδίην, πρῶτοι δὲ βοῶν ἐπάσαντ᾽ ἀροτήρων,	-uu- -- u u- uu- uu--	dactylic hexameter	masculine penthemimeral, hepthemimeral, trithemimeral
καὶ τότε μισήσασα Δίκη κείνων γένος ἀνδρῶν	- uu ---u u- -- uu --	dactylic hexameter	feminine penthemimeral, hepthemimeral
ἔπταθ᾽ ὑπουρανίη· ταύτην δ᾽ἄρα νάσσατο χώρην,	-u u-uu- -- uu -uu --	dactylic hexameter	masculine penthemimeral, hepthemimeral
ἧχί περ ἐννυχίη ἔτι φαίνεται ἀνθρώποισιν	-u u -uu- uu -uu ----	dactylic hexameter	masculine penthemimeral
παρθένος, ἐγγὺς ἐοῦσα πολυσκέπτοιο Βοώτεω.	-uu -u u-u u---u u--	dactylic hexameter	feminine penthemimeral
τῆς ὑπὲρ ἀμφοτέρων ὤμων εἱλίσσεται ἀστὴρ	- uu -uu- -- --uu --	dactylic hexameter	masculine penthemimeral, hepthemimeral
[δεξιτερῇ πτέρυγι· Προτρυγητὴρ δ᾽αὖτε καλεῖται·	-uu- uu- ---- -- ---	lyric	
τόσσος μὲν μεγέθει, τοίῃ δ᾽ἐγκείμενος αἴγλῃ,	-- - uu- -- --uu --	dactylic hexameter	masculine penthemimeral, hepthemimeral, trithemimeral
οἷος καὶ μεγάλης οὐρὴν ὑποφαίνεται Ἄρκτου.	-- - uu- -- uu-uu --	dactylic hexameter	masculine penthemimeral, hepthemimeral, trithemimeral
δεινὴ γὰρ κείνη, δεινοὶ δέ οἱ ἐγγύθεν εἰσὶν	-- - -- -- u u -uu --	dactylic hexameter	masculine penthemimeral, hepthemimeral, trithemimeral
ἀστέρες· οὐκ ἂν τούς γε ἰδὼν ἐπιτεκμήραιο	-uu - - - u u- uu----	dactylic hexameter	masculine penthemimeral, hepthemimeral, trithemimeral
[οἵ μιν πᾶσαν ὄπισθεν ἑλισσόμενοι τυπόωσιν,	- - -u u-u u-uu- uu--	dactylic hexameter	feminine penthemimeral
οἷός οἱ πρὸ ποδῶν φέρεται καλός τε μέγας τε	-- - u u- uu- -- u u- -	dactylic hexameter	masculine penthemimeral, hepthemimeral, trithemimeral
εἷς μὲυ ὑπωμαίων, εἷς δ᾽ἰξυόθεν κατιόντων,	- u u--- - -uu- uu--	dactylic hexameter	masculine penthemimeral
ἄλλος δ᾽οὐραίοις ὑπὸ γούνασιν· ἀλλ᾽ ἄρα πάντες	-- --- uu -uu - uu --	dactylic hexameter	masculine penthemimeral
ἁπλόοι ἄλλοθεν ἄλλος ἀνωνυμίῃ φορέονται.	-uu -uu -u u-uu- uu--	dactylic hexameter	feminine penthemimeral
Κραιὶ δέ οἱ Δίδυμοι, μέσσῃ δ᾽ὕπο κάρκινος ἐστίν·	-u u - uu- -- uu -uu --	dactylic hexameter	masculine penthemimeral, hepthemimeral, trithemimeral
ποσσὶ δ᾽ὀπισθοτέροισι λέων ὕπο καλὰ φαείνει.	-u u-uu-u u- uu -u u--	dactylic hexameter	feminine penthemimeral, hepthemimeral
ἔνθα μὲν ἠελίοιο θερείταταί εἰσι κέλευθοι·	-u u -uu-u u-uu -u u--	dactylic hexameter	feminine penthemimeral
αἱ δέ που ἀσταχύων κενεαὶ φαίνονται ἄρουραι	- u u -uu- uu- --u u--	dactylic hexameter	masculine penthemimeral, hepthemimeral
ἠελίου τὰ πρῶτα συνερχομένοιο Λέοντι.	-uu- - -u u-uu-u u--	dactylic hexameter	feminine penthemimeral, trithemimeral
τῆμος καὶ κελάδοντες ἐτησίαι εὐρέϊ πόντῳ	-- - uu-u u-uu -uu --	dactylic hexameter	feminine penthemimeral, trithemimeral
ἀθρόοι ἐμπίπτουσιν, ὁ δὲ πλόος οὐκέτι κώπαις	-uu ---u u - uu -uu --	dactylic hexameter	feminine penthemimeral, hepthemimeral
ὥριος. εὐρεῖαί μοι ἀρέσκοιεν τότε νῆες,	-uu --- u u--- uu --	dactylic hexameter	masculine penthemimeral
εἰς ἄνεμον δὲ τὰ πηδὰ κυβερνητῆρες ἔχοιεν.	- uu- u u -u u---u u--	dactylic hexameter	feminine penthemimeral, trithemimeral
εἰ δέ τοι ἡνίοχον τε καὶ ἀστέρας Ἡνιόχοιο	- u u -uu- u u -uu -uu--	dactylic hexameter	masculine penthemimeral
σκέπτεσθαι δοκέει, καί τοι φάτις ἤλυθεν αἰγός	--- uu- - - uu -uu --	dactylic hexameter	masculine penthemimeral, hepthemimeral, trithemimeral
αὐτῆς ἠδ᾽ Ἐρίφων, οἵ τ᾽εἰν ἁλὶ πορφυρούσῃ	-- - uu- - - uu ----	dactylic hexameter	masculine penthemimeral, hepthemimeral, trithemimeral
πολλάκις ἐσκέψαντο κεδαιομένους ἀνθρώπους,	-uu ---u u-uu- ---	dactylic hexameter	feminine penthemimeral
αὐτὸν μέν μιν ἅπαντα μέγαν Διδύμων ἐπὶ λαιὰ	-- - u u-u u- uu- uu --	dactylic hexameter	feminine penthemimeral, hepthemimeral, trithemimeral
κεκλιμένον δήεις· Ἑλίκης δέ οἱ ἄκρα κάρηνα	-uu- -- uu- u u -u u--	dactylic hexameter	masculine penthemimeral, hepthemimeral, trithemimeral
ἀντία δινεύει. σκαιῷ δ᾽ἐπελήλαται ὤμῳ	-uu --- -- uu-uu --	dactylic hexameter	masculine penthemimeral, hepthemimeral
αἲξ ἱερή, τὴν μέν τε λόγος Διὶ μαζὸν ἐπτσχεῖν,	- uu- - - u u- uu -- --	dactylic hexameter	masculine penthemimeral, hepthemimeral, trithemimeral
Ὠλενίην δέ μιν Αἶγα Διὸς καλέουσ᾽ ὑποφῆται.	-uu- u u -u u- uu- uu--	dactylic hexameter	feminine penthemimeral, hepthemimeral, trithemimeral
ἀλλ᾽ ἡ μὲν πολλή τε καὶ ἀγλαή· οἱ δέ οἱ αὐτοῦ	- - - -- u u -uu - u u --	dactylic hexameter	masculine penthemimeral, trithemimeral
λεπτὰ φαείνονται Ἔριφοι καρπὸν κάτα χειρός.	-u u--- uu- -- uu --	dactylic hexameter	masculine penthemimeral, hepthemimeral
πὰρ ποσὶ δ᾽Ἡνιόχου κεραὸν πεπτηότα Ταῦρον	- uu -uu- uu- --uu --	dactylic hexameter	masculine penthemimeral, hepthemimeral
μαίεσθαι. τὰ δέ οἱ μάλ᾽ έοικότα σήματα κεῖται·	--- u u - u u-uu -uu --	dactylic hexameter	masculine penthemimeral, trithemimeral
τοίη οἱ κεφαλὴ διακέκριται· οὐδέ τις ἄλλῳ	-- - uu- uu-uu -u u --	dactylic hexameter	masculine penthemimeral, trithemimeral
σήματι τεκμήραιτο κάρη βοός, οἷά μιν αὐτοὶ	-uu ---u u- uu -u u --	dactylic hexameter	feminine penthemimeral, hepthemimeral
ἀστέρες ἀμφοτέρωθεν ἑλισσόμενοι τυπόωσιν.	-uu -uu-u u-uu- uu--	dactylic hexameter	feminine penthemimeral
καὶ λίην κείνων ὄνομ᾽ εἴρεται, οὐδέ τοι αὕτως	- -- -- uu -uu -u u --	dactylic hexameter	masculine penthemimeral, trithemimeral
νήκουστοι Ὑάδες. ταὶ μέν ῥ᾽ἐπὶ παντὶ μετώπῳ	--- uu- - - uu -u u--	dactylic hexameter	masculine penthemimeral, hepthemimeral, trithemimeral
Ταύρου βεβλέαται· λαιοῦ δὲ κεράατος ἄκρον	-- -uu- -- u u-uu --	dactylic hexameter	masculine penthemimeral, hepthemimeral
καὶ πόδα δεξιτερὸν παρακειμένου Ἡνιόχοιο	- uu -uu- uu-uu -uu--	dactylic hexameter	masculine penthemimeral
εἷς ἀστὴρ ἐπέχει· συνεληλάμενοι δὲ φέρονται,	- -- uu- uu-uu- u u--	dactylic hexameter	masculine penthemimeral, trithemimeral
ἀλλ᾽ αἰεὶ Ταῦρος προφερέστερος Ἡνιόχοιο	- -- -- uu-uu -uu--	dactylic hexameter	masculine penthemimeral, trithemimeral
εἰς ἑτέρην καταβῆναι, ὁμηλυσίῃ περ ἀνελθών.	- uu- uu-u u-uu- u u--	dactylic hexameter	feminine penthemimeral, trithemimeral
Οὐδ᾽ ἄρα Κηφῆος μογερὸν γένος Ἰασίδαο	- uu --- uu- uu -uu--	dactylic hexameter	masculine penthemimeral, hepthemimeral
αὕτως ἄρρητον κατακείσεται· ἀλλ᾽ ἄρα καὶ τῶν	-- --- uu-uu - uu - -	dactylic hexameter	masculine penthemimeral
οὐρανὸν εἰς ὄνομ᾽ ἦλθεν, ἐπεὶ Διὸς ἐγγύθεν ἦσαν.	-uu - uu -u u- uu -uu --	dactylic hexameter	feminine penthemimeral, hepthemimeral, trithemimeral
αὐτὸς μὲν κατόπτσθεν ἐὼν Κυνοσουρίδος Ἄρκτου	-- - --u u- uu-uu --	dactylic hexameter	feminine penthemimeral, hepthemimeral, trithemimeral
Κηφεὺς ἀμφοτέρας χεῖρας τανύοντι ἐοικώς·	-- -uu- -- uu-u u--	dactylic hexameter	masculine penthemimeral, hepthemimeral
ἴση οἱ στάθμη νεάτης ἀποτείνεται οὐρῆς	-- - -- uu- uu-uu --	dactylic hexameter	masculine penthemimeral, hepthemimeral, trithemimeral
ἐς πόδας ἀμφοτέρους, ὅσση ποδὸς ἐς πόδα τείνει.	- uu -uu- -- uu - uu --	dactylic hexameter	masculine penthemimeral, hepthemimeral
αὐτὰρ ἀπὸ ζὠνης ὀλίγον κε μεταβλέψειας	-u u- -- uu- u u----	dactylic hexameter	masculine penthemimeral, hepthemimeral, trithemimeral
πρώτης ἱέμενος καμπῆς μεγάλοιο Δράκοντος.	-- -uu- -- uu-u u--	dactylic hexameter	masculine penthemimeral, hepthemimeral
τοῦ δ᾽ἄρα δαιμονίη προκυλίνδεται οὐ μάλα πολλὴ	- uu -uu- uu-uu - uu --	dactylic hexameter	masculine penthemimeral
νυκτὶ φαεινομένη παμμήνιδι Κασσιέπεια·	-u u-uu- --uu -uu--	dactylic hexameter	masculine penthemimeral
οὐ γάρ μιν πολλοὶ καὶ ἐπημοιβοὶ γανόωσιν	- - - -- u u--- uu--	dactylic hexameter	masculine penthemimeral, trithemimeral
ἀστέρες, οἵ μιν πᾶσαν ἐπιρρήδην στιχόωσιν.	-uu - - -u u--- uu--	dactylic hexameter	feminine penthemimeral, trithemimeral
οἵῃ δὲ κληῖδι θύρην ἔντοσθ᾽ ἀραρυῖαν	-- - --u u- -- uu--	dactylic hexameter	feminine penthemimeral, hepthemimeral, trithemimeral
δικλίδ᾽ ἐπτπλήσσοντες ἀνακρούουσιν ὀχῆας,	-- ---u u---u u--	dactylic hexameter	feminine penthemimeral
τοῖοί οἱ μουνὰξ ὑποκείμενοι ἰνδάλλονται	-- - -- uu-uu ----	dactylic hexameter	masculine penthemimeral, trithemimeral
ἀστέρες. ἡ δ᾽αὕτως ὀλίγων ἀποτείνεται ὤμων	-uu - -- uu- uu-uu --	dactylic hexameter	masculine penthemimeral, hepthemimeral, trithemimeral
ὀργυιήν. φαίης κεν ἀνιάξειν ἐπὶ παιδί.	--- -- u u--- uu --	dactylic hexameter	masculine penthemimeral, trithemimeral
αὐτοῦ γὰρ κἀκεῖνο κυλίνδεται αἰνὸν ἄγαλμα	-- - --u u-uu -u u--	dactylic hexameter	feminine penthemimeral, trithemimeral
Ἀνδρομέδης ὑπὸ μητρὶ κεκασμένον. οὔ σε μάλ᾽ οἴω	-uu- uu -u u-uu - u u --	dactylic hexameter	feminine penthemimeral, trithemimeral
νύκτα περισκέψασθαι, ἵν᾽ αὐτίκα μᾶλλον ἴδηαι·	-u u---u u -uu -u u--	dactylic hexameter	feminine penthemimeral
τοίη οἱ κεφαλή, τοῖοι δέ οἱ ἀμφοτέρωθεν	-- - uu- -- u u -uu--	dactylic hexameter	masculine penthemimeral, hepthemimeral, trithemimeral
ὦμοι καὶ πόδες ἀκρότατοι καὶ ζώματα πάντα.	-- - uu -uu- - -uu --	dactylic hexameter	hepthemimeral, trithemimeral
ἀλλ᾽ ἔμπης κἀκεῖθι διωλενίη τετάνυσται,	- -- --u u-uu- uu--	dactylic hexameter	feminine penthemimeral, trithemimeral
δεσμὰ δέ οἱ κεῖται καὶ ἐν οὐρανῷ· αἱ δ᾽ἀνέχονται	-u u - -- u u -uu - uu--	dactylic hexameter	masculine penthemimeral, trithemimeral
αὐτοῦ πεπταμέναι πάντ᾽ ἤματα χεῖρες ἐκεῖναι.	-- -uu- - -uu -u u--	dactylic hexameter	masculine penthemimeral
Ἀλλ᾽ ἄρα οἱ καὶ κρατὶ πέλωρ ἐπελήλαται ἵππος	- uu - - -u u- uu-uu --	dactylic hexameter	feminine penthemimeral, hepthemimeral, trithemimeral
γαστέρι νειαίρῃ· ξυνὸς δ᾽ἐπιλάμπεται ἀστὴρ	-uu --- -- uu-uu --	dactylic hexameter	masculine penthemimeral, hepthemimeral
τοῦ μὲν ἐπ᾽ ὀμφαλίῳ, τῆς δ᾽ἐσχατόωντι καρήνῳ.	- u u -uu- - -uu-u u--	dactylic hexameter	masculine penthemimeral
οἱ δ᾽ἄρ᾽ ἔτι τρεῖς ἄλλοι ἐπὶ πλευράς τε καὶ ὤμους	- u u- - -u u- -- u u --	dactylic hexameter	feminine penthemimeral, hepthemimeral, trithemimeral
ἵππου δεικανόωσι διασταδὸν ἶσα πέλεθρα,	-- -uu-u u-uu -u u--	dactylic hexameter	feminine penthemimeral
καλοὶ καὶ μεγάλοι· κεφαλὴ δέ οἱ οὐδὲν ὁμοίη,	-- - uu- uu- u u -u u--	dactylic hexameter	masculine penthemimeral, hepthemimeral, trithemimeral
οὐδ᾽ αὐχὴν δολιχός περ ἐών. ἀτὰρ ἔσχατος ἀστὴρ	- -- uu- u u- uu -uu --	dactylic hexameter	masculine penthemimeral, hepthemimeral, trithemimeral
αἰθομένης γένυος καί κεν προτέροις ἐρίσειεν	-uu- uu- - - uu- uu--	dactylic hexameter	masculine penthemimeral, hepthemimeral, trithemimeral
τέτρασιν, οἵ μιν ἔχουσι περίσκεπτοι μάλ᾽ ἐόντες.	-uu - u u-u u--- u u--	dactylic hexameter	feminine penthemimeral, trithemimeral
οὐδ᾽ ὅ γε τετράπος ἐστἰν· ἀπ᾽ ὀμφαλίοιο γὰρ ἄκρου	- u u -uu -u u -uu-u u --	dactylic hexameter	feminine penthemimeral
μεσσόθεν ἡμιτελὴς περιτέλλεται ἱερὸς Ἵππος.	-uu -uu- uu-uu -uu --	dactylic hexameter	masculine penthemimeral
κεῖνον δὴ καί φασι καθ᾽ ὑψηλοῦ Ἑλικῶνος	-- - - -u u --- uu--	dactylic hexameter	feminine penthemimeral, trithemimeral
καλὸν ὕδωρ ἀγαγεῖν εὐαλδέος Ἱππουκρήνης.	-u u- uu- --uu ----	dactylic hexameter	masculine penthemimeral, trithemimeral
οὐ γάρ πω Ἑλικὼν ἄκρος κατελείβετο πηγαῖς,	- - - uu- -- uu-uu --	dactylic hexameter	masculine penthemimeral, hepthemimeral, trithemimeral
ἀλλ᾽ Ἵππος μιν ἔτυψε· τὸ δ᾽ἀθρόον αὐτόθεν ὕδωρ	- -- u u-u u -uu -uu --	dactylic hexameter	feminine penthemimeral, trithemimeral
ἐξέχυτο πληγῇ προτέρου ποδός· οἱ δὲ νομῆες	-uu- -- uu- uu - u u--	dactylic hexameter	masculine penthemimeral, hepthemimeral, trithemimeral
πρῶτοι κεῖνο ποτὸν διεφήμισαν Ἱππουκρήνην.	-- -u u- uu-uu ----	dactylic hexameter	masculine penthemimeral
ἀλλὰ τὸ μὲν πέτρης ἀπολείβεται, οὐδέ ποτ᾽ αὐτὸ	-u u - -- uu-uu -u u --	dactylic hexameter	masculine penthemimeral, trithemimeral
Θεσπιέων ἀνδρῶν ἐκὰς ὄψεαι· αὐτὰρ ὁ Ἵππος	-uu- -- uu -uu -u u --	dactylic hexameter	masculine penthemimeral, trithemimeral
ἐν Διὸς εἰλεῖται καί τοι πάρα θηήσασθαι.	- uu --- - - uu ----	dactylic hexameter	masculine penthemimeral, hepthemimeral
αὐτοῦ καὶ Κριοῖο θοώταταί εἰσι κέλευθοι,	-- - --u u-uu -u u--	dactylic hexameter	feminine penthemimeral, trithemimeral
ὅς ῥά τε καὶ μήκιστα διωκόμενος περὶ κύκλα	- u u - --u u-uu- uu --	dactylic hexameter	feminine penthemimeral, trithemimeral
οὐδὲν ἀφαυρότερον τροχάει Κυνοσουρίδος Ἄρκτου,	-u u-uu- uu- uu-uu --	dactylic hexameter	masculine penthemimeral, hepthemimeral
αὐτὸς μὲν νωθὴς καὶ ἀνάστερος οἷα σελήνῃ	-- - -- u u-uu -u u--	dactylic hexameter	masculine penthemimeral, trithemimeral
σκέψασθαι, ζώνῃ δ᾽ἂν ὅμως ἐπιτεκμήραιο	--- -- u u- uu----	dactylic hexameter	masculine penthemimeral, hepthemimeral, trithemimeral
Ἀνδρομέδης· ὀλίγον γὰρ ὑπ᾽ αὐτὴν ἐστήρικται.	-uu- uu- u u -- ----	dactylic hexameter	masculine penthemimeral, trithemimeral
μεσσόθι δὲ τρίβει μέγαν οὐρανόν, ἧχί περ ἄκραι	-uu - -- uu -uu -u u --	dactylic hexameter	masculine penthemimeral, trithemimeral
χηλαὶ καὶ ζώνη περιτέλλεται Ὠρίωνος.	-- - -- uu-uu ----	dactylic hexameter	masculine penthemimeral, trithemimeral
ἔστι δέ τοι καὶ ἔτ᾽ ἄλλο τετυγμένον ἐγγύθι σῆμα	-u u - u u -u u-uu -uu --	dactylic hexameter	feminine penthemimeral, trithemimeral
νειόθεν Ἀνδρομέδης, τὸ δ᾽ἐπὶ τρισὶν ἐστάθμηται	-uu -uu- u u- uu ----	dactylic hexameter	masculine penthemimeral, hepthemimeral
Δελτωτόν πλευρῇσιν, ἰσαιομένῃσιν ἐοικὸς	--- --u u-uu-u u--	dactylic hexameter	feminine penthemimeral, trithemimeral
ἀμφοτέρῃς· ἡ δ᾽οὔτι τόση, μάλα δ᾽ἐστὶν ἑτοίμη	-uu- - -u u- uu -u u--	dactylic hexameter	feminine penthemimeral, hepthemimeral, trithemimeral
εὑρέσθαι· περὶ γὰρ πολέων εὐάστερός ἐστιν.	--- uu - uu- --uu --	dactylic hexameter	masculine penthemimeral, hepthemimeral, trithemimeral
τῶν ὀλίγον Κριοῦ νοτιώτεροι ἀστέρες εἰσίν.	- uu- -- uu-uu -uu --	dactylic hexameter	masculine penthemimeral, trithemimeral
οἱ δ᾽ἄρ᾽ ἔτι προτέρω, ἔτι δ᾽ἐν προμολῇσι νότοιο,	- u u- uu- uu - uu-u u--	dactylic hexameter	masculine penthemimeral, hepthemimeral, trithemimeral
ἰχθύες. ἀλλ᾽ αἰεὶ ἕτερος προφερέστερος ἄλλου,	-uu - -- uu- uu-uu --	dactylic hexameter	masculine penthemimeral, hepthemimeral, trithemimeral
καὶ μᾶλλον βορέαο νέον κατιόντος ἀκούει.	- -- uu-u u- uu-u u--	dactylic hexameter	feminine penthemimeral, hepthemimeral, trithemimeral
ἀμφοτέρων δέ σφεων ἀποτείνεται ἠΰτε δεσμὰ	-uu- - - uu-uu -uu --	dactylic hexameter	masculine penthemimeral, trithemimeral
οὐραίων ἑκάτερθεν ἐπισχερὼ εἰς ἓν ἰόντων.	--- uu-u u-uu - u u--	dactylic hexameter	feminine penthemimeral, trithemimeral
καὶ τὰ μὲν εἷς ἀστὴρ ἐπέχει καλός τε μέγας τε,	- u u - -- uu- -- u u- -	dactylic hexameter	masculine penthemimeral, hepthemimeral, trithemimeral
ὅν ῥά τε καὶ σύνδεσμον ὑπούραιον καλέουσιν.	- u u - --u u--- uu--	dactylic hexameter	feminine penthemimeral, trithemimeral
Ἀνδρομέδης δέ τοι ὦμος ἀριστερὸς Ἰχθύος ἔστω	-uu- u u -u u-uu -uu --	dactylic hexameter	feminine penthemimeral, trithemimeral
σῆμα βορειοτέρου· μάλα γάρ νύ οἱ ἐγγύθεν ἐστίν.	-u u-uu- uu - u u -uu --	dactylic hexameter	masculine penthemimeral, hepthemimeral
ἀμφότεροι δὲ πόδες γαμβροῦ ἐπισημαίνοιεν	-uu- u u- -- uu----	dactylic hexameter	masculine penthemimeral, hepthemimeral, trithemimeral
Περσέος, οἵ ῥά οἱ αἰὲν ἐπωμάδιοι φορέονται.	-uu - u u -u u-uu- uu--	dactylic hexameter	feminine penthemimeral, trithemimeral
αὐτάρ ὅ γ᾽ἐν βορέω φέρεται περιμήκετος ἄλλων.	-u u - uu- uu- uu-uu --	dactylic hexameter	masculine penthemimeral, hepthemimeral, trithemimeral
καί οἱ δεξιτερὴ μὲν ἐπὶ κλισμὸν τετάνυσται	- - -uu- u u- -- uu--	dactylic hexameter	masculine penthemimeral, hepthemimeral
πενθερίου δίφροιο· τὰ δ᾽ἐν ποσὶν οἷα διώκων	-uu- --u u - uu -u u--	dactylic hexameter	feminine penthemimeral, hepthemimeral, trithemimeral
ἴχνια μηκύνει κεκονιμένος ἐν Διὶ πατρί.	-uu --- uu-uu - uu --	dactylic hexameter	masculine penthemimeral
ἄγχι δέ οἱ σκαιῆς ἐπιγουνίδος ἤλιθα πᾶσαι	-u u - -- uu-uu -uu --	dactylic hexameter	masculine penthemimeral, trithemimeral
Πληϊάδες φορέονται. ὁ δ᾽οὐ μάλα πολλὸς ἁπάσας	-uu- uu-u u - uu -u u--	dactylic hexameter	feminine penthemimeral, hepthemimeral, trithemimeral
χῶρος ἔχει, καὶ δ᾽αὐταὶ ἐπισκέψασθαι ἀφαυραί.	-u u- - -u u---u u--	dactylic hexameter	feminine penthemimeral, trithemimeral
ἑπτάποροι δὴ ταί γε μετ᾽ ἀνθρώπους ὑδέονται,	-uu- - - u u --- uu--	dactylic hexameter	masculine penthemimeral, trithemimeral
ἓξ οἶαί περ ἐοῦσαι ἐπόψιαι ὀφθαλμοῖσιν.	- -- u u-u u-uu ----	dactylic hexameter	feminine penthemimeral, trithemimeral
οὐ μέν πως ἀπόλωλεν ἀπευθὴς ἐκ Διὸς ἀστήρ,	- - - uu-u u-- - uu --	dactylic hexameter	feminine penthemimeral, trithemimeral
ἐξ αὗ καὶ γενεῆθεν ἀκούομεν, ἀλλὰ μάλ᾽ αὕτως	- - - uu-u u-uu -u u --	dactylic hexameter	feminine penthemimeral, trithemimeral
εἴρεται. ἑπτὰ δ᾽ἐκεῖναι ἐπιρρήδην καλέονται	-uu -u u-u u--- uu--	dactylic hexameter	feminine penthemimeral
Ἀλκυόνη Μερόπη τε Κελαινώ τ᾽Ἠλέκτρη τε	-uu- uu- u u-- --- -	dactylic hexameter	masculine penthemimeral, trithemimeral
καὶ Στερόπη καὶ Τηϋγέτη καὶ πότνια Μαῖα.	- uu- - -uu- - -uu --	dactylic hexameter	hepthemimeral, trithemimeral
αἱ μὲν ὁμῶς ὀλίγαι καὶ ἀφεγγέες, ἀλλ᾽ ὀνομασταὶ	- u u- uu- u u-uu - uu--	dactylic hexameter	masculine penthemimeral, trithemimeral
ἦρι καὶ ἑσπέριαι, Ζεὺς δ᾽αἴτιος, εἱλίσσονται,	-u u -uu- - -uu ----	dactylic hexameter	masculine penthemimeral
ὅ σφισι καὶ θέρεος καὶ χείματος ἀρχομένοιο	- uu - uu- - -uu -uu--	dactylic hexameter	masculine penthemimeral, trithemimeral
σημαίνειν ἐκέλευσεν ἐπερχομένου τ᾽ἀρότοιο.	--- uu-u u-uu- uu--	dactylic hexameter	feminine penthemimeral, trithemimeral
καὶ χέλυς, ἥτ᾽ ὀλίγη· τὴν δ᾽ἆρ᾽ ἔτι καὶ παρὰ λίκνῳ	- uu - uu- - - uu - uu --	dactylic hexameter	masculine penthemimeral, hepthemimeral, trithemimeral
Ἑρμείης ἐτόρησε, λύρην δέ μιν εἶπε λέγεσθαι.	--- uu-u u- u u -u u--	dactylic hexameter	feminine penthemimeral, hepthemimeral, trithemimeral
κὰδ δ᾽ἔθετο προπάροιθεν ἀπευθέος Εἰδώλοιο	- uu- uu-u u-uu ----	dactylic hexameter	feminine penthemimeral, trithemimeral
οὐρανὸν εἰσαγαγών. τὸ δ᾽ἐπὶ σκελέεσσι πέτηλον	-uu -uu- u u- uu-u u--	dactylic hexameter	masculine penthemimeral, hepthemimeral
γούνατί οἱ σκαιῷ πελάει· κεφαλή γε μὲν ἄκρη	-uu - -- uu- uu- u u --	dactylic hexameter	masculine penthemimeral, hepthemimeral, trithemimeral
ἀντιπέρην Ὄρνιθος ἑλίσσεται· ἡ δὲ μεσηγὺ	-uu- --u u-uu - u u--	dactylic hexameter	feminine penthemimeral, trithemimeral
ὀρνιθέης κεφαλῆς καὶ γούνατος ἐστήρικται.	-uu- uu- - -uu ----	dactylic hexameter	masculine penthemimeral, trithemimeral
ἦτοι γὰρ καὶ Ζηνὶ παρατρέχει αἰόλος ὄρνις.	-- - - -u u-uu -uu --	dactylic hexameter	feminine penthemimeral, trithemimeral
ἀλλ᾽ ὁ μὲν ἠερόεις, τὰ δέ οἱ ἔπι τετρήχυνται	- u u -uu- u u - uu ----	dactylic hexameter	masculine penthemimeral, hepthemimeral
ἀστράσιν οὔτι λίην μεγάλοις, ἀτὰρ οὐ μὲν ἀφαυροῖς.	-uu -u u- uu- uu - u u--	dactylic hexameter	masculine penthemimeral, hepthemimeral
αὐτὰρ ὅ γ᾽εὐδιόωντι ποτὴν ὄρνιθι ἐοικὼς	-u u -uu-u u- --u u--	dactylic hexameter	feminine penthemimeral, hepthemimeral
οὔριος εἰς ἑτέρην φέρεται, κατὰ δεξιὰ χειρὸς	-uu - uu- uu- uu -uu --	dactylic hexameter	masculine penthemimeral, hepthemimeral, trithemimeral
Κηφείης ταρσοῖο τὰ δεξιὰ πείρατα τείνων,	--- --u u -uu -uu --	dactylic hexameter	feminine penthemimeral, trithemimeral
λαιῇ δὲ πτέρυγι σκαρθμὸς παρακέκλιται Ἵππου.	-- - uu- -- uu-uu --	dactylic hexameter	masculine penthemimeral, hepthemimeral, trithemimeral
τὸν δὲ μετασκαίροντα δύ᾽ Ἰχθύες ἀμφινέμονται	- u u---u u -uu -uu--	dactylic hexameter	feminine penthemimeral
ἵππον· πὰρ δ᾽ἄρα οἱ κεφαλῇ χεὶρ Ὑδροχόοιο	-- - uu - uu- - -uu--	dactylic hexameter	masculine penthemimeral, hepthemimeral, trithemimeral
δεξιτερὴ τετάνυσθ᾽· ὁ δ᾽ὀπίστερος Αἰγοκερῆος	-uu- uu- u u-uu -uu--	dactylic hexameter	masculine penthemimeral, trithemimeral
τέλλεται. αὐτὰρ ὅ γε πρότερος καὶ νειόθι μᾶλλον	-uu -u u - uu- - -uu --	dactylic hexameter	masculine penthemimeral, hepthemimeral
κέκλιται αἰγόκερως, ἵνα τε τρέπετ᾽ ἠελίου ἴς.	-uu -uu- uu - uu -uu- -	dactylic hexameter	masculine penthemimeral, hepthemimeral
μὴ κείνῳ ἐνὶ μηνὶ περικλύζοιο θαλάσσῃ	- -- uu -u u---u u--	dactylic hexameter	feminine penthemimeral, trithemimeral
πεπταμένῳ πελάγει κεχρημένος. οὔτε κεν ἠοῖ	-uu- uu- --uu -u u --	dactylic hexameter	masculine penthemimeral, trithemimeral
πολλὴν πειρήνειας, ἐπεὶ ταχινώταταί εἰσιν·	-- ---u u- uu-uu --	dactylic hexameter	feminine penthemimeral, hepthemimeral
οὔτ᾽ ἄν τοι νυκτὸς πεφοβημένῳ ἐγγύθεν ἠὼς	- - - -- uu-uu -uu --	dactylic hexameter	masculine penthemimeral, trithemimeral
ἔλθοι καὶ μάλα πολλὰ βοωμένῳ. οἱ δ᾽ἀλεγεινοὶ	-- - uu -u u-uu - uu--	dactylic hexameter	feminine penthemimeral, trithemimeral
τῆμος ἐπιρρήσσουσι νότοι, ὁπότ᾽ Αἰγοκερῆϊ	-u u---u u- uu -uu--	dactylic hexameter	feminine penthemimeral, hepthemimeral
συμφέρετ᾽ ἠέλιος· τότε δέ κρύος ἐκ Διός ἐστιν	-uu -uu- uu - uu - uu --	dactylic hexameter	masculine penthemimeral, hepthemimeral
ναύτῃ μαλκιόωντι κακώτερον. ἀλλὰ καὶ ἔμπης	-- -uu-u u-uu -u u --	dactylic hexameter	feminine penthemimeral
ἤδη πάντ᾽ ἐνιαυτὸν ὑπὸ στείρῃσι θάλασσα	-- - uu-u u- --u u--	dactylic hexameter	feminine penthemimeral, hepthemimeral, trithemimeral
πορφύρει· ἴκελοι δὲ κολυμβίσιν αἰθυίῃσιν	-uu --- u u-uu ----	dactylic hexameter	masculine penthemimeral
πολλάκις ἐκ νηῶν πέλαγος περιπαπταίνοντες	-uu - -- uu- uu----	dactylic hexameter	masculine penthemimeral, hepthemimeral, trithemimeral
ἥμεθ᾽ ἐπ᾽ αἰγιαλοὺς τετραμμένοι· οἱ δ᾽ἔτι πόρσω	-u u -uu- --uu - uu --	dactylic hexameter	masculine penthemimeral
κλύζονται· ὀλίγον δὲ διὰ ξύλον Ἄϊδ᾽ ἐρύκει.	--- uu- u u- uu -u u--	dactylic hexameter	masculine penthemimeral, hepthemimeral, trithemimeral
καὶ δ᾽ἄν ἐπὶ προτέρῳ γε, θαλάσσῃ πολλὰ πεπονθώς,	- u u- uu- u u-- -u u--	dactylic hexameter	masculine penthemimeral, trithemimeral
τόξον ὅτ᾽ ἠέλιος καίει καὶ ῥύτορα Τόξου,	-u u -uu- -- - -uu --	dactylic hexameter	masculine penthemimeral, hepthemimeral
ἑσπέριος κατάγοιο, πεποιθὼς οὐκέτι νυκτί.	-uu- uu-u u-- -uu --	dactylic hexameter	feminine penthemimeral, trithemimeral
σῆμα δέ τοι κείνης ὥρης καὶ μηνὸς ἐκείνου	-u u - -- -- - -u u--	dactylic hexameter	masculine penthemimeral, hepthemimeral, trithemimeral
σκορπίος ἀντέλλων εἴη πυμάτης ἐπὶ νυκτός.	-uu --- -- uu- uu --	dactylic hexameter	masculine penthemimeral, hepthemimeral
ἤτοι γὰρ μέγα τόξον ἀνέλκεται ἐγγύθι κέντρου	-- - uu -u u-uu -uu --	dactylic hexameter	feminine penthemimeral, trithemimeral
τοξευτὴς· ὀλίγον δὲ παροίτερος ἵσταται αὐτοῦ	--- uu- u u-uu -uu --	dactylic hexameter	masculine penthemimeral, trithemimeral
σκορπίος ἀντέλλων, ὁ δ᾽ἀνέρχεται αὐτίκα μᾶλλον.	-uu --- u u-uu -uu --	dactylic hexameter	masculine penthemimeral
τῆμος καὶ κεφαλὴ Κυνοσουρίδος ἀκρόθι νυκτὸς	-- - uu- uu-uu -uu --	dactylic hexameter	masculine penthemimeral, trithemimeral
ὕψι μάλα τροχάει, ὁ δὲ δύεται ἠῶθι πρὸ	-u u- uu- u u -uu --- -	dactylic hexameter	masculine penthemimeral, trithemimeral
ἀθρόος Ὠρίων, Κηφεὺς δ᾽ἀπὸ χειρὸς ἐπ᾽ ἰξύν.	-uu --- -- uu -u u --	dactylic hexameter	masculine penthemimeral, hepthemimeral
ἔστι δέ τις προτέρω βεβλημένος ἄλλος ὀϊστὸς	-u u - uu- --uu -u u--	dactylic hexameter	masculine penthemimeral, trithemimeral
αὐτός ἄτερ τόξου· ὁ δέ οἱ παραπέπταται Ὄρνις	-u u- -- u u - uu-uu --	dactylic hexameter	masculine penthemimeral, hepthemimeral, trithemimeral
ἀσσότερον βορέω. σχεδόθεν δέ οἱ ἄλλος ἄηται	-uu- uu- uu- u u -u u--	dactylic hexameter	masculine penthemimeral, hepthemimeral, trithemimeral
οὐ τόσσος μεγέθει, χαλεπός γε μὲν ἐξ ἁλὸς ἐλθεῖν	- -- uu- uu- u u - uu --	dactylic hexameter	masculine penthemimeral, hepthemimeral, trithemimeral
νυκτὸς ἀπερχομένης· καί μιν καλέουσιν ἄητον.	-u u-uu- - - uu-u u--	dactylic hexameter	masculine penthemimeral, hepthemimeral
δελφὶς δ᾽,οὐ μάλα πολλός, ἐπιτρέχει Αἰγοκερῆϊ	-- - uu -u u-uu -uu--	dactylic hexameter	feminine penthemimeral, trithemimeral
μεσσόθεν ἠερόεις· τὰ δέ οἱ περὶ τέσσαρα κεῖται	-uu -uu- u u - uu -uu --	dactylic hexameter	masculine penthemimeral, hepthemimeral
γλήνεα, παρβολάδην δύο πὰρ δύο πεπτηῶτα.	-uu -uu- uu - uu ----	dactylic hexameter	masculine penthemimeral, hepthemimeral
καὶ τὰ μὲν οὖν βορέω καὶ ἀλήσιος ἠελίοιο	- u u - uu- u u-uu -uu--	dactylic hexameter	masculine penthemimeral, trithemimeral
μεσσηγὺς κέχυται· τὰ δὲ νειόθι τέλλεται ἄλλα	--- uu- u u -uu -uu --	dactylic hexameter	masculine penthemimeral, trithemimeral
πολλὰ μεταξὺ νότοιο καὶ ἠελίοιο κελεύθου.	-u u-u u-u u -uu-u u--	dactylic hexameter	feminine penthemimeral
λοξὸς μὲν Ταύροιο τομῆ ὑποκέκλιται αὐτὸς	-- - --u u- uu-uu --	dactylic hexameter	feminine penthemimeral, hepthemimeral, trithemimeral
Ὠρίων. μὴ κεῖνον ὅτις καθαρῇ ἐνὶ νυκτὶ	--- - -u u- uu- uu --	dactylic hexameter	feminine penthemimeral, hepthemimeral, trithemimeral
ὑψοῦ πεπτηῶτα παρέρχεται ἄλλα πεποίθοι	-- ---u u-uu -u u--	dactylic hexameter	feminine penthemimeral
οὐρανὸν εἰσανιδὼν προφερέστερα θηήσασθαι.	-uu -uu- uu-uu ----	dactylic hexameter	masculine penthemimeral
τοῖός οἱ καὶ φρουρὸς ἀειρομένῳ ὑπὸ νώτῳ	-- - - -u u-uu- uu --	dactylic hexameter	feminine penthemimeral, trithemimeral
φαίνεται ἀμφοτέροισι κύων ὑπὸ ποσσὶ βεβηκώς,	-uu -uu-u u- uu -u u--	dactylic hexameter	feminine penthemimeral, hepthemimeral
ποικίλος, ἀλλ᾽ οὐ πάντα πεφασμένος· ἀλλὰ κατ᾽ αὐτὴν	-uu - - -u u-uu -u u --	dactylic hexameter	feminine penthemimeral, trithemimeral
γαστέρα κυάνεος περιτέλλεται, ἡ δέ αἱ ἄκρη	-uu -uu- uu-uu - u u --	dactylic hexameter	masculine penthemimeral
ἀστέρι βέβληται δεινὴ γένυς, ὅς ῥα μάλιστα	-uu --- -- uu - u u--	dactylic hexameter	masculine penthemimeral, hepthemimeral
ὀξέα σειριάει· καί μιν καλέουσ᾽ ἄνθρωποι	-uu -uu- - - uu- ---	dactylic hexameter	masculine penthemimeral, hepthemimeral
Σείριον. οὐκέτι κεῖνον ἅμ᾽ ἠελίῳ ἀνιόντα	-uu -uu -u u -uu- uu--	dactylic hexameter	feminine penthemimeral
φυταλιαὶ ψεύδονται ἀναλδέα φυλλιόωσαι.	-uu- --u u-uu -uu--	dactylic hexameter	feminine penthemimeral, trithemimeral
ῥεῖα γάρ οὖν ἔκρινε διὰ στίχας ὀξὺς ἀΐξας,	-u u - --u u- uu -u u--	dactylic hexameter	feminine penthemimeral, hepthemimeral, trithemimeral
καὶ τὰ μὲν ἔρρωσεν, τῶν δὲ φλόον ὤλεσε πάντα.	- u u --- - - uu -uu --	dactylic hexameter	masculine penthemimeral, hepthemimeral
κείνου καὶ κατιόντος ἀκούομεν· οἱ δὲ δὴ ἄλλοι	-- - uu-u u-uu - u u --	dactylic hexameter	feminine penthemimeral, trithemimeral
σῆμ᾽ ἔμεναι μελέεσσιν ἐλαφρότεροι περίκεινται.	- uu- uu-u u-uu- uu--	dactylic hexameter	feminine penthemimeral, trithemimeral
ποσσὶν δ᾽Ὠρίωνος ὑπ᾽ ἀμφοτέροισι λαγῳός	-- ---u u -uu-u u--	dactylic hexameter	feminine penthemimeral
ἐμμενές ἤματα πάντα διώκεται. αὐτὰρ ὅ γ᾽αἰεὶ	-uu -uu -u u-uu -u u --	dactylic hexameter	feminine penthemimeral
Σείριος ἐξόπιθεν φέρεται μετιόντι ἐοικώς,	-uu -uu- uu- uu-u u--	dactylic hexameter	masculine penthemimeral, hepthemimeral
καί οἱ ἐπαντέλλει, καί μιν κατιόντα δοκεύει.	- u u--- - - uu-u u--	dactylic hexameter	masculine penthemimeral, hepthemimeral
ἡ δὲ Κυνὸς μεγάλοιο κατ᾽ οὐρὴν ἕλκεται ἀργῷ	- u u- uu-u u -- -uu --	dactylic hexameter	feminine penthemimeral, trithemimeral
πρυμνόθεν· οὐ γὰρ τῇ γε κατὰ χρέος εἰσὶ κέλευθοι,	-uu - - - u u- uu -u u--	dactylic hexameter	masculine penthemimeral, hepthemimeral, trithemimeral
ἀλλ᾽ ὄπιθεν φέρεται τετραμμένη, οἷα καὶ αὐταὶ	- uu- uu- --uu -u u --	dactylic hexameter	masculine penthemimeral, trithemimeral
νῆες, ὅτ᾽ ἤδη ναῦται ἐπιστρέψωσι κορώνην	-u u -- -u u---u u--	dactylic hexameter	feminine penthemimeral
ὅρμον ἐσερχόμενοι· τὴν δ᾽αὐτίκα πᾶς ἀνακόπτει	-u u-uu- - -uu - uu--	dactylic hexameter	masculine penthemimeral
νῆα, παλιρροθίη δὲ καθάπτεται ἠπείροιο·	-u u-uu- u u-uu ----	dactylic hexameter	masculine penthemimeral
ὥς ἥ γε πρύμνηθεν Ἰησονὶς ἕλκεται Ἀργώ.	- - - --u u-uu -uu --	dactylic hexameter	feminine penthemimeral, trithemimeral
καὶ τὰ μὲν ἠερίη καὶ ἀνάστερος ἄχρι παρ᾽ αὐτὸν	- u u -uu- u u-uu -u u --	dactylic hexameter	masculine penthemimeral
ἱστὸν ἀπὸ πρώρης φέρεται, τὰ δὲ πᾶσα φαεινή.	-u u- -- uu- u u -u u--	dactylic hexameter	masculine penthemimeral, hepthemimeral, trithemimeral
καί οἱ πηδάλιον κεχαλασμένον ἐστήρικται	- - -uu- uu-uu ----	dactylic hexameter	masculine penthemimeral
ποσσὶν ὑπ᾽ οὐραίοισι Κυνὸς προπάροιθεν ἰόντος.	-u u ---u u- uu-u u--	dactylic hexameter	feminine penthemimeral, hepthemimeral
τὴν δὲ καί οὐκ ὀλίγον περ ἀπόπροθι πεπτηυῖαν	- u u - uu- u u-uu ----	dactylic hexameter	masculine penthemimeral, trithemimeral
Ἀνδρομέδην μέγα κῆτος ἐπερχόμενον κατεπείγει.	-uu- uu -u u-uu- uu--	dactylic hexameter	feminine penthemimeral, trithemimeral
ἡ μὲν γὰρ Θρήϊκος ὑπὸ πνοιῇ βορέαο	- - - --u u- -- uu--	dactylic hexameter	feminine penthemimeral, hepthemimeral, trithemimeral
κεκλιμένη φέρεται, τὸ δέ οἱ νότος ἐχθρὸν ἀγινεῖ	-uu- uu- u u - uu -u u--	dactylic hexameter	masculine penthemimeral, hepthemimeral, trithemimeral
κῆτος, ὑπὸ Κριῷ τε καὶ Ἰχθύσιν ἀμφοτέροισιν,	-u u- -- u u -uu -uu--	dactylic hexameter	masculine penthemimeral, trithemimeral
βαιὸν ὑπὲρ Ποταμοῦ βεβλημένον ἀστερόεντος.	-u u- uu- --uu -uu--	dactylic hexameter	masculine penthemimeral, trithemimeral
οἶον γὰρ κἀκεῖνο θεῶν ὑπό ποσσὶ φορεῖται	-- - --u u- uu -u u--	dactylic hexameter	feminine penthemimeral, hepthemimeral, trithemimeral
λείψανον Ἠριδανοῖο, πολυκλαύτου ποταμοῖο.	-uu -uu-u u--- uu--	dactylic hexameter	feminine penthemimeral
καὶ τὸ μὲν Ὠρίωνος ὑπὸ σκαιὸν πόδα τείνει·	- u u ---u u- -- uu --	dactylic hexameter	feminine penthemimeral, hepthemimeral
δεσμοὶ δ᾽οὐραῖοι, τοῖς Ἰχθύες ἄκροι ἔχονται,	-- --- - -uu -u u--	dactylic hexameter	masculine penthemimeral
ἄμφω συμφορέονται ἀπ᾽ οὐραίων κατιόντες·	-- -uu-u u --- uu--	dactylic hexameter	feminine penthemimeral
Κητείης δ᾽ὄπιθεν λοφίης ἐπιμὶξ φορέονται	--- uu- uu- uu- uu--	dactylic hexameter	masculine penthemimeral, hepthemimeral, trithemimeral
εἰς ἓν ἐλαυνόμενοι· ἑνὶ δ᾽ἀστέρι πειραίνονται	- u u-uu- uu -uu ----	dactylic hexameter	masculine penthemimeral
κήτεος, ὃς κείνου πρώτῃ ἐπίκειται ἀκάνθῃ.	-uu - -- -- uu-u u--	dactylic hexameter	masculine penthemimeral, hepthemimeral, trithemimeral
οἱ δ᾽ὀλίγῳ μέτρῳ ὀλίγῃ δ᾽ἐγκείμενοι αἴγλῃ	- uu- -- uu- --uu --	dactylic hexameter	masculine penthemimeral, hepthemimeral, trithemimeral
μεσσόθι πηδαλίου καὶ Κήτεος εἱλίσσονται,	-uu -uu- - -uu ----	dactylic hexameter	masculine penthemimeral
γλαυκοῦ πεπτηῶτες ὑπὸ πλευρῇσι Λαγωοῦ	-- ---u u- --u u--	dactylic hexameter	feminine penthemimeral, hepthemimeral
νώνυμοι· οὐ γὰρ τοί γε τετυγμένου εἰδώλοιο	-uu - - - u u-uu ----	dactylic hexameter	masculine penthemimeral, trithemimeral
βεβλέαται μελέεσσιν ἐοικότες, οἷά τε πολλὰ	-uu- uu-u u-uu -u u --	dactylic hexameter	feminine penthemimeral, trithemimeral
ἑξείης στιχόωντα παρέρχεται αὐτὰ κέλευθα	--- uu-u u-uu -u u--	dactylic hexameter	feminine penthemimeral, trithemimeral
ἀνομένων ἐτέων· τά τις ἀνδρῶν οὐκέτ᾽ ἐόντων	-uu- uu- u u -- -u u--	dactylic hexameter	masculine penthemimeral, trithemimeral
ἐφράσατ᾽ ἠδ᾽ ἐνόησεν ἅπαντ᾽ ὀνομαστὶ καλέσσαι	-uu - uu-u u- uu-u u--	dactylic hexameter	feminine penthemimeral, hepthemimeral, trithemimeral
ἤλιθα μορφώσας. οὐ γάρ κ᾽ἐδυνήσατο πάντων	-uu --- - - uu-uu --	dactylic hexameter	masculine penthemimeral, hepthemimeral
οἰόθι κεκριμένων ὄνομ᾽ εἰπεῖν, οὐδὲ δαῆναι.	-uu -uu- uu -- -u u--	dactylic hexameter	masculine penthemimeral
πολλοὶ γὰρ πάντη, πολέων δ᾽ἐπὶ ἶσα πέλονται	-- - -- uu- uu -u u--	dactylic hexameter	masculine penthemimeral, hepthemimeral, trithemimeral
μέτρα τε καὶ χροιή, πάντες γε μὲν ἀμφιέλικτοι.	-u u - -- -- u u -uu--	dactylic hexameter	masculine penthemimeral, hepthemimeral, trithemimeral
τῶ καὶ ὁμηγερέας οἱ ἐείσατο ποιήσασθαι	- u u-uu- u u-uu ----	dactylic hexameter	masculine penthemimeral
ἀστέρας, ὄφρ᾽ ἐπιτὰξ ἄλλῳ παρακείμενος ἄλλος	-uu - uu- -- uu-uu --	dactylic hexameter	masculine penthemimeral, hepthemimeral, trithemimeral
εἴδεα σημαίνοιεν. ἄφαρ δ᾽ὀνομαστὰ γένοντο	-uu ---u u- uu-u u--	dactylic hexameter	feminine penthemimeral, hepthemimeral
ἄστρα, καὶ οὐκέτι νῦν ὑπὸ θαύματι τέλλεται ἀστήρ.	-u u -uu - uu -uu -uu --	dactylic hexameter	masculine penthemimeral
ἀλλ᾽ οἱ μὲν καθαροῖς ἐναρηρότες εἰδώλοισιν	- - - uu- uu-uu ----	dactylic hexameter	masculine penthemimeral, trithemimeral
φαίνονται· τὰ δ᾽ἔνερθε διωκομένοιο Λαγωοῦ	--- u u-u u-uu-u u--	dactylic hexameter	feminine penthemimeral, trithemimeral
πάντα μάλ᾽ ἠερόεντα καὶ οὐκ ὀνομαστὰ φέρονται.	-u u -uu-u u - uu-u u--	dactylic hexameter	feminine penthemimeral, hepthemimeral
νειόθι δ᾽Αἰγοκερῆος, ὑπὸ πνοιῇσι νότοιο,	-uu -uu-u u- --u u--	dactylic hexameter	feminine penthemimeral, hepthemimeral
ἰχθὺς ἐς Κῆτος τετραμμένος αἰωρεῖται	-- - -- --uu ----	dactylic hexameter	masculine penthemimeral, trithemimeral
οἶος ἀπὸ προτέρων, νοτιον δέ ἑ κικλήσκουσιν.	-u u- uu- uu- u u ----	dactylic hexameter	masculine penthemimeral, hepthemimeral, trithemimeral
ἄλλοι δέ, σποράδην ὑποκείμενοι Ὑδροχοῆϊ,	-- - uu- uu-uu -uu--	dactylic hexameter	masculine penthemimeral, trithemimeral
κήτεος αἰθερίοιο καὶ Ἰχθύος ἠερέθονται	-uu -uu-u u -uu -uu--	dactylic hexameter	feminine penthemimeral
μέσσοι νωχελέες καὶ ἀνώνυμοι· ἐγγύθι δέ σφεων,	-- -uu- u u-uu -uu - -	dactylic hexameter	masculine penthemimeral
δεξιτερῆς ἀπὸ χειρὸς ἀγαυοῦ Ὑδροχόοιο,	-uu- uu -u u-- -uu--	dactylic hexameter	feminine penthemimeral, trithemimeral
οἵη τίς τ᾽ὀλίγη χύσις ὕδατος ἔνθα καὶ ἔνθα	-- - uu- uu -uu -u u --	dactylic hexameter	masculine penthemimeral, trithemimeral
σκιδναμένου, χαροποὶ καὶ ἀναλδέες εἱλίσσονται.	-uu- uu- u u-uu ----	dactylic hexameter	masculine penthemimeral, trithemimeral
ἐν δέ σφιν δύο μᾶλλον ἐειδόμενοι φορέονται	- - - uu -u u-uu- uu--	dactylic hexameter	feminine penthemimeral, trithemimeral
ἀστέρες, οὔτε τι πολλὸν ἀπήοροι, οὔτε μάλ᾽ ἐγγύς·	-uu -u u -u u-uu -u u --	dactylic hexameter	feminine penthemimeral
εἷς μὲν ὑπ᾽ ἀμφοτέροισι ποσὶν καλός τε μέγας τε	- u u -uu-u u- -- u u- -	dactylic hexameter	feminine penthemimeral, hepthemimeral
Ὑδροχόου, ὁ δὲ κυανέου ὑπὸ Κήτεος οὐρῇ.	-uu- u u -uu- uu -uu --	dactylic hexameter	hepthemimeral, trithemimeral
τοὺς πάντας καλέουσιν ὕδωρ. ὀλίγοι γε μὲν ἄλλοι	- -- uu-u u- uu- u u --	dactylic hexameter	feminine penthemimeral, hepthemimeral, trithemimeral
νειόθι Τοξευτῆρος ὑπὸ προτέροισι πόδεσσιν	-uu ---u u- uu-u u--	dactylic hexameter	feminine penthemimeral, hepthemimeral
δινωτοὶ κύκλῳ περιηγέες εἱλίσσονται.	--- -- uu-uu ----	dactylic hexameter	masculine penthemimeral, trithemimeral
αὐτὰρ ὑπ᾽ αἰθομένῳ κέντρῳ τέραος μεγάλοιο	-u u -uu- -- uu- uu--	dactylic hexameter	masculine penthemimeral, hepthemimeral
σκορπίου, ἄγχι νότοιο, Θυτήριον αἰωρεῖται.	-uu -u u-u u-uu ----	dactylic hexameter	feminine penthemimeral
τοῦ δ᾽ἤτοι ὀλίγον περ ἐπὶ χρόνον ὑψόθ᾽ ἐόντος	- -- uu- u u- uu -u u--	dactylic hexameter	masculine penthemimeral, hepthemimeral, trithemimeral
πεύσεαι· ἀντιπέρην γὰρ ἀείρεται Ἀρκτούροιο.	-uu -uu- u u-uu ----	dactylic hexameter	masculine penthemimeral
καὶ τῷ μὲν μάλα πάγχυ μετήοροί εἰσι κέλευθοι	- - - uu -u u-uu -u u--	dactylic hexameter	feminine penthemimeral, trithemimeral
ἀρκτούρῳ, τὸ δὲ θᾶσσον ὑφ᾽ ἑσπερίην ἅλα νεῖται.	--- u u -u u -uu- uu --	dactylic hexameter	feminine penthemimeral, trithemimeral
ἀλλ᾽ ἄρα καὶ περὶ κεῖνο Θυτήριον ἀρχαίη Νύξ,	- uu - uu -u u-uu --- -	dactylic hexameter	feminine penthemimeral, trithemimeral
ἀνθρώπων κλαίουσα πόνον, χειμῶνος ἔθηκεν	--- --u u- --u u--	dactylic hexameter	feminine penthemimeral, hepthemimeral, trithemimeral
εἰναλίου μέγα σῆμα. κεδαιόμεναι γὰρ ἐκείνῃ	-uu- uu -u u-uu- u u--	dactylic hexameter	feminine penthemimeral, trithemimeral
νῆες ἄπο φρενός εἰσι, τὰ δ᾽ἄλλοθεν ἄλλα πιφαύσκει	-u u- uu -u u -uu -u u--	dactylic hexameter	feminine penthemimeral, trithemimeral
δήματ᾽, ἐποικτείρουσα πολυρροθίους ἀνθρώπους.	-u u---u u-uu- ---	dactylic hexameter	feminine penthemimeral
τῶ μή μοι πελάγει νεφέων εἰλυμένον ἄλλων	- - - uu- uu- --uu --	dactylic hexameter	masculine penthemimeral, hepthemimeral, trithemimeral
εὔχεο μεσσόθι κεῖνο φανήμεναι οὐρανῷ ἄστρον,	-uu -uu -u u-uu -uu --	dactylic hexameter	feminine penthemimeral
αὐτὸ μὲν ἀνέφελόν τε καὶ ἀγλαόν, ὕψι δὲ μᾶλλον	-u u -uu- u u -uu -u u --	dactylic hexameter	masculine penthemimeral
κυμαίνοντι νέφει πεπιεσμένον, οἷά τε πολλὰ	---u u- uu-uu -u u --	dactylic hexameter	masculine penthemimeral
θλίβετ᾽ ἀναστέλλοντος ὀπωρινοῦ ἀνέμοιο.	-u u---u u-uu ----	dactylic hexameter	feminine penthemimeral
πολλάκι γὰρ καὶ τοῦτο νότῳ ἔπι σῆμα τιτύσκει	-uu - - -u u- uu -u u--	dactylic hexameter	feminine penthemimeral, hepthemimeral, trithemimeral
νὺξ αὐτή, μογεροῖσι χαριζομένη ναύτῃσιν.	- -- uu-u u-uu- ---	dactylic hexameter	feminine penthemimeral, trithemimeral
οἱ δ᾽εἰ μέν κε πίθωνται ἐναίσιμα σημαινούσῃ,	- - - u u-u u-uu ----	dactylic hexameter	feminine penthemimeral, trithemimeral
αἶψά τε κοῦφά τε πάντα καὶ ἄρτια ποιήσωνται,	-u u -u u -u u -uu ----	dactylic hexameter	feminine penthemimeral
αὐτίκ᾽ ἐλαφρότερος πέλεται πόνος· εἰ δέ κε νηῒ	-u u-uu- uu- uu - u u --	dactylic hexameter	masculine penthemimeral, hepthemimeral
ὑψόθεν ἐμπλήξῃ δεινὴ ἀνέμοιο θύελλα	-uu --- -- uu-u u--	dactylic hexameter	masculine penthemimeral, hepthemimeral
αὕτως ἀπρόφατος, τὰ δὲ λαίφεα πάντα ταράξῃ,	-- -uu- u u -uu -u u--	dactylic hexameter	masculine penthemimeral
ἄλλοτε μὲν καὶ πάμπαν ὑπόβρυχα ναυτίλλονται,	-uu - - -u u-uu ----	dactylic hexameter	feminine penthemimeral, trithemimeral
ἄλλοτε δ᾽,αἴ κε Διὸς παρανισσομένοιο τύχωσιν	-uu - u u- uu-uu-u u--	dactylic hexameter	masculine penthemimeral, trithemimeral
εὐχόμενοι, βορέω δὲ παραστράψῃ ἀνέμου ἴς,	-uu- uu- u u--- uu- -	dactylic hexameter	masculine penthemimeral, trithemimeral
πολλὰ μάλ᾽ ὀτλήσαντες ὅμως πάλιν ἐσκέψαντο	-u u ---u u- uu ----	dactylic hexameter	feminine penthemimeral, hepthemimeral
ἀλλήλους ἐπὶ νηΐ. νότον δ᾽ἐπὶ σήματι τούτῳ	--- uu -u u- uu -uu --	dactylic hexameter	feminine penthemimeral, hepthemimeral, trithemimeral
δείδιθι, μέχρι βορῆος ἀπαστράψαντος ἴδηαι.	-uu -u u-u u---u u--	dactylic hexameter	feminine penthemimeral
εἰ δέ κεν ἑσπερίης μὲν ἁλὸς κενταύρου ἀπείη	- u u -uu- u u- --u u--	dactylic hexameter	masculine penthemimeral, hepthemimeral
ὦμος ὅσον προτέρης, ὀλίγη δέ μιν εἰλύοι ἀχλὺς	-u u- uu- uu- u u -uu --	dactylic hexameter	masculine penthemimeral, hepthemimeral, trithemimeral
αὐτόν, ἀτὰρ μετόπισθεν ἐοικότα σήματα τεύχοι	-u u- uu-u u-uu -uu --	dactylic hexameter	feminine penthemimeral, trithemimeral
νὺξ ἐπὶ παμφανόωντι Θυτηρίῳ, οὔ σε μάλα χρὴ	- uu -uu-u u-uu - u u- -	dactylic hexameter	feminine penthemimeral
ἐς νότον ἀλλ᾽ εὔροιο περισκοπέειν ἀνέμοιο.	- uu - --u u-uu- uu--	dactylic hexameter	feminine penthemimeral, trithemimeral
δήεις δ᾽ἄστρον ἐκεῖνο δύω ὑποκείμενον ἄλλοις·	-- -u u-u u- uu-uu --	dactylic hexameter	feminine penthemimeral, hepthemimeral
τοῦ γάρ τοι τὰ μὲν ἀνδρὶ ἐοικότα νειόθι κεῖται	- - - u u -u u-uu -uu --	dactylic hexameter	feminine penthemimeral, trithemimeral
σκορπίου, ἱππούραια δ᾽ὑπὸ σφίσι Χηλαὶ ἔχουσιν.	-uu ---u u- uu -u u--	dactylic hexameter	feminine penthemimeral, hepthemimeral
αὐτὰρ ὁ δεξιτερὴν αἰεὶ τανύοντι ἔοικεν	-u u -uu- -- uu-u u--	dactylic hexameter	masculine penthemimeral, hepthemimeral
ἀντία δινωτοῖο Θυτηρίου, ἐν δέ οἱ ἀπρὶξ	-uu ---u u-uu - u u --	dactylic hexameter	feminine penthemimeral
ἄλλο μάλ᾽ ἐσφήκωται ἐληλάμενον διὰ χειρὸς	-u u ---u u-uu- uu --	dactylic hexameter	feminine penthemimeral
θηρίον· ὣς γάρ μιν πρότεροι ἐπεφημίξαντο.	-uu - - - uu- uu----	dactylic hexameter	masculine penthemimeral, hepthemimeral, trithemimeral
ἀλλ᾽ ἔτι γάρ τε καὶ ἄλλο περαιόθεν ἕλκεται ἄστρον·	- uu - u u -u u-uu -uu --	dactylic hexameter	feminine penthemimeral, trithemimeral
ὕδρην μιν καλέουσι, τὸ δὲ ζώοντι ἐοικὸς	-- - uu-u u - --u u--	dactylic hexameter	feminine penthemimeral, hepthemimeral, trithemimeral
ἠνεκὲς εἰλεῖται· καί οἱ κεφαλὴ ὑπὸ μέσσον	-uu --- - - uu- uu --	dactylic hexameter	masculine penthemimeral, hepthemimeral
καρκίνον ἱκνεῖται, σπείρη δ᾽ὑπὸ σῶμα Λέοντος,	-uu --- -- uu -u u--	dactylic hexameter	masculine penthemimeral, hepthemimeral
οὐρὴ δὲ κρέμαται ὑπὲρ αὐτοῦ Κενταύροιο.	-- - uu- uu -- ----	dactylic hexameter	masculine penthemimeral, trithemimeral
μέσσῃ δὲ σπείρῃ κρητὴρ, πυμάτῃ δ᾽ἐπίκειται	-- - -- -- uu- uu--	dactylic hexameter	masculine penthemimeral, hepthemimeral, trithemimeral
εἴδωλον κόρακος σπείρην κόπτοντι ἐοικός.	--- uu- -- --u u--	dactylic hexameter	masculine penthemimeral, hepthemimeral, trithemimeral
καὶ μὴν καὶ προκύων Διδύμοις ὕπο καλὰ φαείνει.	- - - uu- uu- uu -u u--	dactylic hexameter	masculine penthemimeral, hepthemimeral, trithemimeral
ταῦτά κε θηήσαιο παρερχομένων ἐνιαυτῶν	-u u ---u u-uu- uu--	dactylic hexameter	feminine penthemimeral
ἑξείης παλίνωρα· τὰ γὰρ καὶ πάντα μάλ᾽ αὕτως	--- uu-u u - - -u u --	dactylic hexameter	feminine penthemimeral, hepthemimeral, trithemimeral
οὐρανῷ εὖ ἐνάρηρεν ἀγάλματα νυκτὸς ἰούσης.	-uu - uu-u u-uu -u u--	dactylic hexameter	feminine penthemimeral, trithemimeral
οἱ δ᾽ἐπιμὶξ ἄλλοι πέντ᾽ ἀστέρες, οὐδὲν ὁμοῖοι,	- uu- -- - -uu -u u--	dactylic hexameter	masculine penthemimeral, trithemimeral
παντόθεν εἰδώλων δυοκαίδεκα δινεύονται.	-uu --- uu-uu ----	dactylic hexameter	masculine penthemimeral
οὐκ ἂν ἔτ᾽ εἰς ἄλλους ὁρόων ἐπιτεκμήραιο	- u u - -- uu- uu----	dactylic hexameter	masculine penthemimeral, hepthemimeral, trithemimeral
κείνους ἧχι κέονται· ἐπεὶ πάντες μετανάσται,	-- -u u-u u- -- uu--	dactylic hexameter	feminine penthemimeral, hepthemimeral
μακροὶ δέ σφεων εἰσὶν ἑλισσομένων ἐνιαυτοί,	-- - - -u u-uu- uu--	dactylic hexameter	feminine penthemimeral, trithemimeral
μακρὰ δὲ σήματα κεῖται ἀπόπροθεν εἰς ἓν ἰόντων.	-u u -uu -u u-uu - u u--	dactylic hexameter	feminine penthemimeral
οὐδ᾽ ἔτι θαρσαλέος κείνων ἐγώ· ἄρκιος εἴην	- uu -uu- -- uu -uu --	dactylic hexameter	masculine penthemimeral, hepthemimeral
ἀπλανέων τά τε κύκλα τά τ᾽αἰθέρι σήματ᾽ ἐνισπεῖν.	-uu- u u -u u -uu -u u--	dactylic hexameter	feminine penthemimeral, trithemimeral
ἦτοι μὲν τά γε κεῖται ἀλίγκια δινωτοῖσιν	-- - u u -u u-uu ----	dactylic hexameter	feminine penthemimeral, trithemimeral
τέσσαρα, τῶν κε μάλιστα πόθη ὄφελός τε γένοιτο	-uu - u u-u u- uu- u u--	dactylic hexameter	feminine penthemimeral, hepthemimeral, trithemimeral
μέτρα περισκοπέοντι κατανομένων ἐνιαυτῶν.	-u u-uu-u u-uu- uu--	dactylic hexameter	feminine penthemimeral
σήματα δ᾽εὖ μάλα πᾶσιν ἐπιρρήδην περίκειται	-uu - uu -u u--- uu--	dactylic hexameter	feminine penthemimeral, trithemimeral
πολλά τε καὶ σχεδόθεν πάντη συνεεργμένα πάντα.	-u u - uu- -- uu-uu --	dactylic hexameter	masculine penthemimeral, hepthemimeral, trithemimeral
αὐτοὶ δ᾽ἀπλανέες καὶ ἀρηρότες ἀλλήλοισιν	-- -uu- u u-uu ----	dactylic hexameter	masculine penthemimeral
πάντες· ἀτὰρ μέτρῳ γε δύω δυσὶν ἀντιφέρονται.	-u u- -- u u- uu -uu--	dactylic hexameter	masculine penthemimeral, hepthemimeral, trithemimeral
εἴ ποτέ τοι νυκτὸς καθαρῆς, ὅτε πάντας ἀγαυοὺς	- uu - -- uu- uu -u u--	dactylic hexameter	masculine penthemimeral, hepthemimeral, trithemimeral
ἀστέρας ἀνθρώποις ἐπιδείκνυται οὐρανίη Νύξ,	-uu --- uu-uu -uu- -	dactylic hexameter	masculine penthemimeral
οὐδέ τις ἀδρανέων φέρεται διχόμηνι σελήνῃ,	-u u -uu- uu- uu-u u--	dactylic hexameter	masculine penthemimeral, hepthemimeral
ἀλλὰ τά γε κνέφαος διαφαίνεται ὀξέα πάντα—	-u u - uu- uu-uu -uu --	dactylic hexameter	masculine penthemimeral, trithemimeral
εἴ ποτέ τοι τημόσδε περὶ φρένας ἵκετο θαῦμα,	- uu - --u u- uu -uu --	dactylic hexameter	feminine penthemimeral, hepthemimeral, trithemimeral
σκεψαμένῳ πάντη κεκεασμένον εὐρέϊ κύκλῳ	-uu- -- uu-uu -uu --	dactylic hexameter	masculine penthemimeral, trithemimeral
οὐρανόν, ἢ καί τίς τοι ἐπιστὰς ἄλλος ἔδειξεν	-uu - - - u u-- -u u--	dactylic hexameter	masculine penthemimeral, trithemimeral
κεῖνο περιγληνὲς τροχαλόν, γάλα μιν καλέουσιν·	-u u--- uu- uu - uu--	dactylic hexameter	masculine penthemimeral, hepthemimeral
τῷ δ᾽ἤτοι χροιὴν μὲν ἀλίγκιος οὐκέτι κύκλος	- -- -- u u-uu -uu --	dactylic hexameter	masculine penthemimeral, trithemimeral
δινεῖται, τὰ δὲ μέτρα τόσοι πισύρων περ ἐόντων	--- u u -u u- uu- u u--	dactylic hexameter	feminine penthemimeral, hepthemimeral, trithemimeral
οἱ δύο, τοὶ δέ σφεων μέγα μείονες εἱλίσσονται.	- uu - - - uu -uu ----	dactylic hexameter	masculine penthemimeral, trithemimeral
τῶν ὁ μὲν ἐγγύθεν ἐστὶ κατερχομένου βορέαο.	- u u -uu -u u-uu- uu--	dactylic hexameter	feminine penthemimeral
ἐν δέ οἱ ἀμφότεραι κεφαλαὶ Διδύμων φορέονται,	- u u -uu- uu- uu- uu--	dactylic hexameter	masculine penthemimeral, hepthemimeral
ἐν δέ τε γούνατα κεῖται ἀρηρότος Ἡνιόχοιο,	- u u -uu -u u-uu -uu--	dactylic hexameter	feminine penthemimeral
λαιὴ δὲ κνήμη καὶ ἀριστερὸς ὦμος ἐπ᾽ αὐτῷ	-- - -- u u-uu -u u --	dactylic hexameter	masculine penthemimeral, trithemimeral
Περσέος, Ἀνδρομέδης δὲ μέσην ἀγκῶνος ὕπερθεν	-uu -uu- u u- --u u--	dactylic hexameter	masculine penthemimeral, hepthemimeral
δεξιτερὴν ἐπέχει· τὸ μέν οἱ θέναρ ὑψόθι κεῖται,	-uu- uu- u u - uu -uu --	dactylic hexameter	masculine penthemimeral, hepthemimeral, trithemimeral
ἀσσότερον βορέαο, νότῳ δ᾽ἐπικέκλιται ἀγκών·	-uu- uu-u u- uu-uu --	dactylic hexameter	feminine penthemimeral, hepthemimeral, trithemimeral
ὁπλαὶ δ᾽Ἵππειοι, καὶ ὑπαύχενον Ὀρνίθειον	-- --- u u-uu ----	dactylic hexameter	masculine penthemimeral
ἄκρῃ σὺν κεφαλῇ, καλοί τ᾽Ὀφιούχεοι ὦμοι,	-- - uu- -- uu-uu --	dactylic hexameter	masculine penthemimeral, hepthemimeral, trithemimeral
αὐτὸν δινεύονται ἐληλάμενοι περὶ κύκλον·	-- ---u u-uu- uu --	dactylic hexameter	feminine penthemimeral
ἡ δ᾽ὀλίγον φέρεται νοτιωτέρη, οὐδ᾽ ἐπιβάλλει,	- uu- uu- uu-uu - uu--	dactylic hexameter	masculine penthemimeral, trithemimeral
παρθένος· ἀλλὰ Λέων καὶ Καρκίνος· οἱ μέν ἄρ᾽ ἄμφω	-uu -u u- - -uu - u u --	dactylic hexameter	masculine penthemimeral
ἑξείης κέαται βεβλημένοι, αὐτὰρ ὁ κύκλος	--- uu- --uu -u u --	dactylic hexameter	masculine penthemimeral, trithemimeral
τὸν μὲν ὑπὸ στῆθος καὶ γαστέρα μέχρι παρ᾽ αἰδῶ	- u u- -- - -uu -u u --	dactylic hexameter	masculine penthemimeral, trithemimeral
τέμνει, τὸν δὲ διηνεκέως ὑπένερθε χελείου	-- - u u-uu- uu-u u--	dactylic hexameter	hepthemimeral, trithemimeral
καρκίνον, ἧχι μάλιστα διχαιόμενόν κε νοήσαις	-uu -u u-u u-uu- u u--	dactylic hexameter	feminine penthemimeral
ὀρθόν, ἵν᾽ ὀφθαλμοὶ κύκλου ἑκάτερθεν ἴοιεν.	-u u --- -- uu-u u--	dactylic hexameter	masculine penthemimeral, hepthemimeral
τοῦ μέν, ὅσον τε μάλιστα, δι᾽ ὀκτὼ μετρηθέντος,	- u u- u u-u u -- ----	dactylic hexameter	feminine penthemimeral, trithemimeral
πέντε μὲν ἔνδια στρέφεται καθ᾽ ὑκέρτερα γαίης,	-u u --- uu- u u-uu --	dactylic hexameter	masculine penthemimeral, hepthemimeral
τὰ τρία δ᾽ἐν περάτῃ· θέρεος δέ οἱ ἐν τροπαί εἰσιν.	- uu - uu- uu- u u - uu --	dactylic hexameter	masculine penthemimeral, hepthemimeral, trithemimeral
ἀλλ᾽ ὁ μὲν ἐν βορἐω περὶ Καρκίνον ἐστήρικται.	- u u - uu- uu -uu ----	dactylic hexameter	masculine penthemimeral, trithemimeral
ἄλλος δ᾽ἀντιόωντι νότῳ μέσον Αἰγοκερῆα	-- -uu-u u- uu -uu--	dactylic hexameter	feminine penthemimeral, hepthemimeral
τέμνει καὶ πόδας Ὑδροχόου καὶ Κήτεος οὐρήν·	-- - uu -uu- - -uu --	dactylic hexameter	hepthemimeral, trithemimeral
ἐν δέ οἵ ἐστι Λαγωός· ἀτὰρ Κυνὸς οὐ μάλα πολλὴν	- u u -u u-u u- uu - uu --	dactylic hexameter	feminine penthemimeral, hepthemimeral
αἴνυται, ἀλλ᾽ ὁπόσην ἐπέχει ποσίν· ἐν δέ οἰ Ἀργώ,	-uu - uu- uu- uu - u u --	dactylic hexameter	masculine penthemimeral, hepthemimeral, trithemimeral
καὶ μέγα Κενταύροιο μετάφρενον, ἐν δέ τε κέντρον	- uu ---u u-uu - u u --	dactylic hexameter	feminine penthemimeral
σκορπίου, ἐν καὶ Τόξον ἀγαυοῦ Τοξευτῆρος.	-uu - - -u u-- ----	dactylic hexameter	feminine penthemimeral, trithemimeral
τὸν πύματον καθαροῖο παρερχόμενος βορέαο	- uu- uu-u u-uu- uu--	dactylic hexameter	feminine penthemimeral, trithemimeral
ἐς νότον ἠέλιος φέρεται· τρέπεταί γε μὲν αὐτοῦ	- uu -uu- uu- uu- u u --	dactylic hexameter	masculine penthemimeral, hepthemimeral
χειμέριος. καί οἱ τρία μὲν περιτέλλεται ὑψοῦ	-uu- - - uu - uu-uu --	dactylic hexameter	masculine penthemimeral, hepthemimeral, trithemimeral
τῶν ὀκτώ, τὰ δὲ πέντε κατώρυχα δινεύονται.	- -- u u -u u-uu ----	dactylic hexameter	feminine penthemimeral, trithemimeral
μεσσόθι δ᾽ἀμφοτέρων, ὅσσος πολιοῖο Γάλακτος,	-uu -uu- -- uu-u u--	dactylic hexameter	masculine penthemimeral, hepthemimeral
γαῖαν ὑποστρέφεται κύκλος διχόωντι ἐοικώς·	-u u-uu- -- uu-u u--	dactylic hexameter	masculine penthemimeral, hepthemimeral
ἐν δέ οἱ ἤματα νυξὶν ἰσαίεται ἀμφοτέρῃσιν,	- u u -uu -u u-uu -uu--	dactylic hexameter	feminine penthemimeral
φθίνοντος θέρεος, τοτὲ δ᾽εἴαρος ἱσταμένοιο.	--- uu- uu -uu -uu--	dactylic hexameter	masculine penthemimeral, trithemimeral
σῆμα δέ οἱ Κριὸς Ταύροιό τε γούνατα κεῖται,	-u u - -- --u u -uu --	dactylic hexameter	masculine penthemimeral, trithemimeral
κριὸς μὲν κατὰ μῆκος ἐληλάμενος διὰ κύκλου,	-- - uu -u u-uu- uu --	dactylic hexameter	feminine penthemimeral, trithemimeral
Ταύρου δὲ σκελέων ὅσση περιφαίνεται ὀκλάξ.	-- - uu- -- uu-uu --	dactylic hexameter	masculine penthemimeral, hepthemimeral, trithemimeral
ἐν δέ τέ οἱ ζώνη εὐφεγγέος Ὠρίωνος	- u u - -- --uu ----	dactylic hexameter	masculine penthemimeral, trithemimeral
καμπή τ᾽αἰθομένης Ὕδρης· ἐνί οἱ καὶ ἐλαφρὸς	-- -uu- -- uu - u u--	dactylic hexameter	masculine penthemimeral, hepthemimeral
κρητήρ, ἐν δὲ Κόραξ, ἐνὶ δ᾽ἀστέρες οὐ μάλα πολλοὶ	-- - u u- uu -uu - uu --	dactylic hexameter	masculine penthemimeral, trithemimeral
Χηλάων· ἐν τῷ δ᾽Ὀφιούχεα γοῦνα φορεῖται.	--- - - uu-uu -u u--	dactylic hexameter	masculine penthemimeral, trithemimeral
οὐ μὴν Αἰητοῦ ἀπαμείρεται, ἀλλά οἱ ἐγγὺς	- - --- uu-uu -u u --	dactylic hexameter	masculine penthemimeral
Ζηνὸς ἀητεῖται μέγας ἄγγελος. ἡ δὲ κατ᾽ αὐτὸν	-u u--- uu -uu - u u --	dactylic hexameter	masculine penthemimeral
ἱππείη κεφαλὴ καὶ ὑπαύχενον εἱλίσσονται.	--- uu- u u-uu ----	dactylic hexameter	masculine penthemimeral, trithemimeral
τοὺς μὲν παρβολάδην ὀρθοὺς περιβάλλεται ἄξων	- - -uu- -- uu-uu --	dactylic hexameter	masculine penthemimeral, hepthemimeral
μεσσόθι πάντας ἔχων· ὁ δὲ τέτρατος ἐσφήκωται	-uu -u u- u u -uu ----	dactylic hexameter	masculine penthemimeral
λοξὸς ἐν ἀμφοτέροις, οἵ μίν ῥ᾽ἑκάτερθεν ἔχουσιν	-u u -uu- - - uu-u u--	dactylic hexameter	masculine penthemimeral, hepthemimeral
ἀντιπέρην τροπικοί, μέσσος δέ ἑ μεσσόθι τέμνει.	-uu- uu- -- u u -uu --	dactylic hexameter	masculine penthemimeral, hepthemimeral, trithemimeral
οὔ κεν Ἀθηναίης χειρῶν δεδιδαγμένος ἀνὴρ	- u u--- -- uu-uu --	dactylic hexameter	masculine penthemimeral, hepthemimeral
ἄλλῃ κολλήσαιτο κυλινδόμενα τροχάλεια	-- ---u u-uu- uu--	dactylic hexameter	feminine penthemimeral
τοῖα τε καὶ τόσα πάντα περισφαιρηδὸν ἑλίσσων,	-u u - uu -u u---u u--	dactylic hexameter	feminine penthemimeral, trithemimeral
ὡς τά γ᾽ἐναιθέρια πλαγίῳ συναρηρότα κύκλῳ	- u u-uu- uu- uu-uu --	dactylic hexameter	masculine penthemimeral, hepthemimeral
ἐξ ἠοῦς ἐπὶ νύκτα διώκεται ἤματα πάντα.	- -- uu -u u-uu -uu --	dactylic hexameter	feminine penthemimeral, trithemimeral
καὶ τὰ μὲν ἀντέλλει καὶ αὐτίκα νειόθι δύνει	- u u --- - -uu -uu --	dactylic hexameter	masculine penthemimeral
πάντα παραβλήδην· μία δέ σφεων ἐστὶν ἑκάστου	-u u--- uu - - -u u--	dactylic hexameter	masculine penthemimeral, hepthemimeral
ἑξείης ἑκάτερθε κατηλυσίη τ᾽ἄνοδός τε.	--- uu-u u-uu- uu- -	dactylic hexameter	feminine penthemimeral, trithemimeral
αὐτὰρ ὅ γ᾽ὠκεανοῦ τόσσον παραμείβεται ὕδωρ,	-u u -uu- -- uu-uu --	dactylic hexameter	masculine penthemimeral, hepthemimeral
ὅσσον ἀπ᾽ Αἰγοκερῆος ἀνερχομένοιο μάλιστα	-u u -uu-u u-uu-u u--	dactylic hexameter	feminine penthemimeral
καρκίνον εἰς ἀνιόντα κυλίνδεται· ὅσσον ἁπάντη	-uu - uu-u u-uu -u u--	dactylic hexameter	feminine penthemimeral, trithemimeral
ἀντέλλων ἐπέχει, τόσσον γε μὲν ἀλλόθι δύνων.	--- uu- -- u u -uu --	dactylic hexameter	masculine penthemimeral, hepthemimeral, trithemimeral
ὅσσον δ᾽ὀφθαλμοῖο βολῆς ἀποτέμνεται αὐγή.	-- ---u u- uu-uu --	dactylic hexameter	feminine penthemimeral, hepthemimeral
ἑξάκις ἂν τόσση μιν ὑποδράμοι. αὐτὰρ ἑκάστη	-uu - -- u u-uu -u u--	dactylic hexameter	masculine penthemimeral, trithemimeral
ἴση μετρηθεῖσα δύω περιτέμνεται ἄστρα.	-- ---u u- uu-uu --	dactylic hexameter	feminine penthemimeral, hepthemimeral
Ζωΐδιον δέ ἑ κύκλον ἐπίκλησιν καλέουσιν.	-uu- u u -u u--- uu--	dactylic hexameter	feminine penthemimeral, trithemimeral
τῷ ἔνι Καρκίνος ἐστί, Λέων δ᾽ἐπὶ τῷ, καὶ ὑπ᾽ αὐτὸν	- uu -uu -u u- uu - u u --	dactylic hexameter	feminine penthemimeral, hepthemimeral
παρθένος· αἱ δ᾽ἐπί οἱ Χηλαὶ καὶ Σκορπίος αὐτός,	-uu - uu - -- - -uu --	dactylic hexameter	masculine penthemimeral, hepthemimeral, trithemimeral
Τοξευτής τε καὶ Αἰγόκερως, ἐπὶ δ᾽Αἰγοκερῆϊ	--- u u -uu- uu -uu--	dactylic hexameter	hepthemimeral, trithemimeral
Ὑδροχόος· δύο δ᾽αὐτὸν ὕπ᾽ Ἰχθύες ἀστερόωνται·	-uu- uu -u u -uu -uu--	dactylic hexameter	feminine penthemimeral, trithemimeral
τοὺς δὲ μέτα Κριός, Ταῦρός δ᾽ἐπὶ τῷ Δίδυμοί τε.	- u u- -- -- uu - uu- -	dactylic hexameter	masculine penthemimeral, hepthemimeral, trithemimeral
ἐν τοῖς ἠέλιος φέρεται δυοκαίδεκα πᾶσιν	- - -uu- uu- uu-uu --	dactylic hexameter	masculine penthemimeral, hepthemimeral
πάντ᾽ ἐνιαυτὸν ἄγων, καί οἱ περὶ τοῦτον ἰόντι	- uu-u u- - - uu -u u--	dactylic hexameter	masculine penthemimeral, hepthemimeral
κύκλον ἀέξονται πᾶσαι ἐπικάρπιοι ὧραι.	-u u--- -- uu-uu --	dactylic hexameter	masculine penthemimeral, hepthemimeral
τοῦ δ᾽ὅσσον κοίλοιο κατ᾽ ὠκεανοῖο δύηται,	- -- --u u -uu-u u--	dactylic hexameter	feminine penthemimeral, trithemimeral
τόσσον ὑπὲρ γαίης φέρεται· πάσῃ δ᾽ἐπὶ νυκτὶ	-u u- -- uu- -- uu --	dactylic hexameter	masculine penthemimeral, hepthemimeral, trithemimeral
ἓξ αἰεὶ δύνουσι δυωδεκάδες κύκλοιο,	- -- --u u-uu- ---	dactylic hexameter	feminine penthemimeral, trithemimeral
τόσσαι δ᾽ἀντέλλουσι. τόσον δ᾽ἐτί μῆκος ἑκάστη	-- ---u u- uu -u u--	dactylic hexameter	feminine penthemimeral, hepthemimeral
νὺξ αἰεὶ τετάνυσται, ὅσον τέ περ ἥμισυ κύκλου	- -- uu-u u- u u -uu --	dactylic hexameter	feminine penthemimeral, hepthemimeral, trithemimeral
ἀρχομένης ἀπὸ νυκτὸς ἀείρεται ὑψόθι γαίης.	-uu- uu -u u-uu -uu --	dactylic hexameter	feminine penthemimeral, trithemimeral
οὔ κεν ἀπόβλητον δεδοκημένῳ ἤματος εἴη	- u u--- uu-uu -uu --	dactylic hexameter	masculine penthemimeral
μοιράων σκέπτεσθαι ὅτ᾽ ἀντέλλῃσιν ἑκάστη·	--- --u u ---u u--	dactylic hexameter	feminine penthemimeral, trithemimeral
αἰεὶ γὰρ τάων γε μιῇ συνανέρχεται αὐτὸς	-- - -- u u- uu-uu --	dactylic hexameter	masculine penthemimeral, hepthemimeral, trithemimeral
ἠέλιος. τὰς δ᾽ἄν κε περισκέψαιο μάλιστα	-uu- - - u u---u u--	dactylic hexameter	masculine penthemimeral, trithemimeral
εἰς αὐτὰς ὁρόων· ἀτὰρ εἰ νεφέεσσι μέλαιναι	- -- uu- uu - uu-u u--	dactylic hexameter	masculine penthemimeral, hepthemimeral, trithemimeral
γίνοιντ᾽ ἢ ὄρεος κεκρυμμέναι ἀντέλλοιεν,	-- - uu- --uu ----	dactylic hexameter	masculine penthemimeral, trithemimeral
σήματ᾽ ἐπερχομένῃσιν ἀρηρότα ποιήσασθαι.	-u u-uu-u u-uu ----	dactylic hexameter	feminine penthemimeral
αὐτὸς δ᾽ἂν μάλα τοι κεράων ἑκάτερθε διδοίη	-- - uu - uu- uu-u u--	dactylic hexameter	masculine penthemimeral, hepthemimeral, trithemimeral
Ὠκεανός, τά τε πολλὰ περιστρέφεται ἑοῖ αὐτῷ,	-uu- u u -u u-uu- uu --	dactylic hexameter	feminine penthemimeral, trithemimeral
νειόθεν ὁππῆμος κείνων φορέῃσιν ἑκάστην.	-uu --- -- uu-u u--	dactylic hexameter	masculine penthemimeral, hepthemimeral
οὔ οἱ ἀφαυρότατοι, ὅτε κάρκινος ἀντέλλῃσιν,	- u u-uu- uu -uu ----	dactylic hexameter	masculine penthemimeral
ἀστέρες ἀμφοτέρωθεν ἑλισσόμενοι περίκεινται,	-uu -uu-u u-uu- uu--	dactylic hexameter	feminine penthemimeral
τοὶ μὲν δύνοντες, τοὶ δ᾽ἐξ ἑτέρης ἀνιόντες.	- - --- - - uu- uu--	dactylic hexameter	masculine penthemimeral, hepthemimeral
σύνει μὲν Στέφανος, δύνει δὲ κατὰ ῥάχιν Ἰχθύς.	-- - uu- -- u u- uu --	dactylic hexameter	masculine penthemimeral, hepthemimeral, trithemimeral
ἥμισυ μέν κεν ἴδοιο μετήορον, ἥμισυ δ᾽ἤδη	-uu - u u-u u-uu -uu --	dactylic hexameter	feminine penthemimeral, trithemimeral
ἐσχατιαὶ βάλλουσι κατερχομένου Στεφάνοιο.	-uu- --u u-uu- uu--	dactylic hexameter	feminine penthemimeral, trithemimeral
αὐτὰρ ὅ γ᾽ἐξόπιθεν τετραμμένος ἄλλα μὲν οὔπω	-u u -uu- --uu -u u --	dactylic hexameter	masculine penthemimeral
γαστέρι νειαίρῃ, τὰ δ᾽ὑπέρτερα νυκτὶ φορεῖται.	-uu --- u u-uu -u u--	dactylic hexameter	masculine penthemimeral
τὸν δὲ καὶ εἰς ὤμους κατάγει μογερὸν Ὀφιοῦχον	- u u - -- uu- uu- uu--	dactylic hexameter	masculine penthemimeral, hepthemimeral, trithemimeral
Καρκίνος ἐκ γονάτων, κατάγει δ᾽Ὄφιν αὐχένος ἐγγύς.	-uu - uu- uu- uu -uu --	dactylic hexameter	masculine penthemimeral, hepthemimeral, trithemimeral
οὐδ᾽ ἄν ἔτ᾽ Ἀρκτοφύλαξ εἴη πολὺς ἀμφοτέρωθεν,	- u u -uu- -- uu -uu--	dactylic hexameter	masculine penthemimeral, hepthemimeral
μείων ἠμάτιος, τὸ δ᾽ἐπὶ πλέον ἔννυχος ἤδη.	-- -uu- u u- uu -uu --	dactylic hexameter	masculine penthemimeral, hepthemimeral
τέτρασι γὰρ μοίραις ἄμυδις κατιόντα Βοώτην	-uu - -- uu- uu-u u--	dactylic hexameter	masculine penthemimeral, hepthemimeral, trithemimeral
Ὠκεανὸς δέχεται· ὁ δ᾽ἐπὴν φάεος κορέσηται,	-uu- uu- u u- uu- uu--	dactylic hexameter	masculine penthemimeral, hepthemimeral, trithemimeral
βουλυτῷ ἐπέχει πλεῖον δίχα νυκτὸς ἰούσης,	--- uu- -- uu -u u--	dactylic hexameter	masculine penthemimeral, hepthemimeral, trithemimeral
ἦμος ὅτ᾽ ἠελίοιο κατερχομένοιο δύηται.	-u u -uu-u u-uu-u u--	dactylic hexameter	feminine penthemimeral
κεῖναί οἱ καὶ νύκτες ἐπ᾽ ὀψὲ δύοντι λέγονται.	-- - - -u u -u u-u u--	dactylic hexameter	feminine penthemimeral, trithemimeral
ὣς οἱ μὲν δύνουσιν, ὁ δ᾽ἀντίος, οὐδὲν ἀεικής,	- - - --u u -uu -u u--	dactylic hexameter	feminine penthemimeral, trithemimeral
ἀλλ᾽ εὖ μὲν ζώνῃ, εὖ δ᾽ἀμφοτέροισι φαεινὸς	- - - -- - -uu-u u--	dactylic hexameter	masculine penthemimeral, trithemimeral
ὤμοις Ὠρίων, ξίφεός γε μὲν ἶφι πεποιθώς,	-- --- uu- u u -u u--	dactylic hexameter	masculine penthemimeral, hepthemimeral
πάντα φέρων Ποταμόν, κέραος παρατείνεται ἄλλου.	-u u- uu- uu- uu-uu --	dactylic hexameter	masculine penthemimeral, hepthemimeral, trithemimeral
ἐρχομένῳ δὲ Λέοντι τὰ μὲν κατὰ πάντα φέρονται	-uu- u u-u u - uu -u u--	dactylic hexameter	feminine penthemimeral, hepthemimeral, trithemimeral
καρκίνῳ ὅσσ᾽ ἐδύοντο, καὶ Αἰετός. αὐτὰρ ὅ γε Γνὺξ	-uu - uu-u u -uu -u u - -	dactylic hexameter	feminine penthemimeral, trithemimeral
ἥμενος ἄλλα μὲν ἤδη, ἀτὰρ γόνυ καὶ πόσα λαιὸν	-uu -u u -u u- uu - uu --	dactylic hexameter	feminine penthemimeral, hepthemimeral
οὔπω κυμαίνοντος ὑποστρέφει ὠκεανοῖο.	-- ---u u-uu -uu--	dactylic hexameter	feminine penthemimeral
ἀντέλλει δ᾽Ὕδρης κεφαλὴ χαροπός τε Λαγωὸς	--- -- uu- uu- u u--	dactylic hexameter	masculine penthemimeral, hepthemimeral, trithemimeral
καὶ Προκύων πρότεροί τε πόδες Κυνὸς αἰθομένοιο.	- uu- uu- u u- uu -uu--	dactylic hexameter	masculine penthemimeral, hepthemimeral, trithemimeral
οὐ μέν θην ὀλίγους γαίης ὑπὸ νείατα βάλλει	- - - uu- -- uu -uu --	dactylic hexameter	masculine penthemimeral, hepthemimeral, trithemimeral
παρθένος ἀντέλλουσα. Λύρη τότε Κυλληναίη	-uu ---u u- uu ----	dactylic hexameter	feminine penthemimeral, hepthemimeral
καὶ Δελφὶς δύνουσι καὶ εὐποίητος Ὀϊστός·	- -- --u u ---u u--	dactylic hexameter	feminine penthemimeral, trithemimeral
σὺν τοῖς Ὄρνιθος πρώτα πτερὰ μέσφα παρ᾽ αὐτὴν	- - --- -- uu -u u --	dactylic hexameter	masculine penthemimeral, hepthemimeral
οὐρὴν καὶ Ποταμοῖο παρηορίαι σκιόωνται·	-- - uu-u u-uu- uu--	dactylic hexameter	feminine penthemimeral, trithemimeral
δύνει δ᾽Ἱππείη κεφαλή, δύνει δὲ καὶ αὐχήν.	-- --- uu- -- u u --	dactylic hexameter	masculine penthemimeral, hepthemimeral
ἀντέλλει δ᾽Ὕδρη μὲν ἐπὶ πλέον ἄχρι παρ᾽ αὐτὸν	--- -- u u- uu -u u --	dactylic hexameter	masculine penthemimeral, hepthemimeral, trithemimeral
κρητῆρα, φθάμενος δὲ Κύων πόδας αἴνυται ἄλλους,	--- uu- u u- uu -uu --	dactylic hexameter	masculine penthemimeral, hepthemimeral, trithemimeral
ἕλκων ἐξόπιθεν πρύμνην πολυτειρέος Ἀργοῦς.	-- -uu- -- uu-uu --	dactylic hexameter	masculine penthemimeral, hepthemimeral
ἡ δὲ θέει γαίης ἱστὸν διχόωσα κατ᾽ αὐτόν,	- u u- -- -- uu-u u --	dactylic hexameter	masculine penthemimeral, hepthemimeral, trithemimeral
παρθένος ἦμος ἅπασα περαιόθεν ἄρτι γένηται.	-uu -u u-u u-uu -u u--	dactylic hexameter	feminine penthemimeral
Οὐδ᾽ ἄν ἐπερχόμεναι χηλαὶ, καὶ λεπτὰ φάουσαι,	- u u-uu- -- - -u u--	dactylic hexameter	masculine penthemimeral, hepthemimeral
ἄφραστοι παρίοιεν, ἐπεὶ μέγα σῆμα Βοώτης	--- uu-u u- uu -u u--	dactylic hexameter	feminine penthemimeral, hepthemimeral, trithemimeral
ἀθρόος ἀντέλλει βεβολημένος Ἀρκτούροιο.	-uu --- uu-uu ----	dactylic hexameter	masculine penthemimeral
Ἀργὼ δ᾽εὖ μάλα πᾶσα μετήορος ἔσσεται ἤδη·	-- - uu -u u-uu -uu --	dactylic hexameter	feminine penthemimeral, trithemimeral
ἀλλ᾽ Ὕδρη, κέχυται γὰρ ἐν οὐρανῷ ἤλιθα πολλή,	- -- uu- u u -uu -uu --	dactylic hexameter	masculine penthemimeral, trithemimeral
οὐρῆς ἂν δεύοιτο. μόνην δ᾽ἐπὶ Χηλαὶ ἄγουσιν	-- - --u u- uu -u u--	dactylic hexameter	feminine penthemimeral, hepthemimeral, trithemimeral
δεινὸν ἐφεστηῶτ᾽ Ὀφιουχέα· τοῦ ἔπειτα	-u u--- uu-uu - ---	dactylic hexameter	masculine penthemimeral
δεξιτερὴν κνήμην αὐτῆς ἐπιγουνίδος ἄχρις	-uu- -- -- uu-uu --	dactylic hexameter	masculine penthemimeral, hepthemimeral, trithemimeral
αἰεὶ Γνύξ, αἰεὶ δὲ Λύρῃ παραπεπτηῶτος,	-- - -- u u- uu----	dactylic hexameter	masculine penthemimeral, hepthemimeral, trithemimeral
ὅντινα τοῦτον ἄϊστον ὑπουρανίων εἰδώλων	-uu -u u-u u-uu- ---	dactylic hexameter	feminine penthemimeral
ἀμφότερον δύνοντα καὶ ἐξ ἑτέρης ἀνιόντα	-uu- --u u - uu- uu--	dactylic hexameter	feminine penthemimeral, hepthemimeral, trithemimeral
πολλάκις αὐτονυχεὶ θηεύμεθα. τοῦ μὲν ἄρ᾽ οἴη	-uu -uu- --uu - u u --	dactylic hexameter	masculine penthemimeral
κνήμη σὺν Χηλῇσι φαείνεται ἀμφοτέρῃσιν·	-- - --u u-uu -uu--	dactylic hexameter	feminine penthemimeral, trithemimeral
αὐτὸς δ᾽ἐς κεφαλὴν ἔτι που τετραμμένος ἄλλῃ	-- - uu- uu - --uu --	dactylic hexameter	masculine penthemimeral, hepthemimeral, trithemimeral
σκορπίον ἀντέλλοντα μένει καὶ ῥύτορα Τόξου·	-uu ---u u- - -uu --	dactylic hexameter	feminine penthemimeral, hepthemimeral
οἱ γάρ μιν φορέουσιν, ὁ μὲν μέσον ἄλλα τε πάντα,	- - - uu-u u - uu -u u --	dactylic hexameter	feminine penthemimeral, hepthemimeral, trithemimeral
χεῖρα δέ οἱ σκαιἠν κεφαλήν θ᾽ἅμα Τόξον ἀγινεῖ.	-u u - -- uu- uu -u u--	dactylic hexameter	masculine penthemimeral, hepthemimeral, trithemimeral
ἀλλ᾽ ὁ μὲν ὣς τρίχα πάντα καταμελεϊστὶ φορεῖται	- u u - uu -u u-uu-u u--	dactylic hexameter	feminine penthemimeral, trithemimeral
ἥμισυ δὲ Στεφάνοιο καὶ αὐτὴν ἔσχατον οὐρὴν	-uu - uu-u u -- -uu --	dactylic hexameter	feminine penthemimeral, trithemimeral
Κενταύρου φορέουσιν ἀνερχόμεναι ἔτι Χηλαί.	--- uu-u u-uu- uu --	dactylic hexameter	feminine penthemimeral, trithemimeral
τῆμος ἀποιχομένην κεφαλὴν μέτα δύεται Ἵππος,	-u u-uu- uu- uu -uu --	dactylic hexameter	masculine penthemimeral, hepthemimeral
καὶ προτέρου Ὄρνιθος ἐφέλκεται ἔσχατος οὐρὴ.	- uu- --u u-uu -uu --	dactylic hexameter	feminine penthemimeral, trithemimeral
δύνει δ᾽Ἀνδρομέδης κεφαλή· τὸ δέ οἱ μέγα δεῖμα	-- -uu- uu- u u - uu --	dactylic hexameter	masculine penthemimeral, hepthemimeral
κήτεος ἠερόεις ἐπάγει νότος· ἀντία δ᾽αὐτὸς	-uu -uu- uu- uu -uu --	dactylic hexameter	masculine penthemimeral, hepthemimeral
Κηφεὺς ἐκ βορέω μεγάλῃ ἀνὰ χειρὶ κελεύει.	-- - uu- uu- uu -u u--	dactylic hexameter	masculine penthemimeral, hepthemimeral, trithemimeral
καὶ τὸ μὲν ἐς λοφιὴν τετραμμένον ἄχρι παρ᾽ αὐτὴν	- u u - uu- --uu -u u --	dactylic hexameter	masculine penthemimeral, trithemimeral
δύνει, ἀτὰρ Κηφεὺς κεφαλῇ καὶ χειρὶ καὶ ὤμῳ.	-u u- -- uu- - -u u --	dactylic hexameter	masculine penthemimeral, hepthemimeral, trithemimeral
Καμπαὶ δ᾽ἄν Ποταμοῖο καὶ αὐτίκ᾽ ἐπερχομένοιο	-- - uu-u u -u u-uu--	dactylic hexameter	feminine penthemimeral, trithemimeral
σκορπίου ἐμπίπτοιεν ἐϋρρόου ὠκεανοῖο·	-uu ---u u-uu -uu--	dactylic hexameter	feminine penthemimeral
ὃς καὶ ἐπερχόμενος φοβέει μέγαν Ὠρίωνα.	- u u-uu- uu- uu ----	dactylic hexameter	masculine penthemimeral, hepthemimeral
Ἄρτεμις ἱλήκοι· προτέρων λόγος, οἵ μιν ἔφαντο	-uu --- uu- uu - u u--	dactylic hexameter	masculine penthemimeral, hepthemimeral
ἑλκῆσαι πέπλοιο, Χίῳ ὅτε θηρία πάντα	--- --u u- uu -uu --	dactylic hexameter	feminine penthemimeral, hepthemimeral, trithemimeral
καρτερὸς Ὠρίων στιβαρῇ ἐπέκοπτε κορύνῃ,	-uu --- uu- uu-u u--	dactylic hexameter	masculine penthemimeral, hepthemimeral
θήρης ἀρνύμενος κείνῳ χάριν Οἰνοπίωνι.	-- -uu- -- uu -uu--	dactylic hexameter	masculine penthemimeral, hepthemimeral
ἡ δέ οἱ ἐξαυτῆς ἐπετείλατο θηρίον ἄλλο,	- u u --- uu-uu -uu --	dactylic hexameter	masculine penthemimeral
νήσου ἀναρρήξασα μέσας ἑκάτερθε κολώνας,	-u u---u u- uu-u u--	dactylic hexameter	feminine penthemimeral, hepthemimeral
σκορπίον, ὅς ῥά μιν οὖτα καὶ ἔκτανε πολλὸν ἐόντα	-uu - u u -u u -uu -u u--	dactylic hexameter	feminine penthemimeral, trithemimeral
πλειότερος προφανείς, ἐπεὶ Ἄρτεμιν ἤκαχεν αὐτήν.	-uu- uu- uu -uu -uu --	dactylic hexameter	masculine penthemimeral, trithemimeral
τούνεκα δὴ καί φασι περαιόθεν ἐρχομένοιο	-uu - - -u u-uu -uu--	dactylic hexameter	feminine penthemimeral, trithemimeral
σκορπίου Ὠρίωνα περὶ χθονὸς ἔσχατα φεύγειν.	-uu ---u u- uu -uu --	dactylic hexameter	feminine penthemimeral, hepthemimeral
οὐδὲ μέν, Ἀνδρομέδης καὶ Κήτεος ὅσσ᾽ ἐλέλειπτο,	-u u -uu- - -uu - uu--	dactylic hexameter	masculine penthemimeral
κείνου ἔτ᾽ ἀντέλλοντος ἀπευθέες, ἀλλ᾽ ἄρα καὶ τοὶ	-u u ---u u-uu - uu - -	dactylic hexameter	feminine penthemimeral
πανσυδίῃ φεύγουσιν. ὁ δὲ ζώνῃ τότε Κηφεὺς	-uu- --u u - -- uu --	dactylic hexameter	feminine penthemimeral, hepthemimeral, trithemimeral
γαῖαν ἐπιξύει, τὰ μὲν ἐς κεφαλὴν μάλα πάντα	-u u--- u u - uu- uu --	dactylic hexameter	masculine penthemimeral, hepthemimeral
βάπτων ὠκεανοῖο, τὰ δ᾽οὐ θέμις, ἀλλὰ τά γ᾽αὐταὶ	-- -uu-u u - uu -u u --	dactylic hexameter	feminine penthemimeral, hepthemimeral
ἄρκτοι κωλύουσι, πόδας καὶ γοῦνα καὶ ἰξύν.	-- ---u u- - -u u --	dactylic hexameter	feminine penthemimeral, hepthemimeral
ἡ δὲ καὶ αὐτὴ παιδὸς ἐπείγεται εἰδώλοιο	- u u -- -u u-uu ----	dactylic hexameter	feminine penthemimeral
δειλὴ Κασσιέπεια. τὰ δ᾽οὐκέτι οἱ κατὰ κόσμον	-- -uu-u u -uu - uu --	dactylic hexameter	feminine penthemimeral
φαίνεται ἐκ δίφροιο, πόδες καὶ γούναθ᾽ ὕπερθεν,	-uu - --u u- - -u u--	dactylic hexameter	feminine penthemimeral, hepthemimeral, trithemimeral
ἀλλ᾽ ἥ γ᾽ἐς κεφαλὴν ἴση δύετ᾽ ἀρνευτῆρι	- - - uu- -- uu ----	dactylic hexameter	masculine penthemimeral, hepthemimeral, trithemimeral
μειρομένη γονάτων, ἐπεὶ οὐκ ἄρ᾽ ἔμελλεν ἐκείνη	-uu- uu- uu - u u-u u--	dactylic hexameter	masculine penthemimeral, hepthemimeral, trithemimeral
Δωρίδι καὶ Πανόπῃ μεγάλων ἄτερ ἰσώσασθαι.	-uu - uu- uu- uu ----	dactylic hexameter	masculine penthemimeral, hepthemimeral, trithemimeral
ἡ μὲν ἄρ᾽ εἰς ἑτέρην φέρεται· τὰ δὲ νειόθεν ἄλλα	- u u - uu- uu- u u -uu --	dactylic hexameter	masculine penthemimeral, hepthemimeral, trithemimeral
οὐρανὸς ἀντιφέρει, Στεφάνοιό τε δεύτερα κύκλα	-uu -uu- uu-u u -uu --	dactylic hexameter	masculine penthemimeral
ὕδρης τ᾽ἐσχατιήν, φορέει τ᾽ἔπι Κενταύροιο	-- -uu- uu- uu ----	dactylic hexameter	masculine penthemimeral, hepthemimeral
δῶμά τε καὶ κεφαλὴν καὶ Θηρίον ὅ ῥ᾽ἐνὶ χειρὶ	-u u - uu- - -uu - uu --	dactylic hexameter	masculine penthemimeral, trithemimeral
δεξιτερῇ Κένταυρος ἔχει. τοὶ δ᾽αὖθι μένουσιν	-uu- --u u- - -u u--	dactylic hexameter	feminine penthemimeral, hepthemimeral, trithemimeral
τόξον ἐπερχόμενον πρότεροι πόδες ἱππότα Φηρός.	-u u-uu- uu- uu -uu --	dactylic hexameter	masculine penthemimeral, hepthemimeral
τόξῳ καὶ σπείρη Ὄφιος καὶ σῶμ᾽ Ὀφιούχου	-- - -- uu- - - uu--	dactylic hexameter	masculine penthemimeral, hepthemimeral, trithemimeral
ἀντέλλει ἐπιόντι· καρήατα δ᾽αὐτὸς ἀγινεῖ	--- uu-u u-uu -u u--	dactylic hexameter	feminine penthemimeral, trithemimeral
σκορπίος ἀντέλλων, ἀνάγει δ᾽αὐτὰς Ὀφιούχου	-uu --- uu- -- uu--	dactylic hexameter	masculine penthemimeral, hepthemimeral
χεῖρας καὶ προτέρην Ὄφιος πολυτειρέος ἀγήν.	-- - uu- uu- uu-uu --	dactylic hexameter	masculine penthemimeral, hepthemimeral, trithemimeral
τοῦ γε μὲν Ἐγγόνασιν, περὶ γὰρ τετραμμένος αἰεὶ	- u u -uu- uu - --uu --	dactylic hexameter	masculine penthemimeral, hepthemimeral
ἀντέλλει, τότε μὲν περάτης ἐξέρχεται ἄλλα,	--- uu - uu- --uu --	dactylic hexameter	masculine penthemimeral, hepthemimeral, trithemimeral
γυῖά τε καὶ ζώνη καὶ στήθεα πάντα καὶ ὦμος	-u u - -- - -uu -u u --	dactylic hexameter	masculine penthemimeral, trithemimeral
δεξιτερῇ σὺν χειρί· κάρη δ᾽ἑτέρης μετὰ χειρὸς	-uu- - -u u- uu- uu --	dactylic hexameter	feminine penthemimeral, hepthemimeral, trithemimeral
τόξῳ ἀνέρχονται καὶ Τοξότῃ ἀντέλλοντι.	-u u--- - -uu ----	dactylic hexameter	masculine penthemimeral
δὐν τοῖς Ἑρμαίη τε Λύρη καὶ στήθεος ἄχρις	- - --- u u- - -uu --	dactylic hexameter	masculine penthemimeral, hepthemimeral
Κηφεὺς ἠῴου παρελαύνεται ὠκεανοῖο,	-- --- uu-uu -uu--	dactylic hexameter	masculine penthemimeral
ἦμος καὶ μεγάλοιο Κυνὸς πᾶσαι ἀμαρυγαὶ	-- - uu-u u- -- uu--	dactylic hexameter	feminine penthemimeral, hepthemimeral, trithemimeral
δύνουσιν, καὶ πάντα κατέρχεται Ὠρίωνος,	--- - -u u-uu ----	dactylic hexameter	feminine penthemimeral, trithemimeral
πάντα γε μὴν ἀτέλεστα διωκομένοιο Λαγωοῦ.	-u u - uu-u u-uu-u u--	dactylic hexameter	feminine penthemimeral, trithemimeral
ἀλλ᾽ οὐχ Ἡνιόχῳ Ἔριφοι οὐδ᾽ Ὠλενίη Αἲξ	- - -uu- uu- - -uu- -	dactylic hexameter	masculine penthemimeral, hepthemimeral
εὐθὺς ἀπέρχονται· τὰ δέ οἱ μεγάλην ἀνὰ χεῖρα	-u u--- u u - uu- uu --	dactylic hexameter	masculine penthemimeral, hepthemimeral
λάμπονται, καί οἱ μελέων διακέκριται ἄλλων	--- - - uu- uu-uu --	dactylic hexameter	masculine penthemimeral, hepthemimeral, trithemimeral
κινῆσαι χειμῶνας ὅτ᾽ ἠελίῳ συνίωσιν.	--- --u u -uu- uu--	dactylic hexameter	feminine penthemimeral, trithemimeral
Ἀλλὰ τὰ μὲν, κεφαλήν τε καὶ ἄλλην χεῖρα καὶ ἰξύν,	-u u - uu- u u -- -u u --	dactylic hexameter	masculine penthemimeral, trithemimeral
αἰγόκερως ἀνιὼν κατάγει· τὰ δὲ νείατα πάντα	-uu- uu- uu- u u -uu --	dactylic hexameter	masculine penthemimeral, hepthemimeral, trithemimeral
αὐτῷ Τοξευτῆρι κατέρχεται. οὐδέ τι Περσεὺς	-- ---u u-uu -u u --	dactylic hexameter	feminine penthemimeral
οὐδέ τι ἄκρα κόρυμβα μένει πολυτείρεος Ἀργοῦς·	-u u -u u-u u- uu-uu --	dactylic hexameter	feminine penthemimeral, hepthemimeral
ἀλλ᾽ ἤτοι Περσεὺς μὲν ἄτερ γουνός τε ποδός τε	- -- -- u u- -- u u- -	dactylic hexameter	masculine penthemimeral, hepthemimeral, trithemimeral
δεξιτεροῦ δύεται, πρύμνης δ᾽ὅσον ἐς περιαγήν·	-uu- uu- -- uu - uu--	dactylic hexameter	masculine penthemimeral, hepthemimeral, trithemimeral
αὐτὴ δ᾽Αἰγοκερῆϊ κατέρχεται ἀντέλλοντι,	-- -uu-u u-uu ----	dactylic hexameter	feminine penthemimeral
ἦμος καὶ Προκύων δύεται, τὰ δ᾽ἀνέρχεται· ἄλλα,	-- - uu- uu- u u-uu --	dactylic hexameter	masculine penthemimeral, hepthemimeral, trithemimeral
ὄρνις τ᾽Αἰητός τε τά τε πτερόεντος Ὀϊστοῦ	-- --- u u - uu-u u--	dactylic hexameter	masculine penthemimeral, hepthemimeral
τείρεα καὶ νοτίοιο Θυτηρίου ἱερὸς ἕδρη.	-uu - uu-u u-uu -uu --	dactylic hexameter	feminine penthemimeral, trithemimeral
ἵππος δ᾽Ὑδροχόοιο νέον περιτελλομένοιο	-- -uu-u u- uu-uu--	dactylic hexameter	feminine penthemimeral, hepthemimeral
ποσσί τε καὶ κεφαλῇ ἀνελίσσεται· ἀντία δ᾽Ἵππου	-u u - uu- uu-uu -uu --	dactylic hexameter	masculine penthemimeral, trithemimeral
ἐξ οὐρῆς Κένταυρον ἐφέλκεται ἀστερίη Νύξ.	- -- --u u-uu -uu- -	dactylic hexameter	feminine penthemimeral, trithemimeral
ἀλλ᾽ οὔ οἱ δύναται κεφαλὴν οὐδ᾽ εὐρέας ὤμους	- - - uu- uu- - -uu --	dactylic hexameter	masculine penthemimeral, hepthemimeral, trithemimeral
αὐτῷ σὺν θώρηκι χαδεῖν. ἀλλ᾽ αἴθοπος Ὕδρης	-- - --u u- - -uu --	dactylic hexameter	feminine penthemimeral, hepthemimeral, trithemimeral
αὐχενίην κατάγει σπείρην καὶ πάντα μέτωπα.	-uu- uu- -- - -u u--	dactylic hexameter	masculine penthemimeral, hepthemimeral, trithemimeral
ἡ δὲ καὶ ἐξόπιθεν πολλὴ μένει· ἀλλ᾽ ἄρα καὶ τὴν	- u u -uu- -- uu - uu - -	dactylic hexameter	masculine penthemimeral, hepthemimeral
αὐτῷ Κενταύρῳ, ὁπότ᾽ ἰχθύες ἀντέλλωσιν,	-- --- uu -uu ----	dactylic hexameter	masculine penthemimeral
ἀθρόον ἐμφέρεται. ὁ δ᾽ἐπ᾽ Ἰχθύσιν ἔρχεται Ἰχθὺς	-uu -uu- u u -uu -uu --	dactylic hexameter	masculine penthemimeral
αὐτῷ κυανέῳ ὑποκείμενος Αἰγοκερῆϊ,	-- -uu- uu-uu -uu--	dactylic hexameter	masculine penthemimeral
οὐ μὲν ἄδην, ὀλίγον δὲ δυωδεκάδ᾽ ἀμμένει ἄλλην.	- u u- uu- u u-uu -uu --	dactylic hexameter	masculine penthemimeral, trithemimeral
οὕτω καὶ μογεραὶ χεῖρες καὶ γοῦνα καὶ ὦμοι	-- - uu- -- - -u u --	dactylic hexameter	masculine penthemimeral, hepthemimeral, trithemimeral
Ἀνδρομέδης δίχα πάντα, τὰ μὲν πάρος, ἄλλα δ᾽ὀπίσσω,	-uu- uu -u u - uu -u u--	dactylic hexameter	feminine penthemimeral, hepthemimeral, trithemimeral
τείνεται, ὠκεανοῖο νέον ὁπότε προγένωνται	-uu -uu-u u- uu- uu--	dactylic hexameter	feminine penthemimeral, hepthemimeral
Ἰχθύες ἀμφότεροι. τά μέν οἱ κατὰ δεξιὰ χειρὸς	-uu -uu- u u - uu -uu --	dactylic hexameter	masculine penthemimeral, hepthemimeral
αὐτοὶ ἐφέλκονται, τὰ δ᾽ἀριστερὰ νεόθεν ἕλκει	-u u--- u u-uu -uu --	dactylic hexameter	masculine penthemimeral
κριός ἀνερχόμενος. τοῦ καὶ περιτελλομένοιο	-u u-uu- - - uu-uu--	dactylic hexameter	masculine penthemimeral, hepthemimeral
ἐσπερόθεν κεν ἴδοιο Θυτήριον· αὐτὰρ ἐν ἄλλῃ	-uu- u u-u u-uu -u u --	dactylic hexameter	feminine penthemimeral, trithemimeral
Περσέος ἀντέλλοντος ὅσον κεφαλήν τε καὶ ὤμους.	-uu ---u u- uu- u u --	dactylic hexameter	feminine penthemimeral, hepthemimeral
αὐτὴ δὲ ζώνη καί κ᾽ἀμφήριστα πέλοιτο	-- - -- - ---u u--	dactylic hexameter	masculine penthemimeral, trithemimeral
ἢ Κριῷ λήγοντι φαείνεται ἢ ἐπὶ ταύρῳ	- -- --u u-uu - uu --	dactylic hexameter	feminine penthemimeral, trithemimeral
σὺν τῷ πανσυδίῃ ἀνελίσσεται. οὐδ᾽ ὅ γε Ταύρου	- - -uu- uu-uu - u u --	dactylic hexameter	masculine penthemimeral
λείπεται ἀντέλλοντος, ἐπεὶ μάλα οἱ συναρηρὼς	-uu ---u u- uu - uu--	dactylic hexameter	feminine penthemimeral, hepthemimeral
Ἡνίοχος φέρεται· μοίρῃ γε μὲν οὐκ ἐπὶ ταύτῃ	-uu- uu- -- u u - uu --	dactylic hexameter	masculine penthemimeral, hepthemimeral, trithemimeral
ἀθρόος ἀντέλλει, Δίδυμοι δέ μιν οὖλον ἄγουσιν.	-uu --- uu- u u -u u--	dactylic hexameter	masculine penthemimeral, hepthemimeral
ἀλλ᾽ Ἔριφοι λαιοῦ τε θέναρ ποδὸς Αἰγὶ σὺν αὐτῇ	- uu- -- u u- uu -u u --	dactylic hexameter	masculine penthemimeral, hepthemimeral, trithemimeral
Ταύρῳ συμφορέονται, ὅτε λοφίη τε καὶ οὐρὴ	-- -uu-u u- uu- u u --	dactylic hexameter	feminine penthemimeral, hepthemimeral
κήτεος αἰθερίοιο περαιόθεν ἀντέλλωσιν.	-uu -uu-u u-uu ----	dactylic hexameter	feminine penthemimeral
δύνει δ᾽Ἀρκτοφύλαξ ἤδη πρώτῃ τότε μοίρῃ	-- -uu- -- -- uu --	dactylic hexameter	masculine penthemimeral, hepthemimeral
τάων, αἳ πίσυρές μιν ἄτερ χειρὸς κατάγουσιν	-- - uu- u u- -- uu--	dactylic hexameter	masculine penthemimeral, hepthemimeral, trithemimeral
λαιῆς· ἡ δ᾽αὐτῷ μεγάλῃ ὑποτέλλεται Ἄρκτῳ.	-- - -- uu- uu-uu --	dactylic hexameter	masculine penthemimeral, hepthemimeral, trithemimeral
Ἀμφότεροι δὲ πόδες καταδυομένου Ὀφιούχου,	-uu- u u- uu-uu- uu--	dactylic hexameter	masculine penthemimeral, trithemimeral
μέσφ᾽ αὐτῶν γονάτων, διδύμοις ἔπι σῆμα τετύχθω	- -- uu- uu- uu -u u--	dactylic hexameter	masculine penthemimeral, hepthemimeral, trithemimeral
ἐξ ἑτέρης ἀνιοῦσι. τότ᾽ οὐκέτι Κήτεος οὐδὲν	- uu- uu-u u -uu -uu --	dactylic hexameter	feminine penthemimeral, trithemimeral
ἕλκεται ἀμφοτέρωθεν, ὅλον δέ μιν ὄψεαι ἤδη.	-uu -uu-u u- u u -uu --	dactylic hexameter	feminine penthemimeral, hepthemimeral
ἤδη καὶ Ποταμοῦ πρώτην ἁλὸς ἐξανιοῦσαν	-- - uu- -- uu -uu--	dactylic hexameter	masculine penthemimeral, hepthemimeral, trithemimeral
ἀγὴν ἐν καθαρῷ πελάγει σκέψαιτό κε ναύτης,	-- - uu- uu- --u u --	dactylic hexameter	masculine penthemimeral, hepthemimeral, trithemimeral
αὐτὸν ἐπ᾽ Ὠρίωνα μένων, εἴ οἵ ποθι σῆμα	-u u ---u u- - - uu --	dactylic hexameter	feminine penthemimeral, hepthemimeral
ἢ νυκτὸς μέτρων ἠὲ πλόου ἀγγείλειεν.	- -- -- -- uu ----	dactylic hexameter	masculine penthemimeral, hepthemimeral, trithemimeral
πάντη γὰρ τά γε πολλὰ θεοὶ ἄνδρεσσι λέγουσιν.	-- - u u -u u- --u u--	dactylic hexameter	feminine penthemimeral, hepthemimeral, trithemimeral
οὐχ ὁράᾳς; ὀλίγη μὲν ὅταν κεράεσσι σελήνη	- uu- uu- u u- uu-u u--	dactylic hexameter	masculine penthemimeral, hepthemimeral, trithemimeral
ἑσπερόθεν φαίνηται, ἀεξομένοιο διδάσκει	-uu- --u u-uu-u u--	dactylic hexameter	feminine penthemimeral, trithemimeral
μηνός· ὅτε πρώτη ἀποκίδναται αὐτόθεν αὐγή,	-u u- -- uu-uu -uu --	dactylic hexameter	masculine penthemimeral, trithemimeral
ὅσσον ἐπισκιάειν, ἐπὶ τέτρατον ἦμαρ ἰοῦσα·	-u u-uu- uu -uu -u u--	dactylic hexameter	masculine penthemimeral
ὀκτὼ δ᾽ἐν διχάσει· διχόμηνα δὲ παντὶ προσώπῳ.	-- - uu- uu-u u -u u--	dactylic hexameter	masculine penthemimeral, trithemimeral
αἰεὶ δ᾽ἄλλοθεν ἄλλα παρακλίνουσα μέτωπα	-- -uu -u u---u u--	dactylic hexameter	feminine penthemimeral
εἴρει ὁποσταίη μηνὸς περιτέλλεται ἠώς.	-u u--- -- uu-uu --	dactylic hexameter	masculine penthemimeral, hepthemimeral
ἄκρα γε μὴν νυκτῶν κεῖναι δυοκαίδεκα μοῖραι	-u u - -- -- uu-uu --	dactylic hexameter	masculine penthemimeral, hepthemimeral, trithemimeral
ἄρκιαι ἐξειπεῖν. τὰ δέ που μέγαν εἰς ἐνιαυτόν,	-uu --- u u - uu - uu--	dactylic hexameter	masculine penthemimeral, hepthemimeral
ὥρη μέν τ᾽ἀρόσαι νειούς, ὥρη δὲ φυτεῦσαι,	-- - uu- -- -- u u--	dactylic hexameter	masculine penthemimeral, hepthemimeral, trithemimeral
ἐκ Διὸς ἤδη πάντα πεφασμένα πάντοθι κεῖται.	- uu -- -u u-uu -uu --	dactylic hexameter	feminine penthemimeral
καὶ μέν τις καὶ νηῒ πολυκλύστου χειμῶνος	- - - - -u u--- ---	dactylic hexameter	feminine penthemimeral, trithemimeral
ἐφράσατ᾽ ἢ δεινοῦ μεμνημένος Ἀρκτούροιο	-uu - -- --uu ----	dactylic hexameter	masculine penthemimeral, trithemimeral
ἠέ τεων ἄλλων, οἵ τ᾽ὠκεανοῦ ἀρύονται	-u u- -- - -uu- uu--	dactylic hexameter	masculine penthemimeral, trithemimeral
ἀστέρες ἀμφιλύκης, οἵ τε πρώτης ἔτι νυκτός.	-uu -uu- - - -- uu --	dactylic hexameter	masculine penthemimeral, hepthemimeral
ἤτοι γὰρ τοὺς πάντας ἀμείβεται εἰς ἐνιαυτὸν	-- - - -u u-uu - uu--	dactylic hexameter	feminine penthemimeral, trithemimeral
ἠέλιος μέγαν ὄγμον ἐλαύνων, ἄλλοτε δ᾽ἄλλῳ	-uu- uu -u u-- -uu --	dactylic hexameter	feminine penthemimeral, trithemimeral
ἐμπλήσει, τοτὲ μέν τ᾽ἀνιὼν τοτὲ δ᾽αὐτίκα δύνων·	--- uu - uu- uu -uu --	dactylic hexameter	masculine penthemimeral, hepthemimeral, trithemimeral
ἄλλος δ᾽ἀλλοίην ἀστὴρ ἐπιδέρκεται ἠῶ.	-- --- -- uu-uu --	dactylic hexameter	masculine penthemimeral, hepthemimeral
γινώσκεις τάδε καὶ σύ, τὰ γὰρ συναείδεται ἤδη	--- uu - u u - uu-uu --	dactylic hexameter	masculine penthemimeral, hepthemimeral, trithemimeral
ἐννεακαίδεκα κύκλα φαεινοῦ ἠελίοιο,	-uu-uu -u u-- -uu--	dactylic hexameter	feminine penthemimeral
ὅσσα τ᾽ἀπὸ ζώνης εἰς ἔσχατον Ὠρίωνα	-u u- -- - -uu ----	dactylic hexameter	masculine penthemimeral, trithemimeral
νὺξ ἐπιδινεῖται Κύνα τε θρασὺν Ὠρίωνος,	- uu--- uu - uu ----	dactylic hexameter	masculine penthemimeral, hepthemimeral
οἵ τε Ποσειδάωνος ὁρώμενοι ἢ Διὸς αὐτοῦ	- u u---u u-uu - uu --	dactylic hexameter	feminine penthemimeral
ἀστέρες ἀνθρώποισι τετυγμένα σημαίνουσιν.	-uu ---u u-uu ----	dactylic hexameter	feminine penthemimeral
τῶ κείνων πεπόνησο· μέλοι δέ τοι, εἴ ποτε νηῒ	- -- uu-u u- u u - uu --	dactylic hexameter	feminine penthemimeral, hepthemimeral, trithemimeral
πιστεύεις, εὑρεῖν ὅσα που κεχρημένα κεῖται	--- -- uu - --uu --	dactylic hexameter	masculine penthemimeral, hepthemimeral, trithemimeral
σήματα χειμερίοις ἀνέμοις ἢ λαίλαπι πόντου.	-uu -uu- uu- - -uu --	dactylic hexameter	masculine penthemimeral, hepthemimeral
μόχθος μέν τ᾽ὀλίγος, τὸ δὲ μυρίον αὺτίκ᾽ ὄνειαρ	-- - uu- u u -uu -u u--	dactylic hexameter	masculine penthemimeral, trithemimeral
γίνετ᾽ ἐπιφροσύνης αἰεὶ πεφυλαγμένῳ ἀνδρί.	-u u-uu- -- uu-uu --	dactylic hexameter	masculine penthemimeral, hepthemimeral
αὐτὸς μὲν τὰ πρῶτα σαώτερος, εὖ δὲ καὶ ἄλλον	-- - - -u u-uu - u u --	dactylic hexameter	feminine penthemimeral, trithemimeral
παρειπὼν ὤνησεν, ὅτ᾽ ἐγγύθεν ὤρορε χειμών.	--- --u u -uu -uu --	dactylic hexameter	feminine penthemimeral, trithemimeral
πολλάκι γὰρ καί τίς τε γαληναίῃ ὑπὸ νυκτὶ	-uu - - - u u--- uu --	dactylic hexameter	masculine penthemimeral, trithemimeral
νῆα περιστέλλει πεφοβημένος ἦρι θαλάσσης·	-u u--- uu-uu -u u--	dactylic hexameter	masculine penthemimeral
ἄλλοτε δὲ τρίτον ἦμαρ ἐπιτρέχει, ἄλλοτε τέμπτον,	-uu - uu -u u-uu -uu --	dactylic hexameter	feminine penthemimeral, trithemimeral
ἄλλοτε δ᾽ἀπρόφατον κακὸν ἵκετο· πάντα γὰρ οὔπω	-uu -uu- uu -uu -u u --	dactylic hexameter	masculine penthemimeral
ἐκ Διὸς ἄνθρωποι γινώσκομεν, ἀλλ᾽ ἔτι πολλὰ	- uu --- --uu - uu --	dactylic hexameter	masculine penthemimeral
κέκπυπται, τῶν αἴ κε θέλῃ καὶ ἐσαυτίκα δώσει	--- - - u u- u u-uu --	dactylic hexameter	masculine penthemimeral, hepthemimeral, trithemimeral
Ζεύς· ὁ γὰρ οὖν γενεὴν ἀνδρῶν ἀναφανδὸν ὀφέλλει,	- u u - uu- -- uu-u u--	dactylic hexameter	masculine penthemimeral, hepthemimeral, trithemimeral
πάντοθεν εἰδόμενος, πάντη δ᾽ὅ γε σήματα φαίνων.	-uu -uu- -- u u -uu --	dactylic hexameter	masculine penthemimeral, hepthemimeral
ἄλλα δέ τοι ἐρέει ἤπου διχόωσα σελήνη	-u u - uu- -- uu-u u--	dactylic hexameter	masculine penthemimeral, hepthemimeral, trithemimeral
πληθύος ἀμφοτέρωθεν ἢ αὐτίκα πεπληθυῖα·	-uu -uu-u u -uu ----	dactylic hexameter	feminine penthemimeral
ἄλλα δ᾽ἀνερχόμενος, τοτὲ δ᾽ἄκρῃ νυκτὶ κελεύων	-u u-uu- uu -- -u u--	dactylic hexameter	masculine penthemimeral
ἠέλιος· τὰ δέ τοι καὶ ἀπ᾽ ἄλλων ἔσσεται ἄλλα	-uu- u u - u u -- -uu --	dactylic hexameter	masculine penthemimeral, trithemimeral
σήματα καὶ περὶ νυκτὶ καὶ ἤματι ποιήσασθαι.	-uu - uu -u u -uu ----	dactylic hexameter	feminine penthemimeral, trithemimeral
σκέπτεο δέ πρῶτον κεράων ἑκάτερθε σελήνην.	-uu - -- uu- uu-u u--	dactylic hexameter	masculine penthemimeral, hepthemimeral, trithemimeral
ἄλλοτε γάρ τ᾽ἄλλῃ μιν ἐπιγράφει ἕσπερος αἴγλῃ,	-uu - -- u u-uu -uu --	dactylic hexameter	masculine penthemimeral, trithemimeral
ἄλλοτε δ᾽ἀλλοῖαι μορφαὶ κερόωσι σελήνην	-uu --- -- uu-u u--	dactylic hexameter	masculine penthemimeral, hepthemimeral
εὐθὺς ἀεξομένην, αἱ μὲν τρίτῃ, αἱ δὲ τετάρτῃ·	-u u-uu- - - uu - u u--	dactylic hexameter	masculine penthemimeral, hepthemimeral
τάων καὶ πεπὶ μηνὸς ἐφεσταότος κε πύθοιο.	-- - uu -u u-uu- u u--	dactylic hexameter	feminine penthemimeral, trithemimeral
λεπτὴ μὲν καθαρή τε περὶ τρίτον ἦμαρ ἐοῦσα	-- - uu- u u- uu -u u--	dactylic hexameter	masculine penthemimeral, hepthemimeral, trithemimeral
εὔδιός κ᾽εἴη· λεπτὴ δὲ καὶ εὖ μάλ᾽ ἐρευθὴς	--- -- -- u u - u u--	dactylic hexameter	masculine penthemimeral, hepthemimeral, trithemimeral
πνευματίη· παχίων δέ καὶ ἀμβλείῃσι κεραίαις	-uu- uu- u u ---u u--	dactylic hexameter	masculine penthemimeral, trithemimeral
τέτρατον ἐκ τριτάτοιο φόως ἀμενηνὸν ἔχουσα	-uu - uu-u u- uu-u u--	dactylic hexameter	feminine penthemimeral, hepthemimeral, trithemimeral
ἤ νότῳ ἄμβλυνται ἢ ὕδατος ἐγγὺς ἐόντος.	- uu --- u u-- -u u--	dactylic hexameter	masculine penthemimeral
εἰ δέ κ᾽ἀπ᾽ ἀμφοτέρων κεράων, τρίτον ἦμαρ ἄγουσα,	- u u -uu- uu- uu -u u--	dactylic hexameter	masculine penthemimeral, hepthemimeral
μήτ᾽ ἐπινευστάζῃ μήθ᾽ ὑπτιόωσα φαείνῃ,	- uu--- - -uu-u u--	dactylic hexameter	masculine penthemimeral
ἀλλ᾽ ὀρθαὶ ἑκάτερθε περιγνάμπτωσι κεραῖαι,	- -- uu-u u---u u--	dactylic hexameter	feminine penthemimeral, trithemimeral
ἑσπέριοί κ᾽ἄνεμοι κείνην μετὰ νύκτα φέροιντο.	-uu- uu- -- uu -u u--	dactylic hexameter	masculine penthemimeral, hepthemimeral, trithemimeral
εἰ δ᾽αὕτως ὀρθὴ καὶ τέτρατον ἦμαρ ἀγινεῖ,	- -- -- - -uu -u u--	dactylic hexameter	masculine penthemimeral, trithemimeral
ἦ τ᾽ἄν χειμῶνος συναγειρομένοιο διδάσκοι.	- - --- uu-uu-u u--	dactylic hexameter	masculine penthemimeral
εἰ δέ κέ οἱ κεράων τὸ μετήορον εὖ ἐπινεύῃ,	- u u - uu- u u-uu - uu--	dactylic hexameter	masculine penthemimeral, trithemimeral
δειδέχθαι βορέω· ὅτε δ᾽ὑπτιάῃσι, νότοιο.	--- uu- uu -uu-u u--	dactylic hexameter	masculine penthemimeral, trithemimeral
αὐτὰρ ἐπὴν τριτόωσαν ὅλος περὶ κύκλος ἑλίσσῃ	-u u- uu-u u- uu -u u--	dactylic hexameter	feminine penthemimeral, hepthemimeral, trithemimeral
πάντη ἐρευθόμενος, μάλα κεν τότε χείμερος εἴη·	-u u-uu- uu - uu -uu --	dactylic hexameter	masculine penthemimeral, hepthemimeral
μείζονι δ᾽ἂν χειμῶνι πυρώτερα φοινίσσοιτο.	-uu - --u u-uu ----	dactylic hexameter	feminine penthemimeral, trithemimeral
σκέπτεο δ᾽ἐς πληθύν τε καὶ ἀμφότερον διχόωσαν,	-uu - -- u u -uu- uu--	dactylic hexameter	masculine penthemimeral, trithemimeral
ἠμὲν ἀεξομένην ἠδ᾽ ἐς κέρας αὖθις ἰοῦσαν,	-u u-uu- - - uu -u u--	dactylic hexameter	masculine penthemimeral, hepthemimeral
καί οἱ ἐπὶ χροιῇ τεκμαίρεο μηνὸς ἑκάστου.	- u u- -- --uu -u u--	dactylic hexameter	masculine penthemimeral, trithemimeral
πάντη γὰρ καθαρῇ κε μάλ᾽ εὔδια τεκμήραιο·	-- - uu- u u -uu ----	dactylic hexameter	masculine penthemimeral, trithemimeral
πάντα δ᾽ἐρευθομένῃ δοκέειν ἀνέμοιο κελεύθους·	-u u-uu- uu- uu-u u--	dactylic hexameter	masculine penthemimeral, hepthemimeral
ἄλλοθι δ᾽ἄλλο μελαινομένῃ δοκέειν ὑετοῖο.	-uu -u u-uu- uu- uu--	dactylic hexameter	hepthemimeral
σήματα δ᾽οὐτ᾽ ἀρ᾽ πᾶσιν ἐπ᾽ ἤμασι πάντα τέτυκται·	-uu - - -u u -uu -u u--	dactylic hexameter	feminine penthemimeral, trithemimeral
ἀλλ᾽ ὅσα μὲν τριτάτῇ τε τεταρταίῃ τε πέλονται,	- uu - uu- u u--- u u--	dactylic hexameter	masculine penthemimeral, trithemimeral
μέσφα διχαιομένης, διχάδος γε μὲν ἄχρις ἐπ᾽ αὐτὴν	-u u-uu- uu- u u -u u --	dactylic hexameter	masculine penthemimeral, hepthemimeral
σημαίνει διχόμηνον, ἀτὰρ πάλιν ἐκ διχομήνου	--- uu-u u- uu - uu--	dactylic hexameter	feminine penthemimeral, hepthemimeral, trithemimeral
ἐς διχάδα φθιμένην· ἔχεται δέ οἱ αὐτίκα τετρὰς	- uu- uu- uu- u u -uu --	dactylic hexameter	masculine penthemimeral, hepthemimeral, trithemimeral
μηνὸς ἀποιχομένου, τῇ δὲ τριτάτη ἐπιόντος.	-u u-uu- - - uu- uu--	dactylic hexameter	masculine penthemimeral, hepthemimeral
εἰ δέ κέ μιν πεπὶ πᾶσαν ἀλωαὶ κυκλώσωνται	- u u - uu -u u-- ----	dactylic hexameter	feminine penthemimeral, trithemimeral
ἤ τρεῖς ἠὲ δύω περικείμεναι ἠὲ μί᾽ οἴη,	- - -u u- uu-uu -u u --	dactylic hexameter	masculine penthemimeral
τῇ μὲν ἰῇ ἀνέμοιο γαληναίης τε δοκεύειν,	- u u- uu-u u--- u u--	dactylic hexameter	feminine penthemimeral, trithemimeral
ῥηγνυμένῃ ἀνέμοιο, μαραινομένῃ δὲ γαλήνης·	-uu- uu-u u-uu- u u--	dactylic hexameter	feminine penthemimeral, trithemimeral
ταὶ δύο δ᾽ἂν χειμῶνι περιτροχάοιντο σελήνην·	- uu - --u u-uu-u u--	dactylic hexameter	feminine penthemimeral, trithemimeral
μείζονα δ᾽ἂν χειμῶνα φέροι τριέλικτος ἀλωή,	-uu - --u u- uu-u u--	dactylic hexameter	feminine penthemimeral, hepthemimeral, trithemimeral
καὶ μᾶλλον μελανεῦσα, καὶ εἰ ῥηγνύατο μᾶλλον.	- -- uu-u u - --uu --	dactylic hexameter	feminine penthemimeral, hepthemimeral, trithemimeral
καὶ τὰ μὲν οὖν ἐπὶ μηνὶ σεληναίης κε πύθοιο.	- u u - uu -u u--- u u--	dactylic hexameter	feminine penthemimeral, trithemimeral
ἠελίοιο δέ τοι μελέτω ἑκάτερθεν ἰόντος.	-uu-u u - uu- uu-u u--	dactylic hexameter	masculine penthemimeral, hepthemimeral
ἠελίῳ καὶ μᾶλλον ἐοικότα σήματα κεῖται,	-uu- - -u u-uu -uu --	dactylic hexameter	feminine penthemimeral, trithemimeral
ἀμφότερον δύνοντι καὶ ἐκ περάτης ἀνιόντι.	-uu- --u u - uu- uu--	dactylic hexameter	feminine penthemimeral, hepthemimeral, trithemimeral
μή οἱ ποικίλλοιτο νέον βάλλοντος ἀρούρας	- - ---u u- --u u--	dactylic hexameter	feminine penthemimeral, hepthemimeral
κύκλος, ὅτ᾽ εὐδίου κεχρημένος ἤματος εἴης,	-u u --- --uu -uu --	dactylic hexameter	masculine penthemimeral
μηδέ τι σῆμα φέροι, φαίνοιτο δὲ λιτὸς ἁπάντη.	-u u -u u- --u u -u u--	dactylic hexameter	masculine penthemimeral
εἰ δ᾽αὕτως καθαρόν μιν ἔχοι βουλύσιος ὥρη,	- -- uu- u u- --uu --	dactylic hexameter	masculine penthemimeral, hepthemimeral, trithemimeral
δύνοι δ᾽ἀνέφελος μαλακὴν ὑποδείελος αἴγλην,	-- -uu- uu- uu-uu --	dactylic hexameter	masculine penthemimeral, hepthemimeral
καί κεν ἐπερχομένη ἠοῦς ἔθ᾽ ὑπεύδιος εἴη.	- u u-uu- -- u u-uu --	dactylic hexameter	masculine penthemimeral, hepthemimeral
ἀλλ᾽ οὐχ ὁππότε κοῖλος ἐειδόμενος περιτέλλῃ,	- - -uu -u u-uu- uu--	dactylic hexameter	feminine penthemimeral
οὐδ᾽ ὁπότ᾽ ἀκτίνων αἱ μὲν νότον αἱ δὲ βορῆα	- uu --- - - uu - u u--	dactylic hexameter	masculine penthemimeral, hepthemimeral
σχιζόμεναι βάλλωσι, τὰ δ᾽αὖ περὶ μέσσα φαείνῃ,	-uu- --u u - uu -u u--	dactylic hexameter	feminine penthemimeral, hepthemimeral, trithemimeral
ἀλλά που ἢ ὑετοῖο διέρχεται ἢ ἀνέμοιο.	-u u - uu-u u-uu - uu--	dactylic hexameter	feminine penthemimeral, trithemimeral
σκέπτεο δ᾽,εἴ κέ τοι αὐγαὶ ὑπείκωσ᾽ ἠελίοιο,	-uu - u u -u u-- -uu--	dactylic hexameter	feminine penthemimeral, trithemimeral
αὐτὸν ἐς ἠέλιον· τοῦ γὰρ σκοπιαὶ ἄρισται·	-u u -uu- - - uu- ---	dactylic hexameter	masculine penthemimeral, hepthemimeral
εἴ τί οἱ ἤπου ἔρευθος ἐπιτρέχει, οἷά τε πολλὰ	- u u -u u-u u-uu -u u --	dactylic hexameter	feminine penthemimeral
ἑλκομένων νεφέων ἐρυθαίνεται ἄλλοθεν ἄλλα,	-uu- uu- uu-uu -uu --	dactylic hexameter	masculine penthemimeral, trithemimeral
ἢ εἴ που μελανεῖ· καί τοι τὰ μὲν ὕδατος ἔστω	- - - uu- - - u u -uu --	dactylic hexameter	masculine penthemimeral, hepthemimeral, trithemimeral
σήματα μέλλοντος, τὰ δ᾽ἐρεύθεα πάντ᾽ ἀνέμοιο.	-uu --- u u-uu - uu--	dactylic hexameter	masculine penthemimeral
εἴ γε μὲν ἀμφοτέροις ἄμυδις κεχρημένος εἴη,	- u u -uu- uu- --uu --	dactylic hexameter	masculine penthemimeral, hepthemimeral
καί κεν ὕδωρ φορέοι καὶ ὑπηνέμιος τανύοιτο.	- u u- uu- u u-uu- uu--	dactylic hexameter	masculine penthemimeral, trithemimeral
εἰ δέ οἱ ἤ ἀνιόντος ἢ αὐτίκα δυομένοιο	- u u - uu-u u -uu -uu--	dactylic hexameter	feminine penthemimeral, trithemimeral
ἀκτῖνες συνίωσι καὶ ἀμφ᾽ ἑνὶ πεπλήθωσιν,	--- uu-u u - uu ----	dactylic hexameter	feminine penthemimeral, hepthemimeral, trithemimeral
ἤ ποτε καὶ νεφέων πεπιεσμένος ἢ ὅ γ᾽ἐς ἠῶ	- uu - uu- uu-uu - u u --	dactylic hexameter	masculine penthemimeral, trithemimeral
ἔρχηται παρὰ νυκτός, ἢ ἐξ ἠοῦς ἐπὶ νύκτα,	--- uu -u u - -- uu --	dactylic hexameter	feminine penthemimeral, hepthemimeral, trithemimeral
ὕδατί κεν κατιόντι παρατρέχοι ἤματα κεῖνα.	-uu - uu-u u-uu -uu --	dactylic hexameter	feminine penthemimeral, trithemimeral
μηδ᾽ ὅτε οἱ ὀλίγη νεφέλη πάρος ἀντέλλῃσιν,	- uu - uu- uu- uu ----	dactylic hexameter	masculine penthemimeral, hepthemimeral, trithemimeral
τὴν δὲ μέτ᾽ ἀκτίνων κεχρημένος αὐτὸς ἀερθῇ,	- u u --- --uu -u u--	dactylic hexameter	masculine penthemimeral
ἀμνηστεῖν ὑετοῖο. πολὺς δ᾽ὅτε οἱ περὶ κύκλος	--- uu-u u- uu - uu --	dactylic hexameter	feminine penthemimeral, hepthemimeral, trithemimeral
οἷον τηκομένῳ ἐναλίγκιος εὐρύνηται	-- -uu- uu-uu ----	dactylic hexameter	masculine penthemimeral
πρῶτον ἀνερχομένοιο, καὶ ἄψ ἐπὶ μεῖον ἴῃσιν,	-u u-uu-u u - uu -u u--	dactylic hexameter	feminine penthemimeral, hepthemimeral
εὔδιός κε φέροιτο· καὶ εἴ ποτε χείματος ὥρῃ	--- u u-u u - uu -uu --	dactylic hexameter	feminine penthemimeral, hepthemimeral, trithemimeral
ὠχρήσαι κατιών. ἀτὰρ ὕδατος ἡμερινοῖο	--- uu- uu -uu -uu--	dactylic hexameter	masculine penthemimeral, trithemimeral
γινομένου κατότισθε περὶ νέφεα σκοπέεσθαι	-uu- uu-u u- uu- uu--	dactylic hexameter	feminine penthemimeral, hepthemimeral, trithemimeral
κὰδ δὴ δυομένου τετραμμένος ἠελίοιο.	- - -uu- --uu -uu--	dactylic hexameter	masculine penthemimeral
ἢν μὲν ὑποσκιάῃσι μελαινομένῃ εἰκυῖα	- u u-uu-u u-uu- ---	dactylic hexameter	feminine penthemimeral
ἠέλιον νεφέλη, ταὶ δ᾽ἀμφί μιν ἔνθα καὶ ἔνθα	-uu- uu- - -u u -u u --	dactylic hexameter	masculine penthemimeral, trithemimeral
ἀκτῖνες μεσσηγὺς ἐλισσόμεναι διχόωνται,	--- --u u-uu- uu--	dactylic hexameter	feminine penthemimeral, trithemimeral
ἦ τ᾽ἂν ἔτ᾽ εἰς ἠῶ σκέπαος κεχρημένος εἴης.	- u u - -- uu- --uu --	dactylic hexameter	masculine penthemimeral, hepthemimeral, trithemimeral
εἰ δ᾽ὁ μὲν ἀνέφελος βάπτοι ῥόου ἑσπερίοιο,	- u u -uu- -- uu -uu--	dactylic hexameter	masculine penthemimeral, hepthemimeral
ταὶ δὲ κατερχομένου νεφέλαι καὶ ἔτ᾽ οἰχομένοιο	- u u-uu- uu- u u -uu--	dactylic hexameter	masculine penthemimeral, hepthemimeral
πλησίαι ἑστήκωσιν ἐρευθέες οὔ σε μάλα χρὴ	-uu ---u u-uu - u u- -	dactylic hexameter	feminine penthemimeral
αὔριον οὐδ᾽ ἐπὶ νυκτὶ περιτρομέειν ὑετοῖο·	-uu - uu -u u-uu- uu--	dactylic hexameter	feminine penthemimeral, trithemimeral
ἀλλ᾽ ὁπότ᾽ ἠελίοιο μαραινομένῃσιν ὁμοῖαι	- uu -uu-u u-uu-u u--	dactylic hexameter	feminine penthemimeral
ἐξαπίνης ἀκτῖνες ἀπ᾽ οὐρανόθεν τανύωνται,	-uu- --u u -uu- uu--	dactylic hexameter	feminine penthemimeral, trithemimeral
οἶον ἀμαλδύνονται ὅτε σκιάῃσι κατ᾽ ἰθὺ	-u u---u u- uu-u u --	dactylic hexameter	feminine penthemimeral, hepthemimeral
ἱσταμένη γαίης τε καὶ ἠελίοιο σελήνη.	-uu- -- u u -uu-u u--	dactylic hexameter	masculine penthemimeral, trithemimeral
οὐδ᾽, ὅτε οἱ ἐπέχοντι φανήμεναι ἠῶθι πρὸ	- uu - uu-u u-uu --- -	dactylic hexameter	feminine penthemimeral, trithemimeral
φαίνονται νεφέλαι ὑπερευθέες ἄλλοθεν ἄλλαι,	--- uu- uu-uu -uu --	dactylic hexameter	masculine penthemimeral, trithemimeral
ἄρραντοι γίνονται ἐπ᾽ ἤματι κείνῳ ἄρουραι.	--- --u u -uu -u u--	dactylic hexameter	feminine penthemimeral, trithemimeral
μηδ᾽ αὕτως, ἔτ᾽ ἐόντι πέρην ὁπότε προταθεῖσαι	- -- u u-u u- uu- uu--	dactylic hexameter	feminine penthemimeral, hepthemimeral, trithemimeral
ἀκτῖνες φαίνονται ἐπίσκιοι ἠῶθι πρό,	--- --u u-uu --- -	dactylic hexameter	feminine penthemimeral, trithemimeral
ὕδατος ἢ ἀνέμοιο κατοισομένου λελαθέσθαι.	-uu - uu-u u-uu- uu--	dactylic hexameter	feminine penthemimeral, trithemimeral
ἀλλ᾽ εἰ μὲν κεῖναι μᾶλλον κνέφαος φορέοιντο	- - - -- -- uu- uu--	dactylic hexameter	masculine penthemimeral, hepthemimeral, trithemimeral
ἀκτῖνες, μᾶλλόν κεν ἐφ᾽ ὕδατι σημαίνοιεν·	--- -- u u -uu ----	dactylic hexameter	masculine penthemimeral, trithemimeral
εἰ δ᾽ὀλίγος τανύοιτο περὶ δνόφος ἀκτίνεσσιν,	- uu- uu-u u- uu ----	dactylic hexameter	feminine penthemimeral, hepthemimeral, trithemimeral
οἷόν που μαλακαὶ νεφέλαι φορέουσι μάλιστα,	-- - uu- uu- uu-u u--	dactylic hexameter	masculine penthemimeral, hepthemimeral, trithemimeral
ἦ τ᾽ἂν ἐπερχομένοιο περιδνοφέοιντ᾽ ἀνέμοιο.	- u u-uu-u u-uu- uu--	dactylic hexameter	feminine penthemimeral
οὐδὲ μὲν ἠελίου σχεδόθεν μελανεῦσαι ἀλωαὶ	-u u -uu- uu- uu-u u--	dactylic hexameter	masculine penthemimeral, hepthemimeral
εὔδιοι· ἀσσότεραι δὲ καὶ ἀστεμφὲς μελανεῦσαι	-uu -uu- u u --- uu--	dactylic hexameter	masculine penthemimeral
μᾶλλον χειμέριαι· δύο δ᾽ἂν χαλεπώτεραι εἶεν.	-- -uu- uu - uu-uu --	dactylic hexameter	masculine penthemimeral, hepthemimeral
σκέπτεο δ᾽ἢ ἀνιόντος ἢ αὐτίκα δυομένοιο,	-uu - uu-u u -uu -uu--	dactylic hexameter	feminine penthemimeral, trithemimeral
εἴ πού οἱ νεφέων τὰ παρήλια κικλήσκονται	- - - uu- u u-uu ----	dactylic hexameter	masculine penthemimeral, trithemimeral
ἢ νότον ἠὲ βορῆος ἐρεύθεται ἢ ἑκάτερθεν,	- uu -u u-u u-uu - uu--	dactylic hexameter	feminine penthemimeral
μηδ᾽ οὕτω σκοπιὴν ταύτην ἀμενηνὰ φυλάσσειν.	- -- uu- -- uu-u u--	dactylic hexameter	masculine penthemimeral, hepthemimeral, trithemimeral
οὐ γάρ, ὅτ᾽ ἀμφοτέρωθεν ὁμοῦ περὶ μέσσον ἔχουσιν	- u u -uu-u -- uu -u u--	lyric	
ἠέλιον κεῖναι νεφέλαι σχεδὸν ὠκεανοῖο,	-uu- -- uu- uu -uu--	dactylic hexameter	masculine penthemimeral, hepthemimeral, trithemimeral
γίνεται ἀμβολίη διόθεν χειμῶνος ἰόντος.	-uu -uu- uu- --u u--	dactylic hexameter	masculine penthemimeral, hepthemimeral
εἴ γε μὲν ἐκ βορέαο μί᾽ οἴη φοινίσσοιτο,	- u u - uu-u u -- ----	dactylic hexameter	feminine penthemimeral, trithemimeral
ἐκ βορέω πνοιάς κε φέροι, νοτίη δὲ νότοιο,	- uu- -- u u- uu- u u--	dactylic hexameter	masculine penthemimeral, hepthemimeral, trithemimeral
ἢ καί που ῥαθάμιγγες ἐπιτροχόωσ᾽ ὑετοῖο.	- - - uu-u u-uu- uu--	dactylic hexameter	feminine penthemimeral, trithemimeral
ἑσπερίοις καὶ μᾶλλον ἐπίτρεπε σήμασι τούτοις·	-uu- - -u u-uu -uu --	dactylic hexameter	feminine penthemimeral, trithemimeral
ἑσπερόθεν γὰρ ὁμῶς σημαίνεται ἐμμενὲς αἰεί.	-uu- u u- --uu -uu --	dactylic hexameter	masculine penthemimeral, trithemimeral
σκέπτεο καὶ φάτνην. ἡ μέν τ᾽ὀλίγῃ εἰκυῖα	-uu - -- - - uu- ---	dactylic hexameter	masculine penthemimeral, hepthemimeral, trithemimeral
ἀχλύϊ βορραίη ὑπὸ Καρκίνῳ ἡγηλάζει·	-uu --- uu -uu ----	dactylic hexameter	masculine penthemimeral
ἀμφὶ δέ μιν δύο λεπτὰ φαεινόμενοι φορέονται	-u u - uu -u u-uu- uu--	dactylic hexameter	feminine penthemimeral, trithemimeral
ἀστέρες, οὔτε τι πολλὸν ἀπήοροι, οὔτε μάλ᾽ ἐγγύς,	-uu -u u -u u-uu -u u --	dactylic hexameter	feminine penthemimeral
ἀλλ᾽ ὅσσον τε μάλιστα πυγούσιον οἰίσασθαι·	- -- u u-u u-uu ----	dactylic hexameter	feminine penthemimeral, trithemimeral
εἶς μὲν πὰρ βορέαο· νότῳ δ᾽ἐπικέκλιται ἄλλος.	- - - uu-u u- uu-uu --	dactylic hexameter	feminine penthemimeral, hepthemimeral, trithemimeral
καὶ ταὶ μὲν καλέονται ὄνοι· μέσση δέ τε Φάτνη.	- - - uu-u u- -- u u --	dactylic hexameter	feminine penthemimeral, hepthemimeral, trithemimeral
ἥτε καὶ ἐξαπίνης πάντη Διὸς εὐδιόωντος	-u u -uu- -- uu -uu--	dactylic hexameter	masculine penthemimeral, hepthemimeral
γίνετ᾽ ἄφαντος ὅλη· τοὶ δ᾽ἀμφοτέρωθεν ἰόντες	-u u-u u- - -uu-u u--	dactylic hexameter	masculine penthemimeral
ἀστέρες ἀλλήλων αὐτοσχεδὸν ἰνδάλλονται·	-uu --- --uu ----	dactylic hexameter	masculine penthemimeral
οὐκ ὀλίγῳ χειμῶνι τότε κλύζονται ἄρουραι.	- uu- --u u- --u u--	dactylic hexameter	feminine penthemimeral, hepthemimeral, trithemimeral
εἰ δὲ μελαίνηται, τοὶ δ᾽αὐτίκ᾽ ἐοικότες ὦσιν	- u u--- - -u u-uu --	dactylic hexameter	masculine penthemimeral
ἀστέρες ἀμφότεροι, περί χ᾽ὕδατι σημαίνοιεν.	-uu -uu- uu -uu ----	dactylic hexameter	masculine penthemimeral
εἰ δ᾽ὁ μὲν ἐκ βορέω Φάτνης ἀμενηνὰ φαείνοι	- u u - uu- -- uu-u u--	dactylic hexameter	masculine penthemimeral, hepthemimeral, trithemimeral
λεπτὸν ἐπαχλύων, νότιος δὌνος ἀγλαὸς εἴη,	-u u--- uu- uu -uu --	dactylic hexameter	masculine penthemimeral, hepthemimeral
δειδέχθαι ἀνέμοιο νότου· βορέω δὲ μάλα χρή	--- uu-u u- uu- u u- -	dactylic hexameter	feminine penthemimeral, hepthemimeral, trithemimeral
ἔμπαλιν ἀχλυόεντι φαεινομένῳ τε δοκεύειν.	-uu -uu-u u-uu- u u--	dactylic hexameter	feminine penthemimeral
σῆμα δέ τοι ἀνέμοιο καὶ οἰδαίνουσα θάλασσα	-u u - uu-u u ---u u--	dactylic hexameter	feminine penthemimeral, trithemimeral
γινέσθω καὶ μακρὸν ἐπ᾽ αἰγιαλοὶ βοόωντες,	--- - -u u -uu- uu--	dactylic hexameter	feminine penthemimeral, trithemimeral
ἀκταί τ᾽εἰνάλιοι ὁπότ᾽ εὔδιοι ἠχήεσσαι	-- -uu- uu -uu ----	dactylic hexameter	masculine penthemimeral
γίνονται, κορυφαί τε βοώμεναι οὔρεος ἄκραι.	--- uu- u u-uu -uu --	dactylic hexameter	masculine penthemimeral, trithemimeral
καὶ δ᾽ἄν ἐπὶ ξηρὴν ὅτ᾽ ἐρωδιὸς οὐ κατὰ κόσμον	- u u- -- u u-uu - uu --	dactylic hexameter	masculine penthemimeral, trithemimeral
ἐξ ἁλὸς ἔρχηται φωνῇ περιπολλὰ λεληκώς,	- uu --- -- uu-u u--	dactylic hexameter	masculine penthemimeral, hepthemimeral
κινυμένου κε θάλασσαν ὕπερ φορέοιτ᾽ ἀνέμοιο.	-uu- u u-u u- uu- uu--	dactylic hexameter	feminine penthemimeral, hepthemimeral, trithemimeral
καί ποτε καὶ κέπφοι, ὁπότ᾽ εὔδιοι ποτέονται,	- uu - -- uu --- uu--	dactylic hexameter	masculine penthemimeral, trithemimeral
ἀντία μελλόντων ἀνέμων εἰληδὰ φέρονται.	-uu --- uu- --u u--	dactylic hexameter	masculine penthemimeral, hepthemimeral
πολλάκι δ᾽ἀγριάδες νῆσσαι ἤ εἰναλίδιναι	-uu -uu- -- - -uu--	dactylic hexameter	masculine penthemimeral, hepthemimeral
αἴθυιαι χερσαῖα τινάσσονται πτερύγεσσιν·	--- --u u--- uu--	dactylic hexameter	feminine penthemimeral, trithemimeral
ἢ νεφέλη ὄρεος μηκύνεται ἐν κορυφῇσιν.	- uu- uu- --uu - uu--	dactylic hexameter	masculine penthemimeral, trithemimeral
ἤδη καὶ πάπποι, λευκῆς γήρειον ἀκάνθης,	-- - -- -- --u u--	dactylic hexameter	masculine penthemimeral, hepthemimeral, trithemimeral
σῆμ᾽ ἐγένοντ᾽ ἀνέμου, κωφῆς ἁλὸς ὁππότε πολλοὶ	- uu- uu- -- uu -uu --	dactylic hexameter	masculine penthemimeral, hepthemimeral, trithemimeral
ἄκρον ἐπιπλώωσι, τὰ μὲν πάρος, ἄλλα δ᾽ὀπίσσω.	-u u---u u - uu -u u--	dactylic hexameter	feminine penthemimeral, hepthemimeral
καὶ θέρεος βρονταί τε καὶ ἀστραπαὶ ἔνθεν ἴωσιν,	- uu- -- u u -uu -u u--	dactylic hexameter	masculine penthemimeral, trithemimeral
ἔνθεν ἐπερχομένοιο περισκοπέειν ἀνέμοιο.	-u u-uu-u u-uu- uu--	dactylic hexameter	feminine penthemimeral
καὶ διὰ νύκτα μέλαιναν ὅτ᾽ ἀστέρες ἀΐσσωσιν	- uu -u u-u u -uu ----	dactylic hexameter	feminine penthemimeral
ταρφέα, ταὶ δ᾽ὄπιθεν ῥυμοὶ ὑπολευκαίνωνται,	-uu - uu- uu ------	dactylic hexameter	masculine penthemimeral, trithemimeral
δειδέχθαι κείνοις αὐτὴν ὁδὸν ἐρχομένοιο	--- -- -- uu -uu--	dactylic hexameter	masculine penthemimeral, hepthemimeral, trithemimeral
πνεύματος· ἢν δὲ καὶ ἄλλοι ἐναντίοι ἀΐσσωσιν,	-uu - u u -u u-uu ----	dactylic hexameter	feminine penthemimeral, trithemimeral
ἄλλοι δ᾽ἐξ ἄλλων μερέων, τότε δὴ πεφύλαξο	-- - -- uu- uu - uu--	dactylic hexameter	masculine penthemimeral, hepthemimeral, trithemimeral
παντοίων ἀνέμων, οἵ τ᾽ἄκριτοί εἰσι μάλιστα,	--- uu- - -uu -u u--	dactylic hexameter	masculine penthemimeral, trithemimeral
ἄκριτα δὲ πνείουσιν ἐπ᾽ ἀνδράσι τεκμήρασθαι.	-uu - --u u -uu ----	dactylic hexameter	feminine penthemimeral, trithemimeral
αὐτάρ ὅτ᾽ ἐξ εὔροιο καὶ ἐκ νότου ἀστράπτῃσιν,	-u u - --u u - uu ----	dactylic hexameter	feminine penthemimeral, hepthemimeral, trithemimeral
ἄλλοτε δ᾽ἐκ ζεφύροιο, καὶ ἄλλοτε πὰρ βορέαο,	-uu - uu-u u -uu - uu--	dactylic hexameter	feminine penthemimeral, trithemimeral
δὴ τότε τις πελάγει ἔνι δείδιε ναυτίλος ἀνήρ,	- uu - uu- uu -uu -uu --	dactylic hexameter	masculine penthemimeral, trithemimeral
μή μιν τῇ μὲν ἔχῃ πέλαγος τῇ δ᾽ἐκ Διὸς ὕδωρ·	- - - u u- uu- - - uu --	dactylic hexameter	masculine penthemimeral, hepthemimeral, trithemimeral
ὕδατι γὰρ τοσσαίδε περὶ στεροπαὶ φορέονται.	-uu - --u u- uu- uu--	dactylic hexameter	feminine penthemimeral, hepthemimeral, trithemimeral
πολλάκι δ᾽ἐρχομένων ὑετῶν νέφεα προπάροιθεν	-uu -uu- uu- uu- uu--	dactylic hexameter	masculine penthemimeral, hepthemimeral
οἶα μάλιστα πόκοισιν ἐοικότα ἰνδάλλονται,	-u u-u u-u u-uu ----	dactylic hexameter	feminine penthemimeral
ἢ διδύμη ἔζωσε διὰ μέγαν οὐρανὸν ἶρις,	- uu- --u u- uu -uu --	dactylic hexameter	feminine penthemimeral, hepthemimeral, trithemimeral
ἢ καί πού τις ἅλωα μελαινομένην ἔχει ἀστήρ.	- - - u u-u u-uu- uu --	dactylic hexameter	feminine penthemimeral, trithemimeral
πολλάκι λιμναῖαι ἢ εἰνάλιαι ὄρνιθες	-uu --- - -uu- ---	dactylic hexameter	masculine penthemimeral
ἄπληστον κλύζονται ἐνιέμεναι ὑδάτεσσιν,	--- --u u-uu- uu--	dactylic hexameter	feminine penthemimeral, trithemimeral
ἢ λίμνην πέρι δηθὰ χελιδόνες ἀΐσσονται	- -- uu -u u-uu ----	dactylic hexameter	feminine penthemimeral, trithemimeral
γαστέρι τύπτουσαι αὕτως εἰλυμένον ὕδωρ,	-uu --- -- --uu --	dactylic hexameter	masculine penthemimeral, hepthemimeral
ἢ μᾶλλον δειλαὶ γενεαί, ὕδροισιν ὄνειαρ,	- -- -- uu- --u u--	dactylic hexameter	masculine penthemimeral, hepthemimeral, trithemimeral
αὐτόθεν ἐξ ὕδατος πατέρες βοόωσι γυρίνων,	-uu - uu- uu- uu-u u--	dactylic hexameter	masculine penthemimeral, hepthemimeral, trithemimeral
ἢ τρύζει ὀρθρινὸν ἐρημαίη ὀλολυγών,	- -- --u u--- uu--	dactylic hexameter	feminine penthemimeral, trithemimeral
ἤ που καὶ λακέρυζα παρ᾽ ἠϊόνι προὐχούσῃ	- - - uu-u u -uu- ---	dactylic hexameter	feminine penthemimeral, trithemimeral
χείματος ἐρχομένου χέρσῳ ὑπέτυψε κορώνη,	-uu -uu- -- uu-u u--	dactylic hexameter	masculine penthemimeral, hepthemimeral
ἤ που καὶ ποταμοῖο ἐβάψατο μέχρι παρ᾽ ἄκρους	- - - uu-u u-uu -u u --	dactylic hexameter	feminine penthemimeral, trithemimeral
ὤμους ἐκ κεφαλῆς, ἢ καὶ μάλα πᾶσα κολυμβᾷ,	-- - uu- - - uu -u u--	dactylic hexameter	masculine penthemimeral, hepthemimeral, trithemimeral
ἢ πολλὴ στρέφεται παρ᾽ ὕδωρ παχέα κρώζουσα.	- -- uu- u u- uu- ---	dactylic hexameter	masculine penthemimeral, hepthemimeral, trithemimeral
καὶ βόες ἤδη τοι πάρος ὕδατος ἐνδίοιο	- uu -- - uu -uu ----	dactylic hexameter	masculine penthemimeral
οὐρανὸν εἰσανιδόντες ἀπ᾽ αἰθέρος ὠσφρήσαντο·	-uu -uu-u u -uu ----	dactylic hexameter	feminine penthemimeral
καὶ κοίλης μύρμηκες ὀχῆς ἐξ ὤεα πάντα	- -- --u u- - -uu --	dactylic hexameter	feminine penthemimeral, hepthemimeral, trithemimeral
θᾶσσον ἀνηνέγκαντο· καὶ ἀθρόοι ὦφθεν ἴουλοι	-u u---u u -uu -u u--	dactylic hexameter	feminine penthemimeral
τείχη ἀνέρποντες, καὶ πλαζόμενοι σκώληκες	-u u--- - -uu- ---	dactylic hexameter	masculine penthemimeral
κεῖνοι, τοὺς καλέουσι μελαίνης ἔντερα γαίης.	-- - uu-u u-- -uu --	dactylic hexameter	feminine penthemimeral, trithemimeral
καὶ τιθαὶ ὄρνιθες, ταὶ ἀλέκτορος ἐξεγένοντο,	- uu --- u u-uu -uu--	dactylic hexameter	masculine penthemimeral
εὖ ἐφθειρίσσαντο καὶ ἔκρωξαν μάλα φωνῇ,	- ----u u --- uu --	dactylic hexameter	feminine penthemimeral
οἷόν τε σταλάον ψοφέει ἐπὶ ὕδατι ὕδωρ.	-- - uu- uu- uu -uu --	dactylic hexameter	masculine penthemimeral, hepthemimeral, trithemimeral
δή ποτε καὶ γενεαὶ κοράκων καὶ φῦλα κολοιῶν	- uu - uu- uu- - -u u--	dactylic hexameter	masculine penthemimeral, hepthemimeral, trithemimeral
ὕδατος ἐρχομένοιο Διὸς πάρα σῆμ᾽ ἐγένοντο,	-uu -uu-u u- uu - uu--	dactylic hexameter	feminine penthemimeral, hepthemimeral
φαινόμενοι ἀγεληδὰ καὶ ἱρήκεσσιν ὁμοῖον	-uu- uu-u u ---u u--	dactylic hexameter	feminine penthemimeral, trithemimeral
φθεγξάμενοι. καί που κόρακες δίους σταλαγμοὺς	-uu- - - uu- -- ---	dactylic hexameter	masculine penthemimeral, hepthemimeral, trithemimeral
φωνῇ ἐμιμήσαντο σὺν ὕδατος ἐρχομένοιο·	-u u---u u -uu -uu--	dactylic hexameter	feminine penthemimeral
ἤ ποτε καὶ κρώξαντε βαρείῃ δισσάκι φωνῇ	- uu - --u u-- -uu --	dactylic hexameter	feminine penthemimeral, trithemimeral
μακρὸν ἐπιρροιζεῦσι τιναξάμενοι πτερὰ πυκνά·	-u u---u u-uu- uu --	dactylic hexameter	feminine penthemimeral
καὶ νῆσσαι οἰκουροὶ ὑπωρόφιοί τε κολοιοὶ	- -- --u u-uu- u u--	dactylic hexameter	feminine penthemimeral, trithemimeral
ἐρχόμενοι κατὰ γεῖσα τινάσσονται πτερύγεσσιν,	-uu- uu -u u--- uu--	dactylic hexameter	feminine penthemimeral, trithemimeral
ἢ ἐπὶ κῦμα διώκει ἐρωδιὸς ὀξὺ λεληκώς.	- uu -u u-u u-uu -u u--	dactylic hexameter	feminine penthemimeral
τῶν τοι μηδέν ἀπόβλητον πεφυλαγμένῳ ὕδωρ	- - -u u--- uu-uu --	dactylic hexameter	hepthemimeral
γινέσθω· μηδ᾽ εἴ κεν ἐπὶ πλέον ἠὲ πάροιθεν	--- - - u u- uu -u u--	dactylic hexameter	masculine penthemimeral, hepthemimeral, trithemimeral
δάκνωσιν μυῖαι καὶ ἐφ᾽ αἵματος ἱμείρωνται,	--- -- u u -uu ----	dactylic hexameter	masculine penthemimeral, trithemimeral
ἢ λύχνοιο μύκητες ἀγείρωνται περὶ μύξαν	- --u u-u u--- uu --	dactylic hexameter	feminine penthemimeral
νύκτα κατὰ σκοτίην· μηδ᾽ ἢν ὑπὸ χείματος ὥρην	-u u- uu- - - uu -uu --	dactylic hexameter	masculine penthemimeral, hepthemimeral, trithemimeral
λύχνων ἄλλοτε μέν τε φάος κατά κόσμον ὀρώρῃ,	-- -uu - u u- uu -u u--	dactylic hexameter	masculine penthemimeral, hepthemimeral
ἄλλοτε δ᾽ἀΐσσωσιν ἄπο φλόγες ἠΰτε κοῦφαι	-uu ---u u- uu -uu --	dactylic hexameter	feminine penthemimeral, hepthemimeral
πομφόλυγες, μηδ᾽ εἴ κεν ἐπ᾽ αὐτόφι μαρμαίρωσιν	-uu- - - u u -uu ----	dactylic hexameter	masculine penthemimeral, trithemimeral
ἀκτῖνες, μηδ᾽ ἢν θέρεος μέγα πεπταμένοιο	--- - - uu- uu -uu--	dactylic hexameter	masculine penthemimeral, hepthemimeral, trithemimeral
νησαῖοι ὄρνιθες ἐπασσύτεροι φορέωνται.	--- --u u-uu- uu--	dactylic hexameter	feminine penthemimeral, trithemimeral
μηδὲ σύ γ᾽ἢ χύτρης ἠὲ τρίποδος πυριβήτεω,	-u u - -- -- uu- uu--	dactylic hexameter	masculine penthemimeral, hepthemimeral, trithemimeral
σπινθῆρες ὅτ᾽ ἔωσι πέρι πλέονες, λελαθέσθαι·	--- u u-u u- uu- uu--	dactylic hexameter	feminine penthemimeral, hepthemimeral, trithemimeral
μηδὲ κατὰ σποδιὴν ὁπότ᾽ ἄνθρακος αἰθομένοιο	-u u- uu- uu -uu -uu--	dactylic hexameter	masculine penthemimeral, trithemimeral
λάμπηται πέρι σήματ᾽ ἐοικότα κεγχρείοισιν,	--- uu -u u-uu ----	dactylic hexameter	feminine penthemimeral, trithemimeral
ἀλλ᾽ ἐπὶ καὶ τὰ δόκευε περισκοπέων ὑετοῖο.	- uu - u u-u u-uu- uu--	dactylic hexameter	feminine penthemimeral, trithemimeral
εἴ γε μὲν ἠερόεσσα παρὲξ ὄρεος μεγάλοιο	- u u -uu-u u- uu- uu--	dactylic hexameter	feminine penthemimeral, hepthemimeral
πυθμένα τείνηται νεφέλη, ἄκραι δὲ κολῶναι	-uu --- uu- -- u u--	dactylic hexameter	masculine penthemimeral, hepthemimeral
φαίνωνται καθαραί, μάλα κεν τόθ᾽ ὑπεύδιος εἴης.	--- uu- uu - u u-uu --	dactylic hexameter	masculine penthemimeral, hepthemimeral, trithemimeral
εὔδιός κ᾽εἴης καί ὅτε πλατέος παρὰ πόντου	--- -- u u- uu- uu --	dactylic hexameter	masculine penthemimeral, hepthemimeral, trithemimeral
φαίνηται χθαμαλὴ νεφέλη, μηδ᾽ ὑψόθι κύρῃ,	--- uu- uu- - -uu --	dactylic hexameter	masculine penthemimeral, hepthemimeral, trithemimeral
ἀλλ᾽ αὐτοῦ πλαταμῶνι παραθλίβηται ὁμοίη.	- -- uu-u u---u u--	dactylic hexameter	feminine penthemimeral, trithemimeral
σκέπτεο δ᾽εὔδιος μὲν ἐὼν ἐπὶ χείματι μᾶλλον,	-uu --- u u- uu -uu --	dactylic hexameter	masculine penthemimeral, hepthemimeral
ἐς δὲ γαληναίην χειμωνόθεν. εὖ δὲ μάλα χρὴ	- u u--- --uu - u u- -	dactylic hexameter	masculine penthemimeral
ἐς Φάτνην ὁράᾳν, τὴν Καρκίνος ἀμφιελίσσει,	- -- uu- - -uu -uu--	dactylic hexameter	masculine penthemimeral, trithemimeral
πρῶτα καθαιρομένην πάσης ὑπένερθεν ὁμίχλης·	-u u-uu- -- uu-u u--	dactylic hexameter	masculine penthemimeral, hepthemimeral
κείνη γὰρ φθίνοντι καθαίρεται ἐν χειμῶνι.	-- - --u u-uu - ---	dactylic hexameter	feminine penthemimeral, trithemimeral
καὶ φλόγες ἡσύχιαι λύχνων καὶ νυκτερίη γλαὺξ	- uu -uu- -- - -uu- -	dactylic hexameter	masculine penthemimeral, hepthemimeral
ἥσυχον ἀείδουσα μαραινομένου χειμῶνος	-uu ---u u-uu- ---	dactylic hexameter	feminine penthemimeral
γινέσθω τοι σῆμα, καὶ ἥσυχα ποικίλλουσα	--- - -u u -uu ----	dactylic hexameter	feminine penthemimeral, trithemimeral
ὥρῃ ἐν ἑσπερίῃ κρώξῃ πολύφωνα κορώνη·	-u u -uu- -- uu-u u--	dactylic hexameter	masculine penthemimeral, hepthemimeral
καὶ κόρακες μοῦνοι μὲν ἐρημαῖοι βοοῶντες	- uu- -- u u--- uu--	dactylic hexameter	masculine penthemimeral, trithemimeral
δισσάκις, αὐτὰρ ἔπειτα μετ᾽ ἀθρόα κεκλήγοντες·	-uu -u u-u u -uu ----	dactylic hexameter	feminine penthemimeral
πλειότεροι δ᾽ἀγεληδόν, ἐπὴν κοίτοιο μέδωνται,	-uu- uu-u u- --u u--	dactylic hexameter	feminine penthemimeral, hepthemimeral, trithemimeral
φωνῆς ἔμπλειοι· χαίρειν κέ τις οἰίσσαιτο,	-- --- -- u u ----	dactylic hexameter	masculine penthemimeral, hepthemimeral
οἷα τὰ μὲν βοόωσι λιγαινομένοισιν ὁμοῖα,	-u u - uu-u u-uu-u u--	dactylic hexameter	feminine penthemimeral, trithemimeral
πολλὰ δὲ δενδρείοιο περὶ φλόον, ἄλλοτ᾽ ἐπ᾽ αὐτοῦ,	-u u ---u u- uu -u u --	dactylic hexameter	feminine penthemimeral, hepthemimeral
ἧχί τε κείουσιν καὶ ὑπότροποι ἀπτερύονται.	-u u --- u u-uu -uu--	dactylic hexameter	masculine penthemimeral
καὶ δ᾽ἄν που γέρανοι μαλακῆς προπάροιθε γαλήνης	- - - uu- uu- uu-u u--	dactylic hexameter	masculine penthemimeral, hepthemimeral, trithemimeral
ἀσφαλέως τανύσαιεν ἕνα δρόμον ἤλιθα πᾶσαι,	-uu- uu-u u- uu -uu --	dactylic hexameter	feminine penthemimeral, hepthemimeral, trithemimeral
οὐδὲ παλιρρόθιοί κεν ὑπεύδιοι φορέοιντο.	-u u-uu- u u--- uu--	dactylic hexameter	masculine penthemimeral
ἦμος δ᾽ἀστερόθεν καθαρὸν φὰος ἀμβλύνηται,	-- -uu- uu- uu ----	dactylic hexameter	masculine penthemimeral, hepthemimeral
οὐδέ ποθεν νεφέλαι πεπιεσμέναι ἀντιόωσιν,	-u u- uu- uu-uu -uu--	dactylic hexameter	masculine penthemimeral, trithemimeral
οὐδέ ποθεν ζόφος ἄλλος ὑποτρέχῃ οὐδὲ σελήνη,	-u u- uu -u u-uu -u u--	dactylic hexameter	feminine penthemimeral, trithemimeral
ἀλλὰ τά γ᾽ἐξαπίνης αὕτως ἀμενηνὰ φέρωνται,	-u u -uu- -- uu-u u--	dactylic hexameter	masculine penthemimeral, hepthemimeral
μηκέτι τοι τόδε σῆμα γαληναίης ἐπικείσθω,	-uu - uu -u u--- uu--	dactylic hexameter	feminine penthemimeral, trithemimeral
ἀλλ᾽ ἐπὶ χεῖμα δόκευε· καὶ ὁππότε ταὶ μὲν ἔωσιν	- uu -u u-u u -uu - u u--	dactylic hexameter	feminine penthemimeral
αὐτῇ ἐνὶ χώρῃ νεφέλαι, ταὶ δ᾽ἄλλαι ὑπ᾽ αὐταῖς	-u u- -- uu- - -u u --	dactylic hexameter	masculine penthemimeral, hepthemimeral, trithemimeral
ταὶ μὲν ἀμειβόμεναι, ταὶ δ᾽ἐξόπιθεν φορέωνται.	- u u-uu- - -uu- uu--	dactylic hexameter	masculine penthemimeral
καὶ χῆνες κλαγγηδὸν ἐπειγόμεναι βρωμοῖο	- -- --u u-uu- ---	dactylic hexameter	feminine penthemimeral, trithemimeral
χειμῶνος μέγα σῆμα, καὶ ἐννεάγηρα κορώνη	--- uu -u u -uu-u u--	dactylic hexameter	feminine penthemimeral, trithemimeral
νύκτερον ἀείδουσα, καὶ ὀψὲ βοῶντε κολοιοί,	-uu ---u u -u u-u u--	dactylic hexameter	feminine penthemimeral
καὶ σπίνος ἠῶα σπίζων, καὶ ὄρνεα πάντα	- uu --- -- - -uu --	dactylic hexameter	masculine penthemimeral, hepthemimeral
ἐκ πελάγους φεύγοντα, καὶ ὀρχίλος ἢ καὶ ἐριθεὺς	- uu- --u u -uu - u u--	dactylic hexameter	feminine penthemimeral, trithemimeral
δύνων ἐς κοίλας ὀχεάς, καὶ φῦλα κολοιῶν	-- - -- uu- - -u u--	dactylic hexameter	masculine penthemimeral, hepthemimeral, trithemimeral
ἐκ νομοῦ ἐρχόμενα τραφεροῦ ἐπὶ ὄψιον αὖλιν.	- uu -uu- uu- uu -uu --	dactylic hexameter	masculine penthemimeral, hepthemimeral
οὐδ᾽ ἂν ἐπιξουθαὶ μεγάλου χειμῶνος ἰόντος	- u u--- uu- --u u--	dactylic hexameter	masculine penthemimeral, hepthemimeral
πρόσσω ποιήσαιντο νομὸν κηροῖο μέλισσαι,	-- ---u u- --u u--	dactylic hexameter	feminine penthemimeral, hepthemimeral
ἀλλ᾽ αὐτοῦ μέλιτός τε καὶ ἔργων εἱλίσσονται·	- -- uu- u u -- ----	dactylic hexameter	masculine penthemimeral, trithemimeral
οὐδ᾽ ὑψοῦ γεράνων μακραὶ στίχες αὐτὰ κέλευθα	- -- uu- -- uu -u u--	dactylic hexameter	masculine penthemimeral, hepthemimeral, trithemimeral
τείνονται, στροφάδες δὲ παλιμπετὲς ἀπονέονται.	--- uu- u u-uu -uu--	dactylic hexameter	masculine penthemimeral, trithemimeral
μηδ᾽, ὅτε νηνεμίῃ κεν ἀράχνια λεπτὰ φέρητἁ̣̣̓,	- uu -uu- u u-uu -u u--	dactylic hexameter	masculine penthemimeral
καὶ φλόγες αἰθύσσωσι μαραινόμεναι λύχνοιο,	- uu ---u u-uu- ---	dactylic hexameter	feminine penthemimeral
ἢ πῦρ αὔηται σπουδῇ καὶ ὑπεύδια λύχνα,	- - --- -- u u-uu --	dactylic hexameter	masculine penthemimeral, hepthemimeral
πιστεύειν χειμῶνι. τί τοι λέγω ὅσσα πέλονται	--- --u u - uu -u u--	dactylic hexameter	feminine penthemimeral, hepthemimeral, trithemimeral
σήματ᾽ ἐπ᾽ ἀνθρώπους; δὴ γὰρ καὶ ἀεικέϊ τέθρῃ	-u u --- - - u u-uu --	dactylic hexameter	masculine penthemimeral, hepthemimeral
αὐτοῦ πηγνυμένῃ νιφετοῦ ἐπιτεκμήραιο,	-- -uu- uu- uu----	dactylic hexameter	masculine penthemimeral, hepthemimeral
καὶ λύχνῳ χιόνος, κέγχροις ὅτ᾽ ἐοικότα πάντη	- -- uu- -- u u-uu --	dactylic hexameter	masculine penthemimeral, hepthemimeral, trithemimeral
κύκλῳ σήματ᾽ ἔχει πυριλαμπέος έγγύθι μύξης,	-- -u u- uu-uu -uu --	dactylic hexameter	masculine penthemimeral
ἄνθρακι δὲ ζώοντι χαλάζης, ὁππότε λαμπρὸς	-uu - --u u-- -uu --	dactylic hexameter	feminine penthemimeral, trithemimeral
αὐτὸς ἐείδηται, μέσσῳ δέ οἱ ἠΰτε λεπρὴ	-u u--- -- u u -uu --	dactylic hexameter	masculine penthemimeral, hepthemimeral
φαίνηται νεφέλη, πυρὸς ἔνδοθεν αἰθομένοιο.	--- uu- uu -uu -uu--	dactylic hexameter	masculine penthemimeral, trithemimeral
πρῖνοι δ᾽αὖ καρποῖο καταχθέες οὐδὲ μέλαιναι	-- - --u u-uu -u u--	dactylic hexameter	feminine penthemimeral, trithemimeral
σχῖνοι ἀπείρητοι· πάντη δέ τε πολλὸς ἀλωεὺς	-u u--- -- u u -u u--	dactylic hexameter	masculine penthemimeral, hepthemimeral
αἰεὶ παπταίνει, μή οἱ θέρος ἐκ χερὸς ἔρρῃ.	-- --- - - uu - uu --	dactylic hexameter	masculine penthemimeral, hepthemimeral
πρῖνοι μὲν θαμινῆς ἀκύλου κατὰ μέτρον ἔχουσαι	-- - uu- uu- uu -u u--	dactylic hexameter	masculine penthemimeral, hepthemimeral, trithemimeral
χειμῶνός κε λέγοιεν ἐπὶ πλέον ἰσχύσοντος.	--- u u-u u- uu ----	dactylic hexameter	feminine penthemimeral, hepthemimeral, trithemimeral
μὴ μὲν ἄδην ἔκπαγλα περιβρίθοιεν ἁπάντη,	- u u- --u u---u u--	dactylic hexameter	feminine penthemimeral, trithemimeral
τηλοτέρω δ᾽αὐχμοῖο συνασταχύοιεν ἄρουραι.	-uu- --u u-uu-u u--	dactylic hexameter	feminine penthemimeral, trithemimeral
τριπλόα δὲ σχῖνος κυέει, τρισσαὶ δέ οἱ αὖξαι	-uu - -- uu- -- u u --	dactylic hexameter	masculine penthemimeral, hepthemimeral, trithemimeral
γίνονται καρποῖο, φέρει δέ τε σήμαθ᾽ ἑκάστη	--- --u u- u u -u u--	dactylic hexameter	feminine penthemimeral, hepthemimeral, trithemimeral
ἑξείης ἀρότῳ. καὶ γάρ τ᾽ἀροτήσιον ὥρην	--- uu- - - uu-uu --	dactylic hexameter	masculine penthemimeral, hepthemimeral, trithemimeral
τριπλόα μείρονται, μέσσην καὶ ἐπ᾽ ἀμφότερ᾽ ἄκρα·	-uu --- -- u u -uu --	dactylic hexameter	masculine penthemimeral, hepthemimeral
πρῶτος μὲν πρώτην ἄροσιν, μέσσος δέ τε μέσσην	-- - -- uu- -- u u --	dactylic hexameter	masculine penthemimeral, hepthemimeral, trithemimeral
καρπὸς ἀπαγγέλλει, πυμάτην γε μὲν ἔσχατος ἄλλων.	-u u--- uu- u u -uu --	dactylic hexameter	masculine penthemimeral, hepthemimeral
ὅντινα γὰρ κάλλιστα λοχαίη σχῖνος ἄρηται,	-uu - --u u-- -u u--	dactylic hexameter	feminine penthemimeral, trithemimeral
κείνῳ γ᾽ἐξ ἄλλων ἄροσις πολυλήϊος εἴη,	-- - -- uu- uu-uu --	dactylic hexameter	masculine penthemimeral, hepthemimeral, trithemimeral
τῷ δέ γ᾽ἀφαυροτάτῳ ὀλίγη, μέσσῳ δέ τε μέσση.	- u u-uu- uu- -- u u --	dactylic hexameter	masculine penthemimeral, hepthemimeral
αὕτως δ᾽ἀνθέρικος τριχθὰ σκίλλης ὑπερανθεῖ	-- -uu- -- -- uu--	dactylic hexameter	masculine penthemimeral, hepthemimeral
σήματ᾽ ἐπιφράσσασθαι ὁμοιίου ἀμητοῖο.	-u u---u u-uu ----	dactylic hexameter	feminine penthemimeral
ὅσσα δ᾽ἐνὶ σχίνου ἀροτὴρ ἐφράσσατο καρπῷ,	-u u- uu --- --uu --	dactylic hexameter	hepthemimeral, trithemimeral
τόσσα δὲ καὶ σκίλλης τεκμαίρεται ἄνθεϊ λευκῷ.	-u u - -- --uu -uu --	dactylic hexameter	masculine penthemimeral, trithemimeral
αὐτὰρ ὅτε σφῆκες μετοπωρινὸν ἤλιθα πολλοὶ	-u u- -- uu-uu -uu --	dactylic hexameter	masculine penthemimeral, trithemimeral
πάντη βεβρίθωσι, καὶ ἑσπαρίων προπάροιθεν	-- ---u u -uu- uu--	dactylic hexameter	feminine penthemimeral
πληϊάδων εἴποι τις ἐπερχόμενον χειμῶνα,	-uu- -- u u-uu- ---	dactylic hexameter	masculine penthemimeral, trithemimeral
οἷος ἐπὶ σφήκεσσιν ἑλίσσεται αὐτίκα δῖνος.	-u u- --u u-uu -uu --	dactylic hexameter	feminine penthemimeral, trithemimeral
θήλειαι δὲ σύες, θήλεια δὲ μῆλα καὶ αἶγες	--- u u- --u u -u u --	dactylic hexameter	masculine penthemimeral, trithemimeral
ὁππότ᾽ ἀναστρωφῶσιν ὀχῆς, τὰ δέ γ᾽ἄρσενα πάντα	-u u---u u- u u -uu --	dactylic hexameter	feminine penthemimeral, hepthemimeral
δεξάμεναι πάλιν αὖτις ἀναβλήδην ὀχέωνται,	-uu- uu -u u--- uu--	dactylic hexameter	feminine penthemimeral, trithemimeral
αὕτως κε σφήκεσσι μέγαν χειμῶνα λέγοιεν.	-- - --u u- --u u--	dactylic hexameter	feminine penthemimeral, hepthemimeral, trithemimeral
ὀψὲ δὲ μισγομένων αἰγῶν μήλων τε συῶν τε	-u u -uu- -- -- u u- -	dactylic hexameter	masculine penthemimeral, hepthemimeral
χαίρει ἄνολβος ἀνήρ, ὅ οἱ οὐ μάλα θαλπιόωντι	-u u-u u- u u - uu -uu--	dactylic hexameter	masculine penthemimeral, hepthemimeral
εὔδιον φαίνουσι βιβαιόμεναι ἐνιαυτόν.	--- --u u-uu- uu--	dactylic hexameter	feminine penthemimeral, trithemimeral
χαίρει καὶ γεράνων ἀγέλαις ὡραῖος ἀροτρεὺς	-- - uu- uu- --u u--	dactylic hexameter	masculine penthemimeral, hepthemimeral, trithemimeral
ὥριον ἐρχομέναις, ὁ δ᾽ἀώριος αὐτίκα μᾶλλον·	-uu -uu- u u-uu -uu --	dactylic hexameter	masculine penthemimeral
αὕτως γὰρ χειμῶνες ἐπέρχονται γεράνοισιν·	-- - --u u--- uu--	dactylic hexameter	feminine penthemimeral, trithemimeral
πρώϊα μὲν καὶ μᾶλλον ὁμιλαδὸν ἐρχομένῃσιν	-uu - - -u u-uu -uu--	dactylic hexameter	feminine penthemimeral, trithemimeral
πρώιον· αὐτὰρ ὅτ᾽ ὀψὲ καὶ οὐκ ἀγεληδὰ φανεῖσαι	-uu -u u -u u - uu-u u--	dactylic hexameter	feminine penthemimeral, hepthemimeral
πλειότερον φορέονται ἐπὶ χρόνον οὐδ᾽ ἅμα πολλαί,	-uu- uu-u u- uu - uu --	dactylic hexameter	feminine penthemimeral, hepthemimeral, trithemimeral
ἀμβολίῃ χειμῶνος ὀφέλλεται ὕστερα ἔργα.	-uu- --u u-uu -uu --	dactylic hexameter	feminine penthemimeral, trithemimeral
εἰ δὲ βόες καὶ μῆλα μετὰ βρίθουσαν ὀπώρην	- u u- - -u u- --u u--	dactylic hexameter	feminine penthemimeral, hepthemimeral, trithemimeral
γαῖαν ἀρύσσωσιν, κεφαλὰς δ᾽ἀνέμοιο βορῆος	-u u--- uu- uu-u u--	dactylic hexameter	masculine penthemimeral, hepthemimeral
ἀντία τείνωσιν, μάλα κεν τότε χείμερον αὐταὶ	-uu --- uu - uu -uu --	dactylic hexameter	masculine penthemimeral, hepthemimeral
Πληϊάδες χειμῶνα κατερχόμεναι φορέοιεν.	-uu- --u u-uu- uu--	dactylic hexameter	feminine penthemimeral, trithemimeral
μὴ δὲ λίην ὀρύχοιεν· ἐπεὶ μέγας οὐ κατὰ κόσμον	- u u- uu-u u- uu - uu --	dactylic hexameter	feminine penthemimeral, hepthemimeral, trithemimeral
γίνεται οὔτε φυτοῖς χειμὼν φίλος οὔτ᾽ ἀρότοισιν.	-uu -u u- -- uu - uu--	dactylic hexameter	masculine penthemimeral, hepthemimeral
ἀλλὰ χιὼν εἴη πολλὴ μεγάλαις ἐν ἀρούραις,	-u u- -- -- uu- u u--	dactylic hexameter	masculine penthemimeral, hepthemimeral, trithemimeral
μήπω κεκριμένῃ μηδὲ βλωθρῇ ἐπὶ ποίῃ,	-- -uu- -- -- uu --	dactylic hexameter	masculine penthemimeral, hepthemimeral
ὄφρα τις εὐεστοῖ χαίρῃ ποτιδέγμενος ἀνήρ.	-u u --- -- uu-uu --	dactylic hexameter	masculine penthemimeral, hepthemimeral
οἱ δ᾽εἶεν καθύπερθεν ἐοικότες ἀστέρες αἰεί·	- -- uu-u u-uu -uu --	dactylic hexameter	feminine penthemimeral, trithemimeral
μηδ᾽ εἷς μήτε δύω μήτε πλέονες κομόωντες·	- - -u u- -- uu- uu--	dactylic hexameter	masculine penthemimeral, hepthemimeral
πολλοὶ γὰρ κομόωσιν ἐπ᾽ αὐχμηρῷ ἐνιαυτῷ.	-- - uu-u u --- uu--	dactylic hexameter	feminine penthemimeral, trithemimeral
οὐδὲ μὲν ὀρνίθων ἀγέλαις ἠπειρόθεν ἀνήρ,	-u u --- uu- --uu --	dactylic hexameter	masculine penthemimeral, hepthemimeral
ἐκ νήσων ὅτε πολλαὶ ἐπιπλήσσωσιν ἀρούραις,	- -- uu -u u---u u--	dactylic hexameter	feminine penthemimeral, trithemimeral
ἐρχομένου θέρεος χαίρει· περιδείδιε δ᾽αἰνῶς	-uu- uu- -- uu-uu --	dactylic hexameter	masculine penthemimeral, hepthemimeral, trithemimeral
ἀμητῷ, μή οἱ κενεὸς καὶ ἀχύρμιος ἔλθῃ	--- - - uu- u u-uu --	dactylic hexameter	masculine penthemimeral, hepthemimeral, trithemimeral
αὐχμῷ ἀνιηθείς. χαίρει δέ που αἰπόλος ἀνὴρ	-u u--- -- u u -uu --	dactylic hexameter	masculine penthemimeral, hepthemimeral
αὐταῖς ὀρνίθεσσιν, ἐπὴν κατὰ μέτρον ἴωσιν,	-- ---u u- uu -u u--	dactylic hexameter	feminine penthemimeral, hepthemimeral
ἐλπόμενος μετέπειτα πολυγλαγέος ἐνιαυτοῦ.	-uu- uu-u u-uu- uu--	dactylic hexameter	feminine penthemimeral, trithemimeral
οὕτω γὰρ μογεροὶ καὶ ἀλήμονες ἄλλοθεν ἄλλοι	-- - uu- u u-uu -uu --	dactylic hexameter	masculine penthemimeral, trithemimeral
ζώομεν ἄνθρωποι. τὰ δὲ πὰρ ποσὶ πάντες ἑτοῖμοι	-uu --- u u - uu -u u--	dactylic hexameter	masculine penthemimeral, hepthemimeral
σήματ᾽ ἐπιγνῶναι καὶ ἐσαυτίκα ποιήσασθαι.	-u u--- u u-uu ----	dactylic hexameter	masculine penthemimeral
Ἀρνάσι μὲν χειμῶνας ἐτεκμήραντο νομῆες,	-uu - --u u---u u--	dactylic hexameter	feminine penthemimeral, trithemimeral
ἐς νομὸν ὁππότε μᾶλλον ἐπειγόμενοι τροχόωσιν,	- uu -uu -u u-uu- uu--	dactylic hexameter	feminine penthemimeral
ἄλλοι δ᾽ἐξ ἀγέλης κριοί, ἄλλοι δὲ καὶ ἀμνοὶ	-- - uu- -- -- u u --	dactylic hexameter	masculine penthemimeral, hepthemimeral, trithemimeral
εἰνόδιοι παίζωσιν ἐρειδόμενοι κεράεσσιν·	-uu- --u u-uu- uu--	dactylic hexameter	feminine penthemimeral, trithemimeral
ἢ ὁπότ᾽ ἄλλοθεν ἄλλοι ἀναπλήσσωσι πόδεσσιν	- uu -uu -u u---u u--	dactylic hexameter	feminine penthemimeral
τέτρασιν οἱ κοῦφοι, κεραοί γε μὲν ἀμφοτέροισιν·	-uu - -- uu- u u -uu--	dactylic hexameter	masculine penthemimeral, hepthemimeral, trithemimeral
ἢ καὶ ὅτ᾽ ἐξ ἀγἐλης ἀεκούσια κινήσωσιν	- u u - uu- uu-uu ----	dactylic hexameter	masculine penthemimeral, trithemimeral
δείελον εἰσελάοντες ὅμως, τὰ δὲ πάντοθι ποίης	-uu -uu-u u- u u -uu --	dactylic hexameter	feminine penthemimeral, hepthemimeral
δάκνωσιν πυκινῇσι κελευόμενα λιθάκεσσιν.	--- uu-u u-uu- uu--	dactylic hexameter	feminine penthemimeral, trithemimeral
ἐκ δὲ βοῶν ἐπύθοντ᾽ ἀρόται καὶ βουκόλοι ἄνδρες	- u u- uu- uu- - -uu --	dactylic hexameter	masculine penthemimeral, hepthemimeral, trithemimeral
κινυμένου χειμῶνος· ἐπεὶ βόες ὁππότε χηλὰς	-uu- --u u- uu -uu --	dactylic hexameter	feminine penthemimeral, hepthemimeral, trithemimeral
γλώσσῃ ὑπωμαίοιο ποδὸς περιλιχμήσωνται,	-u u---u u- uu----	dactylic hexameter	feminine penthemimeral, hepthemimeral
ἢ κοίτῳ πλευρὰς ἐπὶ δεξιτερὰς τανύσωνται,	- -- -- uu -uu- uu--	dactylic hexameter	masculine penthemimeral, trithemimeral
ἀμβολίην ἀρότοιο γέρων ἐπιέλπετ᾽ ἀροτρεύς.	-uu- uu-u u- uu-u u--	dactylic hexameter	feminine penthemimeral, hepthemimeral, trithemimeral
οὐδ᾽ ὅτε μυκηθμοῖο περίπλειοι ἀγέρωνται	- uu ---u u--- uu--	dactylic hexameter	feminine penthemimeral
ἐρχόμεναι σταθμόνδε βόες βουλύσιον ὥρην,	-uu- --u u- --uu --	dactylic hexameter	feminine penthemimeral, hepthemimeral, trithemimeral
σκυθραὶ λειμῶνος πόριες καὶ βουβοσίοιο	-- --- uu- - -uu--	dactylic hexameter	masculine penthemimeral, hepthemimeral
αὐτίκα τεκμαίρονται ἀχείμεροι ἐμπλήσεσθαι.	-uu ---u u-uu ----	dactylic hexameter	feminine penthemimeral
οὐδ᾽ αἶγες πρίνοιο περισπεύδουσαι ἀκάνθαις	- -- --u u---u u--	dactylic hexameter	feminine penthemimeral, trithemimeral
εὔδιοι, οὐδὲ σύες φορυτῷ ἐπιμαργαίνουσαι.	-uu -u u- uu- uu----	dactylic hexameter	masculine penthemimeral, hepthemimeral
καὶ λύκος ὁππότε μακρὰ μονόλυκος ὠρύηται,	- uu -uu -u u-uu ----	dactylic hexameter	feminine penthemimeral
ἢ ὅγ᾽ ἀροτρήων ὀλίγον πεφυλαγμένος ἀνδρῶν	- u u--- uu- uu-uu --	dactylic hexameter	masculine penthemimeral, hepthemimeral
ἔργα κατέρχηται, σκέπαος χατέοντι ἐοικώς,	-u u--- uu- uu-u u--	dactylic hexameter	masculine penthemimeral, hepthemimeral
ἐγγύθεν ἀνθρώπων, ἵνα οἱ λέχος αὐτόθεν εἴη,	-uu --- uu - uu -uu --	dactylic hexameter	masculine penthemimeral, hepthemimeral
τρὶς περιτελλομένης ἠοῦς χειμῶνα δοκεύειν.	- uu-uu- -- --u u--	dactylic hexameter	masculine penthemimeral, hepthemimeral
οὕτω καὶ προτέροις ἐπὶ σήμασι τεκμήραιο	-- - uu- uu -uu ----	dactylic hexameter	masculine penthemimeral, trithemimeral
ἐσσομένων ἀνέμων ἢ χείματος ἢ ὑετοῖο,	-uu- uu- - -uu - uu--	dactylic hexameter	masculine penthemimeral, trithemimeral
αὐτὴν ἢ μετὰ τὴν ἢ καὶ τριτάτην ἔτ᾽ ἐς ἠῶ.	-- - uu - - - uu- u u --	dactylic hexameter	masculine penthemimeral, hepthemimeral, trithemimeral
ἀλλὰ γὰρ οὐδὲ μύες, τετριγότες εἴ ποτε μᾶλλον	-u u -u u- --uu - uu --	dactylic hexameter	masculine penthemimeral
εὔδιοι ἐσκίρτησαν ἐοικότες ὀρχηθμοῖσιν,	-uu ---u u-uu ----	dactylic hexameter	feminine penthemimeral
ἄσκεπτοι ἐγένοντο παλαιοτέροις ἀνθρώποις·	--- uu-u u-uu- ---	dactylic hexameter	feminine penthemimeral, trithemimeral
οὐδὲ κύνες· καὶ γάρ τε κύων ὠρύξατο ποσσὶν	-u u- - - u u- --uu --	dactylic hexameter	masculine penthemimeral, hepthemimeral, trithemimeral
ἀμφοτέροις χειμῶνος ἐπερχομένοιο δοκεύων,	-uu- --u u-uu-u u--	dactylic hexameter	feminine penthemimeral, trithemimeral
καὶ κεῖνοι χειμῶνα μύες τότε μαντεύονται.	- -- --u u- uu ----	dactylic hexameter	feminine penthemimeral, hepthemimeral, trithemimeral
καὶ μὴν ἐξ ὕδατος καὶ καρκίνος ᾤχετο χέρσον,	- - - uu- - -uu -uu --	dactylic hexameter	masculine penthemimeral, trithemimeral
χειμῶνος μέλλοντος ἐπαΐσσεσθαι ὁδοῖο.	--- --u u---u u--	dactylic hexameter	feminine penthemimeral, trithemimeral
καὶ μύες ἡμέριοι ποσσὶ στιβάδα στρωφῶντες	- uu -uu- -- uu- ---	dactylic hexameter	masculine penthemimeral, hepthemimeral
κοίτης ἱμείρονται, ὅτ᾽ ὄμβρου σήματα φαίνοι.	-- ---u u -- -uu --	dactylic hexameter	feminine penthemimeral
τῶν μηδὲν κατόνοσσο· καλὸν δ᾽ἐπὶ σήματι σῆμα	- -- uu-u u- uu -uu --	dactylic hexameter	feminine penthemimeral, hepthemimeral, trithemimeral
σκέπτεσθαι· μᾶλλον δὲ δυοῖν εἰς ταὐτὸν ἰόντων	--- -- u u- - -u u--	dactylic hexameter	masculine penthemimeral, hepthemimeral, trithemimeral
ἐλπωρὴ τελέθοι, τριτάτῳ δέ κε θαρσήσειας.	--- uu- uu- u u ----	dactylic hexameter	masculine penthemimeral, hepthemimeral, trithemimeral
αἰεὶ δ᾽ἂν παριόντος ἀριθμοίης ἐνιαυτοῦ	-- - uu-u u--- uu--	dactylic hexameter	feminine penthemimeral, trithemimeral
σήματα, συμβάλλων εἴ που καὶ ἐπ᾽ ἀστέρι τοίη	-uu --- - - u u -uu --	dactylic hexameter	masculine penthemimeral, hepthemimeral
ἠὼς ἀντέλλοντι φαείνεται ἢ κατιόντι,	-- ---u u-uu - uu--	dactylic hexameter	feminine penthemimeral
ὁπποίην καὶ σῆμα λέγοι, μάλα δ᾽ἄρκιον εἴη	--- - -u u- uu -uu --	dactylic hexameter	feminine penthemimeral, hepthemimeral, trithemimeral
φράζεσθαι φθίνοντος ἐφισταμένοιό τε μηνὸς	--- --u u-uu-u u --	dactylic hexameter	feminine penthemimeral, trithemimeral
τετράδας ἀμφοτέρας· αἱ γάρ τ᾽ἄμυδις συνιόντων	-uu -uu- - - uu- uu--	dactylic hexameter	masculine penthemimeral, hepthemimeral
μηνῶν πείρατ᾽ ἔχουσιν, ὅτε σφαλερώτερος αἰθὴρ	-- -u u-u u- uu-uu --	dactylic hexameter	feminine penthemimeral, hepthemimeral
ὀκτὼ νυξὶ πέλει, χήτει χαροποῖο σελήνης.	-- -u u- -- uu-u u--	dactylic hexameter	masculine penthemimeral, hepthemimeral
τῶν ἄμυδις πάντων ἐσκεμμένος εἰς ἐνιαυτὸν	- uu- -- --uu - uu--	dactylic hexameter	masculine penthemimeral, trithemimeral
οὐδέποτε σχεδίως κεν ἐπ᾽ αἰθέρι τεκμήραιο.	-uu- uu- u u -uu ----	dactylic hexameter	masculine penthemimeral, trithemimeral
