Ἀρχόμενος πρώτης σελίδος χορὸν ἐξ Ἑλικῶνος	-uu- -- uu- uu - uu--	dactylic hexameter	masculine penthemimeral, hepthemimeral, trithemimeral
ἐλδεῖν εἰς ἐμὸν ἧτορ ἐπεύχομαι εἵνεκ᾽ ἀοιδῆς,	-- - uu -u u-uu -u u--	dactylic hexameter	feminine penthemimeral, trithemimeral
ἣν νέον ἐν δέλτοισιν ἐμοῖς ἐπὶ γούνασι θῆκα,	- uu - --u u- uu -uu --	dactylic hexameter	feminine penthemimeral, hepthemimeral, trithemimeral
δῆριν ἀπειρεσίην, πολεμόκλονον ἔργον Ἄρηος,	-u u-uu- uu-uu -u u--	dactylic hexameter	masculine penthemimeral
εὐχόμενος μερόπεσσιν ἐς οὔατα πᾶσι βαλέσθαι	-uu- uu-u u -uu -u u--	dactylic hexameter	feminine penthemimeral, trithemimeral
πῶς μύες ἐν βατράχοισιν ἀριστεύσαντες ἔβησαν,	- uu - uu-u u---u u--	dactylic hexameter	feminine penthemimeral, trithemimeral
γηγενέων ἀνδρῶν μιμούμενοι ἔργα Γιγάντων,	-uu- -- --uu -u u--	dactylic hexameter	masculine penthemimeral, trithemimeral
ὡς λόγος ἐν θνητοῖσιν ἔην. τοίην δ᾽ἔχεν ἀρχήν·	- uu - --u u- -- uu --	dactylic hexameter	feminine penthemimeral, hepthemimeral, trithemimeral
Μῦς ποτε διψαλέος γαλέης κίνδυνον ἀλύξας	- uu -uu- uu- --u u--	dactylic hexameter	masculine penthemimeral, hepthemimeral
πλησίον ἐν λίμνῃ λίχνον παρέθηκε γένειον,	-uu - -- -- uu-u u--	dactylic hexameter	masculine penthemimeral, hepthemimeral, trithemimeral
ὕδατι τερπόμενος μελιηδέϊ· τὸν δὲ κατεῖδε	-uu -uu- uu-uu - u u--	dactylic hexameter	masculine penthemimeral
λιμνόχαρις πολύφημος, ἔπος δ᾽ἐφθέγξατο τοῖον·	-uu- uu-u u- --uu --	dactylic hexameter	feminine penthemimeral, hepthemimeral, trithemimeral
"Ξεῖνε τίς εἶ; πόδεν ἦλθες ἐπ᾽ ἠϊόνας; τίς ὁ φυσάς;	-u u - uu -u u -uu- u u --	dactylic hexameter	feminine penthemimeral, trithemimeral
πάντα δ᾽ἀλήθευσον, μὴ ψευδόμενόν σε νοήσω.	-u u--- - -uu- u u--	dactylic hexameter	masculine penthemimeral
εἰ γάρ σε γνοίην φίλον ἄξιον, ἐς δόμον ἄξω·	- - - -- uu -uu - uu --	dactylic hexameter	masculine penthemimeral, trithemimeral
δῶρα δέ τοι δώσω ξεινήϊα πολλὰ καὶ ἐσθλά.	-u u - -- --uu -u u --	dactylic hexameter	masculine penthemimeral, trithemimeral
εἰμὶ δ᾽ἐγὼ βασιλεὺς Φυσίγναθος, ὃς κατὰ λίμνην	-u u- uu- --uu - uu --	dactylic hexameter	masculine penthemimeral, trithemimeral
τιμῶμαι βατράχων ἡγούμενος ἤματα πάντα·	--- uu- --uu -uu --	dactylic hexameter	masculine penthemimeral, trithemimeral
καί με πατὴρ Πηλεὺς ἀνεδρέψατο, Ὑδρομεδούσῃ	- u u- -- uu-uu -uu--	dactylic hexameter	masculine penthemimeral, trithemimeral
μιχθεὶς ἐν φιλότητι παρ᾽ ὄχθας Ἠριδανοῖο.	-- - uu-u u -- -uu--	dactylic hexameter	feminine penthemimeral, trithemimeral
καὶ σὲ βλέπω καλόν τε καὶ ἄλκιμον ἔζοχον ἄλλων,	- u u- -- u u -uu -uu --	dactylic hexameter	masculine penthemimeral, trithemimeral
σκηπτοῦχον βασιλῆα καὶ ἐν πολέμοισι μαχητὴν	--- uu-u u - uu-u u--	dactylic hexameter	feminine penthemimeral, hepthemimeral, trithemimeral
ἔμμεναι· ἀλλ᾽ ἄγε θᾶσσον ἑὴν γενεὴν ἀγόρευε."	-uu - uu -u u- uu- uu--	dactylic hexameter	feminine penthemimeral, hepthemimeral, trithemimeral
Τὸν δ᾽αὖ Ψιχάρπαξ ἀπαμείβετο φώνησέν τε·	- - --- uu-uu --- -	dactylic hexameter	masculine penthemimeral
"Τίπτε γένος τοὐμὸν ζητεῖς; δῆλον δ᾽ἐν ἅπασιν	-u u- -- -- -- u u--	dactylic hexameter	masculine penthemimeral, hepthemimeral, trithemimeral
ἀνθρώποις τε θεοῖς τε καὶ οὐρανίοις πετεηυοῖς.	--- u u- u u -uu- uu--	dactylic hexameter	masculine penthemimeral, trithemimeral
Ψιχάρπαξ μὲν ἐγὼ κικλήσκομαι· εἰμὶ δὲ κοῦρος	--- u u- --uu -u u --	dactylic hexameter	masculine penthemimeral, trithemimeral
Τρωζάρταο πατρὸς μεγαλήτορος· ἡ δέ νυ μήτηρ	---u u- uu-uu - u u --	dactylic hexameter	masculine penthemimeral
Λειχομύλη, θυγάτηρ Πτερνοτρώκτου βασιλῆος.	-uu- uu- ---- uu--	dactylic hexameter	masculine penthemimeral, trithemimeral
γείνατο δ᾽ἐν καλύβῃ με καὶ ἔκρυψ᾽ ἐννεμέθεσθαι	-uu - uu- u u -- -uu--	dactylic hexameter	masculine penthemimeral, trithemimeral
σύκοις καὶ καρύοις καὶ ἐδέσμασι παντοδαποῖσιν.	-- - uu- u u-uu -uu--	dactylic hexameter	masculine penthemimeral, trithemimeral
πῶς δὲ φίλον ποιῇ με, τὸν ἐς φύσιν οὐδὲν ὁμοῖον;	- u u- -- u u - uu -u u--	dactylic hexameter	masculine penthemimeral, hepthemimeral, trithemimeral
σοὶ μὲν γὰρ βίος ἐστὶν ἐν ὕδασιν· αὐτὰρ ἔμοιγε	- - - uu -u u -uu -u u--	dactylic hexameter	feminine penthemimeral, trithemimeral
ὅσσα παρ᾽ ἀνθρώποις τρώγειν ἔδος· οὐδέ με λήθει	-u u --- -- uu -u u --	dactylic hexameter	masculine penthemimeral, hepthemimeral
ἄρτος τρισκοπάνιστος ἀπ᾽ εὐκύκλου κανέοιο,	-- -uu-u u --- uu--	dactylic hexameter	feminine penthemimeral
οὐδὲ πλακοῦς τανύπεπλος ἔχων πολὺ σησαμότυρον,	-u u- uu-u u- uu -uu--	dactylic hexameter	feminine penthemimeral, hepthemimeral, trithemimeral
οὐ τόμος ἐκ πτέρνης, οὐχ ἥπατα λευκοχίτωνα,	- uu - -- - -uu -uu--	dactylic hexameter	masculine penthemimeral, trithemimeral
οὐ τυρὸς νεόπηκτος ἀπὸ γλυκεροῖο γάλακτος,	- -- uu-u u- uu-u u--	dactylic hexameter	feminine penthemimeral, hepthemimeral, trithemimeral
οὐ χρηστὸν μελίτωμα, τὸ καὶ μάκαρες ποθέουσιν,	- -- uu-u u - uu- uu--	dactylic hexameter	feminine penthemimeral, hepthemimeral, trithemimeral
οὐδ᾽ ὅσα πρὸς θοίνας μερόπων τεύχουσι μάγειροι,	- uu - -- uu- --u u--	dactylic hexameter	masculine penthemimeral, hepthemimeral, trithemimeral
κοσμοῦντες χύτρας ἀρτύμασι παντοδαπτοῖσιν.	--- uu -uu- -----	dactylic hexameter	hepthemimeral, trithemimeral
οὐ τρώγω ῥαφᾶνους, οὐ κράμβας, οὐ καλοκύνθας,	- -- uu- - -- - uu--	dactylic hexameter	masculine penthemimeral, trithemimeral
οὐ πράσσοις χλωροῖς ἐπιβόσκομαι, οὐδὲ σελίνοις·	- -- -- uu-uu -u u--	dactylic hexameter	masculine penthemimeral, trithemimeral
ταῦτα γὰρ ὑμέτερ᾽ ἐστὶν ἐδέσματα τῶν κατὰ λίμνην."	-u u -uu -u u-uu - uu --	dactylic hexameter	feminine penthemimeral
Πρὸς τάδε μειδήσας Φυσίγναθος ἀντίον ηὔδα·	- uu --- --uu -uu --	dactylic hexameter	masculine penthemimeral
"Ξεῖνε λίην αὐχεῖς ἐπὶ γαστέρι· ἔστι καὶ ἡμῖν	-u u- -- uu -uu -u u --	dactylic hexameter	masculine penthemimeral, trithemimeral
πολλὰ μάλ᾽ ἐν λίμνῃ καὶ ἐπὶ χθονὶ θαύματ᾽ ἰδέσθαι.	-u u - -- u u- uu -u u--	dactylic hexameter	masculine penthemimeral, hepthemimeral, trithemimeral
ἀμφίβιον γὰρ ᾽έδωκε νομὴν βατράχοισι Κρονίων,	-uu- u u-u u- uu-u u--	dactylic hexameter	feminine penthemimeral, hepthemimeral, trithemimeral
σκιρτῆσαι κατὰ γαῖαν, ἐν ὕδασι σῶμα καλύψαι·	--- uu -u u -uu -u u--	dactylic hexameter	feminine penthemimeral, trithemimeral
εἰ δ᾽ἐθέλεις καὶ ταῦτα δαήμεναι εὐχερές ἐστι·	- uu- - -u u-uu -uu --	dactylic hexameter	feminine penthemimeral, trithemimeral
βαῖνέ μοι ἐν νώτοισι, κράτει δέ με μήποτ᾽ ὀλίσθῃς,	-u u - --u u- u u -u u--	dactylic hexameter	feminine penthemimeral, hepthemimeral, trithemimeral
ὅππως γηθόσυνος πρὸς ἐμὸν δόμον εἰσαφίκηαι."	-- -uu- u u- uu -uu--	dactylic hexameter	masculine penthemimeral, hepthemimeral
Ὣς ἄρ᾽ ἔφη καὶ νῶτ᾽ ἐδίδου· ὁ δ᾽ἔβαινε τάχιστα	- u u- - - uu- u u-u u--	dactylic hexameter	masculine penthemimeral, hepthemimeral, trithemimeral
χεῖρας ἔχων τρυφεροῖο κατ᾽ αὐχένος ἅμματι κούφῳ.	-u u- uu-u u -uu -uu --	dactylic hexameter	feminine penthemimeral, trithemimeral
καὶ πρῶτον μὲν ἔχαιρεν ὅτ᾽ ἔβλεπε γείτονας ὅρμους,	- -- u u-u u -uu -uu --	dactylic hexameter	feminine penthemimeral, trithemimeral
νήξει τερπόμενος Φυσιγνάθου· ἀλλ᾽ ὅτε δή ῥα	-- -uu- --uu - uu - -	dactylic hexameter	masculine penthemimeral
κύμασι πορφυρέοις ἐπεκλύζετο, πολλὰ δακρύων	-uu -uu- uu-uu -u u--	dactylic hexameter	masculine penthemimeral
ἄχρηστον μετάνοιαν ἐμέμφετο, τίλλε δὲ χαίτας,	--- uu-u u-uu -u u --	dactylic hexameter	feminine penthemimeral, trithemimeral
καὶ πόδας ἔσφιγγεν κατὰ γαστέρος, ἐν δέ οἱ ἥτορ	- uu --- uu -uu - u u --	dactylic hexameter	masculine penthemimeral
πάλλετ᾽ ἀηθείῃ καὶ ἐπὶ χθόνα βούλεθ᾽ ἱκέσθαι·	-u u--- u u- uu -u u--	dactylic hexameter	masculine penthemimeral, hepthemimeral
δεινὰ δ᾽ὑπεστενάχιζε φόβου κρυόεντος ἀνάγκῃ.	-u u-uu-u u- uu-u u--	dactylic hexameter	feminine penthemimeral, hepthemimeral
οὐρὴν πρῶτ᾽ ἐπελάσσεν ἐφ᾽ ὕδασιν ἠύτε κώπην	-- - uu-u u -uu -uu --	dactylic hexameter	feminine penthemimeral, trithemimeral
σύρων, εὐχόμενος δὲ θεοῖς ἐπὶ γαῖαν ἱκέσθαι	-- -uu- u u- uu -u u--	dactylic hexameter	masculine penthemimeral, hepthemimeral
ὕδασι πορφυρέοισιν ἐκλύζετο, πολλὰ δ᾽ἐβώστρει·	-uu -uu-u u-uu -u u--	dactylic hexameter	feminine penthemimeral
καὶ τοῖον φάτο μῦθον ἀπὸ στόματός τ᾽ἀγόρευσεν·	- -- uu -u u- uu- uu--	dactylic hexameter	feminine penthemimeral, hepthemimeral, trithemimeral
"Οὐχ οὕτω νώτοισιν ἐβάστασε φόρτον ἔρωτος	- -- --u u-uu -u u--	dactylic hexameter	feminine penthemimeral, trithemimeral
ταῦρος ὅτ᾽ Εὐρώπην διὰ κύματος ἦγ᾽ ἐπὶ Κρήτην	-u u --- uu -uu - uu --	dactylic hexameter	masculine penthemimeral
ὡς μῦν ἁπλώσας ἐπινώτιον ἦγεν ἐς οἶκον	- - --- uu-uu -u u --	dactylic hexameter	masculine penthemimeral
βάτραχος ὑψώσας ὠχρὸν δέμας ὕδατι λευκῷ."	-uu --- -- uu -uu --	dactylic hexameter	masculine penthemimeral, hepthemimeral
Ὕλλος δ᾽ἐξαπίνης ἀνεφαίνετο, πικρὸν ὅραμα	-- -uu- uu-uu -u u--	dactylic hexameter	masculine penthemimeral
πᾶσιν ὁμῶς· ὀρθὸν δ᾽ὑπὲρ ὕδατος εἶχε τράχηλον.	-u u- -- uu -uu -u u--	dactylic hexameter	masculine penthemimeral, trithemimeral
τοῦτον ἰδὼν κατέδυ Φυσίγναθος, οὔ τι νοήσας	-u u- uu- --uu - u u--	dactylic hexameter	masculine penthemimeral, trithemimeral
οἷον ἑταῖρον ἔμελλεν ἀπολλύμενον καταλείπειν.	-u u-u u-u u-uu- uu--	dactylic hexameter	feminine penthemimeral
δῦ δὲ βάθος λίμνης καὶ ἀλεύατο κῆρα μέλαιναν.	- u u- -- u u-uu -u u--	dactylic hexameter	masculine penthemimeral, trithemimeral
κεῖνος δ᾽ὡς ἀφέθη, πέσεν ὕπτιος εὐδὺς ἐφ᾽ ὕδωρ,	-- - uu- uu -uu -u u --	dactylic hexameter	masculine penthemimeral, trithemimeral
καὶ χεῖρας ἔσφιγγε καὶ ὀλλύμενος κατέτριζε.	- -- --u u -uu- uu--	dactylic hexameter	feminine penthemimeral, trithemimeral
πολλάκι μὲν κατέδυνεν ὑφ᾽ ὕδατι, πολλάκι δ᾽αὖτε	-uu - uu-u u -uu -uu --	dactylic hexameter	feminine penthemimeral, trithemimeral
λακτίζων ἀνέδυνε· μόρον δ᾽οὐκ ἦν ὑπαλύξαι.	--- uu-u u- - - uu--	dactylic hexameter	feminine penthemimeral, hepthemimeral, trithemimeral
δευόμεναι δὲ τρίχες πλεῖον βάρος εἷλκον ἐπ᾽ αὐτόν·	-uu- u u- -- uu -u u --	dactylic hexameter	masculine penthemimeral, hepthemimeral, trithemimeral
ὕδασι δ᾽ὀλλύμενος τοίους ἐφθέγξατο μύθους·	-uu -uu- -- --uu --	dactylic hexameter	masculine penthemimeral, hepthemimeral
"Οὐ λήσεις δολίως Φυσίγναθε ταῦτα ποιήσας,	- -- uu- --uu -u u--	dactylic hexameter	masculine penthemimeral, trithemimeral
ναυηγὸν ῥίψας ἀπὸ σώματος ὡς ἀπὸ πέτρης.	--- -- uu -uu - uu --	dactylic hexameter	masculine penthemimeral, trithemimeral
οὐκ ἄν μου κατὰ γαῖαν ἀμείνων ἦσθα κάκιστε	- - - uu -u u-- -u u--	dactylic hexameter	feminine penthemimeral, trithemimeral
παγκρατίῳ τε πάλῃ τε καὶ εἰς δρόμον· ἀλλά πλανήσας	-uu- u u- u - - uu -u u--	lyric	
εἰς ὕδωρ μ᾽ἔρριψας. ἔχει θεὸς ἔκδικον ὄμμα."	- -- --u u- uu -uu --	dactylic hexameter	feminine penthemimeral, hepthemimeral, trithemimeral
Ὣς εἰπὼν ἀπέπνευσεν ἐν ὕδασι· τὸν δὲ κατεῖδεν	- -- uu-- u -uu - u u--	lyric	
Λειχοπίναξ ὄχδῃσιν ἐφεζόμενος μαλακῇσιν·	-uu- --u u-uu- uu--	dactylic hexameter	feminine penthemimeral, trithemimeral
δεινὸν δ᾽ἐξολόλυξε, δραμὼν δ᾽ἤγγειλε μύεσσιν.	-- -uu-u u- --u u--	dactylic hexameter	feminine penthemimeral, hepthemimeral
ὡς δ᾽ἔμαθον τὴν μοῖραν ἔδυ χόλος αἰνὸς ἅπαντας.	- uu- - -u u- uu -u u--	dactylic hexameter	feminine penthemimeral, hepthemimeral, trithemimeral
καὶ τότε κηρύκεσσιν ἑοῖς ἐκέλευον ὑπ᾽ ὄρθρον	- uu ---u u- uu-u u --	dactylic hexameter	feminine penthemimeral, hepthemimeral
κηρύσσειν ἀγορὴν ἐς δώματα Τρωξάρταο,	--- uu- - -uu ----	dactylic hexameter	masculine penthemimeral, trithemimeral
πατρὸς δυστήνου Ψιχάρπαγος, ὃς κατὰ λίμνην	-- --- --uu - uu --	dactylic hexameter	masculine penthemimeral
ὕπτιος ἐξήπλωτο νεκρὸν δέμας, οὐδὲ παρ᾽ ὄχθαις	-uu ---u u- uu -u u --	dactylic hexameter	feminine penthemimeral, hepthemimeral
ἦν ἤδη τλήμων, μέσσῳ δ᾽ἐπενήχετο πόντῳ.	- -- -- -- uu-uu --	dactylic hexameter	masculine penthemimeral, hepthemimeral, trithemimeral
ὡς δ᾽ἦλθον σπεύδοντες ἅμ᾽ ἠοῖ, πρῶτος ἀνέστη	- -- --u u -- -u u--	dactylic hexameter	feminine penthemimeral, trithemimeral
Τρωξάρτης ἐπὶ παιδὶ χολούμενος, εἶπέ τε μῦθον·	--- uu -u u-uu -u u --	dactylic hexameter	feminine penthemimeral, trithemimeral
"Ὦ φίλοι, εἰ καὶ μοῦνος ἐγὼ κακὰ πολλὰ πέπονθα	- uu - - -u u- uu -u u--	dactylic hexameter	feminine penthemimeral, hepthemimeral, trithemimeral
ἐκ βατράχων· ἡ πεῖρα κακὴ πάντεσσι τέτυκται.	- uu- - -u u- --u u--	dactylic hexameter	feminine penthemimeral, hepthemimeral, trithemimeral
εἰμὶ δ᾽ἐγὼ δύστηνος ἐπεὶ τρεῖς παῖδας ὄλεσσα·	-u u- --u u- - -u u--	dactylic hexameter	feminine penthemimeral, hepthemimeral, trithemimeral
καὶ τὸν μὲν πρῶτόν γε κατέκτανεν ἁρπάξασα	- - - -- u u-uu ----	dactylic hexameter	masculine penthemimeral, trithemimeral
ἔχθιστος γαλέη, τρώγλης ἔκτοσθεν ἑλοῦσα.	--- uu- -- --u u--	dactylic hexameter	masculine penthemimeral, hepthemimeral, trithemimeral
τὸν δ᾽ἄλλον πάλιν ἄνδρες ἀπηνέες ἐς μόρον εἷλξαν	- -- uu -u u-uu - uu --	dactylic hexameter	feminine penthemimeral, trithemimeral
καινοτέραις τέχναις ξύλινον δόλον ἐξευρόντες,	-uu- -- uu- uu ----	dactylic hexameter	masculine penthemimeral, hepthemimeral, trithemimeral
ὁ τρίτος ἦν ἀγαπητὸς ἐμοὶ καὶ μητέρι κεδνῇ,	- uu - uu-u u- - -uu --	dactylic hexameter	feminine penthemimeral, hepthemimeral, trithemimeral
τοῦτον ἀπέπνιξεν Φυσίγναθος ἐς βυθὸν ἄξας.	-u u--- --uu - uu --	dactylic hexameter	masculine penthemimeral
ἀλλ᾽ ἄγεθ᾽ ὁπλίζεσθε καὶ ἐξέλθωμεν ἐπ᾽ αὐτούς."	- uu ---u u ---u u --	dactylic hexameter	feminine penthemimeral
Ταῦτ᾽ εἰπὼν ἀνέπεισε καθοπλίζεσθαι ἅπαντας·	- -- uu-u u---u u--	dactylic hexameter	feminine penthemimeral, trithemimeral
κνημῖδας μὲν πρῶτον ἐφήρμοσαν εἰς δύο μηρούς,	--- - -u u-uu - uu --	dactylic hexameter	feminine penthemimeral, trithemimeral
ῥήξαντες κυάμους χλωρούς, εὖ δ᾽ἀσκήσαντες,	--- uu- -- - ----	dactylic hexameter	masculine penthemimeral, hepthemimeral, trithemimeral
οὓς αὐτοὶ διὰ νυκτός ἐπιστάντες κατέτρωξαν.	- -- uu -u u--- uu--	dactylic hexameter	feminine penthemimeral, trithemimeral
θώρηκας δ᾽εἶχον καλαμορραφέων ἀπὸ βυρσῶν,	--- -- uu-uu- uu --	dactylic hexameter	masculine penthemimeral, trithemimeral
οὓς γαλέην δείραντες ἐπισταμένως ἐποίησαν.	- uu- --u u-uu- uu--	dactylic hexameter	feminine penthemimeral, trithemimeral
ἀσπὶς δ᾽ἦν λύχνου τὸ μεσόμφαλον· ἡ δέ νυ λόγχη	-- - -- u u-uu - u u --	dactylic hexameter	masculine penthemimeral, trithemimeral
εὐμήκης βελόνη, παγχάλκεον ἔργον Ἄρηος·	--- uu- --uu -u u--	dactylic hexameter	masculine penthemimeral, trithemimeral
ἡ δὲ κόρυς τὸ λέπυρον ἐπὶ κροτάφοις ἐρεβίνθου.	- u u- u u-u u- uu- uu--	dactylic hexameter	feminine penthemimeral, hepthemimeral, trithemimeral
Οὕτω μὲν μύες ἦσαν ἔνοπλοι· ὡς δ᾽ἐνόησαν	-- - uu -u u-- - uu--	dactylic hexameter	feminine penthemimeral, trithemimeral
βάτραχοι, ἐξανέδυσαν ἀφ᾽ ὕδατος, ἐς δ᾽ἕνα χῶρον	-uu -uu-u u -uu - uu --	dactylic hexameter	feminine penthemimeral
ἐλθόντες βουλὴν ξύναγον πολέμοιο κακοῖο.	--- -- uu- uu-u u--	dactylic hexameter	masculine penthemimeral, hepthemimeral, trithemimeral
σκεπτομένων δ᾽αὐτῶν πόθεν ἡ στάσις ἢ τίς ὁ θρύλλος,	-uu- -- uu - uu - u u --	dactylic hexameter	masculine penthemimeral, hepthemimeral, trithemimeral
κῆρυξ ἐγγύθεν ἦλθε φέρων ῥάβδον μετὰ χερσίν,	-- -uu -u u- -- uu --	dactylic hexameter	feminine penthemimeral, hepthemimeral
Τυρογλύφου υἱὸς μεγαλήτορος Ἐμβασίχυτρος,	-uu- -- uu-uu -uu--	dactylic hexameter	masculine penthemimeral, trithemimeral
ἀγγέλλων πολέμοιο κακὴν φάτιν, εἶπέ τε τοῖα·	--- uu-u u- uu -u u --	dactylic hexameter	feminine penthemimeral, hepthemimeral, trithemimeral
"Ὦ βάτραχοι, μύες ὔμμιν ἀπειλήσαντες ἔπεμψαν	- uu- uu -u u---u u--	dactylic hexameter	feminine penthemimeral, trithemimeral
εἰπεῖν ὁπλίζεσθαι ἐπὶ πτόλεμόν τε μάχην τε.	-- ---u u- uu- u u- -	dactylic hexameter	feminine penthemimeral, hepthemimeral
εἶδον γὰρ καθ᾽ ὕδωρ Ψιχάρπαγα ὅν περ ἔπεφνεν	-- - u u- --uu - u u--	dactylic hexameter	masculine penthemimeral, trithemimeral
ὑμέτερος βασιλεὺς Φυσίγναθος. ἀλλὰ μάχεσθε	-uu- uu- --uu -u u--	dactylic hexameter	masculine penthemimeral, trithemimeral
οἵ τινες ἐν βατράχοισιν ἀριστῆες γεγάατε."	- uu - uu-u u--- uu--	dactylic hexameter	feminine penthemimeral, trithemimeral
Ὣς εἰπὼν ἀπέφηνε· λόγος δ᾽εἰς οὔατ᾽ ἀμύμων	- -- uu-u u- - -u u--	dactylic hexameter	feminine penthemimeral, hepthemimeral, trithemimeral
εἰσελθὼν ἐτάραξε φρένας βατράχων ἀγέρωχων·	--- uu-u u- uu- uu--	dactylic hexameter	feminine penthemimeral, hepthemimeral, trithemimeral
μεμφομένων δ᾽αὐτῶν Φυσίγναθος εἶπεν ἀναστάς·	-uu- -- --uu -u u--	dactylic hexameter	masculine penthemimeral, trithemimeral
"Ὦ φίλοι, οὐκ ἔκτεινον ἐγὼ μῦν, οὐδὲ κατεῖδον	- uu - --u u- - -u u--	dactylic hexameter	feminine penthemimeral, hepthemimeral, trithemimeral
ὀλλύμενον· πάντως δ᾽ἐπνίγη παίζων παρὰ λίμνην,	-uu- -- uu- -- uu --	dactylic hexameter	masculine penthemimeral, hepthemimeral, trithemimeral
νήξεις τὰς βατράχων μιμούμενος· οἱ δὲ κάκιστοι	-- - uu- --uu - u u--	dactylic hexameter	masculine penthemimeral, trithemimeral
νῦν ἐμὲ μέμφονται τὸν ἀναίτιον· ἀλλ᾽ ἄγε βουλὴν	- uu --- u u-uu - uu --	dactylic hexameter	masculine penthemimeral
ζητήσωμεν ὅπως δολίους μύας ἐξολέσωμεν.	---u u- uu- uu -uu--	dactylic hexameter	masculine penthemimeral, hepthemimeral
τοιγὰρ ἐγὼν ἐρέω ὥς μοι δοκεῖ εἶναι ἄριστα·	-u u- uu- - - uu -u u--	dactylic hexameter	masculine penthemimeral, hepthemimeral, trithemimeral
σώματα κοσμήσαντες ἔνοπλοι στῶμεν ἅπαντες	-uu ---u u-- -u u--	dactylic hexameter	feminine penthemimeral
ἅκροις πὰρ χείλεσσιν, ὅπου κατάκρημνος ὁ χώρος·	-- - --u u- uu-u u --	dactylic hexameter	feminine penthemimeral, hepthemimeral, trithemimeral
ἡνίκα δ᾽ὁρμηθέντες ἐφ᾽ ἡμέας ἐξέλθωσι,	-uu ---u u -uu ----	dactylic hexameter	feminine penthemimeral
δραξάμενοι κορύθων, ὅς τις σχεδὸν ἀντίος ἔλθῃ,	-uu- uu- - - uu -uu --	dactylic hexameter	masculine penthemimeral, hepthemimeral, trithemimeral
ἐς λίμνην αὐτοὺς σὺν ἐκείνῳ εὐθὺ βάλωμεν.	- -- -- u u-- -u u--	dactylic hexameter	masculine penthemimeral, trithemimeral
οὕτω γὰρ πνίξαντες ἐκείνους τοὺς ἀκολύμβους	-- - --u u-- - uu--	dactylic hexameter	feminine penthemimeral, trithemimeral
στήσομεν εὐθύμος τὸ μυοκτόνον ὧδε τρόπαιον."	-uu --- u u-uu -u u--	dactylic hexameter	masculine penthemimeral
Ὥς εἰπὼν συνέπεισε καθοπλίζεσθαι ἅπαντας·	- -- uu-u u---u u--	dactylic hexameter	feminine penthemimeral, trithemimeral
φύλλοις μὲν μαλαχῶν κνήμας ἑὰς ἀμφεκάλυψαν,	-- - uu- -- uu -uu--	dactylic hexameter	masculine penthemimeral, hepthemimeral, trithemimeral
θώρηκας δ᾽εἶχον καλῶν χλοερῶν ἀπὸ σεύτλων,	--- -- -- uu- uu --	dactylic hexameter	masculine penthemimeral, hepthemimeral, trithemimeral
φύλλα δὲ τῶν κραμβῶν εἰς ἀσπίδας εὖ ἤσκησαν,	-u u - -- - -uu - ---	dactylic hexameter	masculine penthemimeral, trithemimeral
ἔγχος δ᾽ὀξύσχοινος ἑκάστῳ μακρὸς ἀρήρει,	-- ---u u-- -u u--	dactylic hexameter	feminine penthemimeral
καὶ ῥα κέρα κοχλιῶν λεπτῶν ἐκάλυπτε κάρηνα.	- u u- uu- -- uu-u u--	dactylic hexameter	masculine penthemimeral, hepthemimeral, trithemimeral
φραξάμενοι δ᾽ἔστησαν ἐπ᾽ ὄχθαις ὑψηλαῖσι	-uu- --u u -- ----	dactylic hexameter	feminine penthemimeral, trithemimeral
σείοντες λόγχας, θυμοῦ δ᾽ἔμπλητο ἕκαστος.	--- -- -- --u u--	dactylic hexameter	masculine penthemimeral, hepthemimeral, trithemimeral
Ζεὺς δὲ θεοὺς καλέσας εἰς οὐρανὸν ἀστερόεντα,	- u u- uu- - -uu -uu--	dactylic hexameter	masculine penthemimeral, trithemimeral
καὶ πολέμου πληθὺν δείξας κρατερούς τε μαχητάς,	- uu- -- -- uu- u u--	dactylic hexameter	masculine penthemimeral, hepthemimeral, trithemimeral
πολλοὺς καὶ μεγάλους ἠδ᾽ ἔγχεα μακρὰ φέροντας,	-- - uu- - -uu -u u--	dactylic hexameter	masculine penthemimeral, trithemimeral
οἷος Κενταύρων στρατὸς ἔρχεται ἠὲ Γιγάντων,	-- --- uu -uu -u u--	dactylic hexameter	masculine penthemimeral
ἡδὺ γελῶν ἐρέεινε· "Τίνες βατράχοισιν ἀρωγοὶ	-u u- uu-u u- uu-u u--	dactylic hexameter	feminine penthemimeral, hepthemimeral, trithemimeral
ἢ μυσὶν τειρομένοις;" καὶ Ἀθηναίην προσέειπεν·	- uu -uu- u u--- uu--	dactylic hexameter	masculine penthemimeral
"Ὦ θύγατερ, μυσὶν ἦ ῥα βοηθήσουσα πορεύσῃ;	- uu- uu - u u---u u--	dactylic hexameter	masculine penthemimeral, trithemimeral
καὶ γὰρ σοῦ κατὰ νηὸν ἀεὶ σκιρτῶσιν ἅπαντες	- - - uu -u u- --u u--	dactylic hexameter	feminine penthemimeral, hepthemimeral, trithemimeral
κνίσῃ τερπόμενοι καὶ ἐδέσμασι παντοδαποῖσιν."	-- -uu- u u-uu -uu--	dactylic hexameter	masculine penthemimeral
Ὣς ἄρ᾽ ἔφη Κρονίδης· τὸν δὲ προσέειπεν Ἀθήνη·	- u u- uu- - - uu-u u--	dactylic hexameter	masculine penthemimeral, hepthemimeral, trithemimeral
"Ὦ πάτερ, οὐκ ἂν πώ ποτ᾽ ἐγὼ μυσὶ τειρομένοισιν	- uu - - - u u- uu -uu--	dactylic hexameter	masculine penthemimeral, hepthemimeral, trithemimeral
ἐλθοίμην ἐπαρωγός, ἐπεὶ κακὰ πολλὰ μ᾽ἔοργαν	--- uu-u u- uu -u u--	dactylic hexameter	feminine penthemimeral, hepthemimeral, trithemimeral
στέμματα βλάπτοντες καὶ λύχνους εἵνεκ᾽ ἐλαίου.	-uu --- - -- -u u--	dactylic hexameter	masculine penthemimeral
τοῦτο δέ μοι λίην ἔδακε φρένας οἷον ἔρεξαν·	-u u - -- uu- uu -u u--	dactylic hexameter	masculine penthemimeral, hepthemimeral, trithemimeral
πέπλον μου κατέτρωξαν ὃν ἐξύφηνα καμοῦσα	-- - uu-u u ---u u--	dactylic hexameter	feminine penthemimeral, trithemimeral
ἐκ ῥοδάνης λεπτῆς καὶ στήμονα μακρὸν ἔνησα·	- uu- -- - -uu -u u--	dactylic hexameter	masculine penthemimeral, trithemimeral
καὶ τρώγλας ἐτέλεσσαν, ὁ δ᾽ἠπητής μοι ἐπέστη	- -- uu-u u --- u u--	dactylic hexameter	feminine penthemimeral, trithemimeral
καὶ πράσσει με τόκον· τὸ δὲ ῥίγιον ἀθανάτοισιν,	- -- u u- u u -uu -uu--	dactylic hexameter	masculine penthemimeral, trithemimeral
χρησαμένη γὰρ ἔνησα καὶ οὐκ ἔχω ἀνταποδοῦναι.	-uu- u u-u u - uu -uu--	dactylic hexameter	feminine penthemimeral, hepthemimeral, trithemimeral
ἀλλ᾽ οὐδ᾽ ὣς βατράχοισιν ἀρηγέμεν οὐκ ἐθελήσω·	- - - uu-u u-uu - uu--	dactylic hexameter	feminine penthemimeral, trithemimeral
εἰσὶ γὰρ οὐδ᾽ αὐτοὶ φρένας ἔμπεδοι, ἀλλά με πρῴην	-u u - -- uu -uu -u u --	dactylic hexameter	masculine penthemimeral, trithemimeral
ἐκ πολέμου ἀνιοῦσαν ἐπεὶ λίην ἐκοπώθην,	- uu- uu-u u- -- uu--	dactylic hexameter	feminine penthemimeral, hepthemimeral, trithemimeral
ὕπνου δευομένην οὐκ εἴασαν θορυβοῦντες	-- -uu- - --- uu--	dactylic hexameter	masculine penthemimeral
οὐδ᾽ ὀλίγον καταμῦσαι· ἐγὼ δ᾽ἄϋπνος κατεκείμην	- uu- uu-u u- uu- uu--	dactylic hexameter	feminine penthemimeral, hepthemimeral, trithemimeral
τὴν κεφαλὴν ἀλγοῦσα, ἕως ἐβόησεν ἀλέκτωρ.	- uu- --u u- uu-u u--	dactylic hexameter	feminine penthemimeral, hepthemimeral, trithemimeral
ἀλλ᾽ ἄγε παυσώμεσθα θεοὶ τούτοισιν ἀρήγειν,	- uu ---u u- --u u--	dactylic hexameter	feminine penthemimeral, hepthemimeral
μή κέ τις ὑμείων τρωθῇ βέλει ὀξυόεντι·	- u u --- -- uu -uu--	dactylic hexameter	masculine penthemimeral, hepthemimeral
εἰσὶ γὰρ ἀγχέμαχοι, εἰ καὶ θεὸς ἀντίον ἔλθοι·	-u u -uu- - - uu -uu --	dactylic hexameter	masculine penthemimeral, hepthemimeral
πάντες δ᾽οὐρανόθεν τερπώμεθα δῆριν ὁρῶντες."	-- -uu- --uu -u u--	dactylic hexameter	masculine penthemimeral
Ὣς ἄρ᾽ ἔφη, καὶ τῇ γε θεοὶ ἐπεπείθοντ᾽ ἄλλοι,	- u u- - - u u- uu-- --	dactylic hexameter	masculine penthemimeral, hepthemimeral, trithemimeral
πάντες δ᾽αὖτ᾽ εἰσῆλθον ἀολλέες εἰς ἕνα χῶρον.	-- - --u u-uu - uu --	dactylic hexameter	feminine penthemimeral, trithemimeral
καὶ τότε κώνωπες μεγάλας σάλπιγγος ἔχοντες	- uu --- uu- --u u--	dactylic hexameter	masculine penthemimeral, hepthemimeral
δεινὸν ἐσάλπιγξαν πολέμου κτύπον· οὐρανόθεν δὲ	-u u--- uu- uu -uu- -	dactylic hexameter	masculine penthemimeral, hepthemimeral
Ζεὺς Κρονίδης βρόντησε, τέρας πολέμοιο κακοῖο.	- uu- --u u- uu-u u--	dactylic hexameter	feminine penthemimeral, hepthemimeral, trithemimeral
Πρῶτος δ᾽Ὑψιβόας Λειχήνορα οὔτασε δουρὶ	-- -uu- --uu -uu --	dactylic hexameter	masculine penthemimeral
ἑσταότ᾽ ἐν προμάχοις κατὰ γαστέρα ἐς μέσον ἧπαρ·	-uu - uu- uu -uu - uu --	dactylic hexameter	masculine penthemimeral, trithemimeral
κὰδ δ᾽ἔπεσεν πρηνής, ἁπαλὰς δ᾽ἐκόνισεν ἐθείρας.	- uu- -- uu- uu-u u--	dactylic hexameter	masculine penthemimeral, hepthemimeral, trithemimeral
Τρωγλίτης δὲ μετ᾽ αὐτὸν ἀκόντισε Πηλείωνα,	--- u u -u u-uu ----	dactylic hexameter	feminine penthemimeral, trithemimeral
πῆξεν δ᾽ἐν στέρνῳ στιβαρὸν δόρυ· τὸν δὲ πεσόντα	-- - -- uu- uu - u u--	dactylic hexameter	masculine penthemimeral, hepthemimeral, trithemimeral
εἷλε μέλας θάνατος, ψυχὴ δ᾽ἐκ σώματος ἔπτη.	-u u- uu- -- - -uu --	dactylic hexameter	masculine penthemimeral, hepthemimeral, trithemimeral
Σευτλαῖος δ᾽ἂρ ἔπεφνε βαλὼν κέαρ Ἐμβασίχυτρον,	--- u u-u u- uu -uu--	dactylic hexameter	feminine penthemimeral, hepthemimeral, trithemimeral
Τυροφάγον δ᾽αὐτῇσιν ἐπ᾽ ὄχθαις ἐξενάριξεν.	-uu- u-u u -- -uu--	lyric	
Πτερνογλύφον δ᾽ἐσιδὼν Καλαμίνθιος ἐς φόβον ἦλθεν,	-uu- uu- uu-uu - uu --	dactylic hexameter	masculine penthemimeral, trithemimeral
ἥλατο δ᾽ἐς λίμνην, φεύγων τὴν ἀσπίδα ῥίψας.	-uu - -- -- - -uu --	dactylic hexameter	masculine penthemimeral, hepthemimeral, trithemimeral
Λιτραῖον δ᾽ἀρ᾽ ἔπεφνεν ἀμύμων Βορβοροκοίτης,	--- u u-u u-- -uu--	dactylic hexameter	feminine penthemimeral, trithemimeral
χερμαδίῳ πλήξας κατὰ βρέγματος· ἐγκέφαλος δὲ	-uu- -- uu -uu -uu- -	dactylic hexameter	masculine penthemimeral, trithemimeral
ἐκ ῥινῶν ἔσταξε. παλάσσετο δ᾽αἵματι γαῖα.	- -- --u u-uu -uu --	dactylic hexameter	feminine penthemimeral, trithemimeral
Λειχοπίναξ δ᾽ἔκτεινεν ἀμύμονα Βορβοροκοίτην,	-uu- --u u-uu -uu--	dactylic hexameter	feminine penthemimeral, trithemimeral
ἔγχει ἐπαΐξας· τὸν δὲ σκότος ὄσσε κάλυψεν.	-u u--- - - uu -u u--	dactylic hexameter	masculine penthemimeral, hepthemimeral
Πρασσαῖος δ᾽ἐσιδὼν ποδὸς εἵλκυσε νεκρώσαντα,	--- uu- uu -uu ----	dactylic hexameter	masculine penthemimeral, trithemimeral
ἐν λίμνῃ δ᾽ἀπέπνιξε κρατήσας χειρὶ τένοντα.	- -- uu-u u-- -u u--	dactylic hexameter	feminine penthemimeral, trithemimeral
Ψιχάρπαξ δ᾽ἤμυν᾽ ἑτάρου περὶ τεθνειώτος	--- -- uu- uu ----	dactylic hexameter	masculine penthemimeral, hepthemimeral, trithemimeral
καὶ βάλε Πρασσαῖον κατὰ νηδύος ἐς μέσον ἧπαρ,	- uu --- uu -uu - uu --	dactylic hexameter	masculine penthemimeral
πῖπτε δὲ οἱ πρόσθεν, ψυχὴ δ᾽Ἀϊδόσδε βεβήκει.	-u u - -- -- uu-u u--	dactylic hexameter	masculine penthemimeral, hepthemimeral, trithemimeral
Κραμβοβάτης δ᾽ἐσιδὼν πηλοῦ δράκα ῥίψεν ἐπ᾽ αὐτόν,	-uu- uu- -- uu -u u --	dactylic hexameter	masculine penthemimeral, hepthemimeral, trithemimeral
καὶ τὸ μέτωπον ἔχρισε καὶ ἐξετύφλου παρὰ μικρόν.	- u u-u --u u -uu- uu --	lyric	
ὠργίσθη δ᾽ἄρ᾽ ἐκεῖνος, ἑλὼν δ᾽ἄρα χειρὶ παχείῃ	--- u u-u u- uu -u u--	dactylic hexameter	feminine penthemimeral, hepthemimeral, trithemimeral
κείμενον ἐν δαπέδῳ λίθον ὄβριμον, ἄχθος ἀρούρης,	-uu - uu- uu -uu -u u--	dactylic hexameter	masculine penthemimeral, trithemimeral
τῷ βάλε Κραμβοβάτην ὑπὸ γούνατα· πᾶσα δ᾽ἐκλάσθη	- uu -uu- uu -uu -u u--	dactylic hexameter	masculine penthemimeral
κνήμη δεξιτερή, πέσε δ᾽ὕπτιος ἐν κονίηισι.	-- -uu- uu -uu - uu---	lyric	
Κραυγασίδης δ᾽ἤμυνε καὶ αὖθις βαῖνεν ἐπ᾽ αὐτόν,	-uu- --u u -- -u u --	dactylic hexameter	feminine penthemimeral, trithemimeral
τύψε δὲ οἱ μέσσην κατὰ γαστέρα· πᾶς δὲ οἱ εἴσω	-u u - -- uu -uu - u u --	dactylic hexameter	masculine penthemimeral, trithemimeral
ὀξύσχοινος ἔδυνε, χαμαὶ δ᾽ἔκχυντο ἅπαντα	---u u-u u- --u u--	dactylic hexameter	feminine penthemimeral, hepthemimeral
ἔγκατ᾽ ἐφελκομένῳ ὑπὸ δούρατι χειρὶ παχείη.	-u u-uu- uu -uu -u u--	dactylic hexameter	masculine penthemimeral
Τρωξάρτης δ᾽ἔβαλεν Φυσίγναθον ἐς ποδὸς ἄκρον·	--- uu- --uu - uu --	dactylic hexameter	masculine penthemimeral, trithemimeral
ἔσχατος δ᾽ἐκ λίμνης ἀνεδύσετο, τείρετο δ᾽αἰνῶς.	-uu - -- -uu-- -uu --	lyric	
Πρασσαῖος δ᾽ὡς εἶδεν ἔθ᾽ ἡμίπνουν προπεσόντα,	--- - -u u --- uu--	dactylic hexameter	feminine penthemimeral, trithemimeral
ἦλθε διὰ προμᾶχων καὶ ἀκόντισεν ὀξύσχοινον·	-u u- uu- u u-uu ----	dactylic hexameter	masculine penthemimeral, trithemimeral
οὐδ᾽ ἔρρηξε σάκος, σχέτο δ᾽αὐτοῦ δουρὸς ἀκωκή·	- --u u- uu -- -u u--	dactylic hexameter	masculine penthemimeral
οὐδ᾽ ἔβαλε τρυφάλειαν ἀμύμονα καὶ τετράχυτρον	- uu- uu-u u-uu - uu--	dactylic hexameter	feminine penthemimeral, trithemimeral
δῖος Ὀριγανίων, μιμούμενος αὐτὸν Ἄρηα,	-u u-uu- --uu -u u--	dactylic hexameter	masculine penthemimeral
ὃς μόνος ἐν βατράχοισιν ἀρίστευεν καθ᾽ ὅμιλον·	- uu - uu-u u--- u u--	dactylic hexameter	feminine penthemimeral, trithemimeral
ὥρμησεν δ᾽ἄρ᾽ ἐπ᾽ αὐτόν· ὁ δ᾽ὡς ἴδεν οὐχ ὑπέμεινεν.	--- u u -u u - uu - uu--	dactylic hexameter	feminine penthemimeral, hepthemimeral, trithemimeral
(Ἀρτοφάγος δ᾽ἐσιδὼν καὶ Πτερνογλύφος ἀμύμων	-uu- uu- - -uu- u--	lyric	
ἦλθον ἀρηγέμεναι, ὁ δὲ βάτραχος οὐχ ὑπέμεινεν)	-u u-uu- u u -uu - uu--	dactylic hexameter	masculine penthemimeral
ἥρωας κρατερούς, ἀλλ᾽ ἔδυνε βένθεσι λίμνης.	--- uu- - -uu -uu --	dactylic hexameter	masculine penthemimeral, trithemimeral
Ἦν δέ τις ἐν μύεσσιν Μεριδάρπαξ ἔξοχος ἄλλων,	- u u - uu- uu-- -uu --	dactylic hexameter	masculine penthemimeral, trithemimeral
Κναίσωνος φίλος υἱὸς ἀμύμονος ἀρτεπιβούλου·	--- uu -u u-uu -uu--	dactylic hexameter	feminine penthemimeral, trithemimeral
οἴκαδ᾽ ἰών πολέμοιο μετασχεῖν παῖδ᾽ ἐκέλευεν·	-u u- uu-u u-- - uu--	dactylic hexameter	feminine penthemimeral, trithemimeral
αὐτὸς δ᾽ἑστήκει γαυρούμενος κατὰ λίμνην.	-- --- ---- uu --	dactylic hexameter	masculine penthemimeral
οὗτος ἀναρπάξαι βατράχων γενεὴν ἐπαπείλει,	-u u--- uu- uu- uu--	dactylic hexameter	masculine penthemimeral, hepthemimeral
καὶ ῥήξας καρύοιο μέσην ῥάχιν εἰς δύο μοίρας	- -- uu-u u- uu - uu --	dactylic hexameter	feminine penthemimeral, hepthemimeral, trithemimeral
φράγδην ἀμφοτέροισι κενώμασι χεῖρας ἔθηκεν·	-- -uu-u u-uu -u u--	dactylic hexameter	feminine penthemimeral
οἱ δὲ τάχος δείσαντες ἔβαν πάντες κατὰ λίμνην.	- u u- --u u- -- uu --	dactylic hexameter	feminine penthemimeral, hepthemimeral, trithemimeral
καί νύ κεν ἐξετέλεσσεν ἐπεὶ μέγα οἱ σθένος ἦεν,	- u u -uu-u u- uu - uu --	dactylic hexameter	feminine penthemimeral, hepthemimeral
εἰ μὴ ἄρ᾽ ὀξὺ νόησε πατὴρ ἀνδρῶν τε θεῶν τε.	- u u -u u-u u- -- u u- -	dactylic hexameter	feminine penthemimeral, hepthemimeral
καὶ τότ᾽ ἀπολλυμένους βατράχους ὤικτειρε Κρονίων,	- u u-uu- uu- --u u--	dactylic hexameter	masculine penthemimeral, hepthemimeral
κινήσας δὲ κάρη τοίην ἐφθέγξατο φωνήν·	--- u u- -- --uu --	dactylic hexameter	masculine penthemimeral, hepthemimeral, trithemimeral
"Ὢ πόποι, ἦ μέγα θαῦμα τόδ᾽ ὀφθαλμοῖσιν ὁρῶμαι·	- uu - uu -u u ---u u--	dactylic hexameter	feminine penthemimeral, trithemimeral
οὐ μικρὸν πλήσσει Μεριδάρπαξ ὃς κατὰ λίμνην	- -- -- uu-- - uu --	dactylic hexameter	masculine penthemimeral, trithemimeral
ἅρπαξ ἐν βατράχοισιν ἀμείβεται· ἀλλὰ τάχιστα	-- - uu-u u-uu -u u--	dactylic hexameter	feminine penthemimeral, trithemimeral
Παλλάδα πέμψωμεν πολεμόκλονον ἢ καὶ Ἄρηα,	-uu --- uu-uu - u u--	dactylic hexameter	masculine penthemimeral
οἵ μιν ἐπισχήσουσι μάχης κροπερόν περ ἐόντα."	- u u---u u- uu- u u--	dactylic hexameter	feminine penthemimeral, hepthemimeral
Ὣς ἄρ᾽ ἔφη Κρονίδης· Ἄρης δ᾽ἀπαμείβετο μύθῳ·	- u u- uu- -- uu-uu --	dactylic hexameter	masculine penthemimeral, hepthemimeral, trithemimeral
"Οὔτ᾽ ἄρ᾽ Ἀθηναίης, Κρονίδη, σθένος οὔτε Ἄρηος	- u u--- uu- uu -u u--	dactylic hexameter	masculine penthemimeral, hepthemimeral
ἰσχύει βατράχοισιν ἀμυνέμεν αἰπὺν ὄλεθρον.	--- uu-u u-uu -u u--	dactylic hexameter	feminine penthemimeral, trithemimeral
ἀλλ᾽ ἄγε πάντες ἴωμεν ἀρηγόνες· ἢ τὸ σὸν ὅπλον	- uu -u u-u u-uu - u u --	dactylic hexameter	feminine penthemimeral
κινείσθω· οὕτω γὰρ ἁλώσεται ὅς τις ἄριστος,	--- -- u u-uu - u u--	dactylic hexameter	masculine penthemimeral, trithemimeral
ὥς ποτε καὶ Καπανῆα κατέκτανες ὄβριμον ἄνδρα	- uu - uu-u u-uu -uu --	dactylic hexameter	feminine penthemimeral, trithemimeral
καὶ μέγαν Ἐγκελάδοντα καὶ ἄγρια φῦλα Γιγάντων."	- uu -uu-u u -uu -u u--	dactylic hexameter	feminine penthemimeral
Ὣς ἄρ᾽ ἔφη· Κρονίδης δ᾽λαβὼν ἀργῆτα κεραυνὸν	- u u- uu- -- --u u--	dactylic hexameter	masculine penthemimeral, hepthemimeral, trithemimeral
πρῶτα μὲν ἐβρόντησε, μέγαν δ᾽ἐλέλιξεν Ὄλυμπον,	-u u ---u u- uu-u u--	dactylic hexameter	feminine penthemimeral, hepthemimeral
[αὐτὰρ ἔπειτα κεραυνὸν δειμαλέον Διὸς ὅπλον	-u u-u u-- -uu- uu --	dactylic hexameter	
ἧκ᾽ ἐπιδινήσας· ὁ δ᾽ἄρ᾽ ἔπτατο χειρὸς ἄνακτος.	- uu--- u u -uu -u u--	dactylic hexameter	masculine penthemimeral
πάντας μέν ῥ᾽ἐφόβησε βολὼν ἐπὶ τούσδε τε μύας·	-- - uu-u u- uu -u u --	dactylic hexameter	feminine penthemimeral, hepthemimeral, trithemimeral
ἀλλ᾽ οὐδ᾽ ὣς ἀπέληγε μυῶν στράτος, ἀλλ᾽ ἔτι μᾶλλον	- - - uu-u u- uu - uu --	dactylic hexameter	feminine penthemimeral, hepthemimeral, trithemimeral
ἔλπετο πορθήσείν βατράχων γένος αἰχμητάων.	-uu --- uu- uu ----	dactylic hexameter	masculine penthemimeral, hepthemimeral
(καὶ τάχα δ᾽ἂν δεινῶς οὖν ἀθλήσαντες ἐνίκων,)	- uu - -- - ---u u--	dactylic hexameter	masculine penthemimeral, trithemimeral
εἰ μὴ ἀπ᾽ Οὐλύμπου βατράχους ἐλέησε Κρονίων,	- u u --- uu- uu-u u--	dactylic hexameter	masculine penthemimeral, hepthemimeral
ὅς ῥα φθειρομένοισιν ἀρωγοὺς εὐθὺς ἔπεμψεν·	- - -uu-u u-- -u u--	dactylic hexameter	feminine penthemimeral
Ἦλθον δ᾽ἐξαίφνης νωτάκμονες, ἀγκυλοχεῖλαι,	-- --- --uu -uu--	dactylic hexameter	masculine penthemimeral
λοξοβάται, στρεβλοί, ψαλιδόστομοι, ὀστρακόδερμοι,	-uu- -- uu-uu -uu--	dactylic hexameter	masculine penthemimeral, trithemimeral
ὀστοφυεῖς, πλατύνωτοι, ἀποστίλβοντες ἐν ὤμοίς,	-uu- uu-u u---u u --	dactylic hexameter	feminine penthemimeral, trithemimeral
βλαισοί, χειλοτένοντες, ἀπὸ στέρνων ἐσορῶντες,	-- -uu-u u- -- uu--	dactylic hexameter	feminine penthemimeral, hepthemimeral
ὀκτάποδες, δικάρηνοι, ἀχειρέες, οἱ δὲ καλεῦνται	-uu- uu-u u-uu - u u--	dactylic hexameter	feminine penthemimeral, trithemimeral
καρκίνοι, οἵ ῥα μυῶν οὐρὰς στομάτεσσιν ἔκοπτον	-uu - u u- -- uu-u u--	dactylic hexameter	masculine penthemimeral, hepthemimeral, trithemimeral
ἠδὲ πόδας καὶ χεῖρος· ἀνεγνάμπτοντο δὲ λόγχαι.	-u u- - -u u---u u --	dactylic hexameter	feminine penthemimeral, trithemimeral
τοὺς καὶ ὑπέδ<δ>εισαν δειλοὶ μύες οὐδ᾽ ἔτ᾽ ἔμειναν,	- u u--- -- uu - u u--	dactylic hexameter	masculine penthemimeral, hepthemimeral
ἐς δὲ φυγὴν ἐτράποντο· ἐδύετο δ᾽ἥλιος ἤδη,	- u u- uu-u u-uu -uu --	dactylic hexameter	feminine penthemimeral, trithemimeral
καὶ πολέμου τελετὴ μονοήμερος ἐξετελέσθη.	- uu- uu- uu-uu -uu--	dactylic hexameter	masculine penthemimeral, trithemimeral
