Ζηνὸς ἔοι τί κεν ἄλλο παρὰ σπονδῇσιν ἀείδειν	-u u- u u -u u- --u u--	dactylic hexameter	feminine penthemimeral, hepthemimeral, trithemimeral
λώιον ἢ θεὸν αὐτόν, ἀεὶ μέγαν, αἰὲν ἄνακτα,	-uu - uu -u u- uu -u u--	dactylic hexameter	feminine penthemimeral, hepthemimeral, trithemimeral
Πηλαγόνων ἐλατῆρα, δικασπόλον οὐρανίδῃσι;	-uu- uu-u u-uu -uu--	dactylic hexameter	feminine penthemimeral, trithemimeral
πῶς καί μιν, Δικταῖον ἀείσομεν ἠὲ Λυκαῖον;	- - - --u u-uu -u u--	dactylic hexameter	feminine penthemimeral, trithemimeral
ἐν δοιῇ μάλα θυμός, ἐπεὶ γένος ἀμφήριστον.	- -- uu -u u- uu ----	dactylic hexameter	feminine penthemimeral, hepthemimeral, trithemimeral
Ζεῦ, σὲ μὲν Ἰδαίοισιν ἐν οὔρεσί φασι γενέσθαι,	- u u ---u u -uu -u u--	dactylic hexameter	feminine penthemimeral
Ζεῦ, σὲ δ᾽ἐν Ἀρκαδίῃ· πότεροι, πάτερ, ἐψεύσαντο;	- u u -uu- uu- uu ----	dactylic hexameter	masculine penthemimeral, hepthemimeral
"Κρῆτες ἀεὶ ψεῦσται·" καὶ γὰρ τάφον, ὦ ἄνα, σεῖο	-u u- -- - - uu - uu --	dactylic hexameter	masculine penthemimeral, hepthemimeral, trithemimeral
Κρῆτες ἐτεκτήναντο· σὺ δ᾽οὐ θάνες, ἐσσὶ γὰρ αἰεί.	-u u---u u - uu -u u --	dactylic hexameter	feminine penthemimeral, hepthemimeral
ἐν δέ σε Παρρασίῃ Ῥείη τέκεν, ἧχι μάλιστα	- u u -uu- -- uu -u u--	dactylic hexameter	masculine penthemimeral, hepthemimeral
ἔσκεν ὄρος θάμνοισι περισκεπές· ἔνθεν ὁ χῶρος	-u u- --u u-uu -u u --	dactylic hexameter	feminine penthemimeral, trithemimeral
ἱερός, οὐδέ τί μιν κεχρημένον Εἰλειθυίης	-uu -u u - --uu ----	dactylic hexameter	masculine penthemimeral
ἑρπετὸν οὐδὲ γυνὴ ἐπιμίσγεται, ἀλλά ἑ Ῥείης	-uu -u u- uu-uu -u u --	dactylic hexameter	masculine penthemimeral
ὠγύγιον καλέουσι λεχώιον Ἀπιδανῆες.	-uu- uu-u u-uu -uu--	dactylic hexameter	feminine penthemimeral, trithemimeral
ἔνθα σ᾽ἐπεὶ μήτηρ μεγάλων ἀπεθήκατο κόλπων	-u u- -- uu- uu-uu --	dactylic hexameter	masculine penthemimeral, hepthemimeral, trithemimeral
αὐτίκα δίζητο ῥόον ὕδατος, ᾧ κε τόκοιο	-uu --- uu -uu - u u--	dactylic hexameter	masculine penthemimeral
λύματα χυτλώσαιτο, τεὸν δ᾽ἐνὶ χρῶτα λοέσσαι.	-uu ---u u- uu -u u--	dactylic hexameter	feminine penthemimeral, hepthemimeral
Λάδων ἀλλ᾽ οὔπω μέγας ἔρρεεν οὐδ᾽ Ἐρύμανθος,	-- - -- uu -uu - uu--	dactylic hexameter	masculine penthemimeral, trithemimeral
λευκότατος ποταμῶν, ἔτι δ᾽ἄβροχος ἦεν ἅπασα	-uu- uu- uu -uu -u u--	dactylic hexameter	masculine penthemimeral, trithemimeral
Ἀρκαδίη· μέλλεν δὲ μάλ᾽ εὔυδρος καλέεσθαι	-uu- -- u u --- uu--	dactylic hexameter	masculine penthemimeral, trithemimeral
αὖτις· ἐπεὶ τημόσδε, Ῥέη ὅτ᾽ ἐλύσατο μίτρην,	-u u- --u u- u u-uu --	dactylic hexameter	feminine penthemimeral, hepthemimeral, trithemimeral
ἦ πολλὰς ἐφύπερθε σαρωνίδας ὑγρὸς Ἰάων	- -- uu-u u-uu -u u--	dactylic hexameter	feminine penthemimeral, trithemimeral
ἤειρεν, πολλὰς δὲ Μέλας ὤκχησεν ἁμάξας,	--- -- u u- --u u--	dactylic hexameter	masculine penthemimeral, hepthemimeral, trithemimeral
πολλὰ δὲ Καρνίωνος ἄνω διεροῦ περ ἐόντος	-u u ---u u- uu- u u--	dactylic hexameter	feminine penthemimeral, hepthemimeral
ἰλυοὺς ἐβάλοντο κινώπετα, νίσσετο δ᾽ἀνὴρ	--- uu-u u-uu -uu --	dactylic hexameter	feminine penthemimeral, trithemimeral
πεζὸς ὑπὲρ Κρᾶθίν τε πολύστιόν τε Μετώπην	-u u- -- u u--- u u--	dactylic hexameter	masculine penthemimeral, trithemimeral
διψαλέος· τὸ δὲ πολλὸν ὕδωρ ὑπὸ ποσσὶν ἔκειτο.	-uu- u u -u u- uu -u u--	dactylic hexameter	feminine penthemimeral, hepthemimeral, trithemimeral
καί ῥ᾽ὑπ᾽ ἀμηχανίης σχομένη φάτο πότνια Ῥείη·	- u u-uu- uu- uu -uu --	dactylic hexameter	masculine penthemimeral, hepthemimeral
"Γαῖα φίλη, τέκε καὶ σύ· τεαὶ δ᾽ὠδῖνες ἐλαφραί."	-u u- uu - u u- --u u--	dactylic hexameter	masculine penthemimeral, hepthemimeral, trithemimeral
εἶπε καὶ ἀντανύσασα θεὴ μέγαν ὑψόθι πῆχυν	-u u -uu-u u- uu -uu --	dactylic hexameter	feminine penthemimeral, hepthemimeral
πλῆξεν ὄρος σκήπτρῳ· τὸ δέ οἱ δίχα πουλὺ διέστη,	-u u- -- u u - uu -u u--	dactylic hexameter	masculine penthemimeral, hepthemimeral, trithemimeral
ἐκ δ᾽ἔχεεν μέγα χεῦμα· τόθι χρόα φαιδρύνασα,	- uu- uu -u u- uu -u--	lyric	
ὦνα, τεὸν σπείρωσε, Νέδῃ δέ σε δῶκε κομίζειν	-u u- --u u- u u -u u--	dactylic hexameter	feminine penthemimeral, hepthemimeral, trithemimeral
κευθμὸν ἔσω Κρηταῖον, ἵνα κρύφα παιδεύοιο,	-u u- --u u- uu ----	dactylic hexameter	feminine penthemimeral, hepthemimeral, trithemimeral
πρεσβυτάτῃ Νυμφέων αἵ μιν τότε μαιώσαντο,	-uu- -- - - uu ----	dactylic hexameter	masculine penthemimeral, hepthemimeral, trithemimeral
πρωτίστῃ γενεῇ μετά γε Στύγα τε Φιλύρην τε.	--- uu- uu - uu - uu- -	dactylic hexameter	masculine penthemimeral, hepthemimeral, trithemimeral
οὐδ᾽ ἁλίην ἀπέτεισε θεὴ χάριν, ἀλλὰ τὸ χεῦμα	- uu- uu-u u- uu -u u --	dactylic hexameter	feminine penthemimeral, hepthemimeral, trithemimeral
κεῖνο Νέδην ὀνόμηνε· τὸ μέν ποθι πουλὺ κατ᾽ αὐτὸ	-u u- uu-u u - uu -u u --	dactylic hexameter	feminine penthemimeral, hepthemimeral, trithemimeral
Καυκώνων πτολίεθρον, ὃ Λέπρειον πεφάτισται,	--- uu-u u --- uu--	dactylic hexameter	feminine penthemimeral, trithemimeral
συμφέρεται Νηρῆι, παλαιότατον δέ μιν ὕδωρ	-uu- --u u-uu- u u --	dactylic hexameter	feminine penthemimeral, trithemimeral
υἱωνοὶ πίνουσι Λυκαονίης ἄρκτοιο.	--- --u u-uu- ---	dactylic hexameter	feminine penthemimeral, trithemimeral
εὖτε Θενὰς ἀπέλειπεν ἐπὶ Κνωσοῖο φέρουσα,	-u u- uu-u u- --u u--	dactylic hexameter	feminine penthemimeral, hepthemimeral, trithemimeral
Ζεῦ πάτερ, ἡ Νύμφη σε Θ̔εναὶ δ᾽ἔσαν ἐγγύθι Κνωσοὖ,	- uu - -- u u- uu -uu --	dactylic hexameter	masculine penthemimeral, hepthemimeral, trithemimeral
τουτάκι τοι πέσε, δαῖμον, ἄπ᾽ ὀμφαλός· ἔνθεν ἐκεῖνο	-uu - uu -u u -uu -u u--	dactylic hexameter	feminine penthemimeral, trithemimeral
ὀμφάλιον μετέπειτα πέδον καλέουσι Κύδωνες.	-uu- uu-u u- uu-u u--	dactylic hexameter	feminine penthemimeral, hepthemimeral, trithemimeral
Ζεῦ, σὲ δὲ Κυρβάντων ἑτάραι προσεπηχύναντο	- u u --- uu- uu----	dactylic hexameter	masculine penthemimeral, hepthemimeral
Δικταῖαι Μελίαι, σὲ δ᾽ἐκοίμισεν Ἀδρήστεια	--- uu- u u-uu ----	dactylic hexameter	masculine penthemimeral, trithemimeral
λίκνῳ ἐνὶ χρυσέῳ, δὺ δ᾽ἐθήσαο πίονα μαζὸν	-u u- uu- u u-uu -uu --	dactylic hexameter	masculine penthemimeral, trithemimeral
αἰγὸς Ἀμαλθείης, ἐπὶ σὲ γλυκὺ κηρίον ἔβρως.	-u u--- uu - uu -uu --	dactylic hexameter	masculine penthemimeral, hepthemimeral
γέντο γὰρ ἐξαπιναῖα Πανακρίδος ἔργα μελίσσης	-u u -uu-u u-uu -u u--	dactylic hexameter	feminine penthemimeral
Ἰδαίοις ἐν ὄρεσσι, τά τε κλείουσι Πάνακρα.	--- u u-u u - --u u--	dactylic hexameter	feminine penthemimeral, hepthemimeral, trithemimeral
οὖλα δὲ Κούρητές σε περὶ πρύλιν ὠρχήσαντο	-u u --- u u- uu ----	dactylic hexameter	masculine penthemimeral, hepthemimeral
τεύχεα πεπλήγοντες, ἵνα Κρόνος οὔασιν ἠχὴν	-uu ---u u- uu -uu --	dactylic hexameter	feminine penthemimeral, hepthemimeral
ἀσπίδος εἰσαΐοι καὶ μή σεο κουρίζοντος.	-uu -uu- - - uu ----	dactylic hexameter	masculine penthemimeral, hepthemimeral
καλὰ μὲν ἠέξευ, καλὰ δ᾽ἔτραφες, οὐράνιε Ζεῦ,	-u u --- uu -uu -uu- -	dactylic hexameter	masculine penthemimeral
ὀξὺ δ᾽ἀνήβησας, ταχινοὶ δέ τοι ἦλθον ἴουλοι.	-u u--- uu- u u -u u--	dactylic hexameter	masculine penthemimeral, hepthemimeral
ἀλλ᾽ ἔτι παιδνὸς ἐὼν ἐφράσσαο πάντα τέλεια·	- uu -u u- --uu -u u--	dactylic hexameter	masculine penthemimeral
τῶ τοι καὶ γνωτοὶ προτερηγενέες περ ἐόντες	- - - -- uu-uu- u u--	dactylic hexameter	masculine penthemimeral, trithemimeral
οὐρανὸν οὐκ ἐμέγηραν ἔχειν ἐπιδαίσιον οἶκον.	-uu - uu-u u- uu-uu --	dactylic hexameter	feminine penthemimeral, hepthemimeral, trithemimeral
δηναιοὶ δ᾽οὐ πάμπαν ἀληθέες ἦσαν ἀοιδοί.	--- - -u u-uu -u u--	dactylic hexameter	feminine penthemimeral, trithemimeral
φάντο πάλον Κρονίδῃσι διάτριχα δώματα νεῖμαι·	-u u- uu-u u-uu -uu --	dactylic hexameter	feminine penthemimeral, trithemimeral
τίς δέ κ᾽ἐπ᾽ Οὐλύμπῳ τε καὶ Ἄιδι κλῆρον ἐρύσσαι,	- u u --- u u -- -u u--	dactylic hexameter	masculine penthemimeral
ὃς μάλα μὴ νενίηλος; ἐπ᾽ ἰσαίῃ γὰρ ἔοικε	- uu - uu-u u --- u u--	dactylic hexameter	feminine penthemimeral, trithemimeral
πήλασθαι· τὰ δὲ τόσσον ὅσον διὰ πλεῖστον ἔχουσι.	--- u u -u u- uu -u u--	dactylic hexameter	feminine penthemimeral, hepthemimeral, trithemimeral
ψευδοίμην ἀίοντος ἅ κεν πεπίθοιεν ἀκουήν.	--- uu-u u - uu-u u--	dactylic hexameter	feminine penthemimeral, hepthemimeral, trithemimeral
οὔ σε θεῶν ἐσσῆνα πάλοι θέσαν, ἔργα δὲ χειρῶν,	- u u- --u u- uu -u u --	dactylic hexameter	feminine penthemimeral, hepthemimeral, trithemimeral
σή τε βίη τό τε κάρτος, ὃ καὶ πέλας εἵσαο δίφρου.	- u u- u u -u u - uu -uu --	dactylic hexameter	feminine penthemimeral, hepthemimeral, trithemimeral
θήκαο δ᾽οἰωνῶν μέγ᾽ ὑπείροχον ἀγγελιώτην	-uu --- u u-uu -uu--	dactylic hexameter	masculine penthemimeral
σῶν τεράων· ἅ τ᾽ἐμοῖσι φίλοις ἐνδέξια φαίνοις.	- uu- u u-u u- --uu --	dactylic hexameter	feminine penthemimeral, hepthemimeral, trithemimeral
εἵλεο δ᾽αἰζηῶν ὅ τι φέρτατον· οὐ σύ γε νηῶν	-uu --- u u -uu - u u --	dactylic hexameter	masculine penthemimeral
ἐμπεράμους, οὐκ ἄνδρα σακέσπαλον, οὐ μὲν ἀοιδόν·	-uu- - -u u-uu - u u--	dactylic hexameter	feminine penthemimeral, trithemimeral
ἀλλὰ τὰ μὲν μακάρεσσιν ὀλίζοσιν αὖθι παρῆκας	-u u - uu-u u-uu -u u--	dactylic hexameter	feminine penthemimeral, trithemimeral
ἄλλα μέλειν ἑτέροισι, σὺ δ᾽ἐξέλεο πτολιάρχους	-u u- uu-u u -uu- uu--	dactylic hexameter	feminine penthemimeral, trithemimeral
αὐτούς, ὧν ὑπὸ χεῖρα γεωμόρος, ὧν ἴδρις αἰχμῆς,	-- - uu -u u-uu - uu --	dactylic hexameter	feminine penthemimeral, trithemimeral
ὧν ἐρέτης, ὧν πάντα· τί δ᾽οὐ κρατέοντος ὑπ᾽ ἰοχύν;	- uu- - -u u - uu-u u ---	lyric	
αὐτίκα χαλκῆας μὲν ὑδείομεν Ἡφαίστοιο,	-uu --- u u-uu ----	dactylic hexameter	masculine penthemimeral
τευχηστὰς δ᾽Ἄρηος, ἐπακτῆρας δὲ Χιτώνης	--- --u u--- u u--	dactylic hexameter	feminine penthemimeral, trithemimeral
Ἀρτέμιδος, Φοίβου δὲ λύρης εὖ εἰδότας οἴμους·	-uu- -- u u- - -uu --	dactylic hexameter	masculine penthemimeral, hepthemimeral, trithemimeral
ἐκ δὲ Διὸς βασιλῆες, ἐπεὶ Διὸς οὐδὲν ἀνάκτων	- u u- uu-u u- uu -u u--	dactylic hexameter	feminine penthemimeral, hepthemimeral, trithemimeral
θειότερον· τῶ καί σφε τεὴν ἐκρίναο λάξιν.	-uu- - - u u- --uu --	dactylic hexameter	masculine penthemimeral, hepthemimeral, trithemimeral
δῶκας δὲ πτολίεθρα φυλασσέμεν, ἵζεο δ᾽αὐτὸς	-- - uu-u u-uu -uu --	dactylic hexameter	feminine penthemimeral, trithemimeral
ἄκρῃσ᾽ ἐν πολίεσσιν, ἐπόψιος οἵ τε δίκῃσι	-- - uu-u u-uu - u u--	dactylic hexameter	feminine penthemimeral, trithemimeral
λαὸν ὑπὸ σκολιῇσ᾽ οἵ τ᾽ἔμπαλιν ἰθύνουσιν·	-u u- uu- - -uu ----	dactylic hexameter	masculine penthemimeral, trithemimeral
ἐν δὲ ῥυηφενίην ἔβαλές σφισιν, ἐν δ᾽ἅλις ὄλβον·	- u u-uu- uu- uu - uu --	dactylic hexameter	masculine penthemimeral, hepthemimeral
πᾶσι μέν, οὐ μάλα δ᾽ἶσον. ἔοικε δὲ τεκμήρασθαι	-u u - uu -u u-u u ----	dactylic hexameter	feminine penthemimeral, trithemimeral
ἡμετέρῳ μεδέοντι· περιπρὸ γὰρ εὐρὺ βέβηκεν.	-uu- uu-u u-u u -u u--	dactylic hexameter	feminine penthemimeral, trithemimeral
ἑσπέριος κεῖνός γε τελεῖ τά κεν ἦρι νοήσῃ·	-uu- -- u u- u u -u u--	dactylic hexameter	masculine penthemimeral, hepthemimeral, trithemimeral
ἑσπέριος τὰ μέγιστα, τὰ μείονα δ᾽,εὖτε νοήσῃ.	-uu- u u-u u -uu -u u--	dactylic hexameter	feminine penthemimeral, trithemimeral
οἱ δὲ τὰ μὲν πλειῶνι, τὰ δ᾽οὐχ ἑνί, τῶν δ᾽ἀπὸ πάμπαν	- u u - --u u - uu - uu --	dactylic hexameter	feminine penthemimeral, hepthemimeral, trithemimeral
αὐτὸς ἄνην ἐκόλουσας, ἐνέκλασσας δὲ μενοινήν.	-u u- uu-u u--- u u--	dactylic hexameter	feminine penthemimeral, trithemimeral
χαῖρε μέγα, Κρονίδη πανυπέρτατε, δῶτορ ἐάων,	-u u- uu- uu-uu -u u--	dactylic hexameter	masculine penthemimeral, trithemimeral
δῶτορ ἀπημονίης. τεὰ δ᾽ἔργματα τίς κεν ἀείδοι;	-u u-uu- uu -uu - u u--	dactylic hexameter	masculine penthemimeral
οὐ γένετ᾽, οὐκ ἔσται, τίς κεν Διὸς ἔργματ᾽ ἀείσαι.	- uu - -- - - uu -u u--	dactylic hexameter	masculine penthemimeral, hepthemimeral, trithemimeral
χαῖρε πάτερ, χαῖρ᾽ αὖθι· δίδου δ᾽ἀρετήν τ᾽ἄφενός τε.	-u u- - -u u- uu- uu- -	dactylic hexameter	feminine penthemimeral, hepthemimeral, trithemimeral
οὔτ᾽ ἀρετῆς ἄτερ ὄλβος ἐπίσταται ἄνδρας ἀέξειν	- uu- uu -u u-uu -u u--	dactylic hexameter	feminine penthemimeral, trithemimeral
οὔτ᾽ ἀρετὴ ἀφένοιο· δίδου δ᾽ἀρετήν τε καὶ ὄλβον.	- uu- uu-u u- uu- u u --	dactylic hexameter	feminine penthemimeral, hepthemimeral, trithemimeral
οἷον ὁ τὠπόλλωνος ἐσείσατο δάφνινος ὅρπηξ,	-u u ---u u-uu -uu --	dactylic hexameter	feminine penthemimeral
οἷα δ᾽ὅλον τὸ μέλαθρον· ἑκάς, ἑκὰς ὅστις ἀλιτρός.	-u u- u u-u u- uu -u u--	dactylic hexameter	feminine penthemimeral, hepthemimeral, trithemimeral
καὶ δή που τὰ θύρετρα καλῷ ποδὶ Φοῖβος ἀράσσει·	- - - u u-u u- uu -u u--	dactylic hexameter	feminine penthemimeral, hepthemimeral, trithemimeral
οὐχ ὁράᾳς; ἐπένευσεν ὁ Δήλιος ἡδύ τι φοῖνιξ	- uu- uu-u u -uu -u u --	dactylic hexameter	feminine penthemimeral, trithemimeral
ἐξαπίνης, ὁ δὲ κύκνος ἐν ἠέρι καλὸν ἀείδει.	-uu- u u -u u -uu -u u--	dactylic hexameter	feminine penthemimeral, trithemimeral
αὐτοὶ νῦν κατοχῆες ἀνακλίνεσθε πυλάων,	-- - uu-u u---u u--	dactylic hexameter	feminine penthemimeral, trithemimeral
αὐταὶ δὲ κληῖδες· ὁ γὰρ θεὸς οὐκέτι μακρήν·	-- - --u u - uu -uu --	dactylic hexameter	feminine penthemimeral, hepthemimeral, trithemimeral
οἱ δὲ νέοι μολπήν τε καὶ ἐς χορὸν ἐντύνεσθε.	- u u- -- u u - uu ----	dactylic hexameter	masculine penthemimeral, hepthemimeral, trithemimeral
ὡπόλλων οὐ παντὶ φαείνεται, ἀλλ᾽ ὅ τις ἐσθλός·	--- - -u u-uu - u u --	dactylic hexameter	feminine penthemimeral, trithemimeral
ὅς μιν ἴδῃ, μέγας οὗτος, ὃς οὐκ ἴδε, λιτὸς ἐκεῖνος.	- u u- uu -u u - uu -u u--	dactylic hexameter	feminine penthemimeral, hepthemimeral, trithemimeral
ὀψόμεθ᾽, ὦ Ἑκάεργε, καὶ ἐσσόμεθ᾽ οὔποτε λιτοί.	-uu - uu-u u -uu -uu --	dactylic hexameter	feminine penthemimeral, trithemimeral
μήτε σιωπηλὴν κίθαριν μήτ᾽ ἄψοφον ἴχνος	-u u--- uu- - -uu --	dactylic hexameter	masculine penthemimeral, hepthemimeral
τοῦ Φοίβου τοὺς παῖδας ἔχειν ἐπιδημήσαντος,	- -- - -u u- uu----	dactylic hexameter	feminine penthemimeral, hepthemimeral, trithemimeral
εἰ τελέειν μέλλουσι γάμον πολιήν τε κερεῖσθαι,	- uu- --u u- uu- u u--	dactylic hexameter	feminine penthemimeral, hepthemimeral, trithemimeral
ἑστήξειν δὲ τὸ τεῖχος ἐπ᾽ ἀρχαίοισι θεμέθλοις.	--- u u -u u ---u u--	dactylic hexameter	feminine penthemimeral, trithemimeral
ἠγασάμην τοὺς παῖδας, ἐπεὶ χέλυς οὐκέτ᾽ ἀεργός.	-uu- - -u u- uu -u u--	dactylic hexameter	feminine penthemimeral, hepthemimeral, trithemimeral
εὐφημεῖτ᾽ ἀίοντες ἐπ᾽ Ἀπόλλωνος ἀοιδῇ.	--- uu-u u ---u u--	dactylic hexameter	feminine penthemimeral, trithemimeral
εὐφημεῖ καὶ πόντος, ὅτε κλείουσιν ἀοιδοὶ	--- - -u u- --u u--	dactylic hexameter	feminine penthemimeral, hepthemimeral, trithemimeral
ἢ κίθαριν ἢ τόξα, Λυκωρέος ἔντεα Φοίβου.	- uu- - -u u-uu -uu --	dactylic hexameter	feminine penthemimeral, trithemimeral
οὐδὲ Θέτις Ἀχιλῆα κινύρεται αἴλινα μήτηρ,	-u u- uu-u u-uu -uu --	dactylic hexameter	feminine penthemimeral, trithemimeral
ὁππόθ᾽ ἱὴ παιῆον ἱὴ παιῆον ἀκούσῃ.	-u u- --u u- --u u--	dactylic hexameter	feminine penthemimeral, hepthemimeral, trithemimeral
καὶ μὲν ὁ δακρυόεις ἀναβάλλεται ἄλγεα πέτρος,	- u u -uu- uu-uu -uu --	dactylic hexameter	masculine penthemimeral
ὅστις ἐνὶ Φρυγίῃ διερὸς λίθος ἐστήρικται,	-u u- uu- uu- uu ----	dactylic hexameter	masculine penthemimeral, hepthemimeral, trithemimeral
μάρμαρον ἀντὶ γυναικὸς ὀιζυρόν τι χανούσης.	-uu -u u-u u--- u u--	dactylic hexameter	feminine penthemimeral
ἱὴ ἱὴ φθέγγεσθε· κακὸν μακάρεσσιν ἐρίζειν.	-u u- --u u- uu-u u--	dactylic hexameter	feminine penthemimeral, hepthemimeral, trithemimeral
ὃς μάχεται μακάρεσσιν, ἐμῷ βασιλῆι μάχοιτο·	- uu- uu-u u- uu-u u--	dactylic hexameter	feminine penthemimeral, hepthemimeral, trithemimeral
ὅστις ἐμῷ βασιλῆι, καὶ Ἀπόλλωνι μάχοιτο.	-u u- uu-u u ---u u--	dactylic hexameter	feminine penthemimeral, trithemimeral
τὸν χορὸν ὡπόλλων, ὅ τι οἱ κατὰ θυμὸν ἀείδει,	- uu --- u u - uu -u u--	dactylic hexameter	masculine penthemimeral, hepthemimeral
τιμήσει· δύναται γάρ, ἐπεὶ Διὶ δεξιὸς ἧσται.	--- uu- u u- uu -uu --	dactylic hexameter	masculine penthemimeral, hepthemimeral, trithemimeral
οὐδ᾽ ὁ χορὸς τὸν Φοῖβον ἐφ᾽ ἓν μόνον ἦμαρ ἀείσει,	- u u- - -u u - uu -u u--	dactylic hexameter	feminine penthemimeral, hepthemimeral, trithemimeral
ἔστι γὰρ εὔυμνος· τίς ἂν οὐ ῥέα Φοῖβον ἀείδοι;	-u u --- u u - uu -u u--	dactylic hexameter	masculine penthemimeral, hepthemimeral
χρύσεα τὠπόλλωνι τό τ᾽ ἐνδυτὸν ἥ τ᾽ἐπιπορπὶς	-uu ---u u -uu - uu--	dactylic hexameter	feminine penthemimeral
ἥ τε λύρη τό τ᾽ἄεμμα τὸ Λύκτιον ἥ τε φαρέτρη,	- u u- u u-u u -uu - u u--	dactylic hexameter	feminine penthemimeral, trithemimeral
χρύσεα καὶ τὰ πέδιλα· πολύχρυσος γὰρ Ἀπόλλων.	-uu - u u-u u--- u u--	dactylic hexameter	feminine penthemimeral, trithemimeral
καὶ δὲ πολυκτέανος· Πυθῶνί κε τεκμήραιο.	- u u-uu- --u u ----	dactylic hexameter	masculine penthemimeral
καὶ μὲν ἀεὶ καλὸς καὶ ἀεὶ νέος· οὔποτε Θοίβου	- u u- -- u u- uu -uu --	dactylic hexameter	masculine penthemimeral, hepthemimeral, trithemimeral
θηλείῃσ᾽ οὐδ᾽ ὅσσον ἐπὶ χνόος ἦλθε παρειαῖς.	--- - -u u- uu -u u--	dactylic hexameter	feminine penthemimeral, hepthemimeral, trithemimeral
αἱ δὲ κόμαι θυόεντα πέδῳ λείβουσιν ἔλαια·	- u u- uu-u u- --u u--	dactylic hexameter	feminine penthemimeral, hepthemimeral, trithemimeral
οὐ λίπος Ἀπόλλωνος ἀποστάζουσιν ἔθειραι,	- uu ---u u---u u--	dactylic hexameter	feminine penthemimeral
ἀλλ᾽ αὐτὴν πανάκειαν· ἐν ἄστεϊ δ᾽ᾧ κεν ἐκεῖναι	- -- uu-u u -uu - u u--	dactylic hexameter	feminine penthemimeral, trithemimeral
πρῶκες ἔραζε πέσωσιν ἀκήρια πάντ᾽ ἐγένοντο.	-u u-u u-u u-uu - uu--	dactylic hexameter	feminine penthemimeral
τέχνῃ δ᾽ἀμφιλαφὴς οὔ τις τόσον ὅσσον Ἀπόλλων·	-- -uu- - - uu -u u--	dactylic hexameter	masculine penthemimeral, hepthemimeral
κεῖνος ὀιστευτὴν ἔλαχ᾽ ἀνέρα, κεῖνος ἀοιδὸν	-u u--- uu -uu -u u--	dactylic hexameter	masculine penthemimeral
Φοίβῳ γὰρ καὶ τόξον ἐπιτρέπεται καὶ ἀοιδή,	-- - - -u u-uu- u u--	dactylic hexameter	feminine penthemimeral, trithemimeral
κείνου δὲ θριαὶ καὶ μάντιες· ἐκ δέ νυ Φοίβου	-- - -- - -uu - u u --	dactylic hexameter	masculine penthemimeral, trithemimeral
ἰητροὶ δεδάασιν ἀνάβλησιν θανάτοιο.	--- uu-u u--- uu--	dactylic hexameter	feminine penthemimeral, trithemimeral
Φοῖβον καὶ Νόμιον κικλήσκομεν ἐξέτι κείνου,	-- - uu- --uu -uu --	dactylic hexameter	masculine penthemimeral, trithemimeral
ἐξότ᾽ ἐπ᾽ Ἀμφρυσσῷ ζευγίτιδας ἔτρεφεν ἵππους	-u u --- --uu -uu --	dactylic hexameter	masculine penthemimeral
ἠιθέου ὑπ᾽ ἔρωτι κεκαυμένος Ἀδμήτοιο.	-uu- u u-u u-uu ----	dactylic hexameter	feminine penthemimeral, trithemimeral
ῥεῖά κε βουβόσιον τελέθοι πλέον, οὐδέ κεν αἶγες	-u u -uu- uu- uu -u u --	dactylic hexameter	masculine penthemimeral, hepthemimeral
δεύοιντο βρεφέων ἐπιμηλάδες ᾗδιν Ἀπόλλων	--- uu- uu-uu -u u--	dactylic hexameter	masculine penthemimeral, trithemimeral
βοσκομένῃσ᾽ ὀφθαλμὸν ἐπήγαγεν· οὐδ᾽ ἀγάλακτες	-uu- --u u-uu - uu--	dactylic hexameter	feminine penthemimeral, trithemimeral
οἴιες οὐδ᾽ ἄκυθοι, πᾶσαι δέ κεν εἶεν ὕπαρνοι,	-uu - uu- -- u u -u u--	dactylic hexameter	masculine penthemimeral, hepthemimeral, trithemimeral
ἡ δέ κε μουνοτόκος διδυμητόκος αἶψα γένοιτο.	- u u -uu- uu-uu -u u--	dactylic hexameter	masculine penthemimeral
Φοίβῳ δ᾽ἑσπόμενοι πόλιας διεμετρήσαντο	-- -uu- uu- uu----	dactylic hexameter	masculine penthemimeral, hepthemimeral
ἄνθρωποι· Φοῖβος γὰρ ἀεὶ πολίεσσι φιληδεῖ	--- -- u u- uu-u u--	dactylic hexameter	masculine penthemimeral, hepthemimeral, trithemimeral
κτιζομένῃσ᾽, αὐτὸς δὲ θεμείλια Φοῖβος ὑφαίνει.	-uu- -- u u-uu -u u--	dactylic hexameter	masculine penthemimeral, trithemimeral
τετραέτης τὰ πρῶτα θεμείλια Φοῖβος ἔπηξε	-uu- - -u u-uu -u u--	dactylic hexameter	feminine penthemimeral, trithemimeral
καλῇ ἐν Ὀρτυγίῃ περιηγέος ἐγγύθι λίμνης.	-u u -uu- uu-uu -uu --	dactylic hexameter	masculine penthemimeral
Ἄρτεμις ἀγρώσσουσα καρήατα συνεχὲς αἰγῶν	-uu ---u u-uu -uu --	dactylic hexameter	feminine penthemimeral
Κυνθιάδων φορέεσκεν, ὁ δ᾽ἔπλεκε βωμὸν Ἀπόλλων.	-uu- uu-u u -uu -u u--	dactylic hexameter	feminine penthemimeral, trithemimeral
δείματο μὲν κεράεσσιν ἐδέθλια, πῆξε δὲ βωμὸν	-uu - uu-u u-uu -u u --	dactylic hexameter	feminine penthemimeral, trithemimeral
ἐκ κεράων, κεραοὺς δὲ πέριξ ὑπεβάλλετο τοίχους.	- uu- uu- u u- uu-uu --	dactylic hexameter	masculine penthemimeral, hepthemimeral, trithemimeral
ὧδ᾽ ἔμαθεν τὰ πρῶτα θεμείλια Φοῖβος ἐγείρειν.	- uu- - -u u-uu -u u--	dactylic hexameter	feminine penthemimeral, trithemimeral
Φοῖβος καὶ βαθύγειον ἐμὴν πόλιν ἔφρασε Βάττῳ	-- - uu-u u- uu -uu --	dactylic hexameter	feminine penthemimeral, hepthemimeral, trithemimeral
καὶ Λιβύην ἐσιόντι κόραξ ἡγήσατο λαῷ	- uu- uu-u u- --uu --	dactylic hexameter	feminine penthemimeral, hepthemimeral, trithemimeral
δεξιὸς οἰκιστῆρι καὶ ὤμοσε τείχεα δώσειν	-uu ---u u -uu -uu --	dactylic hexameter	feminine penthemimeral
ἡμετέροις βασιλεῦσιν· ἀεὶ δ᾽εὔορκος Ἀπόλλων.	-uu- uu-u u- --u u--	dactylic hexameter	feminine penthemimeral, hepthemimeral, trithemimeral
ὤπολλον, πολλοί σε Βοηδρόμιον καλέουσι,	--- -- u u-uu- uu--	dactylic hexameter	masculine penthemimeral, trithemimeral
πολλοὶ δὲ Κλάριον, πάντη δέ τοι οὔνομα πουλύ·	-- - uu- -- u u -uu --	dactylic hexameter	masculine penthemimeral, hepthemimeral, trithemimeral
αὐτὰρ ἐγὼ Καρνεῖον· ἐμοὶ πατρώιον οὕτω.	-u u- --u u- --uu --	dactylic hexameter	feminine penthemimeral, hepthemimeral, trithemimeral
Σπάρτη τοι, Καρνεῖε, τὸ δὴ πρώτιστον ἔδεθλον,	-- - --u u - --u u--	dactylic hexameter	feminine penthemimeral, hepthemimeral, trithemimeral
δεύτερον αὖ Θήρη, τρίτατόν γε μὲν ἄστυ Κυρήνης.	-uu - -- uu- u u -u u--	dactylic hexameter	masculine penthemimeral, hepthemimeral, trithemimeral
ἐκ μέν σε Σπάρτης ἕκτον γένος Οἰδιπόδαο	- - - -- -- uu -uu--	dactylic hexameter	masculine penthemimeral, hepthemimeral, trithemimeral
ἤγαγε Θηραίην ἐς ἀπόκτισιν· ἐκ δέ σε Θήρης	-uu --- u u-uu - u u --	dactylic hexameter	masculine penthemimeral
οὖλος Ἀριστοτέλης Ἀσβυστίδι πάρθετο γαίῃ,	-u u-uu- --uu -uu --	dactylic hexameter	masculine penthemimeral
δεῖμε δέ τοι μάλα καλὸν ἀνάκτορον, ἐν δὲ πόληι	-u u - uu -u u-uu - u u--	dactylic hexameter	feminine penthemimeral, trithemimeral
θῆκε τελεσφορίην ἐπετήσιον, ᾗ ἐνὶ πολλοὶ	-u u-uu- uu-uu - uu --	dactylic hexameter	masculine penthemimeral
ὑστάτιον πίπτουσιν ἐπ᾽ ἰσχίον, ὦ ἄνα, ταῦροι.	-uu- --u u -uu - uu --	dactylic hexameter	feminine penthemimeral, trithemimeral
ἱὴ ἱὴ Καρνεῖε πολύλλιτε, σεῖο δὲ βωμοὶ	-u u- --u u-uu -u u --	dactylic hexameter	feminine penthemimeral, trithemimeral
ἄνθεα μὲν φορέουσιν ἐν εἴαρι τόσσα περ Ὧραι	-uu - uu-u u -uu -u u --	dactylic hexameter	feminine penthemimeral, trithemimeral
ποικίλ᾽ ἀγινεῦσι ζεφύρου πνείοντος ἐέρσην,	-u u--- uu- --u u--	dactylic hexameter	masculine penthemimeral, hepthemimeral
χείματι δὲ κρόκον ἡδύν· ἀεὶ δέ τοι ἀέναον πῦρ,	-uu - uu -u u- u u -uu- -	dactylic hexameter	feminine penthemimeral, hepthemimeral, trithemimeral
οὐδέ ποτε χθιζὸν περιβόσκεται ἄνθρακα τέφρη.	-u u- -- uu-uu -uu --	dactylic hexameter	masculine penthemimeral, trithemimeral
ἦ ῥ᾽ἐχάρη μέγα Φοῖβος, ὅτε ζωστῆρες Ἐνυοῦς	- uu- uu -u u- --u u--	dactylic hexameter	feminine penthemimeral, hepthemimeral, trithemimeral
ἀνέρες ὠρχήσαντο μετὰ ξανθῇσι Λιβύσσαις,	-uu ---u u- --u u--	dactylic hexameter	feminine penthemimeral, hepthemimeral
τέθμιαι εὖτέ σφιν Καρνειάδες ἤλυθον ὧραι.	-uu -- - --uu -uu --	dactylic hexameter	masculine penthemimeral
οἱ δ᾽οὔπω πηγῇσι Κύρης ἐδύναντο πελάσσαι	- -- --u u- uu-u u--	dactylic hexameter	feminine penthemimeral, hepthemimeral, trithemimeral
Δωριέες, πυκινὴν δὲ νάπαις Ἄζιλιν ἔναιον.	-uu- uu- u u- --u u--	dactylic hexameter	masculine penthemimeral, hepthemimeral, trithemimeral
τοὺς μὲν ἄναξ ἴδεν αὐτός, ἑῇ δ᾽ἐπεδείξατο νύμφῃ	- u u- uu -u u- uu-uu --	dactylic hexameter	feminine penthemimeral, hepthemimeral, trithemimeral
στὰς ἐπὶ Μυρτούσσης κερατώδεος, ἧχι λέοντα	- uu --- uu-uu -u u--	dactylic hexameter	masculine penthemimeral
Ὑψηὶς κατέπεφνε βοῶν σίνιν Εὐρυπύλοιο.	--- uu-u u- uu -uu--	dactylic hexameter	feminine penthemimeral, hepthemimeral, trithemimeral
οὐ κείνου χορὸν εἶδε θεώτερον ἄλλον Ἀπόλλων,	- -- uu -u u-uu -u u--	dactylic hexameter	feminine penthemimeral, trithemimeral
οὐδὲ πόλει τόσ᾽ ἔνειμεν ὀφέλσιμα, τόσσα Κυρήνῃ,	-u u- u u-u u-uu -u u--	dactylic hexameter	feminine penthemimeral, trithemimeral
μνωόμενος προτέρης ἁρπακτύος. οὐδὲ μὲν αὐτοὶ	-uu- uu- --uu -u u --	dactylic hexameter	masculine penthemimeral, trithemimeral
Βαττιάδαι Φοίβοιο πλέον θεὸν ἄλλον ἔτεισαν.	-uu- --u u- uu -u u--	dactylic hexameter	feminine penthemimeral, hepthemimeral, trithemimeral
ἱὴ ἱὴ παιῆον ἀκούομεν, οὕνεκα τοῦτο	-u u- --u u-uu -uu --	dactylic hexameter	feminine penthemimeral, trithemimeral
Δελφός τοι πρώτιστον ἐφύμνιον εὕρετο λαός,	-- - --u u-uu -uu --	dactylic hexameter	feminine penthemimeral, trithemimeral
ἦμος ἑκηβολίην χρυσέων ἐπεδείκνυσο τόξων.	-u u-uu- -- uu-uu --	dactylic hexameter	masculine penthemimeral, hepthemimeral
Πυθώ τοι κατιόντι συνήντετο δαιμόνιος θήρ,	-- - uu-u u-uu -uu- -	dactylic hexameter	feminine penthemimeral, trithemimeral
αἰνὸς ὄφις. τὸν μὲν σὺ κατήναρες ἄλλον ἐπ᾽ ἄλλῳ	-u u- - - u u-uu -u u --	dactylic hexameter	masculine penthemimeral, trithemimeral
βάλλων ὠκὺν ὀιστόν, ἐπηύτησε δὲ λαός,	-- -u u-u u--- - --	dactylic hexameter	feminine penthemimeral
"ἱὴ ἱὴ παιῆον, ἵει βέλος." εὐθύ σε μήτηρ	-u u- --u u- uu -u u --	dactylic hexameter	feminine penthemimeral, hepthemimeral, trithemimeral
γείνατ᾽ ἀοσσητῦρα, τὸ δ᾽ἐξέτι κεῖθεν ἀείδῃ.	-u u---u u -uu -u u--	dactylic hexameter	feminine penthemimeral
ὁ Φθόνος Ἀπόλλωνος ἐπ᾽ οὔατα λάθριος εἶπεν	- uu ---u u -uu -uu --	dactylic hexameter	feminine penthemimeral
"οὐκ ἄγαμαι τὸν ἀοιδὸν ὃς οὐδ᾽ ὅσα πόντος ἀείδει."	- uu- u u-u u - uu -u u--	dactylic hexameter	feminine penthemimeral, hepthemimeral, trithemimeral
τὸν Φθόνον ὡπόλλων ποδί τ᾽ἤλασεν ὧδέ τ᾽ἔειπεν·	- uu --- uu -uu -u u--	dactylic hexameter	masculine penthemimeral
"Ἀσσυρίου ποταμοῖο μέγας ῥόος, ἀλλὰ τὰ πολλὰ	-uu- uu-u u- uu -u u --	dactylic hexameter	feminine penthemimeral, hepthemimeral, trithemimeral
λύματα γῆς καὶ πολλὸν ἐφ᾽ ὕδατι συρφετὸν ἕλκει.	-uu - - -u u -uu -uu --	dactylic hexameter	feminine penthemimeral, trithemimeral
Δηοῖ δ᾽οὐκ ἀπὸ παντὸς ὕδωρ φορέουσι Μέλισσαι,	-- - uu -u u- uu-u u--	dactylic hexameter	feminine penthemimeral, hepthemimeral, trithemimeral
ἥτις καθαρή τε καὶ ἀχράαντος ἀνέρπει	-- uu- u u ---u u--	lyric	
πίδακος ἐξ ἱερῆς ὀλίγη λιβὰς ἄκρον ἄωτον.'	-uu - uu- uu- uu -u u--	dactylic hexameter	masculine penthemimeral, hepthemimeral, trithemimeral
χαῖρε ἄναξ· ὁ δὲ Μῶμος, ἵν᾽ ὁ Φθόνος, ἔνθα νέοιτο.	-u u- u u -u u - uu -u u--	dactylic hexameter	feminine penthemimeral, hepthemimeral, trithemimeral
Ἄρτεμιν, οὐ γὰρ ἐλαφρὸν ἀειδόντεσσι λαθέσθαἰ	-uu - u u-u u---u u--	dactylic hexameter	feminine penthemimeral, trithemimeral
ὑμνέομεν, τῇ τόξα λαγωβολίαι τε μέλονται	-uu- - -u u-uu- u u--	dactylic hexameter	feminine penthemimeral, trithemimeral
καὶ χορὸς ἀμφιλαφὴς καὶ ἐν οὔρεσιν ἑψιάασθαι,	- uu -uu- u u -uu -uu--	dactylic hexameter	masculine penthemimeral
ἄρχμενοι, ὡς ὅτε πατρὸς ἐφεζομένη γονάτεσσι	-uu - uu -u u-uu- uu--	dactylic hexameter	feminine penthemimeral, trithemimeral
παῖς ἔτι κουρίζουσα τάδε προσέειπε γονῆα	- uu ---u u- uu-u u--	dactylic hexameter	feminine penthemimeral, hepthemimeral
"δός μοι παρθενίην αἰώνιον, ἄππα, φυλάσσειν,	- - -uu- --uu -u u--	dactylic hexameter	masculine penthemimeral
καὶ πολυωνυμίην, ἵνα μή μοι Φοῖβος ἐρίζῃ.	- uu-uu- uu - - -u u--	dactylic hexameter	masculine penthemimeral, hepthemimeral
δὸς δ᾽ἰοὺς καὶ τόξα· ἔα, πάτερ, οὔ σε Φαρέτρην	- -- - -u u- uu - u u--	dactylic hexameter	feminine penthemimeral, hepthemimeral, trithemimeral
οὐδ᾽ αἰτέω μέγα τόξον· ἐμοὶ Κύκλωπες ὀιστοὺς	- -- uu -u u- --u u--	dactylic hexameter	feminine penthemimeral, hepthemimeral, trithemimeral
αὐτίκα τεχνήσονται, ἐμοὶ δ᾽εὐκαμπὲς ἄεμμα·	-uu ---u u- --u u--	dactylic hexameter	feminine penthemimeral, hepthemimeral
ἀλλὰ φαεσφορίην τε καὶ ἐς γόνυ μέχρι χιτῶνα	-u u-uu- u u - uu -u u--	dactylic hexameter	masculine penthemimeral, hepthemimeral
ζώννυσθαι λεγνωτόν, ἵν᾽ ἄγρια θηρία καίνω.	--- --u u -uu -uu --	dactylic hexameter	feminine penthemimeral, trithemimeral
δὸς δέ μοι ἑξήκοντα χορίτιδας Ὠκεανίνας,	- u u ---u u-uu -uu--	dactylic hexameter	feminine penthemimeral
πάσας εἰνέτεας, πάσας ἔτι παῖδας ἀμίτρους.	-- -uu- uu -- -u u--	dactylic hexameter	masculine penthemimeral
δὸς δέ μοι ἀμφιπόλους Ἀμνισίδας εἴκοσι νύμφας,	- u u -uu- --uu -uu --	dactylic hexameter	masculine penthemimeral
αἵ τέ μοι ἐνδρομίδας τε καὶ ὁππότε μηκέτι λύγκας	- u u -uu- u u -uu -uu --	dactylic hexameter	masculine penthemimeral
μήτ᾽ ἐλάφους βάλλοιμι, θοοὺς κύνας εὖ κομέοιεν,	- uu- --u u- uu - uu--	dactylic hexameter	feminine penthemimeral, hepthemimeral, trithemimeral
δὸς δέ μοι οὔρεα πάντα· πόλιν δέ μοι ἥντινα νεῖμον	- u u -uu -u u- u u -uu --	dactylic hexameter	feminine penthemimeral, hepthemimeral
ἥντινα λῇς· σπαρνὸν γὰρ ὅτ᾽ Ἄρτεμις ἄστυ κάτεισιν·	-uu - -- u u -uu -u u--	dactylic hexameter	masculine penthemimeral, trithemimeral
οὔρεσιν οἰκήσω, πόλεσιν δ᾽ἐπιμείξομαι ἀνδρῶν	-uu --- uu- uu-uu --	dactylic hexameter	masculine penthemimeral, hepthemimeral
μοῦνον ὅτ᾽ ἐξείῃσιν ὑπ᾽ ὠδίνεσσι γυναῖκες	-u u ---u u ---u u--	dactylic hexameter	feminine penthemimeral
τειρόμεναι καλέουσι βοηθόον, ᾗσί με Μοῖραι	-uu- uu-u u-uu -u u --	dactylic hexameter	feminine penthemimeral, trithemimeral
γεινομένην τὸ πρῶτον ἐπεκλήρωσαν ἀρήγειν,	-uu- - -u u---u u--	dactylic hexameter	feminine penthemimeral, trithemimeral
ὅττι με καὶ τίκτουσα καὶ οὐκ ἤλγησε φέρουσα	-u u - --u u - --u u--	dactylic hexameter	feminine penthemimeral, hepthemimeral, trithemimeral
μήτηρ, ἀλλ᾽ ἀμογητὶ φίλων ἀπεθήκατο γυίων."	-- - uu-u u- uu-uu --	dactylic hexameter	feminine penthemimeral, hepthemimeral, trithemimeral
ὣς ἡ παῖς εἰποῦσα γενειάδος ἤθελε πατρὸς	- - - --u u-uu -uu --	dactylic hexameter	feminine penthemimeral, trithemimeral
ἅψασθαι, πολλὰς δὲ μάτην ἐτανὐσσατο χεῖρας,	--- -- u u- uu-uu --	dactylic hexameter	masculine penthemimeral, hepthemimeral, trithemimeral
μέχρις ἵνα ψαύσειε. πατὴρ δ᾽ἐπένευσε γελάσσας,	-u u- --u u- uu-u u--	dactylic hexameter	feminine penthemimeral, hepthemimeral, trithemimeral
φῆ δὲ καταρρέζων "ὅτε μοι τοιαῦτα θέαιναι	- u u--- uu - --u u--	dactylic hexameter	masculine penthemimeral, hepthemimeral
τίκτοιεν, τυτθόν κεν ἐγὼ ζηλήμονος Ἥρης	--- -- u u- --uu --	dactylic hexameter	masculine penthemimeral, hepthemimeral, trithemimeral
χωομένης ἀλέγοιμι. φέρευ, τέκος, ὅσσ᾽ ἐθελημὸς	-uu- uu-u u- uu - uu--	dactylic hexameter	feminine penthemimeral, hepthemimeral, trithemimeral
αἰτίζεις, καὶ δ᾽ἄλλα πατὴρ ἔτι μείζονα δώσει.	--- - -u u- uu -uu --	dactylic hexameter	feminine penthemimeral, hepthemimeral, trithemimeral
τρὶς δέκα τοι πτολίεθρα καὶ οὐχ ἕνα πύργον ὀπάσσω,	- uu - uu-u u - uu -u u--	dactylic hexameter	feminine penthemimeral, hepthemimeral, trithemimeral
τρὶς δέκα τοι πτολίεθρα, τὰ μὴ θεὸν ἄλλον ἀέξειν	- uu - uu-u u - uu -u u--	dactylic hexameter	feminine penthemimeral, hepthemimeral, trithemimeral
εἴσεται, ἀλλὰ μόνην σὲ καὶ Ἀρτέμιδος καλέεσθαι·	-uu -u u- u u -uu- uu--	dactylic hexameter	masculine penthemimeral
πολλὰς δὲ ξυνῇ πόλιας διαμετρήσασθαι	-- - -- uu- uu----	dactylic hexameter	masculine penthemimeral, hepthemimeral, trithemimeral
μεσσόγεως νήσους τε· καὶ ἐν πάσῃσιν ἔσονται	-uu- -- u u - --u u--	dactylic hexameter	masculine penthemimeral, hepthemimeral, trithemimeral
Ἀρτέμιδος βωμοί τε καὶ ἄλσεα. καὶ μὲν ἀγυιαῖς	-uu- -- u u -uu - u u--	dactylic hexameter	masculine penthemimeral, trithemimeral
ἔσσῃ καὶ λιμένεσσιν ἐπίσκοπος." ὣς ὁ μὲν εἰπὼν	-- - uu-u u-uu - u u --	dactylic hexameter	feminine penthemimeral, trithemimeral
μῦθον ἐπεκρήηνε καρήατι. βαῖνε δὲ κούρη	-u u---u u-uu -u u --	dactylic hexameter	feminine penthemimeral
λευκὸν ἐπὶ Κρηταῖον ὄρος κεκομημένον ὕλῃ·	-u u- --u u- uu-uu --	dactylic hexameter	feminine penthemimeral, hepthemimeral, trithemimeral
ἔνθεν ἐπ᾽ Ὠκεανόν· πολέας δ᾽ἐπελέξατο νύμφας,	-u u -uu- uu- uu-uu --	dactylic hexameter	masculine penthemimeral, hepthemimeral
πάσας εἰνέτεας, πάσας ἔτι παῖδας ἀμίτρους.	-- -uu- uu -- -u u--	dactylic hexameter	masculine penthemimeral
χαῖρε δὲ Καίρατος ποταμὸς μέγα, χαῖρε δὲ Τηθύς,	-u u --- uu- uu -u u --	dactylic hexameter	masculine penthemimeral, hepthemimeral
οὕνεκα θυγατέρας Λητωίδι πέμπον ἀμορβούς.	-uu -uu- --uu -u u--	dactylic hexameter	masculine penthemimeral
αὖθι δὲ Κύκλωπας μετεκίαθε· τοὺς μὲν ἔτετμε	-u u --- uu-uu - u u--	dactylic hexameter	masculine penthemimeral
νήσῳ ἐνὶ Λιπάρῃ (Λιπάρη νέον, ἀλλὰ τότ᾽ ἔσκεν	-u u- uu- uu- uu -u u --	dactylic hexameter	masculine penthemimeral, hepthemimeral, trithemimeral
οὔνομά οἱ Μελιγουνίς) ἐπ᾽ ἄκμοσιν Ἡφαίστοιο	-uu - uu-u u -uu ----	dactylic hexameter	feminine penthemimeral, trithemimeral
ἑσταότας περὶ μύδρον· ἐπείγετο γὰρ μέγα ἔργον·	-uu- uu -u u-uu - uu --	dactylic hexameter	feminine penthemimeral, trithemimeral
ἱππείην τετύκοντο Ποσειδάωνι ποτίστρην.	--- uu-u u---u u--	dactylic hexameter	feminine penthemimeral, trithemimeral
αἱ νύμφαι δ᾽ἔδδεισαν, ὅπως ἴδον αἰνὰ πέλωρα	- -- --u u- uu -u u--	dactylic hexameter	feminine penthemimeral, hepthemimeral, trithemimeral
πρηόσιν Ὀσσαίοισιν ἐοικότα, πᾶσι δ᾽ὑπ᾽ ὀφρὺν	-uu ---u u-uu -u u --	dactylic hexameter	feminine penthemimeral
φάεα μουνόγληνα σάκει ἴσα τετραβοείῳ	-uu ---u u- uu -uu--	dactylic hexameter	feminine penthemimeral, hepthemimeral
δεινὸν ὑπογλαύσσοντα, καὶ ὁππότε δοῦπον ἄκουσαν	-u u---u u -uu -u u--	dactylic hexameter	feminine penthemimeral
ἄκμονος ἠχήσαντος ἐπὶ μέγα πουλύ τ᾽ἄημα	-uu ---u u- uu -u u--	dactylic hexameter	feminine penthemimeral, hepthemimeral
φυσάων αὐτῶν τε βαρὺν στόνον· αὖε γὰρ Αἴτνη,	--- -- u u- uu -u u --	dactylic hexameter	masculine penthemimeral, hepthemimeral, trithemimeral
αὖε δὲ Τρινακίη, Σικανῶν ἕδος, αὖε δὲ γείτων	-u u -uu- uu- uu -u u --	dactylic hexameter	masculine penthemimeral, hepthemimeral
Ἰταλίη, μεγάλην δὲ βοὴν ἐπὶ Κύρνος ἀύτει,	-uu- uu- u u- uu -- --	dactylic hexameter	masculine penthemimeral, hepthemimeral, trithemimeral
εὖθ᾽ οἵ γε ῥαιστῆρας ἀειράμενοι ὑπὲρ ὤμων	- - - --u u-uu- uu --	dactylic hexameter	feminine penthemimeral, trithemimeral
ἢ χαλκὸν ζείοντα καμινόθεν ἠὲ σίδηρον	- -- --u u-uu -u u--	dactylic hexameter	feminine penthemimeral, trithemimeral
ἀμβολαδὶς τετυπόντες ἐπὶ μέγα μοχθήσειαν.	-uu- uu-u u- uu ----	dactylic hexameter	feminine penthemimeral, hepthemimeral, trithemimeral
τῶ σφέας οὐκ ἐτάλασσαν ἀκηδέες Ὠκεανῖναι	- uu - uu-u u-uu -uu--	dactylic hexameter	feminine penthemimeral, trithemimeral
οὔτ᾽ ἄντην ἰδέειν οὔτε κτύπον οὔασι δέχθαι.	- -- uu- -- uu -uu --	dactylic hexameter	masculine penthemimeral, hepthemimeral, trithemimeral
οὐ νέμεσις· κείνους γε καὶ αἱ μάλα μηκέτι τυτθαὶ	- uu- -- u u - uu -uu --	dactylic hexameter	masculine penthemimeral, hepthemimeral, trithemimeral
οὐδέποτ᾽ ἀφρικτὶ μακάρων ὁρόωσι θύγατρες.	-uu --- uu- uu-u u--	dactylic hexameter	masculine penthemimeral, hepthemimeral
ἀλλ᾽ ὅτε κουράων τις ἀπειθέα μητέρι τεύχοι,	- uu --- u u-uu -uu --	dactylic hexameter	masculine penthemimeral
μήτηρ μὲν Κύκλωπας ἑῇ ἐπὶ παιδὶ καλιστρεῖ,	-- - --u u- uu -u u--	dactylic hexameter	feminine penthemimeral, hepthemimeral, trithemimeral
Ἄργην ἢ Στερόπην· ὁ δὲ δώματος ἐκ μυχάτοιο	-- - uu- u u -uu - uu--	dactylic hexameter	masculine penthemimeral, trithemimeral
ἔρχεται Ἑρμείης σποδιῇ κεχρημένος αἰθῇ·	-uu --- uu- --uu --	dactylic hexameter	masculine penthemimeral, hepthemimeral
αὐτίκα τὴν κούρην μορμύσσεται, ἡ δὲ τεκούσης	-uu - -- --uu - u u--	dactylic hexameter	masculine penthemimeral, trithemimeral
δύνει ἔσω κόλπους θεμένη ἐπὶ φάεσι χεῖρας.	-u u- -- uu- uu -uu --	dactylic hexameter	masculine penthemimeral, hepthemimeral, trithemimeral
κοῦρα, σὺ δὲ προτέρω περ, ἔτι τριέτηρος ἐοῦσα,	-u u - uu- u u- uu-u u--	dactylic hexameter	masculine penthemimeral, hepthemimeral, trithemimeral
εὖτ᾽ ἔμολεν Λητώ σε μετ᾽ ἀγκαλίδεσσι φέρουσα,	- uu- -- u u -uu-u u--	dactylic hexameter	masculine penthemimeral, trithemimeral
Ἡφαίστου καλέοντος ὅπως ὀπτήρια δοίη,	--- uu-u u- --uu --	dactylic hexameter	feminine penthemimeral, hepthemimeral, trithemimeral
Βρόντεώ σε στιβαροῖσιν ἐφεσσαμένου γονάτεσσι,	-- - uu-u u-uu- uu--	dactylic hexameter	feminine penthemimeral, trithemimeral
στήθεος ἐκ μεγάλου λασίης ἐδράξαο χαίτης,	-uu - uu- uu- --uu --	dactylic hexameter	masculine penthemimeral, hepthemimeral, trithemimeral
ὤλοψας δὲ βίηφι· τὸ δ᾽ἄτριχον εἰσέτι καὶ νῦν	--- u u-u u -uu -uu - -	dactylic hexameter	feminine penthemimeral, trithemimeral
μεσσάτιον στέρνοιο μένει μέρος, ὡς ὅτε κόρσην	-uu- --u u- uu - uu --	dactylic hexameter	feminine penthemimeral, hepthemimeral, trithemimeral
φωτὸς ἐνιδρυθεῖσα κόμην ἐπενείματ᾽ ἀλώπηξ.	-u u---u u- uu-u u--	dactylic hexameter	feminine penthemimeral, hepthemimeral
τῶ μάλα θαρσαλέη σφε τάδε προσελέξαο τῆμος	- uu -uu- u u- uu-uu --	dactylic hexameter	masculine penthemimeral, hepthemimeral
"Κύκλωπες, κἠμοί τι Κυδώνιον εἰ δ᾽ἄγε τόξον	--- -- u u-uu - uu --	dactylic hexameter	masculine penthemimeral, trithemimeral
ἠδ᾽ ἰοὺς κοίλην τε κατακληῖδα βελέμνων	- -- -- u u---u u--	dactylic hexameter	masculine penthemimeral, trithemimeral
τεύξατε· καὶ γὰρ ἐγὼ Λητωιὰς ὥσπερ Ἀπόλλων.	-uu - u u- --uu -u u--	dactylic hexameter	masculine penthemimeral, trithemimeral
αἰ δέ κ᾽ἐγὼ τόξοις μονιὸν δάκος ἤ τι πέλωρον	- u u- -- uu- uu - u u--	dactylic hexameter	masculine penthemimeral, hepthemimeral, trithemimeral
θηρίον ἀγρεύσω, τὸ δέ κεν Κύκλωπες ἔδοιεν."	-uu --- u u - --u u--	dactylic hexameter	masculine penthemimeral, hepthemimeral
ἔννεπες· οἱ δ᾽ἐτέλεσσαν· ἄφαρ δ᾽ὡπλίσσαο, δαῖμον,	-uu - uu-u u- --uu --	dactylic hexameter	feminine penthemimeral, hepthemimeral, trithemimeral
αἶψα δ᾽ἐπὶ σκύλακας πάλιν ἤιες· ἵκεο δ᾽αὖλιν	-u u- uu- uu -uu -uu --	dactylic hexameter	masculine penthemimeral, trithemimeral
Ἀρκαδικὴν ἔπι Πανός. ὁ δὲ κρέα λυγκὸς ἔταμνε	-uu- uu -u u - uu -u u--	dactylic hexameter	feminine penthemimeral, hepthemimeral, trithemimeral
Μαιναλίης, ἵνα οἱ τοκάδες κύνες εἶδαρ ἔδοιεν.	-uu- uu - uu- uu -u u--	dactylic hexameter	masculine penthemimeral, hepthemimeral, trithemimeral
τὶν δ᾽ὁ γενειήτης δύο μὲν κύνας ἥμισυ πηγοὺς	- u u--- uu - uu -uu --	dactylic hexameter	masculine penthemimeral, hepthemimeral
τρεῖς δὲ παρουαίους ἕνα δ᾽αἰόλον, οἵ ῥα λέοντας	- u u--- uu -uu - u u--	dactylic hexameter	masculine penthemimeral
αὐτοὺς αὖ ἐρύοντες, ὅτε δράξαιντο δεράων,	-- - uu-u u- --u u--	dactylic hexameter	feminine penthemimeral, hepthemimeral, trithemimeral
εἷλκον ἔτι ζώοντας ἐπ᾽ αὐλίον, ἑπτὰ δ᾽ἔδωκε	-u u- --u u -uu -u u--	dactylic hexameter	feminine penthemimeral, trithemimeral
θάσσονας αὐράων Κυνοσουρίδας, αἵ ῥα διῶξαι	-uu --- uu-uu - u u--	dactylic hexameter	masculine penthemimeral
ὤκισται νεβρούς τε καὶ οὐ μύοντα λαγωόν,	--- -- u u - --u u--	dactylic hexameter	masculine penthemimeral, hepthemimeral, trithemimeral
καὶ κοίτην ἐλάφοιο καὶ ὕστριχος ἔνθα καλιαὶ	- -- uu-u u -uu -u u--	dactylic hexameter	feminine penthemimeral, trithemimeral
σημῆναι, καὶ ζορκὸς ἐπ᾽ ἴχνιον ἡγήσασθαι.	--- - -u u -uu ----	dactylic hexameter	feminine penthemimeral, trithemimeral
ἔνθεν ἀπερχομένη (μετὰ καὶ κύνες ἐσσεύοντὀ	-u u-uu- uu - uu ----	dactylic hexameter	masculine penthemimeral, hepthemimeral
εὗρες ἐτί προμολῇσ) ὄρεος τοῦ Παρρασίοιο	-u u- uu- uu- - -uu--	dactylic hexameter	masculine penthemimeral, hepthemimeral, trithemimeral
σκαιρούσας ἐλάφους, μέγα τι χρέος· αἱ μὲν ἑπ᾽ ὄχθῃς	--- uu- uu - uu - u u --	dactylic hexameter	masculine penthemimeral, hepthemimeral, trithemimeral
αἰὲν ἐβουκολέοντο μελαμψήφιδος Ἀναύρου,	-u u-uu-u u---u u--	dactylic hexameter	feminine penthemimeral
μάσσονες ἢ ταῦροι, κεράων δ᾽ἀπελάμπετο χρυσός·	-uu - -- uu- uu--- --	lyric	
ἐξαπίνης δ᾽ἔταφές τε καὶ ὃν ποτὶ θυμὸν ἔειπες	-uu- uu- u u - uu -u u--	dactylic hexameter	masculine penthemimeral, hepthemimeral, trithemimeral
"τοῦτό κεν Ἀρτέμιδος πρωτάγριον ἄξιον εἴη."	-u u -uu- --uu -uu --	dactylic hexameter	masculine penthemimeral
πέντ᾽ ἔσαν αἱ πᾶσαι· πίσυρας δ᾽ἕλες ὦκα θέουσα	- uu - -- uu- uu -u u--	dactylic hexameter	masculine penthemimeral, hepthemimeral, trithemimeral
νόσφι κυνοδρομίης, ἵνα τοι θοὸν ἅρμα φέρωσι.	-u u-uu- uu - uu -u u--	dactylic hexameter	masculine penthemimeral, hepthemimeral
τὴν δὲ μίαν Κελάδοντος ὑπὲρ ποταμοῖο φυγοῦσαν	- u u- uu-u u- uu-u u--	dactylic hexameter	feminine penthemimeral, hepthemimeral, trithemimeral
Ἡρης ἐννεσίῃσιν, ἀέθλιον Ἡρακλῆι	-- -uu-u u-uu ----	dactylic hexameter	feminine penthemimeral
ὕστερον ὄφρα γένοιτο, πάγος Κερύνειος ἔδεκτο.	-uu -u u-u u- uu-u u--	dactylic hexameter	feminine penthemimeral, hepthemimeral
Ἄρτεμι Παρθενίη Τιτυοκτόνε, χρύσεα μέν τοι	-uu -uu- uu-uu -uu - -	dactylic hexameter	masculine penthemimeral
ἔντεα καὶ ζώνη, χρύσεον δ᾽ἐζεύξαο δίφρον,	-uu - -- uu- --uu --	dactylic hexameter	masculine penthemimeral, hepthemimeral, trithemimeral
ἐν δ᾽ἐβάλευ χρύσεια, θεή, κεμάδεσσι χαλινά.	- uu- --u u- uu-u u--	dactylic hexameter	feminine penthemimeral, hepthemimeral, trithemimeral
ποῦ δέ σε τὸ πρῶτον κερόεις ὄχος ἤρξατ᾽ ἀείρειν;	- u u - -- uu- uu -u u--	dactylic hexameter	masculine penthemimeral, hepthemimeral, trithemimeral
Αἵμῳ ἐπὶ Θρήικι, τόθεν βορέαο κατᾶιξ	-u u- --u u- uu-u --	lyric	
ἔρχεται ἀχλαίνοισι δυσαέα κρυμὸν ἄγουσα.	-uu ---u u-uu -u u--	dactylic hexameter	feminine penthemimeral
ποῦ δ᾽ἔταμες πεύκην, ἀπὸ δὲ φλογὸς ἥψαο ποίης;	- uu- -- uu - uu -uu --	dactylic hexameter	masculine penthemimeral, hepthemimeral, trithemimeral
Μυσῷ ἐν Οὐλύμπῳ, φάεος δ᾽ἐνέηκας ἀυτμὴν	-u u --- uu- uu-u u--	dactylic hexameter	masculine penthemimeral, hepthemimeral
ἀσβέστου, τό ῥα πατρὸς ἀποστάζουσι κεραυνοί.	--- u u -u u---u u--	dactylic hexameter	feminine penthemimeral, trithemimeral
ποσσάκι δ᾽ἀργυρέοιο, θεή, πειρήσαο τόξου;	-uu -uu-u u- --uu --	dactylic hexameter	feminine penthemimeral, hepthemimeral
πρῶτον ἐπὶ πτελέην, τὸ δὲ δεύτερον ἧκας ἐπὶ δρῦν,	-u u- uu- u u -uu -u u- -	dactylic hexameter	masculine penthemimeral, trithemimeral
τὸ τρίτον αὖτ᾽ ἐπὶ θῆρα. τὸ τέτρατον οὐκέτ᾽ ἐπὶ δὴν	- uu - uu -u u -uu -u u- -	dactylic hexameter	feminine penthemimeral, trithemimeral
ἀλλά μιν εἰς ἀδίκων ἔβαλες πόλιν, οἵ τε περὶ σφέας	-u u - uu- uu- uu - u u- --	lyric	
οἵ τε περὶ ξείνους ἀλιτήμονα πολλά τέλεσκον,	- u u- -- uu-uu -u u--	dactylic hexameter	masculine penthemimeral, trithemimeral
σχέτλιοι· οἷς τύνη χαλεπὴν ἐμμάξεαι ὀργήν·	-uu - -- uu- --uu --	dactylic hexameter	masculine penthemimeral, hepthemimeral, trithemimeral
κτήνεά φιν λοιμὸς καταβόσκεται, ἔργα δὲ πάχνη,	-uu - -- uu-uu -u u --	dactylic hexameter	masculine penthemimeral, trithemimeral
κείρονται δὲ γέροντες ἐφ᾽ υἱάσιν, αἱ δὲ γυναῖκες	--- u u-u u -uu - u u--	dactylic hexameter	feminine penthemimeral, trithemimeral
ἢ βληταὶ θνῄσκουσι λεχωίδες ἠὲ φυγοῦσαι	- -- --u u-uu -u u--	dactylic hexameter	feminine penthemimeral, trithemimeral
τίκτουσιν τῶν οὐδὲν ἐπὶ σφυρὸν ὀρθὸν ἀνέστη.	--- - -u u- uu -u u--	dactylic hexameter	feminine penthemimeral, hepthemimeral, trithemimeral
οἷς δέ κεν εὐμειδής τε καὶ ἵλαος αὐγάσσηαι,	- u u --- u u -uu ----	dactylic hexameter	masculine penthemimeral
κείνοις εὖ μὲν ἄρουρα φέρει στάχυν, εὖ δὲ γενέθλη	-- - u u-u u- uu - u u--	dactylic hexameter	feminine penthemimeral, hepthemimeral, trithemimeral
τετραπόδων, εὖ δ᾽ὄλβος ἀέξεται· οὐδ᾽ ἐπὶ σῆμα	-uu- - -u u-uu - uu --	dactylic hexameter	feminine penthemimeral, trithemimeral
ἔρχονται πλὴν εὖτε πολυχρόνιόν τι φέρωσιν·	--- - -u u-uu- u u--	dactylic hexameter	feminine penthemimeral, trithemimeral
οὐδὲ διχοστασίη τρώει γένος, ἥ τε καὶ εὖ περ	-u u-uu- -- uu - u u - -	dactylic hexameter	masculine penthemimeral, hepthemimeral
οἴκους ἑστηῶτας ἐσίνατο· ταὶ δὲ θυωρὸν	-- ---u u-uu - u u--	dactylic hexameter	feminine penthemimeral
εἰνάτερες γαλόῳ τε μίαν περὶ δίφρα τίθενται.	-uu- uu- u u- uu -u u--	dactylic hexameter	masculine penthemimeral, hepthemimeral, trithemimeral
πότνια, τῶν εἴη μὲν ἐμοὶ φίλος ὅστις ἀληθής,	-uu - -- u u- uu -u u--	dactylic hexameter	masculine penthemimeral, hepthemimeral, trithemimeral
εἴην δ᾽αὐτός, ἄνασσα, μέλοι δέ μοι αἰὲν ἀοιδή·	-- -u u-u u- u u -u u--	dactylic hexameter	feminine penthemimeral, hepthemimeral
τῇ ἔνι μὲν Λητοῦς γάμος ἔσσεται, ἐν δὲ σὺ πολλή,	- uu - -- uu -uu - u u --	dactylic hexameter	masculine penthemimeral, trithemimeral
ἐν δὲ καὶ Ἀπόλλων, ἐν δ᾽οἵ σεο πάντες ἄεθλοι,	- u u --- - - uu -u u--	dactylic hexameter	masculine penthemimeral, hepthemimeral
ἐν δὲ κύνες καὶ τόξα καὶ ἄντυγες, αἵ τέ σε ῥεῖα	- u u- - -u u -uu - u u --	dactylic hexameter	feminine penthemimeral, trithemimeral
θηητὴν φορέουσιν, ὅτ᾽ ἐς Διὸς οἶκον ἐλαύνεις.	--- uu-u u - uu -u u--	dactylic hexameter	feminine penthemimeral, hepthemimeral, trithemimeral
ἔνθα τοι ἀντιόωντες ἐνὶ προμολῇσι δέχονται	-u u -uu-u u- uu-u u--	dactylic hexameter	feminine penthemimeral, hepthemimeral
ὅπλα μὲν Ἑρμείης Ἀκακήσιος, αὐτὰρ Ἀπόλλων	-u u --- uu-uu -u u--	dactylic hexameter	masculine penthemimeral
θηρίον ὅττι φέρῃσθα· πάροιθέ γέ, πρίν περ ἱκέσθαι	-uu -u u-u u-u u - u u--	dactylic hexameter	feminine penthemimeral
καρτερὸν Ἀλκεΐδην· νῦν δ᾽οὐκέτι τοῦτον ἄεθλον	-uu -uu- - -uu -u u--	dactylic hexameter	masculine penthemimeral
Φοῖβος ἔχει, τοῖος γὰρ ἀεὶ Τιρύνθιος ἄκμων	-u u- -- u u- --uu --	dactylic hexameter	masculine penthemimeral, hepthemimeral, trithemimeral
ἕστηκε πρὸ πυλέων ποτιδέγμενος, εἴ τι φέρουσα	--- u u- uu-uu - u u--	dactylic hexameter	masculine penthemimeral, trithemimeral
νεῖαι πῖον ἔδεσμα· θεοὶ δ᾽ἐπὶ πάντες ἐκείνῳ	-- -u u-u u- uu -u u--	dactylic hexameter	feminine penthemimeral, hepthemimeral
ἄλληκτον γελόωσι, μάλιστα δὲ πενθερὴ αὐτή,	--- uu-u u-u u -uu --	dactylic hexameter	feminine penthemimeral, trithemimeral
ταῦρον ὅτ᾽ ἐκ δίφροιο μάλα μέγαν ἢ ὅ γε χλούνην	-u u - --u u- uu - u u --	dactylic hexameter	feminine penthemimeral, hepthemimeral, trithemimeral
κάπρον ὀπισθιδίοιο φέροι ποδὸς ἀσπαίροντα·	-u u-uu-u u- uu ----	dactylic hexameter	feminine penthemimeral, hepthemimeral
κερδαλέῳ μύθῳ σε, θεή, μάλα τῷδε πινύσκει	-uu- -- u u- uu -u u--	dactylic hexameter	masculine penthemimeral, hepthemimeral, trithemimeral
"βάλλε κακοὺς ἐπὶ θῆρας, ἵνα θνητοί σε βοηθὸν	-u u- uu -u u- -- u u--	dactylic hexameter	feminine penthemimeral, hepthemimeral, trithemimeral
ὡς ἐμὲ κικλήσκωσιν. ἔα πρόκας ἠδὲ λαγωοὺς	- uu ---u u- uu -u u--	dactylic hexameter	feminine penthemimeral, hepthemimeral
οὔρεα βόσκεσθαι· τί δέ κεν πρόκες ἠδὲ λαγωοὶ	-uu --- u u - uu -u u--	dactylic hexameter	masculine penthemimeral, hepthemimeral
ῥέξειαν; σύες ἔργα, σύες φυτὰ λυμαίνονται.	--- uu -u u- uu ----	dactylic hexameter	feminine penthemimeral, hepthemimeral, trithemimeral
καὶ βόες ἀνθρώποισι κακὸν μέγα· βάλλ᾽ ἐπὶ καὶ τούς."	- uu ---u u- uu - uu - -	dactylic hexameter	feminine penthemimeral, hepthemimeral
ὣς ἔνεπεν, ταχινὸς δὲ μέγαν περὶ θῆρα πονεῖτο.	- uu- uu- u u- uu -u u--	dactylic hexameter	masculine penthemimeral, hepthemimeral, trithemimeral
οὐ γὰρ ὅ γε Φρυγίῃ περ ὑπὸ δρυὶ γυῖα θεωθεὶς	- u u - uu- u u- uu -u u--	dactylic hexameter	masculine penthemimeral, hepthemimeral, trithemimeral
παύσατ᾽ ἀδηφαγίης· ἔτι οἱ πάρα νηδὺς ἐκείνη,	-u u-uu- uu - uu -u u--	dactylic hexameter	masculine penthemimeral, hepthemimeral
τῇ ποτ᾽ ἀροτριόωντι συνήντετο Θειοδάμαντι.	- u u-uu-u u-uu -uu--	dactylic hexameter	feminine penthemimeral
σοὶ δ᾽Ἀμνισιάδες μὲν ὑπὸ ζεύγληφι λυθείσας	- --uu- u u- --u u--	dactylic hexameter	masculine penthemimeral, hepthemimeral
ψήχουσιν κεμάδας, παρὰ δέ σφισι πουλὺ νέμεσθαι	--- uu- uu - uu -u u--	dactylic hexameter	masculine penthemimeral, hepthemimeral, trithemimeral
Ἥρης ἐκ λειμῶνος ἀμησάμεναι φορέουσιν	-- - --u u-uu- uu--	dactylic hexameter	feminine penthemimeral, trithemimeral
ὠκύθοον τριπέτηλον, ὃ καὶ Διὸς ἵπποι ἔδονσιν·	-uu- uu-u u - uu -u u--	dactylic hexameter	feminine penthemimeral, hepthemimeral, trithemimeral
ἐν καὶ χρυσείας ὑποληνίδας ἐπλήσαντο	- - --- uu-uu ----	dactylic hexameter	masculine penthemimeral
ὕδατος, ὄφρ᾽ ἐλάφοισι ποτὸν θυμάρμενον εἴη.	-uu - uu-u u- --uu --	dactylic hexameter	feminine penthemimeral, hepthemimeral, trithemimeral
αὐτὴ δ᾽ἐς πατρὸς δόμον ἔρχεαι· οἱ δέ σ᾽ἐφ᾽ ἕδρην	-- - -- uu -uu - u u --	dactylic hexameter	masculine penthemimeral, trithemimeral
πάντες ὁμῶς καλέουσι· σὺ δ᾽Ἀπόλλωνι παρίζεις.	-u u- uu-u u ---u u--	dactylic hexameter	feminine penthemimeral, trithemimeral
ἡνίκα δ᾽αἱ νύμφαι σε χορῷ ἔνι κυκλώσονται	-uu - -- u u- uu ----	dactylic hexameter	masculine penthemimeral, hepthemimeral, trithemimeral
ἀγχόθι πηγάων Αἰγυπτίου Ἰνωποῖο	-uu --- --uu ----	dactylic hexameter	masculine penthemimeral
ἢ Πιτάνης (καὶ γὰρ Πιτάνη σέθεν) ἢ ἐνὶ Λίμναις,	- uu- - - uu- uu - uu --	dactylic hexameter	masculine penthemimeral, hepthemimeral, trithemimeral
ἢ ἵνα, δαῖμον, Ἀλὰς Ἀραφηνίδας οἰκήσονσα	- uu -u u- uu-uu ----	dactylic hexameter	masculine penthemimeral
ἦλθες ἀπὸ Σκυθίης, ἀπὸ δ᾽εἴπαο τέθμια Ταύρων,	-u u- uu- uu -uu -uu --	dactylic hexameter	masculine penthemimeral, trithemimeral
μὴ νειὸν τημοῦτος ἐμαὶ βόες εἵνεκα μισθοῦ	- -- --u u- uu -uu --	dactylic hexameter	feminine penthemimeral, hepthemimeral, trithemimeral
τετράγυον τέμνοιεν ὑπ᾽ ἀλλοτρίῳ ἀροτῆρι·	-uu- --u u -uu- uu--	dactylic hexameter	feminine penthemimeral, trithemimeral
ἦ γάρ κεν γυιαί τε καὶ αὐχένα κεκμηυῖαι	- - - -- u u -uu ----	dactylic hexameter	masculine penthemimeral, trithemimeral
κόπρον ἔπι προγένοιντο, καὶ εἰ Στυμφαιίδες εἶεν	-u u- uu-u u - --uu --	dactylic hexameter	feminine penthemimeral, hepthemimeral, trithemimeral
εἰναετιζόμεναι κεραελκέες, αἳ μέγ᾽ ἄρισται	-uu-uu- uu-uu - u u--	dactylic hexameter	masculine penthemimeral
τέμνειν ὦλκα βαθεῖαν· ἐπεὶ θεὸς οὔποτ᾽ ἐκεῖνον	-- -u u-u u- uu -u u--	dactylic hexameter	feminine penthemimeral, hepthemimeral
ἦλθε παρ᾽ Ἠέλιος καλὸν χορόν, ἀλλὰ θεῆται	-u u -uu- -- uu -u u--	dactylic hexameter	masculine penthemimeral, hepthemimeral
δίφρον ἐπιστήσας, τὰ δὲ φάεα μηκύνονται.	-u u--- u u -uu ----	dactylic hexameter	masculine penthemimeral
τίς δέ νύ τοι νήσων, ποῖον δ᾽ὄρος εὔαδε πλεῖστον,	- u u - -- -- uu -uu --	dactylic hexameter	masculine penthemimeral, hepthemimeral, trithemimeral
τίς δὲ λιμήν, ποίη δὲ πόλις; τίνα δ᾽ἔξοχα νυμφέων	- u u- -- u u- uu -uu --	dactylic hexameter	masculine penthemimeral, hepthemimeral, trithemimeral
φίλαο, καὶ ποίας ἡρωίδας ἔσχες ἑταίρας;	-uu - -- --uu -u u--	dactylic hexameter	masculine penthemimeral, trithemimeral
εἰπέ, θεή, σὺ μὲν ἄμμιν, ἐγὼ δ᾽ἑτέροισιν ἀείσω.	-u u- u u -u u- uu-u u--	dactylic hexameter	feminine penthemimeral, hepthemimeral, trithemimeral
νήσων μὲν Δολίχη, πολίων δέ τοι εὔαδε Πέργη,	-- - uu- uu- u u -uu --	dactylic hexameter	masculine penthemimeral, hepthemimeral, trithemimeral
Τηύγετον δ᾽ὀρέων, λιμένες γε μὲν Εὐρίποιο.	--- uu- uu- u u ----	dactylic hexameter	masculine penthemimeral, hepthemimeral, trithemimeral
ἔξοχα δ᾽ἀλλάων Γορτυνίδα φίλαο νύμφην,	-uu --- --uu -uu --	dactylic hexameter	masculine penthemimeral
ἐλλοφόνον Βριτόμαρτιν ἐύσκοπον· ἧς ποτε Μίνως	-uu- uu-u u-uu - uu --	dactylic hexameter	feminine penthemimeral, trithemimeral
πτοιηθεὶς ὑπ᾽ ἔρωτι κατέδραμεν οὔρεα Κρήτης.	--- u u-u u-uu -uu --	dactylic hexameter	feminine penthemimeral, trithemimeral
ἡ δ᾽ὁτὲ μὲν λασίῃσιν ὑπὸ δρυσὶ κρύπτετο νύμφη,	- uu - uu-u u- uu -uu --	dactylic hexameter	feminine penthemimeral, hepthemimeral, trithemimeral
ἄλλοτε δ᾽εἱαμενῇσιν· ὁ δ᾽ἐννέα μῆνας ἐφοίτα	-uu -uu-u u -uu -u u--	dactylic hexameter	feminine penthemimeral
παίπαλά τε κρημνούς τε καὶ οὐκ ἀνέπαυσε διωκτύν,	-uu - -- u u - uu-u u--	dactylic hexameter	masculine penthemimeral, hepthemimeral, trithemimeral
μέσφ᾽ ὅτε μαρπτομένη καὶ δὴ σχεδὸν ἥλατο πόντον	- uu -uu- - - uu -uu --	dactylic hexameter	masculine penthemimeral, hepthemimeral
πρηόνος ἐξ ὑπάτοιο καὶ ἔνθορεν εἰς ἁλιήων	-uu - uu-u u -uu - uu--	dactylic hexameter	feminine penthemimeral, trithemimeral
δίκτυα, τά σφ᾽ ἐσάωσαν· ὅθεν μετέπειτα Κύδωνες	-uu - uu-u u- uu-u u--	dactylic hexameter	feminine penthemimeral, hepthemimeral, trithemimeral
νύμφην μὲν Δίκτυναν, ὄρος δ᾽ὅθεν ἥλατο νύμφη	-- - --u u- uu -uu --	dactylic hexameter	feminine penthemimeral, hepthemimeral, trithemimeral
Δικταῖον καλέουσιν, ἀνεστήσαντο δὲ βωμοὺς	--- uu-u u---u u --	dactylic hexameter	feminine penthemimeral, trithemimeral
ἱερά τε ῥέζουσι· τὸ δὲ στέφος ἤματι κείνῳ	-uu - --u u - uu -uu --	dactylic hexameter	feminine penthemimeral, hepthemimeral, trithemimeral
ἢ πίτυς ἢ σχῖνος, μύρτοιο δὲ χεῖρες ἄθικτοι·	- uu - -- --u u -u u--	dactylic hexameter	masculine penthemimeral, trithemimeral
δὴ τότε γὰρ πέπλοισιν ἐνέσχετο μύρσινος ὄζος	- uu - --u u-uu -uu --	dactylic hexameter	feminine penthemimeral, trithemimeral
τῆς κούρης, ὅτ᾽ ἔφευγεν· ὅθεν μέγα χώσατο μύρτῳ.	- -- u u-u u- uu -uu --	dactylic hexameter	feminine penthemimeral, hepthemimeral, trithemimeral
Οὖπι ἄνασσ᾽ εὐῶπι φαεσφόρε, καὶ δὲ σὲ κείνγς	-u u- --u u-uu - u - -	lyric	
Κρηταέες καλέουσιν ἐπωνυμίην ἀπὸ νύμφης.	-uu- uu-u u-uu- uu --	dactylic hexameter	feminine penthemimeral, trithemimeral
καὶ μὴν Κυρήνην ἑταρίσσαο, τῇ ποτ᾽ ἔδωκας	- - --- uu-uu - u u--	dactylic hexameter	masculine penthemimeral
αὐτὴ θηρητῆρε δύω κύνε, τοῖς ἔνι κούρη	-- ---u u- uu - uu --	dactylic hexameter	feminine penthemimeral, hepthemimeral
Ὑψηὶς παρὰ τύμβον Ἰώλκιον ἔμμορ᾽ ἀέθλου.	--- uu -u u-uu -u u--	dactylic hexameter	feminine penthemimeral, trithemimeral
καὶ Κεφάλου ξανθὴν ἄλοχον Δηιονίδαο,	- uu- -- uu- --uu--	dactylic hexameter	masculine penthemimeral, hepthemimeral, trithemimeral
πότνια, σὴν ὁμόθηρον ἐθήκαο· καὶ δὲ σὲ φασὶ	-uu - uu-u u-uu - u u --	dactylic hexameter	feminine penthemimeral, trithemimeral
καλὴν Ἀντίκλειαν ἴσον φαέεσσι φιλῆσαι	-- ---u u- uu-u u--	dactylic hexameter	feminine penthemimeral, hepthemimeral
αἳ πρῶται θοὰ τόξα καὶ ἀμφ᾽ ὤμοισι φαρέτρας	- -- uu -u u - --u u--	dactylic hexameter	feminine penthemimeral, hepthemimeral, trithemimeral
ἰοδόκους ἐφόρησαν· ἀσίλλωτοι δέ φιν ὦμοι	-uu- uu-u u--- u u --	dactylic hexameter	feminine penthemimeral, trithemimeral
δεξιτεροὶ καὶ γυμνὸς ἀεὶ παρεφαίνετο μαζός.	-uu- - -u u- uu-uu --	dactylic hexameter	feminine penthemimeral, hepthemimeral, trithemimeral
ᾔνησας δ᾽ἔτι πάγχυ ποδορρώρην Ἀταλάντην,	--- uu -u u--- uu--	dactylic hexameter	feminine penthemimeral, trithemimeral
κούρην Ἰασίοιο συοκτόνον Ἀρκασίδαο,	-- -uu-u u-uu -uu--	dactylic hexameter	feminine penthemimeral
καί ἑ κυνηλασίην τε καὶ εὐστοχίην ἐδίδαξας.	- u u-uu- u u -uu- uu--	dactylic hexameter	masculine penthemimeral
οὔ μιν ἐπίκλητοι Καλυδωνίου ἀγρευτῆρες	- u u--- uu-uu ----	dactylic hexameter	masculine penthemimeral
μέμφονται κάπροιο· τὰ γὰρ σημήια νίκης	--- --u u - --uu --	dactylic hexameter	feminine penthemimeral, hepthemimeral, trithemimeral
Ἀρκαδίην εἰσῆλθεν, ἔχει δ᾽ἔτι θηρὸς ὀδόντας·	-uu- --u u- uu -u u--	dactylic hexameter	feminine penthemimeral, hepthemimeral, trithemimeral
οὐδὲ μὲν Ὑλαῖόν τε καὶ ἄφρονα Ῥοῖκον ἔολπα	-u u --- u u -uu -u u--	dactylic hexameter	masculine penthemimeral
οὐδέ περ ἐχθαίροντας ἐν Ἄιδι μωμήσασθαι	-u u ---u u -- ----	dactylic hexameter	feminine penthemimeral
τοξότιν· οὐ γάρ σφιν λαγόνες συνεπιψεύσονται,	-uu - - - uu- uu----	dactylic hexameter	masculine penthemimeral, hepthemimeral, trithemimeral
τάων Μαιναλίη νᾶεν φόνῳ ἀκρώρεια.	-- -uu- -- uu ----	dactylic hexameter	masculine penthemimeral, hepthemimeral
πότνια πουλυμέλαθρε, πολύπτολι, χαῖρε Χιτώνη	-uu -uu-u u-uu -u u--	dactylic hexameter	feminine penthemimeral
Μιλήτῳ ἐπίδημε· σὲ γὰρ ποιήσατο Νηλεὺς	--- uu-u u - --uu --	dactylic hexameter	feminine penthemimeral, hepthemimeral, trithemimeral
ἡγεμόνην, ὅτε νηυσὶν ἀνήγετο Κεκροπίηθεν.	-uu- uu -u u-uu -uu--	dactylic hexameter	feminine penthemimeral, trithemimeral
Χησιὰς Ἰμβρασίη πρωτόθρονε, σοὶ δ᾽Ἀγαμέμνων	-uu -uu- --uu - uu--	dactylic hexameter	masculine penthemimeral
πηδάλιον νηὸς σφετέρης ἐγκάτθετο νηῷ	-uu- -- uu- --uu --	dactylic hexameter	masculine penthemimeral, hepthemimeral, trithemimeral
μείλιον ἀπλοΐης, ὅτε οἱ κατέδησας ἀήτας,	-uu -uu- uu - uu-u u--	dactylic hexameter	masculine penthemimeral, hepthemimeral
Τευκρῶν ἡνίκα νῆες Ἀχαιίδες ἄστεα κήδειν	-- -uu -u u-uu -uu --	dactylic hexameter	feminine penthemimeral
ἔπλεον ἀμφ᾽ Ἑλένῃ Ῥαμνουσίδι θυμωθεῖσαι.	-uu - uu- --uu ----	dactylic hexameter	masculine penthemimeral, trithemimeral
ἦ μέν τοι Προῖτός γε δύω ἐκαθίσσατο νηούς,	- - - -- u u- uu-uu --	dactylic hexameter	masculine penthemimeral, hepthemimeral, trithemimeral
ἄλλον μὲν Κορίης, ὅτι οἱ συνελέξαο κούρας	-- - uu- uu - uu-uu --	dactylic hexameter	masculine penthemimeral, hepthemimeral, trithemimeral
οὔρεα πλαζομένας Ἀζήνια, τὸν δ᾽ἐνὶ Λούσοις	-uu -uu- --uu - uu --	dactylic hexameter	masculine penthemimeral
ἡμέρῃ, οὕνεκα θυμὸν ἀπ᾽ ἄγριον εἵλεο παίδων.	-uu -uu -u u -uu -uu --	dactylic hexameter	feminine penthemimeral
σοὶ καὶ Ἀμαζονίδες πολέμου ἐπιθυμήτειραι	- u u-uu- uu- uu----	dactylic hexameter	masculine penthemimeral, hepthemimeral
ἔν ποτε παρραλίῃ Ἐφέσῳ βρέτας ἱδρύσαντο	- uu -uu- uu- uu ----	dactylic hexameter	masculine penthemimeral, hepthemimeral
φηγῷ ὑπὸ πρέμεῳ, τέλεσεν δέ τοι ἱερὸν Ἱππώ·	-u u- uu- uu- u u -uu --	dactylic hexameter	masculine penthemimeral, hepthemimeral, trithemimeral
αὐταὶ δ᾽,Οὖπι ἄνασσα, περὶ πρύλιν ὠρχήσαντο	-- -u u-u u- uu ----	dactylic hexameter	feminine penthemimeral, hepthemimeral
πρῶτα μὲν ἐν σακέεσσιν ἐνόπλιον, αὖθι δὲ κύκλῳ	-u u - uu-u u-uu -u u --	dactylic hexameter	feminine penthemimeral, trithemimeral
στησάμεναι χορὸν εὐρύν· ὑπήεισαν δὲ λίγειαι	-uu- uu -u u--- u u--	dactylic hexameter	feminine penthemimeral, trithemimeral
λεπταλέον σύριγγες, ἵνα ῥήσσωσιν ὁμαρτῇ·	-uu- --u u- --u u--	dactylic hexameter	feminine penthemimeral, hepthemimeral, trithemimeral
οὐ γάρ πω νέβρεια δι᾽ ὀστέα τετρήναντο,	- - - --u u -uu ----	dactylic hexameter	feminine penthemimeral, trithemimeral
ἔργον᾽ Ἀθηναίης ἐλάφῳ κακόν· ἔδραμε δ᾽ἠχὼ	-u u--- uu- uu -uu --	dactylic hexameter	masculine penthemimeral, hepthemimeral
Σάρδιας ἔς τε νομὸν Βερεκύνθιον. αἱ δὲ πόδεσσιν	-uu - u u- uu-uu - u u--	dactylic hexameter	masculine penthemimeral, trithemimeral
οὖλα κατεκροτάλιζον, ἐπεψόφεον δὲ φαρέτραι.	-u u-uu-u u-uu- u u--	dactylic hexameter	feminine penthemimeral
κεῖνο δέ τοι μετέπειτα περὶ βρέτας εὐρὺ θέμειλον	-u u - uu-u u- uu -u u--	dactylic hexameter	feminine penthemimeral, hepthemimeral, trithemimeral
δωμήθη, τοῦ δ᾽οὔτε θεώτερον ὄψεται ἠὼς	--- - -u u-uu -uu --	dactylic hexameter	feminine penthemimeral, trithemimeral
οὐδ᾽ ἀφνειότερον· ῥέα κεν Πυθῶνα παρέλθοι.	- --uu- uu - --u u--	dactylic hexameter	masculine penthemimeral, hepthemimeral
τῶ ῥα καὶ ἠλαίνων ἀλαπαξέμεν ἠπείλησε	- u u --- uu-uu ----	dactylic hexameter	masculine penthemimeral
Λύγδαμις ὑβριστής· ἐπὶ δὲ στρατὸν ἱππημολγῶν	-uu --- uu - uu ----	dactylic hexameter	masculine penthemimeral, hepthemimeral
ἤγαγε Κιμμερίων ψαμάθῳ ἴσον, οἵ ῥα παρ᾽ αὐτὸν	-uu -uu- uu- uu - u u --	dactylic hexameter	masculine penthemimeral, hepthemimeral
κεκλιμένοι ναίουσι βοὸς πόρον Ἰναχιώνης.	-uu- --u u- uu -uu--	dactylic hexameter	feminine penthemimeral, hepthemimeral, trithemimeral
ἆ δειλὸς βασιλέων, ὅσον ἤλιτεν· οὐ γὰρ ἔμελλεν	- -- uu- uu -uu - u u--	dactylic hexameter	masculine penthemimeral, trithemimeral
οὔτ᾽ αὐτὸς Σκυθίηνδε παλιμπετὲς οὔτε τις ἄλλος	- -- uu-u u-uu -u u --	dactylic hexameter	feminine penthemimeral, trithemimeral
ὅσσων ἐν λειμῶνι Καϋστρίῳ ἔσταν ἅμαξαι	-- - --u u-uu -u u--	dactylic hexameter	feminine penthemimeral, trithemimeral
νοστήσειν· Ἐφέσου γὰρ ἀεὶ τεὰ τόξα πρόκειται.	--- uu- u u- uu -u u--	dactylic hexameter	masculine penthemimeral, hepthemimeral, trithemimeral
πότνια Μουνιχίη λιμενοσκόπε, χαῖρε Φεραίη.	-uu -uu- uu-uu -u u--	dactylic hexameter	masculine penthemimeral
μή τις ἀτιμήσῃ τὴν Ἄρτεμιν· οὐδὲ γὰρ Οἰνεῖ	- u u--- - -uu -u u --	dactylic hexameter	masculine penthemimeral
βωμὸν ἀτιμήσαντι καλοὶ πόλιν ἦλθον ἀγῶνες·	-u u---u u- uu -u u--	dactylic hexameter	feminine penthemimeral, hepthemimeral
μηδ᾽ ἐλαφηβολίην μηδ᾽ εὐστοχίην ἐριδαίνειν·	- uu-uu- - -uu- uu--	dactylic hexameter	masculine penthemimeral
οὐδὲ γὰρ Ἀτρεΐδης ὀλίγῳ ἔπι κόμπασε μισθῷ·	-u u -uu- uu- uu -uu --	dactylic hexameter	masculine penthemimeral, hepthemimeral
μηδέ τινα μνᾶσθαι τὴν παρθένον· οὐδὲ γὰρ Ὦτος,	-u u- -- - -uu -u u --	dactylic hexameter	masculine penthemimeral, trithemimeral
οὐδὲ μὲν Ὠαρίων ἀγαθὸν γάμον ἐμνήστευσαν·	-u u -uu- uu- uu ----	dactylic hexameter	masculine penthemimeral, hepthemimeral
μηδὲ χορὸν φεύγειν ἐνιαύσιον· οὐδὲ γὰρ Ἱππὼ	-u u- -- uu-uu -u u --	dactylic hexameter	masculine penthemimeral, trithemimeral
ἀκλαυτεὶ περὶ βωμὸν ἀπείπατο κυκλώσασθαι·	--- uu -u u-uu ----	dactylic hexameter	feminine penthemimeral, trithemimeral
χαῖρε μέγα κρείουσα καὶ εὐάντησον ἀοιδῇ.	-u u- --u u ---u u--	dactylic hexameter	feminine penthemimeral, trithemimeral
τὴν ἱερήν, ὦ θυμέ, τίνα χρόνον ἢ πότ᾽ ἀείσεις	- uu- - -u u- uu - u u--	dactylic hexameter	feminine penthemimeral, hepthemimeral, trithemimeral
δῆλον, Ἀπόλλωνος κουροτρόφον; ἦ μὲν ἅπασαι	-u u--- --uu - u u--	dactylic hexameter	masculine penthemimeral
Κυκλάδες, αἳ νήσων ἱερώταται εἰν ἁλὶ κεῖνται,	-uu - -- uu-uu - uu --	dactylic hexameter	masculine penthemimeral, trithemimeral
εὔυμνοι· δῆλος δ᾽ἐθέλει τὰ πρῶτα φέρεσθαι	--- -- uu- - -u u--	dactylic hexameter	masculine penthemimeral, hepthemimeral, trithemimeral
ἐκ Μουσέων, ὅτι Φοῖβον ἀοιδάων μεδέοντα	- -- uu -u u--- uu--	dactylic hexameter	feminine penthemimeral, trithemimeral
λοῦσέ τε καὶ σπείρωσε καὶ ὡς θεὸν ᾔνεσε πρώτη.	-u u - --u u - uu -uu --	dactylic hexameter	feminine penthemimeral, hepthemimeral, trithemimeral
ὡς Μοῦσαι τὸν ἀοιδὸν ὃ μὴ Πίμπλειαν ἀείσῃ	- -- u u-u u - --u u--	dactylic hexameter	feminine penthemimeral, hepthemimeral, trithemimeral
ἔχθουσιν, τὼς Φοῖβος ὅτις Δήλοιο λάθηται.	--- - -u u- --u u--	dactylic hexameter	feminine penthemimeral, hepthemimeral, trithemimeral
Δήλῳ νῦν οἴμης ἀποδάσσομαι, ὡς ἂν Ἀπόλλων	-- - -- uu-uu - u u--	dactylic hexameter	masculine penthemimeral, trithemimeral
Κύνθιος αἰνήσῃ με φίλης ἀλέγοντα τιθήνης.	-uu --- u u- uu-u u--	dactylic hexameter	masculine penthemimeral, hepthemimeral
κείνγ δ᾽ἠνεμόεσσα καὶ ἄτροπος οἷά θ᾽ἁλιπλὴξ	- ----u u -uu -u u--	dactylic hexameter	feminine penthemimeral
αἰθυίῃς καὶ μᾶλλον ἐπίδρομος ἠέπερ ἵπποις	--- - -u u-uu -uu --	dactylic hexameter	feminine penthemimeral, trithemimeral
πόντῳ ἐνεστήρικται· ὁ δ᾽ἀμφί ἑ πουλύς ἑλίσσων	-u u---u u -u u -u u--	dactylic hexameter	feminine penthemimeral
Ἰκαρίου πολλὴν ἀπομάσσεται ὕδατος ἄχνην·	-uu- -- uu-uu -uu --	dactylic hexameter	masculine penthemimeral, trithemimeral
τῶ σφε καὶ ἰχθυβολῆες ἁλίπλοοι ἐννάσσαντο.	- u u -uu-u u-uu ----	dactylic hexameter	feminine penthemimeral
ἀλλά οἱ οὐ νεμεσητὸν ἐνὶ πρώτῃσι λέγεσθαι,	-u u - uu-u u- --u u--	dactylic hexameter	feminine penthemimeral, hepthemimeral, trithemimeral
ὀππότ᾽ ἐς Ὠκεανόν τε καὶ ἐς Τιτηνίδα Τηθὺν	-u u -uu- u u - --uu --	dactylic hexameter	masculine penthemimeral, hepthemimeral
νῆσοι ἀολλίζονται, ἀεὶ δ᾽ἔξαρχος ὁδεύει.	-u u---u u- --u u--	dactylic hexameter	feminine penthemimeral, hepthemimeral
ἡ δ᾽ὄπιθεν Φοίνισσα μετ᾽ ἴχνια Κύρνος ὀπηδεῖ	- uu- --u u -uu -u u--	dactylic hexameter	feminine penthemimeral, trithemimeral
οὐκ ὀνοτὴ καὶ Μάκρις Ἀβαντιὰς Ἐλλοπιήων	- uu- - -u u-uu -uu--	dactylic hexameter	feminine penthemimeral, trithemimeral
Σαρδώ θ᾽ἱμερόεσσα καὶ ἣν ἐπενήξατο Κύπρις	-- -uu-u u - uu-uu --	dactylic hexameter	feminine penthemimeral, hepthemimeral
ἐξ ὕδατος τὰ πρῶτα, σαοῖ δέ μιν ἀντ᾽ ἐπιβάθρων.	- uu- - -u u- u u - uu--	dactylic hexameter	feminine penthemimeral, hepthemimeral, trithemimeral
κεῖναι μὲν πύργοισι περισκεπέεσσιν ἐρυμναί,	-- - --u u-uu-u u--	dactylic hexameter	feminine penthemimeral, trithemimeral
δῆλος δ᾽Ἀπόλλωνι· τί δὲ στιβαρώτερον ἕρκος;	-- ---u u - uu-uu --	dactylic hexameter	feminine penthemimeral, hepthemimeral
τείχεα μὲν καὶ λᾶες ὑπαὶ ῥιπῆς κε πέσοιεν	-uu - - -u u- -- u u--	dactylic hexameter	feminine penthemimeral, hepthemimeral, trithemimeral
Στρυμονίου βορέαο· θεὸς δ᾽ἀεὶ ἀστυφέλικτος·	-uu- uu-u u- uu -uu--	dactylic hexameter	feminine penthemimeral, hepthemimeral, trithemimeral
Δῆλε φίλη, τοῖός σε βοηθόος ἀμφιβέβηκεν.	-u u- -- u u-uu -uu--	dactylic hexameter	masculine penthemimeral, trithemimeral
εἰ δὲ λίην πολέες σε περιτροχόωσιν ἀοιδαί,	- u u- uu- u u-uu-u u--	dactylic hexameter	masculine penthemimeral, trithemimeral
ποίῃ ἐνιπλέξω σε; τί τοι θυμῆρες ἀκοῦσαι;	-u u--- u u - --u u--	dactylic hexameter	masculine penthemimeral, hepthemimeral
ἢ ὡς τὰ πρώτιστα μέγας θεὸς οὔρεα θείνων	- - - --u u- uu -uu --	dactylic hexameter	feminine penthemimeral, hepthemimeral, trithemimeral
ἄορι τριγλώχινι, τό οἱ Τελχῖνες ἔτευξαν,	-uu ---u u - --u u--	dactylic hexameter	feminine penthemimeral, hepthemimeral
νήσους εἰναλίας εἰργάζετο, νέρθε δὲ πάσας	-- -uu- --uu -u u --	dactylic hexameter	masculine penthemimeral
ἐκ νεάτων ὤχλισσε καὶ εἰσεκύλισε θαλάσσῃ;	- uu- --u u -uu-u u--	dactylic hexameter	feminine penthemimeral, trithemimeral
καὶ τὰς μὲν κατὰ βυσσόν, ἵν᾽ ἠπείροιο λάθωνται,	- - - uu -u u ---u u--	dactylic hexameter	feminine penthemimeral, trithemimeral
πρυμνόθεν ἐρρίζωσε· δὲ δ᾽οὐκ ἔθλιψεν ἀνάγκη,	-uu ---u u - --u u--	dactylic hexameter	feminine penthemimeral, hepthemimeral
ἀλλ᾽ ἄφετος πελάγεσσιν ἐπέπλεες, οὔνομα δ᾽ἦν σοι	- uu- uu-u u-uu -uu - -	dactylic hexameter	feminine penthemimeral, trithemimeral
Ἀστερίη τὸ παλαιόν, ἐπεὶ βαθὺν ἥλαο τάφρον	-uu- u u-u u- uu -uu --	dactylic hexameter	feminine penthemimeral, hepthemimeral, trithemimeral
οὐρανόθεν φεύγουσα Διὸς γάμον ἀστέρι ἴση.	-uu- --u u- uu -uu --	dactylic hexameter	feminine penthemimeral, hepthemimeral, trithemimeral
τόφρα μὲν οὔπω σοι χρυσέη ἐπεμίσγετο Λητώ,	-u u -- - uu- uu-uu --	dactylic hexameter	masculine penthemimeral, hepthemimeral
τόφρα δ᾽ἔτ᾽ Ἀστερίη σὺ καὶ οὐδέπω ἔκλεο Δῆλος·	-u u -uu- u u -uu -uu --	dactylic hexameter	masculine penthemimeral
πολλάκι σε Τροιζῆνος ἀπὸ ξανθοῖο πολίχνης	-uu - --u u- --u u--	dactylic hexameter	feminine penthemimeral, hepthemimeral, trithemimeral
ἐρχόμενοι Ἐφύρηνδε Σαρωνικοῦ ἔνδοθι κόλπου	-uu- uu-u u-uu -uu --	dactylic hexameter	feminine penthemimeral, trithemimeral
ναῦται ἐπεσκέψαντο, καὶ ἐξ Ἐφύρης ἀνιόντες	-u u---u u - uu- uu--	dactylic hexameter	feminine penthemimeral, hepthemimeral
οἱ μὲν ἔτ᾽ οὐκ ἴδον αὖθι, σὺ δὲ στεινοῖο παρ᾽ ὀξὺν	- u u - uu -u u - --u u --	dactylic hexameter	feminine penthemimeral, hepthemimeral, trithemimeral
ἔδραμες Εὐρίποιο πόρον καναχηδὰ ῥέοντος,	-uu ---u u- uu-u u--	dactylic hexameter	feminine penthemimeral, hepthemimeral
Χαλκιδικῆς δ᾽αὐτῆμαρ ἀνηναμένη ἁλὸς ὕδωρ	-uu- --u u-uu- uu --	dactylic hexameter	feminine penthemimeral, trithemimeral
μέσφ᾽ ἐς Ἀθηναίων προσενήξαο Σούνιον ἄκρον	- u u--- uu-uu -uu --	dactylic hexameter	masculine penthemimeral
ἢ Χίον ἢ νήσοιο διάβροχον ὕδατι μαστὸν	- uu - --u u-uu -uu --	dactylic hexameter	feminine penthemimeral, trithemimeral
παρθενίης (οὔπω γὰρ ἔην Σάμος), ἧχι σε νύμφαι	-uu- -- u u- uu -u u --	dactylic hexameter	masculine penthemimeral, hepthemimeral, trithemimeral
γείτονες Ἀγκαίου Μυκαλησσίδες ἐξείνισσαν.	-uu --- uu-uu ----	dactylic hexameter	masculine penthemimeral
ἡνίκα δ᾽Ἀπόλλωνι γενέθλιον οὖδας ὑπέσχες,	-uu ---u u-uu -u u--	dactylic hexameter	feminine penthemimeral
τοῦτό τοι ἀντημοιβὸν ἁλίπλοοι οὔνομ᾽ ἔθεντο,	-u u ---u u-uu -u u--	dactylic hexameter	feminine penthemimeral
οὕνεκεν οὐκέτ᾽ ἄδηλος ἐπέπλεες, ἀλλ᾽ ἐνὶ πόντου	-uu -u u-u u-uu - uu --	dactylic hexameter	feminine penthemimeral
κύμασιν Αἰγαίοιο ποδῶν ἐνεθήκαο ῥίζας.	-uu ---u u- uu-uu --	dactylic hexameter	feminine penthemimeral, hepthemimeral
οὐδ᾽ Ἥρην κοτέουσαν ὑπέτρεσας· ἡ μὲν ἁπάσαις	- -- uu-u u-uu - u u--	dactylic hexameter	feminine penthemimeral, trithemimeral
δεινὸν ἐπεβρωμᾶτο λεχωίσιν αἳ Διὶ παῖδας	-u u---u u-uu - uu --	dactylic hexameter	feminine penthemimeral
ἐξέφερον, Λητοῖ δὲ διακριδόν, οὕνεκα μούνη	-uu- -- u u-uu -uu --	dactylic hexameter	masculine penthemimeral, trithemimeral
Ζηνὶ τεκεῖν ἤμελλε φιλαίτερον Ἄρεος υἷα.	-u u- --u u-uu -uu --	dactylic hexameter	feminine penthemimeral, trithemimeral
τῶ ῥα καὶ αὐτὴ μὲν σκοπιὴν ἔχεν αἰθέρος εἴσω	- u u -- - uu- uu -uu --	dactylic hexameter	masculine penthemimeral, hepthemimeral
σπερχομένη μέγα δή τι καὶ οὐ φατόν, εἶργε δὲ Λητὼ	-uu- uu - u u - uu -u u --	dactylic hexameter	masculine penthemimeral, hepthemimeral, trithemimeral
τειρομένην ὠδῖσι· δύω δέ οἱ εἵατο φρουροὶ	-uu- --u u- u u -uu --	dactylic hexameter	feminine penthemimeral, hepthemimeral, trithemimeral
γαῖαν ἐποπτεύοντες, ὁ μὲν πέδον ἠπείροιο	-u u---u u - uu ----	dactylic hexameter	feminine penthemimeral, hepthemimeral
ἥμενος ὑψηλῆς κορυφῆς ἔπι Θρήικος Αἵμου	-uu --- uu- uu -uu --	dactylic hexameter	masculine penthemimeral, hepthemimeral
θοῦρος Ἄρης ἐφύλασσε σὺν ἔντεσι, τὼ δέ οἱ ἵππω	-u u- uu-u u -uu - u u --	dactylic hexameter	feminine penthemimeral, trithemimeral
ἑπτάμυχον βορέαο παρὰ σπέος ηὐλίζοντο·	-uu- uu-u u- uu ----	dactylic hexameter	feminine penthemimeral, hepthemimeral, trithemimeral
ἡ δ᾽ἐπὶ νησάων ἑτέρη σκοπὸς εὐρειάων	- uu --- uu- uu ----	dactylic hexameter	masculine penthemimeral, hepthemimeral
ἧστο κόρη Θαύμαντος ἐπαΐξασα Μίμαντι.	-u u- --u u-uu- ---	dactylic hexameter	feminine penthemimeral, trithemimeral
ἔνθ᾽ οἱ μὲν πολίεσσιν ὅσαις ἐπεβάλλετο Λητὼ	- - - uu-u u- uu-uu --	dactylic hexameter	feminine penthemimeral, hepthemimeral, trithemimeral
μίμνον ἀπειλητῆρες, ἀπετρώπων δὲ δέχεσθαι.	-u u---u u--- u u--	dactylic hexameter	feminine penthemimeral
φεῦγε μὲν Ἀρκαδίη, φεῦγεν δ᾽ὄρος ἱερὸν Αὔγης	-u u -uu- -- uu -uu --	dactylic hexameter	masculine penthemimeral, hepthemimeral
Παρθένιον, φεῦγεν δ᾽ὁ γέρων μετόπισθε Φενειός.	-uu- -- u u- uu-u u--	dactylic hexameter	masculine penthemimeral, hepthemimeral, trithemimeral
φεῦγε δ᾽ὅλη Πελοπηὶς ὅση παρακέκλιται Ἰσθμῷ,	-u u- uu-u u- uu-uu --	dactylic hexameter	feminine penthemimeral, hepthemimeral, trithemimeral
ἔμπλην Αἰγιαλοῦ τε καὶ Ἄργεος· οὐ γὰρ ἐκείνας	-- -uu- u u -uu - u u--	dactylic hexameter	masculine penthemimeral
ἀτραπιτοὺς ἐπάτησεν, ἐπεὶ λάχεν Ἴναχον Ἥρη.	-uu- uu-u u- uu -uu --	dactylic hexameter	feminine penthemimeral, hepthemimeral, trithemimeral
φεῦγε καὶ Ἀονίη τὸν ἕνα δρόμον, αἱ δ᾽ἐφέποντο	-u u -uu- u u- uu - uu--	dactylic hexameter	masculine penthemimeral, hepthemimeral
Δίρκη τε Στροφίη τε μελαμψήφιδος ἔχουσαι	-- - uu- u u---u u--	dactylic hexameter	masculine penthemimeral, trithemimeral
Ἰσμηνοῦ χέρα πατρός, ὁ δ᾽εἵπετο πολλὸν ὄπισθεν	--- uu -u u -uu -u u--	dactylic hexameter	feminine penthemimeral, trithemimeral
Ἀσωπὸς βαρύγουνος, ἐπεὶ πεπάλακτο κεραυνῷ.	--- uu-u u- uu-u u--	dactylic hexameter	feminine penthemimeral, hepthemimeral, trithemimeral
ἡ δ᾽ὑποδινηθεῖσα χοροῦ ἀπεπαύσατο νύμφη	- uu---u u- uu-uu --	dactylic hexameter	feminine penthemimeral, hepthemimeral
αὐτόχθων Μελίη καὶ ὑπόχλοον ἔσχε παρειὴν	--- uu- u u-uu -u u--	dactylic hexameter	masculine penthemimeral, trithemimeral
ἥλικος ἀσθμαίνουσα περὶ δρυός, ὡς ἴδε χαίτην	-uu ---u u- uu - uu --	dactylic hexameter	feminine penthemimeral, hepthemimeral
σειομένην Ἑλικῶνος. ἐμαὶ θεαί, εἴπατε Μοῦσαι,	-uu- uu-u u- uu -uu --	dactylic hexameter	feminine penthemimeral, hepthemimeral, trithemimeral
ἦ ῥ᾽ἐτεὸν ἐγένοντο τότε δρύες ἡνίκα Νύμφαι;	- uu- uu-u u- uu -uu --	dactylic hexameter	feminine penthemimeral, hepthemimeral, trithemimeral
νύμφαι μὲν χαίρουσιν, ὅτε δρύας ὄμβρος ἀέξει,	-- - --u u- uu -u u--	dactylic hexameter	feminine penthemimeral, hepthemimeral, trithemimeral
νύμφαι δ᾽αὖ κλαίουσιν, ὅτε δρυσὶν οὐκέτι φύλλα.	-- - --u u- uu -uu --	dactylic hexameter	feminine penthemimeral, hepthemimeral, trithemimeral
ταῖς μὲν ἔτ᾽ Ἀπόλλων ὑποκόλπιος αἰνὰ χολώθη,	- u u --- uu-uu -u u--	dactylic hexameter	masculine penthemimeral
φθέγξατο δ᾽οὐκ ἀτέλεστον ἀπειλήσας ἐπὶ Θήβῃ·	-uu - uu-u u--- uu --	dactylic hexameter	feminine penthemimeral, trithemimeral
"Θήβη, τίπτε τάλαινα τὸν αὐτίκα πότμον ἐλέγχεις;	-- -u u-u u -uu -u u--	dactylic hexameter	feminine penthemimeral
μήπω μή μ᾽ἀέκοντα βιάζεο μαντεύεσθαι.	-- - uu-u u-uu ----	dactylic hexameter	feminine penthemimeral, trithemimeral
οὔπω μοι Πυθῶνι μέλει τριποδήιος ἕδρη,	-- - --u u- uu-uu --	dactylic hexameter	feminine penthemimeral, hepthemimeral, trithemimeral
οὐδέ τί πω τέθνηκεν ὄφις μέγας, ἀλλ᾽ ἔτι κεῖνο	-u u - --u u- uu - uu --	dactylic hexameter	feminine penthemimeral, hepthemimeral, trithemimeral
θηρίον αἰνογένειον ἀπὸ Πλειστοῖο καθέρπον	-uu -uu-u u- --u u--	dactylic hexameter	feminine penthemimeral, hepthemimeral
Παρνησὸν νιφόεντα περιστέφει ἐννέα κύκλοις·	--- uu-u u-uu -uu --	dactylic hexameter	feminine penthemimeral, trithemimeral
ἀλλ᾽ ἔμπης ἐρέω τι τομώτερον ἢ ἀπὸ δάφνης.	- -- uu- u u-uu - uu --	dactylic hexameter	masculine penthemimeral, trithemimeral
φεῦγε πρόσω· ταχινός σε κιχήσομαι αἵματι λούσων	-u u- uu- u u-uu -uu --	dactylic hexameter	masculine penthemimeral, trithemimeral
τόξον ἐμόν· σὺ δὲ τέκνα κακογλώσσοιο γυναικὸς	-u u- u u -u u---u u--	dactylic hexameter	feminine penthemimeral, trithemimeral
ἔλλαχες1. οὐ σύ γ᾽ἐμεῖο φίλη τροφὸς οὐδὲ Κιθαιρὼν	-uu - u u-u u- uu -u u--	dactylic hexameter	feminine penthemimeral, hepthemimeral, trithemimeral
ἔσσεται· εὐαγέων δὲ καὶ εὐαγέεσσι μελοίμην."	-uu -uu- u u -uu-u u--	dactylic hexameter	masculine penthemimeral
ὣς ἄρ᾽ ἔφη. Λητὼ δὲ μετάτροπος αὖτις ἐχώρει.	- u u- -- u u-uu -u u--	dactylic hexameter	masculine penthemimeral, trithemimeral
ἀλλ᾽ ὅτ᾽ Ἀχαιιάδες μιν ἀπηρνήσαντο πόληες	- u u-uu- u u---u u--	dactylic hexameter	masculine penthemimeral
ἐρχομένην, Ἑλίκη τε Ποσειδάωνος ἑταίρη	-uu- uu- u u---u u--	dactylic hexameter	masculine penthemimeral, trithemimeral
Βοῦρά τε Δεξαμενοῖο βοόστασις Οἰκιάδαο,	-u u -uu-u u-uu -uu--	dactylic hexameter	feminine penthemimeral
ἂψ δ᾽ἐπὶ Θεσσαλίην πόδας ἔτρεπε, φεῦγε δ᾽Ἄναυρος	- uu -uu- uu -uu -u u--	dactylic hexameter	masculine penthemimeral
καὶ μεγάλη Λάρισα καὶ αἱ Χειρωνίδες ἄκραι,	- uu- uu- - - --uu --	dactylic hexameter	masculine penthemimeral, hepthemimeral, trithemimeral
φεῦγε δὲ καὶ Πηνειὸς ἑλισσόμενος διὰ Τεμπέων.	-u u - --u u-uu- uu --	dactylic hexameter	feminine penthemimeral, trithemimeral
Ἥρη, σοὶ δ᾽ἔτι τῆμος ἀνηλεὲς ἦτορ ἔκειτο	-- - uu -u u-uu -u u--	dactylic hexameter	feminine penthemimeral, trithemimeral
οὐδὲ κατεκλάσθης τε καὶ ᾤκτισας, ἡνίκα πήχεις	-u u--- u u -uu -uu --	dactylic hexameter	masculine penthemimeral
ἀμφοτέρους ὀρέγουσα μάτην ἐφθέγξατο τοῖα	-uu- uu-u u- --uu --	dactylic hexameter	feminine penthemimeral, hepthemimeral, trithemimeral
"Νύμφαι Θεσσαλίδες, ποταμοῦ γένος, εἴπατε πατρὶ	-- -uu- uu- uu -uu --	dactylic hexameter	masculine penthemimeral, hepthemimeral
κοιμῆσαι μέγα χεῦμα· περιπλέξασθε γενείῳ	--- uu -u u---u u--	dactylic hexameter	feminine penthemimeral, trithemimeral
λισσόμεναι τὰ Ζηνὸς ἐν ὕδατι τέκνα τεκέσθαι.	-uu- - -u u -uu -u u--	dactylic hexameter	feminine penthemimeral, trithemimeral
Πηνειὲ Φθιῶτα, τί νῦν ἀνέμοισιν ἐρίζεις;	--- --u u - uu-u u--	dactylic hexameter	feminine penthemimeral, hepthemimeral, trithemimeral
ὦ πάτερ, οὐ μὴν ἵππον ἀέθλιον ἀμφιβέβηκας.	- uu - - -u u-uu -uu--	dactylic hexameter	feminine penthemimeral, trithemimeral
ἦ ῥά τοι ὧδ᾽ αἰεὶ ταχινοὶ πόδες, ἢ ἐπ᾽ ἐμεῖο	- u u - -- uu- uu - u u--	dactylic hexameter	masculine penthemimeral, hepthemimeral, trithemimeral
μοῦνοι ἐλαφρίζουσι, πεποίησαι δὲ πέτεσθαι	-u u---u u--- u u--	dactylic hexameter	feminine penthemimeral
σήμερον ἐξαπίνης;" ὁ δ᾽ἀνήκοος. "ὦ ἐμὸν ἄχθος,	-uu -uu- u u-uu - uu --	dactylic hexameter	masculine penthemimeral
ποῖ σε φέρω; μέλεοι γὰρ ἀπειρήκασι τένοντες.	- u u- uu- u u---u u--	dactylic hexameter	masculine penthemimeral, trithemimeral
Πήλιον ὦ Φιλύρης νυμφήιον, ἀλλὰ σὺ μεῖνον,	-uu - uu- --uu -u u --	dactylic hexameter	masculine penthemimeral, trithemimeral
μεῖνον, ἐπεὶ καὶ θῆρες ἐν οὔρεσι πολλάκι σεῖο	-u u- - -u u -uu -uu --	dactylic hexameter	feminine penthemimeral, trithemimeral
ὠμοτόκους ὠδῖνας ἀπηρείσαντο λέαιναι."	-uu- --u u---u u--	dactylic hexameter	feminine penthemimeral, trithemimeral
τὴν δ᾽ἄρα καὶ Πηνειὸς ἀμείβετο δάκρυα λείβων	- uu - --u u-uu -uu --	dactylic hexameter	feminine penthemimeral, trithemimeral
"Λητοῖ, Ἀναγκαίη μεγάλη θεός. οὐ γὰρ ἔγωγε	-u u--- uu- uu - u u--	dactylic hexameter	masculine penthemimeral, hepthemimeral
πότνια σὰς ὠδῖνας ἀναίνομαι· οἶδα καὶ ἄλλας	-uu - --u u-uu -u u --	dactylic hexameter	feminine penthemimeral, trithemimeral
λουσαμένας ἀπ᾽ ἐμεῖο λεχωίδας· ἀλλά μοι Ἥρη	-uu- u u-u u-uu -u u --	dactylic hexameter	feminine penthemimeral, trithemimeral
δαψιλὲς ἠπείλησεν. ἀπαύγασαι, οἷος ἔφεδρος	-uu ---u u-uu -u u--	dactylic hexameter	feminine penthemimeral
οὔρεος ἐξ ὑπάτου σκοπιὴν ἔχει, ὅς κέ με ῥεῖα	-uu - uu- uu- uu - u u --	dactylic hexameter	masculine penthemimeral, hepthemimeral, trithemimeral
βυσσόθεν ἐξερύσειε. τί μήσομαι; ἢ ἀπολέσθαι	-uu -uu-u u -uu - uu--	dactylic hexameter	feminine penthemimeral
ἡδύ τί τοι Πηνειόν; ἴτω πεπρωμένον ἦμαρ·	-u u - --u u- --uu --	dactylic hexameter	feminine penthemimeral, hepthemimeral, trithemimeral
τλήσομαι εἵνεκα σεῖο καὶ εἰ μέλλοιμι ῥοάων	-uu -uu -u u - --u u--	dactylic hexameter	feminine penthemimeral, hepthemimeral
διψαλέην ἄμπωτιν ἔχων αἰώνιον ἔρρειν	-uu- --u u- --uu --	dactylic hexameter	feminine penthemimeral, hepthemimeral, trithemimeral
καὶ μόνος ἐν ποταμοῖσιν ἀτιμότατος καλέεσθαι.	- uu - uu-u u-uu- uu--	dactylic hexameter	feminine penthemimeral, trithemimeral
ἠνίδ᾽ ἐγώ· τί περισσά; κάλει μόνον Εἰλήθυιαν."	-u u- u u-u u- uu ----	dactylic hexameter	feminine penthemimeral, hepthemimeral, trithemimeral
εἶπε καὶ ἠρώησε μέμαν ῥόον. ἀλλά οἱ Ἄρης	-u u ---u u- uu -u u --	dactylic hexameter	feminine penthemimeral, hepthemimeral
Παγγαίου προθέλυμνα καρήατα μέλλεν ἀείρας	--- uu-u u-uu -u u--	dactylic hexameter	feminine penthemimeral, trithemimeral
ἐμβαλέειν δίνῃσιν, ἀποκρύψαι δὲ ῥέεθρα·	-uu- --u u--- u u--	dactylic hexameter	feminine penthemimeral, trithemimeral
ὑψόθε δ᾽ἐσμαράγησε καὶ ἀσπίδα τύψεν ἀκωκῇ	-uu -uu-u u -uu -u u--	dactylic hexameter	feminine penthemimeral
δούρατος· ἡ δ᾽ἐλέλιξεν ἐνόπλιον· ἔτρεμε δ᾽Ὄσσης	-uu - uu-u u-uu -uu --	dactylic hexameter	feminine penthemimeral, trithemimeral
οὔρεα καὶ πεδίον Κραννώνιον αἵ τε δυσαεῖς	-uu - uu- --uu - u u--	dactylic hexameter	masculine penthemimeral, trithemimeral
ἐσχατιαὶ Πίνδοιο, φόβῳ δ᾽ὠρχήσατο πᾶσα	-uu- --u u- --uu --	dactylic hexameter	feminine penthemimeral, hepthemimeral, trithemimeral
Θεσσαλίη· τοῖος γὰρ ἀπ᾽ ἀσπίδος ἔβρεμεν ἦχος.	-uu- -- u u -uu -uu --	dactylic hexameter	masculine penthemimeral, trithemimeral
ὡς δ᾽ὁπότ᾽ Αἰτναίου ὄρεος πυρὶ τυφομένοιο	- uu --- uu- uu -uu--	dactylic hexameter	masculine penthemimeral, hepthemimeral
σείονται μυχὰ πάντα κατουδαίοιο γίγαντος	--- uu -u u---u u--	dactylic hexameter	feminine penthemimeral, trithemimeral
εἰς ἑτέρην Βριαρῆος ἐπωμίδα κινυμένοιο,	- uu- uu-u u-uu -uu--	dactylic hexameter	feminine penthemimeral, trithemimeral
θερμάστραι τε βρέμουσιν ὑφ᾽ Ἡφαίστοιο πυράγρης	--- u u-u u ---u u--	dactylic hexameter	feminine penthemimeral, trithemimeral
ἔργα θ᾽ὁμοῦ, δεινὸν δὲ πυρίκμητοί τε λέβητες	-u u- -- u u--- u u--	dactylic hexameter	masculine penthemimeral, trithemimeral
καὶ τρίποδες πίπτοντες ἐπ᾽ ἀλλήλοις ἰαχεῦσι·	- uu- --u u --- uu--	dactylic hexameter	feminine penthemimeral, trithemimeral
τῆμος ἔγεντ᾽ ἄραβος σάκεος τόσος εὐκύκλοιο.	-u u- uu- uu- uu ----	dactylic hexameter	masculine penthemimeral, hepthemimeral, trithemimeral
Πηνειὸς δ᾽οὐκ αὖτις ἐχάζετο, μίμνε δ᾽ὁμοίως	--- - -u u-uu -u u--	dactylic hexameter	feminine penthemimeral, trithemimeral
καρτερὸς ὡς τὰ πρῶτα, θοὰς δ᾽ἐστήσατο δίνας,	-uu - - -u u- --uu --	dactylic hexameter	feminine penthemimeral, hepthemimeral, trithemimeral
εἰσόκε οἱ Κοιηὶς ἐκέκλετο "σῴζεο χαίρων,	-uu - --u u-uu -uu --	dactylic hexameter	feminine penthemimeral, trithemimeral
σῴζεο· μὴ σύ γ᾽ἐμεῖο πάθῃς κακὸν εἵνεκα τῆσδε	-uu - u u-u u- uu -uu --	dactylic hexameter	feminine penthemimeral, hepthemimeral, trithemimeral
ἀντ᾽ ἐλεημοσύνης, χάριτος δέ τοι ἔσσετ᾽ ἀμοιβή."	- uu-uu- uu- u u -u u--	dactylic hexameter	masculine penthemimeral, hepthemimeral
ἦ καὶ πολλὰ πάροιθεν ἐπεὶ κάμεν ἔστιχε νήσους	- - -u u-u u- uu -uu --	dactylic hexameter	feminine penthemimeral, hepthemimeral
εἰναλίας· αἱ δ᾽οὔ μιν ἐπερχομένην ἐδέχοντο,	-uu- - - u u-uu- uu--	dactylic hexameter	masculine penthemimeral, trithemimeral
οὐ λιπαρὸν νήεσσιν Ἐχινάδες ὅρμον ἔχουσαι,	- uu- --u u-uu -u u--	dactylic hexameter	feminine penthemimeral, trithemimeral
οὐδ᾽ ἥτις Κέρκυρα φιλοξεινωτάτη ἄλλων,	- -- --u u---uu --	dactylic hexameter	feminine penthemimeral, trithemimeral
Ἶρις ἐπεὶ πάσῃσιν ἐφ᾽ ὑψηλοῖο Μίμαντος	-u u- --u u ---u u--	dactylic hexameter	feminine penthemimeral, trithemimeral
σπερχομένη μάλα πολλὸν ἀπέτραπεν· αἱ δ᾽ὑπ᾽ ὁμοκλῆς	-uu- uu -u u-uu - u u--	dactylic hexameter	feminine penthemimeral, trithemimeral
πανσυδίῃ φοβέοντο κατὰ ῥόον ἥντινα τέτμοι.	-uu- uu-u u- uu -uu --	dactylic hexameter	feminine penthemimeral, hepthemimeral, trithemimeral
ὠγυγίην δἤπειτα Κόων, Μεροπηίδα νῆσον,	-uu- --u u- uu-uu --	dactylic hexameter	feminine penthemimeral, hepthemimeral, trithemimeral
ἵκετο, Χαλκιόπης ἱερὸν μυχὸν ἡρωίνης.	-uu -uu- uu- uu ----	dactylic hexameter	masculine penthemimeral, hepthemimeral
ἀλλά ἑ παιδὸς ἔρυκεν ἔπος τόδε "μὴ σύ γε, μῆτερ,	-u u -u u-u u- uu - u u --	dactylic hexameter	feminine penthemimeral, hepthemimeral
τῇ με τέκοις. οὔτ᾽ οὖν ἐπιμέμφομαι οὐδὲ μεγαίρω	- u u- - - uu-uu -u u--	dactylic hexameter	masculine penthemimeral, trithemimeral
νῆσον, ἐπεὶ λιπαρή τε καὶ εὔβοτος, εἴ νύ τις ἄλλη·	-u u- uu- u u -uu - u u --	dactylic hexameter	masculine penthemimeral, trithemimeral
ἀλλά οἱ ἐκ Μοιρέων τις ὀφειλόμενος θεὸς ἄλλος	-u u - -- u u-uu- uu --	dactylic hexameter	masculine penthemimeral, trithemimeral
ἐστί, Σαωτήρων ὕπατον γένος· ᾧ ὑπὸ μίτρην	-u u--- uu- uu - uu --	dactylic hexameter	masculine penthemimeral, hepthemimeral
ἵξεται οὐκ ἀέκουσα Μακηδόνι κοιρανέεσθαι	-uu - uu-u u-uu -uu--	dactylic hexameter	feminine penthemimeral, trithemimeral
ἀμφοτέρη μεσόγεια καὶ αἳ πελάγεσσι κάθηνται,	-uu- uu-u u - uu-u u--	dactylic hexameter	feminine penthemimeral, hepthemimeral, trithemimeral
μέχρις ὅπου περάτη τε καὶ ὁππόθεν ὠκέες ἵπποι	-u u- uu- u u -uu -uu --	dactylic hexameter	masculine penthemimeral, trithemimeral
ἠέλιον φορέουσιν· ὁ δ᾽εἴσεται ἤθεα πατρός.	-uu- uu-u u -uu -uu --	dactylic hexameter	feminine penthemimeral, trithemimeral
καί νύ ποτε ξυνός τις ἐλεύσεται ἄμμιν ἄεθλος	- u u- -- u u-uu -u u--	dactylic hexameter	masculine penthemimeral, trithemimeral
ὕστερον, ὁππότ᾽ ἂν οἱ μὲν ἐφ᾽ Ἑλλήνεσσι μάχαιραν	-uu -u u - u u ---u u--	dactylic hexameter	masculine penthemimeral
βαρβαρικὴν καὶ Κελτὸν ἀναστήσαντες Ἄρηα	-uu- - -u u---u u--	dactylic hexameter	feminine penthemimeral, trithemimeral
ὀψίγονοι Τιτῆνες ἀφ᾽ ἑσπέρου ἐσχατόωντος	-uu- --u u -uu -uu--	dactylic hexameter	feminine penthemimeral, trithemimeral
ῥώσωνται νιφάδεσσιν ἐοικότες ἢ ἰσάριθμοι	--- uu-u u-uu - uu--	dactylic hexameter	feminine penthemimeral, trithemimeral
τείρεσιν, ἡνίκα πλεῖστα κατ᾽ ἠέρα βουκολέονται,	-uu -uu -u u -uu -uu--	dactylic hexameter	feminine penthemimeral
φρούρια καὶ [κῶμαι Λοκρῶν καὶ Δελφίδες ἄκραι	-uu - -- -- - -uu --	dactylic hexameter	masculine penthemimeral, hepthemimeral, trithemimeral
καὶ πεδία Κρισσαῖα καὶ ἠπείροι [ο φάραγγες	- uu- --u u --- u u--	dactylic hexameter	feminine penthemimeral, trithemimeral
ἀμφιπεριστείνωνται, ἴδωσι δὲ πίονα καπνὸν	-uu---u u-u u -uu --	dactylic hexameter	feminine penthemimeral
γείτονος αἰθομένοιο, καὶ οὐκέτι μοῦνον ἀκουῇ,	-uu -uu-u u -uu -u u--	dactylic hexameter	feminine penthemimeral
ἀλλ᾽ ἤδη παρὰ νηὸν ἀπαυγάζοιντο φάλαγγας	- -- uu -u u---u u--	dactylic hexameter	feminine penthemimeral, trithemimeral
δυσμενέων, ἤδη δὲ παρὰ τριπόδεσσιν ἐμεῖο	-uu- -- u u- uu-u u--	dactylic hexameter	masculine penthemimeral, hepthemimeral, trithemimeral
φάσγανα καὶ ζωστῆρας ἀναιδέας ἐχθομένας τε	-uu - --u u-uu -uu- -	dactylic hexameter	feminine penthemimeral, trithemimeral
ἀσπίδας, αἳ Γαλάτῃσι κακὴν ὁδὸν ἄφρονι φύλῳ	-uu - uu-u u- uu -uu --	dactylic hexameter	feminine penthemimeral, hepthemimeral, trithemimeral
στήσονται· τέων αἱ μὲν ἐμοὶ γέρας, αἱ δ᾽ἐπὶ Νείλῳ	--- - - u u- uu - uu --	dactylic hexameter	masculine penthemimeral, hepthemimeral, trithemimeral
ἐν πυρὶ τοὺς φορέοντας ἀποπνεύσαντας ἰδοῦσαι	- uu - uu-u u---u u--	dactylic hexameter	feminine penthemimeral, trithemimeral
κείσονται βασιλῆος ἀέθλια πολλὰ καμόντος.	--- uu-u u-uu -u u--	dactylic hexameter	feminine penthemimeral, trithemimeral
ἐσσόμενε Πτολεμαῖε, τά τοι μαντήια φαίνω.	-uu- uu-u u - --uu --	dactylic hexameter	feminine penthemimeral, hepthemimeral, trithemimeral
αἰνήσεις μέγα δή τι τὸν εἰσέτι γαστέρι μάντιν	--- uu - u u -uu -uu --	dactylic hexameter	masculine penthemimeral, trithemimeral
ὕστερον ἤματα πάντα. σὺ δὲ ξυμβάλλεο, μῆτερ·	-uu -uu -u u - --uu --	dactylic hexameter	feminine penthemimeral, hepthemimeral
ἔστι διειδομένη τις ἐν ὕδατι νήσος ἀραιή,	-u u-uu- u u -uu -u u--	dactylic hexameter	masculine penthemimeral
πλαζομένη πελάγεσσι· πόδες δέ οἱ οὐχ ἑνὶ χώρῳ,	-uu- uu-u u- u u - uu --	dactylic hexameter	feminine penthemimeral, hepthemimeral, trithemimeral
ἀλλὰ παλιρροίῃ ἐπινήχεται ἀνθέρικος ὥς,	-u u--- uu-uu -uu- -	dactylic hexameter	masculine penthemimeral
ἔνθα νότος, ἔνθ᾽ εὖρος, ὅπη φορέῃσι θάλασσα.	-u u- - -u u- uu-u u--	dactylic hexameter	feminine penthemimeral, hepthemimeral, trithemimeral
τῇ με φέροις· κείνην γὰρ ἐλεύσεαι εἰς ἐθέλουσαν."	- u u- -- u u-uu - uu--	dactylic hexameter	masculine penthemimeral, trithemimeral
αἱ μὲν τόσσα λέγοντος ἀπέτρεχον εἰν ἁλὶ νῆσοι·	- - -u u-u u-uu - uu --	dactylic hexameter	feminine penthemimeral
Ἀστερίη φιλόμολπε, σὺ δ᾽Εὐβοίηθε κατῄεις,	-uu- uu-u u ---u u--	dactylic hexameter	feminine penthemimeral, trithemimeral
Κυκλάδας ὀψομένη περιηγέας, οὔ τι παλαιόν,	-uu -uu- uu-uu - u u--	dactylic hexameter	masculine penthemimeral
ἀλλ᾽ ἔτι τοι μετόπισθε Γεραίστιον εἵπετο φῦκος·	- uu - uu-u u-uu -uu --	dactylic hexameter	feminine penthemimeral, trithemimeral
φλεξας ἐπεὶ περικαίεο  πυρί,	-- -- uu-uu - --	lyric	
τλήμον᾽ ὑπ᾽ ὠδίνεσσι βαρυνομένην ὁρόωσα·	-u u ---u u-uu- uu--	dactylic hexameter	feminine penthemimeral
"Ἥρη, τοῦτό με ῥέξον ὅ τοι φίλον· οὐ γὰρ ἀπειλὰς	-- -u u -u u - uu - u u--	dactylic hexameter	feminine penthemimeral, hepthemimeral
ὑμετέρας ἐφύλαξα· πέρα, πέρα εἰς ἐμὲ Λητοῖ."	-uu- uu-u u- uu - uu --	dactylic hexameter	feminine penthemimeral, hepthemimeral, trithemimeral
ἔννεπες· ἡ δ᾽ἀρητὸν ἄλης ἀπεπαύσατο λυγρῆς,	-uu - --u u- uu-uu --	dactylic hexameter	feminine penthemimeral, hepthemimeral, trithemimeral
ἕζετο δ᾽Ἰνωποῖο παρὰ ῥόον, ὅντε βάθιστον	-uu ---u u- uu -u u--	dactylic hexameter	feminine penthemimeral, hepthemimeral
γαῖα τότ᾽ ἐξανίησιν, ὅτε πλήθοντι ῥεέθρῳ	-u u -uu-u u- --u u--	dactylic hexameter	feminine penthemimeral, hepthemimeral
Νεῖλος ἀπὸ κρημνοῖο κατέρχεται Αἰθιοπῆος·	-u u- --u u-uu -uu--	dactylic hexameter	feminine penthemimeral, trithemimeral
λύσατο δὲ ζώνην, ἀπὸ δ᾽ἐκλίθη ἔμπαλιν ὤμοις	-uu - -- uu -uu -uu --	dactylic hexameter	masculine penthemimeral, trithemimeral
φοίνικος ποτὶ πρέμνον ἀμηχανίης ὑπὸ λυγρῆς	--- uu -u u-uu- uu --	dactylic hexameter	feminine penthemimeral, trithemimeral
τειρομένη· νότιος δὲ διὰ χροὸς ἔρρεεν ἱδρώς.	-uu- uu- u u- uu -uu --	dactylic hexameter	masculine penthemimeral, hepthemimeral, trithemimeral
εἶπε δ᾽ἀλυσθμαίνουσα "τί μητέρα, κοῦρε, βαρύνεις;	-u u---u u -uu -u u--	dactylic hexameter	feminine penthemimeral
αὕτη τοι, φίλε, νῆσος ἐπιπλώουσα θαλάσσῃ.	-- - uu -u u---u u--	dactylic hexameter	feminine penthemimeral, trithemimeral
γείνεο, γείνεο, κοῦρε, καὶ ἤπιος ἔξιθι κόλπου."	-uu -uu -u u -uu -uu --	dactylic hexameter	feminine penthemimeral
νύμφα Διὸς βαρύθυμε, σὺ δ᾽οὐκ ἄρ᾽ ἔμελλες ἄπυστος	-u u- uu-u u - u u-u u--	dactylic hexameter	feminine penthemimeral, hepthemimeral, trithemimeral
δὴν ἔμεναι· τοίη σε προσέδραμεν ἀγγελιῶτις,	- uu- -- u u-uu -uu--	dactylic hexameter	masculine penthemimeral, trithemimeral
εἶπε δ᾽ἔτ᾽ ἀσθμαίνουσα, φόβῳ δ᾽ἀνεμίσγετο μῦθος,	-u u ---u u- uu-uu --	dactylic hexameter	feminine penthemimeral, hepthemimeral
"Ἥρη τιμηέσσα, πολὺ προὔχουσα θεάων	-- ---u u- --u u--	dactylic hexameter	feminine penthemimeral, hepthemimeral
σὴ μὲν ἐγώ, σὰ δὲ πάντα, σὺ δὲ κρείουσα κάθησαι	- u u- u u -u u - --u u--	dactylic hexameter	feminine penthemimeral, hepthemimeral, trithemimeral
γνησίη Οὐλύμποιο, καὶ οὐ χέρα δείδιμεν ἄλλην	-uu ---u u - uu -uu --	dactylic hexameter	feminine penthemimeral, hepthemimeral
θηλυτέρην, σὺ δ᾽,ἄνασσα, τὸν αἴτιον εἴσεαι ὀργῆς.	-uu- u u-u u -uu -uu --	dactylic hexameter	feminine penthemimeral, trithemimeral
Λητώ τοι μίτρην ἀναλύεται ἔνδοθι νήσου.	-- - -- uu-uu -uu --	dactylic hexameter	masculine penthemimeral, trithemimeral
ἄλλαι μὲν πᾶσαί μιν ἀπέστυγον οὐδ᾽ ἐδέχοντο·	-- - -- u u-uu - uu--	dactylic hexameter	masculine penthemimeral, trithemimeral
Ἀστερίη δ᾽ὀνομαστὶ παρερχομένην ἐκάλεσσεν,	-uu- uu-u u-uu- uu--	dactylic hexameter	feminine penthemimeral, trithemimeral
Ἀστερίη, πόντοιο κακὸν σάρον· οἶσθα καὶ αὐτή.	-uu- --u u- uu -u u --	dactylic hexameter	feminine penthemimeral, hepthemimeral, trithemimeral
ἀλλά, φίλη, δύνασαι γάρ, ἀμύνειν, πότνια, δούλοις	-u u- uu- u u-- -uu --	dactylic hexameter	masculine penthemimeral, trithemimeral
ὑμετέροις, οἳ σεῖο πέδον πατέουσιν ἐφετμῇ."	-uu- - -u u- uu-u u--	dactylic hexameter	feminine penthemimeral, hepthemimeral, trithemimeral
ἦ καὶ ὑπὸ χρύσειον ἐδέθλιον ἷζε κύων ὥς,	- u u- --u u-uu -u u- -	dactylic hexameter	feminine penthemimeral, trithemimeral
Ἀρτέμιδος ἥτις τε, θοῆς ὅτε παύσεται ἄγρης,	-uu- -- u u- uu -uu --	dactylic hexameter	masculine penthemimeral, hepthemimeral, trithemimeral
ἵζει θηρήτειρα παρ᾽ ἴχνεσιν, οὔατα δ᾽αὐτῆς	-- ---u u -uu -uu --	dactylic hexameter	feminine penthemimeral
ὀρθὰ μάλ᾽, αἰὲν ἑτοῖμα θεῆς ὑποδέχθαι ὀμοκλήν·	-u u -u u-u u- uu-u u--	dactylic hexameter	feminine penthemimeral, hepthemimeral
τῇ ἰκέλη Θαύμαντος ὑπὸ θρόνον ἵζετο κούρη.	- uu- --u u- uu -uu --	dactylic hexameter	feminine penthemimeral, hepthemimeral, trithemimeral
κείνη δ᾽οὐδέποτε σφετέρης ἐπιλήθεται ἕδρης,	-- -uu- uu- uu-uu --	dactylic hexameter	masculine penthemimeral, hepthemimeral
οὐδ᾽ ὅτε οἱ ληθαῖον ἐπὶ πτερὸν ὕπνος ἐρείσῃ,	- uu - --u u- uu -u u--	dactylic hexameter	feminine penthemimeral, hepthemimeral, trithemimeral
ἀλλ᾽ αὐτοῦ μεγάλοιο ποτὶ γλωχῖνα θρόνοιο	- -- uu-u u- --u u--	dactylic hexameter	feminine penthemimeral, hepthemimeral, trithemimeral
τυτθὸν ἀποκλίνασα καρήατα λέχριος εὕδει.	-u u-uu- --uu -uu --	dactylic hexameter	masculine penthemimeral
οὐδέ ποτε ζώνην ἀναλύεται οὐδὲ ταχείας	-u u- -- uu-uu -u u--	dactylic hexameter	masculine penthemimeral, trithemimeral
ἐνδρομίδας, μή οἵ τι καὶ αἰφνίδιον ἔπος εἴπῃ	-uu- - - u u -uu- uu --	dactylic hexameter	masculine penthemimeral, trithemimeral
δεσπότις. ἡ δ᾽ἀλεγεινὸν ἀλαστήσασα προσηύδα	-uu - uu-u u---u u--	dactylic hexameter	feminine penthemimeral, trithemimeral
"οὕτω νῦν, ὦ Ζηνὸς ὀνείδεα, καὶ γαμέοισθε	-- - - -u u-uu - uu--	dactylic hexameter	feminine penthemimeral, trithemimeral
λάθρια καὶ τίκτοιτε κεκρυμμένα, μηδ᾽ ὅθι δειλαὶ	-uu - --u u-uu - uu --	dactylic hexameter	feminine penthemimeral, trithemimeral
δυστοκέες μογέουσιν ἀλετρίδες, ἀλλ᾽ ὅθι φῶκαι	-uu- uu-u u-uu - uu --	dactylic hexameter	feminine penthemimeral, trithemimeral
εἰνάλιαι τίκτουσιν, ἐνὶ σπιλάδεσσιν ἐρήμοις.	-uu- --u u- uu-u u--	dactylic hexameter	feminine penthemimeral, hepthemimeral, trithemimeral
Ἀστερίῃ δ᾽οὐδέν τι βαρύνομαι εἵνεκα τῆσδε	-uu- -- u u-uu -uu --	dactylic hexameter	masculine penthemimeral, trithemimeral
ἀμπλακίης, οὐδ᾽ ἔστιν ὅπως ἀποθύμια ῥέξω,	-uu- - -u u- uu-uu --	dactylic hexameter	feminine penthemimeral, hepthemimeral, trithemimeral
τόσσα δέοι μάλα γάρ τε κακῶς ἐχαρίσσατο Λητοῖ·	-u u- uu - u u- uu-uu --	dactylic hexameter	masculine penthemimeral, hepthemimeral, trithemimeral
ἀλλά μιν ἔκπαγλόν τι σεβίζομαι, οὕνεκ᾽ ἐμεῖο	-u u --- u u-uu -u u--	dactylic hexameter	masculine penthemimeral
δέμνιον οὐκ ἐπάτησε, Διὸς δ᾽ἀνθείλετο πόντον."	-uu - uu-u u- --uu --	dactylic hexameter	feminine penthemimeral, hepthemimeral, trithemimeral
ἡ μὲν ἔφη· κύκνοι δὲ θεοῦ μέλποντες ἀοιδοὶ	- u u- -- u u- --u u--	dactylic hexameter	masculine penthemimeral, hepthemimeral, trithemimeral
Μῃόνιον Πακτωλὸν ἐκυκλώσαντο λιπόντες	-uu- --u u---u u--	dactylic hexameter	feminine penthemimeral, trithemimeral
ἑβδομάκις περὶ Δῆλον, ἐπήεισαν δὲ λοχείῃ	-uu- uu -u u--- u u--	dactylic hexameter	feminine penthemimeral, trithemimeral
Μουσάων ὄρνιθες, ἀοιδότατοι πετεηνῶν·	--- --u u-uu- uu--	dactylic hexameter	feminine penthemimeral, trithemimeral
ἔνθεν ὁ παῖς τοσσάσδε λύρῃ ἐνεδήσατο χορδὰς	-u u - --u u- uu-uu --	dactylic hexameter	feminine penthemimeral, hepthemimeral, trithemimeral
ὕστερον, ὁσσάκι κύκνοι ἐπ᾽ ὠδίνεσσιν ἄεισαν.	-uu -uu -u u ---u u--	dactylic hexameter	feminine penthemimeral
ὄγδοον οὐκέτ᾽ ἄεισαν, ὁ δ᾽ἔκθορεν, αἱ δ᾽ἐπὶ μακρὸν	-uu -u u-u u -uu - uu --	dactylic hexameter	feminine penthemimeral
νύμφαι Δηλιάδες, ποταμοῦ γένος ἀρχαίοιο,	-- -uu- uu- uu ----	dactylic hexameter	masculine penthemimeral, hepthemimeral
εἶπαν Ἐλειθυίης ἱερὸν μέλος, αὐτίκα δ᾽αἰθὴρ	-u u--- uu- uu -uu --	dactylic hexameter	masculine penthemimeral, hepthemimeral
χάλκεος ἀντήχησε διαπρυσίην ὀλολυγήν,	-uu ---u u-uu- uu--	dactylic hexameter	feminine penthemimeral
οὐδ᾽ Ἥρη νεμέσησεν, ἐπεὶ χόλον ἐξέλετο Ζεύς.	- -- uu-u u- uu -uu- -	dactylic hexameter	feminine penthemimeral, hepthemimeral, trithemimeral
χρύσεά τοι τότε πάντα θεμείλια γείνετο, Δῆλε,	-uu - uu -u u-uu -uu --	dactylic hexameter	feminine penthemimeral, trithemimeral
χρυσῷ δὲ τροχόεσσα πανήμερος ἔρρεε λίμνη,	-- - uu-u u-uu -uu --	dactylic hexameter	feminine penthemimeral, trithemimeral
χρύσειον δ᾽ἐκόμησε γενέθλιον ἔρνος ἐλαίης,	--- uu-u u-uu -u u--	dactylic hexameter	feminine penthemimeral, trithemimeral
χρυσῷ δὲ πλήμυρε βαθὺς Ἰνωπὸς ἑλιχθείς.	-- - --u u- --u u--	dactylic hexameter	feminine penthemimeral, hepthemimeral, trithemimeral
αὐτὴ δὲ χρυσέοιο ἀπ᾽ οὔδεος εἵλεο παῖδα,	-- - uu-u u -uu -uu --	dactylic hexameter	feminine penthemimeral, trithemimeral
ἐν δ᾽ἐβάλευ κόλποισιν, ἔπος δ᾽ἐφθέγξαο τοῖον·	- uu- --u u- --uu --	dactylic hexameter	feminine penthemimeral, hepthemimeral, trithemimeral
"ᾦ μεγάλη πολύβωμε πολύπτολι πολλὰ φέρουσα,	- uu- uu-u u-uu -u u--	dactylic hexameter	feminine penthemimeral, trithemimeral
πίονες ἤπειροί τε καὶ αἳ περιναίετε νῆσοι·	-uu --- u u - uu-uu --	dactylic hexameter	masculine penthemimeral, hepthemimeral
αὐτὴ ἐγὼ τοιήδε, δυσήροτος, ἀλλ᾽ ἀπ᾽ ἐμεῖο	-u u- --u u-uu - u u--	dactylic hexameter	feminine penthemimeral, trithemimeral
Δήλιος Απόλλων κεκλήσεται, οὐδέ τις ἄλλη	-uu --- --uu -u u --	dactylic hexameter	masculine penthemimeral
γαιάων τοσσόνδε θεῷ πεφιλήσεται ἄλλῳ,	--- --u u- uu-uu --	dactylic hexameter	feminine penthemimeral, hepthemimeral, trithemimeral
οὐ Κερχνὶς κρείοντι Ποσειδάωνι Λεχαίῳ,	- -- --u u---u u--	dactylic hexameter	feminine penthemimeral, trithemimeral
οὐ πάγος Ἑρμείῃ Κυλλήνιος, οὐ Διὶ Κρήτη,	- uu --- --uu - uu --	dactylic hexameter	masculine penthemimeral
ὡς ἐγὼ Ἀπόλλωνι· καὶ ἔσσομαι οὐκέτι πλαγκτή."	- uu ---u u -uu -uu --	dactylic hexameter	feminine penthemimeral
ὧδε σὺ μὲν κατέλεξας· ὁ δὲ γλυκὺν ἔσπασε μαζόν.	-u u - uu-u u - uu -uu --	dactylic hexameter	feminine penthemimeral, hepthemimeral, trithemimeral
τῶ καὶ νησάων ἁγιωτάτη ἐξέτι κεἰνου	- - --- uu-uu -uu --	dactylic hexameter	masculine penthemimeral
κλἠζῃ, Ἀπόλλωνος κουροτρόφος· οὐδέ σ᾽Ἐνυὼ	-u u--- --uu -u u--	dactylic hexameter	masculine penthemimeral
οὐδ᾽ Ἀίδης οὐδ᾽ ἵπποι ἐπιστείβουσιν Ἄρηος·	- uu- - -u u---u u--	dactylic hexameter	feminine penthemimeral, trithemimeral
ἀλλά τοι ἀμφιετεῖς δεκατηφόροι αἰὲν ἀπαρχαὶ	-u u -uu- uu-uu -u u--	dactylic hexameter	masculine penthemimeral
πέμπονται, πᾶσαι δὲ χοροὺς ἀνάγουσι πόληες,	--- -- u u- uu-u u--	dactylic hexameter	masculine penthemimeral, hepthemimeral, trithemimeral
αἵ τε πρὸς ἠοίην αἵ θ᾽ἕσπερον αἵ τ᾽ἀνὰ μέσσην	- u u --- - -uu - uu --	dactylic hexameter	masculine penthemimeral
κλήρονς ἐστήσαντο, καὶ οἳ καθύπερθε βορείης	-- ---u u - uu-u u--	dactylic hexameter	feminine penthemimeral, hepthemimeral
οἰκία θινὸς ἔχουσι, πολυχρνιώτατον αἷμα.	-uu -u u-u u---uu --	dactylic hexameter	feminine penthemimeral
οἱ μέν τοι καλάμην τε καὶ ἱερὰ δράγματα πρῶτοι	- - - uu- u u -uu -uu --	dactylic hexameter	masculine penthemimeral, trithemimeral
ἀσταχύων φορέουσιν· ἃ Δωδώνηθι Πελασγοὶ	-uu- uu-u u ---u u--	dactylic hexameter	feminine penthemimeral, trithemimeral
τηλόθεν ἐκβαίνοντα πολὺ πρώτιστα δέχονται,	-uu ---u u- --u u--	dactylic hexameter	feminine penthemimeral, hepthemimeral
γηλεχέες θεράποντες ἀσιγήτοιο λέβητος·	-uu- uu-u u---u u--	dactylic hexameter	feminine penthemimeral, trithemimeral
δεύτερον Ἱερὸν ἄστυ καὶ οὔτεα Μηλίδος αἴης	-uu -uu -u u -uu -uu --	dactylic hexameter	feminine penthemimeral
ἔρχονται· κεῖθεν δὲ διαπλώουσιν Ἀβάντων	--- -- u u---u u--	dactylic hexameter	masculine penthemimeral, trithemimeral
εἰς ἀγαθὸν πεδίον Ληλάντιον· οὐδ᾽ ἔτι μακρὸς	- uu- uu- --uu - uu --	dactylic hexameter	masculine penthemimeral, trithemimeral
ὁ πλόος Εὐβοίηθεν, ἐπεὶ σέο γείτονες ὅρμοι.	- uu ---u u- uu -uu --	dactylic hexameter	feminine penthemimeral, hepthemimeral
πρῶταί τοι τάδ᾽ ἔνεικαν ἀπὸ ξανθῶν Ἀριμασπῶν	-- - u u-u u- -- uu--	dactylic hexameter	feminine penthemimeral, hepthemimeral, trithemimeral
Οὖπίς τε Λοξώ τε καὶ εὐαίων Ἑκαέργη,	-- - -- u u --- uu--	dactylic hexameter	masculine penthemimeral, trithemimeral
θυγατέρες Βορέαο, καὶ ἄρσενες οἱ τότ᾽ ἄριστοι	-uu- uu-u u -uu - u u--	dactylic hexameter	feminine penthemimeral, trithemimeral
ἠιθέων· οὐδ᾽ οἵ γε παλιμπετὲς οἴκαδ᾽ ἵκοντο,	-uu- - - u u-uu -u u--	dactylic hexameter	masculine penthemimeral, trithemimeral
εὔμοιροι δ᾽ἐγένοντο, καὶ ἀκλέες οὔποτ᾽ ἐκεῖνοι.	--- uu-u u -uu -u u--	dactylic hexameter	feminine penthemimeral, trithemimeral
ἦ τοι Δηλιάδες μέν, ὅτ᾽ εὐήχης ὑμέναιος	- - -uu- u u --- uu--	dactylic hexameter	masculine penthemimeral
ἤθεα κουράων μορμύσσεται, ἥλικα χαίτην	-uu --- --uu -uu --	dactylic hexameter	masculine penthemimeral
παρθενικαῖς, παῖδες δὲ θέρος τὸ πρῶτον ἰούλων	-uu- -- u u- - -u u--	dactylic hexameter	masculine penthemimeral, hepthemimeral, trithemimeral
ἄρσενες ἠιθέοισιν ἀπαρχόμενοι φορέουσιν.	-uu -uu-u u-uu- uu--	dactylic hexameter	feminine penthemimeral
Ἀστερίη θυόεσσα, σὲ μὲν περί τ᾽ἀμφί τε νῆσοι	-uu- uu-u u - uu -u u --	dactylic hexameter	feminine penthemimeral, hepthemimeral, trithemimeral
κύκλον ἐποιήσαντο καὶ ὡς χορὸν ἀμφεβάλοντο·	-u u---u u - uu -uu--	dactylic hexameter	feminine penthemimeral, hepthemimeral
οὔτε σιωπηλὴν οὔτ᾽ ἄψοφον οὖλος ἐθείραις	-u u--- - -uu -u u--	dactylic hexameter	masculine penthemimeral
ἕσπερος, ἀλλ᾽ αἰεί σε καταβλέπει ἀμφιβόητον.	-uu - -- u u-uu -uu--	dactylic hexameter	masculine penthemimeral, trithemimeral
οἱ μὲν ὑπαείδουσι νόμον Λυκίοιο γέροντος,	- u u---u u- uu-u u--	dactylic hexameter	feminine penthemimeral, hepthemimeral
ὅν τοι ἀπὸ Ξάνθοιο θεοπρόπος ἤγαγεν Ὠλήν·	- u u- --u u-uu -uu --	dactylic hexameter	feminine penthemimeral, trithemimeral
αἱ δὲ ποδὶ πλήσσουσι χορίτιδες ἀσφαλἐς οὖδας.	- u u- --u u-uu -uu --	dactylic hexameter	feminine penthemimeral, trithemimeral
δὴ τότε καὶ στεφάνοισι βαρύνεται ἱρὸν ἄγαλμα	- uu - uu-u u-uu -u u--	dactylic hexameter	feminine penthemimeral, trithemimeral
Κύπριδος ἀρχαίης ἀριήκοον, ἥν ποτε Θησεὺς	-uu --- uu-uu - uu --	dactylic hexameter	masculine penthemimeral
εἵσατο σὺν παίδεσσιν, ὅτε Κρήτηθεν ἀνέπλει.	-uu - --u u- --u u--	dactylic hexameter	feminine penthemimeral, hepthemimeral, trithemimeral
οἳ χαλεπὸν μύκημα καὶ ἄγριον υἷα φυγόντες	- uu- --u u -uu -u u--	dactylic hexameter	feminine penthemimeral, trithemimeral
Πασιφάης καὶ γναμπτὸν ἕδος σκολιοῦ λαβυρίνθου,	-uu- - -u u- uu- uu--	dactylic hexameter	feminine penthemimeral, hepthemimeral, trithemimeral
πότνια, σὸν περὶ βωμὸν ἐγειρομένου κιθαρισμοῦ	-uu - uu -u u-uu- uu--	dactylic hexameter	feminine penthemimeral, trithemimeral
κύκλιον ὠρχήσαντο, χοροῦ δ᾽ἡγήσατο Θησεύς.	-uu ---u u- --uu --	dactylic hexameter	feminine penthemimeral, hepthemimeral
ἔνθεν ἀειζώοντα θεωρίδος ἱερὰ Φοίβῳ	-u u---u u-uu -uu --	dactylic hexameter	feminine penthemimeral
Κεκροπίδαι πέμπουσι, τοπήια νηὸς ἐκείνης.	-uu- --u u-uu -u u--	dactylic hexameter	feminine penthemimeral, trithemimeral
Ἀστερίη πολύβωμε πολύλλιτε, τίς δέ σε ναύτης	-uu- uu-u u-uu - u u --	dactylic hexameter	feminine penthemimeral, trithemimeral
ἔμπορος Αἰγαίοιο παρήλυθε νηὶ θεούσῃ;	-uu ---u u-uu -u u--	dactylic hexameter	feminine penthemimeral
οὐχ οὕτω μεγάλοι μιν ἐπιπνείουσιν ἀῆται,	- -- uu- u u---u u--	dactylic hexameter	masculine penthemimeral, trithemimeral
χρειὼ δ᾽ὅττι τάχιστον ἄγει πλόον, ἀλλὰ τὰ λαίφη	-- -u u-u u- uu -u u --	dactylic hexameter	feminine penthemimeral, hepthemimeral
ὠκέες ἐστείλαντο καὶ οὐ πάλιν αὖτις ἔβησαν,	-uu ---u u - uu -u u--	dactylic hexameter	feminine penthemimeral, hepthemimeral
πρὶν μέγαν ἢ σέο βωμὸν ὑπὸ πληγῇσιν ἑλίξαι	- uu - uu -u u- --u u--	dactylic hexameter	feminine penthemimeral, hepthemimeral, trithemimeral
ῥησσόμενον καὶ πρέμνον ὀδακτάσαι ἁγνὸν ἐλαίης	-uu- - -u u-uu -u u--	dactylic hexameter	feminine penthemimeral, trithemimeral
χεῖρας ἀποστρέψαντας· ἃ Δηλιὰς εὕρετο νύμφη	-u u---u u -uu -uu --	dactylic hexameter	feminine penthemimeral
παίγνια κουρίζοντι καὶ Ἀπόλλωνι γελαστύν.	-uu ---u u ---u u--	dactylic hexameter	feminine penthemimeral
ἱστίη ὦ νήσων εὐέστιε, χαῖρε μὲν αὐτή,	-uu - -- --uu -u u --	dactylic hexameter	masculine penthemimeral, trithemimeral
χαίροι δ᾽Ἀπόλλων τε καὶ ἣν ἐλοχεύσατο Λητώ.	-- --- u u - uu-uu --	dactylic hexameter	masculine penthemimeral, hepthemimeral
ὅσσαι λωτροχόοι τᾶς Παλλάδος ἔξιτε πᾶσαι,	-- -uu- - -uu -uu --	dactylic hexameter	masculine penthemimeral
ἔξιτε· τᾶν ἵππων ἄρτι φρυασσομενᾶν	-uu - -- -u u-uu-	dactylic pentameter	
τᾶν ἱερᾶν ἐσάκουσα, καὶ ἁ θεὸς εὔτυκος ἕρπειν	- uu- uu-u u - uu -uu --	dactylic hexameter	feminine penthemimeral, hepthemimeral, trithemimeral
σοῦσθέ νυν, ὦ ξανθαί, σοῦσθε Πελασγιάδες.	-u u - -- -u u-uu-	dactylic pentameter	
οὔποκ᾽ Ἀθαναία μεγάλως ἀπενίψατο πάχεις	-u u--- uu- uu-uu --	dactylic hexameter	masculine penthemimeral, hepthemimeral
πρὶν κόνιν ἱππειᾶν ἐξελάσαι λαγόνων,	- uu --- -uu- uu-	dactylic pentameter	
οὐδ᾽ ὅκα δὴ λύθρῳ πεπαλαγμένα πάντα φέροισα	- uu - -- uu-uu -u u--	dactylic hexameter	masculine penthemimeral, trithemimeral
τεύχεα τῶν ἀδίκων ἦνθ᾽ ἀπὸ γηγενέων,	-uu - uu- - uu -uu-	dactylic pentameter	
ἀλλὰ πολὺ πράτιστον ὑφ᾽ ἅρματος αὐχένας ἵππων	-u u- --u u -uu -uu --	dactylic hexameter	feminine penthemimeral, trithemimeral
λυσαμένα παγαῖς ἔκλυσεν Ὠκεανῶ	-uu- -- -uu -uu-	dactylic pentameter	
ἱδρῶ καὶ ῥαθάμιγγας, ἐφοίβασεν δὲ παγέντα	-- - uu-u u--- u u--	dactylic hexameter	feminine penthemimeral, trithemimeral
πάντα χαλινοφάγων ἀφρὸν ἀπὸ στομάτων.	-u u-uu- -u u- uu-	dactylic pentameter	
ὦ ἴτ᾽ Ἀχαιιάδες, καὶ μὴ μύρα μηδ᾽ ἀλαβάστρως	- u u-uu- - - uu - uu--	dactylic hexameter	masculine penthemimeral, hepthemimeral
(συρίγγων ἀίω φθόγγον ὑπαξονίων),	--- uu- -u u-uu-	dactylic pentameter	
μὴ μύρα λωτροχόοι τᾷ Παλλάδι μηδ᾽ ἀλαβάστρως·	- uu -uu- - -uu - uu--	dactylic hexameter	masculine penthemimeral
οὐ γὰρ Ἀθαναία χρίματα μεικτὰ φιλεἶ	- u u--- -uu -u u-	dactylic pentameter	
οἴσετε μηδὲ κάτοπτρον· ἀεὶ καλὸν ὄμμα τὸ τήνας	-uu -u u-u u- uu -u u --	dactylic hexameter	feminine penthemimeral, hepthemimeral
οὐδ᾽ ὅκα τὰν Ἴδᾳ Φρὺξ ἐδίκαζεν ἔριν,	- uu - -- - uu-u u-	dactylic pentameter	
οὔτ᾽ ἐς ὀρείχαλκον μεγάλα θεὸς οὔτε Σιμοῦντος	- u u--- uu- uu -u u--	dactylic hexameter	masculine penthemimeral, hepthemimeral
ἔβλεψεν δίναν ἐς διαφαινομέναν·	--- uu - -uu-uu	lyric	
οὐδ᾽ Ἥρα· Κύπρις δὲ διαυγέα χαλκὸν ἑλοῖσα	- -- -- u u-uu -u u--	dactylic hexameter	masculine penthemimeral, trithemimeral
πολλάκι τὰν αὐτὰν δὶς μετέθηκε κόμαν·	-uu - -- - uu-u u-	dactylic pentameter	
ἁ δέ, δὶς ἑξήκοντα διαθρέξασα διαύλως,	- u u ---u u---u u--	dactylic hexameter	feminine penthemimeral
οἷα παρ᾽ Εὐρώτᾳ τοὶ Λακεδαιμόνιοι	-u u --- - uu-uu-	dactylic pentameter	
ἀστέρες, ἐμπεράμως ἐνετρίψατο λιτὰ λαβοῖσα	-uu -uu- uu-uu -u u--	dactylic hexameter	masculine penthemimeral
χρίματα, τᾶς ἰδίας ἔκγονα φυταλιᾶς·	-uu - uu- -uu -uu-	dactylic pentameter	
ὦ κῶραι, τὸ δ᾽ἔρευθος ἀνέδραμε, πρώιον οἵαν	- -- u u-u u-uu -uu --	dactylic hexameter	feminine penthemimeral, trithemimeral
ἢ ῥόδον ἢ σίβδας κόκκος ἔχει χροΐαν.	- uu - -- -u u- uu-	dactylic pentameter	
τῶ καὶ νῦν ἄρσεν τι κομίξατε μῶνον ἔλαιον,	- - - -- u u-uu -u u--	dactylic hexameter	masculine penthemimeral, trithemimeral
ᾧ Κάστωρ, ᾧ καὶ χρίεται Ἡρακλέης·	- -- - - -uu -uu-	dactylic pentameter	
οἴσετε καὶ κτένα οἱ παγχρύσεον, ὡς ἀπὸ χαίταν	-uu - uu - --uu - uu --	dactylic hexameter	masculine penthemimeral, trithemimeral
πέξηται, λιπαρὸν σμασαμένα πλόκαμον.	--- uu- -uu- uu-	dactylic pentameter	
ἔξιθ᾽ Ἀθαναία· πάρα τοι καταθύμιος ἴλα,	-u u--- uu - uu-uu --	dactylic hexameter	masculine penthemimeral, hepthemimeral
παρθενικαὶ μεγάλων παῖδες Ἀκεστοριδᾶν	-uu- uu- -u u-uu-	dactylic pentameter	
ὠθάνα, φέρεται δὲ καὶ ἁ Διομήδεος ἀσπίς,	-uu --- u u - uu-uu --	dactylic hexameter	masculine penthemimeral, hepthemimeral
ὡς ἔθος Ἀργείων τοῦτο παλαιότερον	- uu --- -u u-uu-	dactylic pentameter	
Εὐμήδης ἐδίδαξε, τεὶν κεχαρισμένος ἱρεύς·	--- uu-- - uu-uu --	dactylic hexameter	hepthemimeral, trithemimeral
ὅς ποκα βωλευτὸν γνοὺς ἐπί οἱ θάνατον	- uu --- - uu - uu-	dactylic pentameter	
δᾶμον ἑτοιμάζοντα φυγᾷ τεὸν ἱρὸν ἄγαλμα	-u u---u u- uu -u u--	dactylic hexameter	feminine penthemimeral, hepthemimeral
ᾤχετ᾽ ἔχων, Κρεῖον δ᾽εἰς ὄρος ᾠκίσατο·	-u u- -- - uu -uu-	dactylic pentameter	
κρεῖον ὄρος· σὲ δέ, δαῖμον, ἀπορρώγεσσιν ἔθηκεν	-u u- u u -u u---u u--	dactylic hexameter	feminine penthemimeral, trithemimeral
ἐν πέτραις, αἷς νῦν οὔνομα Παλλατίδες·	- -- - - -uu -uu-	dactylic pentameter	
ἔξιθ᾽ Ἀθαναία περσέπτολι, χρυσεοπήληξ,	-u u--- --uu -uu--	dactylic hexameter	masculine penthemimeral
ἵππων καὶ σακέων ἁδομένα πατάγῳ.	-- - uu- -uu- uu-	dactylic pentameter	
σάμερον ὑδροφόροι μὴ βάπτετε—σάμερον Ἄργος	-uu -uu- - -uu-uu --	dactylic hexameter	masculine penthemimeral
πίνετ᾽ ἀπὸ κρανᾶν μηδ᾽ ἀπὸ τῶ ποταμῶ,	-u u- -- - uu - uu-	dactylic pentameter	
σάμερον αἱ δῶλαι τὰς κάλπιδας ἢ᾽ς Φυσάδειαν	-uu - -- - -uu - uu--	dactylic hexameter	masculine penthemimeral, trithemimeral
ἢ ἐς Ἀμυμώναν οἴσετε τὰν Δαναῶ.	- u u--- -uu - uu-	dactylic pentameter	
καὶ γὰρ δὴ χρυδῷ τε καὶ ἄνθεσιν ὕδατα μίξας	- - - -- u u -uu -uu --	dactylic hexameter	masculine penthemimeral, trithemimeral
ἡξεῖ φορβαίων Ἴναχος ἐξ ὀρέων	-- --- -uu - uu-	dactylic pentameter	
τἀθάνᾳ τὸ λοετρὸν ἄγων καλόν. ἀλλά, Πελασγέ,	--- u u-u u- uu -u u--	dactylic hexameter	feminine penthemimeral, hepthemimeral, trithemimeral
φράζεο μὴ οὐκ ἐθέλων τὰν βασίλειαν ἴδῃς.	-uu - uuu - uu-u u-	lyric	
ὅς κεν ἴδῃ γυμνὰν τὰν Παλλάδα τὰν πολιοῦχον,	- u u- -- - -uu - uu--	dactylic hexameter	masculine penthemimeral, trithemimeral
τὦργος ἐσοψεῖται τοῦτο πανυστάτιον.	-u u--- -u u-uu-	dactylic pentameter	
πότνἰ Ἀθαναία τὺ μὲν ἔξιθι· μέσφα δ᾽ἐγώ τι	-u u--- u u -uu -u u- -	dactylic hexameter	masculine penthemimeral
ταῖσδ᾽ ἐρέω. μῦθος δ᾽οὐκ ἐμός, ἀλλ᾽ ἑτέρων.	- uu- -- - uu - uu-	dactylic pentameter	
παῖδες, Ἀθαναία νύμφαν μίαν ἔν ποκα Θήβαις	-u u--- -- uu - uu --	dactylic hexameter	masculine penthemimeral, hepthemimeral
πουλύ τι καὶ περὶ δὴ φίλατο τᾶν ἑταρᾶν,	-u u - uu - -uu - uu-	dactylic pentameter	
ματέρα Τειρεσίαο, καὶ οὔποκα χωρὶς ἔγεντο·	-uu -uu-u u -uu -u u--	dactylic hexameter	feminine penthemimeral
ἀλλὰ καὶ ἀρχαίων εὖτ᾽ ἐπὶ Θεσπιέων	-u u --- - uu -uu-	dactylic pentameter	
ἢ ᾽πὶ Κορωνείας ἢ εἰς Ἁλίαρτον ἐλαύνοι	- uu ---u u - uu-u u--	dactylic hexameter	feminine penthemimeral, hepthemimeral
ἵππως, Βοιωτῶν ἔργα διερχομένα,	-- --- -u u-uu-	dactylic pentameter	
ἢ ᾽πὶ Κορωνείας, ἵνα οἱ τεθυωμένον ἄλσος	- u u--- uu - uu-uu --	dactylic hexameter	masculine penthemimeral, hepthemimeral
καὶ βωμοὶ ποταμῷ κεῖντ᾽ ἐπὶ Κωραλίῳ·	- -- uu- - uu -uu-	dactylic pentameter	
πολλάκις ἁ δαίμων νιν ἑῶ ἐπεβάσατο δίφρω,	-uu - -- u u- uu-uu --	dactylic hexameter	masculine penthemimeral, hepthemimeral, trithemimeral
οὐδ᾽ ὄαροι νυμφᾶν οὐδὲ χοροστασίαι	- uu- -- -u u-uu-	dactylic pentameter	
ἁδεῖαι τελέθεσκον, ὅκ᾽ οὐχ ἁγεῖτο Χαρικλώ·	--- uu-u u - --u u--	dactylic hexameter	feminine penthemimeral, hepthemimeral, trithemimeral
ἀλλ᾽ ἔτι καὶ τήναν δάκρυα πόλλ᾽ ἔμενεν,	- uu - -- -uu - uu-	dactylic pentameter	
καίπερ Ἀθαναίᾳ καταθύμιον ἔσσαν ἑταίραν.	-u u--- uu-uu -u u--	dactylic hexameter	masculine penthemimeral
δή ποκα γὰρ πέπλων λυσαμένα περόνας	- uu - -- -uu- uu-	dactylic pentameter	
ἵππω ἐπὶ κράνᾳ Ἑλικωνίδι καλὰ ῥεοίσᾳ	-u u- -- uu-uu -u u--	dactylic hexameter	masculine penthemimeral, trithemimeral
λῶντο· μεσαμβρινὰ δ᾽εἶχ᾽ ὄρος ἁσυχία.	-u u-uu - -u u-uu	lyric	
ἀμφότεραι λώοντο, μεσαμβριναὶ δ᾽ἔσαν ὧραι,	-uu- --u u--- uu --	dactylic hexameter	feminine penthemimeral, trithemimeral
πολλὰ δ᾽ἁσυχία τῆνο κατεῖχεν ὄρος.	-u u-uu -- uu- uu	lyric	
Τειρεσίας δ᾽ἔτι μῶνος ἁμᾶ κυσὶν ἄρτι γένεια	-uu- uu -u u- uu -u u--	dactylic hexameter	feminine penthemimeral, hepthemimeral, trithemimeral
περκάζων ἱερὸν χῶρον ἀνεστρέφετο·	--- uu- -u u-uu-	dactylic pentameter	
διψάσας δ᾽ἄφατόν τι ποτὶ ῥόον ἤλυθε κράνας,	--- uu- u u- uu --- --	lyric	
σχέτλιος· οὐκ ἐθέλων δ᾽εἶδε τὰ μὴ θεμιτά·	-uu - uu- -u u - uu-	dactylic pentameter	
τὸν δὲ χολωσαμένα περ ὅμως προσέφασεν Ἀθάνα	- u u-uu- u u- uu-u u--	dactylic hexameter	masculine penthemimeral, hepthemimeral
"τίς σε, τὸν ὀφθαλμὼς οὐκέτ᾽ ἀποισόμενον,	- u u --- -u u-uu-	dactylic pentameter	
ὦ Εὐηρείδα, χαλεπὰν ὁδὸν ἄγαγε δαίμων;"	- ---- uu- uu -uu --	dactylic hexameter	masculine penthemimeral, hepthemimeral
ἁ μὲν ἔφα, παιδὸς δ᾽ὄμματα νὺξ ἔλαβεν.	- u u- -- -uu - uu-	dactylic pentameter	
ἑστάκη δ᾽ἄφθογγος, ἐκόλλασαν γὰρ ἀνῖαι	--- --u u--- u u--	dactylic hexameter	feminine penthemimeral, trithemimeral
γώνατα καὶ φωνὰν ἔσχεν ἀμηχανία.	-uu - -- -u u-uu-	dactylic pentameter	
ἁ νύμφα δ᾽ἐβόασε "τί μοι τὸν κῶρον ἔρεξας,	- -- uu-u u - - -u u--	dactylic hexameter	feminine penthemimeral, hepthemimeral, trithemimeral
πότνια; τοιαῦται δαίμονες ἐστὲ φίλαι;	-uu --- -uu -u u-	dactylic pentameter	
ὄμματά μοι τῶ παιδὸς ἀφείλεο. τέκνον ἄλαστε,	-uu - - -u u-uu -u u--	dactylic hexameter	feminine penthemimeral, trithemimeral
εἶδες Ἀθαναίας στήθεα καὶ λαγόνας,	-u u--- -uu - uu-	dactylic pentameter	
ἀλλ᾽ οὐκ ἀέλιον πάλιν ὄψεαι. ὦ ἐμὲ δειλάν,	- - -uu- uu -uu - uu --	dactylic hexameter	masculine penthemimeral
ὦ ὄρος, ὦ Ἑλικὼν οὐκέτι μοι παριτέ,	- uu - uu- -uu - uu-	dactylic pentameter	
ἦ μεγάλ᾽ ἀντ᾽ ὀλίγων ἐπράξαο· δόρκας ὀλέσσας	- uu - uu- --uu -u u--	dactylic hexameter	masculine penthemimeral, trithemimeral
καὶ πρόκας οὐ πολλὰς φάεα παιδὸς ἔχεις."	- uu - -- -uu -u u-	dactylic pentameter	
ἆ καὶ ἅμ᾽ ἀμφοτέραισι φίλον περὶ παῖδα λαβοῖσα	- u u -uu-u u- uu -u u--	dactylic hexameter	feminine penthemimeral, hepthemimeral
μάτηρ μὲν γοερᾶν οἶτον ἀηδονίδων	-- - uu- -u u-uu-	dactylic pentameter	
ἆγε βαρὺ κλαίοισα, θεὰ δ᾽ἐλέησεν ἑταίραν	-u u- --u u- uu-u u--	dactylic hexameter	feminine penthemimeral, hepthemimeral, trithemimeral
καί νιν Ἀθαναία πρὸς τόδ᾽ ἔλεξεν ἔπος	- u u--- - u u-u u-	dactylic pentameter	
"δῖα γύναι, μετὰ πάντα βαλεῦ πάλιν ὅσσα δι᾽ ὀργὰν	-u u- uu -u u- uu -u u --	dactylic hexameter	feminine penthemimeral, hepthemimeral, trithemimeral
εἶπας· ἐγὼ δ᾽οὔ τοι τέκνον ἔθηκ᾽ ἀλαόν.	-u u- - - -u u- uu-	dactylic pentameter	
οὐ γὰρ Ἀθαναίᾳ γλυκερὸν πέλει ὄμματα παίδων	- u u--- uu- uu -uu --	dactylic hexameter	masculine penthemimeral, hepthemimeral
ἁρπάζειν· Κρόνιοι δ᾽ὧδε λέγοντι νόμοι·	--- uu- -u u-u u-	dactylic pentameter	
ὅς κε τιν᾽ ἀθανάτων, ὅκα μὴ θεὸς αὐτὸς ἕληται,	- u u -uu- uu - uu -u u--	dactylic hexameter	masculine penthemimeral, hepthemimeral
ἀθρήσῃ, μισθῶ τοῦτον ἰδεῖν μεγάλω.	--- -- -u u- uu-	dactylic pentameter	
δῖα γύναι, τὸ μὲν οὐ παλινάγρετον αὖθι γένοιτο	-u u- u u - uu-uu -u u--	dactylic hexameter	masculine penthemimeral, trithemimeral
ἔργον· ἐπεὶ μοιρᾶν ὧδ᾽ ἐπένησε λίνα,	-u u- -- - uu-u u-	dactylic pentameter	
ἁνίκα τὸ πρᾶτόν νιν ἐγείναο· νῦν δὲ κομίζευ,	-uu - -- u u-uu - u u--	dactylic hexameter	masculine penthemimeral, trithemimeral
ὦ Εὐηρείδα, τέλθος ὀφειλόμενον.	- ---- -u u-uu-	dactylic pentameter	
πόσσα μὲν ἁ Καδμηὶς ἐς ὕστερον ἔμπυρα καυσεῖ,	-u u - --u u -uu -uu --	dactylic hexameter	feminine penthemimeral, trithemimeral
τόσσα δ᾽Ἀρισταῖος, τὸν μόνον εὐχόμενοι	-u u--- - uu -uu-	dactylic pentameter	
παῖδα, τὸν ἁβατὰν Ἀκταίονα, τυφλὸν ἰδέσθαι.	-u u -uu ---- -u u--	dactylic hexameter	
καὶ τῆνος μεγάλας σύνδρομος Ἀρτέμιδος	- -- uu- -uu -uu-	dactylic pentameter	
ἐσσεῖτ᾽· ἀλλ᾽ οὐκ αὐτὸν ὅ τε δρόμος αἵ τ᾽ἐν ὄρεσσι	-- - - -u u - uu - u u--	dactylic hexameter	feminine penthemimeral, hepthemimeral, trithemimeral
ῥυσεῦνται ξυναὶ τᾶμος ἑκαβολίαι,	--- -- -u u-uu-	dactylic pentameter	
ὁππόκ᾽ ἂν οὐκ ἐθέλων περ ἴδῃ χαρίεντα λοετρὰ	-u u - uu- u u- uu-u u--	dactylic hexameter	masculine penthemimeral, hepthemimeral, trithemimeral
δαίμονος· ἀλλ᾽ αὐταὶ τὸν πρὶν ἄνακτα κύνες	-uu - -- - u u-u u-	dactylic pentameter	
τουτάκι δειπνησεῦντι· τὰ δ᾽υἱέος ὀστέα μάτηρ	-uu ---u u -uu -uu --	dactylic hexameter	feminine penthemimeral
λεξεῖται δρυμὼς πάντας ἐπερχομένα·	--- -- -u u-uu-	dactylic pentameter	
ὀλβίσταν ἐρέει σε καὶ εὐαίωνα γενέσθαι,	--- uu- u u ---u u--	dactylic hexameter	masculine penthemimeral, trithemimeral
ἐξ ὀρέων ἀλαὸν παῖδ᾽ ὑποδεξαμέναν.	- uu- uu- - uu-uu-	dactylic pentameter	
ὦ ἑτάρα, τῶ μή τι μινύρεο· τῷδε γὰρ ἄλλα	- uu- - - u u-uu -u u --	dactylic hexameter	masculine penthemimeral, trithemimeral
τεῦ χάριν ἐξ ἐμέθεν πολλὰ μενεῦντι γέρα.	- uu - uu- -u u-u u-	dactylic pentameter	
μάντιν ἐπεὶ θησῶ νιν ἀοίδιμον ἐσσομένοισιν,	-u u- -- u u-uu -uu--	dactylic hexameter	masculine penthemimeral, trithemimeral
ἦ μέγα τῶν ἄλλων δή τι περισσότερον.	- uu - -- - u u-uu-	dactylic pentameter	
γνωσεῖται δ᾽ὄρνιχας, ὅς αἴσιος οἵ τε πέτονται	--- --u u -uu - u u--	dactylic hexameter	feminine penthemimeral, trithemimeral
ἤλιθα καὶ ποίων οὐκ ἀγαθαὶ πτέρυγες.	-uu - -- - uu- uu-	dactylic pentameter	
πολλὰ δὲ Βοιωτοῖσι θεοπρόπα, πολλὰ δὲ Κάδμῳ	-u u ---u u-uu -u u --	dactylic hexameter	feminine penthemimeral
χρησεῖ, καὶ μεγάλοις ὕστερα Λαβδακίδαις.	-- - uu- -uu -uu-	dactylic pentameter	
δωσῶ καὶ μέγα βάκτρον, ὅ οἱ πόδας ἐς δέον ἀξεῖ,	-- - uu -u u - uu - uu --	dactylic hexameter	feminine penthemimeral, hepthemimeral, trithemimeral
δωσῶ καὶ βιότω τέρμα πολυχρόνιον.	-- - uu- -u u-uu-	dactylic pentameter	
καὶ μόνος, εὖτε θάνῃ, πεπνυμένος ἐν νεκύεσσι	- uu -u u- --uu - uu--	dactylic hexameter	masculine penthemimeral
φοιτασεῖ, μεγάλωι τίμιος Ἁγεσίλᾳ."	--- uu- -uu -uu-	dactylic pentameter	
ὥς φαμένα κατένευσε· τὸ δ᾽ἐντελὲς ᾧ κ᾽ἔπι νεύσῃ	- uu- uu-u u -uu - uu --	dactylic hexameter	feminine penthemimeral, trithemimeral
Παλλάς, ἐπεὶ μώνᾳ Ζεὺς τό γε θυγατέρων	-u u- -- - u u -uu-	dactylic pentameter	
δῶκεν Ἀθαναίᾳ, πατρώια πάντα φέρεσθαι,	-u u--- --uu -u u--	dactylic hexameter	masculine penthemimeral
λωτροχόοι, μάτηρ δ᾽οὔτις ἔτικτε θεάν,	-uu- -- -u u-u u-	dactylic pentameter	
ἀλλὰ Διὸς κορυφά. κορυφὰ Διὸς οὐκ ἐπινεύει	-u u- uu- uu- uu - uu--	dactylic hexameter	masculine penthemimeral, hepthemimeral, trithemimeral
ψεύδεα κοὐδὲ Διὸς ψεύδετ αι ἁ θυγάτηρ.	-uu -u u- -u u - uu-	dactylic pentameter	
ἔρχετ᾽ Ἀθαναία νῦν ἀτρεκές· ἀλλὰ δέχεσθε	-u u--- - -uu -u u--	dactylic hexameter	masculine penthemimeral
τὰν θεόν, ὦ κῶραι τὦργον ὅσαις μέλεται,	- uu - -- -u u- uu-	dactylic pentameter	
σύν τ᾽εὐαγορίᾳ σύν τ᾽εὔγμασι σύν τ᾽ὀλολυγαῖς.	- --uu- - -uu - uu--	dactylic hexameter	masculine penthemimeral
χαῖρε θεά, κάδευ δ᾽Ἄργεος Ἰναχίω.	-u u- -- -uu -uu-	dactylic pentameter	
χαῖρε καὶ ἐξελάοισα, καὶ ἐς πάλιν αὖτις ἐλάσσαις	-u u -uu-u u - uu -u u--	dactylic hexameter	feminine penthemimeral, hepthemimeral
ἵππως, καὶ Δαναῶν κλᾶρον ἅπαντα σάω.	-- - uu- -u u-u u-	dactylic pentameter	
τῶ καλάθω κατιόντος ἐπιφθέγξασθε, γυναῖκες,	- uu- uu-u u---u u--	dactylic hexameter	feminine penthemimeral, trithemimeral
"Δάματερ μέγα χαῖρε πολυτρόφε πουλυμέδιμνε."	--- uu -u u-uu -uu--	dactylic hexameter	feminine penthemimeral, trithemimeral
τὸν κάλαθον κατιόντα χαμαὶ θασεῖσθε βέβαλοι,	- uu- uu-u u- --u u--	dactylic hexameter	feminine penthemimeral, hepthemimeral, trithemimeral
μηδ᾽ ἀπὸ τῶ τέγεος μηδ᾽ ὑψόθεν αὐγάσσησθε	- uu - uu- - -uu ----	dactylic hexameter	masculine penthemimeral, trithemimeral
μὴ παῖς μηδὲ γυνὰ μηδ᾽ ἃ κατεχεύατο χαίταν,	- - -u u- - - uu-uu --	dactylic hexameter	masculine penthemimeral, hepthemimeral
μηδ᾽ ὅκ᾽ ἀφ᾽ αὑαλέων στομάτων πτύωμες ἄπαστοι.	- u u -uu- uu- --u u--	dactylic hexameter	masculine penthemimeral, hepthemimeral
ἕσπερος ἐκ νεφέων ἐσκέψατο πανίκα νεῖται,	-uu - uu- --uu -uu --	dactylic hexameter	masculine penthemimeral, trithemimeral
ἕσπερος, ὅστε πιεῖν Δαμάτερα μῶνος ἔπεισεν,	-uu -u u- uu-- -u u--	dactylic hexameter	masculine penthemimeral
ἁρπαγίμας ὅκ᾽ ἄπυστα μετέστιχεν ἴχνια κώρας.	-uu- u u-u u-uu -uu --	dactylic hexameter	feminine penthemimeral, trithemimeral
πότνια, πῶς σε δύναντο πόδες φέρεν ἔστ᾽ ἐπὶ δυθμάς,	-uu - u u-u u- uu - uu --	dactylic hexameter	feminine penthemimeral, hepthemimeral, trithemimeral
ἔστ᾽ ἐπὶ τὼς μέλανας καὶ ὅπα τὰ χρύσεα μᾶλα;	- uu - uu- u u- - -uu --	dactylic hexameter	masculine penthemimeral, hepthemimeral, trithemimeral
οὐ πίες οὔτ᾽ ἄρ᾽ ἔδες τῆνον χρόνον οὐδὲ λοέσσα.	- uu - u u- -- uu -u u--	dactylic hexameter	masculine penthemimeral, hepthemimeral, trithemimeral
τρὶς μὲν δὴ διέβας Ἀχελώιον ἀργυροδίναν,	- - - uu- uu-uu -uu--	dactylic hexameter	masculine penthemimeral, trithemimeral
τοσσάκι δ᾽ἀενάων ποταμῶν ἐπέρασας ἕκαστον,	-uu -uu- uu- uu-u u--	dactylic hexameter	masculine penthemimeral, hepthemimeral
τρὶς δ᾽ἐπὶ Καλλιχόρῳ χαμάδις ἐκαθίσσαο φρητί	- uu -uu- uu- uu-uu --	dactylic hexameter	masculine penthemimeral, hepthemimeral
αὐσταλέα ἄποτός τε καὶ οὐ φάγες οὐδὲ λοέσσα.	-uu- uu- u u - uu -u u--	dactylic hexameter	masculine penthemimeral, hepthemimeral, trithemimeral
μὴ μὴ ταῦτα λέγωμες ἃ δάκρυον ἄγαγε Δηοῖ·	- - -u u-u u -uu -uu --	dactylic hexameter	feminine penthemimeral
κάλλιον, ὡς πολίεσσιν ἑαδότα τέθμια δῶκε·	-uu - uu-u u-uu -uu --	dactylic hexameter	feminine penthemimeral, trithemimeral
κάλλιον, ὡς καλάμαν τε καὶ ἱερὰ δράγματα πράτα	-uu - uu- u u -uu -uu --	dactylic hexameter	masculine penthemimeral, trithemimeral
ἀσταχύων ἀπέκοψε καὶ ἐν βόας ἧκε πατῆσαι,	-uu- uu-u u - uu -u u--	dactylic hexameter	feminine penthemimeral, hepthemimeral, trithemimeral
ἁνίκα Τριπτόλεμος ἀγαθὰν ἐδιδάσκετο τέχναν·	-uu -uu- uu- uu-uu --	dactylic hexameter	masculine penthemimeral, hepthemimeral
κάλλιον, ὡς, ἵνα καί τις ὑπερβασίας ἀλέηται,	-uu - uu - u u-uu- uu--	dactylic hexameter	masculine penthemimeral, trithemimeral
ἰδέσθαι	u--	lyric	
οὔπω τὰν Κνιδίαν, ἔτι Δώτιον ἱρὸν ἔναιον,	-- - uu- uu -uu -u u--	dactylic hexameter	masculine penthemimeral, trithemimeral
τὶν δ᾽ αὐτᾷ καλὸν ἄλσος ἐποιήσαντο Πελασγοὶ	- -- uu -u u---u u--	dactylic hexameter	feminine penthemimeral, trithemimeral
δένδρεσιν ἀμφιλαές· διά κεν μόλις ἦνθεν ὀιστός·	-uu -uu- uu - uu -u u--	dactylic hexameter	masculine penthemimeral, hepthemimeral
ἐν πίτυς, ἐν μεγάλαι πτελέαι ἔσαν, ἐν δὲ καὶ ὄχναι,	- uu - uu- uu- uu - u u --	dactylic hexameter	masculine penthemimeral, hepthemimeral, trithemimeral
ἐν δὲ καλὰ γλυκύμαλα· τὸ δ᾽ὥστ᾽ ἀλέκτρινον ὕδωρ	- u u- uu-u u - --uu --	dactylic hexameter	feminine penthemimeral, hepthemimeral, trithemimeral
ἐξ ἀμαρᾶν ἀνέθυε. θεὰ δ᾽ἐπεμαίνετο χώρῳ	- uu- uu-u u- uu-uu --	dactylic hexameter	feminine penthemimeral, hepthemimeral, trithemimeral
ὅσσον Ἐλευσῖνι, Τριόπῳ θ᾽ὅσον, ὁκκόσον Ἔννᾳ.	-u u--- uu- uu -uu --	dactylic hexameter	masculine penthemimeral, hepthemimeral
ἀλλ᾽ ὅκα Τριοπίδαισιν ὁ δεξιὸς ἄχθετο δαίμων,	- uu -uu-u u -uu -uu --	dactylic hexameter	feminine penthemimeral
τουτάκις ἁ χείρων Ἐρυσίχθονος ἅψατο βωλά·	-uu - -- uu-uu -uu --	dactylic hexameter	masculine penthemimeral, trithemimeral
σεύατ᾽ ἔχων θεράποντας ἐείκοσι, πάντας ἐν ἀκμᾷ,	-u u- uu-u u-uu -u u --	dactylic hexameter	feminine penthemimeral, trithemimeral
πάντας δ᾽ἀνδρογίγαντας ὅλαν πόλιν ἀρκίος ἆραι,	-- -uu-u u- uu -uu --	dactylic hexameter	feminine penthemimeral, hepthemimeral
ἀμφότερον πελέκεσσι καὶ ἀξίναισιν ὁπλίσσας,	-uu- uu-u u ---u u--	dactylic hexameter	feminine penthemimeral, trithemimeral
ἐς δὲ τὸ Δάματρος ἀναιδέες ἔδραμον ἄλσος.	- u u --- --uu -uu --	dactylic hexameter	masculine penthemimeral
ἦς δέ τις αἴγειρος, μέγα δένδρεον αἰθέρι κῦρον,	- u u --- uu -uu -uu --	dactylic hexameter	masculine penthemimeral
τῷ δ᾽ἔπι ταὶ νύμφαι ποτὶ τὤνδιον ἑψιόωντο,	- uu - -- uu -uu -uu--	dactylic hexameter	masculine penthemimeral, trithemimeral
ἃ πράτα πλαγεῖσα κακὸν μέλος ἴαχεν ἄλλαις.	- -- --u u- uu -uu --	dactylic hexameter	feminine penthemimeral, hepthemimeral, trithemimeral
ᾄσθετο Δαμάτηρ, ὅτι οἱ ξύλον ἱερὸν ἄλγει,	-uu --- uu - uu -uu --	dactylic hexameter	masculine penthemimeral, hepthemimeral
εἶπε δὲ χωσαμένα "τίς μοι καλὰ δένδρεα κόπτει;"	-u u -uu- - - uu -uu --	dactylic hexameter	masculine penthemimeral, hepthemimeral
αὐτίκα Νικίππᾳ, τάν οἱ πόλις ἀράτειραν	-uu --- - - uu ----	dactylic hexameter	masculine penthemimeral, hepthemimeral
δαμοσίαν ἔστασαν, ἐείσατο, γέντο δὲ χειρὶ	-uu- --u u-uu -u u --	dactylic hexameter	feminine penthemimeral, trithemimeral
στέμματα καὶ μάκωνα, κατωμαδίαν δ᾽ἔχε κλᾷδα.	-uu - --u u-uu- uu --	dactylic hexameter	feminine penthemimeral, trithemimeral
φᾶ δὲ παραψύχοισα κακὸν καὶ ἀναιδέα φῶτα	- u u---u u- u u-uu --	dactylic hexameter	feminine penthemimeral, hepthemimeral
"τέκνον, ὅτις τὰ θεοῖσιν ἀνειμένα δένδρεα κόπτεις,	-u u- u u-u u-uu -uu --	dactylic hexameter	feminine penthemimeral, trithemimeral
τέκνον ἐλίνυσον, τέκνον πολύθεστε τοκεῦσι,	-u u--- -- uu-u u--	dactylic hexameter	masculine penthemimeral, hepthemimeral
παύεο καὶ θεράποντας ἀπότρεπε, μή τι χαλεφθῇ	-uu - uu-u u-uu - u u--	dactylic hexameter	feminine penthemimeral, trithemimeral
πότνια Δαμάτηρ, τᾶς ἱερὸν ἐκκεραΐζεις."	-uu --- - -uu -uu--	dactylic hexameter	masculine penthemimeral
τὰν δ᾽ἄρ᾽ ὑποβλέψας χαλεπώτερον ἠὲ κυναγὸν	- u u--- uu-uu -u u--	dactylic hexameter	masculine penthemimeral
ὤρεσιν ἐν Τμαρίοισιν ὑποβλέπει ἄνδρα λέαινα	-uu - uu-u u-uu -u u--	dactylic hexameter	feminine penthemimeral, trithemimeral
ὠμοτόκος, τᾶς φαντὶ πέλειν βλοσυρώτατον ὄμμα,	-uu- - -u u- uu-uu --	dactylic hexameter	feminine penthemimeral, hepthemimeral, trithemimeral
"χάζευ," ἔφα, "μή τοι πέλεκυν μέγαν ἐν χροΐ πάξω.	-u u- - - uu- uu - uu --	dactylic hexameter	masculine penthemimeral, hepthemimeral, trithemimeral
ταῦτα δ᾽ἐμὸν θησεῖ στεγανὸν δόμον, ᾧ ἔνι δαῖτας	-u u- -- uu- uu - uu --	dactylic hexameter	masculine penthemimeral, hepthemimeral, trithemimeral
αἰὲν ἐμοῖς ἑτάροισιν ἄδην θυμαρέας ἀξῶ."	-u u- uu-u u- --uu --	dactylic hexameter	feminine penthemimeral, hepthemimeral, trithemimeral
εἶπεν ὁ παῖς, Νέμεσις δὲ κακὰν ἐγράψατο φωνάν.	-u u - uu- u u- --uu --	dactylic hexameter	masculine penthemimeral, hepthemimeral, trithemimeral
Δαμάτηρ δ᾽ἄφατόν τι κοτέσσατο, γείνατο δ᾽ἁ θεύς·	--- uu- u u-uu -uu - -	dactylic hexameter	masculine penthemimeral, trithemimeral
ἴθματα μὲν χέρσω, κεφαλὰ δέ οἱ ἅψατ᾽ Ὀλύμπω.	-uu - -- uu- u u -u u--	dactylic hexameter	masculine penthemimeral, hepthemimeral, trithemimeral
οἱ μὲν ἄρ᾽ ἡμιθνῆτες, ἐπεὶ τὰν πότνιαν εἶδον,	- u u ---u u- - -uu --	dactylic hexameter	feminine penthemimeral, hepthemimeral
ἐξαπίνας ἀπόρουσαν ἐνὶ δρυσὶ χαλκὸν ἀφέντες·	-uu- uu-u u- uu -u u--	dactylic hexameter	feminine penthemimeral, hepthemimeral, trithemimeral
ἁ δ᾽ἄλλως μὲν ἔασεν, ἀναγκαίᾳ γὰρ ἕποντο	- -- u u-u u--- u u--	dactylic hexameter	feminine penthemimeral, trithemimeral
δεσποτικὰν ὑπὸ χεῖρα, βαρὺν δ᾽ἀπαμείψατ᾽ ἄνακτα	-uu- uu -u u- uu-u u--	dactylic hexameter	feminine penthemimeral, hepthemimeral, trithemimeral
"ναὶ ναί, τεύχεο δῶμα, κύον, κύον, ᾧ ἔνι δαῖτας	- - -uu -u u- uu - uu --	dactylic hexameter	feminine penthemimeral, hepthemimeral
ποιησεῖς· θαμιναὶ γάρ ἐς ὕστερον εἰλαπίναι τοι."	--- uu- u u -uu -uu- -	dactylic hexameter	masculine penthemimeral, trithemimeral
ἁ μὲν τόσσ᾽ εἰποῖσ᾽ Ἐρυσίχθονι τεῦχε πονηρά.	- - - -- uu-uu -u u--	dactylic hexameter	masculine penthemimeral, trithemimeral
αὐτίκα οἱ χαλεπόν τε καὶ ἄγριον ἔμβαλε λιμὸν	-uu - uu- u u -uu -uu --	dactylic hexameter	masculine penthemimeral, trithemimeral
αἴθωνα κρατερόν, μεγάλᾳ δ᾽ἐστρεύγετο νούσῳ.	--- uu- uu- --uu --	dactylic hexameter	masculine penthemimeral, hepthemimeral, trithemimeral
σχέτλιος, ὅσσα πάσαιτο τόσων ἔχεν ἵμερος αὖτις.	-uu -u u-u u- uu -uu --	dactylic hexameter	feminine penthemimeral, hepthemimeral
εἴκατι δαῖτα πένοντο, δυώδεκα δ᾽οἶνον ἄφυσσον·	-uu -u u-u u-uu -u u--	dactylic hexameter	feminine penthemimeral
τόσσα Διώνυσον γὰρ ἃ καὶ Δάματρα χαλέπτελ·	-u u--- u u - --u u--	dactylic hexameter	masculine penthemimeral, hepthemimeral
καὶ γὰρ τᾷ Δάματρι συνωργίσθη Διόνυσος.	- - - --u u--- uu--	dactylic hexameter	feminine penthemimeral, trithemimeral
οὔτε νιν εἰς ἐράνως οὔτε ξυνδείπνια πέμπον	-u u - uu- -- --uu --	dactylic hexameter	masculine penthemimeral, hepthemimeral, trithemimeral
αἰδόμενοι γονέες, προχανὰ δ᾽εὑρίσκετο πᾶσα.	-uu- uu- uu- --uu --	dactylic hexameter	masculine penthemimeral, hepthemimeral, trithemimeral
ἦνθον Ἰτωνιάδος νιν Ἀθαναίας ἐπ᾽ ἄεθλα	-u u-uu- u u--- u u--	dactylic hexameter	masculine penthemimeral
Ὀρμενίδαι καλέοντες· ἀπ᾽ ὦν ἀρνήσατο μάτηρ	-uu- uu-u u - --uu --	dactylic hexameter	feminine penthemimeral, hepthemimeral, trithemimeral
"οὐκ ἔνδοι, χθιζὸς γὰρ ἐπὶ Κραννῶνα βέβακε	- -- -- u u- --u u--	dactylic hexameter	masculine penthemimeral, hepthemimeral, trithemimeral
τέλθος ἀπαιτησῶν ἑκατὸν βόας." ἦνθε Πολυξώ,	-u u--- uu- uu -u u--	dactylic hexameter	masculine penthemimeral, hepthemimeral
μάτηρ Ἀκτορίωνος, ἐπεὶ γάμον ἄρτυε παιδί,	-- -uu-u u- uu -uu --	dactylic hexameter	feminine penthemimeral, hepthemimeral
ἀμφότερον Τριόπαν τε καὶ υἱέα κικλήσκοισα.	-uu- uu- u u -uu ----	dactylic hexameter	masculine penthemimeral, trithemimeral
τὰν δὲ γυνὰ βαρύθυμος ἀμείβετο δάκρυ χέοισα	- u u- uu-u u-uu -u u--	dactylic hexameter	feminine penthemimeral, trithemimeral
"νεῖταί τοι Τριόπας, Ἐρυσίχθονα δ᾽ἤλασε κάπρος	-- - uu- uu-uu -uu --	dactylic hexameter	masculine penthemimeral, trithemimeral
Πίνδον ἀν᾽ εὐάγκειαν, ὁ δ᾽ἐννέα φάεα κεῖται."	-u u ---u u -uu -uu --	dactylic hexameter	feminine penthemimeral
δειλαία φιλότεκνε, τί δ᾽οὐκ ἐψεύσαο, μᾶτερ;	--- uu-u u - --uu --	dactylic hexameter	feminine penthemimeral, hepthemimeral, trithemimeral
δαίνυεν εἰλαπίναν τις· "ἐν ἀλλοτρίοις Ἐρυσίχθων."	-uu -uu- u u -uu- uu--	dactylic hexameter	masculine penthemimeral
ἄγετό τις νύμφαν· "Ἐρυσίχθονα δίσκος ἔτυψεν,"	-uu - -- uu-uu -u u--	dactylic hexameter	masculine penthemimeral, trithemimeral
ἢ "ἔπεσ᾽ ἐξ ἵππων," ἢ "ἐν Ὄθρυϊποίμνι᾽ ἀμιθρεῖ."	- uu - -- u u -uu-u u--	dactylic hexameter	masculine penthemimeral, trithemimeral
ἐνδόμυχος δἤπειτα πανάμερος εἰλαπιναστὰς	-uu- --u u-uu -uu--	dactylic hexameter	feminine penthemimeral, trithemimeral
ἤσθιε μυρία πάντα· κακὰ δ᾽ἐξάλλετο γαστὴρ	-uu -uu -u u- --uu --	dactylic hexameter	feminine penthemimeral, hepthemimeral
αἰεὶ μᾶλλον ἔδοντι, τὰ δ᾽ἐς βυθὸν οἷα θαλάσσας	-- -u u-u u - uu -u u--	dactylic hexameter	feminine penthemimeral, hepthemimeral
ἀλεμάτως ἀχάριστα κατέρρεεν εἴδατα πάντα.	-uu- uu-u u-uu -uu --	dactylic hexameter	feminine penthemimeral, trithemimeral
ὡς δὲ Μίμαντι χιών, ὡς ἀελίῳ ἔνι πλαγγών,	- u u-u u- - -uu- uu --	dactylic hexameter	masculine penthemimeral
καὶ τούτων ἔτι μεῖζον ἐτάκετο μέσφ᾽ ἐπὶ νευράς·	- -- uu -u u-uu - uu --	dactylic hexameter	feminine penthemimeral, trithemimeral
δειλαίῳ ἶνές τε καὶ ὀστέα μῶνον ἔλειφθεν.	--- -- u u -uu -u u--	dactylic hexameter	masculine penthemimeral, trithemimeral
κλαῖε μὲν ἁ μάτηρ, βαρὺ δ᾽ἔστενον αἱ δ̣̣̔̓ ἀδελφαὶ	-u u - -- uu -uu - u u--	dactylic hexameter	masculine penthemimeral, trithemimeral
χὡ μαστὸς τὸν ἔπωνε καὶ αἱ δέκα πολλάκι δῶλαι.	- -- u u-u u - uu -uu --	dactylic hexameter	feminine penthemimeral, hepthemimeral, trithemimeral
καὶ δ᾽αὐτὸς Τριόπας πολιαῖς ἐπὶ χεῖρας ἔβαλλε,	- -- uu- uu- uu -u u--	dactylic hexameter	masculine penthemimeral, hepthemimeral, trithemimeral
τοῖα τὸν οὐκ ἀίοντα Ποσειδάωνα καλιστρέων·	-u u - uu-u u---u u--	dactylic hexameter	feminine penthemimeral, trithemimeral
"ψευδοπάτωρ ἰδὲ τόνδε τεοῦ τρίτον, εἴπερ ἐγὼ μὲν	-uu- uu -u u- uu -u u- -	dactylic hexameter	feminine penthemimeral, hepthemimeral, trithemimeral
σεῦ τε καὶ Αἰολίδος Κανάκας γένος, αὐτὰρ ἐμεῖο	- u u -uu- uu- uu -u u--	dactylic hexameter	masculine penthemimeral, hepthemimeral
τοῦτο τὸ δείλαιον γένετο βρέφος· αἴθε γὰρ αὐτὸν	-u u --- uu- uu -u u --	dactylic hexameter	masculine penthemimeral, hepthemimeral
βλητὸν ὑπ᾽ Ἀπόλλωνος ἐμαὶ χέρες ἐκτερέιξαν·	-u u ---u u- uu -uu--	dactylic hexameter	feminine penthemimeral, hepthemimeral
νῦν δὲ κακὰ βούβρωστις ἐν ὀφθαλμοῖσι κάθηται.	- u u- --u u ---u u--	dactylic hexameter	feminine penthemimeral, trithemimeral
ἤ οἱ ἀπόστασον χαλεπὰν νόσον ἠέ νιν αὐτὸς	- u u--- uu- uu -u u --	dactylic hexameter	masculine penthemimeral, hepthemimeral
βόσκε λαβών· ἁμαὶ γὰρ ἀπειρήκαντι τράπεζαι.	-u u- -- u u---u u--	dactylic hexameter	masculine penthemimeral, trithemimeral
χῆραι μὲν μάνδραι, κενεαὶ δέ μοι αὔλιες ἤδη	-- - -- uu- u u -uu --	dactylic hexameter	masculine penthemimeral, hepthemimeral, trithemimeral
τετραπόδων, ἤδη γὰρ ἀπαρνήσαντο μάγειροι."	-uu- -- u u---u u--	dactylic hexameter	masculine penthemimeral, trithemimeral
ἀλλὰ καὶ οὐρῆας μεγαλᾶν ὑπέλυσαν ἁμαξᾶν,	-u u --- uu- uu-u u--	dactylic hexameter	masculine penthemimeral, hepthemimeral
καὶ τὰν βῶν ἔφαγεν, τὰν Ἑστίᾳ ἔτρεφε μάτηρ,	- - - uu- - -uu -uu --	dactylic hexameter	masculine penthemimeral, trithemimeral
καὶ τὰν ἀεθλοφόρον καὶ τὸν πολεμήιον ἵππον,	- u u-uu- - - uu-uu --	dactylic hexameter	masculine penthemimeral, hepthemimeral
καὶ τὰν αἴλουρον, τὰν ἔτρεμε θηρία μικκά.	- - --- - -uu -uu --	dactylic hexameter	masculine penthemimeral
μέσφ᾽ ὅκα μὲν Τριόπαο δόμοις ἔνι χρήματα κεῖτο,	- uu - uu-u u- uu -uu --	dactylic hexameter	feminine penthemimeral, hepthemimeral, trithemimeral
μῶνοι ἄρ᾽ οἰκεῖοι θάλαμοι κακὸν ἠπίσταντο.	-u u --- uu- uu ----	dactylic hexameter	masculine penthemimeral, hepthemimeral
ἀλλ᾽ ὅκα τὸν βαθὺν οἶκον ἀνεξήραναν ὀδόντες,	- uu - uu -u u---u u--	dactylic hexameter	feminine penthemimeral, trithemimeral
καὶ τόχ᾽ ὁ τῶ βασιλῆος ἐνὶ τριόδοισι καθῆστο	- u u - uu-u u- uu-u u--	dactylic hexameter	feminine penthemimeral, hepthemimeral, trithemimeral
αἰτίζων ἀκόλως τε καὶ ἔκβολα λύματα δαιτός.	--- uu- u u -uu -uu --	dactylic hexameter	masculine penthemimeral, trithemimeral
Δάματερ, μὴ τῆνος ἐμὶν φίλος, ὅς τοι ἀπεχθής,	--- - -u u- uu - u u--	dactylic hexameter	feminine penthemimeral, hepthemimeral, trithemimeral
εἴη μηδ᾽ ὁμότοιχος· ἐμοὶ κακογείτονες ἐχθροί.	-- - uu-u u- uu-uu --	dactylic hexameter	feminine penthemimeral, hepthemimeral, trithemimeral
ᾄσατε παρθενικαί, καὶ ἐπιφθέγξασθε τεκοῖσαι	-uu -uu- u u---u u--	dactylic hexameter	masculine penthemimeral
"Δάματερ μέγα χαῖρε πολυτρόφε πουλυμέδιμνε."	--- uu -u u-uu -uu--	dactylic hexameter	feminine penthemimeral, trithemimeral
χὠς αἱ τὸν κάλαθον λευκότριχες ἵπποι ἄγοντι	- - - uu- --uu -u u--	dactylic hexameter	masculine penthemimeral, trithemimeral
τέσσαρες, ὣς ἁμὶν μεγάλα θεὸς εὐρυάνασσα	-uu - -- uu- uu -uu--	dactylic hexameter	masculine penthemimeral, hepthemimeral, trithemimeral
λευκὸν ἔαρ, λευκὸν δὲ θέρος καὶ χεῖμα φέροισα	-u u- -- u u- - -u u--	dactylic hexameter	masculine penthemimeral, hepthemimeral, trithemimeral
ἡξεῖ καὶ φθινόπωρον, ἔτος δ᾽εἰς ἄλλο φυλαξεῖ.	-- - uu-u u- - -u u--	dactylic hexameter	feminine penthemimeral, hepthemimeral, trithemimeral
ὡς δ᾽ἀπεδίλωτοι καὶ ἀνάμπυκες ἄστυ πατεῦμες,	- uu--- u u-uu -u u--	dactylic hexameter	masculine penthemimeral
ὣς πόδας, ὣς κεφαλὰς παναπηρέας ἕξομες αἰεί.	- uu - uu- uu-uu -uu --	dactylic hexameter	masculine penthemimeral, trithemimeral
ὡς δ᾽αἱ λικνοφόροι χρυσῶ πλέα λίκνα φέροντι,	- - -uu- -- uu -u u--	dactylic hexameter	masculine penthemimeral, hepthemimeral
ὣς ἁμὲς τὸν χρυσὸν ἀφειδέα πασαίμεσθα.	- -- - -u u-uu ----	dactylic hexameter	feminine penthemimeral, trithemimeral
μέσφα τὰ τᾶς πόλιος πρυτανήια τὰς ἀτελέστως,	-u u - uu- uu-uu - uu--	dactylic hexameter	masculine penthemimeral, trithemimeral
τὰς δὲ τελεσφορέας ποτὶ τὰν θεὸν ἄχρις ὁμαρτεῖν,	- u u-uu- uu - uu -u u--	dactylic hexameter	masculine penthemimeral, hepthemimeral
αἵτινες ἑξήκοντα κατώτεραι· αἱ δὲ βαρεῖαι	-uu ---u u-uu - u u--	dactylic hexameter	feminine penthemimeral
χἄτις Ἐλειθυίᾳ τείνει χέρα χἄτις ἐν ἄλγει.	-u u--- -- uu -u u --	dactylic hexameter	masculine penthemimeral, hepthemimeral
ὣς ἅλις, ὡς αὐτᾶν ἱκανὸν γόνυ· ταῖσι δὲ Δηὼ	- uu - -- uu- uu -u u --	dactylic hexameter	masculine penthemimeral, hepthemimeral, trithemimeral
δωσεῖ πάντ᾽ ἐπίμεστα καὶ ὡς ποτὶ ναὸν ἵκωνται.	-- - uu-u u - uu -u u--	dactylic hexameter	feminine penthemimeral, hepthemimeral, trithemimeral
χαῖρε θεὰ καὶ τάνδε σάω πόλιν ἔν θ᾽ὁμονοίᾳ	-u u- - -u u- uu - uu--	dactylic hexameter	feminine penthemimeral, hepthemimeral, trithemimeral
ἔν τ᾽εὐηπελίᾳ, φέρε δ᾽ἀγρόθι νόστιμα πάντα·	- --uu- uu -uu -uu --	dactylic hexameter	masculine penthemimeral
φέρβε βόας, φέρε μᾶλα, φέρε στάχυν, οἶσε θερισμόν,	-u u- uu -u u- uu -u u--	dactylic hexameter	feminine penthemimeral, hepthemimeral, trithemimeral
φέρβε καὶ εἰράναν, ἵν᾽ ὃς ἄροσε τῆνος ἀμάσῃ.	-u u -uu - u u-- -u u--	dactylic hexameter	masculine penthemimeral
ἵλαθί μοι τρίλλιστε μέγα κρείοισα θεάων.	-uu - --u u- --u u--	dactylic hexameter	feminine penthemimeral, hepthemimeral, trithemimeral
