νύμφαι Τρωιάδες, ποταμοῦ Ξάνθοιο γενέθλη,	-- -uu- uu- --u u--	dactylic hexameter	masculine penthemimeral, hepthemimeral
αἳ πλοκάμων κρήδεμνα καὶ ἱερὰ παίγνια χειρῶν	- uu- --u u -uu -uu --	dactylic hexameter	feminine penthemimeral, trithemimeral
πολλάκι πατρῴῃσιν ἐπὶ ψαμάθοισι λιποῦσαι	-uu ---u u- uu-u u--	dactylic hexameter	feminine penthemimeral, hepthemimeral
ἐς χορὸν Ἰδαίῃσιν ἐπεντύνασθε χορείαις,	- uu ---u u---u u--	dactylic hexameter	feminine penthemimeral
δεῦτε, θεμιστοπόλοιο νοήματα μηλοβοτῆρος	-u u-uu-u u-uu -uu--	dactylic hexameter	feminine penthemimeral
εἴπατέ μοι, κελάδοντος ἀπορνύμεναι ποταμοῖο,	-uu - uu-u u-uu- uu--	dactylic hexameter	feminine penthemimeral, trithemimeral
ἐξ ὀρέων πόθεν ἦλθεν ἀήθεα πόντον ἐλαύνων	- uu- uu -u u-uu -u u--	dactylic hexameter	feminine penthemimeral, trithemimeral
ἀγνώσσων ἁλὸς ἔργα; τί δὲ χρέος ἔπλετο νηῶν	--- uu -u u - uu -uu --	dactylic hexameter	feminine penthemimeral, hepthemimeral, trithemimeral
ἀρχεκάκων, ἵνα πόντον ὁμοῦ καὶ γαῖαν ὀρίνῃ	-uu- uu -u u- - -u u--	dactylic hexameter	feminine penthemimeral, hepthemimeral, trithemimeral
βουκόλος; ὠγυγίη δὲ τίς ἔπλετο νείκεος ἀρχή,	-uu -uu- u u -uu -uu --	dactylic hexameter	masculine penthemimeral
ὄφρα καὶ ἀθανάτοισι θεμιστεύσωσι νομῆες;	-u u -uu-u u---u u--	dactylic hexameter	feminine penthemimeral
τίς δὲ δικασπολίη; πόθεν ἔκλυεν οὔνομα νύμφης	- u u-uu- uu -uu -uu --	dactylic hexameter	masculine penthemimeral
Ἀργείης; αὐταὶ γὰρ ἐθηήσασθε μολοῦσαι	--- -- u u---u u--	dactylic hexameter	masculine penthemimeral, trithemimeral
Ἰδαίης τρικάρηνον ὑπὸ πρηῶνα Φαλάκρης	--- uu-u u- --u u--	dactylic hexameter	feminine penthemimeral, hepthemimeral, trithemimeral
καὶ Πάριν οἰοπόλοισιν ἐφεδριόωντα θοώκοις	- uu -uu-u u-uu-u u--	dactylic hexameter	feminine penthemimeral
καὶ Χαρίτων βασίλειαν ἀγαλλομένην Ἀφροδίτην.	- uu- uu-u u-uu- uu--	dactylic hexameter	feminine penthemimeral, trithemimeral
ὣς ὁ μὲν ὑψιλόφοισιν ἐν οὔρεσιν Αἱμονιήων	- u u -uu-u u -uu -uu--	dactylic hexameter	feminine penthemimeral
νυμφιδίων Πηλῆος ἀειδομένων ὑμεναίων	-uu- --u u-uu- uu--	dactylic hexameter	feminine penthemimeral, trithemimeral
Ζηνὸς ἐφημοσύνῃσιν ἐῳνοχόει Γανυμήδης·	-u u-uu-u u-uu- uu--	dactylic hexameter	feminine penthemimeral
πᾶσα δὲ κυδαίνουσα θεῶν ἔσπευδε γενέθλη	-u u ---u u- --u u--	dactylic hexameter	feminine penthemimeral, hepthemimeral
αὐτοκασιγνήτην λευκώλενον Ἀμφιτρίτης,	-uu--- --uu -u--	lyric	
Ζεὺς μὲν ἀπ᾽ Οὐλύμποιο, Ποσειδάων δὲ θαλάσσης·	- u u ---u u--- u u--	dactylic hexameter	feminine penthemimeral
ἐκ δὲ Μελισσήεντος ἀπ᾽ εὐόδμου Ἑλικῶνος	- u u---u u -u u---	lyric	
Μουσάων λιγύφωνον ἄγων χορὸν ἦλθεν Ἀπόλλων·	--- uu-u u- uu -u u--	dactylic hexameter	feminine penthemimeral, hepthemimeral, trithemimeral
χρυσείοις δ᾽ἑκάτερθε τινασσόμενος πλοκάμοισι	--- uu-u u-uu- uu--	dactylic hexameter	feminine penthemimeral, trithemimeral
βότρυς ἀκερσεκόμης ζεφύρῳ στυφελίζετο χαίτης.	-u u-uu- uu- uu-uu --	dactylic hexameter	masculine penthemimeral, hepthemimeral
τὸν δὲ μεθ᾽ ὡμάρτησε κασιγνήτη Διὸς Ἥρη.	- u u ---u u--- uu --	dactylic hexameter	feminine penthemimeral
οὐδ᾽ αὐτὴ βασίλεια καὶ ἁρμονίης Ἀφροδίτη	- -- uu-u u -uu- uu--	dactylic hexameter	feminine penthemimeral, trithemimeral
ἐρχομένη δήθυνεν ἐς ἄλσεα Κενταύροιο.	-uu- --u u -uu ----	dactylic hexameter	feminine penthemimeral, trithemimeral
καὶ στέφος ἀσκήσασα γαμήλιον ἤλυθε Πειθώ,	- uu ---u u-uu -uu --	dactylic hexameter	feminine penthemimeral
τοξευτῆρος Ἔρωτος ἐλαφρίζουσα φαρέτρην.	---u u-u u---u u--	dactylic hexameter	feminine penthemimeral
καὶ βριαρὴν τρυφάλειαν ἀπὸ κροτάφοιο μεθεῖσα	- uu- uu-u u- uu-u u--	dactylic hexameter	feminine penthemimeral, hepthemimeral, trithemimeral
ἐς γάμον ὡμάρτησε γάμων ἀδίδακτος Ἀθήνη.	- uu ---u u- uu-u u--	dactylic hexameter	feminine penthemimeral, hepthemimeral
οὐδὲ κασιγνήτη Λητωιὰς Ἀπόλλωνος	-u u--- --uu ----	dactylic hexameter	masculine penthemimeral
Ἄρτεμις ἠτίμησε καὶ ἀγροτέρη περ ἐοῦσα.	-uu ---u u -uu- u u--	dactylic hexameter	feminine penthemimeral
οἷος δ᾽οὐ κυνέην, οὐ δήιον ἔγχος ἀείρων	-- - uu- - -uu -u u--	dactylic hexameter	masculine penthemimeral, trithemimeral
ἐς δόμον Ἡφαίστοιο σιδήρεος ἔρχεται Ἄρης,	- uu ---u u-uu -uu --	dactylic hexameter	feminine penthemimeral
τοῖος ἄτερ θώρηκος, ἄτερ θηκτοῖο σιδήρου	-u u- --u u- --u u--	dactylic hexameter	feminine penthemimeral, hepthemimeral, trithemimeral
μειδιόων ἐχόρευεν. ἔριν δ᾽ἀγέραστον ἐάσας	-uu- uu-u u- uu-u u--	dactylic hexameter	feminine penthemimeral, hepthemimeral, trithemimeral
οὐ Χείρων ἀλέγιζε καὶ οὐκ ἐμπάζετο Πηλεύς.	- -- uu-u u - --uu --	dactylic hexameter	feminine penthemimeral, hepthemimeral, trithemimeral
ἡ δ᾽ἅτε βησσήεντος ἀποπλαγχθεῖσα νομοῖο	- uu ---u u--- ---	dactylic hexameter	feminine penthemimeral
πόρτις ἐρημαίῃσιν ἐνὶ ξυλόχοισιν ἀλᾶται	-u u---u u- uu-u u--	dactylic hexameter	feminine penthemimeral, hepthemimeral
φοινήεντι μύωπι, βοῶν ἐλατῆρι, τυπεῖσα·	---u u-u u- uu-u u--	dactylic hexameter	feminine penthemimeral, hepthemimeral
τοῖα βαρυζήλοισιν Ἔρις πληγῇσι δαμεῖσα	-u u---u u- --u u--	dactylic hexameter	feminine penthemimeral, hepthemimeral
πλάζετο μαστεύουσα, θεῶν πῶς δαῖτας ὀρίνοι.	-uu ---u u- - -u u--	dactylic hexameter	feminine penthemimeral, hepthemimeral
πολλάκι δ᾽εὐλάιγγος ἀπὸ κλισμοῖο θοροῦσα	-uu ---u u- --u u--	dactylic hexameter	feminine penthemimeral, hepthemimeral
ἵστατο καὶ παλίνορσος ἐφέζετο· χειρὶ δὲ γαίης	-uu - uu-u u-uu -u u --	dactylic hexameter	feminine penthemimeral, trithemimeral
οὔδεϊ κόλπον ἄραξε καὶ οὐκ ἐφράσσατο πέρην·	-uu -u u-u u - --uu --	dactylic hexameter	feminine penthemimeral, hepthemimeral
ἤθελεν ὀρφναίων γυάλων κληῖδας ἀνεῖσα,	-uu --- uu- --u u--	dactylic hexameter	masculine penthemimeral, hepthemimeral
ἐκ χθονίων Τιτῆνας ἀναστήσασα βερέθρων	- uu- --u u---u u--	dactylic hexameter	feminine penthemimeral, trithemimeral
οὐρανὸν ὑψιμέδοντος ἀιστῶσαι Διὸς ἕδρην.	-uu -uu-- --- uu --	dactylic hexameter	
ἤθελεν ἠχήεντα πυρὸς πρηστῆρα τινάσσειν,	-uu ---u u- --u u--	dactylic hexameter	feminine penthemimeral, hepthemimeral
Ἡφαίστῳ δ᾽ὑπόεικεν ἀμαιμακέτη περ ἐοῦσα,	--- uu-u u-uu- u u--	dactylic hexameter	feminine penthemimeral, trithemimeral
καὶ πυρὸς ἀσβέστοιο καὶ ὀπτευτῆρι σιδήρου.	- uu ---u u ---u u--	dactylic hexameter	feminine penthemimeral
καὶ σακέων βαρύδουπον ἐμήσατο κόμπον ἀράσσειν,	- uu- uu-u u-uu -u u--	dactylic hexameter	feminine penthemimeral, trithemimeral
εἴ ποτε δειμαίνοντες ἀναθρῴσκοιεν ἰωήν·	- uu ---u u---u u--	dactylic hexameter	feminine penthemimeral
ἀλλά καὶ ὁπλοτέρης δολίης ἀνεχάσσατο βουλῆς	-u u -uu- uu- uu-uu --	dactylic hexameter	masculine penthemimeral, hepthemimeral
Ἄρεα δειμαίνουσα, σιδήρεον ἀσπιδιώτην.	-uu ---u u-uu -uu--	dactylic hexameter	feminine penthemimeral
ἤδη δ᾽Ἑσπερίδων χρυσέων ἐμνήσατο μήλων·	-- -uu- uu- --uu --	dactylic hexameter	masculine penthemimeral, hepthemimeral
ἔνθεν Ἔρις, πολέμοιο προάγγελον ἔρνος ἑλοῦσα	-u u- uu-u u-uu -u u--	dactylic hexameter	feminine penthemimeral, trithemimeral
μῆλον, ἀριζήλων ἐφράσσατο δήνεα μόχθων.	-u u--- --uu -u- -	lyric	
χειρὶ δὲ δινήσασα μόθου πρωτόσπορον ἀρχὴν	-u u ---u u- --uu --	dactylic hexameter	feminine penthemimeral, hepthemimeral
ἐς θαλίην ἔρριψε, χορὸν δ᾽ὤρινε θεάων.	- uu- --u u- --u u--	dactylic hexameter	feminine penthemimeral, hepthemimeral, trithemimeral
Ἥρη μὲν παράκοιτις ἀγαλλομένη Διὸς εὐνῇ	-- - uu-u u-uu- uu --	dactylic hexameter	feminine penthemimeral, trithemimeral
ἵστατο θαμβήσασα καὶ ἤθελε ληίζεσθαι·	-uu ---u u -uu ----	dactylic hexameter	feminine penthemimeral
πασάων δ᾽ἅτε Κύπρις ἀρειοτέρη γεγαυῖα	--- uu -u u-uu- uu--	dactylic hexameter	feminine penthemimeral, trithemimeral
μῆλον ἔχειν ἐπόθησεν, ὅτι κτέρας ἐστὶν Ἐρώτων·	-u u- uu-u u- uu -u u--	dactylic hexameter	feminine penthemimeral, hepthemimeral, trithemimeral
Ἥρη δ᾽οὐ μεθέηκε καὶ οὐχ ὑπόεικεν Ἀθήνη.	-- - uu-u u - uu-u u--	dactylic hexameter	feminine penthemimeral, hepthemimeral, trithemimeral
Ζεὺς δὲ θεῶν καὶ νεῖκος ἰδὼν καὶ παῖδα καλέσσας	- u u- - -u u- - -u u--	dactylic hexameter	feminine penthemimeral, hepthemimeral, trithemimeral
τοῖον ὑφεδρήσσοντα προσέννεπεν Ἑρμάωνα·	-u u---u u-uu ----	dactylic hexameter	feminine penthemimeral
εἴ τινά που Ξάνθοιο παρ᾽ Ἰδαίοιο ῥεέθροις	- uu - --u u ---u u--	dactylic hexameter	feminine penthemimeral, trithemimeral
παῖδα Πάριν Πριάμοιο, τὸν ἀγλαὸν ἡβητῆρα,	-u u- uu-u u -uu ----	dactylic hexameter	feminine penthemimeral, trithemimeral
Τροίης βουκολέοντα κατ᾽ οὔρεα, τέκνον, ἀκούεις,	-- -uu-u u -uu -u u--	dactylic hexameter	feminine penthemimeral
κείνῳ μῆλον ὄπαζε· διακρίνειν δὲ θεάων	-- -u u-u u--- u u--	dactylic hexameter	feminine penthemimeral
κέκλεο καὶ βλεφάρων ξυνοχὴν καὶ κύκλα προσώπων.	-uu - uu- uu- - -u u--	dactylic hexameter	masculine penthemimeral, hepthemimeral, trithemimeral
ἡ δὲ διακρινθεῖσα φέρειν περίπυστον ὀπώρην	- u u---u u- uu-u u--	dactylic hexameter	feminine penthemimeral, hepthemimeral
κάρτος ἀρειοτέρης ἐχέτω καὶ κόσμον Ἐρώτων.	-u u-uu- uu- - -u u--	dactylic hexameter	masculine penthemimeral, hepthemimeral
ὣς ὁ μὲν Ἑρμάωνι πατὴρ ἐπέτελλε Κρονίων·	- u u ---u u- uu-u u--	dactylic hexameter	feminine penthemimeral, hepthemimeral
αὐτὰρ ὁ πατρῴῃσιν ἐφημοσύνῃσι πιθήσας	-u u ---u u-uu-u u--	dactylic hexameter	feminine penthemimeral
εἰς ὁδὸν ἡγεμόνευε καὶ οὐκ ἀμέλησε θεάων.	- uu -uu-u u - uu-u u--	dactylic hexameter	feminine penthemimeral, hepthemimeral
πᾶσα δὲ λωιτέρην καὶ ἀμείνονα δίζετο μορφήν.	-u u -uu- u u-uu -uu --	dactylic hexameter	masculine penthemimeral
Κύπρις μὲν δολόμητις ἀναπτύξασα καλύπτρην	-- - uu-u u---u u--	dactylic hexameter	feminine penthemimeral, trithemimeral
λαὶ περόνην θυόεντα διαστήσασα κομάων	- uu- uu-u u---u u--	dactylic hexameter	feminine penthemimeral, trithemimeral
χρυσῷ μὲν πλοκάμους, χρυσῷ δ᾽ἐστέψατο χαίτην.	-- - uu- -- --uu --	dactylic hexameter	masculine penthemimeral, hepthemimeral, trithemimeral
τοῖα δὲ παῖδας Ἔρωτας ἀνηΰτησεν ἰδοῦσα·	-u u -u u-u u---u u--	dactylic hexameter	feminine penthemimeral
ἐγγὺς ἀγών, φίλα τέκνα· περιπτύξασθε τιθήνην.	-u u- uu -u u---u u--	dactylic hexameter	feminine penthemimeral, trithemimeral
σήμερον ἀγλαΐαι με διακρίνουσι προσώπων·	-uu -uu- u u---u u--	dactylic hexameter	masculine penthemimeral
δειμαίνω, τίνι μῆλον ὁ βουκόλος οὗτος ὀπάσσει.	--- uu -u u -uu -u u--	dactylic hexameter	feminine penthemimeral, trithemimeral
Ἥρην μὲν Χαρίτων ἱερὴν ἐνέπουσι τιθήνην,	-- - uu- uu- uu-u u--	dactylic hexameter	masculine penthemimeral, hepthemimeral, trithemimeral
φασὶ δὲ κοιρανίην μεθέπειν καὶ σκῆπτρα φυλάσσειν·	-u u -uu- uu- - -u u--	dactylic hexameter	masculine penthemimeral, hepthemimeral
καὶ πολέμων βασίλειαν ἀεὶ καλέουσιν Ἀθήνην·	- uu- uu-u u- uu-u u--	dactylic hexameter	feminine penthemimeral, hepthemimeral, trithemimeral
μούνη Κύπρις ἄναλκις ἔην θεός. οὐ βασιλήων	-- -u u-u u- uu - uu--	dactylic hexameter	feminine penthemimeral, hepthemimeral
κοιρανίην, οὐκ ἔγχος ἀρήιον, οὐ βέλος ἕλκω.	-uu- - -u u-uu - uu --	dactylic hexameter	feminine penthemimeral, trithemimeral
ἀλλὰ τί δειμαίνω περιώσιον ἀντὶ μὲν αἰχμῆς	-u u --- uu-uu -u u --	dactylic hexameter	masculine penthemimeral
ὡς θοὸν ἔγχος ἔχουσα μελίφρονα δεσμὸν ἐρώτων;	- uu -u u-u u-uu -u u--	dactylic hexameter	feminine penthemimeral
κεστὸν ἔχω καἰ κέντρον ἄγω καὶ τόξον ἀείρω,	-u u- - -u u- - -u u--	dactylic hexameter	feminine penthemimeral, hepthemimeral, trithemimeral
κεστόν, ὅθεν φιλότητος ἐμῆς ἐμὸν οἶστρον ἑλοῦσαι	-u u- uu-u u- uu -u u--	dactylic hexameter	feminine penthemimeral, hepthemimeral, trithemimeral
πολλάκις ὠδίνουσι καὶ οὐ θνῄσκουσι γυναῖκες.	-uu ---u u - --u u--	dactylic hexameter	feminine penthemimeral, hepthemimeral
τοῖον ἐφεσπομένη ῥοδοδάκτυλος ἔννεπε Κύπρις.	-u u-uu- uu-uu -uu --	dactylic hexameter	masculine penthemimeral
οἱ δ᾽ἄρα μητρῴης ἐρατῆς ἀίοντες ἐφετμῆς	- uu --- uu- uu-u u--	dactylic hexameter	masculine penthemimeral, hepthemimeral
φοιτητῆρες Ἔρωτες ἐπερρώοντο τιθήνῃ.	---u u-u u---u u--	dactylic hexameter	feminine penthemimeral
ἄρτι μὲν Ἰδαίην ὑπερέδραμον οὔρεος ἄκρην,	-u u --- uu-uu -uu --	dactylic hexameter	masculine penthemimeral
ἔνθα λιθοκρήδεμνον ὑπὸ πρηῶνος ἐρίπνην	-u u---u u- --u u--	dactylic hexameter	feminine penthemimeral, hepthemimeral
κουρίζων ἐνόμευε Πάρις πατρώια μῆλα.	--- uu-u u- --uu --	dactylic hexameter	feminine penthemimeral, hepthemimeral, trithemimeral
ποιμαίνων δ᾽ἑκάτερθεν ἐπὶ προχοῇσιν ἀναύρου	--- uu-u u- uu-u u--	dactylic hexameter	feminine penthemimeral, hepthemimeral, trithemimeral
νόσφι μέν ἀγρομένων ἀγέλην πεμπάζετο ταύρων,	-u u -uu- uu- --uu --	dactylic hexameter	masculine penthemimeral, hepthemimeral
νόσφι δὲ βοσκομένων διεμέτρεε πώεα μήλων·	-u u -uu- uu-uu -uu --	dactylic hexameter	masculine penthemimeral
καί τις ὀρεσσαύλοιο δορὴ μετόπισθε χιμαίρης	- u u---u u- uu-u u--	dactylic hexameter	feminine penthemimeral, hepthemimeral
ἐκκρεμὲς ᾐώρητο καὶ αὐτῶν ἥπτετο μηρῶν,	-uu ---u u -- -uu --	dactylic hexameter	feminine penthemimeral
ποιμενίη δ᾽ἀπέκειτο, βοῶν ἐλάτειρα, καλαῦροψ,	-uu- uu-u u- uu-u u--	dactylic hexameter	feminine penthemimeral, hepthemimeral, trithemimeral
τοῖος ἐπεὶ σύριγγος, ἐς ἤθεα βαιὸν ὁδεύων,	-u u- --u u -uu -u u--	dactylic hexameter	feminine penthemimeral, trithemimeral
ἀγροτέρων καλάμων λιγυρὴν ἐδίωκεν ἀοιδήν·	-uu- uu- uu- uu-u u--	dactylic hexameter	masculine penthemimeral, hepthemimeral, trithemimeral
πολλάκι δ᾽οἰοπόλοισιν ἐνὶ σταθμοῖσιν ἀείδων	-uu -uu-u u- --u u--	dactylic hexameter	feminine penthemimeral, hepthemimeral
καὶ ταύρων ἀμέλησε καὶ οὐκ ἐμπάζετο μήλων·	- -- uu-u u - --uu --	dactylic hexameter	feminine penthemimeral, hepthemimeral, trithemimeral
ἔνθεν ἔχων σύριγγα κατ᾽ ἤθεα καλὰ νομήων	-u u- --u u -uu -u u--	dactylic hexameter	feminine penthemimeral, trithemimeral
Πανὶ καὶ Ἑρμάωνι φίλην ἀνεβάλλετο μολπήν·	-u u ---u u- uu-uu --	dactylic hexameter	feminine penthemimeral, hepthemimeral
οὐ κύνες ὠρύοντο καὶ οὐ μυκήσατο ταῦρος,	- uu ---u u - --uu --	dactylic hexameter	feminine penthemimeral, hepthemimeral
μούνη δ᾽ἠνεμόεσσα, βοῆς ἀδίδακτος ἐοῦσα,	-- -uu-u u- uu-u u--	dactylic hexameter	feminine penthemimeral, hepthemimeral
Ἰδαίων ὀρέων ἀντίθροος ἴαχεν Ἠχώ.	--- uu- --uu -uu --	dactylic hexameter	masculine penthemimeral, trithemimeral
ταῦροι δὲ χλοερῆς κεκορηότες ὑψόθι ποίης,	-- - uu- uu-uu -uu --	dactylic hexameter	masculine penthemimeral, trithemimeral
κεκλιμένοι βαρύγουνον ἐπ᾽ ἰσχίον εὐνάζοντο.	-uu- uu-u u -uu ----	dactylic hexameter	feminine penthemimeral, trithemimeral
ὣς ὁ μὲν ὑψορόφοιο φυτῶν ὑπένερθε καλύπτρης	- u u -uu-u u- uu-u u--	dactylic hexameter	feminine penthemimeral, hepthemimeral
τηλόθεν Ἑρμάωνα διάκτορον εἶδε λιγαίνων.	-uu ---u u-uu -u u--	dactylic hexameter	feminine penthemimeral
δειμαίνων δ᾽ἀνόρουσε, θεῶν δ᾽ἀλέεινεν ὀπωπήν·	--- uu-u u- uu-u u--	dactylic hexameter	feminine penthemimeral, hepthemimeral, trithemimeral
καὶ χορὸν εὐκελάδων δονάκων ἐπὶ φηγὸν ἐρείσας	- uu -uu- uu- uu -u u--	dactylic hexameter	masculine penthemimeral, hepthemimeral
μήπω πολλὰ καμοῦσαν ἑὴν ἀνέκοπτεν ἀοιδήν.	-- -u u-u u- uu-u u--	dactylic hexameter	feminine penthemimeral, hepthemimeral
τοῖα δὲ δειμαίνοντα προσέννεπε θέσκελος Ἑρμῆς·	-u u ---u u-uu -uu --	dactylic hexameter	feminine penthemimeral
γαῦλον ἀπορρίψας καὶ πώεα καλὰ μεθήσας	-u u--- - -uu -u u--	dactylic hexameter	masculine penthemimeral
δεῦρο θεμιστεύσειας ἐπουρανίῃσι δικάζων·	-u u---u u-uu-u u--	dactylic hexameter	feminine penthemimeral
δεῦρο διακρίνων προφερέστερον εἶδος ὀπωπῆς	-u u--- uu-uu -u u--	dactylic hexameter	masculine penthemimeral
φαιδροτέρῃ τόδε μῆλον, ἐπήρατον ἔρνος, ὀπάσσαις.	-uu- uu -u u-uu -u u--	dactylic hexameter	feminine penthemimeral, trithemimeral
τοῖον ἀνηΰτησεν· ὁ δ᾽ἤπιον ὄμμα τανύσσας	-u u---u u -uu -u u--	dactylic hexameter	feminine penthemimeral
ἦκα διακρίνειν πειρήσατο κάλλος ἑκάστης.	-u u--- --uu -u u--	dactylic hexameter	masculine penthemimeral
δέρκετο μὲν γλαυκῶν βλεφάρων σέλας, ἔδρακε δειρὴν	-uu - -- uu- uu -uu --	dactylic hexameter	masculine penthemimeral, hepthemimeral, trithemimeral
χρυσῷ δαιδαλέην, ἐφράσσατο κόσμον ἑκάστης	-- -uu- --uu -u u--	dactylic hexameter	masculine penthemimeral
καὶ πτέρνης μετόπισθε καὶ αὐτῶν ἴχνια ταρσῶν.	- -- uu-u u -- -- --	dactylic hexameter	feminine penthemimeral, trithemimeral
χειρῶν μειδιόωντα δίκης προπάροιθεν ἑλοῦσα	-- -uu-u u- uu-u u--	dactylic hexameter	feminine penthemimeral, hepthemimeral
τοῖον Ἀλεξάνδρῳ μυθήσατο μῦθον Ἀθήνη·	-u u--- --uu -u u--	dactylic hexameter	masculine penthemimeral
δεῦρο, τέκος Πριάμοιο, Διὸς παράκοιτιν ἐάσας	-u u- uu-u u- uu-u u--	dactylic hexameter	feminine penthemimeral, hepthemimeral, trithemimeral
καὶ θαλάμων βασίλειαν ἀτιμήσας Ἀφροδίτην	- uu- uu-u u--- uu--	dactylic hexameter	feminine penthemimeral, trithemimeral
ἠνορέης ἐπίκουρον ἐπαινήσειας Ἀθήνην.	-uu- uu-u u---u u--	dactylic hexameter	feminine penthemimeral, trithemimeral
φασί σε κοιρανέειν καὶ Τρώιον ἄστυ φυλάσσειν·	-u u -uu- - -uu -u u--	dactylic hexameter	masculine penthemimeral
δεῦρό σε τειρομένοισι σαόπτολιν ἀνδράσι θήσω,	-u u -uu-u u-uu -uu --	dactylic hexameter	feminine penthemimeral
μή ποτέ σοι βαρύμηνις ἐπιβρίσειεν Ἐνυώ.	- uu - uu-u u---u u--	dactylic hexameter	feminine penthemimeral, trithemimeral
πείθεο, καὶ πολέμους τε καὶ ἠνορέην σε διδάξω.	-uu - uu- u u -uu- u u--	dactylic hexameter	masculine penthemimeral, trithemimeral
ὣς ἡ μὲν πολύμητις ἀνηΰτησεν Ἀθήνη.	- - - uu-u u---u u--	dactylic hexameter	feminine penthemimeral, trithemimeral
τοῖα δ᾽ὑποβλήδην λευκώλενος ἔννεπεν Ἥρη·	-u u--- --uu -uu --	dactylic hexameter	masculine penthemimeral
εἴ με διακρίνων προφερέστερον ἔρνος ὀπάσσῃς,	- u u--- uu-uu -u u--	dactylic hexameter	masculine penthemimeral
πάσης ἡμετέρης Ἀσίης ἡγήτορα θήσω.	-- -uu- uu- --uu --	dactylic hexameter	masculine penthemimeral, hepthemimeral
ἔργα μόθων ἀθέριζε· τί γὰρ πολέμων βασιλῆι;	-u u- uu-u u - uu- uu--	dactylic hexameter	feminine penthemimeral, hepthemimeral, trithemimeral
κοίρανος ἰφθίμοισι καὶ ἀπτολέμοισι κελεύει.	-uu ---u u -uu-u u--	dactylic hexameter	feminine penthemimeral
οὐκ αἰεὶ θεράποντες ἀριστεύουσιν Ἀθήνης·	- -- uu-u u---u u--	dactylic hexameter	feminine penthemimeral, trithemimeral
ὠκύμοροι θνῄσκουσιν ὑποδρηστῆρες Ἐνυοῦς.	-uu- --u u---u u--	dactylic hexameter	feminine penthemimeral, trithemimeral
τοίην κοιρανίην πρωτόθρονος ὤπασεν Ἥρη.	-- -uu- --uu -uu --	dactylic hexameter	masculine penthemimeral
ἡ δ᾽ἑανὸν βαθύκολπον, ἐς ἠέρα γυμνώσασα	- uu- uu-u u -uu ----	dactylic hexameter	feminine penthemimeral, trithemimeral
κόλπον, ἀνῃώρησε καὶ οὐκ ᾐδέσσατο Κύπρις.	-u u---u u - --uu --	dactylic hexameter	feminine penthemimeral, hepthemimeral
χειρὶ δ᾽ἐλαφρίζουσα μελίφρονα δεσμὸν ἐρώτων	-u u---u u-uu -u u--	dactylic hexameter	feminine penthemimeral
στῆθος ἅπαν γύμνωσε καὶ οὐκ ἐμνήσατο μαζῶν.	-u u- --u u - --uu --	dactylic hexameter	feminine penthemimeral, hepthemimeral, trithemimeral
τοῖα δὲ μειδιόωσα προσέννεπε μηλοβοτῆρα·	-u u -uu-u u-uu -uu--	dactylic hexameter	feminine penthemimeral
δέξό με καὶ πολέμων ἐπιλήθεο, δέχνυσο μορφὴν	-u u - uu- uu-uu -- --	dactylic hexameter	masculine penthemimeral, trithemimeral
ἡμετέρην καὶ σκῆπτρα καὶ Ἀσίδα κάλλιπε γαῖαν.	-uu- - -u u -uu -uu --	dactylic hexameter	feminine penthemimeral, trithemimeral
ἔργα μόθων οὐκ οἶδα· τί γὰρ σακέων Ἀφροδίτῃ;	-u u- - -u u - uu- uu--	dactylic hexameter	feminine penthemimeral, hepthemimeral, trithemimeral
ἀγλαΐῃ πολὺ μᾶλλον ἀριστεύουσι γυναῖκες.	-uu- uu -u u---u u--	dactylic hexameter	feminine penthemimeral, trithemimeral
ἀντὶ μὲν ἠνορέης ἐρατὴν παράκοιτιν ὀπάσσω,	-u u -uu- uu- uu-u u--	dactylic hexameter	masculine penthemimeral, hepthemimeral
ἀντὶ δὲ κοιρανίης Ἑλένης ἐπιβήσεο λέκτρων·	-u u -uu- uu- uu-uu --	dactylic hexameter	masculine penthemimeral, hepthemimeral
νυμφίον ἀθρήσει σε μετὰ Τροίην Λακεδαίμων	-uu --- u u- -- uu--	dactylic hexameter	masculine penthemimeral, hepthemimeral
οὔπω μῦθος ἔληγεν, ὁ δ᾽ἀγλαὸν ὤπασε μῆλον,	-- -u u-u u -uu -uu --	dactylic hexameter	feminine penthemimeral
ἀγλαΐης ἀνάθημα, μέγα κτέρας Ἀφρογενείῃ,	-uu- uu-u u- uu -uu--	dactylic hexameter	feminine penthemimeral, hepthemimeral, trithemimeral
φυταλιὴν πολέμοιο, κακὴν πολέμοιο γενέθλην.	-uu- uu-u u- uu-u u--	dactylic hexameter	feminine penthemimeral, hepthemimeral, trithemimeral
χειρὶ δὲ μῆλον ἔχουσα τόσην ἀνενείκατο φωνὴν	-u u -u u-u u- uu-uu --	dactylic hexameter	feminine penthemimeral, hepthemimeral
Ἥρην κερτομέουσα καὶ ἀντιάνειραν Ἀθήνην·	-- -uu-u u -uu-u u--	dactylic hexameter	feminine penthemimeral
εἴξατέ μοι πολέμοιο συνήθεες, εἴξατε νίκης.	-uu - uu-u u-uu -uu --	dactylic hexameter	feminine penthemimeral, trithemimeral
ἀγλαΐην ἐφίλησα, καὶ ἀγλαΐη με διώκει.	-uu- uu-u u -uu- u u--	dactylic hexameter	feminine penthemimeral, trithemimeral
φασί σε, μῆτερ Ἄρηος, ὑπ᾽ ὠδίνεσσιν ἀέξειν	-u u -u u-u u ---u u--	dactylic hexameter	feminine penthemimeral
ἠυκόμων Χαρίτων ἱερὸν χορόν· ἀλλά σε πᾶσαι	-uu- uu- uu- uu -u u --	dactylic hexameter	masculine penthemimeral, hepthemimeral, trithemimeral
σήμερον ἠρνήσαντο, καὶ οὐ μίαν εὗρες ἀρωγόν.	-uu ---u u - uu -u u--	dactylic hexameter	feminine penthemimeral, hepthemimeral
οὐ σακέων βασίλεια καὶ οὐ πυρός ἐσσι τιθήνη·	- uu- uu-u u - uu -- ---	lyric	
οὔ σοι Ἄρης ἐπάρηξε, καὶ εἰ δορὶ μαίνεται Ἄρης,	- u u- uu-u u - uu -uu --	dactylic hexameter	feminine penthemimeral, hepthemimeral, trithemimeral
οὐ φλόγες Ἡφαίστοιο, καὶ εἰ φλογὸς ἆσθμα λοχεύει.	- uu ---u u - uu -u u--	dactylic hexameter	feminine penthemimeral, hepthemimeral
οἶα δὲ κυδιάεις ἀνεμώλιος, Ἀτρυτώνη,	-u u -uu- uu-uu ----	dactylic hexameter	masculine penthemimeral
ἣν γάμος οὐκ ἔσπειρε καὶ οὐ μαιώσατο μήτηρ,	- uu - --u u - --uu --	dactylic hexameter	feminine penthemimeral, hepthemimeral, trithemimeral
ἀλλὰ σιδηρείη σε τομὴ καὶ ῥίζα σιδήρου	-u u--- u u- - -u u--	dactylic hexameter	masculine penthemimeral, hepthemimeral
πατρῴων ἀλόχευτον ἀνεβλάστησε καρήνων.	--- uu-u u---u u--	dactylic hexameter	feminine penthemimeral, trithemimeral
οἶα δὲ χαλκείοισι καλυψαμένη χρόα πέπλοις	-u u ---u u-uu- uu --	dactylic hexameter	feminine penthemimeral
καὶ φεύγεις φιλότητα καὶ Ἄρεος ἔργα διώκεις,	- -- uu-u u -uu -u u--	dactylic hexameter	feminine penthemimeral, trithemimeral
ἁρμονίης ἀδίδακτος, ὁμοφροσύνης ἀδαήμων.	-uu- uu-u u-uu- uu--	dactylic hexameter	feminine penthemimeral, trithemimeral
ἀγνώσσεις, ὅτι μᾶλλον ἀνάλκιδές εἰσιν Ἀθῆναι	--- uu -u u-uu -u u--	dactylic hexameter	feminine penthemimeral, trithemimeral
τοῖαι, κυδαλίμοισιν ἀγαλλόμεναι πολέμοισι,	-- -uu-u u-uu- uu--	dactylic hexameter	feminine penthemimeral
κεκριμένων μελέων οὔτ᾽ ἄρσενες οὔτε γυναῖκες;	-uu- uu- - -uu -u u--	dactylic hexameter	masculine penthemimeral, trithemimeral
τοῖον ἐφυβρίζουσα προσέννεπε Κύπρις Ἀθήνην,	-u u---u u-uu -u u--	dactylic hexameter	feminine penthemimeral
ὣς ἡ μὲν πτολίπορθον ἀέθλιον ἔλλαχε μορφῆς	- - - uu-u u-uu -uu --	dactylic hexameter	feminine penthemimeral, trithemimeral
Ἥρην ἐξελάσασα καὶ ἀσχαλόωσαν Ἀθήνην·	-- -uu-u u -uu-u u--	dactylic hexameter	feminine penthemimeral
ἱμείρων δ᾽ὑπ᾽ ἔρωτι καὶ ἣν οὐκ εἶδε διώκων,	--- u u-u u - - -u u--	dactylic hexameter	feminine penthemimeral, hepthemimeral, trithemimeral
Δύσπαρις ἀθροίσας ἐπὶ δάσκιον ἤγαγεν ὕλην	-uu --- uu -uu -uu --	dactylic hexameter	masculine penthemimeral
ἀνέρας ἐργοπόνοιο δαήμονας Ἀτρυτώνης.	-uu -uu-u u-uu ----	dactylic hexameter	feminine penthemimeral
ἔνθα πολυπ0ρέμνοιο δαϊζόμεναι δρύες Ἴδης	-u u---u u-uu- uu --	dactylic hexameter	feminine penthemimeral
ἤριπον ἀρχεκάκοιο περιφροσύνῃσι Φερέκλου,	-uu -uu-u u-uu-u u--	dactylic hexameter	feminine penthemimeral
ὅς τότε μαργαίνοντι χαριζόμενος βασιλῆι	- uu ---u u-uu- uu--	dactylic hexameter	feminine penthemimeral
νῆας Ἀλεξάνδρῳ δρυτόμῳ τεκτήνατο χαλκῷ.	-u u--- uu- --uu --	dactylic hexameter	masculine penthemimeral, hepthemimeral
αὐτῆμαρ προβέβουλε καὶ αὐτῆμαρ κάμε νῆας,	--- uu-u u --- uu --	dactylic hexameter	feminine penthemimeral, trithemimeral
νῆας δ᾽οὐκ ἐνόησε καὶ οὐκ ἤσκησεν Ἀθήνη.	-- - uu-u u - --u u--	dactylic hexameter	feminine penthemimeral, hepthemimeral, trithemimeral
ἄρτι μὲν Ἰδαίων ὀρέων ἠλλάξατο πόντον	-u u --- uu- --uu --	dactylic hexameter	masculine penthemimeral, hepthemimeral
καὶ λεχέων ἐπίκουρον ἐφεσπομένην Ἀφροδίτην	- uu- uu-u u-uu- uu--	dactylic hexameter	feminine penthemimeral, trithemimeral
πολλάκις ἀκταίοισιν ἱλασσάμενος θυέεσσιν	-uu ---u u-uu- uu--	dactylic hexameter	feminine penthemimeral
ἔπλεεν Ἑλλήσποντον ἐπ᾽ εὐρέα νῶτα θαλάσσης,	-uu ---u u -uu -u u--	dactylic hexameter	feminine penthemimeral
τῷ δὲ πολυτλήτων σημήια φαίνετο μόχθων.	- u u-- ---- -u- -	lyric	
κυανέη μὲν ὕπερθεν ἀναθρώσκουσα θάλασσα	-uu- u u-u u---u u--	dactylic hexameter	feminine penthemimeral, trithemimeral
οὐρανὸν ὀρφναίων ἑλίκων ἐζώσατο δεσμῷ	-uu --- uu- --uu --	dactylic hexameter	masculine penthemimeral, hepthemimeral
εἶθαρ ἀμιχθαλόεντος ἀπ᾽ ἠέρος ὄμβρον ἱεῖσα,	-u u---u u -uu -u u--	dactylic hexameter	feminine penthemimeral
ἐκλύσθη δέ τε πόντος ἐρεσσομένων ἐρετάων.	--- u u -u u-uu- uu--	dactylic hexameter	feminine penthemimeral, trithemimeral
τόφρα δὲ Δαρδανίην καὶ Τρώιον οὖδας ἀμείψας	-u u -uu- - -uu -u u--	dactylic hexameter	masculine penthemimeral
Ἰσμαρίδος μεθέηκε παραπλώων στόμα λίμνης,	-uu- uu-u u--- uu --	dactylic hexameter	feminine penthemimeral, trithemimeral
αἶψα δὲ Θρηικίοιο μετ᾽ οὔρεα Παγγαίοιο	-u u -uu-u u -uu ----	dactylic hexameter	feminine penthemimeral
Φυλλίδος ἀντέλλοντα φιλήνορος ἔδρακε τύμβον	-uu ---u u-uu -uu --	dactylic hexameter	feminine penthemimeral
καὶ δρόμον ἐννεάκυκλον ἀλήμονος εἶδε κελεύθου,	- uu -uu-u u-uu -u u--	dactylic hexameter	feminine penthemimeral
ἔνθα διαστείχουσα κινύρεο, Φυλλίς, ἀκοίτην	-u u---u u-uu -u u--	dactylic hexameter	feminine penthemimeral
δεχνυμένη παλίνορσον ἀπήμονα Δημοφόωντα,	--- uu-u u-uu -uu--	dactylic hexameter	feminine penthemimeral, trithemimeral
ὁππότε νοστήσειεν Ἀθηναίης ἀπὸ δήμων.	-uu ---u u--- uu --	dactylic hexameter	feminine penthemimeral
τῷ δὲ βαθυκλήροιο διὰ χθονὸς Αἱμονιήων	- u u---u u- uu -uu--	dactylic hexameter	feminine penthemimeral, hepthemimeral
ἐξαπίνης ἀνέτελλεν Ἀχαιίδος ἄνθεα γαίης,	-uu- uu-u u-uu -uu --	dactylic hexameter	feminine penthemimeral, trithemimeral
Φθίη βωτιάνειρα καὶ εὐρυάγυια Μυκήνη.	-- -uu-u u -uu-u u--	dactylic hexameter	feminine penthemimeral
ἔνθεν ἀνερχομένοιο παρ᾽ εἰαμενὰς Ἐρυμάνθου	-u u-uu-u u -uu- uu--	dactylic hexameter	feminine penthemimeral
Σπάρτην καλλιγύναικα, φίλην πόλιν Ἀτρείωνος,	-- -uu-u u- uu ----	dactylic hexameter	feminine penthemimeral, hepthemimeral
κεκλιμένην ἐνόησεν ἐπ᾽ Εὐρώταο ῥεέθροις.	-uu- uu-u u ---u u--	dactylic hexameter	feminine penthemimeral, trithemimeral
ἄγχι δὲ ναιομένην ὑπὸ δάσκιον οὔρεος ὕλην	-u u -uu- uu -uu -uu --	dactylic hexameter	masculine penthemimeral
γείτονα παπταίνων ἐρατὴν θηεῖτο Θεράπνην.	-uu --- uu- --u u--	dactylic hexameter	masculine penthemimeral, hepthemimeral
οὔπω κεῖθεν ἔην δολιχὸς πλόος, οὐδέ γαλήνης	-- -u u- uu- uu -u u--	dactylic hexameter	masculine penthemimeral, hepthemimeral
δηρὸν ἐρεσσομένων ἠκούετο δοῦπος ἐρετμῶν,	-u u-uu- --uu -u u--	dactylic hexameter	masculine penthemimeral
καὶ χθονὸς εὐκόλποισιν ἐπ᾽ ἠιόνεσσι βαλόντες	- uu ---u u -uu-u u--	dactylic hexameter	feminine penthemimeral
πείσματα νηὸς ἔδησαν, ὅσοις ἁλὸς ἔργα μεμήλει.	-uu -u u-u u- uu -u u--	dactylic hexameter	feminine penthemimeral, hepthemimeral
αὐτὰρ ὁ χιονέοιο λοεσσάμενος ποταμοῖο	-u u -uu-u u-uu- uu--	dactylic hexameter	feminine penthemimeral
ᾤχετο φειδομένοισιν ἐπ᾽ ἴχνεσιν ἴχνος ἐρείδων,	-uu -uu-u u -- - ---	dactylic hexameter	feminine penthemimeral
μὴ πόδες ἱμερόεντες ὑποχραίνοιντο κονίης,	- uu -uu-u u---u u--	dactylic hexameter	feminine penthemimeral
μὴ πλοκάμων κυνέῃσιν ἐπιβρίσαντες ἐθείρας	- uu- uu-u u---u u--	dactylic hexameter	feminine penthemimeral, trithemimeral
ὀξύτερον σπεύδοντος ἀναστέλλοιεν ἀῆται.	-uu- --u u---u u--	dactylic hexameter	feminine penthemimeral, trithemimeral
ἄρτι μὲν αἰπύδμητα φιλοξείνων ναετήρων	-u u --- ---- uu--	dactylic hexameter	masculine penthemimeral
δώματα παπταίνων καὶ γείτονας ἐγγύθι νηοὺς	-uu --- - -uu -uu --	dactylic hexameter	masculine penthemimeral
ἄστεος ἀγλαΐην διεμέτρεεν, ἔνθα μὲν αὐτῆς	-uu -uu- uu-uu -u u --	dactylic hexameter	masculine penthemimeral
χρύσεον ἐνδαπίης θηεύμενος εἶδος Ἀθήνης,	-uu -uu- --uu -u u--	dactylic hexameter	masculine penthemimeral
ἔνθα δὲ Καρνείοιο φίλον κτέρας Ἀπόλλωνος	-u u ---u u- uu ----	dactylic hexameter	feminine penthemimeral, hepthemimeral
οἶκον Ἀμυκλαίοιο παραγνάμψας Ὑακίνθου,	-u u---u u--- uu--	dactylic hexameter	feminine penthemimeral
ὅν ποτε κουρίζοντα σὺν Ἀπόλλωνι νοήσας	- uu ---u u ---u u--	dactylic hexameter	feminine penthemimeral
δῆμος Ἀμυκλαίων ἠγάσσατο, μὴ Διὶ Λητὼ	-u u--- --uu - uu --	dactylic hexameter	masculine penthemimeral
κυσαμένη καὶ τοῦτον ἀνήγαγεν· αὐτὰρ Ἀπόλλων	-uu- - -u u-uu -u u--	dactylic hexameter	feminine penthemimeral, trithemimeral
οὐκ ἐκάη Ζεφύρῳ ζηλήμονι παῖδα φυλάσσων.	- uu- uu- --uu -u u--	dactylic hexameter	masculine penthemimeral, trithemimeral
γαῖα δὲ δακρύσαντι χαριζομένη βασιλῆι	-u u ---u u-uu- uu--	dactylic hexameter	feminine penthemimeral
ἄνθος ἀνηέξησε, παραίφασιν Ἀπόλλωνος,	-u u---u u-uu ----	dactylic hexameter	feminine penthemimeral
ἄνθος ἀριζήλοιο φερώνυμον ἡβητῆρος.	-u u---u u-uu ----	dactylic hexameter	feminine penthemimeral
ἤδη δ᾽ἀγχιδόμοισιν ἐπ᾽ Ἀτρείδαο μελάθροις	-- -uu-u u ---u u--	dactylic hexameter	feminine penthemimeral
ἵστατο θεσπεσίῃσιν ἀγαλλόμενος χαρίτεσσιν.	-uu -uu-u u-uu- uu--	dactylic hexameter	feminine penthemimeral
οὐ Διὶ τοῖον ἔτικτεν ἐπήρατον υἷα Θυώνη·	- uu -u u-u u-uu -u u--	dactylic hexameter	feminine penthemimeral
ἱλήκοις, Διόνυσε· καὶ εἰ Διός ἐσσι γενέθλης,	--- uu-u u - uu -u u--	dactylic hexameter	feminine penthemimeral, hepthemimeral, trithemimeral
καλὸς ἔην καὶ κεῖνος ἐπ᾽ ἀγλαΐῃσι προσώπων.	-u u- - -u u -uu-u u--	dactylic hexameter	feminine penthemimeral, trithemimeral
ἡ δὲ φιλοξείνων θαλάμων κληῖδας ἀνεῖσα	- u u--- uu- --u u--	dactylic hexameter	masculine penthemimeral, hepthemimeral
ἐξαπίνης Ἑλένη μετεκίαθε δώματος αὐλὴν	-uu- uu- uu-uu -uu --	dactylic hexameter	masculine penthemimeral, trithemimeral
καὶ θαλερῶν προπάροιθεν ὀπιπεύουσα θυράων	- uu- uu-u u---u u--	dactylic hexameter	feminine penthemimeral, trithemimeral
ὡς ἴδεν, ὣς ἐκάλεσσε καὶ ἐς μυχὸν ἤγαγεν οἴκου	- uu - uu-u u - uu -uu --	dactylic hexameter	feminine penthemimeral, hepthemimeral, trithemimeral
καί μιν ἐφεδρήσσειν νεοπηγέος ὑψόθεν ἕδρης	- u u--- uu-uu -uu --	dactylic hexameter	masculine penthemimeral
ἀργυρέης ἐπέτελλε· κόρον δ᾽οὐκ εἶχεν ὀπωπῆς	-uu- uu-u u- - -u u--	dactylic hexameter	feminine penthemimeral, hepthemimeral, trithemimeral
ἄλλοτε δὴ χρύσειον ὀισαμένη Κυθερείης	-uu - --u u-uu- uu--	dactylic hexameter	feminine penthemimeral, trithemimeral
κοῦρον ὀπιπεύειν θαλαμηπόλον—ὀψὲ δ᾽ἀνέγνω,	-u u--- uu-uu-u u--	dactylic hexameter	masculine penthemimeral
ὡς οὐκ ἔστιν Ἔρως· βελέων δ᾽οὐκ εἶδε φαρέτρην,	- - -u u- uu- - -u u--	dactylic hexameter	masculine penthemimeral, hepthemimeral
πολλάκι δ᾽ἀγλαΐῃσιν ἐυγλήνοισι προσώπων	-uu -uu-u u---u u--	dactylic hexameter	feminine penthemimeral
παπταίνειν ἐδόκευε τὸν ἡμερίδων βασιλῆα·	--- uu-u u -uu- uu--	dactylic hexameter	feminine penthemimeral, trithemimeral
ἀλλ᾽ οὐχ ἡμερίδων θαλερὴν ἐδόκευεν ὀπώρην	- - -uu- uu- uu-u u--	dactylic hexameter	masculine penthemimeral, hepthemimeral
πεπταμένην χαρίεντος ἐπὶ ξυνοχῇσι καρήνου.	-uu- uu-u u- uu-u u--	dactylic hexameter	feminine penthemimeral, hepthemimeral, trithemimeral
ὀψὲ δὲ θαμβήσασα τόσην ἀνενείκατο φωνήν·	-u u ---u u- uu-uu --	dactylic hexameter	feminine penthemimeral, hepthemimeral
ξεῖνε, πόθεν τελέθεις; ἐρατὸν γένος εἰπὲ καὶ ἡμῖν.	-u u- uu- uu- uu -u u --	dactylic hexameter	masculine penthemimeral, hepthemimeral, trithemimeral
ἀγλαΐην μὲν ἔοικας ἀριζήλῳ βασιλῆι,	-uu- u u-u u--- uu--	dactylic hexameter	feminine penthemimeral, trithemimeral
ἀλλὰ τεὴν οὐκ οἶδα παρ᾽ Ἀργείοισι γενέθλην.	-u u- - -u u ---u u--	dactylic hexameter	feminine penthemimeral, trithemimeral
πᾶσαν Δευκαλίωνος ἀμύμονος οἶδα γενέθλην·	-- -uu-u u-uu -u u--	dactylic hexameter	feminine penthemimeral
οὐ Πύλον ἠμαθόεσσαν ἔχεις, Νηλήιον οὖδας,	- uu -uu-u u- --uu --	dactylic hexameter	feminine penthemimeral, hepthemimeral
Ἀντίλοχον δεδάηκα, τεὴν δ᾽οὐκ εἶδον ὀπωπὴν	-uu- uu-u u- - -u u--	dactylic hexameter	feminine penthemimeral, hepthemimeral, trithemimeral
οὐ Φθίην χαρίεσσαν, ἀριστήων τροφὸν ἀνδρῶν·	- -- uu-u u--- uu --	dactylic hexameter	feminine penthemimeral, trithemimeral
οἶδα περικλήιστον ὅλον γένος Αἰακιδάων,	-u u---u u- uu -uu--	dactylic hexameter	feminine penthemimeral, hepthemimeral
ἀγλαΐην Πηλῆος, ἐυκλείην Τελαμῶνος,	-uu- --u u--- uu--	dactylic hexameter	feminine penthemimeral, trithemimeral
ἤθεα Πατρόκλοιο καὶ ἠνορέην Ἀχιλῆος.	-uu ---u u -uu- uu--	dactylic hexameter	feminine penthemimeral
τοῖα Πάριν ποθέουσα λιγύθροος ἔννεπε νύμφη·	-u u- uu-u u-uu -uu --	dactylic hexameter	feminine penthemimeral, trithemimeral
αὐτὰρ ὁ μειλιχίην ἠμείβετο γῆρυν ἀνοίξας·	-u u -uu- --uu -u u--	dactylic hexameter	masculine penthemimeral
εἴ τινά που Φρυγίης ἐνὶ πείρασι γαῖαν ἀκούεις,	- uu - uu- uu -uu -u u--	dactylic hexameter	masculine penthemimeral, trithemimeral
Ἴλιον, ἣν πύργωσε Ποσειδάων καὶ Ἀπόλλων·	-uu - --u u--- u u--	dactylic hexameter	feminine penthemimeral, trithemimeral
εἴ τινά που πολύολβον ἐνὶ Τροίῃ βασιλῆα	- uu - uu-u u- -- uu--	dactylic hexameter	feminine penthemimeral, hepthemimeral, trithemimeral
ἔκλυες εὐώδινος ἀπὸ Κρονίδαο γενέθλης·	-uu ---u u- uu-u u--	dactylic hexameter	feminine penthemimeral, hepthemimeral
ἔνθεν ἀριστεύων ἐμφύλια πάντα διώκω.	-u u--- --uu -u u--	dactylic hexameter	masculine penthemimeral
εἰμί, γύναι, Πριάμοιο πολυχρύσου φίλος υἱός,	-u u- uu-u u--- uu --	dactylic hexameter	feminine penthemimeral, trithemimeral
εἰμὶ δὲ Δαρδανίδης· ὁ δὲ Δάρδανος ἐκ Διὸς ἦεν,	-u u -uu- u u -uu - uu --	dactylic hexameter	masculine penthemimeral
ᾧ καὶ ἀπ᾽ Οὐλύμποιο θεοὶ ξυνήονες ἀνδρῶν	- u u ---u u- --uu --	dactylic hexameter	feminine penthemimeral, hepthemimeral
πολλάκι θητεύουσι καὶ ἀθάνατοί περ ἐόντες·	-uu ---u u -uu- u u--	dactylic hexameter	feminine penthemimeral
ὧν ὁ μὲν ἡμετέρης δωμήσατο τείχεα πάτρης,	- u u -uu- --uu -uu --	dactylic hexameter	masculine penthemimeral
τείχεα μαρμαίροντα, Ποσειδάων καὶ Ἀπόλλων.	-uu ---u u--- u u--	dactylic hexameter	feminine penthemimeral
αὐτὰρ ἐγώ, βασίλεια, δικασπόλος εἰμὶ θεάων·	-u u- uu-u u-uu -u u--	dactylic hexameter	feminine penthemimeral, trithemimeral
καὶ γὰρ ἀκηχεμένῃσιν ἐπουρανίῃσι δικάζων	- u u-uu-u u-uu-u u--	dactylic hexameter	feminine penthemimeral
Κύπριδος ἀγλαΐην καὶ ἐπήρατον ᾔνεσα μορφήν,	-uu -uu- u u-uu -uu --	dactylic hexameter	masculine penthemimeral
ἡ δὲ περικλήιστον, ἐμῶν ἀντάξιον ἔργων,	- u u---u u- --uu --	dactylic hexameter	feminine penthemimeral, hepthemimeral
νύμφην ἱμερόεσσαν ἐμοὶ κατένευσεν ὀπάσσαι,	-- -uu-u u- uu-u u--	dactylic hexameter	feminine penthemimeral, hepthemimeral
ἣν Ἑλένην ἐνέπουσι, κασιγνήτην Ἀφροδίτης,	- uu- uu-u u--- uu--	dactylic hexameter	feminine penthemimeral, trithemimeral
ἧς ἕνεκεν τέτληκα καὶ οἴδματα τόσσα περῆσαι.	- uu- -- - -- -u u--	dactylic hexameter	masculine penthemimeral, trithemimeral
δεῦρο γάμον κεράσωμεν, ἐπεὶ Κυθέρεια κελεύει·	-u u- uu-u u- uu-u u--	dactylic hexameter	feminine penthemimeral, hepthemimeral, trithemimeral
μή με καταισχύνειας, ἐμὴν μὴ Κύπριν ἐλέγξῃς.	- u u---u u- - -u u--	dactylic hexameter	feminine penthemimeral, hepthemimeral
οὐκ ἐρέω· τί δὲ τόσσον ἐπισταμένην σε διδάξω;	- uu- u u -u u-uu- u u--	dactylic hexameter	feminine penthemimeral, trithemimeral
οἶσθα γάρ, ὡς Μενέλαος ἀνάλκιδός ἐστι γενέθλης·	-u u - uu-u u-uu -u u--	dactylic hexameter	feminine penthemimeral, trithemimeral
οὐ τοῖαι γεγάασιν ἐν Ἀργείοισι γυναῖκες,	- -- uu-u u ---u u--	dactylic hexameter	feminine penthemimeral, trithemimeral
καὶ γὰρ ἀκιδνοτέροισιν ἀεξόμεναι μελέεσσιν	- u u---u u-uu- uu--	dactylic hexameter	feminine penthemimeral
ἀνδρῶν εἶδος ἔχουσι, νόθοι δ᾽ἐγένοντο γυναῖκες.	-- -u u-u u- uu-u u--	dactylic hexameter	feminine penthemimeral, hepthemimeral
ἔννεπεν· ἡ δ᾽ἐρόεσσαν ἐπὶ χθονὶ πῆξεν ὀπωπὴν	-uu - uu-u u- uu -u u--	dactylic hexameter	feminine penthemimeral, hepthemimeral, trithemimeral
δηρὸν ἀμηχανέουσα καὶ οὐκ ἠμείβετο νύμφη.	-u u-uu-u u - --uu --	dactylic hexameter	feminine penthemimeral, hepthemimeral
ὀψὲ δὲ θαμβήσασα τόσην ἀνενείκατο φωνήν·	-u u ---u u- uu-uu --	dactylic hexameter	feminine penthemimeral, hepthemimeral
ἀτρεκέως, ὦ ξεῖνε, τεῆς ποτε πυθμένα πάτρης	-uu- - -u u- uu -uu --	dactylic hexameter	feminine penthemimeral, hepthemimeral, trithemimeral
τὸ πρὶν ἐδωμήσαντο Ποσειδάων καὶ Ἀπόλλων;	- u u---u u--- u u--	dactylic hexameter	feminine penthemimeral
ἤθελον ἀθανάτων δαιδάλματα κεῖνα νοῆσαι	-uu -uu- --uu -u u--	dactylic hexameter	masculine penthemimeral
καὶ νομὸν οἰοπόλοιο λιγύπνοον Ἀπόλλωνος,	- uu -uu-u u-uu ----	dactylic hexameter	feminine penthemimeral
ἔνθα θεοδμήτοισι παρὰ προθύροισι πυλάων	-u u--- uu ---u u--	dactylic hexameter	masculine penthemimeral
πολλάκις εἰλιπόδεσσιν ἐφέσπετο βουσὶν Ἀπόλλων.	-uu -uu-u u-uu -u u--	dactylic hexameter	feminine penthemimeral
ἀγρέο νῆν Σπάρτηθεν ἐπὶ Τροίην με κομίζων.	-uu - --u u- -- u u--	dactylic hexameter	feminine penthemimeral, hepthemimeral, trithemimeral
ἕψομαι, ὡς Κυθέρεια γάμων βασίλεια κελεύει.	-uu - uu-u u- uu-u u--	dactylic hexameter	feminine penthemimeral, hepthemimeral, trithemimeral
οὐ τρομέω Μενέλαον, ὅταν Τροίη με νοήσῃ·	- uu- uu-u u- -- u u--	dactylic hexameter	feminine penthemimeral, hepthemimeral, trithemimeral
τοίην συνθεσίην καλλίσφυρος ἔννεπε νύμφη.	-- -uu- --uu -uu --	dactylic hexameter	masculine penthemimeral
νὺξ δέ, πόνων ἄμπαυμα μετ᾽ ἠελίοιο κελεύθους,	- u u- --u u -uu-u u--	dactylic hexameter	feminine penthemimeral, trithemimeral
ὕπνον ἐλαφρίζουσα, παρήορον ὤπασεν ἠῶ	-u u---u u-uu -uu --	dactylic hexameter	feminine penthemimeral
ἀρχομένην· δοιὰς δὲ πύλας ὤιξεν ὀνείρων,	-uu- -- u u- --u u--	dactylic hexameter	masculine penthemimeral, hepthemimeral, trithemimeral
τὴν μὲν ἀληθείης (κεράων ἀπελάμπετο κόσμος)	- u u--- uu- uu-uu --	dactylic hexameter	masculine penthemimeral, hepthemimeral
ἔνθεν ἀναθρῴσκουσι θεῶν νημερτέες ὀμφαί,	-u u---u u- --uu --	dactylic hexameter	feminine penthemimeral, hepthemimeral
τὴν δὲ δολοφροσύνης, κενεῶν θρέπτειραν ὀνείρων.	- u u-uu- uu- --u u--	dactylic hexameter	masculine penthemimeral, hepthemimeral
αὐτὰρ ὁ ποντοπόρων Ἑλένην ἐπὶ σέλματα νηῶν	-u u -uu- uu- uu -uu --	dactylic hexameter	masculine penthemimeral, hepthemimeral
ἐκ θαλάμων ἐκόμισσε φιλοξείνου Μενελάου,	- uu- uu-u u--- uu--	dactylic hexameter	feminine penthemimeral, trithemimeral
κυδιόων δ᾽ὑπέροπλον ὑποσχεσίῃ Κυθερείης	-uu- uu-u u-uu- uu--	dactylic hexameter	feminine penthemimeral, trithemimeral
φόρτον ἄγων ἔσπευδεν ἐς Ἴλιον ἰωχμοῖο.	-u u- --u u -uu ----	dactylic hexameter	feminine penthemimeral, trithemimeral
Ἑρμιόνη δ᾽ἀνέμοισιν ἀπορρίψασα καλύπτρην	-uu- uu-u u---u u--	dactylic hexameter	feminine penthemimeral, trithemimeral
ἱσταμένης πολύδακρυς ἀνέστενεν ἠριγενείης,	-uu- uu-u u-uu -uu--	dactylic hexameter	feminine penthemimeral, trithemimeral
πολλάκι δ᾽ἀμφιπόλους θαλάμων ἔκτοσθε λαβοῦσα,	-uu -uu- uu- --u u--	dactylic hexameter	masculine penthemimeral, hepthemimeral
ὀξύτατον βοόωσα τόσην ἀνενείκατο φωνήν·	-uu- uu-u u- uu-uu --	dactylic hexameter	feminine penthemimeral, hepthemimeral, trithemimeral
παῖδες, πῆ με λιποῦσα πολύστονον ᾤχετο μήτηρ,	-- - u u-u u-uu -uu --	dactylic hexameter	feminine penthemimeral, trithemimeral
ἣ χθιζόν σὺν ἐμοὶ θαλάμων κληῖδας ἑλοῦσα	- -- u u- uu- --u u--	dactylic hexameter	masculine penthemimeral, hepthemimeral, trithemimeral
ἔδραθεν ὑπνώουσα καὶ ἐς μίαν ἤλυθεν εὐνήν;	-uu ---u u - uu -uu --	dactylic hexameter	feminine penthemimeral, hepthemimeral
ἔννεπε δακρυχέουσα, συνωδύροντο δὲ παῖδες.	-uu -uu-u u---u u --	dactylic hexameter	feminine penthemimeral
ἀγρόμεναι δ᾽ἑκάτερθεν ἐπὶ προθύροισιν ἐρύκειν	-uu- uu-u u- uu-u u--	dactylic hexameter	feminine penthemimeral, hepthemimeral, trithemimeral
Ἑρμιόνην στενάχουσαν ἐπειρήσαντο γυναῖκες·	-uu- uu-u u---u u--	dactylic hexameter	feminine penthemimeral, trithemimeral
τέκνον ὀδυρομένη, γόον εὔνασον. Ὤιετο μήτηρ,	-u u-uu- uu -uu -uu --	dactylic hexameter	masculine penthemimeral
νοστήσει παλίνορσος· ἔτι κλαίουσα νοήσεις.	--- uu-u u- --u u--	dactylic hexameter	feminine penthemimeral, hepthemimeral, trithemimeral
οὐχ ὁράᾳς; γοεραί μὲν ἐπιμύουσιν ὀπωπαί,	- uu- uu- u u---u u--	dactylic hexameter	masculine penthemimeral, trithemimeral
πυκνὰ δὲ μυρομένης θαλεραὶ μινύθουσι παρειαί.	-u u -uu- uu- uu-u u--	dactylic hexameter	masculine penthemimeral, hepthemimeral
ἦ τάχα νυμφάων ἐς ὁμήγυριν ἀγρομενάων	- uu --- u u-uu -uu--	dactylic hexameter	masculine penthemimeral
ἤλυθεν, ἰθείης δὲ παραπλάζουσα κελεύθου	-uu --- u u---u u--	dactylic hexameter	masculine penthemimeral
ἵσταται ἀσχαλόωσα, καὶ ἐς λειμῶνα μολοῦσα	-uu -uu-u u - --u u--	dactylic hexameter	feminine penthemimeral, hepthemimeral
ὡράων δροσόεντος ὑπὲρ πεδίοιο θαάσσει,	--- uu-u u- uu-u u--	dactylic hexameter	feminine penthemimeral, hepthemimeral, trithemimeral
ἢ χρόα πατρῴοιο λοεσσομένη ποταμοῖο	- uu ---u u-uu- uu--	dactylic hexameter	feminine penthemimeral
ᾤχετο καὶ δήθυνεν ἐπ᾽ Εὐρώταο ῥεέθροις.	-uu - --u u ---u u--	dactylic hexameter	feminine penthemimeral, trithemimeral
τοῖα δὲ δακρύσασα πολύστονος ἔννεπε κούρη·	-u u -uu- --uu -uu --	dactylic hexameter	masculine penthemimeral
οἶδεν ὄρος, ποταμῶν ἐδάη ῥόον, οἶδε κελεύθους	-u u- uu- uu- uu -u u--	dactylic hexameter	masculine penthemimeral, hepthemimeral, trithemimeral
ἐς ῥόδον, ἐς λειμῶνα· τί μοι φθέγγεσθε, γυναῖκες;	- uu - --u u - --u u--	dactylic hexameter	feminine penthemimeral, hepthemimeral, trithemimeral
ἀστέρες ὑπνώουσι, καὶ ἐν σκοπέλοισιν ἰαύει·	-uu ---u u - uu-u u--	dactylic hexameter	feminine penthemimeral, hepthemimeral
ἀστέρες ἀντέλλουσι, καὶ οὐ παλίνορσος ἱκάνει.	-uu ---u u - uu-u u--	dactylic hexameter	feminine penthemimeral, hepthemimeral
μῆτερ ἐμή, τίνα χῶρον ἔχεις; τίνα δ᾽οὔρεα ναίεις;	-u u- uu -u u- uu -uu --	dactylic hexameter	feminine penthemimeral, hepthemimeral, trithemimeral
πλαζομένην θῆρές σε κατέκτανον; ἀλλὰ καὶ αὐτοὶ	-uu- -- u u-uu -u u --	dactylic hexameter	masculine penthemimeral, trithemimeral
θῆρες ἀριζήλοιο Διὸς τρομέουσι γενέθλην	-u u---u u- uu-u u--	dactylic hexameter	feminine penthemimeral, hepthemimeral
ἤριπες ἐξ ὀχέων χθαμαλῆς ἐπὶ νῶτα κονίης	-uu - uu- uu- uu -u u--	dactylic hexameter	masculine penthemimeral, hepthemimeral, trithemimeral
σὸν δέμας οἰοπόλοισιν ἐνὶ δρυμοῖσι λιποῦσα;	- uu -uu-u u- --u u--	dactylic hexameter	feminine penthemimeral, hepthemimeral
ἀλλὰ πολυπρέμνων ξυλόχων ὑπὸ δάσκιον ὕλην	-u u--- uu- uu -uu --	dactylic hexameter	masculine penthemimeral, hepthemimeral
δένδρεα παπτήνασα καὶ αὐτῶν μέχρι πετήλων	-uu ---u u -- -u u--	dactylic hexameter	feminine penthemimeral
σὸν δέμας οὐκ ἐνόησα· καὶ οὐ νεμεσίζομαι ὕλῃ.	- uu - uu-u u - uu-uu --	dactylic hexameter	feminine penthemimeral, hepthemimeral, trithemimeral
μὴ διεροῖς στονόεντος ἐπ᾽ Εὐρώταο ῥεέθροις	- uu- uu-u u ---u u--	dactylic hexameter	feminine penthemimeral, trithemimeral
νηχομένην ἐκάλυψεν ὑποβρυχίην σε γαλήνη;	-uu- uu-u u-uu- u u--	dactylic hexameter	feminine penthemimeral, trithemimeral
ἀλλὰ καὶ ἐν ποταμοῖσι καὶ ἐν πελάγεσσι θαλάσσης	-u u - uu-u u - uu-u u--	dactylic hexameter	feminine penthemimeral, hepthemimeral, trithemimeral
νηιάδες ζώουσι καὶ οὐ κτείνουσι γυναῖκας.	-uu- --u u - --u u--	dactylic hexameter	feminine penthemimeral, hepthemimeral, trithemimeral
ὣς ἡ μὲν στενάχιζεν· ἀνακλίνουσα δὲ δειρὴν	- - - uu-u u---u u --	dactylic hexameter	feminine penthemimeral, trithemimeral
ὕπνον ἔπνει, θανάτοιο συνέμπορον· ἦ γὰρ ἐτύχθη	-u u- uu-u u-uu - u u--	dactylic hexameter	feminine penthemimeral, trithemimeral
ἄμφω ἀναγκαίη ξυνήια πάντα λαχόντε	-u u--- --uu -u u--	dactylic hexameter	masculine penthemimeral
ἔργα παλαιοτέροιο κασιγνήτοιο διώκειν.	-u u-uu-u u---u u--	dactylic hexameter	feminine penthemimeral
ἔνθεν ἀκηχεμένοισι βαρυνόμεναι βλεφάροισι	-u u-uu-u u-uu- uu--	dactylic hexameter	feminine penthemimeral
πολλάκις ὑπνώουσιν, ὅτε κλαίουσι, γυναῖκες.	-uu ---u u- --u u--	dactylic hexameter	feminine penthemimeral, hepthemimeral
ἡ μὲν ἀλητεύουσα δολοφροσύνῃσιν ὀνείρων	- u u---u u-uu-u u--	dactylic hexameter	feminine penthemimeral
μητέρα παπταίνειν ὠίσατο, τοῖα δὲ κούρη	-uu --- --uu -u u --	dactylic hexameter	masculine penthemimeral
ἴαχε θαμβήσασα καὶ ἀχνυμένη περ ἐοῦσα·	-uu ---u u --- u u--	dactylic hexameter	feminine penthemimeral
χθιζὸν ὀδυρομένην με δόμων ἔκτοσθε φυγοῦσα	-u u-uu- u u- --u u--	dactylic hexameter	masculine penthemimeral, hepthemimeral
κάλλιπες ὑπνώουσαν ὑπὲρ λεχέων γενετῆρος.	-uu ---u u- uu- uu--	dactylic hexameter	feminine penthemimeral, hepthemimeral
ποῖον ὄρος μεθέηκα; τίνας προλέλοιπα κολώνας;	-u u- uu-u u- uu-u u--	dactylic hexameter	feminine penthemimeral, hepthemimeral, trithemimeral
οὕτω καλλικόμοιο μεθ᾽ ἁρμονίην Ἀφροδίτης;	-- -uu-u u -uu- uu--	dactylic hexameter	feminine penthemimeral
τοῖα δὲ φωνήσασα προσέννεπε Τυνδαρεώνη·	-u u ---u u-uu -uu--	dactylic hexameter	feminine penthemimeral
τέκνον ἀκηχεμένη, μὴ μέμφεο δεινὰ παθούσῃ·	-u u-uu- - -uu -u u--	dactylic hexameter	masculine penthemimeral
ὁ χθιζός με μολών ἀπατήλιος ἥρπασεν ἀνήρ.	- -- u u- uu-uu -uu --	dactylic hexameter	masculine penthemimeral, trithemimeral
ἔννεπεν. ἡ δ᾽ἀνόρουσε καὶ οὐχ ὁρόωσα τιθήνην	-uu - uu-u u - uu-u u--	dactylic hexameter	feminine penthemimeral, hepthemimeral, trithemimeral
ὀξυτέρῃ πολὺ μᾶλλον ἀνεβρυχήσατο φωνῇ·	-uu- uu -u u---uu --	dactylic hexameter	feminine penthemimeral, trithemimeral
ἠερίης, ὄρνιθες, ἐύπτερα τέκνα γενέθλης,	-uu- --u u-uu -u u--	dactylic hexameter	feminine penthemimeral, trithemimeral
εἴπατε νοστήσαντες ἐπὶ Κρήτην Μενελάῳ·	-uu ---u u- -- uu--	dactylic hexameter	feminine penthemimeral, hepthemimeral
χθιζὸν ἐπὶ Σπάρτην τις ἀνὴρ ἀθεμίστιος ἐλθὼν	-u u- -- u u- uu-uu --	dactylic hexameter	masculine penthemimeral, hepthemimeral, trithemimeral
ἀγλαΐην ξύμπασαν ἑῶν ἀλάπαξε μελάθρων.	-uu- --u u- uu-u u--	dactylic hexameter	feminine penthemimeral, hepthemimeral, trithemimeral
ὣς ἡ μὲν πολύδακρυς ἐς ἠέρα φωνήσασα,	- - - uu-u u -uu ----	dactylic hexameter	feminine penthemimeral, trithemimeral
μητέρα μαστεύουσα, μάτην ἐπλάζετο κούρη.	-uu ---u u- --uu --	dactylic hexameter	feminine penthemimeral, hepthemimeral
καὶ Κικόνων πτολίεθρα καὶ Αἰολίδος πόρον Ἕλλης	- uu- uu-u u -uu- uu --	dactylic hexameter	feminine penthemimeral, trithemimeral
Δαρδανίης λιμένεσσιν ὁ νυμφίος ἤγαγε νύμφην.	-uu- uu-u u -uu -uu --	dactylic hexameter	feminine penthemimeral, trithemimeral
πυκνὰ δὲ τίλλε κόμην, χρυσέην δ᾽ἔρριψε καλύπτρην	-u u -u u- uu- --u u--	dactylic hexameter	masculine penthemimeral, hepthemimeral
Κασσάνδρη νεόφοιτον ἀπ᾽ ἀκροπόληος ἰδοῦσα.	--- uu-u u -uu-u u--	dactylic hexameter	feminine penthemimeral, trithemimeral
Τροίη δ᾽ὑψιδόμων πυλέων κληῖδας ἀνεῖσα	-- -uu- uu- --u u--	dactylic hexameter	masculine penthemimeral, hepthemimeral
δέξατο νοστήσαντα τὸν ἀρχέκακον πολιήτην.	-uu ---u u -uu- uu--	dactylic hexameter	feminine penthemimeral
