οἳ μὲν γὰρ Δρακάνῳ σ᾽,οἳ δ᾽Ἰκάρῳ ἠνεμοέσσῃ	- - - uu- - -uu -uu--	dactylic hexameter	masculine penthemimeral, trithemimeral
φάσʼ, οἳ δ᾽ἐν Νάξῳ, δῖον γένος, εἰραφιῶτα,	- - - -- -- uu -uu--	dactylic hexameter	masculine penthemimeral, hepthemimeral, trithemimeral
οἳ δέ σ᾽ἐπʼ Ἀλφειῷ ποταμῷ βαθυδινήεντι	- u u --- uu- uu----	dactylic hexameter	masculine penthemimeral, hepthemimeral
κυσαμένην Σεμέλην τεκέειν Διὶ τερπικεραύνῳ·	-uu- uu- uu- uu -uu--	dactylic hexameter	masculine penthemimeral, hepthemimeral, trithemimeral
ἄλλοι δ᾽ἐν Θήβῃσιν, ἄναξ, σε λέγουσι γενέσθαι,	-- - --u u- u u-u u--	dactylic hexameter	feminine penthemimeral, hepthemimeral, trithemimeral
ψευδόμενοι· σὲ δ᾽ἔτικτε πατὴρ ἀνδρῶν τε θεῶν τε	-uu- u u-u u- -- u u- -	dactylic hexameter	feminine penthemimeral, hepthemimeral, trithemimeral
πολλὸν ἀπʼ ἀνθρώπων, κρύπτων λευκώλενον Ἥρην.	-u u --- -- --uu --	dactylic hexameter	masculine penthemimeral, hepthemimeral
ἔστι δέ τις Νύση, ὕπατον ὄρος, ἀνθέον ὕλῃ,	-u u - uu -uu -- -uu --	dactylic hexameter	trithemimeral
τηλοῦ Φοινίκης, σχεδὸν Αἰγύπτοιο ῥοάων,	-- --- uu ---u u--	dactylic hexameter	masculine penthemimeral
καί οἱ ἀναστήσουσιν ἀγάλματα πόλλʼ ἐνὶ νηοῖς.	- u u---u u-uu - uu --	dactylic hexameter	feminine penthemimeral
ὣς δὲ τὰ μὲν τρία, σοὶ πάντως τριετηρίσιν αἰεὶ	- u u - uu - -- uu-uu --	dactylic hexameter	masculine penthemimeral, hepthemimeral, trithemimeral
ἄνθρωποι ῥέξουσι τεληέσσας ἑκατόμβας.	--- --u u--- uu--	dactylic hexameter	feminine penthemimeral, trithemimeral
ἦ καὶ κυανέῃσιν ἐπʼ ὀφρύσι νεῦσε Κρονίων·	- - -uu-u u -uu -u u--	dactylic hexameter	feminine penthemimeral
ἀμβρόσιαι δ᾽ἄρα χαῖται ἐπερρώσαντο ἄνακτος	-uu- uu -u u---u u--	dactylic hexameter	feminine penthemimeral, trithemimeral
κρατὸς ἀπʼ ἀθανάτοιο· μέγαν δ᾽ἐλέλιξεν Ὄλυμπον.	-u u -uu-u u- uu-u u--	dactylic hexameter	feminine penthemimeral, hepthemimeral
ὣς εἰπὼν ἐπένευσε καρήατι μητίετα Ζεύς.	- -- uu-u u-uu -uu- -	dactylic hexameter	feminine penthemimeral, trithemimeral
ἵληθʼ, εἰραφιῶτα, γυναιμανές· οἱ δέ σ᾽ἀοιδοὶ	-- -uu-u u-uu - u u--	dactylic hexameter	feminine penthemimeral
ᾁδομεν ἀρχόμενοι λήγοντές τ᾽·οὐδέ πῃ ἔστι	-uu -uu- --- -u u --	dactylic hexameter	masculine penthemimeral
σεῖʼ ἐπιληθομένῳ ἱερῆς μεμνῆσθαι ἀοιδῆς.	- uu-uu- uu- --u u--	dactylic hexameter	masculine penthemimeral, hepthemimeral
καὶ σὺ μὲν οὕτω χαῖρε, Διώνυσʼ εἰραφιῶτα,	- u u -- -u u-- -uu--	dactylic hexameter	feminine penthemimeral
σὺν μητρὶ Σεμέλῃ, ἥν περ καλέουσι Θυώνην.	- -- uu- - - uu-u u--	dactylic hexameter	masculine penthemimeral, hepthemimeral, trithemimeral
αἰδοίην, χρυσοστέφανον, καλὴν Ἀφροδίτην	--- --uu- -- uu--	dactylic hexameter	hepthemimeral, trithemimeral
ᾁσομαι, ἣ πάσης Κύπρου κρήδεμνα λέλογχεν	-uu - -- -- --u u--	dactylic hexameter	masculine penthemimeral, hepthemimeral, trithemimeral
εἰναλίης, ὅθι μιν Ζεφύρου μένος ὑγρὸν ἀέντος	-uu- uu - uu- uu -u u--	dactylic hexameter	masculine penthemimeral, hepthemimeral, trithemimeral
ἤνεικεν κατὰ κῦμα πολυφλοίσβοιο θαλάσσης	--- uu -u u---u u--	dactylic hexameter	feminine penthemimeral, trithemimeral
ἀφρῷ ἔνι μαλακῷ: τὴν δὲ χρυσάμπυκες Ὧραι	-u u- uu- - - --uu --	dactylic hexameter	masculine penthemimeral, hepthemimeral, trithemimeral
δέξαντ᾽ ἀσπασίως, περὶ δ᾽ἄμβροτα εἵματα ἕσσαν:	-- -uu- uu -uu -uu --	dactylic hexameter	masculine penthemimeral
κρατὶ δ᾽ἐπ᾽ ἀθανάτῳ στεφάνην εὔτυκτον ἔθηκαν	-u u -uu- uu- --u u--	dactylic hexameter	masculine penthemimeral, hepthemimeral
καλήν, χρυσείην: ἐν δὲ τρητοῖσι λοβοῖσιν	-- --- - - --u u--	dactylic hexameter	masculine penthemimeral, hepthemimeral
ἄνθεμ᾽ ὀρειχάλκου χρυσοῖό τε τιμήεντος:	-u u--- --u u ----	dactylic hexameter	masculine penthemimeral
δειρῇ δ᾽ἀμφ᾽ ἁπαλῇ καὶ στήθεσιν ἀργυφέοισιν	-- - uu- - -uu -uu--	dactylic hexameter	masculine penthemimeral, trithemimeral
ὅρμοισι χρυσέοισιν ἐκόσμεον, οἷσί περ αὐταὶ	--- uu-u u-uu -u u --	dactylic hexameter	feminine penthemimeral, trithemimeral
Ὧραι κοσμείσθην χρυσάμπυκες, ὁππότ᾽ ἴοιεν	-- --- --uu -u u--	dactylic hexameter	masculine penthemimeral
ἐς χορὸν ἱμερόεντα θεῶν καὶ δώματα πατρός.	- uu -uu-u u- - -uu --	dactylic hexameter	feminine penthemimeral, hepthemimeral
αὐτὰρ ἐπειδὴ πάντα περὶ χροῒ κόσμον ἔθηκαν,	-u u-- -u u- uu -u u--	dactylic hexameter	feminine penthemimeral, hepthemimeral
ἦγον ἐς ἀθανάτους: οἳ δ᾽ἠσπάζοντο ἰδόντες	-u u -uu- - ---u u--	dactylic hexameter	masculine penthemimeral
χερσί τ᾽ἐδεξιόωντο καὶ ἠρήσαντο ἕκαστος	-u u-uu-u u ---u u--	dactylic hexameter	feminine penthemimeral
εἶναι κουριδίην ἄλοχον καὶ οἴκαδ᾽ ἄγεσθαι,	-- -uu- uu- - -u u--	dactylic hexameter	masculine penthemimeral, hepthemimeral
εἶδος θαυμάζοντες ἰοστεφάνου Κυθερείης.	-- ---u u-uu- uu--	dactylic hexameter	feminine penthemimeral
χαῖρ᾽ ἑλικοβλέφαρε, γλυκυμείλιχε: δὸς δ᾽ἐν ἀγῶνι	- uu-uu- uu-uu - u u--	dactylic hexameter	masculine penthemimeral
νίκην τῷδε φέρεσθαι, ἐμὴν δ᾽ἔντυνον ἀοιδήν.	-- -u u-u u- --u u--	dactylic hexameter	feminine penthemimeral, hepthemimeral
αὐτὰρ ἐγὼ καὶ σεῖο καὶ ἄλλης μνήσομ᾽ ἀοιδῆς.	-u u- - -u u -- -u u--	dactylic hexameter	feminine penthemimeral, trithemimeral
ἀμφὶ Διώνυσον, Σεμέλης ἐρικυδέος υἱόν,	-u u--- uu- uu-uu --	dactylic hexameter	masculine penthemimeral, hepthemimeral
μνήσομαι, ὡς ἐφάνη παρὰ θῖν᾽ ἁλὸς ἀτρυγέτοιο	-uu - uu- uu - uu -uu--	dactylic hexameter	masculine penthemimeral, hepthemimeral, trithemimeral
ἀκτῇ ἔπι προβλῆτι νεηνίῃ ἀνδρὶ ἐοικώς,	-u u- --u u-uu -u u--	dactylic hexameter	feminine penthemimeral, trithemimeral
πρωθήβῃ: καλαὶ δὲ περισσείοντο ἔθειραι,	--- -- u u---u u--	dactylic hexameter	masculine penthemimeral, trithemimeral
κυάνεαι, φᾶρος δὲ περὶ στιβαροῖς ἔχεν ὤμοις	-uu- -- u u- uu- uu --	dactylic hexameter	masculine penthemimeral, hepthemimeral, trithemimeral
πορφύρεον: τάχα δ᾽ἄνδρες ἐυσσέλμου ἀπὸ νηὸς	-uu- uu -u u--- uu --	dactylic hexameter	feminine penthemimeral, trithemimeral
ληισταὶ προγένοντο θοῶς ἐπὶ οἴνοπα πόντον,	--- uu-u u- uu -uu --	dactylic hexameter	feminine penthemimeral, hepthemimeral, trithemimeral
Τυρσηνοί: τοὺς δ᾽ἦγε κακὸς μόρος: οἳ δὲ ἰδόντες	--- - -u u- uu - u u--	dactylic hexameter	feminine penthemimeral, hepthemimeral, trithemimeral
νεῦσαν ἐς ἀλλήλους, τάχα δ᾽ἔκθορον. αἶψα δ᾽ἑλόντες	-u u --- uu -uu -u u--	dactylic hexameter	masculine penthemimeral
εἷσαν ἐπὶ σφετέρης νηὸς κεχαρημένοι ἦτορ.	-u u- uu- -- uu-uu --	dactylic hexameter	masculine penthemimeral, hepthemimeral, trithemimeral
υἱὸν γάρ μιν ἔφαντο διοτρεφέων βασιλήων	-- - u u-u u-uu- uu--	dactylic hexameter	feminine penthemimeral, trithemimeral
εἶναι καὶ δεσμοῖς ἔθελον δεῖν ἀργαλέοισι.	-- - -- uu- - -uu--	dactylic hexameter	masculine penthemimeral, hepthemimeral, trithemimeral
τὸν δ᾽οὐκ ἴσχανε δεσμά, λύγοι δ᾽ἀπὸ τηλόσε πῖπτον	- - -uu -u u- uu -uu --	dactylic hexameter	feminine penthemimeral, hepthemimeral
χειρῶν ἠδὲ ποδῶν: ὃ δὲ μειδιάων ἐκάθητο	-- -u u- u u -uu- uu--	dactylic hexameter	masculine penthemimeral
ὄμμασι κυανέοισι: κυβερνήτης δὲ νοήσας	-uu -uu-u u--- u u--	dactylic hexameter	feminine penthemimeral
αὐτίκα οἷς ἑτάροισιν ἐκέκλετο φώνησέν τε:	-uu - uu-u u-uu --- -	dactylic hexameter	feminine penthemimeral, trithemimeral
δαιμόνιοι, τίνα τόνδε θεὸν δεσμεύεθ᾽ ἑλόντες,	-uu- uu -u u- --u u--	dactylic hexameter	feminine penthemimeral, hepthemimeral, trithemimeral
καρτερόν; οὐδὲ φέρειν δύναταί μιν νηῦς εὐεργής.	-uu -u u- uu- - - ---	dactylic hexameter	masculine penthemimeral, hepthemimeral
ἢ γὰρ Ζεὺς ὅδε γ᾽ἐστὶν ἢ ἀργυρότοξος Ἀπόλλων	- - - uu -u u -uu-u u--	dactylic hexameter	feminine penthemimeral, trithemimeral
ἠὲ Ποσειδάων: ἐπεὶ οὐ θνητοῖσι βροτοῖσιν	-u u--- uu - --u u--	dactylic hexameter	masculine penthemimeral, hepthemimeral
εἴκελος, ἀλλὰ θεοῖς, οἳ Ὀλύμπια δώματ᾽ ἔχουσιν.	-uu -u u- u u-uu -u u--	dactylic hexameter	masculine penthemimeral
ἀλλ᾽ ἄγετ᾽, αὐτὸν ἀφῶμεν ἐπ᾽ ἠπείροιο μελαίνης	- uu -u u-u u ---u u--	dactylic hexameter	feminine penthemimeral
αὐτίκα: μηδ᾽ ἐπὶ χεῖρας ἰάλλετε, μή τι χολωθεὶς	-uu - uu -u u-uu - u u--	dactylic hexameter	feminine penthemimeral, trithemimeral
ὄρσῃ ἔπ᾽ ἀργαλέους τ᾽ἀνέμους καὶ λαίλαπα πολλήν.	-u u -uu- uu- - -uu --	dactylic hexameter	masculine penthemimeral, hepthemimeral
Ὣς φάτο: τὸν δ᾽ἀρχὸς στυγερῷ ἠνίπαπε μύθῳ:	- uu - -- uu- --uu --	dactylic hexameter	masculine penthemimeral, hepthemimeral, trithemimeral
δαιμόνι᾽, οὖρον ὅρα, ἅμα δ᾽ἱστίον ἕλκεο νηὸς	-uu -u u- uu -uu -uu --	dactylic hexameter	masculine penthemimeral
σύμπανθ᾽ ὅπλα λαβών: ὅδε δ᾽αὖτ᾽ ἄνδρεσσι μελήσει.	-- -u u- uu - --u u--	dactylic hexameter	masculine penthemimeral, hepthemimeral
ἔλπομαι, ἢ Αἴγυπτον ἀφίξεται ἢ ὅ γε Κύπρον	-uu - --u u-uu - u u --	dactylic hexameter	feminine penthemimeral, trithemimeral
ἢ ἐς Ὑπερβορέους ἢ ἑκαστέρω: ἐς δὲ τελευτὴν	- u u-uu- u u-uu - u u--	dactylic hexameter	masculine penthemimeral
ἔκ ποτ᾽ ἐρεῖ αὐτοῦ τε φίλους καὶ κτήματα πάντα	- u u- -- u u- - -uu --	dactylic hexameter	masculine penthemimeral, hepthemimeral, trithemimeral
οὕς τε κασιγνήτους, ἐπεὶ ἡμῖν ἔμβαλε δαίμων.	- u u--- uu -- -uu --	dactylic hexameter	masculine penthemimeral
ὣς εἰπὼν ἱστόν τε καὶ ἱστίον ἕλκετο νηός.	- -- -- u u -uu -uu --	dactylic hexameter	masculine penthemimeral, trithemimeral
ἔμπνευσεν δ᾽ἄνεμος μέσον ἱστίον: ἀμφὶ δ᾽ἄρ᾽ ὅπλα	--- uu- uu -uu -u u --	dactylic hexameter	masculine penthemimeral, trithemimeral
καττάνυσαν: τάχα δέ σφιν ἐφαίνετο θαυματὰ ἔργα.	-uu- uu - u u-uu -uu --	dactylic hexameter	masculine penthemimeral, trithemimeral
οἶνος μὲν πρώτιστα θοὴν ἀνὰ νῆα μέλαιναν	-- - --u u- uu -u u--	dactylic hexameter	feminine penthemimeral, hepthemimeral, trithemimeral
ἡδύποτος κελάρυζ᾽ εὐώδης, ὤρνυτο δ᾽ὀδμὴ	-uu- uu- --- --- -	dactylic hexameter	masculine penthemimeral, trithemimeral
ἀμβροσίη: ναύτας δὲ τάφος λάβε πάντας ἰδόντας.	-uu- -- u u- uu -u u--	dactylic hexameter	masculine penthemimeral, hepthemimeral, trithemimeral
αὐτίκα δ᾽ἀκρότατον παρὰ ἱστίον ἐξετανύσθη	-uu -uu- uu -uu -uu--	dactylic hexameter	masculine penthemimeral
ἄμπελος ἔνθα καὶ ἔνθα, κατεκρημνῶντο δὲ πολλοὶ	-uu -u u -u u---u u --	dactylic hexameter	feminine penthemimeral
βότρυες: ἀμφ᾽ ἱστὸν δὲ μέλας εἱλίσσετο κισσός,	-uu - -- u u- --uu --	dactylic hexameter	masculine penthemimeral, hepthemimeral, trithemimeral
ἄνθεσι τηλεθάων, χαρίεις δ᾽ἐπὶ καρπὸς ὀρώρει:	-uu -uu- uu- uu -u u--	dactylic hexameter	masculine penthemimeral, hepthemimeral
πάντες δὲ σκαλμοὶ στεφάνους ἔχον: οἳ δὲ ἰδόντες,	-- - -- uu- uu - u u--	dactylic hexameter	masculine penthemimeral, hepthemimeral, trithemimeral
νῆ᾽ ἤδη τότ᾽ ἔπειτα κυβερνήτην ἐκέλευον	- -- u u-u u--- uu--	dactylic hexameter	feminine penthemimeral, trithemimeral
γῇ πελάαν: ὃ δ᾽ἄρα σφι λέων γένετ᾽ ἔνδοθι νηὸς	- uu- u u- u u- uu -uu --	dactylic hexameter	masculine penthemimeral, hepthemimeral, trithemimeral
δεινὸς ἐπ᾽ ἀκροτάτης, μέγα δ᾽ἔβραχεν, ἐν δ᾽ἄρα μέσσῃ	-u u -uu- uu -uu - uu --	dactylic hexameter	masculine penthemimeral
ἄρκτον ἐποίησεν λασιαύχενα, σήματα φαίνων:	-u u--- uu-uu -uu --	dactylic hexameter	masculine penthemimeral
ἂν δ᾽ἔστη μεμαυῖα: λέων δ᾽ἐπὶ σέλματος ἄκρου	- -- uu-u u- uu -uu --	dactylic hexameter	feminine penthemimeral, hepthemimeral, trithemimeral
δεινὸν ὑπόδρα ἰδών: οἳ δ᾽ἐς πρύμνην ἐφόβηθεν,	-u u-u u- - - -- uu--	dactylic hexameter	masculine penthemimeral, hepthemimeral
ἀμφὶ κυβερνήτην δὲ σαόφρονα θυμὸν ἔχοντα	-u u--- u u-uu -u u--	dactylic hexameter	masculine penthemimeral
ἔσταν ἄρ᾽ ἐκπληγέντες: ὃ δ᾽ἐξαπίνης ἐπορούσας	-u u ---u u -uu- uu--	dactylic hexameter	feminine penthemimeral
ἀρχὸν ἕλ᾽, οἳ δὲ θύραζε κακὸν μόρον ἐξαλύοντες	-u u - u u-u u- uu -uu--	dactylic hexameter	feminine penthemimeral, hepthemimeral, trithemimeral
πάντες ὁμῶς πήδησαν, ἐπεὶ ἴδον, εἰς ἅλα δῖαν,	-u u- --u u- uu - uu --	dactylic hexameter	feminine penthemimeral, hepthemimeral, trithemimeral
δελφῖνες δ᾽ἐγένοντο: κυβερνήτην δ᾽ἐλεήσας	--- uu-u u--- uu--	dactylic hexameter	feminine penthemimeral, trithemimeral
ἔσχεθε καί μιν ἔθηκε πανόλβιον εἶπέ τε μῦθον:	-uu - u u-u u-uu -u u --	dactylic hexameter	feminine penthemimeral, trithemimeral
θάρσει, †δῖε κάτωρ†, τῷ ἐμῷ κεχαρισμένε θυμῷ:	-- -u u- u u- uu-uu --	dactylic hexameter	masculine penthemimeral, hepthemimeral
εἰμὶ δ᾽ἐγὼ Διόνυσος ἐρίβρομος, ὃν τέκε μήτηρ	-u u- uu-u u-uu - uu --	dactylic hexameter	feminine penthemimeral, trithemimeral
Καδμηὶς Σεμέλη Διὸς ἐν φιλότητι μιγεῖσα.	-- --- uu - uu-u u--	dactylic hexameter	masculine penthemimeral, hepthemimeral
χαῖρε, τέκος Σεμέλης εὐώπιδος: οὐδέ πη ἔστι	-u u- uu- --uu -u u --	dactylic hexameter	masculine penthemimeral, trithemimeral
σεῖό γε ληθόμενον γλυκερὴν κοσμῆσαι ἀοιδήν.	-u u -uu- uu- --u u--	dactylic hexameter	masculine penthemimeral, hepthemimeral
Ἆρες ὑπερμενέτα, βρισάρματε, χρυσεοπήληξ,	-u u-uu- --uu -uu--	dactylic hexameter	masculine penthemimeral
ὀβριμόθυμε, φέρασπι, πολισσόε, χαλκοκορυστά,	-uu-u u-u u-uu -uu--	dactylic hexameter	feminine penthemimeral
καρτερόχειρ, ἀμόγητε, δορισθενές, ἕρκος Ὀλύμπου,	-uu- uu-u u-uu -u u--	dactylic hexameter	feminine penthemimeral, trithemimeral
Νίκης εὐπολέμοιο πάτερ, συναρωγὲ Θέμιστος,	-- -uu-u u- uu-u u--	dactylic hexameter	feminine penthemimeral, hepthemimeral
ἀντιβίοισι τύραννε, δικαιοτάτων ἀγὲ φωτῶν,	-uu-u u-u u-uu- uu --	dactylic hexameter	feminine penthemimeral
ἠνορέης σκηπτοῦχε, πυραυγέα κύκλον ἑλίσσων	-uu- --u u-uu -u u--	dactylic hexameter	feminine penthemimeral, trithemimeral
αἰθέρος ἑπταπόροις ἐνὶ τείρεσιν, ἔνθα σε πῶλοι	-uu -uu- uu -uu -u u --	dactylic hexameter	masculine penthemimeral
ζαφλεγέες τριτάτης ὑπὲρ ἄντυγος αἰὲν ἔχουσι·	-uu- uu- uu -uu -u u--	dactylic hexameter	masculine penthemimeral, trithemimeral
κλῦθι, βροτῶν ἐπίκουρε, δοτὴρ εὐθαρσέος ἥβης,	-u u- uu-u u- --uu --	dactylic hexameter	feminine penthemimeral, hepthemimeral, trithemimeral
πρηὺ καταστίλβων σέλας ὑψόθεν ἐς βιότητα	- ---- uu -uu - uu--	dactylic hexameter	masculine penthemimeral
ἡμετέρην καὶ κάρτος ἀρήιον, ὥς κε δυναίμην	-uu- - -u u-uu - u u--	dactylic hexameter	feminine penthemimeral, trithemimeral
σεύασθαι κακότητα πικρὴν ἀπʼ ἐμοῖο καρήνου,	--- uu-u u- u u-u u--	dactylic hexameter	feminine penthemimeral, hepthemimeral, trithemimeral
καὶ ψυχῆς ἀπατηλὸν ὑπογνάμψαι φρεσὶν ὁρμήν,	- -- uu-u u--- uu --	dactylic hexameter	feminine penthemimeral, trithemimeral
θυμοῦ αὖ μένος ὀξὺ κατισχέμεν, ὅς μ᾽ἐρέθῃσι	-- - uu -u u-uu - uu--	dactylic hexameter	feminine penthemimeral, trithemimeral
φυλόπιδος κρυερῆς ἐπιβαινέμεν· ἀλλὰ σὺ θάρσος	-uu- uu- uu-uu -u u --	dactylic hexameter	masculine penthemimeral, trithemimeral
δός, μάκαρ, εἰρήνης τε μένειν ἐν ἀπήμοσι θεσμοῖς	- uu --- u u- u u-uu --	dactylic hexameter	masculine penthemimeral, hepthemimeral
δυσμενέων προφυγόντα μόθον Κῆράς τε βιαίους.	-uu- uu-u u- -- u u--	dactylic hexameter	feminine penthemimeral, hepthemimeral, trithemimeral
Ἄρτεμιν ὕμνει, Μοῦσα, κασιγνήτην Ἑκάτοιο.	-uu -- -u u--- uu--	dactylic hexameter	feminine penthemimeral
παρθένον ἰοχέαιραν, ὁμότροφον Ἀπόλλωνος,	-uu -uu-u u-uu ----	dactylic hexameter	feminine penthemimeral
ἥθʼ ἵππους ἄρσασα βαθυσχοίνοιο Μέλητος	- -- --u u---u u--	dactylic hexameter	feminine penthemimeral, trithemimeral
ῥίμφα διὰ Σμύρνης παγχρύσεον ἅρμα διώκει	-u u- -- --uu -u u--	dactylic hexameter	masculine penthemimeral, trithemimeral
ἐς Κλάρον ἀμπελόεσσαν, ὅθʼ ἀργυρότοξος Ἀπόλλων	- uu -uu-u u -uu-u u--	dactylic hexameter	feminine penthemimeral
ἧσται μιμνάζων ἑκατηβόλον ἰοχέαιραν.	-- --- uu-uu -uu--	dactylic hexameter	masculine penthemimeral
καὶ σὺ μὲν οὕτω χαῖρε θεαί θ᾽ἅμα πᾶσαι ἀοιδῇ·	- u u -- -u u- uu -u u--	dactylic hexameter	feminine penthemimeral, hepthemimeral
αὐτὰρ ἐγώ σε πρῶτα καὶ ἐκ σέθεν ἄρχομʼ ἀείδειν,	-u u- - -u u - uu -u u--	dactylic hexameter	feminine penthemimeral, hepthemimeral, trithemimeral
σεῦ δ᾽ἐγὼ ἀρξάμενος μεταβήσομαι ἄλλον ἐς ὕμνον.	- uu -uu- uu-uu -u u --	dactylic hexameter	masculine penthemimeral
κυπρογενῆ Κυθέρειαν ἀείσομαι, ἥτε βροτοῖσι	-uu- uu-u u-uu -u u--	dactylic hexameter	feminine penthemimeral, trithemimeral
μείλιχα δῶρα δίδωσιν, ἐφ᾽ ἱμερτῷ δὲ προσώπῳ	-uu -u u-u u --- u u--	dactylic hexameter	feminine penthemimeral
αἰεὶ μειδιάει καὶ ἐφ᾽ ἱμερτὸν θέει ἄνθος.	-- -uu- u u --- uu --	dactylic hexameter	masculine penthemimeral
χαῖρε, θεά, Σαλαμῖνος ἐυκτιμένης μεδέουσα	-u u- uu-u u-uu- uu--	dactylic hexameter	feminine penthemimeral, trithemimeral
εἰναλίης τε Κύπρου: δὸς δ᾽ἱμερόεσσαν ἀοιδήν.	-uu- u u- - -uu-u u--	dactylic hexameter	masculine penthemimeral, trithemimeral
αὐτὰρ ἐγὼ καὶ σεῖο καὶ ἄλλης μνήσομ᾽ ἀοιδῆς.	-u u- - -u u -- -u u--	dactylic hexameter	feminine penthemimeral, trithemimeral
Παλλάδʼ Ἀθηναίην ἐρυσίπτολιν ἄρχομʼ ἀείδειν,	-u u--- uu-uu -u u--	dactylic hexameter	masculine penthemimeral
δεινήν, ᾗ σὺν Ἄρηι μέλει πολεμήια ἔργα	-- - u u-u u- uu-uu --	dactylic hexameter	feminine penthemimeral, hepthemimeral, trithemimeral
περθόμεναί τε πόληες ἀϋτή τε πτόλεμοί τε,	-uu- u u-u u-- - uu- -	dactylic hexameter	feminine penthemimeral, trithemimeral
καί τ᾽ἐρρύσατο λαὸν ἰόντα τε νισσόμενόν τε.	- --uu -u u-u u -uu- -	dactylic hexameter	feminine penthemimeral
χαῖρε, θεά, δὸς δ᾽ἄμμι τύχην εὐδαιμονίην τε.	-u u- - -u u- --uu- -	dactylic hexameter	feminine penthemimeral, hepthemimeral, trithemimeral
Ἥρην ἀείδω χρυσόθρονον, ἣν τέκε Ῥείη,	-- --- --uu - uu --	dactylic hexameter	masculine penthemimeral
ἀθανάτων βασίλειαν, ὑπείροχον εἶδος ἔχουσαν,	-uu- uu-u u-uu -u u--	dactylic hexameter	feminine penthemimeral, trithemimeral
Ζην`?̀ς ἐριγδούποιο κασιγνήτην ἄλοχόν τε,	- ----u u--- uu- -	dactylic hexameter	feminine penthemimeral
κυδρήν, ἣν πάντες μάκαρες κατὰ μακρὸν Ὄλυμπον	-- - -- uu- uu -u u--	dactylic hexameter	masculine penthemimeral, hepthemimeral, trithemimeral
ἁζόμενοι τίουσιν ὁμῶς Διὶ τερπικεραύνῳ.	-uu- --u u- uu -uu--	dactylic hexameter	feminine penthemimeral, hepthemimeral, trithemimeral
Δημήτρ᾽ ἠύκομον, σεμνὴν θεάν, ἄρχομ᾽ ἀείδειν,	-- -uu- -- uu -u u--	dactylic hexameter	masculine penthemimeral, hepthemimeral
αὐτὴν καὶ κούρην, περικαλλέα Περσεφόνειαν.	-- - -- uu-uu -uu--	dactylic hexameter	masculine penthemimeral, trithemimeral
χαῖρε, θεά, καὶ τήνδε σάου πόλιν: ἄρχε δ᾽ἀοιδῆς.	-u u- - -u u- uu -u u--	dactylic hexameter	feminine penthemimeral, hepthemimeral, trithemimeral
μητέρα μοι πάντων τε θεῶν πάντων τ᾽ἀνθρώπων	-uu - -- u u- -- ---	dactylic hexameter	masculine penthemimeral, hepthemimeral, trithemimeral
ὕμνει, Μοῦσα λίγεια, Διὸς θυγάτηρ μεγάλοιο,	-- -u u-u u- uu- uu--	dactylic hexameter	feminine penthemimeral, hepthemimeral
ᾗ κροτάλων τυπάνων τ᾽ἰαχὴ σύν τε βρόμος αὐλῶν	- uu- uu- uu- - - uu --	dactylic hexameter	masculine penthemimeral, hepthemimeral, trithemimeral
εὔαδεν ἠδὲ λύκων κλαγγὴ χαροπῶν τε λεόντων	-uu -u u- -- uu- u u--	dactylic hexameter	masculine penthemimeral, hepthemimeral
οὔρεά τ᾽ἠχήεντα καὶ ὑλήεντες ἔναυλοι.	-uu ---u u ---u u--	dactylic hexameter	feminine penthemimeral
καὶ σὺ μὲν οὕτω χαῖρε θεαί θ᾽ἅμα πᾶσαι ἀοιδῇ.	- u u -- -u u- uu -u u--	dactylic hexameter	feminine penthemimeral, hepthemimeral
Ἡρακλέα, Διὸς υἱόν, ἀείσομαι, ὃν μέγʼ ἄριστον	-uu- uu -u u-uu - u u--	dactylic hexameter	feminine penthemimeral, trithemimeral
γείνατʼ ἐπιχθονίων Θήβῃς ἔνι καλλιχόροισιν	-u u--- -- uu -uu--	dactylic hexameter	masculine penthemimeral, hepthemimeral
Ἀλκμήνη μιχθεῖσα κελαινεφέι Κρονίωνι·	--- -- --uu- uu--	dactylic hexameter	masculine penthemimeral, trithemimeral
ὃς πρὶν μὲν κατὰ γαῖαν ἀθέσφατον ἠδὲ θάλασσαν	- - - uu -u u-uu -u u--	dactylic hexameter	feminine penthemimeral, trithemimeral
πλαζόμενος πομπῇσιν ὕπʼ Εὐρυσθῆος ἄνακτος	-uu- --u u ---u u--	dactylic hexameter	feminine penthemimeral, trithemimeral
πολλὰ μὲν αὐτὸς ἔρεξεν ἀτάσθαλα, πολλὰ δ᾽ἀνέτλη·	-u u -u u-u u-uu -u --	lyric	
νῦν δ᾽ἤδη κατὰ καλὸν ἕδος νιφόεντος Ὀλύμπου	- -- uu -u u- uu-u u--	dactylic hexameter	feminine penthemimeral, hepthemimeral, trithemimeral
ναίει τερπόμενος καὶ ἔχει καλλίσφυρον Ἥβην.	-- -uu- u u- --uu --	dactylic hexameter	masculine penthemimeral, hepthemimeral
χαῖρε, ἄναξ, Διὸς υἱέ· δίδου δ᾽ἀρετήν τε καὶ ὄλβον.	-u u- uu -u u- uu- u u --	dactylic hexameter	feminine penthemimeral, hepthemimeral, trithemimeral
ἰητῆρα νόσων Ἀσκληπιὸν ἄρχομʼ ἀείδειν,	---u u- --uu -u u--	dactylic hexameter	masculine penthemimeral
υἱὸν Ἀπόλλωνος, τὸν ἐγείνατο δῖα Κορωνὶς	-u u--- u u-uu -u u--	dactylic hexameter	masculine penthemimeral
Δωτίῳ ἐν πεδίῳ, κούρη Φλεγύου βασιλῆος,	-uu - uu- -- uu- uu--	dactylic hexameter	masculine penthemimeral, hepthemimeral, trithemimeral
χάρμα μέγʼ ἀνθρώποισι, κακῶν θελκτῆρʼ ὀδυνάων.	-u u ---u u- -- uu--	dactylic hexameter	feminine penthemimeral, hepthemimeral
καὶ σὺ μὲν οὕτω χαῖρε, ἄναξ· λίτομαι δέ σʼἀοιδῇ.	- u u -- -u u- uu- u u--	dactylic hexameter	feminine penthemimeral, hepthemimeral
Κάστορα καὶ Πολυδεύκἐ ἀείσεο, Μοῦσα λίγεια,	-uu - uu-u u-uu -u u--	dactylic hexameter	feminine penthemimeral, trithemimeral
Τυνδαρίδας, οἳ Ζηνὸς Ὀλυμπίου ἐξεγένοντο·	-uu- - -u u-uu -uu--	dactylic hexameter	feminine penthemimeral, trithemimeral
τοὺς ὑπὸ Τηϋγέτου κορυφῇς τέκε πότνια Λήδη	- uu -uu- uu- uu -uu --	dactylic hexameter	masculine penthemimeral, hepthemimeral
λάθρη ὑποδμηθεῖσα κελαινεφέι Κρονίωνι.	-u u--- --uu- uu--	dactylic hexameter	masculine penthemimeral
χαίρετε, Τυνδαρίδαι, ταχέων ἐπιβήτορες ἵππων.	-uu -uu- uu- uu-uu --	dactylic hexameter	masculine penthemimeral, hepthemimeral
Ἑρμῆν ἀείδω Κυλλήνιον, Ἀργειφόντην,	-- --- --uu ----	dactylic hexameter	masculine penthemimeral
Κυλλήνης μεδέοντα καὶ Ἀρκαδίης πολυμήλου,	--- uu-u u -uu- uu--	dactylic hexameter	feminine penthemimeral, trithemimeral
ἄγγελον ἀθανάτων ἐριούνιον, ὃν τέκε Μαῖα,	-uu -uu- uu-uu - uu --	dactylic hexameter	masculine penthemimeral
Ατλαντος θυγάτηρ, Διὸς ἐν φιλότητι μιγεῖσα,	-- --- uu - uu-u u--	dactylic hexameter	masculine penthemimeral, hepthemimeral
αἰδοίη: μακάρων δὲ θεῶν ἀλέεινεν ὅμιλον,	--- uu- u u- uu-u u--	dactylic hexameter	masculine penthemimeral, hepthemimeral, trithemimeral
ἄντρῳ ναιετάουσα παλισκίῳ: ἔνθα Κρονίων	-- -uu-u u-uu -u u--	dactylic hexameter	feminine penthemimeral
νύμφῃ ἐυπλοκάμῳ μισγέσκετο νυκτὸς ἀμολγῷ,	-u u-uu- --uu -u u--	dactylic hexameter	masculine penthemimeral
εὖτε κατὰ γλυκὺς ὕπνος ἔχοι λευκώλενον Ἥρην:	-u u- uu -u u- --uu --	dactylic hexameter	feminine penthemimeral, hepthemimeral, trithemimeral
λάνθανε δ᾽ἀθανάτους τε θεοὺς θνητούς τ᾽ἀνθρώπους.	-uu -uu- u u- -- ---	dactylic hexameter	masculine penthemimeral, hepthemimeral
καὶ σὺ μὲν οὕτω χαῖρε, Διὸς καὶ Μαιάδος υἱέ:	- u u -- -u u- - -uu --	dactylic hexameter	feminine penthemimeral, hepthemimeral
σεῦ δ᾽ἐγὼ ἀρξάμενος μεταβήσομαι ἄλλον ἐς ὕμνον.	- uu -uu- uu-uu -u u --	dactylic hexameter	masculine penthemimeral
[χαῖρ᾽. Ἑρμῆ χαριδῶτα, διάκτορε, δῶτορ ἐάων.	- -- uu-u u-uu -u u--	dactylic hexameter	feminine penthemimeral, trithemimeral
ἀμφί μοι Ἑρμείαο φίλον γόνον ἔννεπε, Μοῦσα,	-u u ---u u- uu -uu --	dactylic hexameter	feminine penthemimeral, hepthemimeral
αἰγιπόδην, δικέρωτα, φιλόκροτον, ὅστ᾽ ἀνὰ πίση	-uu- uu-u u-uu - uu --	dactylic hexameter	feminine penthemimeral, trithemimeral
δενδρήεντ᾽ ἄμυδις φοιτᾷ χορογηθέσι νύμφαις,	--- uu- -- uu-uu --	dactylic hexameter	masculine penthemimeral, hepthemimeral, trithemimeral
αἵ τε κατ᾽ αἰγίλιπος πέτρης στείβουσι κάρηνα	- u u -uu- -- --u u--	dactylic hexameter	masculine penthemimeral, hepthemimeral
Πᾶν᾽ ἀνακεκλόμεναι, νόμιον θεόν, ἀγλαέθειρον,	- uu-uu- uu- uu -uu--	dactylic hexameter	masculine penthemimeral, hepthemimeral
αὐχμήενθ᾽, ὃς πάντα λόφον νιφόεντα λέλογχε	--- - -u u- uu-u u--	dactylic hexameter	feminine penthemimeral, hepthemimeral, trithemimeral
καὶ κορυφὰς ὀρέων καὶ πετρήεντα κάρηνα.	- uu- uu- - ---u u--	dactylic hexameter	masculine penthemimeral, trithemimeral
φοιτᾷ δ᾽ἔνθα καὶ ἔνθα διὰ ῥωπήια πυκνά,	-- -u u -u u- --uu --	dactylic hexameter	feminine penthemimeral, hepthemimeral
ἄλλοτε μὲν ῥείθροισιν ἐφελκόμενος μαλακοῖσιν,	-uu - --u u-uu- uu--	dactylic hexameter	feminine penthemimeral, trithemimeral
ἄλλοτε δ᾽αὖ πέτρῃσιν ἐν ἠλιβάτοισι διοιχνεῖ,	-uu - --u u -uu-u --	lyric	
ἀκροτάτην κορυφὴν μηλοσκόπον εἰσαναβαίνων.	-uu- uu- --uu -uu--	dactylic hexameter	masculine penthemimeral, trithemimeral
πολλάκι δ᾽ἀργινόεντα διέδραμεν οὔρεα μακρά,	-uu -uu-u u-uu -uu --	dactylic hexameter	feminine penthemimeral
πολλάκι δ᾽ἐν κνημοῖσι διήλασε θῆρας ἐναίρων,	-uu - --u u-uu -u u--	dactylic hexameter	feminine penthemimeral, trithemimeral
ὀξέα δερκόμενος: τότε δ᾽ἕσπερος ἔκλαγεν οἶον	-uu -uu- uu -uu -uu --	dactylic hexameter	masculine penthemimeral
ἄγρης ἐξανιών, δονάκων ὕπο μοῦσαν ἀθύρων	-- -uu- uu- uu -u u--	dactylic hexameter	masculine penthemimeral, hepthemimeral
νήδυμον: οὐκ ἂν τόν γε παραδράμοι ἐν μελέεσσιν	-uu - - - u u-uu - uu--	dactylic hexameter	masculine penthemimeral, trithemimeral
ὄρνις, ἥτ᾽ ἔαρος πολυανθέος ἐν πετάλοισι	-- - uu- uu-uu - uu--	dactylic hexameter	masculine penthemimeral, trithemimeral
θρῆνον ἐπιπροχέουσ᾽ ἀχέει μελίγηρυν ἀοιδήν.	-u u-uu- uu- uu-u u--	dactylic hexameter	masculine penthemimeral, hepthemimeral
σὺν δέ σφιν τότε Νύμφαι ὀρεστιάδες λιγύμολποι	- - - uu -u u-uu- uu--	dactylic hexameter	feminine penthemimeral, trithemimeral
φοιτῶσαι πύκα ποσσὶν ἐπὶ κρήνῃ μελανύδρῳ	--- uu -u u- -- uu--	dactylic hexameter	feminine penthemimeral, hepthemimeral, trithemimeral
μέλπονται: κορυφὴν δὲ περιστένει οὔρεος Ἠχώ:	--- uu- u u-uu -uu --	dactylic hexameter	masculine penthemimeral, trithemimeral
δαίμων δ᾽ἔνθα καὶ ἔνθα χορῶν, τοτὲ δ᾽ἐς μέσον ἕρπων,	-- -u u -u u- uu - uu --	dactylic hexameter	feminine penthemimeral, hepthemimeral
πυκνὰ ποσὶν διέπει, λαῖφος δ᾽ἐπὶ νῶτα δαφοινὸν	-u u- uu- -- uu -u u--	dactylic hexameter	masculine penthemimeral, hepthemimeral, trithemimeral
λυγκὸς ἔχει, λιγυρῇσιν ἀγαλλόμενος φρένα μολπαῖς	-u u- uu-u u-uu- uu --	dactylic hexameter	feminine penthemimeral, trithemimeral
ἐν μαλακῷ λειμῶνι, τόθι κρόκος ἠδ᾽ ὑάκινθος	- uu- --u u- uu - uu--	dactylic hexameter	feminine penthemimeral, hepthemimeral, trithemimeral
εὐώδης θαλέθων καταμίσγεται ἄκριτα ποίῃ.	--- uu- uu-uu -uu --	dactylic hexameter	masculine penthemimeral, trithemimeral
ὑμνεῦσιν δὲ θεοὺς μάκαρας καὶ μακρὸν Ὄλυμπον:	--- u u- uu- - -u u--	dactylic hexameter	masculine penthemimeral, hepthemimeral, trithemimeral
οἷόν θ᾽Ἑρμείην ἐριούνιον ἔξοχον ἄλλων	-- --- uu-uu -uu --	dactylic hexameter	masculine penthemimeral
ἔννεπον, ὡς ὅ γ᾽ἅπασι θεοῖς θοὸς ἄγγελός ἐστι,	-uu - u u-u u- uu -uu --	dactylic hexameter	feminine penthemimeral, hepthemimeral, trithemimeral
καί ῥ᾽ὅ γ᾽ἐς Ἀρκαδίην πολυπίδακα, μητέρα μήλων,	- u u -uu- uu-uu -uu --	dactylic hexameter	masculine penthemimeral
ἐξίκετ᾽, ἔνθα τέ οἱ τέμενος Κυλληνίου ἐστίν.	-uu -u u - uu- --uu --	dactylic hexameter	masculine penthemimeral, hepthemimeral
ἔνθ᾽ ὅ γε καὶ θεὸς ὢν ψαφαρότριχα μῆλ᾽ ἐνόμευεν	- u u - uu - uu-uu - uu--	dactylic hexameter	masculine penthemimeral, trithemimeral
ἀνδρὶ πάρα θνητῷ θάλε γὰρ πόθος ὑγρὸς ἐπελθὼν	-u u- -- uu - uu -u u--	dactylic hexameter	masculine penthemimeral, hepthemimeral, trithemimeral
νύμφῃ ἐυπλοκάμῳ Δρύοπος φιλότητι μιγῆναι:	-u u-uu- uu- uu-u u--	dactylic hexameter	masculine penthemimeral, hepthemimeral
ἐκ δ᾽ἐτέλεσσε γάμον θαλερόν. τέκε δ᾽ἐν μεγάροισιν	- uu-u u- uu- uu - uu--	dactylic hexameter	masculine penthemimeral, hepthemimeral
Ἑρμείῃ φίλον υἱόν, ἄφαρ τερατωπὸν ἰδέσθαι,	--- uu -u u- uu-u u--	dactylic hexameter	feminine penthemimeral, hepthemimeral, trithemimeral
αἰγιπόδην, δικέρωτα, φιλόκροτον, ἡδυγέλωτα:	-uu- uu-u u-uu -uu--	dactylic hexameter	feminine penthemimeral, trithemimeral
φεῦγε δ᾽ἀναΐξασα, λίπεν δ᾽ἄρα παῖδα τιθήνη	-u u-uu- -- uu -u u--	dactylic hexameter	masculine penthemimeral, hepthemimeral
δεῖσε γάρ, ὡς ἴδεν ὄψιν ἀμείλιχον, ἠυγένειον.	-u u - uu -u u-uu -uu--	dactylic hexameter	feminine penthemimeral, trithemimeral
τὸν δ᾽αἶψ᾽ Ἑρμείας ἐριούνιος εἰς χέρα θῆκε	- - --- uu-uu - uu --	dactylic hexameter	masculine penthemimeral
δεξάμενος, χαῖρεν δὲ νόῳ περιώσια δαίμων.	-uu- -- u u- uu-uu --	dactylic hexameter	masculine penthemimeral, hepthemimeral, trithemimeral
ῥίμφα δ᾽ἐς ἀθανάτων ἕδρας κίε παῖδα καλύψας	-u u -uu- -- uu -u u--	dactylic hexameter	masculine penthemimeral, hepthemimeral
δέρμασιν ἐν πυκινοῖσιν ὀρεσκῴοιο λαγωοῦ	-uu - uu-u u---u u--	dactylic hexameter	feminine penthemimeral, trithemimeral
πὰρ δὲ Ζηνὶ κάθιζε καὶ ἄλλοις ἀθανάτοισι,	- - -u u-u u -- -uu--	dactylic hexameter	feminine penthemimeral
δεῖξε δὲ κοῦρον ἑόν: πάντες δ᾽ἄρα θυμὸν ἔτερφθεν	-u u -u u- -- uu -u u--	dactylic hexameter	masculine penthemimeral, hepthemimeral
ἀθάνατοι, περίαλλα δ᾽ὁ Βάκχειος Διόνυσος:	-uu- uu-u u --- uu--	dactylic hexameter	feminine penthemimeral, trithemimeral
Πᾶνα δέ μιν καλέεσκον, ὅτι φρένα πᾶσιν ἔτερψε.	-u u - uu-u u- uu -u u--	dactylic hexameter	feminine penthemimeral, hepthemimeral, trithemimeral
καὶ σὺ μὲν οὕτω χαῖρε, ἄναξ, ἵλαμαι δέ σ᾽ἀοιδῇ	- u u -- -u u- uu- u u--	dactylic hexameter	feminine penthemimeral, hepthemimeral
αὐτὰρ ἐγὼ καὶ σεῖο καὶ ἄλλης μνήσομ᾽ ἀοιδῆς.	-u u- - -u u -- -u u--	dactylic hexameter	feminine penthemimeral, trithemimeral
Ἥφαιστον κλυτόμητιν ἀείσεο, Μοῦσα λίγεια,	--- uu-u u-uu -u u--	dactylic hexameter	feminine penthemimeral, trithemimeral
ὃς μετʼ Ἀθηναίης γλαυκώπιδος ἀγλαὰ ἔργα	- u u--- --uu -uu --	dactylic hexameter	masculine penthemimeral
ἀνθρώπους ἐδίδαξεν ἐπὶ χθονός, οἳ τὸ πάρος περ	--- uu-u u- uu - u u- -	dactylic hexameter	feminine penthemimeral, hepthemimeral, trithemimeral
ἄντροις ναιετάασκον ἐν οὔρεσιν, ἠύτε θῆρες.	-- -uu-u u -uu -uu --	dactylic hexameter	feminine penthemimeral
νῦν δὲ διʼ Ἥφαιστον κλυτοτέχνην ἔργα δαέντες	- u u --- uu- -- ---	dactylic hexameter	masculine penthemimeral, hepthemimeral
ῥηιδίως αἰῶνα τελεσφόρον εἰς ἐνιαυτὸν	-uu- --u u-uu - uu--	dactylic hexameter	feminine penthemimeral, trithemimeral
εὔκηλοι διάγουσιν ἐνὶ σφετέροισι δόμοισιν.	--- uu-u u- uu-u u--	dactylic hexameter	feminine penthemimeral, hepthemimeral, trithemimeral
ἀλλʼ ἵληθʼ, Ἥφαιστε· δίδου δ᾽ἀρετήν τε καὶ ὄλβον.	- -- --u u- uu- u u --	dactylic hexameter	feminine penthemimeral, hepthemimeral, trithemimeral
φοῖβε, σὲ μὲν καὶ κύκνος ὑπὸ πτερύγων λίγʼ ἀείδει,	-u u - - -u u- uu- u u--	dactylic hexameter	feminine penthemimeral, hepthemimeral, trithemimeral
ὄχθῃ ἐπιθρώσκων ποταμὸν πάρα δινήεντα,	- ---- uu- uu ----	dactylic hexameter	masculine penthemimeral, hepthemimeral
Πηνειόν· σὲ δ᾽ἀοιδὸς ἔχων φόρμιγγα λίγειαν	--- u u-u u- --u u--	dactylic hexameter	feminine penthemimeral, hepthemimeral, trithemimeral
ἡδυεπὴς πρῶτόν τε καὶ ὕστατον αἰὲν ἀείδει.	-uu- -- u u -uu -u u--	dactylic hexameter	masculine penthemimeral, trithemimeral
καὶ σὺ μὲν οὕτω χαῖρε, ἄναξ, ἵλαμαι δέ σ᾽ἀοιδῇ.	- u u -- -u u- uu- u u--	dactylic hexameter	feminine penthemimeral, hepthemimeral
ἀμφὶ Ποσειδάωνα, μέγαν θεόν, ἄρχομʼ ἀείδειν,	-u u---u u- uu -u u--	dactylic hexameter	feminine penthemimeral, hepthemimeral
γαίης κινητῆρα καὶ ἀτρυγέτοιο θαλάσσης,	-- ---u u -uu-u u--	dactylic hexameter	feminine penthemimeral
πόντιον, ὅσθʼ Ἑλικῶνα καὶ εὐρείας ἔχει Αἰγάς.	-uu - uu-u u --- uu --	dactylic hexameter	feminine penthemimeral, trithemimeral
διχθά τοι, Ἐννοσίγαιε, θεοὶ τιμὴν ἐδάσαντο,	- - -uu-u u- -- uu--	dactylic hexameter	feminine penthemimeral, hepthemimeral
ἵππων τε δμητῆρʼ ἔμεναι σωτῆρά τε νηῶν.	-- - -- uu- --u u --	dactylic hexameter	masculine penthemimeral, hepthemimeral, trithemimeral
χαῖρε, Ποσείδαον γαιήοχε, κυανοχαῖτα,	-u u--- --uu -uu--	dactylic hexameter	masculine penthemimeral
καί, μάκαρ, εὐμενὲς ἦτορ ἔχων πλώουσιν ἄρηγε.	- uu -uu -u u- --u u--	dactylic hexameter	feminine penthemimeral, hepthemimeral
Ζῆνα θεῶν τὸν ἄριστον ἀείσομαι ἠδὲ μέγιστον,	-u u- u u-u u-uu -u u--	dactylic hexameter	feminine penthemimeral, trithemimeral
εὐρύοπα, κρείοντα, τελεσφόρον, ὅστε Θέμιστι	-uu- --u u-uu -u u--	dactylic hexameter	feminine penthemimeral, trithemimeral
ἐγκλιδὸν ἑζομένῃ πυκινοὺς ὀάρους ὀαρίζει.	-uu -uu- uu- uu- uu--	dactylic hexameter	masculine penthemimeral, hepthemimeral
ἵληθʼ, εὐρύοπα Κρονίδη, κύδιστε μέγιστε.	-- -uu- uu- --u u--	dactylic hexameter	masculine penthemimeral, hepthemimeral
ἑστίη, ἥτε ἄνακτος Ἀπόλλωνος ἑκάτοιο	-uu -u u-u u--- uu--	dactylic hexameter	feminine penthemimeral
Πυθοῖ ἐν ἠγαθέῃ ἱερὸν δόμον ἀμφιπολεύεις,	-u u -uu- uu- uu -uu--	dactylic hexameter	masculine penthemimeral, hepthemimeral
αἰεὶ σῶν πλοκάμων ἀπολείβεται ὑγρὸν ἔλαιον·	-- - uu- uu-uu -u u--	dactylic hexameter	masculine penthemimeral, trithemimeral
ἔρχεο τόνδʼ ἀνὰ οἶκον, ἕνʼ ἔρχεο θυμὸν ἔχουσα	-uu - uu -u u -uu -u u--	dactylic hexameter	feminine penthemimeral, trithemimeral
σὺν Διὶ μητιόεντι· χάριν δ᾽ἅμʼ ὄπασσον ἀοιδῇ.	- uu -uu-u u- u u-u u--	dactylic hexameter	feminine penthemimeral, hepthemimeral
μουσάων ἄρχωμαι Ἀπόλλωνός τε Διός τε·	--- --u u--- u u- -	dactylic hexameter	feminine penthemimeral, trithemimeral
ἐκ γὰρ Μουσάων καὶ ἑκηβόλου Ἀπόλλωνος	- - --- u u-uu ----	dactylic hexameter	masculine penthemimeral
ἄνδρες ἀοιδοὶ ἔασιν ἐπὶ χθονὶ καὶ κιθαρισταί,	-u u-u u-u u- uu - uu--	dactylic hexameter	feminine penthemimeral, hepthemimeral
ἐκ δὲ Διὸς βασιλῆες· ὃ δ᾽ὄλβιος, ὅν τινα Μοῦσαι	- u u- uu-u u -uu - uu --	dactylic hexameter	feminine penthemimeral, trithemimeral
φίλωνται· γλυκερή οἱ ἀπὸ στόματος ῥέει αὐδή.	--- uu- u u- uu- uu --	dactylic hexameter	masculine penthemimeral, hepthemimeral, trithemimeral
χαίρετε, τέκνα Διός, καὶ ἐμὴν τιμήσατʼ ἀοιδήν·	-uu -u u- u u- --u u--	dactylic hexameter	masculine penthemimeral, hepthemimeral
αὐτὰρ ἐγὼν ὑμέων τε καὶ ἄλλης μνήσομʼ ἀοιδῆς.	-u u- uu- u u -- -u u--	dactylic hexameter	masculine penthemimeral, trithemimeral
κισσοκόμην Διόνυσον ἐρίβρομον ἄρχομʼ ἀείδειν,	-uu- uu-u u-uu -u u--	dactylic hexameter	feminine penthemimeral, trithemimeral
Ζηνὸς καὶ Σεμέλης ἐρικυδέος ἀγλαὸν υἱόν,	-- - uu- uu-uu -uu --	dactylic hexameter	masculine penthemimeral, trithemimeral
ὃν τρέφον ἠύκομοι Νύμφαι παρὰ πατρὸς ἄνακτος	- uu -uu- -- uu -u u--	dactylic hexameter	masculine penthemimeral, hepthemimeral
δεξάμεναι κόλποισι καὶ ἐνδυκέως ἀτίταλλον	-uu- --u u -uu- uu--	dactylic hexameter	feminine penthemimeral, trithemimeral
Νύσης ἐν γυάλοις· ὃ δ᾽ἀέξετο πατρὸς ἕκητι	-- - uu- u u-uu -u u--	dactylic hexameter	masculine penthemimeral, trithemimeral
ἄντρῳ ἐν εὐώδει μεταρίθμιος ἀθανάτοισιν.	-u u --- uu-uu -uu--	dactylic hexameter	masculine penthemimeral
αὐτὰρ ἐπειδὴ τόνδε θεαὶ πολύυμνον ἔθρεψαν,	-u u-- -u u- uu-u u--	dactylic hexameter	feminine penthemimeral, hepthemimeral
δὴ τότε φοιτίζεσκε καθʼ ὑλήεντας ἐναύλους,	- uu ---u u ---u u--	dactylic hexameter	feminine penthemimeral
κισσῷ καὶ δάφνῃ πεπυκασμένος· αἳ δ᾽ἅμʼ ἕποντο	-- - -- uu-uu - u u--	dactylic hexameter	masculine penthemimeral, trithemimeral
Νύμφαι, ὃ δ᾽ἐξηγεῖτο· βρόμος δ᾽ἔχεν ἄσπετον ὕλην.	-u u ---u u- uu -uu --	dactylic hexameter	feminine penthemimeral, hepthemimeral
καὶ σὺ μὲν οὕτω χαῖρε, πολυστάφυλʼ ὦ Διόνυσε·	- u u -- -u u-uu - uu--	dactylic hexameter	feminine penthemimeral
δὸς δ᾽ἡμᾶς χαίροντας ἐς ὥρας αὖτις ἱκέσθαι,	- -- --u u -- -u u--	dactylic hexameter	feminine penthemimeral, trithemimeral
ἐκ δ᾽αὖθʼ ὡράων εἰς τοὺς πολλοὺς ἐνιαυτούς.	- - --- - - -- uu--	dactylic hexameter	masculine penthemimeral, hepthemimeral
Ἄρτεμιν ἀείδω χρυσηλάκατον, κελαδεινήν,	-uu --- --uu- uu--	dactylic hexameter	masculine penthemimeral
παρθένον αἰδοίην, ἐλαφηβόλον, ἰοχέαιραν,	-uu --- uu-uu -uu--	dactylic hexameter	masculine penthemimeral
αὐτοκασιγνήτην χρυσαόρου Ἀπόλλωνος,	-uu--- --uu ----	dactylic hexameter	masculine penthemimeral
ἣ κατ᾽ ὄρη σκιόεντα καὶ ἄκριας ἠνεμοέσσας	- u u- uu-u u -uu -uu--	dactylic hexameter	feminine penthemimeral, trithemimeral
ἄγρῃ τερπομένη παγχρύσεα τόξα τιταίνει	-- -uu- --uu -u u--	dactylic hexameter	masculine penthemimeral
πέμπουσα στονόεντα βέλη: τρομέει δὲ κάρηνα	--- uu-u u- uu- u u--	dactylic hexameter	feminine penthemimeral, hepthemimeral, trithemimeral
ὑψηλῶν ὀρέων, ἰάχει δ᾽ἔπι δάσκιος ὕλη	--- uu- uu- uu -uu --	dactylic hexameter	masculine penthemimeral, hepthemimeral, trithemimeral
δεινὸν ὑπὸ κλαγγῆς θηρῶν, φρίσσει δέ τε γαῖα	-u u- -- -- -- u u --	dactylic hexameter	masculine penthemimeral, hepthemimeral, trithemimeral
πόντος τ᾽ἰχθυόεις: ἣ δ᾽ἄλκιμον ἦτορ ἔχουσα	-- --- - -uu -u u--	dactylic hexameter	masculine penthemimeral
πάντη ἐπιστρέφεται θηρῶν ὀλέκουσα γενέθλην.	-u u-uu- -- uu-u u--	dactylic hexameter	masculine penthemimeral, hepthemimeral
αὐτὰρ ἐπὴν τερφθῇ θηροσκόπος ἰοχέαιρα,	-u u- -- --uu -uu--	dactylic hexameter	masculine penthemimeral, trithemimeral
εὐφρήνῃ δὲ νόον, χαλάσασ᾽ εὐκαμπέα τόξα	--- u u- uu- --uu --	dactylic hexameter	masculine penthemimeral, hepthemimeral, trithemimeral
ἔρχεται ἐς μέγα δῶμα κασιγνήτοιο φίλοιο,	-uu - uu -u u---u u--	dactylic hexameter	feminine penthemimeral, trithemimeral
Φοίβου Ἀπόλλωνος, Δελφῶν ἐς πίονα δῆμον,	-u u--- -- - -uu --	dactylic hexameter	masculine penthemimeral, hepthemimeral
Μουσῶν καὶ Χαρίτων καλὸν χορὸν ἀρτυνέουσα.	-- - uu- -- uu -uu--	dactylic hexameter	masculine penthemimeral, hepthemimeral, trithemimeral
ἔνθα κατακρεμάσασα παλίντονα τόξα καὶ ἰοὺς	-u u-uu-u u-uu -u u --	dactylic hexameter	feminine penthemimeral
ἡγεῖται χαρίεντα περὶ χροῒ κόσμον ἔχουσα,	--- uu-u u- uu -u u--	dactylic hexameter	feminine penthemimeral, hepthemimeral, trithemimeral
ἐξάρχουσα χορούς: αἳ δ᾽ἀμβροσίην ὄπ᾽ ἰεῖσαι	---u u- - -uu- u u--	dactylic hexameter	masculine penthemimeral
ὑμνεῦσιν Λητὼ καλλίσφυρον, ὡς τέκε παῖδας	--- -- --uu - uu --	dactylic hexameter	masculine penthemimeral, trithemimeral
ἀθανάτων βουλῇ τε καὶ ἔργμασιν ἔξοχ᾽ ἀρίστους.	-uu- -- u u -uu -u u--	dactylic hexameter	masculine penthemimeral, trithemimeral
χαίρετε, τέκνα Διὸς καὶ Λητοῦς ἠυκόμοιο:	-uu -u u- - -- -uu--	dactylic hexameter	masculine penthemimeral
αὐτὰρ ἐγὼν ὑμέων τε καὶ ἄλλης μνήσομ᾽ ἀοιδῆς.	-u u- uu- u u -- -u u--	dactylic hexameter	masculine penthemimeral, trithemimeral
Παλλάδ᾽ Ἀθηναίην, κυδρὴν θεόν, ἄρχομ᾽ ἀείδειν	-u u--- -- uu -u u--	dactylic hexameter	masculine penthemimeral, hepthemimeral
γλαυκῶπιν, πολύμητιν, ἀμείλιχον ἦτορ ἔχουσαν,	--- uu-u u-uu -u u--	dactylic hexameter	feminine penthemimeral, trithemimeral
παρθένον αἰδοίην, ἐρυσίπτολιν, ἀλκήεσσαν,	-uu --- uu-uu ----	dactylic hexameter	masculine penthemimeral
Τριτογενῆ, τὴν αὐτὸς ἐγείνατο μητίετα Ζεὺς	-uu- - -u u-uu -uu- -	dactylic hexameter	feminine penthemimeral, trithemimeral
σεμνῆς ἐκ κεφαλῆς, πολεμήια τεύχε᾽ ἔχουσαν,	-- - uu- uu-uu -u u--	dactylic hexameter	masculine penthemimeral, trithemimeral
χρύσεα, παμφανόωντα: σέβας δ᾽ἔχε πάντας ὁρῶντας	-uu -uu-u u- uu -u u--	dactylic hexameter	feminine penthemimeral, hepthemimeral
ἀθανάτους: ἣ δὲ πρόσθεν Διὸς αἰγιόχοιο	-uu- - - -- uu -uu--	dactylic hexameter	masculine penthemimeral, hepthemimeral, trithemimeral
ἐσσυμένως ὤρουσεν ἀπ᾽ ἀθανάτοιο καρήνου,	-uu- --u u -uu-u u--	dactylic hexameter	feminine penthemimeral, trithemimeral
σείσασ᾽ ὀξὺν ἄκοντα: μέγας δ᾽ἐλελίζετ᾽ Ὄλυμπος	-- -u u-u u- uu-u u--	dactylic hexameter	feminine penthemimeral, hepthemimeral
δεινὸν ὑπὸ βρίμης γλαυκώπιδος: ἀμφὶ δὲ γαῖα	-u u- -- --uu -u u --	dactylic hexameter	masculine penthemimeral, trithemimeral
σμερδαλέον ἰάχησεν: ἐκινήθη δ᾽ἄρα πόντος,	-uu- uu-u u--- uu --	dactylic hexameter	feminine penthemimeral, trithemimeral
κύμασι πορφυρέοισι κυκώμενος: ἔκχυτο δ᾽ἅλμη	-uu -uu-u u-uu -uu --	dactylic hexameter	feminine penthemimeral
ἐξαπίνης: στῆσεν δ᾽Ὑπερίονος ἀγλαὸς υἱὸς	-uu- -- uu-uu -uu --	dactylic hexameter	masculine penthemimeral, trithemimeral
ἵππους ὠκύποδας δηρὸν χρόνον, εἰσότε κούρη	-- -uu- -- uu -uu --	dactylic hexameter	masculine penthemimeral, hepthemimeral
εἵλετ᾽ ἀπ᾽ ἀθανάτων ὤμων θεοείκελα τεύχη	-u u -uu- -- uu-uu --	dactylic hexameter	masculine penthemimeral, hepthemimeral
Παλλὰς Ἀθηναίη: γήθησε δὲ μητίετα Ζεύς.	-u u--- --u u -uu- -	dactylic hexameter	masculine penthemimeral
καὶ σὺ μὲν οὕτω χαῖρε, Διὸς τέκος αἰγιόχοιο:	- u u -- -u u- uu -uu--	dactylic hexameter	feminine penthemimeral, hepthemimeral
αὐτὰρ ἐγὼ καὶ σεῖο καὶ ἄλλης μνήσομ᾽ ἀοιδῆς.	-u u- - -u u -- -u u--	dactylic hexameter	feminine penthemimeral, trithemimeral
ἑστίη, ἣ πάντων ἐν δώμασιν ὑψηλοῖσιν	-uu - -- - -uu ----	dactylic hexameter	masculine penthemimeral, trithemimeral
ἀθανάτων τε θεῶν χαμαὶ ἐρχομένων τ᾽ἀνθρώπων	-uu- u u- uu -uu- ---	dactylic hexameter	masculine penthemimeral, trithemimeral
ἕδρην ἀίδιον ἔλαχες, πρεσβηίδα τιμήν,	-- -uu- uu- --uu --	dactylic hexameter	masculine penthemimeral, hepthemimeral
καλὸν ἔχουσα γέρας καὶ τίμιον: οὐ γὰρ ἄτερ σοῦ	-u u-u u- - -uu - u u- -	dactylic hexameter	masculine penthemimeral
εἰλαπίναι θνητοῖσιν, ἵν᾽ οὐ πρώτῃ πυμάτῃ τε	-uu- --u u - -- uu- -	dactylic hexameter	feminine penthemimeral, hepthemimeral, trithemimeral
Ἑστίῃ ἀρχόμενος σπένδει μελιηδέα οἶνον:	-uu -uu- -- uu-uu --	dactylic hexameter	masculine penthemimeral, hepthemimeral
καὶ σύ μοι, Ἀργειφόντα, Διὸς καὶ Μαιάδος υἱέ,	- u u ---u u- - -uu --	dactylic hexameter	feminine penthemimeral, hepthemimeral
ἄγγελε τῶν μακάρων, χρυσόρραπι, δῶτορ ἐάων,	-uu - uu- --uu -u u--	dactylic hexameter	masculine penthemimeral, trithemimeral
ἵλαος ὢν ἐπάρηγε σὺν αἰδοίῃ τε φίλῃ τε.	-uu - uu-u u --- u u- -	dactylic hexameter	feminine penthemimeral, trithemimeral
ναίετε δώματα καλά, φίλα φρεσὶν ἀλλήλοισιν	-uu -uu -u u- uu ----	dactylic hexameter	feminine penthemimeral, hepthemimeral
εἰδότες: ἀμφότεροι γὰρ ἐπιχθονίων ἀνθρώπων	-uu -uu- u u--- ---	dactylic hexameter	masculine penthemimeral
εἰδότες ἔργματα καλὰ νόῳ θ᾽ἕσπεσθε καὶ ἥβῃ.	-uu -uu -u u- --u u --	dactylic hexameter	feminine penthemimeral, hepthemimeral
χαῖρε, Κρόνου θύγατερ, σύ τε καὶ χρυσόρραπις Ἑρμῆς:	-u u- uu- u u - --uu --	dactylic hexameter	masculine penthemimeral, hepthemimeral, trithemimeral
αὐτὰρ ἐγὼν ὑμέων τε καὶ ἄλλης μνήσομ᾽ ἀοιδῆς.	-u u- uu- u u -- -u u--	dactylic hexameter	masculine penthemimeral, trithemimeral
γαῖαν παμμήτειραν ἀείσομαι, ἠυθέμεθλον,	-- ---u u-uu -uu--	dactylic hexameter	feminine penthemimeral
πρεσβίστην, ἣ φέρβει ἐπὶ χθονὶ πάνθʼ ὁπόσʼ ἐστίν,	--- - -u u- uu - uu --	dactylic hexameter	feminine penthemimeral, hepthemimeral, trithemimeral
ἠμὲν ὅσα χθόνα δῖαν ἐπέρχεται ἠδʼ ὅσα πόντον	-u u- uu -u u-uu - uu --	dactylic hexameter	feminine penthemimeral, trithemimeral
ἠδʼ ὅσα πωτῶνται, τάδε φέρβεται ἐκ σέθεν ὄλβου.	- uu --- uu -uu - uu --	dactylic hexameter	masculine penthemimeral
ἐκ σέο δ᾽εὔπαιδές τε καὶ εὔκαρποι τελέθουσι,	- uu --- u u --- uu--	dactylic hexameter	masculine penthemimeral
πότνια, σεῦ δ᾽ἔχεται δοῦναι βίον ἠδʼ ἀφελέσθαι	-uu - uu- -- uu - uu--	dactylic hexameter	masculine penthemimeral, hepthemimeral, trithemimeral
θνητοῖς ἀνθρώποισιν· ὃ δ᾽ὄλβιος, ὅν κε σὺ θυμῷ	-- ---u u -uu - u u --	dactylic hexameter	feminine penthemimeral
πρόφρων τιμήσῃς· τῷ τ᾽ἄφθονα πάντα πάρεστι.	-- --- - -uu -u u--	dactylic hexameter	masculine penthemimeral
βρίθει μέν σφιν ἄρουρα φερέσβιος ἠδὲ κατʼ ἀγροὺς	-- - u u-u u-uu -u u --	dactylic hexameter	feminine penthemimeral, trithemimeral
κτήνεσιν εὐθηνεῖ, οἶκος δ᾽ἐμπίπλαται ἐσθλῶν·	-uu --- -- --uu --	dactylic hexameter	masculine penthemimeral, hepthemimeral
αὐτοὶ δ᾽εὐνομίῃσι πόλιν κάτα καλλιγύναικα	-- -uu-u u- uu -uu--	dactylic hexameter	feminine penthemimeral, hepthemimeral
κοιρανέουσʼ, ὄλβος δὲ πολὺς καὶ πλοῦτος ὀπηδεῖ·	-uu- -- u u- - -u u--	dactylic hexameter	masculine penthemimeral, hepthemimeral, trithemimeral
παῖδες δ᾽εὐφροσύνῃ νεοθηλέι κυδιόωσι	-- -uu- uu-uu -uu--	dactylic hexameter	masculine penthemimeral
παρθενικαί τε χοροῖς πολυανθέσιν εὔφρονι θυμῷ	-uu- u u- uu-uu -uu --	dactylic hexameter	masculine penthemimeral, trithemimeral
παίζουσαι σκαίρουσι κατʼ ἄνθεα μαλθακὰ ποίης,	--- --u u -uu -uu --	dactylic hexameter	feminine penthemimeral, trithemimeral
οὕς κε σὺ τιμήσῃς, σεμνὴ θεά, ἄφθονε δαῖμον.	- u u --- -- uu -uu --	dactylic hexameter	masculine penthemimeral, hepthemimeral
χαῖρε, θεῶν μήτηρ, ἄλοχʼ Οὐρανοῦ ἀστερόεντος,	-u u- -- uu -uu -uu--	dactylic hexameter	masculine penthemimeral, trithemimeral
πρόφρων δ᾽ἀντʼ ᾠδῆς βίοτον θυμήρεʼ ὄπαζε·	-- - -- uu- --u u--	dactylic hexameter	masculine penthemimeral, hepthemimeral, trithemimeral
αὐτὰρ ἐγὼ καὶ σεῖο καὶ ἄλλης μνήσομʼ ἀοιδῆς.	-u u- - -u u -- -u u--	dactylic hexameter	feminine penthemimeral, trithemimeral
ἥλιον ὑμνεῖν αὖτε Διὸς τέκος ἄρχεο Μοῦσα,	-uu -- -u u- uu -uu --	dactylic hexameter	feminine penthemimeral, hepthemimeral
Καλλιόπη, φαέθοντα, τὸν Εὐρυφάεσσα βοῶπις	-uu- uu-u u -uu-u u--	dactylic hexameter	feminine penthemimeral, trithemimeral
γείνατο Γαίης παιδὶ καὶ Οὐρανοῦ ἀστερόεντος·	-uu -- -u u -uu -uu--	dactylic hexameter	feminine penthemimeral
γῆμε γὰρ Εὐρυφάεσσαν ἀγακλειτὴν Ὑπερίων,	-u u -uu-u u--- uu--	dactylic hexameter	feminine penthemimeral
αὐτοκασιγνήτην, ἥ οἱ τέκε κάλλιμα τέκνα,	-uu--- - - uu -uu --	dactylic hexameter	masculine penthemimeral, hepthemimeral
Ἠῶ τε ῥοδόπηχυν ἐυπλόκαμόν τε Σελήνην	-- - uu-u u-uu- u u--	dactylic hexameter	feminine penthemimeral, trithemimeral
Ἠέλιόν τ᾽ἀκάμαντʼ, ἐπιείκελον ἀθανάτοισιν,	-uu- uu- uu-uu -uu--	dactylic hexameter	masculine penthemimeral, trithemimeral
ὃς φαίνει θνητοῖσι καὶ ἀθανάτοισι θεοῖσιν	- -- --u u -uu-u u--	dactylic hexameter	feminine penthemimeral, trithemimeral
ἵπποις ἐμβεβαώς· σμερδνὸν δ᾽ὅ γε δέρκεται ὄσσοις	-- -uu- - - - -uu --	dactylic hexameter	masculine penthemimeral, hepthemimeral
χρυσέης ἐκ κόρυθος· λαμπραὶ δ᾽ἀκτῖνες ἀπʼ αὐτοῦ	-- - uu- -- --u u --	dactylic hexameter	masculine penthemimeral, hepthemimeral, trithemimeral
αἰγλῆεν στίλβουσι παρὰ κροτάφων δέ τ᾽ἔθειραι	--- --u u- uu- u u--	dactylic hexameter	feminine penthemimeral, hepthemimeral, trithemimeral
λαμπραὶ ἀπὸ κρατὸς χαρίεν κατέχουσι πρόσωπον	-u u- -- uu- uu-u u--	dactylic hexameter	masculine penthemimeral, hepthemimeral, trithemimeral
τηλαυγές· καλὸν δὲ περὶ χροῒ λάμπεται ἔσθος	--- -- u u- uu -uu --	dactylic hexameter	masculine penthemimeral, hepthemimeral, trithemimeral
λεπτουργές, πνοιῇ ἀνέμων· ὕπο δ᾽ἄρσενες ἵπποι.	--- -- uu- uu -uu --	dactylic hexameter	masculine penthemimeral, hepthemimeral, trithemimeral
ἔνθʼ ἄρʼ ὅ γε στήσας χρυσόζυγον ἅρμα καὶ ἵππους,	- u u - -- --uu -u u --	dactylic hexameter	masculine penthemimeral, trithemimeral
[αὐτόθι παύεται ἄκρου ἐπʼ οὐρανοῦ, εἰσόκεν αὖτις	-uu -uu -u u -uu -uu --	dactylic hexameter	feminine penthemimeral
θεσπέσιος πέμπῃσι διʼ οὐρανοῦ Ὠκεανόνδε.	-uu- --u u -uu -uu--	dactylic hexameter	feminine penthemimeral, trithemimeral
χαῖρε, ἄναξ, πρόφρων δὲ βίον θυμήρεʼ ὄπαζε.	-u u- -- u u- --u u--	dactylic hexameter	masculine penthemimeral, hepthemimeral, trithemimeral
ἐκ σέο δ᾽ἀρξάμενος κλῄσω μερόπων γένος ἀνδρῶν	- uu -uu- -- uu- uu --	dactylic hexameter	masculine penthemimeral, hepthemimeral
ἡμιθέων, ὧν ἔργα θεαὶ θνητοῖσιν ἔδειξαν.	-uu- - -u u- --u u--	dactylic hexameter	feminine penthemimeral, hepthemimeral, trithemimeral
μήνην ἀείδειν τανυσίπτερον ἔσπετε, Μοῦσαι,	-- --- uu-uu -uu --	dactylic hexameter	masculine penthemimeral
ἡδυεπεῖς κοῦραι Κρονίδεω Διός, ἵστορες ᾠδῆς·	-uu- -- uu- uu -uu --	dactylic hexameter	masculine penthemimeral, hepthemimeral, trithemimeral
ἧς ἄπο αἴγλη γαῖαν ἑλίσσεται οὐρανόδεικτος	- uu -- -u u-uu -uu--	dactylic hexameter	feminine penthemimeral
κρατὸς ἀπʼ ἀθανάτοιο, πολὺς δ᾽ὑπὸ κόσμος ὄρωρεν	-u u -uu-u u- uu -u u--	dactylic hexameter	feminine penthemimeral, hepthemimeral
αἴγλης λαμπούσης· στίλβει δέ τ᾽ἀλάμπετος ἀὴρ	-- --- -- u u-uu --	dactylic hexameter	masculine penthemimeral, hepthemimeral
χρυσέου ἀπὸ στεφάνου, ἀκτῖνες δ᾽ἐνδιάονται,	-u u- uu- --- -uu--	dactylic hexameter	masculine penthemimeral, trithemimeral
εὖτʼ ἂν ἀπʼ Ὠκεανοῖο λοεσσαμένη χρόα καλόν,	- u u -uu-u u-uu- uu --	dactylic hexameter	feminine penthemimeral
εἵματα ἑσσαμένη τηλαυγέα δῖα Σελήνη,	-uu -uu- --uu -u u--	dactylic hexameter	masculine penthemimeral
ζευξαμένη πώλους ἐριαύχενας, αἰγλήεντας,	-uu- -- uu-uu ----	dactylic hexameter	masculine penthemimeral, trithemimeral
ἐσσυμένως προτέρωσʼ ἐλάσῃ καλλίτριχας ἵππους,	-uu- uu- uu- --uu --	dactylic hexameter	masculine penthemimeral, hepthemimeral, trithemimeral
ἑσπερίη, διχόμηνος· ὃ δὲ πλήθει μέγας ὄγμος	-uu- uu-u u - -- uu --	dactylic hexameter	feminine penthemimeral, hepthemimeral, trithemimeral
λαμπρόταταί τ᾽αὐγαὶ τότʼ ἀεξομένης τελέθουσιν	-uu- -- u u-uu- uu--	dactylic hexameter	masculine penthemimeral, trithemimeral
οὐρανόθεν· τέκμωρ δὲ βροτοῖς καὶ σῆμα τέτυκται.	-uu- -- u u- - -u u--	dactylic hexameter	masculine penthemimeral, hepthemimeral, trithemimeral
τῇ ῥά ποτε Κρονίδης ἐμίγη φιλότητι καὶ εὐνῇ·	- u u- uu- uu- uu-u u --	dactylic hexameter	masculine penthemimeral, hepthemimeral, trithemimeral
ἣ δ᾽ὑποκυσαμένη Πανδείην γείνατο κούρην,	- uu-uu- --- -uu --	dactylic hexameter	masculine penthemimeral
ἐκπρεπὲς εἶδος ἔχουσαν ἐν ἀθανάτοισι θεοῖσι.	-uu -u u-u u -uu-u u--	dactylic hexameter	feminine penthemimeral
χαῖρε, ἄνασσα, θεὰ λευκώλενε, δῖα Σελήνη,	-u u-u u- --uu -u u--	dactylic hexameter	masculine penthemimeral
πρόφρον, ἐυπλόκαμος· σέο δ᾽ἀρχόμενος κλέα φωτῶν	-u u-uu- uu -uu- uu --	dactylic hexameter	masculine penthemimeral
ᾁσομαι ἡμιθέων, ὧν κλείουσʼ ἔργματʼ ἀοιδοί,	-uu -uu- - -- -u u--	dactylic hexameter	masculine penthemimeral
Μουσάων θεράποντες, ἀπὸ στομάτων ἐροέντων.	--- uu-u u- uu- uu--	dactylic hexameter	feminine penthemimeral, hepthemimeral, trithemimeral
ἀμφὶ Διὸς κούρους, ἑλικώπιδες ἔσπετε Μοῦσαι,	-u u- -- uu-uu -uu --	dactylic hexameter	masculine penthemimeral, trithemimeral
Τυνδαρίδας, Λήδης καλλισφύρου ἀγλαὰ τέκνα,	-uu- -- --uu -uu --	dactylic hexameter	masculine penthemimeral, trithemimeral
Κάστορά θ᾽ἱππόδαμον καὶ ἀμώμητον Πολυδεύκεα,	-uu -uu- u u--- uu---	lyric	
τοὺς ὑπὸ Ταϋγέτου κορυφῇ ὄρεος μεγάλοιο	- uu -uu- uu- uu- uu--	dactylic hexameter	masculine penthemimeral, hepthemimeral
μιχθεῖσ᾽ ἐν φιλότητι κελαινεφέι Κρονίωνι	- - ---u u-uu- uu--	dactylic hexameter	feminine penthemimeral
σωτῆρας τέκε παῖδας ἐπιχθονίων ἀνθρώπων	--- uu -u u--- ---	dactylic hexameter	feminine penthemimeral, trithemimeral
ὠκυπόρων τε νεῶν, ὅτε τε σπέρχωσιν ἄελλαι	-uu- u u- uu - --u u--	dactylic hexameter	masculine penthemimeral, hepthemimeral, trithemimeral
χειμέριαι κατὰ πόντον ἀμείλιχον: οἳ δ᾽ἀπὸ νηῶν	-uu- uu -u u-uu - uu --	dactylic hexameter	feminine penthemimeral, trithemimeral
εὐχόμενοι καλέουσι Διὸς κούρους μεγάλοιο	-uu- uu-u u- -- uu--	dactylic hexameter	feminine penthemimeral, hepthemimeral, trithemimeral
ἄρνεσσιν λευκοῖσιν, ἐπ᾽ ἀκρωτήρια βάντες	--- --u u ---uu --	dactylic hexameter	feminine penthemimeral, trithemimeral
πρύμνης: τὴν δ᾽ἄνεμός τε μέγας καὶ κῦμα θαλάσσης	-- - uu- u u- - -u u--	dactylic hexameter	masculine penthemimeral, hepthemimeral, trithemimeral
θῆκαν ὑποβρυχίην: οἳ δ᾽ἐξαπίνης ἐφάνησαν	-u u-uu- - -uu- uu--	dactylic hexameter	masculine penthemimeral
ξουθῇσι πτερύγεσσι δι᾽ αἰθέρος ἀίξαντες,	--- uu-u u -uu ----	dactylic hexameter	feminine penthemimeral, trithemimeral
αὐτίκα δ᾽ἀργαλέων ἀνέμων κατέπαυσαν ἀέλλας,	-uu -uu- uu- uu-u u--	dactylic hexameter	masculine penthemimeral, hepthemimeral
κύματα δ᾽ἐστόρεσαν λευκῆς ἁλὸς ἐν πελάγεσσι,	-uu -uu- -- uu - uu--	dactylic hexameter	masculine penthemimeral, hepthemimeral
σήματα καλά, πόνου ἀπονόσφισιν: οἳ δὲ ἰδόντες	-uu -u u- uu-uu - u u--	dactylic hexameter	masculine penthemimeral
γήθησαν, παύσαντο δ᾽ὀιζυροῖο πόνοιο.	--- --u u---u u--	dactylic hexameter	feminine penthemimeral, trithemimeral
χαίρετε, Τυνδαρίδαι, ταχέων ἐπιβήτορες ἵππων:	-uu -uu- uu- uu-uu --	dactylic hexameter	masculine penthemimeral, hepthemimeral
αὐτὰρ ἐγὼν ὑμέων τε καὶ ἄλλης μνήσομ᾽ ἀοιδῆς.	-u u- uu- u u -- -u u--	dactylic hexameter	masculine penthemimeral, trithemimeral
