ὣς ὃ μὲν ἐν κλισίῃσι Μενοιτίου ἄλκιμος υἱὸς	- u u - uu-u u-uu -uu --	dactylic hexameter	feminine penthemimeral, trithemimeral
ἰᾶτ’ Εὐρύπυλον βεβλημένον· οἳ δὲ μάχοντο	-- -uu- --uu - u u--	dactylic hexameter	masculine penthemimeral
Ἀργεῖοι καὶ Τρῶες ὁμιλαδόν· οὐδ’ ἄρ’ ἔμελλε	--- - -u u-uu - u u--	dactylic hexameter	feminine penthemimeral, trithemimeral
τάφρος ἔτι σχήσειν Δαναῶν καὶ τεῖχος ὕπερθεν	-u u- -- uu- - -u u--	dactylic hexameter	masculine penthemimeral, hepthemimeral, trithemimeral
εὐρύ, τὸ ποιήσαντο νεῶν ὕπερ, ἀμφὶ δὲ τάφρον	-u u ---u u- uu -u u --	dactylic hexameter	feminine penthemimeral, hepthemimeral
ἤλασαν· οὐδὲ θεοῖσι δόσαν κλειτὰς ἑκατόμβας·	-uu -u u-u u- -- uu--	dactylic hexameter	feminine penthemimeral, hepthemimeral
ὄφρά σφιν νῆάς τε θοὰς καὶ ληΐδα πολλὴν	-- - -- u u- - -uu --	dactylic hexameter	masculine penthemimeral, hepthemimeral, trithemimeral
ἐντὸς ἔχον ῥύοιτο· θεῶν δ’ἀέκητι τέτυκτο	-u u- --u u- uu-u u--	dactylic hexameter	feminine penthemimeral, hepthemimeral, trithemimeral
ἀθανάτων· τὸ καὶ οὔ τι πολὺν χρόνον ἔμπεδον ἦεν.	-uu- u u - u u- uu -uu --	dactylic hexameter	masculine penthemimeral, hepthemimeral, trithemimeral
ὄφρα μὲν Ἕκτωρ ζωὸς ἔην καὶ μήνι’ Ἀχιλλεὺς	-u u -- -u u- - -u u--	dactylic hexameter	feminine penthemimeral, hepthemimeral
καὶ Πριάμοιο ἄνακτος ἀπόρθητος πόλις ἔπλεν,	- uu-u u-u u--- uu --	dactylic hexameter	feminine penthemimeral
τόφρα δὲ καὶ μέγα τεῖχος Ἀχαιῶν ἔμπεδον ἦεν.	-u u - uu -u u-- -uu --	dactylic hexameter	feminine penthemimeral, trithemimeral
αὐτὰρ ἐπεὶ κατὰ μὲν Τρώων θάνον ὅσσοι ἄριστοι,	-u u- uu - -- uu -u u--	dactylic hexameter	masculine penthemimeral, hepthemimeral, trithemimeral
πολλοὶ δ’Ἀργείων οἳ μὲν δάμεν, οἳ δὲ λίποντο,	-- --- - - uu - u u--	dactylic hexameter	masculine penthemimeral, hepthemimeral
πέρθετο δὲ Πριάμοιο πόλις δεκάτῳ ἐνιαυτῷ,	-uu - uu-u u- uu- uu--	dactylic hexameter	feminine penthemimeral, hepthemimeral, trithemimeral
Ἀργεῖοι δ’ἐν νηυσὶ φίλην ἐς πατρίδ’ ἔβησαν,	--- - -u u- - -u u--	dactylic hexameter	feminine penthemimeral, hepthemimeral, trithemimeral
δὴ τότε μητιόωντο Ποσειδάων καὶ Ἀπόλλων	- uu -uu-u u--- u u--	dactylic hexameter	feminine penthemimeral
τεῖχος ἀμαλδῦναι ποταμῶν μένος εἰσαγαγόντες.	-u u--- uu- uu -uu--	dactylic hexameter	masculine penthemimeral, hepthemimeral
ὅσσοι ἀπ’ Ἰδαίων ὀρέων ἅλα δὲ προρέουσι,	-u u --- uu- uu - uu--	dactylic hexameter	masculine penthemimeral, hepthemimeral
’Ρῆσός θ’Ἑπτάπορός τε Κάρησός τε ’Ροδίος τε	-- -uu- u u-- - uu- -	dactylic hexameter	masculine penthemimeral
Γρήνικός τε καὶ Αἴσηπος δῖός τε Σκάμανδρος	--- u u --- -- u u--	dactylic hexameter	hepthemimeral, trithemimeral
καὶ Σιμόεις, ὅθι πολλὰ βοάγρια καὶ τρυφάλειαι	- uu- uu -u u-uu - uu--	dactylic hexameter	feminine penthemimeral, trithemimeral
κάππεσον ἐν κονίῃσι καὶ ἡμιθέων γένος ἀνδρῶν·	-uu - uu-u u -uu- uu --	dactylic hexameter	feminine penthemimeral, trithemimeral
τῶν πάντων ὁμόσε στόματ’ ἔτραπε Φοῖβος Ἀπόλλων,	- -- uu- uu -uu -u u--	dactylic hexameter	masculine penthemimeral, trithemimeral
ἐννῆμαρ δ’ἐς τεῖχος ἵει ῥόον· ὗε δ’ἄρα Ζεὺς	--- - -u u- uu -u u- -	dactylic hexameter	feminine penthemimeral, hepthemimeral, trithemimeral
συνεχές, ὄφρά κε θᾶσσον ἁλίπλοα τείχεα θείη.	-uu -u u -u u-uu -uu --	dactylic hexameter	feminine penthemimeral
αὐτὸς δ’ἐννοσίγαιος ἔχων χείρεσσι τρίαιναν	-- -uu-u u- --u u--	dactylic hexameter	feminine penthemimeral, hepthemimeral
ἡγεῖτ’, ἐκ δ’ἄρα πάντα θεμείλια κύμασι πέμπε	-- - uu -u u-uu -uu --	dactylic hexameter	feminine penthemimeral, trithemimeral
φιτρῶν καὶ λάων, τὰ θέσαν μογέοντες Ἀχαιοί,	-- - -- u u- uu-u u--	dactylic hexameter	masculine penthemimeral, hepthemimeral, trithemimeral
λεῖα δ’ἐποίησεν παρ’ ἀγάρροον Ἑλλήσποντον,	-u u--- u u-uu ----	dactylic hexameter	masculine penthemimeral
αὖτις δ’ἠϊόνα μεγάλην ψαμάθοισι κάλυψε	-- -uu- uu- uu-u u--	dactylic hexameter	masculine penthemimeral, hepthemimeral
τεῖχος ἀμαλδύνας· ποταμοὺς δ’ἔτρεψε νέεσθαι	-u u--- uu- --u u--	dactylic hexameter	masculine penthemimeral, hepthemimeral
κὰρ ῥόον, ᾗ περ πρόσθεν ἵεν καλλίρροον ὕδωρ.	- uu - - -u u- --uu --	dactylic hexameter	feminine penthemimeral, hepthemimeral, trithemimeral
ὣς ἄρ’ ἔμελλον ὄπισθε Ποσειδάων καὶ Ἀπόλλων	- u u-u u-u u--- u u--	dactylic hexameter	feminine penthemimeral
θησέμεναι· τότε δ’ἀμφὶ μάχη ἐνοπή τε δεδήει	-uu- uu -u u- uu- u u--	dactylic hexameter	feminine penthemimeral, hepthemimeral, trithemimeral
τεῖχος ἐΰδμητον, κανάχιζε δὲ δούρατα πύργων	-u u--- uu-u u -uu --	dactylic hexameter	masculine penthemimeral
βαλλόμεν’· Ἀργεῖοι δὲ Διὸς μάστιγι δαμέντες	-uu --- u u- --u u--	dactylic hexameter	masculine penthemimeral, hepthemimeral
νηυσὶν ἔπι γλαφυρῇσιν ἐελμένοι ἰσχανόωντο	-u u- uu-u u-uu -uu--	dactylic hexameter	feminine penthemimeral, trithemimeral
Ἕκτορα δειδιότες, κρατερὸν μήστωρα φόβοιο·	-uu -uu- uu- --u u--	dactylic hexameter	masculine penthemimeral, hepthemimeral
αὐτὰρ ὅ γ’ὡς τὸ πρόσθεν ἐμάρνατο ἶσος ἀέλλῃ·	-u u - - -u u-uu -u u--	dactylic hexameter	feminine penthemimeral, trithemimeral
ὡς δ’ὅτ’ ἂν ἔν τε κύνεσσι καὶ ἀνδράσι θηρευτῇσι	- u u - u u-u u -uu ----	dactylic hexameter	feminine penthemimeral, trithemimeral
κάπριος ἠὲ λέων στρέφεται σθένεϊ βλεμεαίνων·	-uu -u u- uu- uu- uu--	dactylic hexameter	masculine penthemimeral, hepthemimeral
οἳ δέ τε πυργηδὸν σφέας αὐτοὺς ἀρτύναντες	- u u --- uu -- ----	dactylic hexameter	masculine penthemimeral
ἀντίον ἵστανται καὶ ἀκοντίζουσι θαμειὰς	-uu --- u u---u u--	dactylic hexameter	masculine penthemimeral
αἰχμὰς ἐκ χειρῶν· τοῦ δ’οὔ ποτε κυδάλιμον κῆρ	-- - -- - - uu -uu- -	dactylic hexameter	masculine penthemimeral, hepthemimeral, trithemimeral
ταρβεῖ οὐδὲ φοβεῖται, ἀγηνορίη δέ μιν ἔκτα·	-- -u u-u u-uu- u u --	dactylic hexameter	feminine penthemimeral
ταρφέα τε στρέφεται στίχας ἀνδρῶν πειρητίζων·	-uu - uu- uu -- ----	dactylic hexameter	masculine penthemimeral, trithemimeral
ὅππῃ τ’ἰθύσῃ τῇ εἴκουσι στίχες ἀνδρῶν·	-- --- - --- uu --	dactylic hexameter	masculine penthemimeral
ὣς Ἕκτωρ ἀν’ ὅμιλον ἰὼν ἐλλίσσεθ’ ἑταίρους	- -- u u-u u- --u u--	dactylic hexameter	feminine penthemimeral, hepthemimeral, trithemimeral
τάφρον ἐποτρύνων διαβαινέμεν· οὐδέ οἱ ἵπποι	-u u--- uu-uu -u u --	dactylic hexameter	masculine penthemimeral
τόλμων ὠκύποδες, μάλα δὲ χρεμέτιζον ἐπ’ ἄκρῳ	-- -uu- uu - uu-u u --	dactylic hexameter	masculine penthemimeral, hepthemimeral
χείλει ἐφεσταότες· ἀπὸ γὰρ δειδίσσετο τάφρος	-u u-uu- uu - --uu --	dactylic hexameter	masculine penthemimeral, hepthemimeral
εὐρεῖ’, οὔτ’ ἄρ’ ὑπερθορέειν σχεδὸν οὔτε περῆσαι	-- - u u-uu- uu -u u--	dactylic hexameter	hepthemimeral, trithemimeral
ῥηϊδίη· κρημνοὶ γὰρ ἐπηρεφέες περὶ πᾶσαν	-uu- -- u u-uu- uu --	dactylic hexameter	masculine penthemimeral, trithemimeral
ἕστασαν ἀμφοτέρωθεν, ὕπερθεν δὲ σκολόπεσσιν	-uu -uu-u u-- - uu--	dactylic hexameter	feminine penthemimeral
ὀξέσιν ἠρήρει, τοὺς ἵστασαν υἷες Ἀχαιῶν	-uu --- - -uu -u u--	dactylic hexameter	masculine penthemimeral
πυκνοὺς καὶ μεγάλους δηίων ἀνδρῶν ἀλεωρήν.	-- - uu- -- -- uu--	dactylic hexameter	masculine penthemimeral, hepthemimeral, trithemimeral
ἔνθ’ οὔ κεν ῥέα ἵππος ἐΰτροχον ἅρμα τιταίνων	- - - uu -u u-uu -u u--	dactylic hexameter	feminine penthemimeral, trithemimeral
ἐσβαίη, πεζοὶ δὲ μενοίνεον εἰ τελέουσι.	--- -- u u-uu - uu--	dactylic hexameter	masculine penthemimeral, trithemimeral
δὴ τότε Πουλυδάμας θρασὺν Ἕκτορα εἶπε παραστάς·	- uu -uu- uu -uu -u u--	dactylic hexameter	masculine penthemimeral
Ἕκτορ τ’ἠδ’ ἄλλοι Τρώων ἀγοὶ ἠδ’ ἐπικούρων	-- - -- -- uu - uu--	dactylic hexameter	masculine penthemimeral, hepthemimeral, trithemimeral
ἀφραδέως διὰ τάφρον ἐλαύνομεν ὠκέας ἵππους·	-uu- uu -u u-uu -uu --	dactylic hexameter	feminine penthemimeral, trithemimeral
ἣ δὲ μάλ’ ἀργαλέη περάαν· σκόλοπες γὰρ ἐν αὐτῇ	- u u -uu- uu- uu- u u --	dactylic hexameter	masculine penthemimeral, hepthemimeral
ὀξέες ἑστᾶσιν, ποτὶ δ’αὐτοὺς τεῖχος Ἀχαιῶν,	-uu --- uu -- -u u--	dactylic hexameter	masculine penthemimeral
ἔνθ’ οὔ πως ἔστιν καταβήμεναι οὐδὲ μάχεσθαι	- - - -- uu-uu -u u--	dactylic hexameter	masculine penthemimeral, trithemimeral
ἱππεῦσι· στεῖνος γάρ, ὅθι τρώσεσθαι ὀΐω.	--- -- u u- --u u--	dactylic hexameter	masculine penthemimeral, hepthemimeral, trithemimeral
εἰ μὲν γὰρ τοὺς πάγχυ κακὰ φρονέων ἀλαπάζει	- - - - -u u- uu- uu--	dactylic hexameter	feminine penthemimeral, hepthemimeral, trithemimeral
Ζεὺς ὑψιβρεμέτης, Τρώεσσι δὲ ἵετ’ ἀρήγειν,	- --uu- --u u -u u--	dactylic hexameter	masculine penthemimeral
ἦ τ’ἂν ἔγωγ’ ἐθέλοιμι καὶ αὐτίκα τοῦτο γενέσθαι,	- u u- uu-u u -uu -u u--	dactylic hexameter	feminine penthemimeral, trithemimeral
νωνύμνους ἀπολέσθαι ἀπ’ Ἄργεος ἐνθάδ’ Ἀχαιούς·	--- uu-u u -uu -u u--	dactylic hexameter	feminine penthemimeral, trithemimeral
εἰ δέ χ’ὑποστρέψωσι, παλίωξις δὲ γένηται	- u u---u u--- u u--	dactylic hexameter	feminine penthemimeral
ἐκ νηῶν καὶ τάφρῳ ἐνιπλήξωμεν ὀρυκτῇ,	- -- - -u u---u u--	dactylic hexameter	feminine penthemimeral, trithemimeral
οὐκέτ’ ἔπειτ’ ὀΐω οὐδ’ ἄγγελον ἀπονέεσθαι	-u u- uu- - -uu -uu--	dactylic hexameter	masculine penthemimeral, trithemimeral
ἄψορρον προτὶ ἄστυ ἑλιχθέντων ὑπ’ Ἀχαιῶν.	--- uu -u u--- u u--	dactylic hexameter	feminine penthemimeral, trithemimeral
ἀλλ’ ἄγεθ’ ὡς ἂν ἐγὼ εἴπω πειθώμεθα πάντες·	- uu - u u- -- --uu --	dactylic hexameter	masculine penthemimeral, hepthemimeral, trithemimeral
ἵππους μὲν θεράποντες ἐρυκόντων ἐπὶ τάφρῳ,	-- - uu-u u--- uu --	dactylic hexameter	feminine penthemimeral, trithemimeral
αὐτοὶ δὲ πρυλέες σὺν τεύχεσι θωρηχθέντες	-- - uu- - -uu ----	dactylic hexameter	masculine penthemimeral, trithemimeral
Ἕκτορι πάντες ἑπώμεθ’ ἀολλέες· αὐτὰρ Ἀχαιοὶ	-uu -u u-u u-uu -u u--	dactylic hexameter	feminine penthemimeral
οὐ μενέουσ’ εἰ δή σφιν ὀλέθρου πείρατ’ ἐφῆπται.	- uu- - - u u-- -u u--	dactylic hexameter	masculine penthemimeral, trithemimeral
ὣς φάτο Πουλυδάμας, ἅδε δ’Ἕκτορι μῦθος ἀπήμων,	- uu -uu- uu -uu -u u--	dactylic hexameter	masculine penthemimeral
αὐτίκα δ’ἐξ ὀχέων σὺν τεύχεσιν ἆλτο χαμᾶζε.	-uu - uu- - -uu -u u--	dactylic hexameter	masculine penthemimeral, trithemimeral
οὐδὲ μὲν ἄλλοι Τρῶες ἐφ’ ἵππων ἠγερέθοντο,	-u u -- -u u -- -uu--	dactylic hexameter	feminine penthemimeral
ἀλλ’ ἀπὸ πάντες ὄρουσαν, ἐπεὶ ἴδον Ἕκτορα δῖον.	- uu -u u-u u- uu -uu --	dactylic hexameter	feminine penthemimeral, hepthemimeral
ἡνιόχῳ μὲν ἔπειτα ἑῷ ἐπέτελλεν ἕκαστος	-uu- u u-u u- uu-u u--	dactylic hexameter	feminine penthemimeral, hepthemimeral, trithemimeral
ἵππους εὖ κατὰ κόσμον ἐρυκέμεν αὖθ’ ἐπὶ τάφρῳ·	-- - uu -u u-uu - uu --	dactylic hexameter	feminine penthemimeral, trithemimeral
οἳ δὲ διαστάντες σφέας αὐτοὺς ἀρτύναντες	- u u--- uu -- ----	dactylic hexameter	masculine penthemimeral
πένταχα κοσμηθέντες ἅμ’ ἡγεμόνεσσιν ἕποντο.	-uu ---u u -uu-u u--	dactylic hexameter	feminine penthemimeral
οἳ μὲν ἅμ’ Ἕκτορ’ ἴσαν καὶ ἀμύμονι Πουλυδάμαντι,	- u u -u u- u u-uu -uu--	dactylic hexameter	masculine penthemimeral
οἳ πλεῖστοι καὶ ἄριστοι ἔσαν, μέμασαν δὲ μάλιστα	- -- u u-u u- uu- u u--	dactylic hexameter	feminine penthemimeral, hepthemimeral, trithemimeral
τεῖχος ῥηξάμενοι κοίλῃς ἐπὶ νηυσὶ μάχεσθαι.	-- -uu- -- uu -u u--	dactylic hexameter	masculine penthemimeral, hepthemimeral
καί σφιν Κεβριόνης τρίτος εἵπετο· πὰρ δ’ἄρ’ ὄχεσφιν	- - -uu- uu -uu - u u--	dactylic hexameter	masculine penthemimeral
ἄλλον Κεβριόναο χερείονα κάλλιπεν Ἕκτωρ.	-- -uu-u u-uu -uu --	dactylic hexameter	feminine penthemimeral
τῶν δ’ἑτέρων Πάρις ἦρχε καὶ Ἀλκάθοος καὶ Ἀγήνωρ,	- uu- uu -u u -uu- u u--	dactylic hexameter	feminine penthemimeral, trithemimeral
τῶν δὲ τρίτων Ἕλενος καὶ Δηΐφοβος θεοειδὴς	- u u- uu- - -uu- uu--	dactylic hexameter	masculine penthemimeral, trithemimeral
υἷε δύω Πριάμοιο· τρίτος δ’ἦν Ἄσιος ἥρως	-u u- uu-u u- - -uu --	dactylic hexameter	feminine penthemimeral, hepthemimeral, trithemimeral
Ἄσιος Ὑρτακίδης, ὃν Ἀρίσβηθεν φέρον ἵπποι	-uu -uu- u u--- uu --	dactylic hexameter	masculine penthemimeral
αἴθωνες μεγάλοι ποταμοῦ ἄπο Σελλήεντος.	--- uu- uu- uu ----	dactylic hexameter	masculine penthemimeral, hepthemimeral, trithemimeral
τῶν δὲ τετάρτων ἦρχεν ἐῢς πάϊς Ἀγχίσαο	- u u-- -u u- uu ----	dactylic hexameter	feminine penthemimeral, hepthemimeral
Αἰνείας, ἅμα τῷ γε δύω Ἀντήνορος υἷε	--- uu - u u- --uu --	dactylic hexameter	masculine penthemimeral, hepthemimeral, trithemimeral
Ἀρχέλοχός τ’Ἀκάμας τε μάχης εὖ εἰδότε πάσης.	-uu- uu- u u- - -uu --	dactylic hexameter	masculine penthemimeral, hepthemimeral, trithemimeral
Σαρπηδὼν δ’ἡγήσατ’ ἀγακλειτῶν ἐπικούρων,	--- --u u--- uu--	dactylic hexameter	feminine penthemimeral, trithemimeral
πρὸς δ’ἕλετο Γλαῦκον καὶ ἀρήϊον Ἀστεροπαῖον·	- uu- -- u u-uu -uu--	dactylic hexameter	masculine penthemimeral, trithemimeral
οἳ γάρ οἱ εἴσαντο διακριδὸν εἶναι ἄριστοι	- - - --u u-uu -u u--	dactylic hexameter	feminine penthemimeral, trithemimeral
τῶν ἄλλων μετά γ’αὐτόν· ὃ δ’ἔπρεπε καὶ διὰ πάντων.	- -- uu -u u -uu - uu --	dactylic hexameter	feminine penthemimeral, trithemimeral
οἳ δ’ἐπεὶ ἀλλήλους ἄραρον τυκτῇσι βόεσσι	- uu --- uu- --u u--	dactylic hexameter	masculine penthemimeral, hepthemimeral
βάν ῥ’ἰθὺς Δαναῶν λελιημένοι, οὐδ’ ἔτ’ ἔφαντο	- -- uu- uu-uu - u u--	dactylic hexameter	masculine penthemimeral, trithemimeral
σχήσεσθ’, ἀλλ’ ἐν νηυσὶ μελαίνῃσιν πεσέεσθαι.	-- - - -u u--- uu--	dactylic hexameter	feminine penthemimeral, trithemimeral
ἔνθ’ ἄλλοι Τρῶες τηλεκλειτοί τ’ἐπίκουροι	- -- -- ---- uu--	dactylic hexameter	masculine penthemimeral, trithemimeral
βουλῇ Πουλυδάμαντος ἀμωμήτοιο πίθοντο·	-- -uu-u u---u u--	dactylic hexameter	feminine penthemimeral
ἀλλ’ οὐχ Ὑρτακίδης ἔθελ’ Ἄσιος ὄρχαμος ἀνδρῶν	- - -uu- uu -uu -uu --	dactylic hexameter	masculine penthemimeral
αὖθι λιπεῖν ἵππους τε καὶ ἡνίοχον θεράποντα,	-u u- -- u u -uu- uu--	dactylic hexameter	masculine penthemimeral, trithemimeral
ἀλλὰ σὺν αὐτοῖσιν πέλασεν νήεσσι θοῇσι	-u u --- uu- --u u--	dactylic hexameter	masculine penthemimeral, hepthemimeral
νήπιος, οὐδ’ ἄρ’ ἔμελλε κακὰς ὑπὸ κῆρας ἀλύξας	-uu - u u-u u- uu -u u--	dactylic hexameter	feminine penthemimeral, hepthemimeral, trithemimeral
ἵπποισιν καὶ ὄχεσφιν ἀγαλλόμενος παρὰ νηῶν	--- u u-u u-uu- uu --	dactylic hexameter	feminine penthemimeral, trithemimeral
ἂψ ἀπονοστήσειν προτὶ Ἴλιον ἠνεμόεσσαν·	- uu--- uu -uu -uu--	dactylic hexameter	masculine penthemimeral
πρόσθεν γάρ μιν μοῖρα δυσώνυμος ἀμφεκάλυψεν	-- - - -u u-uu -uu--	dactylic hexameter	feminine penthemimeral, trithemimeral
ἔγχεϊ Ἰδομενῆος ἀγαυοῦ Δευκαλίδαο.	-uu -uu-u u-- -uu--	dactylic hexameter	feminine penthemimeral
εἴσατο γὰρ νηῶν ἐπ’ ἀριστερά, τῇ περ Ἀχαιοὶ	-uu - -- u u-uu - u u--	dactylic hexameter	masculine penthemimeral, trithemimeral
ἐκ πεδίου νίσοντο σὺν ἵπποισιν καὶ ὄχεσφι·	- uu- --u u --- u u--	dactylic hexameter	feminine penthemimeral, trithemimeral
τῇ ῥ’ἵππους τε καὶ ἅρμα διήλασεν, οὐδὲ πύλῃσιν	- -- u u -u u-uu -u u--	dactylic hexameter	feminine penthemimeral, trithemimeral
εὗρ’ ἐπικεκλιμένας σανίδας καὶ μακρὸν ὀχῆα,	- uu-uu- uu- - -u u--	dactylic hexameter	masculine penthemimeral, hepthemimeral
ἀλλ’ ἀναπεπταμένας ἔχον ἀνέρες, εἴ τιν’ ἑταίρων	- uu-uu- uu -uu - u u--	dactylic hexameter	masculine penthemimeral
ἐκ πολέμου φεύγοντα σαώσειαν μετὰ νῆας.	- uu- --u u--- uu --	dactylic hexameter	feminine penthemimeral, trithemimeral
τῇ ῥ’ἰθὺς φρονέων ἵππους ἔχε, τοὶ δ’ἅμ’ ἕποντο	- -- uu- -- uu - u u--	dactylic hexameter	masculine penthemimeral, hepthemimeral, trithemimeral
ὀξέα κεκλήγοντες· ἔφαντο γὰρ οὐκ ἔτ’ Ἀχαιοὺς	-uu ---u u-u u - u u--	dactylic hexameter	feminine penthemimeral
σχήσεσθ’, ἀλλ’ ἐν νηυσὶ μελαίνῃσιν πεσέεσθαι	-- - - -u u--- uu--	dactylic hexameter	feminine penthemimeral, trithemimeral
νήπιοι, ἐν δὲ πύλῃσι δύ’ ἀνέρας εὗρον ἀρίστους	-uu - u u-u u -uu -u u--	dactylic hexameter	feminine penthemimeral, trithemimeral
υἷας ὑπερθύμους Λαπιθάων αἰχμητάων,	-u u--- uu-- ----	dactylic hexameter	masculine penthemimeral
τὸν μὲν Πειριθόου υἷα κρατερὸν Πολυποίτην,	- - -uu- -- uu- uu--	dactylic hexameter	masculine penthemimeral, hepthemimeral
τὸν δὲ Λεοντῆα βροτολοιγῷ ἶσον Ἄρηϊ.	- u u--- uu-- -u u--	dactylic hexameter	masculine penthemimeral
τὼ μὲν ἄρα προπάροιθε πυλάων ὑψηλάων	- u u- uu-u u-- ----	dactylic hexameter	feminine penthemimeral, trithemimeral
ἕστασαν ὡς ὅτε τε δρύες οὔρεσιν ὑψικάρηνοι,	-uu - uu - uu -uu -uu--	dactylic hexameter	masculine penthemimeral, trithemimeral
αἵ τ’ἄνεμον μίμνουσι καὶ ὑετὸν ἤματα πάντα	- uu- --u u -uu -uu --	dactylic hexameter	feminine penthemimeral, trithemimeral
ῥίζῃσιν μεγάλῃσι διηνεκέεσσ’ ἀραρυῖαι·	--- uu-u u-uu- uu--	dactylic hexameter	feminine penthemimeral, trithemimeral
ὣς ἄρα τὼ χείρεσσι πεποιθότες ἠδὲ βίηφι	- uu - --u u-uu -u u--	dactylic hexameter	feminine penthemimeral, trithemimeral
μίμνον ἐπερχόμενον μέγαν Ἄσιον οὐδὲ φέβοντο.	-u u-uu- uu -uu -u u--	dactylic hexameter	masculine penthemimeral
οἳ δ’ἰθὺς πρὸς τεῖχος ἐΰδμητον βόας αὔας	- -- - -u u--- uu --	dactylic hexameter	feminine penthemimeral, trithemimeral
ὑψόσ’ ἀνασχόμενοι ἔκιον μεγάλῳ ἀλαλητῷ	-u u-uu- uu- uu- uu--	dactylic hexameter	masculine penthemimeral, hepthemimeral
Ἄσιον ἀμφὶ ἄνακτα καὶ Ἰαμενὸν καὶ Ὀρέστην	-uu -u u-u u -uu- u u--	dactylic hexameter	feminine penthemimeral
Ἀσιάδην τ’Ἀδάμαντα Θόωνά τε Οἰνόμαόν τε.	-uu- uu-u u-u u -uu- -	dactylic hexameter	feminine penthemimeral, trithemimeral
οἳ δ’ἤτοι εἷος μὲν ἐϋκνήμιδας Ἀχαιοὺς	- -- -- u u---u u--	dactylic hexameter	masculine penthemimeral, trithemimeral
ὄρνυον ἔνδον ἐόντες ἀμύνεσθαι περὶ νηῶν·	-uu -u u-u u--- uu --	dactylic hexameter	feminine penthemimeral
αὐτὰρ ἐπεὶ δὴ τεῖχος ἐπεσσυμένους ἐνόησαν	-u u- - -u u-uu- uu--	dactylic hexameter	feminine penthemimeral, trithemimeral
Τρῶας, ἀτὰρ Δαναῶν γένετο ἰαχή τε φόβος τε,	-u u- uu- uu- uu- u u- -	dactylic hexameter	masculine penthemimeral, hepthemimeral, trithemimeral
ἐκ δὲ τὼ ἀΐξαντε πυλάων πρόσθε μαχέσθην	- u u ---u u-- -u u--	dactylic hexameter	feminine penthemimeral
ἀγροτέροισι σύεσσιν ἐοικότε, τώ τ’ἐν ὄρεσσιν	-uu-u u-u u-uu - u u--	dactylic hexameter	feminine penthemimeral
ἀνδρῶν ἠδὲ κυνῶν δέχαται κολοσυρτὸν ἰόντα,	-- -u u- uu- uu-u u--	dactylic hexameter	masculine penthemimeral, hepthemimeral
δοχμώ τ’ἀΐσσοντε περὶ σφίσιν ἄγνυτον ὕλην	-- ---u u- uu -uu --	dactylic hexameter	feminine penthemimeral, hepthemimeral
πρυμνὴν ἐκτάμνοντες, ὑπαὶ δέ τε κόμπος ὀδόντων	-- ---u u- u u -u u--	dactylic hexameter	feminine penthemimeral, hepthemimeral
γίγνεται εἰς ὅ κέ τίς τε βαλὼν ἐκ θυμὸν ἕληται·	-uu - u u - u u- - -u u--	dactylic hexameter	masculine penthemimeral, hepthemimeral, trithemimeral
ὣς τῶν κόμπει χαλκὸς ἐπὶ στήθεσσι φαεινὸς	- - -- -u u- --u u--	dactylic hexameter	feminine penthemimeral, hepthemimeral
ἄντην βαλλομένων· μάλα γὰρ κρατερῶς ἐμάχοντο	-- -uu- uu - uu- uu--	dactylic hexameter	masculine penthemimeral, hepthemimeral
λαοῖσιν καθύπερθε πεποιθότες ἠδὲ βίηφιν.	--- uu-u u-uu -u u--	dactylic hexameter	feminine penthemimeral, trithemimeral
οἳ δ’ἄρα χερμαδίοισιν ἐϋδμήτων ἀπὸ πύργων	- uu -uu-u u--- uu --	dactylic hexameter	feminine penthemimeral
βάλλον ἀμυνόμενοι σφῶν τ’αὐτῶν καὶ κλισιάων	-u u-uu- - -- - uu--	dactylic hexameter	masculine penthemimeral
νηῶν τ’ὠκυπόρων· νιφάδες δ’ὡς πῖπτον ἔραζε,	-- -uu- uu- - -u u--	dactylic hexameter	masculine penthemimeral, hepthemimeral
ἅς τ’ἄνεμος ζαὴς νέφεα σκιόεντα δονήσας	- uu- -- uu- uu-u u--	dactylic hexameter	masculine penthemimeral, hepthemimeral, trithemimeral
ταρφειὰς κατέχευεν ἐπὶ χθονὶ πουλυβοτείρῃ·	--- uu-u u- uu -uu--	dactylic hexameter	feminine penthemimeral, hepthemimeral, trithemimeral
ὣς τῶν ἐκ χειρῶν βέλεα ῥέον ἠμὲν Ἀχαιῶν	- - - -- uu- uu -u u--	dactylic hexameter	masculine penthemimeral, hepthemimeral, trithemimeral
ἠδὲ καὶ ἐκ Τρώων· κόρυθες δ’ἀμφ’ αὖον ἀΰτευν	-u u - -- uu- - -u u--	dactylic hexameter	masculine penthemimeral, hepthemimeral, trithemimeral
βαλλομένων μυλάκεσσι καὶ ἀσπίδες ὀμφαλόεσσαι.	-uu- uu-u u -uu -uu--	dactylic hexameter	feminine penthemimeral, trithemimeral
δή ῥα τότ’ ᾤμωξεν καὶ ὣ πεπλήγετο μηρὼ	- u u --- - - --uu --	dactylic hexameter	masculine penthemimeral, hepthemimeral
Ἄσιος Ὑρτακίδης, καὶ ἀλαστήσας ἔπος ηὔδα·	-uu -uu- u u--- uu --	dactylic hexameter	masculine penthemimeral
Ζεῦ πάτερ ἦ ῥά νυ καὶ σὺ φιλοψευδὴς ἐτέτυξο	- uu - u u - u u--- uu--	dactylic hexameter	masculine penthemimeral, trithemimeral
πάγχυ μάλ’· οὐ γὰρ ἔγωγ’ ἐφάμην ἥρωας Ἀχαιοὺς	-u u - u u- uu- --u u--	dactylic hexameter	masculine penthemimeral, hepthemimeral, trithemimeral
σχήσειν ἡμέτερόν γε μένος καὶ χεῖρας ἀάπτους.	-- -uu- u u- - -u u--	dactylic hexameter	masculine penthemimeral, hepthemimeral
οἳ δ’,ὥς τε σφῆκες μέσον αἰόλοι ἠὲ μέλισσαι	- - - -- uu -uu -u u--	dactylic hexameter	masculine penthemimeral, trithemimeral
οἰκία ποιήσωνται ὁδῷ ἔπι παιπαλοέσσῃ,	-uu ---u u- uu -uu--	dactylic hexameter	feminine penthemimeral, hepthemimeral
οὐδ’ ἀπολείπουσιν κοῖλον δόμον, ἀλλὰ μένοντες	- uu--- -- uu -u u--	dactylic hexameter	masculine penthemimeral, hepthemimeral
ἄνδρας θηρητῆρας ἀμύνονται περὶ τέκνων,	-- ---u u--- uu --	dactylic hexameter	feminine penthemimeral
ὣς οἵ γ’οὐκ ἐθέλουσι πυλάων καὶ δύ’ ἐόντε	- - - uu-u u-- - u u--	dactylic hexameter	feminine penthemimeral, trithemimeral
χάσσασθαι πρίν γ’ἠὲ κατακτάμεν ἠὲ ἁλῶναι.	--- - -u u-uu -u u--	dactylic hexameter	feminine penthemimeral, trithemimeral
ὣς ἔφατ’, οὐδὲ Διὸς πεῖθε φρένα ταῦτ’ ἀγορεύων·	- uu -u u- -- uu - uu--	dactylic hexameter	masculine penthemimeral, hepthemimeral
Ἕκτορι γάρ οἱ θυμὸς ἐβούλετο κῦδος ὀρέξαι.	-uu - - -u u-uu -u u--	dactylic hexameter	feminine penthemimeral, trithemimeral
ἄλλοι δ’ἀμφ’ ἄλλῃσι μάχην ἐμάχοντο πύλῃσιν·	-- - --u u- uu-u u--	dactylic hexameter	feminine penthemimeral, hepthemimeral, trithemimeral
ἀργαλέον δέ με ταῦτα θεὸν ὣς πάντ’ ἀγορεῦσαι·	-uu- u u -u u- - - uu--	dactylic hexameter	feminine penthemimeral, hepthemimeral, trithemimeral
πάντῃ γὰρ περὶ τεῖχος ὀρώρει θεσπιδαὲς πῦρ	-- - uu -u u-- -uu- -	dactylic hexameter	feminine penthemimeral, trithemimeral
λάϊνον· Ἀργεῖοι δὲ καὶ ἀχνύμενοί περ ἀνάγκῃ	-uu --- u u -uu- u u--	dactylic hexameter	masculine penthemimeral
νηῶν ἠμύνοντο· θεοὶ δ’ἀκαχήατο θυμὸν	-- ---u u- uu-uu --	dactylic hexameter	feminine penthemimeral, hepthemimeral
πάντες ὅσοι Δαναοῖσι μάχης ἐπιτάρροθοι ἦσαν.	-u u- uu-u u- uu-uu --	dactylic hexameter	feminine penthemimeral, hepthemimeral, trithemimeral
σὺν δ’ἔβαλον Λαπίθαι πόλεμον καὶ δηϊοτῆτα.	- uu- uu- uu- - -uu--	dactylic hexameter	masculine penthemimeral, hepthemimeral, trithemimeral
ἔνθ’ αὖ Πειριθόου υἱὸς κρατερὸς Πολυποίτης	- - -uu- -- uu- uu--	dactylic hexameter	masculine penthemimeral, hepthemimeral
δουρὶ βάλεν Δάμασον κυνέης διὰ χαλκοπαρῄου·	-u u- uu- uu- uu -uu--	dactylic hexameter	masculine penthemimeral, hepthemimeral, trithemimeral
οὐδ’ ἄρα χαλκείη κόρυς ἔσχεθεν, ἀλλὰ διὰ πρὸ	- uu --- uu -uu -u u- -	dactylic hexameter	masculine penthemimeral
αἰχμὴ χαλκείη ῥῆξ’ ὀστέον, ἐγκέφαλος δὲ	-- --- - -uu -uu- -	dactylic hexameter	masculine penthemimeral
ἔνδον ἅπας πεπάλακτο· δάμασσε δέ μιν μεμαῶτα·	-u u- uu-u u-u u - uu--	dactylic hexameter	feminine penthemimeral, trithemimeral
αὐτὰρ ἔπειτα Πύλωνα καὶ Ὄρμενον ἐξενάριξεν.	-u u-u u-u u -uu -uu--	dactylic hexameter	feminine penthemimeral
υἱὸν δ’Ἀντιμάχοιο Λεοντεὺς ὄζος Ἄρηος	-- -uu-u u-- -u u--	dactylic hexameter	feminine penthemimeral
Ἱππόμαχον βάλε δουρὶ κατὰ ζωστῆρα τυχήσας.	-uu- uu -u u- --u u--	dactylic hexameter	feminine penthemimeral, hepthemimeral, trithemimeral
αὖτις δ’ἐκ κολεοῖο ἐρυσσάμενος ξίφος ὀξὺ	-- - uu-u u-uu- uu --	dactylic hexameter	feminine penthemimeral, trithemimeral
Ἀντιφάτην μὲν πρῶτον ἐπαΐξας δι’ ὁμίλου	-uu- - -u u--- u u--	dactylic hexameter	feminine penthemimeral, trithemimeral
πλῆξ’ αὐτοσχεδίην· ὃ δ’ἄρ’ ὕπτιος οὔδει ἐρείσθη·	- --uu- u u -uu -u u--	dactylic hexameter	masculine penthemimeral
αὐτὰρ ἔπειτα Μένωνα καὶ Ἰαμενὸν καὶ Ὀρέστην	-u u-u u-u u -uu- u u--	dactylic hexameter	feminine penthemimeral
πάντας ἐπασσυτέρους πέλασε χθονὶ πουλυβοτείρῃ.	-u u-uu- uu- uu -uu--	dactylic hexameter	masculine penthemimeral, hepthemimeral
ὄφρ’ οἳ τοὺς ἐνάριζον ἀπ’ ἔντεα μαρμαίροντα,	- - - uu-u u -uu ----	dactylic hexameter	feminine penthemimeral, trithemimeral
τόφρ’ οἳ Πουλυδάμαντι καὶ Ἕκτορι κοῦροι ἕποντο,	- - -uu-u u -uu -u u--	dactylic hexameter	feminine penthemimeral
οἳ πλεῖστοι καὶ ἄριστοι ἔσαν, μέμασαν δὲ μάλιστα	- -- u u-u u- uu- u u--	dactylic hexameter	feminine penthemimeral, hepthemimeral, trithemimeral
τεῖχός τε ῥήξειν καὶ ἐνιπρήσειν πυρὶ νῆας,	-- - -- u u--- uu --	dactylic hexameter	masculine penthemimeral, trithemimeral
οἵ ῥ’ἔτι μερμήριζον ἐφεσταότες παρὰ τάφρῳ.	- uu ---u u-uu- uu --	dactylic hexameter	feminine penthemimeral
ὄρνις γάρ σφιν ἐπῆλθε περησέμεναι μεμαῶσιν	-- - u u-u u-uu- uu--	dactylic hexameter	feminine penthemimeral, trithemimeral
αἰετὸς ὑψιπέτης ἐπ’ ἀριστερὰ λαὸν ἐέργων	-uu -uu- u u-uu -u u--	dactylic hexameter	masculine penthemimeral
φοινήεντα δράκοντα φέρων ὀνύχεσσι πέλωρον	---u u-u u- uu-u u--	dactylic hexameter	feminine penthemimeral, hepthemimeral
ζωὸν ἔτ’ ἀσπαίροντα, καὶ οὔ πω λήθετο χάρμης,	-u u ---u u - - -uu --	dactylic hexameter	feminine penthemimeral, hepthemimeral
κόψε γὰρ αὐτὸν ἔχοντα κατὰ στῆθος παρὰ δειρὴν	-u u -u u-u u- -- uu --	dactylic hexameter	feminine penthemimeral, hepthemimeral
ἰδνωθεὶς ὀπίσω· ὃ δ’ἀπὸ ἕθεν ἧκε χαμᾶζε	--- uu- u u- uu -u u--	dactylic hexameter	masculine penthemimeral, hepthemimeral, trithemimeral
ἀλγήσας ὀδύνῃσι, μέσῳ δ’ἐνὶ κάββαλ’ ὁμίλῳ,	--- uu-u u- uu -u u--	dactylic hexameter	feminine penthemimeral, hepthemimeral, trithemimeral
αὐτὸς δὲ κλάγξας πέτετο πνοιῇς ἀνέμοιο.	-- - -- uu- -- uu--	dactylic hexameter	masculine penthemimeral, hepthemimeral, trithemimeral
Τρῶες δ’ἐρρίγησαν ὅπως ἴδον αἰόλον ὄφιν	-- ---u u- uu -uu --	dactylic hexameter	feminine penthemimeral, hepthemimeral
κείμενον ἐν μέσσοισι Διὸς τέρας αἰγιόχοιο.	-uu - --u u- uu -uu--	dactylic hexameter	feminine penthemimeral, hepthemimeral, trithemimeral
δὴ τότε Πουλυδάμας θρασὺν Ἕκτορα εἶπε παραστάς·	- uu -uu- uu -uu -u u--	dactylic hexameter	masculine penthemimeral
Ἕκτορ ἀεὶ μέν πώς μοι ἐπιπλήσσεις ἀγορῇσιν	-u u- - - u u--- uu--	dactylic hexameter	masculine penthemimeral, trithemimeral
ἐσθλὰ φραζομένῳ, ἐπεὶ οὐδὲ μὲν οὐδὲ ἔοικε	-- -uu- uu -u u -u u--	dactylic hexameter	masculine penthemimeral
δῆμον ἐόντα παρὲξ ἀγορευέμεν, οὔτ’ ἐνὶ βουλῇ	-u u-u u- uu-uu - uu --	dactylic hexameter	masculine penthemimeral
οὔτέ ποτ’ ἐν πολέμῳ, σὸν δὲ κράτος αἰὲν ἀέξειν·	-u u - uu- - - uu -u u--	dactylic hexameter	masculine penthemimeral, hepthemimeral, trithemimeral
νῦν αὖτ’ ἐξερέω ὥς μοι δοκεῖ εἶναι ἄριστα.	- - -uu- - - uu -u u--	dactylic hexameter	masculine penthemimeral, hepthemimeral
μὴ ἴομεν Δαναοῖσι μαχησόμενοι περὶ νηῶν.	- uu- uu-u u-uu- uu --	dactylic hexameter	feminine penthemimeral, trithemimeral
ὧδε γὰρ ἐκτελέεσθαι ὀΐομαι, εἰ ἐτεόν γε	-u u -uu-u u-uu - uu- -	dactylic hexameter	feminine penthemimeral
Τρωσὶν ὅδ’ ὄρνις ἦλθε περησέμεναι μεμαῶσιν	-u u -- -u u-uu- uu--	dactylic hexameter	feminine penthemimeral
αἰετὸς ὑψιπέτης ἐπ’ ἀριστερὰ λαὸν ἐέργων	-uu -uu- u u-uu -u u--	dactylic hexameter	masculine penthemimeral
φοινήεντα δράκοντα φέρων ὀνύχεσσι πέλωρον	---u u-u u- uu-u u--	dactylic hexameter	feminine penthemimeral, hepthemimeral
ζωόν· ἄφαρ δ’ἀφέηκε πάρος φίλα οἰκί’ ἱκέσθαι,	-u u- uu-u u- uu -u u--	dactylic hexameter	feminine penthemimeral, hepthemimeral, trithemimeral
οὐδ’ ἐτέλεσσε φέρων δόμεναι τεκέεσσιν ἑοῖσιν.	- uu-u u- uu- uu-u u--	dactylic hexameter	masculine penthemimeral, hepthemimeral
ὣς ἡμεῖς, εἴ πέρ τε πύλας καὶ τεῖχος Ἀχαιῶν	- -- - - u u- - -u u--	dactylic hexameter	masculine penthemimeral, hepthemimeral, trithemimeral
ῥηξόμεθα σθένεϊ μεγάλῳ, εἴξωσι δ’Ἀχαιοί,	-uu- uu- uu- --u u--	dactylic hexameter	masculine penthemimeral, hepthemimeral, trithemimeral
οὐ κόσμῳ παρὰ ναῦφιν ἐλευσόμεθ’ αὐτὰ κέλευθα·	- -- uu -u u-uu -u u--	dactylic hexameter	feminine penthemimeral, trithemimeral
πολλοὺς γὰρ Τρώων καταλείψομεν, οὕς κεν Ἀχαιοὶ	-- - -- uu-uu - u u--	dactylic hexameter	masculine penthemimeral, trithemimeral
χαλκῷ δῃώσωσιν ἀμυνόμενοι περὶ νηῶν.	-- ---u u-uu- uu --	dactylic hexameter	feminine penthemimeral
ὧδέ χ’ὑποκρίναιτο θεοπρόπος, ὃς σάφα θυμῷ	-u u---u u-uu - uu --	dactylic hexameter	feminine penthemimeral
εἰδείη τεράων καί οἱ πειθοίατο λαοί.	--- uu- - - --uu --	dactylic hexameter	masculine penthemimeral, hepthemimeral, trithemimeral
τὸν δ’ἄρ’ ὑπόδρα ἰδὼν προσέφη κορυθαίολος Ἕκτωρ·	- u u-u u- uu- uu-uu --	dactylic hexameter	masculine penthemimeral, hepthemimeral
Πουλυδάμα, σὺ μὲν οὐκ ἔτ’ ἐμοὶ φίλα ταῦτ’ ἀγορεύεις·	-uu- u u - u u- uu - uu--	dactylic hexameter	masculine penthemimeral, hepthemimeral, trithemimeral
οἶσθα καὶ ἄλλον μῦθον ἀμείνονα τοῦδε νοῆσαι.	-u u -- -u u-uu -u u--	dactylic hexameter	feminine penthemimeral
εἰ δ’ἐτεὸν δὴ τοῦτον ἀπὸ σπουδῆς ἀγορεύεις,	- uu- - -u u- -- uu--	dactylic hexameter	feminine penthemimeral, hepthemimeral, trithemimeral
ἐξ ἄρα δή τοι ἔπειτα θεοὶ φρένας ὤλεσαν αὐτοί,	- uu - u u-u u- uu -uu --	dactylic hexameter	feminine penthemimeral, hepthemimeral, trithemimeral
ὃς κέλεαι Ζηνὸς μὲν ἐριγδούποιο λαθέσθαι	- uu- -- u u---u u--	dactylic hexameter	masculine penthemimeral, trithemimeral
βουλέων, ἅς τέ μοι αὐτὸς ὑπέσχετο καὶ κατένευσε·	-- - u u -u u-uu - uu--	dactylic hexameter	feminine penthemimeral, trithemimeral
τύνη δ’οἰωνοῖσι τανυπτερύγεσσι κελεύεις	-- ---u u-uu-u u--	dactylic hexameter	feminine penthemimeral
πείθεσθαι, τῶν οὔ τι μετατρέπομ’ οὐδ’ ἀλεγίζω	--- - - u u-uu - uu--	dactylic hexameter	masculine penthemimeral, trithemimeral
εἴτ’ ἐπὶ δεξί’ ἴωσι πρὸς ἠῶ τ’ἠέλιόν τε,	- uu -u u-u u -- -uu- -	dactylic hexameter	feminine penthemimeral
εἴτ’ ἐπ’ ἀριστερὰ τοί γε ποτὶ ζόφον ἠερόεντα.	- u u-uu - u u- uu -uu--	dactylic hexameter	masculine penthemimeral, hepthemimeral
ἡμεῖς δὲ μεγάλοιο Διὸς πειθώμεθα βουλῇ,	-- - uu-u u- --uu --	dactylic hexameter	feminine penthemimeral, hepthemimeral, trithemimeral
ὃς πᾶσι θνητοῖσι καὶ ἀθανάτοισιν ἀνάσσει.	- -- --u u -uu-u u--	dactylic hexameter	feminine penthemimeral, trithemimeral
εἷς οἰωνὸς ἄριστος ἀμύνεσθαι περὶ πάτρης.	- --u u-u u--- uu --	dactylic hexameter	feminine penthemimeral
τίπτε σὺ δείδοικας πόλεμον καὶ δηϊοτῆτα;	-u u --- uu- - -uu--	dactylic hexameter	masculine penthemimeral, hepthemimeral
εἴ περ γάρ τ’ἄλλοι γε περὶ κτεινώμεθα πάντες	- - - -- u u- --uu --	dactylic hexameter	masculine penthemimeral, hepthemimeral, trithemimeral
νηυσὶν ἐπ’ Ἀργείων, σοὶ δ’οὐ δέος ἔστ’ ἀπολέσθαι·	-u u --- - - uu - uu--	dactylic hexameter	masculine penthemimeral, hepthemimeral
οὐ γάρ τοι κραδίη μενεδήϊος οὐδὲ μαχήμων.	- - - uu- uu-uu -u u--	dactylic hexameter	masculine penthemimeral, trithemimeral
εἰ δὲ σὺ δηϊοτῆτος ἀφέξεαι, ἠέ τιν’ ἄλλον	- u u -uu-u u-uu -u u --	dactylic hexameter	feminine penthemimeral
παρφάμενος ἐπέεσσιν ἀποτρέψεις πολέμοιο,	-uu- uu-u u--- uu--	dactylic hexameter	feminine penthemimeral, trithemimeral
αὐτίκ’ ἐμῷ ὑπὸ δουρὶ τυπεὶς ἀπὸ θυμὸν ὀλέσσεις.	-u u- uu -u u- uu -u u--	dactylic hexameter	feminine penthemimeral, hepthemimeral, trithemimeral
ὣς ἄρα φωνήσας ἡγήσατο, τοὶ δ’ἅμ’ ἕποντο	- uu --- --uu - u u--	dactylic hexameter	masculine penthemimeral
ἠχῇ θεσπεσίῃ· ἐπὶ δὲ Ζεὺς τερπικέραυνος	-- -uu- uu - - -uu--	dactylic hexameter	masculine penthemimeral, hepthemimeral
ὦρσεν ἀπ’ Ἰδαίων ὀρέων ἀνέμοιο θύελλαν,	-u u --- uu- uu-u u--	dactylic hexameter	masculine penthemimeral, hepthemimeral
ἥ ῥ’ἰθὺς νηῶν κονίην φέρεν· αὐτὰρ Ἀχαιῶν	- -- -- uu- uu -u u--	dactylic hexameter	masculine penthemimeral, hepthemimeral, trithemimeral
θέλγε νόον, Τρωσὶν δὲ καὶ Ἕκτορι κῦδος ὄπαζε.	-u u- -- u u -uu -u u--	dactylic hexameter	masculine penthemimeral, trithemimeral
τοῦ περ δὴ τεράεσσι πεποιθότες ἠδὲ βίηφι	- - - uu-u u-uu -u u--	dactylic hexameter	feminine penthemimeral, trithemimeral
ῥήγνυσθαι μέγα τεῖχος Ἀχαιῶν πειρήτιζον.	--- uu -u u-- ----	dactylic hexameter	feminine penthemimeral, trithemimeral
κρόσσας μὲν πύργων ἔρυον, καὶ ἔρειπον ἐπάλξεις,	-- - -- uu- u u-u u--	dactylic hexameter	masculine penthemimeral, hepthemimeral, trithemimeral
στήλας τε προβλῆτας ἐμόχλεον, ἃς ἄρ’ Ἀχαιοὶ	-- - --u u-uu - u u--	dactylic hexameter	feminine penthemimeral, trithemimeral
πρώτας ἐν γαίῃ θέσαν ἔμμεναι ἔχματα πύργων.	-- - -- uu -uu -uu --	dactylic hexameter	masculine penthemimeral, trithemimeral
τὰς οἵ γ’αὐέρυον, ἔλποντο δὲ τεῖχος Ἀχαιῶν	- - -uu- --u u -u u--	dactylic hexameter	masculine penthemimeral
ῥήξειν· οὐδέ νύ πω Δαναοὶ χάζοντο κελεύθου,	-- -u u - uu- --u u--	dactylic hexameter	masculine penthemimeral, hepthemimeral
ἀλλ’ οἵ γε ῥινοῖσι βοῶν φράξαντες ἐπάλξεις	- - - --u u- --u u--	dactylic hexameter	feminine penthemimeral, hepthemimeral, trithemimeral
βάλλον ἀπ’ αὐτάων δηίους ὑπὸ τεῖχος ἰόντας.	-u u --- -- uu -u u--	dactylic hexameter	masculine penthemimeral, hepthemimeral
ἀμφοτέρω δ’Αἴαντε κελευτιόωντ’ ἐπὶ πύργων	-uu- --u u-uu- uu --	dactylic hexameter	feminine penthemimeral, trithemimeral
πάντοσε φοιτήτην μένος ὀτρύνοντες Ἀχαιῶν.	-uu --- uu ---u u--	dactylic hexameter	masculine penthemimeral
ἄλλον μειλιχίοις, ἄλλον στερεοῖς ἐπέεσσι	-- -uu- -- uu- uu--	dactylic hexameter	masculine penthemimeral, hepthemimeral
νείκεον, ὅν τινα πάγχυ μάχης μεθιέντα ἴδοιεν·	-uu - uu -u u- uu-u u--	dactylic hexameter	feminine penthemimeral, hepthemimeral, trithemimeral
ὦ φίλοι Ἀργείων ὅς τ’ἔξοχος ὅς τε μεσήεις	- uu --- - -uu - u u--	dactylic hexameter	masculine penthemimeral
ὅς τε χερειότερος, ἐπεὶ οὔ πω πάντες ὁμοῖοι	- u u-uu- uu - - -u u--	dactylic hexameter	masculine penthemimeral, hepthemimeral
ἀνέρες ἐν πολέμῳ, νῦν ἔπλετο ἔργον ἅπασι·	-uu - uu- - -uu -u u--	dactylic hexameter	masculine penthemimeral, trithemimeral
καὶ δ’αὐτοὶ τόδε που γιγνώσκετε. μή τις ὀπίσσω	- -- uu - --uu - u u--	dactylic hexameter	masculine penthemimeral, trithemimeral
τετράφθω ποτὶ νῆας ὁμοκλητῆρος ἀκούσας,	--- uu -u u---u u--	dactylic hexameter	feminine penthemimeral, trithemimeral
ἀλλὰ πρόσω ἵεσθε καὶ ἀλλήλοισι κέλεσθε,	-u u- --u u ---u u--	dactylic hexameter	feminine penthemimeral, trithemimeral
αἴ κε Ζεὺς δώῃσιν Ὀλύμπιος ἀστεροπητὴς	- - - --u u-uu -uu--	dactylic hexameter	feminine penthemimeral, trithemimeral
νεῖκος ἀπωσαμένους δηίους προτὶ ἄστυ δίεσθαι.	-u u-uu- -- uu -u u--	dactylic hexameter	masculine penthemimeral, hepthemimeral
ὣς τώ γε προβοῶντε μάχην ὄτρυνον Ἀχαιῶν.	- - - uu-u u- --u u--	dactylic hexameter	feminine penthemimeral, hepthemimeral, trithemimeral
τῶν δ’,ὥς τε νιφάδες χιόνος πίπτωσι θαμειαὶ	- - - uu- uu- --u u--	dactylic hexameter	masculine penthemimeral, hepthemimeral, trithemimeral
ἤματι χειμερίῳ, ὅτε τ’ὤρετο μητίετα Ζεὺς	-uu -uu- uu -uu -uu- -	dactylic hexameter	masculine penthemimeral
νιφέμεν ἀνθρώποισι πιφαυσκόμενος τὰ ἃ κῆλα·	-uu ---u u-uu- u u --	dactylic hexameter	feminine penthemimeral
κοιμήσας δ’ἀνέμους χέει ἔμπεδον, ὄφρα καλύψῃ	--- uu- uu -uu -u u--	dactylic hexameter	masculine penthemimeral, trithemimeral
ὑψηλῶν ὀρέων κορυφὰς καὶ πρώονας ἄκρους	--- uu- uu- - -uu --	dactylic hexameter	masculine penthemimeral, hepthemimeral, trithemimeral
καὶ πεδία λωτοῦντα καὶ ἀνδρῶν πίονα ἔργα,	- uu- --u u -- -uu --	dactylic hexameter	feminine penthemimeral, trithemimeral
καί τ’ἐφ’ ἁλὸς πολιῆς κέχυται λιμέσιν τε καὶ ἀκταῖς,	- u u- uu- uu- uu- u u --	dactylic hexameter	masculine penthemimeral, hepthemimeral, trithemimeral
κῦμα δέ μιν προσπλάζον ἐρύκεται· ἄλλά τε πάντα	-u u - --u u-uu -u u --	dactylic hexameter	feminine penthemimeral, trithemimeral
εἴλυται καθύπερθ’, ὅτ’ ἐπιβρίσῃ Διὸς ὄμβρος·	--- uu- u u--- uu --	dactylic hexameter	masculine penthemimeral, trithemimeral
ὣς τῶν ἀμφοτέρωσε λίθοι πωτῶντο θαμειαί,	- - -uu-u u- --u u--	dactylic hexameter	feminine penthemimeral, hepthemimeral
αἱ μὲν ἄρ’ ἐς Τρῶας, αἱ δ’ἐκ Τρώων ἐς Ἀχαιούς,	- u u - -- - - -- u u--	dactylic hexameter	masculine penthemimeral, hepthemimeral, trithemimeral
βαλλομένων· τὸ δὲ τεῖχος ὕπερ πᾶν δοῦπος ὀρώρει.	-uu- u u -u u- - -u u--	dactylic hexameter	feminine penthemimeral, hepthemimeral, trithemimeral
οὐδ’ ἄν πω τότε γε Τρῶες καὶ φαίδιμος Ἕκτωρ	- - - uu - -- - -uu --	dactylic hexameter	masculine penthemimeral, hepthemimeral, trithemimeral
τείχεος ἐρρήξαντο πύλας καὶ μακρὸν ὀχῆα,	-uu ---u u- - -u u--	dactylic hexameter	feminine penthemimeral, hepthemimeral
εἰ μὴ ἄρ’ υἱὸν ἑὸν Σαρπηδόνα μητίετα Ζεὺς	- u u -u u- --uu -uu- -	dactylic hexameter	masculine penthemimeral
ὦρσεν ἐπ’ Ἀργείοισι λέονθ’ ὣς βουσὶν ἕλιξιν.	-u u ---u u- - -u u--	dactylic hexameter	feminine penthemimeral, hepthemimeral
αὐτίκα δ’ἀσπίδα μὲν πρόσθ’ ἔσχετο πάντοσ’ ἐΐσην	-uu -uu - - -uu -u u--	dactylic hexameter	masculine penthemimeral
καλὴν χαλκείην ἐξήλατον, ἣν ἄρα χαλκεὺς	-- --- --uu - uu --	dactylic hexameter	masculine penthemimeral
ἤλασεν, ἔντοσθεν δὲ βοείας ῥάψε θαμειὰς	-uu --- u u-- -u u--	dactylic hexameter	masculine penthemimeral
χρυσείῃς ῥάβδοισι διηνεκέσιν περὶ κύκλον.	--- --u u-uu- uu --	dactylic hexameter	feminine penthemimeral, trithemimeral
τὴν ἄρ’ ὅ γε πρόσθε σχόμενος δύο δοῦρε τινάσσων	- u u - -- uu- uu -u u--	dactylic hexameter	masculine penthemimeral, hepthemimeral, trithemimeral
βῆ ῥ’ἴμεν ὥς τε λέων ὀρεσίτροφος, ὅς τ’ἐπιδευὴς	- uu - u u- uu-uu - uu--	dactylic hexameter	masculine penthemimeral, trithemimeral
δηρὸν ἔῃ κρειῶν, κέλεται δέ ἑ θυμὸς ἀγήνωρ	-u u- -- uu- u u -u u--	dactylic hexameter	masculine penthemimeral, hepthemimeral, trithemimeral
μήλων πειρήσοντα καὶ ἐς πυκινὸν δόμον ἐλθεῖν·	-- ---u u - uu- uu --	dactylic hexameter	feminine penthemimeral, hepthemimeral
εἴ περ γάρ χ’εὕρῃσι παρ’ αὐτόφι βώτορας ἄνδρας	- - - --u u -uu -uu --	dactylic hexameter	feminine penthemimeral, trithemimeral
σὺν κυσὶ καὶ δούρεσσι φυλάσσοντας περὶ μῆλα,	- uu - --u u--- uu --	dactylic hexameter	feminine penthemimeral, trithemimeral
οὔ ῥά τ’ἀπείρητος μέμονε σταθμοῖο δίεσθαι,	- u u--- uu- --u u--	dactylic hexameter	masculine penthemimeral, hepthemimeral
ἀλλ’ ὅ γ’ἄρ’ ἢ ἥρπαξε μετάλμενος, ἠὲ καὶ αὐτὸς	- u u - --u u-uu -u u --	dactylic hexameter	feminine penthemimeral, trithemimeral
ἔβλητ’ ἐν πρώτοισι θοῆς ἀπὸ χειρὸς ἄκοντι·	-- - --u u- uu -u u--	dactylic hexameter	feminine penthemimeral, hepthemimeral, trithemimeral
ὥς ῥα τότ’ ἀντίθεον Σαρπηδόνα θυμὸς ἀνῆκε	- u u -uu- --uu -u u--	dactylic hexameter	masculine penthemimeral
τεῖχος ἐπαΐξαι διά τε ῥήξασθαι ἐπάλξεις.	-u u--- uu - --u u--	dactylic hexameter	masculine penthemimeral, hepthemimeral
αὐτίκα δὲ Γλαῦκον προσέφη παῖδ’ Ἱππολόχοιο·	-uu - -- uu- - -uu--	dactylic hexameter	masculine penthemimeral, hepthemimeral, trithemimeral
Γλαῦκε τί ἢ δὴ νῶϊ τετιμήμεσθα μάλιστα	-u u - - -u u---u u--	dactylic hexameter	feminine penthemimeral, trithemimeral
ἕδρῃ τε κρέασίν τε ἰδὲ πλείοις δεπάεσσιν	-- - uu- u u- -- uu--	dactylic hexameter	masculine penthemimeral, hepthemimeral, trithemimeral
ἐν Λυκίῃ, πάντες δὲ θεοὺς ὣς εἰσορόωσι,	- uu- -- u u- - -uu--	dactylic hexameter	masculine penthemimeral, hepthemimeral, trithemimeral
καὶ τέμενος νεμόμεσθα μέγα Ξάνθοιο παρ’ ὄχθας	- uu- uu-u u- --u u --	dactylic hexameter	feminine penthemimeral, hepthemimeral, trithemimeral
καλὸν φυταλιῆς καὶ ἀρούρης πυροφόροιο;	-- -uu- u u-- -uu--	dactylic hexameter	masculine penthemimeral
τὼ νῦν χρὴ Λυκίοισι μέτα πρώτοισιν ἐόντας	- - - uu-u u- --u u--	dactylic hexameter	feminine penthemimeral, hepthemimeral, trithemimeral
ἑστάμεν ἠδὲ μάχης καυστείρης ἀντιβολῆσαι,	-uu -u u- --- -uu--	dactylic hexameter	masculine penthemimeral
ὄφρά τις ὧδ’ εἴπῃ Λυκίων πύκα θωρηκτάων·	-u u - -- uu- uu ----	dactylic hexameter	masculine penthemimeral, hepthemimeral, trithemimeral
οὐ μὰν ἀκλεέες Λυκίην κάτα κοιρανέουσιν	- - -uu- uu- uu -uu--	dactylic hexameter	masculine penthemimeral, hepthemimeral
ἡμέτεροι βασιλῆες, ἔδουσί τε πίονα μῆλα	-uu- uu-u u-u u -uu --	dactylic hexameter	feminine penthemimeral, trithemimeral
οἶνόν τ’ἔξαιτον μελιηδέα· ἀλλ’ ἄρα καὶ ἲς	-- --- uu-uu - uu - -	dactylic hexameter	masculine penthemimeral
ἐσθλή, ἐπεὶ Λυκίοισι μέτα πρώτοισι μάχονται.	-u u- uu-u u- --u u--	dactylic hexameter	feminine penthemimeral, hepthemimeral, trithemimeral
ὦ πέπον εἰ μὲν γὰρ πόλεμον περὶ τόνδε φυγόντε	- uu - - - uu- uu -u u--	dactylic hexameter	masculine penthemimeral, hepthemimeral, trithemimeral
αἰεὶ δὴ μέλλοιμεν ἀγήρω τ’ἀθανάτω τε	-- - --u u-- -uu- -	dactylic hexameter	feminine penthemimeral, trithemimeral
ἔσσεσθ’, οὔτέ κεν αὐτὸς ἐνὶ πρώτοισι μαχοίμην	-- -u u -u u- --u u--	dactylic hexameter	feminine penthemimeral, hepthemimeral
οὔτέ κε σὲ στέλλοιμι μάχην ἐς κυδιάνειραν·	-u u - --u u- - -uu--	dactylic hexameter	feminine penthemimeral, hepthemimeral, trithemimeral
νῦν δ’ἔμπης γὰρ κῆρες ἐφεστᾶσιν θανάτοιο	- -- - -u u--- uu--	dactylic hexameter	feminine penthemimeral, trithemimeral
μυρίαι, ἃς οὐκ ἔστι φυγεῖν βροτὸν οὐδ’ ὑπαλύξαι,	-uu - - -u u- uu - uu--	dactylic hexameter	feminine penthemimeral, hepthemimeral, trithemimeral
ἴομεν ἠέ τῳ εὖχος ὀρέξομεν ἠέ τις ἡμῖν.	-uu -u u -u u-uu -u u --	dactylic hexameter	feminine penthemimeral
ὣς ἔφατ’, οὐδὲ Γλαῦκος ἀπετράπετ’ οὐδ’ ἀπίθησε·	- uu -- -u u-uu - uu--	dactylic hexameter	feminine penthemimeral
τὼ δ’ἰθὺς βήτην Λυκίων μέγα ἔθνος ἄγοντε.	- -- -- uu- uu -u u--	dactylic hexameter	masculine penthemimeral, hepthemimeral, trithemimeral
τοὺς δὲ ἰδὼν ῥίγησ’ υἱὸς Πετεῶο Μενεσθεύς·	- u u- -- -- uu-u u--	dactylic hexameter	masculine penthemimeral, hepthemimeral, trithemimeral
τοῦ γὰρ δὴ πρὸς πύργον ἴσαν κακότητα φέροντες.	- - - - -u u- uu-u u--	dactylic hexameter	feminine penthemimeral, hepthemimeral, trithemimeral
πάπτηνεν δ’ἀνὰ πύργον Ἀχαιῶν εἴ τιν’ ἴδοιτο	--- uu -u u-- - u u--	dactylic hexameter	feminine penthemimeral, trithemimeral
ἡγεμόνων, ὅς τίς οἱ ἀρὴν ἑτάροισιν ἀμύναι·	-uu- - - u u- uu-u u--	dactylic hexameter	masculine penthemimeral, hepthemimeral, trithemimeral
ἐς δ’ἐνόησ’ Αἴαντε δύω πολέμου ἀκορήτω	- uu- --u u- uu- uu--	dactylic hexameter	feminine penthemimeral, hepthemimeral, trithemimeral
ἑσταότας, Τεῦκρόν τε νέον κλισίηθεν ἰόντα	-uu- -- u u- uu-u u--	dactylic hexameter	masculine penthemimeral, hepthemimeral, trithemimeral
ἐγγύθεν· ἀλλ’ οὔ πώς οἱ ἔην βώσαντι γεγωνεῖν·	-uu - - - u u- --u u--	dactylic hexameter	masculine penthemimeral, hepthemimeral, trithemimeral
τόσσος γὰρ κτύπος ἦεν, ἀϋτὴ δ’οὐρανὸν ἷκε,	-- - uu -u u-- -uu --	dactylic hexameter	feminine penthemimeral, trithemimeral
βαλλομένων σακέων τε καὶ ἱπποκόμων τρυφαλειῶν	-uu- uu- u u -uu- uu--	dactylic hexameter	masculine penthemimeral, trithemimeral
καὶ πυλέων· πᾶσαι γὰρ ἐπώχατο, τοὶ δὲ κατ’ αὐτὰς	- -- -- u u-uu - u u --	dactylic hexameter	masculine penthemimeral, trithemimeral
ἱστάμενοι πειρῶντο βίῃ ῥήξαντες ἐσελθεῖν.	-uu- --u u- --u u--	dactylic hexameter	feminine penthemimeral, hepthemimeral, trithemimeral
αἶψα δ’ἐπ’ Αἴαντα προΐει κήρυκα Θοώτην·	-u u --- uu- --u u--	dactylic hexameter	masculine penthemimeral, hepthemimeral
ἔρχεο δῖε Θοῶτα, θέων Αἴαντα κάλεσσον,	-uu -u u-u u- --u u--	dactylic hexameter	feminine penthemimeral, hepthemimeral
ἀμφοτέρω μὲν μᾶλλον· ὃ γάρ κ’ὄχ’ ἄριστον ἁπάντων	-uu- - -u u - u u-u u--	dactylic hexameter	feminine penthemimeral, hepthemimeral, trithemimeral
εἴη, ἐπεὶ τάχα τῇδε τετεύξεται αἰπὺς ὄλεθρος.	-u u- uu -u u-uu -u u--	dactylic hexameter	feminine penthemimeral, trithemimeral
ὧδε γὰρ ἔβρισαν Λυκίων ἀγοί, οἳ τὸ πάρος περ	-u u --- uu- uu - u u- -	dactylic hexameter	masculine penthemimeral, hepthemimeral
ζαχρηεῖς τελέθουσι κατὰ κρατερὰς ὑσμίνας.	--- uu-u u- uu- ---	dactylic hexameter	feminine penthemimeral, hepthemimeral, trithemimeral
εἰ δέ σφιν καὶ κεῖθι πόνος καὶ νεῖκος ὄρωρεν,	- - - - -u u- - -u u--	dactylic hexameter	feminine penthemimeral, hepthemimeral, trithemimeral
ἀλλά περ οἶος ἴτω Τελαμώνιος ἄλκιμος Αἴας,	-u u -u u- uu-uu -uu --	dactylic hexameter	masculine penthemimeral
καί οἱ Τεῦκρος ἅμα σπέσθω τόξων ἐῢ εἰδώς.	- - -u u- -- -- uu --	dactylic hexameter	masculine penthemimeral, hepthemimeral
ὣς ἔφατ’, οὐδ’ ἄρα οἱ κῆρυξ ἀπίθησεν ἀκούσας,	- uu - uu - -- uu-u u--	dactylic hexameter	masculine penthemimeral, hepthemimeral, trithemimeral
βῆ δὲ θέειν παρὰ τεῖχος Ἀχαιῶν χαλκοχιτώνων,	- u u- uu -u u-- -uu--	dactylic hexameter	feminine penthemimeral, trithemimeral
στῆ δὲ παρ’ Αἰάντεσσι κιών, εἶθαρ δὲ προσηύδα·	- u u ---u u- -- u u--	dactylic hexameter	feminine penthemimeral, hepthemimeral
Αἴαντ’ Ἀργείων ἡγήτορε χαλκοχιτώνων	-- --- --uu -uu--	dactylic hexameter	masculine penthemimeral
ἠνώγει Πετεῶο διοτρεφέος φίλος υἱὸς	--- uu-u u-uu- uu --	dactylic hexameter	feminine penthemimeral, trithemimeral
κεῖσ’ ἴμεν, ὄφρα πόνοιο μίνυνθά περ ἀντιάσητον	- uu -u u-u u-u u -uu--	dactylic hexameter	feminine penthemimeral
ἀμφοτέρω μὲν μᾶλλον· ὃ γάρ κ’ὄχ’ ἄριστον ἁπάντων	-uu- - -u u - u u-u u--	dactylic hexameter	feminine penthemimeral, hepthemimeral, trithemimeral
εἴη, ἐπεὶ τάχα κεῖθι τετεύξεται αἰπὺς ὄλεθρος·	-u u- uu -u u-uu -u u--	dactylic hexameter	feminine penthemimeral, trithemimeral
ὧδε γὰρ ἔβρισαν Λυκίων ἀγοί, οἳ τὸ πάρος περ	-u u --- uu- uu - u u- -	dactylic hexameter	masculine penthemimeral, hepthemimeral
ζαχρηεῖς τελέθουσι κατὰ κρατερὰς ὑσμίνας.	--- uu-u u- uu- ---	dactylic hexameter	feminine penthemimeral, hepthemimeral, trithemimeral
εἰ δὲ καὶ ἐνθάδε περ πόλεμος καὶ νεῖκος ὄρωρεν,	- u u -uu - uu- - -u u--	dactylic hexameter	masculine penthemimeral, hepthemimeral
ἀλλά περ οἶος ἴτω Τελαμώνιος ἄλκιμος Αἴας,	-u u -u u- uu-uu -uu --	dactylic hexameter	masculine penthemimeral
καί οἱ Τεῦκρος ἅμα σπέσθω τόξων ἐῢ εἰδώς.	- - -u u- -- -- uu --	dactylic hexameter	masculine penthemimeral, hepthemimeral
ὣς ἔφατ’, οὐδ’ ἀπίθησε μέγας Τελαμώνιος Αἴας.	- uu - uu-u u- uu-uu --	dactylic hexameter	feminine penthemimeral, hepthemimeral, trithemimeral
αὐτίκ’ Ὀϊλιάδην ἔπεα πτερόεντα προσηύδα·	-u u-uu- uu- uu-u u--	dactylic hexameter	masculine penthemimeral, hepthemimeral
Αἶαν σφῶϊ μὲν αὖθι, σὺ καὶ κρατερὸς Λυκομήδης,	-- -u u -u u - uu- uu--	dactylic hexameter	feminine penthemimeral, hepthemimeral
ἑσταότες Δαναοὺς ὀτρύνετον ἶφι μάχεσθαι·	-uu- uu- --uu -u u--	dactylic hexameter	masculine penthemimeral, trithemimeral
αὐτὰρ ἐγὼ κεῖσ’ εἶμι καὶ ἀντιόω πολέμοιο·	-u u- - -u u -uu- uu--	dactylic hexameter	feminine penthemimeral, trithemimeral
αἶψα δ’ἐλεύσομαι αὖτις, ἐπὴν εὖ τοῖς ἐπαμύνω.	-u u-uu -u u- - - uu--	dactylic hexameter	feminine penthemimeral, hepthemimeral
ὣς ἄρα φωνήσας ἀπέβη Τελαμώνιος Αἴας,	- uu --- uu- uu-uu --	dactylic hexameter	masculine penthemimeral, hepthemimeral
καί οἱ Τεῦκρος ἅμ’ ᾖε κασίγνητος καὶ ὄπατρος·	- - -u u -u u--- u u--	dactylic hexameter	feminine penthemimeral
τοῖς δ’ἅμα Πανδίων Τεύκρου φέρε καμπύλα τόξα.	- uu --- -- uu -uu --	dactylic hexameter	masculine penthemimeral, hepthemimeral
εὖτε Μενεσθῆος μεγαθύμου πύργον ἵκοντο	-u u--- uu-- -u u--	dactylic hexameter	masculine penthemimeral
τείχεος ἐντὸς ἰόντες, ἐπειγομένοισι δ’ἵκοντο,	-uu -u u-u u-uu-u u--	dactylic hexameter	feminine penthemimeral
οἳ δ’ἐπ’ ἐπάλξεις βαῖνον ἐρεμνῇ λαίλαπι ἶσοι	- u u-- -u u-- -uu --	dactylic hexameter	feminine penthemimeral
ἴφθιμοι Λυκίων ἡγήτορες ἠδὲ μέδοντες·	--- uu- --uu -u u--	dactylic hexameter	masculine penthemimeral, trithemimeral
σὺν δ’ἐβάλοντο μάχεσθαι ἐναντίον, ὦρτο δ’ἀϋτή.	- uu-u u-u u-uu -u u--	dactylic hexameter	feminine penthemimeral
Αἴας δὲ πρῶτος Τελαμώνιος ἄνδρα κατέκτα	-- - -- uu-uu -u u--	dactylic hexameter	masculine penthemimeral, trithemimeral
Σαρπήδοντος ἑταῖρον Ἐπικλῆα μεγάθυμον	---u u-u u--- uu--	dactylic hexameter	feminine penthemimeral
μαρμάρῳ ὀκριόεντι βαλών, ὅ ῥα τείχεος ἐντὸς	-uu -uu-u u- u u -uu --	dactylic hexameter	feminine penthemimeral, hepthemimeral
κεῖτο μέγας παρ’ ἔπαλξιν ὑπέρτατος· οὐδέ κέ μιν ῥέα	-u u- u u-u u-uu -u u - -	dactylic hexameter	feminine penthemimeral, trithemimeral
χείρεσσ’ ἀμφοτέρῃς ἔχοι ἀνὴρ οὐδὲ μάλ’ ἡβῶν,	-- -uu- uu -- -u u --	dactylic hexameter	masculine penthemimeral
οἷοι νῦν βροτοί εἰσ’· ὃ δ’ἄρ’ ὑψόθεν ἔμβαλ’ ἀείρας,	-- - uu - u u -uu -u u--	dactylic hexameter	masculine penthemimeral, trithemimeral
θλάσσε δὲ τετράφαλον κυνέην, σὺν δ’ὀστέ’ ἄραξε	-u u -uu- uu- - -u u--	dactylic hexameter	masculine penthemimeral, hepthemimeral
πάντ’ ἄμυδις κεφαλῆς· ὃ δ’ἄρ’ ἀρνευτῆρι ἐοικὼς	- uu- uu- u u ---u u--	dactylic hexameter	masculine penthemimeral, trithemimeral
κάππεσ’ ἀφ’ ὑψηλοῦ πύργου, λίπε δ’ὀστέα θυμός.	-u u --- -- uu -uu --	dactylic hexameter	masculine penthemimeral, hepthemimeral
Τεῦκρος δὲ Γλαῦκον κρατερὸν παῖδ’ Ἱππολόχοιο	-- - -- uu- - -uu--	dactylic hexameter	masculine penthemimeral, hepthemimeral, trithemimeral
ἰῷ ἐπεσσύμενον βάλε τείχεος ὑψηλοῖο,	-u u-uu- uu -uu ----	dactylic hexameter	masculine penthemimeral
ᾗ ῥ’ἴδε γυμνωθέντα βραχίονα, παῦσε δὲ χάρμης.	- uu ---u u-uu -u u --	dactylic hexameter	feminine penthemimeral
ἂψ δ’ἀπὸ τείχεος ἆλτο λαθών, ἵνα μή τις Ἀχαιῶν	- uu -uu -u u- uu - u u--	dactylic hexameter	feminine penthemimeral, hepthemimeral
βλήμενον ἀθρήσειε καὶ εὐχετόῳτ’ ἐπέεσσι.	-uu ---u u -uu- uu--	dactylic hexameter	feminine penthemimeral
Σαρπήδοντι δ’ἄχος γένετο Γλαύκου ἀπιόντος	---u u- uu- -- uu--	dactylic hexameter	masculine penthemimeral, hepthemimeral
αὐτίκ’ ἐπεί τ’ἐνόησεν· ὅμως δ’οὐ λήθετο χάρμης,	-u u- uu-u u- - -uu --	dactylic hexameter	feminine penthemimeral, hepthemimeral, trithemimeral
ἀλλ’ ὅ γε Θεστορίδην Ἀλκμάονα δουρὶ τυχήσας	- u u -uu- --uu -u u--	dactylic hexameter	masculine penthemimeral
νύξ’, ἐκ δ’ἔσπασεν ἔγχος· ὃ δ’ἑσπόμενος πέσε δουρὶ	- - -uu -u u -uu- uu --	dactylic hexameter	feminine penthemimeral
πρηνής, ἀμφὶ δέ οἱ βράχε τεύχεα ποικίλα χαλκῷ,	-- -u u - uu -uu -uu --	dactylic hexameter	masculine penthemimeral
Σαρπηδὼν δ’ἄρ’ ἔπαλξιν ἑλὼν χερσὶ στιβαρῇσιν	--- u u-u u- -- uu--	dactylic hexameter	feminine penthemimeral, hepthemimeral, trithemimeral
ἕλχ’, ἣ δ’ἕσπετο πᾶσα διαμπερές, αὐτὰρ ὕπερθε	- - -uu -u u-uu -u u--	dactylic hexameter	feminine penthemimeral
τεῖχος ἐγυμνώθη, πολέεσσι δὲ θῆκε κέλευθον.	-u u--- uu-u u -u u--	dactylic hexameter	masculine penthemimeral
τὸν δ’Αἴας καὶ Τεῦκρος ὁμαρτήσανθ’ ὃ μὲν ἰῷ	- -- - -u u--- u u --	dactylic hexameter	feminine penthemimeral, trithemimeral
βεβλήκει τελαμῶνα περὶ στήθεσσι φαεινὸν	--- uu-u u- --u u--	dactylic hexameter	feminine penthemimeral, hepthemimeral, trithemimeral
ἀσπίδος ἀμφιβρότης· ἀλλὰ Ζεὺς κῆρας ἄμυνε	-uu -uu- -- - -u u--	dactylic hexameter	masculine penthemimeral, hepthemimeral
παιδὸς ἑοῦ, μὴ νηυσὶν ἔπι πρύμνῃσι δαμείη·	-u u- - -u u- --u u--	dactylic hexameter	feminine penthemimeral, hepthemimeral, trithemimeral
Αἴας δ’ἀσπίδα νύξεν ἐπάλμενος, οὐδὲ διὰ πρὸ	-- -uu -u u-uu -u u- -	dactylic hexameter	feminine penthemimeral
ἤλυθεν ἐγχείη, στυφέλιξε δέ μιν μεμαῶτα.	-uu --- uu-u u - uu--	dactylic hexameter	masculine penthemimeral
χώρησεν δ’ἄρα τυτθὸν ἐπάλξιος· οὐδ’ ὅ γε πάμπαν	--- uu -u u-uu - u u --	dactylic hexameter	feminine penthemimeral, trithemimeral
χάζετ’, ἐπεί οἱ θυμὸς ἐέλπετο κῦδος ἀρέσθαι.	-u u- - -u u-uu -u u--	dactylic hexameter	feminine penthemimeral, trithemimeral
κέκλετο δ’ἀντιθέοισιν ἑλιξάμενος Λυκίοισιν·	-uu -uu-u u-uu- uu--	dactylic hexameter	feminine penthemimeral
ὦ Λύκιοι τί τ’ἄρ’ ὧδε μεθίετε θούριδος ἀλκῆς;	- uu- u u -u u-uu -uu --	dactylic hexameter	feminine penthemimeral, trithemimeral
ἀργαλέον δέ μοί ἐστι καὶ ἰφθίμῳ περ ἐόντι	-uu- u u -u u --- u u--	dactylic hexameter	feminine penthemimeral, trithemimeral
μούνῳ ῥηξαμένῳ θέσθαι παρὰ νηυσὶ κέλευθον·	-- -uu- -- uu -u u--	dactylic hexameter	masculine penthemimeral, hepthemimeral
ἀλλ’ ἐφομαρτεῖτε· πλεόνων δέ τι ἔργον ἄμεινον.	- uu--- uu- u u -u u--	dactylic hexameter	masculine penthemimeral, hepthemimeral
ὣς ἔφαθ’, οἳ δὲ ἄνακτος ὑποδείσαντες ὁμοκλὴν	- uu - u u-u u---u u--	dactylic hexameter	feminine penthemimeral, trithemimeral
μᾶλλον ἐπέβρισαν βουληφόρον ἀμφὶ ἄνακτα.	-u u--- --uu -u u--	dactylic hexameter	masculine penthemimeral
Ἀργεῖοι δ’ἑτέρωθεν ἐκαρτύναντο φάλαγγας	--- uu-u u---u u--	dactylic hexameter	feminine penthemimeral, trithemimeral
τείχεος ἔντοσθεν, μέγα δέ σφισι φαίνετο ἔργον·	-uu --- uu - uu -uu --	dactylic hexameter	masculine penthemimeral, hepthemimeral
οὔτε γὰρ ἴφθιμοι Λύκιοι Δαναῶν ἐδύναντο	-u u --- uu- uu- uu--	dactylic hexameter	masculine penthemimeral, hepthemimeral
τεῖχος ῥηξάμενοι θέσθαι παρὰ νηυσὶ κέλευθον,	-- -uu- -- uu -u u--	dactylic hexameter	masculine penthemimeral, hepthemimeral
οὔτέ ποτ’ αἰχμηταὶ Δαναοὶ Λυκίους ἐδύναντο	-u u --- uu- uu- uu--	dactylic hexameter	masculine penthemimeral, hepthemimeral
τείχεος ἂψ ὤσασθαι, ἐπεὶ τὰ πρῶτα πέλασθεν.	-uu - --u u- - -u u--	dactylic hexameter	feminine penthemimeral, hepthemimeral, trithemimeral
ἀλλ’ ὥς τ’ἀμφ’ οὔροισι δύ’ ἀνέρε δηριάασθον	- - - --u u -uu -uu--	dactylic hexameter	feminine penthemimeral, trithemimeral
μέτρ’ ἐν χερσὶν ἔχοντες ἐπιξύνῳ ἐν ἀρούρῃ,	- - -u u-u u--- u u--	dactylic hexameter	feminine penthemimeral
ὥ τ’ὀλίγῳ ἐνὶ χώρῳ ἐρίζητον περὶ ἴσης,	- uu- uu -u u--- uu --	dactylic hexameter	feminine penthemimeral, trithemimeral
ὣς ἄρα τοὺς διέεργον ἐπάλξιες· οἳ δ’ὑπὲρ αὐτέων	- uu - uu-u u-uu - uu --	dactylic hexameter	feminine penthemimeral, trithemimeral
δῄουν ἀλλήλων ἀμφὶ στήθεσσι βοείας	-- --- -- --u u--	dactylic hexameter	masculine penthemimeral, hepthemimeral
ἀσπίδας εὐκύκλους λαισήϊά τε πτερόεντα.	-uu --- --uu - uu--	dactylic hexameter	masculine penthemimeral
πολλοὶ δ’οὐτάζοντο κατὰ χρόα νηλέϊ χαλκῷ,	-- ---u u- uu -uu --	dactylic hexameter	feminine penthemimeral, hepthemimeral
ἠμὲν ὅτεῳ στρεφθέντι μετάφρενα γυμνωθείη	-u u- --u u-uu ----	dactylic hexameter	feminine penthemimeral, trithemimeral
μαρναμένων, πολλοὶ δὲ διαμπερὲς ἀσπίδος αὐτῆς.	-uu- -- u u-uu -uu --	dactylic hexameter	masculine penthemimeral, trithemimeral
πάντῃ δὴ πύργοι καὶ ἐπάλξιες αἵματι φωτῶν	-- - -- u u-uu -uu --	dactylic hexameter	masculine penthemimeral, trithemimeral
ἐρράδατ’ ἀμφοτέρωθεν ἀπὸ Τρώων καὶ Ἀχαιῶν.	-uu -uu-u u- -- u u--	dactylic hexameter	feminine penthemimeral, hepthemimeral
ἀλλ’ οὐδ’ ὧς ἐδύναντο φόβον ποιῆσαι Ἀχαιῶν,	- - - uu-u u- --u u--	dactylic hexameter	feminine penthemimeral, hepthemimeral, trithemimeral
ἀλλ’ ἔχον ὥς τε τάλαντα γυνὴ χερνῆτις ἀληθής,	- uu - u u-u u- --u u--	dactylic hexameter	feminine penthemimeral, hepthemimeral, trithemimeral
ἥ τε σταθμὸν ἔχουσα καὶ εἴριον ἀμφὶς ἀνέλκει	- - -u u-u u -uu -u u--	dactylic hexameter	feminine penthemimeral
ἰσάζουσ’, ἵνα παισὶν ἀεικέα μισθὸν ἄρηται·	--- uu -u u-uu -u u--	dactylic hexameter	feminine penthemimeral, trithemimeral
ὣς μὲν τῶν ἐπὶ ἶσα μάχη τέτατο πτόλεμός τε,	- - - uu -u u- uu- uu- -	dactylic hexameter	feminine penthemimeral, hepthemimeral, trithemimeral
πρίν γ’ὅτε δὴ Ζεὺς κῦδος ὑπέρτερον Ἕκτορι δῶκε	- uu - - -u u-uu -uu --	dactylic hexameter	feminine penthemimeral, trithemimeral
Πριαμίδῃ, ὃς πρῶτος ἐσήλατο τεῖχος Ἀχαιῶν.	-uu- - -u u-uu -u u--	dactylic hexameter	feminine penthemimeral, trithemimeral
ἤϋσεν δὲ διαπρύσιον Τρώεσσι γεγωνώς·	--- u u-uu- --u u--	dactylic hexameter	hepthemimeral, trithemimeral
ὄρνυσθ’ ἱππόδαμοι Τρῶες, ῥήγνυσθε δὲ τεῖχος	-- -uu- -- --u u --	dactylic hexameter	masculine penthemimeral, hepthemimeral
Ἀργείων καὶ νηυσὶν ἐνίετε θεσπιδαὲς πῦρ.	--- - -u u-uu -uu- -	dactylic hexameter	feminine penthemimeral, trithemimeral
ὣς φάτ’ ἐποτρύνων, οἳ δ’οὔασι πάντες ἄκουον,	- u u--- - -uu -u u--	dactylic hexameter	masculine penthemimeral
ἴθυσαν δ’ἐπὶ τεῖχος ἀολλέες· οἳ μὲν ἔπειτα	--- uu -u u-uu - u u--	dactylic hexameter	feminine penthemimeral, trithemimeral
κροσσάων ἐπέβαινον ἀκαχμένα δούρατ’ ἔχοντες,	--- uu-u u-uu -u u--	dactylic hexameter	feminine penthemimeral, trithemimeral
Ἕκτωρ δ’ἁρπάξας λᾶαν φέρεν, ὅς ῥα πυλάων	-- --- -- uu - u u--	dactylic hexameter	masculine penthemimeral, hepthemimeral
ἑστήκει πρόσθε πρυμνὸς παχύς, αὐτὰρ ὕπερθεν	--- -- -- uu -u u--	dactylic hexameter	masculine penthemimeral, hepthemimeral, trithemimeral
ὀξὺς ἔην· τὸν δ’οὔ κε δύ’ ἀνέρε δήμου ἀρίστω	-u u- - - u u -uu -u u--	dactylic hexameter	masculine penthemimeral, trithemimeral
ῥηϊδίως ἐπ’ ἄμαξαν ἀπ’ οὔδεος ὀχλίσσειαν,	-uu- u u-u u -uu ----	dactylic hexameter	feminine penthemimeral, trithemimeral
οἷοι νῦν βροτοί εἰσ’· ὃ δέ μιν ῥέα πάλλε καὶ οἶος.	-- - uu - u u - uu -u u --	dactylic hexameter	masculine penthemimeral, hepthemimeral, trithemimeral
τόν οἱ ἐλαφρὸν ἔθηκε Κρόνου πάϊς ἀγκυλομήτεω.	- u u-u u-u u- uu -uu--	dactylic hexameter	feminine penthemimeral, hepthemimeral
ὡς δ’ὅτε ποιμὴν ῥεῖα φέρει πόκον ἄρσενος οἰὸς	- uu -- -u u- uu -uu --	dactylic hexameter	feminine penthemimeral, hepthemimeral
χειρὶ λαβὼν ἑτέρῃ, ὀλίγον τέ μιν ἄχθος ἐπείγει,	-u u- uu- uu- u u -u u--	dactylic hexameter	masculine penthemimeral, hepthemimeral, trithemimeral
ὣς Ἕκτωρ ἰθὺς σανίδων φέρε λᾶαν ἀείρας,	- -- -- uu- uu -u u--	dactylic hexameter	masculine penthemimeral, hepthemimeral, trithemimeral
αἵ ῥα πύλας εἴρυντο πύκα στιβαρῶς ἀραρυίας	- u u- --u u- uu- uu--	dactylic hexameter	feminine penthemimeral, hepthemimeral, trithemimeral
δικλίδας ὑψηλάς· δοιοὶ δ’ἔντοσθεν ὀχῆες	-uu --- -- --u u--	dactylic hexameter	masculine penthemimeral, hepthemimeral
εἶχον ἐπημοιβοί, μία δὲ κληῒς ἐπαρήρει.	-u u--- uu - -- uu--	dactylic hexameter	masculine penthemimeral, hepthemimeral
στῆ δὲ μάλ’ ἐγγὺς ἰών, καὶ ἐρεισάμενος βάλε μέσσας	- u u -u u- u u-uu- uu --	dactylic hexameter	masculine penthemimeral
εὖ διαβάς, ἵνα μή οἱ ἀφαυρότερον βέλος εἴη,	- uu- uu - u u-uu- uu --	dactylic hexameter	masculine penthemimeral, trithemimeral
ῥῆξε δ’ἀπ’ ἀμφοτέρους θαιρούς· πέσε δὲ λίθος εἴσω	-u u -uu- -- uu - uu --	dactylic hexameter	masculine penthemimeral, hepthemimeral
βριθοσύνῃ, μέγα δ’ἀμφὶ πύλαι μύκον, οὐδ’ ἄρ’ ὀχῆες	-uu- uu -u u- uu - u u--	dactylic hexameter	feminine penthemimeral, hepthemimeral, trithemimeral
ἐσχεθέτην, σανίδες δὲ διέτμαγεν ἄλλυδις ἄλλη	-uu- uu- u u-uu -uu --	dactylic hexameter	masculine penthemimeral, trithemimeral
λᾶος ὑπὸ ῥιπῆς· ὃ δ’ἄρ’ ἔσθορε φαίδιμος Ἕκτωρ	-u u- -- u u -uu -uu --	dactylic hexameter	masculine penthemimeral, trithemimeral
νυκτὶ θοῇ ἀτάλαντος ὑπώπια· λάμπε δὲ χαλκῷ	-u u- uu-u u-uu -u u --	dactylic hexameter	feminine penthemimeral, trithemimeral
σμερδαλέῳ, τὸν ἕεστο περὶ χροΐ, δοιὰ δὲ χερσὶ	-uu- u u-u u- uu -u u --	dactylic hexameter	feminine penthemimeral, hepthemimeral, trithemimeral
δοῦρ’ ἔχεν· οὔ κέν τίς μιν ἐρύκακεν ἀντιβολήσας	- uu - - - u u-uu -uu--	dactylic hexameter	masculine penthemimeral, trithemimeral
νόσφι θεῶν ὅτ’ ἐσᾶλτο πύλας· πυρὶ δ’ὄσσε δεδήει.	-u u- u u-u u- uu -u u--	dactylic hexameter	feminine penthemimeral, hepthemimeral, trithemimeral
κέκλετο δὲ Τρώεσσιν ἑλιξάμενος καθ’ ὅμιλον	-uu - --u u-uu- u u--	dactylic hexameter	feminine penthemimeral, trithemimeral
τεῖχος ὑπερβαίνειν· τοὶ δ’ὀτρύνοντι πίθοντο.	-u u--- - ---u u--	dactylic hexameter	masculine penthemimeral
αὐτίκα δ’οἳ μὲν τεῖχος ὑπέρβασαν, οἳ δὲ κατ’ αὐτὰς	-uu - - -u u-uu - u u --	dactylic hexameter	feminine penthemimeral, trithemimeral
ποιητὰς ἐσέχυντο πύλας· Δαναοὶ δὲ φόβηθεν	--- uu-u u- uu- u u--	dactylic hexameter	feminine penthemimeral, hepthemimeral, trithemimeral
νῆας ἀνὰ γλαφυράς, ὅμαδος δ’ἀλίαστος ἐτύχθη.	-u u- uu- uu- uu-u u--	dactylic hexameter	masculine penthemimeral, hepthemimeral, trithemimeral
