Οἳ δὲ θεοὶ πὰρ Ζηνὶ καθήμενοι ἠγορόωντο	- u u- - -u u-uu -uu--	dactylic hexameter	feminine penthemimeral, trithemimeral
χρυσέῳ ἐν δαπέδῳ, μετὰ δέ σφισι πότνια Ἥβη	-- - uu- uu - uu -uu --	dactylic hexameter	masculine penthemimeral, hepthemimeral, trithemimeral
νέκταρ ἐοινοχόει· τοὶ δὲ χρυσέοις δεπάεσσι	-u u-uu- - - uu- uu--	dactylic hexameter	masculine penthemimeral, hepthemimeral
δειδέχατ’ ἀλλήλους, Τρώων πόλιν εἰσορόωντες·	-uu --- -- uu -uu--	dactylic hexameter	masculine penthemimeral, hepthemimeral
αὐτίκ’ ἐπειρᾶτο Κρονίδης ἐρεθιζέμεν Ἥρην	-u u--- uu- uu-uu --	dactylic hexameter	masculine penthemimeral, hepthemimeral
κερτομίοις ἐπέεσσι παραβλήδην ἀγορεύων·	-uu- uu-u u--- uu--	dactylic hexameter	feminine penthemimeral, trithemimeral
δοιαὶ μὲν Μενελάῳ ἀρηγόνες εἰσὶ θεάων	-- - uu-u u-uu -u u--	dactylic hexameter	feminine penthemimeral, trithemimeral
Ἥρη τ’Ἀργείη καὶ Ἀλαλκομενηῒς Ἀθήνη.	-- --- u u-uu-u u--	dactylic hexameter	masculine penthemimeral
Ἀλλ’ ἤτοι ταὶ νόσφι καθήμεναι εἰσορόωσαι	- -- - -u u-uu -uu--	dactylic hexameter	feminine penthemimeral, trithemimeral
τέρπεσθον· τῷ δ’αὖτε φιλομειδὴς Ἀφροδίτη	--- - -u u--- uu--	dactylic hexameter	feminine penthemimeral, trithemimeral
αἰεὶ παρμέμβλωκε καὶ αὐτοῦ κῆρας ἀμύνει·	-- ---u u -- -u u--	dactylic hexameter	feminine penthemimeral
καὶ νῦν ἐξεσάωσεν ὀϊόμενον θανέεσθαι.	- - -uu-u u-uu- uu--	dactylic hexameter	feminine penthemimeral
Ἀλλ’ ἤτοι νίκη μὲν ἀρηϊφίλου Μενελάου·	- -- -- u u-uu- uu--	dactylic hexameter	masculine penthemimeral, trithemimeral
ἡμεῖς δὲ φραζώμεθ’ ὅπως ἔσται τάδε ἔργα,	-- - --u u- -- uu --	dactylic hexameter	feminine penthemimeral, hepthemimeral, trithemimeral
ἤ ῥ’αὖτις πόλεμόν τε κακὸν καὶ φύλοπιν αἰνὴν	- -- uu- u u- - -uu --	dactylic hexameter	masculine penthemimeral, hepthemimeral, trithemimeral
ὄρσομεν, ἦ φιλότητα μετ’ ἀμφοτέροισι βάλωμεν.	-uu - uu-u u -uu-u u--	dactylic hexameter	feminine penthemimeral, trithemimeral
Εἰ δ’αὖ πως τόδε πᾶσι φίλον καὶ ἡδὺ γένοιτο,	- - - uu -u u- - -u u--	dactylic hexameter	feminine penthemimeral, hepthemimeral, trithemimeral
ἤτοι μὲν οἰκέοιτο πόλις Πριάμοιο ἄνακτος,	-- - --u u- uu-u u--	dactylic hexameter	feminine penthemimeral, hepthemimeral, trithemimeral
αὖτις δ’Ἀργείην Ἑλένην Μενέλαος ἄγοιτο.	-- --- uu- uu-u u--	dactylic hexameter	masculine penthemimeral, hepthemimeral
Ὣς ἔφαθ’, αἳ δ’ἐπέμυξαν Ἀθηναίη τε καὶ Ἥρη·	- uu - uu-u u--- u u --	dactylic hexameter	feminine penthemimeral, trithemimeral
πλησίαι αἵ γ’ἥσθην, κακὰ δὲ Τρώεσσι μεδέσθην.	-uu - -- uu - --u u--	dactylic hexameter	masculine penthemimeral, hepthemimeral, trithemimeral
Ἤτοι Ἀθηναίη ἀκέων ἦν οὐδέ τι εἶπε	-u u--- uu- - -u u --	dactylic hexameter	masculine penthemimeral, hepthemimeral
σκυζομένη Διὶ πατρί, χόλος δέ μιν ἄγριος ᾕρει·	-uu- uu -u u- u u -uu --	dactylic hexameter	feminine penthemimeral, hepthemimeral, trithemimeral
Ἥρῃ δ’οὐκ ἔχαδε στῆθος χόλον, ἀλλὰ προσηύδα·	-- - uu- -- uu -u u--	dactylic hexameter	masculine penthemimeral, hepthemimeral, trithemimeral
αἰνότατε Κρονίδη ποῖον τὸν μῦθον ἔειπες·	-uu- uu- -- - -u u--	dactylic hexameter	masculine penthemimeral, hepthemimeral, trithemimeral
πῶς ἐθέλεις ἅλιον θεῖναι πόνον ἠδ’ ἀτέλεστον,	- uu- uu- -- uu - uu--	dactylic hexameter	masculine penthemimeral, hepthemimeral, trithemimeral
ἱδρῶ θ’ὃν ἵδρωσα μόγῳ, καμέτην δέ μοι ἵπποι	-- - --u u- uu- u u --	dactylic hexameter	feminine penthemimeral, hepthemimeral, trithemimeral
λαὸν ἀγειρούσῃ, Πριάμῳ κακὰ τοῖό τε παισίν.	-u u--- uu- uu -u u --	dactylic hexameter	masculine penthemimeral, hepthemimeral
Ἕρδ’· ἀτὰρ οὔ τοι πάντες ἐπαινέομεν θεοὶ ἄλλοι.	- uu - - -u u-uu- uu --	dactylic hexameter	feminine penthemimeral, trithemimeral
Τὴν δὲ μέγ’ ὀχθήσας προσέφη νεφεληγερέτα Ζεύς·	- u u --- uu- uu-uu- -	dactylic hexameter	masculine penthemimeral, hepthemimeral
δαιμονίη τί νύ σε Πρίαμος Πριάμοιό τε παῖδες	-uu- u u - uu- uu-u u --	dactylic hexameter	masculine penthemimeral, hepthemimeral, trithemimeral
τόσσα κακὰ ῥέζουσιν, ὅ τ’ἀσπερχὲς μενεαίνεις	-u u- --u u --- uu--	dactylic hexameter	feminine penthemimeral, trithemimeral
Ἰλίου ἐξαλαπάξαι ἐϋκτίμενον πτολίεθρον;	-uu -uu-u u-uu- uu--	dactylic hexameter	feminine penthemimeral
εἰ δὲ σύ γ’εἰσελθοῦσα πύλας καὶ τείχεα μακρὰ	- u u ---u u- - -uu --	dactylic hexameter	feminine penthemimeral, hepthemimeral
ὠμὸν βεβρώθοις Πρίαμον Πριάμοιό τε παῖδας	-- --- uu- uu-u u --	dactylic hexameter	masculine penthemimeral, hepthemimeral
ἄλλους τε Τρῶας, τότε κεν χόλον ἐξακέσαιο.	-- - -- uu - uu -uu--	dactylic hexameter	masculine penthemimeral, hepthemimeral, trithemimeral
Ἕρξον ὅπως ἐθέλεις· μὴ τοῦτό γε νεῖκος ὀπίσσω	-u u- uu- - -u u -u u--	dactylic hexameter	masculine penthemimeral, trithemimeral
σοὶ καὶ ἐμοὶ μέγ’ ἔρισμα μετ’ ἀμφοτέροισι γένηται.	- u u- u u-u u -uu-u u--	dactylic hexameter	feminine penthemimeral, trithemimeral
Ἄλλο δέ τοι ἐρέω, σὺ δ’ἐνὶ φρεσὶ βάλλεο σῇσιν·	-u u - uu- u u- uu -uu --	dactylic hexameter	masculine penthemimeral, hepthemimeral, trithemimeral
ὁππότε κεν καὶ ἐγὼ μεμαὼς πόλιν ἐξαλαπάξαι	-uu - u u- uu- uu -uu--	dactylic hexameter	masculine penthemimeral, hepthemimeral, trithemimeral
τὴν ἐθέλω ὅθι τοι φίλοι ἀνέρες ἐγγεγάασι,	- uu- uu - uu -uu -uu--	dactylic hexameter	masculine penthemimeral, trithemimeral
μή τι διατρίβειν τὸν ἐμὸν χόλον, ἀλλά μ’ἐᾶσαι·	- u u--- u u- uu -u u--	dactylic hexameter	masculine penthemimeral, hepthemimeral
καὶ γὰρ ἐγὼ σοὶ δῶκα ἑκὼν ἀέκοντί γε θυμῷ·	- u u- - -u u- uu-u u --	dactylic hexameter	feminine penthemimeral, hepthemimeral, trithemimeral
αἳ γὰρ ὑπ’ ἠελίῳ τε καὶ οὐρανῷ ἀστερόεντι	- u u -uu- u u -uu -uu--	dactylic hexameter	masculine penthemimeral
ναιετάουσι πόληες ἐπιχθονίων ἀνθρώπων,	-uu-u u-u u-uu- ---	dactylic hexameter	feminine penthemimeral
τάων μοι περὶ κῆρι τιέσκετο Ἴλιος ἱρὴ	-- - uu -u u-uu -uu --	dactylic hexameter	feminine penthemimeral, trithemimeral
καὶ Πρίαμος καὶ λαὸς ἐϋμμελίω Πριάμοιο.	- uu- - -u u-uu- uu--	dactylic hexameter	feminine penthemimeral, trithemimeral
Οὐ γάρ μοί ποτε βωμὸς ἐδεύετο δαιτὸς ἐΐσης	- - - uu -u u-uu -u u--	dactylic hexameter	feminine penthemimeral, trithemimeral
λοιβῆς τε κνίσης τε· τὸ γὰρ λάχομεν γέρας ἡμεῖς.	-- - -- u u - uu- uu --	dactylic hexameter	masculine penthemimeral, hepthemimeral, trithemimeral
Τὸν δ’ἠμείβετ’ ἔπειτα βοῶπις πότνια Ἥρη·	- --u u-u u-- -uu --	dactylic hexameter	feminine penthemimeral
ἤτοι ἐμοὶ τρεῖς μὲν πολὺ φίλταταί εἰσι πόληες	-u u- - - uu -uu -u u--	dactylic hexameter	masculine penthemimeral, trithemimeral
Ἄργός τε Σπάρτη τε καὶ εὐρυάγυια Μυκήνη·	-- - -- u u -uu-u u--	dactylic hexameter	masculine penthemimeral, trithemimeral
τὰς διαπέρσαι ὅτ’ ἄν τοι ἀπέχθωνται περὶ κῆρι·	- uu-u u - u u--- uu --	dactylic hexameter	masculine penthemimeral
τάων οὔ τοι ἐγὼ πρόσθ’ ἵσταμαι οὐδὲ μεγαίρω.	-- - u u- - -uu -u u--	dactylic hexameter	masculine penthemimeral, trithemimeral
Εἴ περ γὰρ φθονέω τε καὶ οὐκ εἰῶ διαπέρσαι,	- - - uu- u u - -- uu--	dactylic hexameter	masculine penthemimeral, hepthemimeral, trithemimeral
οὐκ ἀνύω φθονέουσ’ ἐπεὶ ἦ πολὺ φέρτερός ἐσσι.	- uu- uu- uu - uu -uu --	dactylic hexameter	masculine penthemimeral, hepthemimeral, trithemimeral
Ἀλλὰ χρὴ καὶ ἐμὸν θέμεναι πόνον οὐκ ἀτέλεστον·	-- - u u- uu- uu - uu--	dactylic hexameter	masculine penthemimeral, hepthemimeral, trithemimeral
καὶ γὰρ ἐγὼ θεός εἰμι, γένος δέ μοι ἔνθεν ὅθεν σοί,	- u u- uu -u u- u u -u u- -	dactylic hexameter	feminine penthemimeral, hepthemimeral, trithemimeral
καί με πρεσβυτάτην τέκετο Κρόνος ἀγκυλομήτης,	- - -uu- uu- uu -uu--	dactylic hexameter	masculine penthemimeral, hepthemimeral
ἀμφότερον γενεῇ τε καὶ οὕνεκα σὴ παράκοιτις	-uu- uu- u u -uu - uu--	dactylic hexameter	masculine penthemimeral, trithemimeral
κέκλημαι, σὺ δὲ πᾶσι μετ’ ἀθανάτοισιν ἀνάσσεις.	--- u u -u u -uu-u u--	dactylic hexameter	feminine penthemimeral, trithemimeral
Ἀλλ’ ἤτοι μὲν ταῦθ’ ὑποείξομεν ἀλλήλοισι,	- -- - - uu-uu ----	dactylic hexameter	masculine penthemimeral, trithemimeral
σοὶ μὲν ἐγώ, σὺ δ’ἐμοί· ἐπὶ δ’ἕψονται θεοὶ ἄλλοι	- u u- u u- uu --- uu --	dactylic hexameter	masculine penthemimeral, trithemimeral
ἀθάνατοι· σὺ δὲ θᾶσσον Ἀθηναίῃ ἐπιτεῖλαι	-uu- u u -u u--- uu--	dactylic hexameter	feminine penthemimeral, trithemimeral
ἐλθεῖν ἐς Τρώων καὶ Ἀχαιῶν φύλοπιν αἰνήν,	-- - -- u u-- -uu --	dactylic hexameter	masculine penthemimeral, trithemimeral
πειρᾶν δ’ὥς κε Τρῶες ὑπερκύδαντας Ἀχαιοὺς	-- - - -u u---u u--	dactylic hexameter	feminine penthemimeral, trithemimeral
ἄρξωσι πρότεροι ὑπὲρ ὅρκια δηλήσασθαι.	--- uu- uu -uu ----	dactylic hexameter	masculine penthemimeral, trithemimeral
Ὣς ἔφατ’, οὐδ’ ἀπίθησε πατὴρ ἀνδρῶν τε θεῶν τε·	- uu - uu-u u- -- u u- -	dactylic hexameter	feminine penthemimeral, hepthemimeral, trithemimeral
αὐτίκ’ Ἀθηναίην ἔπεα πτερόεντα προσηύδα·	-u u--- uu- uu-u u--	dactylic hexameter	masculine penthemimeral, hepthemimeral
αἶψα μάλ’ ἐς στρατὸν ἐλθὲ μετὰ Τρῶας καὶ Ἀχαιούς,	-u u - uu -u u- -- u u--	dactylic hexameter	feminine penthemimeral, hepthemimeral, trithemimeral
πειρᾶν δ’ὥς κε Τρῶες ὑπερκύδαντας Ἀχαιοὺς	-- - - -u u---u u--	dactylic hexameter	feminine penthemimeral, trithemimeral
ἄρξωσι πρότεροι ὑπὲρ ὅρκια δηλήσασθαι.	--- uu- uu -uu ----	dactylic hexameter	masculine penthemimeral, trithemimeral
Ὣς εἰπὼν ὄτρυνε πάρος μεμαυῖαν Ἀθήνην,	- -- --u u- uu-u u--	dactylic hexameter	feminine penthemimeral, hepthemimeral, trithemimeral
βῆ δὲ κατ’ Οὐλύμποιο καρήνων ἀΐξασα.	- u u ---u u-- ----	dactylic hexameter	feminine penthemimeral
Οἷον δ’ἀστέρα ἧκε Κρόνου πάϊς ἀγκυλομήτεω	-- -uu -u u- uu -uu--	dactylic hexameter	feminine penthemimeral, hepthemimeral
ἢ ναύτῃσι τέρας ἠὲ στρατῷ εὐρέϊ λαῶν	- --u u- -- uu -uu --	dactylic hexameter	masculine penthemimeral, hepthemimeral
λαμπρόν· τοῦ δέ τε πολλοὶ ἀπὸ σπινθῆρες ἵενται·	-- - u u -u u- --u u--	dactylic hexameter	feminine penthemimeral, hepthemimeral, trithemimeral
τῷ ἐϊκυῖ’ ἤϊξεν ἐπὶ χθόνα Παλλὰς Ἀθήνη,	- uu- --u u- uu -u u--	dactylic hexameter	feminine penthemimeral, hepthemimeral, trithemimeral
κὰδ δ’ἔθορ’ ἐς μέσσον· θάμβος δ’ἔχεν εἰσορόωντας	- uu - -- -- uu -uu--	dactylic hexameter	masculine penthemimeral, hepthemimeral, trithemimeral
Τρῶάς θ’ἱπποδάμους καὶ ἐϋκνήμιδας Ἀχαιούς·	-- -uu- u u---u u--	dactylic hexameter	masculine penthemimeral
ὧδε δέ τις εἴπεσκεν ἰδὼν ἐς πλησίον ἄλλον·	-u u - --u u- - -uu --	dactylic hexameter	feminine penthemimeral, hepthemimeral, trithemimeral
ἦ ῥ’αὖτις πόλεμός τε κακὸς καὶ φύλοπις αἰνὴ	- -- uu- u u- - -uu --	dactylic hexameter	masculine penthemimeral, hepthemimeral, trithemimeral
ἔσσεται, ἢ φιλότητα μετ’ ἀμφοτέροισι τίθησι	-uu - uu-u u -uu-u u--	dactylic hexameter	feminine penthemimeral, trithemimeral
Ζεύς, ὅς τ’ἀνθρώπων ταμίης πολέμοιο τέτυκται.	- - --- uu- uu-u u--	dactylic hexameter	masculine penthemimeral, hepthemimeral
Ὣς ἄρα τις εἴπεσκεν Ἀχαιῶν τε Τρώων τε.	- uu - --u u-- - -- -	dactylic hexameter	feminine penthemimeral, trithemimeral
Ἣ δ’ἀνδρὶ ἰκέλη Τρώων κατεδύσεθ’ ὅμιλον	- -- uu- -- uu-u u--	dactylic hexameter	masculine penthemimeral, hepthemimeral, trithemimeral
Λαοδόκῳ Ἀντηνορίδῃ κρατερῷ αἰχμητῇ,	-uu- --uu- uu- ---	dactylic hexameter	hepthemimeral, trithemimeral
Πάνδαρον ἀντίθεον διζημένη εἴ που ἐφεύροι.	-uu -uu- --uu - u u--	dactylic hexameter	masculine penthemimeral
Εὗρε Λυκάονος υἱὸν ἀμύμονά τε κρατερόν τε	-u u-uu -u u-uu - uu- -	dactylic hexameter	feminine penthemimeral
ἑσταότ’· ἀμφὶ δέ μιν κρατεραὶ στίχες ἀσπιστάων	-uu -u u - uu- uu ----	dactylic hexameter	masculine penthemimeral, hepthemimeral
λαῶν, οἵ οἱ ἕποντο ἀπ’ Αἰσήποιο ῥοάων·	-- - u u-u u ---u u--	dactylic hexameter	feminine penthemimeral, trithemimeral
ἀγχοῦ δ’ἱσταμένη ἔπεα πτερόεντα προσηύδα·	-- -uu- uu- uu-u u--	dactylic hexameter	masculine penthemimeral, hepthemimeral
ἦ ῥά νύ μοί τι πίθοιο Λυκάονος υἱὲ δαΐφρον.	- u u - u u-u u-uu -u u--	dactylic hexameter	feminine penthemimeral, trithemimeral
Τλαίης κεν Μενελάῳ ἐπιπροέμεν ταχὺν ἰόν,	-- - uu-u u-uu- uu --	dactylic hexameter	feminine penthemimeral, trithemimeral
πᾶσι δέ κε Τρώεσσι χάριν καὶ κῦδος ἄροιο,	-u u - --u u- - -u u--	dactylic hexameter	feminine penthemimeral, hepthemimeral, trithemimeral
ἐκ πάντων δὲ μάλιστα Ἀλεξάνδρῳ βασιλῆϊ.	- -- u u-u u--- uu--	dactylic hexameter	feminine penthemimeral, trithemimeral
Τοῦ κεν δὴ πάμπρωτα παρ’ ἀγλαὰ δῶρα φέροιο,	- - - --u u -uu -u u--	dactylic hexameter	feminine penthemimeral, trithemimeral
αἴ κεν ἴδῃ Μενέλαον ἀρήϊον Ἀτρέος υἱὸν	- u u- uu-u u-uu -uu --	dactylic hexameter	feminine penthemimeral, trithemimeral
σῷ βέλεϊ δμηθέντα πυρῆς ἐπιβάντ’ ἀλεγεινῆς.	- uu- --u u- uu- uu--	dactylic hexameter	feminine penthemimeral, hepthemimeral, trithemimeral
Ἀλλ’ ἄγ’ ὀΐστευσον Μενελάου κυδαλίμοιο,	- u u--- uu-- -uu--	dactylic hexameter	masculine penthemimeral
εὔχεο δ’Ἀπόλλωνι Λυκηγενέϊ κλυτοτόξῳ	-uu ---u u-uu- uu--	dactylic hexameter	feminine penthemimeral
ἀρνῶν πρωτογόνων ῥέξειν κλειτὴν ἑκατόμβην	-- -uu- -- -- uu--	dactylic hexameter	masculine penthemimeral, hepthemimeral
οἴκαδε νοστήσας ἱερῆς εἰς ἄστυ Ζελείης.	-uu --- uu- - -u u--	dactylic hexameter	masculine penthemimeral, hepthemimeral
Ὣς φάτ’ Ἀθηναίη, τῷ δὲ φρένας ἄφρονι πεῖθεν·	- u u--- - - uu -uu --	dactylic hexameter	masculine penthemimeral, hepthemimeral
αὐτίκ’ ἐσύλα τόξον ἐΰξοον ἰξάλου αἰγὸς	-u u-- -u u-uu -uu --	dactylic hexameter	feminine penthemimeral
ἀγρίου, ὅν ῥά ποτ’ αὐτὸς ὑπὸ στέρνοιο τυχήσας	-uu - u u -u u- --u u--	dactylic hexameter	feminine penthemimeral, hepthemimeral, trithemimeral
πέτρης ἐκβαίνοντα δεδεγμένος ἐν προδοκῇσι	-- ---u u-uu - uu--	dactylic hexameter	feminine penthemimeral
βεβλήκει πρὸς στῆθος· ὃ δ’ὕπτιος ἔμπεσε πέτρῃ.	--- - -u u -uu -uu --	dactylic hexameter	feminine penthemimeral, trithemimeral
Τοῦ κέρα ἐκ κεφαλῆς ἑκκαιδεκάδωρα πεφύκει·	- uu - uu- --uu-u u--	dactylic hexameter	masculine penthemimeral, trithemimeral
καὶ τὰ μὲν ἀσκήσας κεραοξόος ἤραρε τέκτων,	- u u --- uu-uu -uu --	dactylic hexameter	masculine penthemimeral
πᾶν δ’εὖ λειήνας χρυσέην ἐπέθηκε κορώνην.	- - --- uu- uu-u u--	dactylic hexameter	masculine penthemimeral, hepthemimeral
Καὶ τὸ μὲν εὖ κατέθηκε τανυσσάμενος ποτὶ γαίῃ	- u u - uu-u u-uu- uu --	dactylic hexameter	feminine penthemimeral, trithemimeral
ἀγκλίνας· πρόσθεν δὲ σάκεα σχέθον ἐσθλοὶ ἑταῖροι	--- -- u u- uu -u u--	dactylic hexameter	masculine penthemimeral, hepthemimeral, trithemimeral
μὴ πρὶν ἀναΐξειαν ἀρήϊοι υἷες Ἀχαιῶν	- u u---u u-uu -u u--	dactylic hexameter	feminine penthemimeral
πρὶν βλῆσθαι Μενέλαον ἀρήϊον Ἀτρέος υἱόν.	- -- uu-u u-uu -uu --	dactylic hexameter	feminine penthemimeral, trithemimeral
Αὐτὰρ ὁ σύλα πῶμα φαρέτρης, ἐκ δ’ἕλετ’ ἰὸν	-u u -- -u u-- - uu --	dactylic hexameter	feminine penthemimeral
ἀβλῆτα πτερόεντα μελαινέων ἕρμ’ ὀδυνάων·	--- uu-u u-- - uu--	dactylic hexameter	feminine penthemimeral, trithemimeral
αἶψα δ’ἐπὶ νευρῇ κατεκόσμει πικρὸν ὀϊστόν,	-u u- -- uu-- -u u--	dactylic hexameter	masculine penthemimeral, trithemimeral
εὔχετο δ’Ἀπόλλωνι Λυκηγενέϊ κλυτοτόξῳ	-uu ---u u-uu- uu--	dactylic hexameter	feminine penthemimeral
ἀρνῶν πρωτογόνων ῥέξειν κλειτὴν ἑκατόμβην	-- -uu- -- -- uu--	dactylic hexameter	masculine penthemimeral, hepthemimeral
οἴκαδε νοστήσας ἱερῆς εἰς ἄστυ Ζελείης.	-uu --- uu- - -u u--	dactylic hexameter	masculine penthemimeral, hepthemimeral
Ἕλκε δ’ὁμοῦ γλυφίδας τε λαβὼν καὶ νεῦρα βόεια·	-u u- uu- u u- - -u u--	dactylic hexameter	masculine penthemimeral, hepthemimeral, trithemimeral
νευρὴν μὲν μαζῷ πέλασεν, τόξῳ δὲ σίδηρον.	-- - -- uu- -- u u--	dactylic hexameter	masculine penthemimeral, hepthemimeral, trithemimeral
Αὐτὰρ ἐπεὶ δὴ κυκλοτερὲς μέγα τόξον ἔτεινε,	-u u- - -uu- uu -u u--	dactylic hexameter	hepthemimeral, trithemimeral
λίγξε βιός, νευρὴ δὲ μέγ’ ἴαχεν, ἆλτο δ’ὀϊστὸς	-u u- -- u u -uu -u u--	dactylic hexameter	masculine penthemimeral, trithemimeral
ὀξυβελὴς καθ’ ὅμιλον ἐπιπτέσθαι μενεαίνων.	-uu- u u-u u--- uu--	dactylic hexameter	feminine penthemimeral, trithemimeral
Οὐδὲ σέθεν Μενέλαε θεοὶ μάκαρες λελάθοντο	-u u- uu-u u- uu- uu--	dactylic hexameter	feminine penthemimeral, hepthemimeral, trithemimeral
ἀθάνατοι, πρώτη δὲ Διὸς θυγάτηρ ἀγελείη,	-uu- -- u u- uu- uu--	dactylic hexameter	masculine penthemimeral, hepthemimeral, trithemimeral
ἥ τοι πρόσθε στᾶσα βέλος ἐχεπευκὲς ἄμυνεν.	- - -- -u u- uu-u u--	dactylic hexameter	feminine penthemimeral, hepthemimeral
Ἣ δὲ τόσον μὲν ἔεργεν ἀπὸ χροὸς ὡς ὅτε μήτηρ	- u u- u u-u u- uu - uu --	dactylic hexameter	feminine penthemimeral, hepthemimeral, trithemimeral
παιδὸς ἐέργῃ μυῖαν ὅθ’ ἡδέϊ λέξεται ὕπνῳ,	-u u-- -u u -uu -uu --	dactylic hexameter	feminine penthemimeral
αὐτὴ δ’αὖτ’ ἴθυνεν ὅθι ζωστῆρος ὀχῆες	-- - --u u- --u u--	dactylic hexameter	feminine penthemimeral, hepthemimeral, trithemimeral
χρύσειοι σύνεχον καὶ διπλόος ἤντετο θώρηξ.	--- uu- - -uu -uu --	dactylic hexameter	masculine penthemimeral, trithemimeral
Ἐν δ’ἔπεσε ζωστῆρι ἀρηρότι πικρὸς ὀϊστός·	- uu- --u u-uu -u u--	dactylic hexameter	feminine penthemimeral, trithemimeral
διὰ μὲν ἂρ ζωστῆρος ἐλήλατο δαιδαλέοιο,	-u u - --u u-uu -uu--	dactylic hexameter	feminine penthemimeral, trithemimeral
καὶ διὰ θώρηκος πολυδαιδάλου ἠρήρειστο	- uu --- uu-uu ----	dactylic hexameter	masculine penthemimeral
μίτρης θ’,ἣν ἐφόρει ἔρυμα χροὸς ἕρκος ἀκόντων,	-- - uu- uu- uu -u u--	dactylic hexameter	masculine penthemimeral, hepthemimeral, trithemimeral
ἥ οἱ πλεῖστον ἔρυτο· διὰ πρὸ δὲ εἴσατο καὶ τῆς.	- - -u u-u u- u u -uu - -	dactylic hexameter	feminine penthemimeral, hepthemimeral
Ἀκρότατον δ’ἄρ’ ὀϊστὸς ἐπέγραψε χρόα φωτός·	-uu- u u-u u--- uu --	dactylic hexameter	feminine penthemimeral, trithemimeral
αὐτίκα δ’ἔρρεεν αἷμα κελαινεφὲς ἐξ ὠτειλῆς.	-uu -uu -u u-uu - ---	dactylic hexameter	feminine penthemimeral
Ὡς δ’ὅτε τίς τ’ἐλέφαντα γυνὴ φοίνικι μιήνῃ	- uu - uu-u u- --u u--	dactylic hexameter	feminine penthemimeral, hepthemimeral, trithemimeral
Μῃονὶς ἠὲ Κάειρα παρήϊον ἔμμεναι ἵππων·	-uu -u u-u u-uu -uu --	dactylic hexameter	feminine penthemimeral
κεῖται δ’ἐν θαλάμῳ, πολέες τέ μιν ἠρήσαντο	-- - uu- uu- u u ----	dactylic hexameter	masculine penthemimeral, hepthemimeral, trithemimeral
ἱππῆες φορέειν· βασιλῆϊ δὲ κεῖται ἄγαλμα,	--- uu- uu-u u -u u--	dactylic hexameter	masculine penthemimeral, trithemimeral
ἀμφότερον κόσμός θ’ἵππῳ ἐλατῆρί τε κῦδος·	-uu- -- -- uu-u u --	dactylic hexameter	masculine penthemimeral, hepthemimeral, trithemimeral
τοῖοί τοι Μενέλαε μιάνθην αἵματι μηροὶ	-- - uu-u u-- -uu --	dactylic hexameter	feminine penthemimeral, trithemimeral
εὐφυέες κνῆμαί τε ἰδὲ σφυρὰ κάλ’ ὑπένερθε.	-uu- -- u u- uu - uu--	dactylic hexameter	masculine penthemimeral, hepthemimeral, trithemimeral
Ῥίγησεν δ’ἄρ’ ἔπειτα ἄναξ ἀνδρῶν Ἀγαμέμνων	--- u u-u u- -- uu--	dactylic hexameter	feminine penthemimeral, hepthemimeral, trithemimeral
ὡς εἶδεν μέλαν αἷμα καταρρέον ἐξ ὠτειλῆς·	- -- uu -u u-uu - ---	dactylic hexameter	feminine penthemimeral, trithemimeral
ῥίγησεν δὲ καὶ αὐτὸς ἀρηΐφιλος Μενέλαος.	--- u u -u u-uu- uu--	dactylic hexameter	feminine penthemimeral, trithemimeral
Ὡς δὲ ἴδεν νεῦρόν τε καὶ ὄγκους ἐκτὸς ἐόντας	- u u- -- u u -- -u u--	dactylic hexameter	masculine penthemimeral, trithemimeral
ἄψορρόν οἱ θυμὸς ἐνὶ στήθεσσιν ἀγέρθη.	--- - -u u- --u u--	dactylic hexameter	feminine penthemimeral, hepthemimeral, trithemimeral
Τοῖς δὲ βαρὺ στενάχων μετέφη κρείων Ἀγαμέμνων	- u u- uu- uu- -- uu--	dactylic hexameter	masculine penthemimeral, hepthemimeral, trithemimeral
χειρὸς ἔχων Μενέλαον, ἐπεστενάχοντο δ’ἑταῖροι·	-u u- uu-u u-uu-u u--	dactylic hexameter	feminine penthemimeral, trithemimeral
φίλε κασίγνητε θάνατόν νύ τοι ὅρκι’ ἔταμνον	-u u--- uu- u u -u u--	dactylic hexameter	masculine penthemimeral, hepthemimeral
οἶον προστήσας πρὸ Ἀχαιῶν Τρωσὶ μάχεσθαι,	-- --- u u-- -u u--	dactylic hexameter	masculine penthemimeral
ὥς σ’ἔβαλον Τρῶες, κατὰ δ’ὅρκια πιστὰ πάτησαν.	- uu- -- uu -uu -u u--	dactylic hexameter	masculine penthemimeral, trithemimeral
Οὐ μέν πως ἅλιον πέλει ὅρκιον αἷμά τε ἀρνῶν	- - - uu- uu -uu -u u --	dactylic hexameter	masculine penthemimeral, trithemimeral
σπονδαί τ’ἄκρητοι καὶ δεξιαὶ ᾗς ἐπέπιθμεν.	-- --- - -uu - uu--	dactylic hexameter	masculine penthemimeral
Εἴ περ γάρ τε καὶ αὐτίκ’ Ὀλύμπιος οὐκ ἐτέλεσσεν,	- - - u u -u u-uu - uu--	dactylic hexameter	feminine penthemimeral, trithemimeral
ἔκ τε καὶ ὀψὲ τελεῖ, σύν τε μεγάλῳ ἀπέτισαν	- u u -u u- - - uu- uu--	dactylic hexameter	masculine penthemimeral, hepthemimeral
σὺν σφῇσιν κεφαλῇσι γυναιξί τε καὶ τεκέεσσιν.	- -- uu-u u-u u - uu--	dactylic hexameter	feminine penthemimeral, trithemimeral
Εὖ γὰρ ἐγὼ τόδε οἶδα κατὰ φρένα καὶ κατὰ θυμόν·	- u u- uu -u u- uu - uu --	dactylic hexameter	feminine penthemimeral, hepthemimeral, trithemimeral
ἔσσεται ἦμαρ ὅτ’ ἄν ποτ’ ὀλώλῃ Ἴλιος ἱρὴ	-uu -u u - u u-- -uu --	dactylic hexameter	masculine penthemimeral
καὶ Πρίαμος καὶ λαὸς ἐϋμμελίω Πριάμοιο,	- uu- - -u u-uu- uu--	dactylic hexameter	feminine penthemimeral, trithemimeral
Ζεὺς δέ σφι Κρονίδης ὑψίζυγος αἰθέρι ναίων	- - - uu- --uu -uu --	dactylic hexameter	masculine penthemimeral, trithemimeral
αὐτὸς ἐπισσείῃσιν ἐρεμνὴν αἰγίδα πᾶσι	-u u---u u-- -uu --	dactylic hexameter	feminine penthemimeral
τῆσδ’ ἀπάτης κοτέων· τὰ μὲν ἔσσεται οὐκ ἀτέλεστα·	- uu- uu- u u -uu - uu--	dactylic hexameter	masculine penthemimeral, trithemimeral
ἀλλά μοι αἰνὸν ἄχος σέθεν ἔσσεται ὦ Μενέλαε	-u u -u u- uu -uu - uu--	dactylic hexameter	masculine penthemimeral
αἴ κε θάνῃς καὶ πότμον ἀναπλήσῃς βιότοιο.	- u u- - -u u--- uu--	dactylic hexameter	feminine penthemimeral, trithemimeral
Καί κεν ἐλέγχιστος πολυδίψιον Ἄργος ἱκοίμην·	- u u--- uu-uu -u u--	dactylic hexameter	masculine penthemimeral
αὐτίκα γὰρ μνήσονται Ἀχαιοὶ πατρίδος αἴης·	-uu - --u u-- -uu --	dactylic hexameter	feminine penthemimeral, trithemimeral
κὰδ δέ κεν εὐχωλὴν Πριάμῳ καὶ Τρωσὶ λίποιμεν	- u u --- uu- - -u u--	dactylic hexameter	masculine penthemimeral, hepthemimeral
Ἀργείην Ἑλένην· σέο δ’ὀστέα πύσει ἄρουρα	--- uu- uu -uu -u u--	dactylic hexameter	masculine penthemimeral, trithemimeral
κειμένου ἐν Τροίῃ ἀτελευτήτῳ ἐπὶ ἔργῳ.	-uu - -- uu--- uu --	dactylic hexameter	masculine penthemimeral, trithemimeral
Καί κέ τις ὧδ’ ἐρέει Τρώων ὑπερηνορεόντων	- u u - uu- -- uu-uu--	dactylic hexameter	masculine penthemimeral, hepthemimeral, trithemimeral
τύμβῳ ἐπιθρῴσκων Μενελάου κυδαλίμοιο·	-u u--- uu-- -uu--	dactylic hexameter	masculine penthemimeral
αἴθ’ οὕτως ἐπὶ πᾶσι χόλον τελέσει’ Ἀγαμέμνων,	- -- uu -u u- uu- uu--	dactylic hexameter	feminine penthemimeral, hepthemimeral, trithemimeral
ὡς καὶ νῦν ἅλιον στρατὸν ἤγαγεν ἐνθάδ’ Ἀχαιῶν,	- - - uu- uu -uu -u u--	dactylic hexameter	masculine penthemimeral, trithemimeral
καὶ δὴ ἔβη οἶκον δὲ φίλην ἐς πατρίδα γαῖαν	- u u- -- u u- - -uu --	dactylic hexameter	masculine penthemimeral, hepthemimeral, trithemimeral
σὺν κεινῇσιν νηυσὶ λιπὼν ἀγαθὸν Μενέλαον.	- --- -u u- uu- uu--	dactylic hexameter	feminine penthemimeral, hepthemimeral
Ὥς ποτέ τις ἐρέει· τότε μοι χάνοι εὐρεῖα χθών.	- uu - uu- uu - uu --- -	dactylic hexameter	masculine penthemimeral, hepthemimeral, trithemimeral
Τὸν δ’ἐπιθαρσύνων προσέφη ξανθὸς Μενέλαος·	- uu--- uu- -- uu--	dactylic hexameter	masculine penthemimeral, hepthemimeral
θάρσει, μηδέ τί πω δειδίσσεο λαὸν Ἀχαιῶν·	-- -u u - --uu -u u--	dactylic hexameter	masculine penthemimeral
οὐκ ἐν καιρίῳ ὀξὺ πάγη βέλος, ἀλλὰ πάροιθεν	- - -uu -u u- uu -u u--	dactylic hexameter	feminine penthemimeral, hepthemimeral
εἰρύσατο ζωστήρ τε παναίολος ἠδ’ ὑπένερθε	-uu- -- u u-uu - uu--	dactylic hexameter	masculine penthemimeral, trithemimeral
ζῶμά τε καὶ μίτρη, τὴν χαλκῆες κάμον ἄνδρες.	-u u - -- - --- uu --	dactylic hexameter	masculine penthemimeral, trithemimeral
Τὸν δ’ἀπαμειβόμενος προσέφη κρείων Ἀγαμέμνων·	- uu-uu- uu- -- uu--	dactylic hexameter	masculine penthemimeral, hepthemimeral
αἲ γὰρ δὴ οὕτως εἴη φίλος ὦ Μενέλαε·	- - - -- -- uu - uu--	dactylic hexameter	masculine penthemimeral, hepthemimeral, trithemimeral
ἕλκος δ’ἰητὴρ ἐπιμάσσεται ἠδ’ ἐπιθήσει	-- --- uu-uu - uu--	dactylic hexameter	masculine penthemimeral
φάρμαχ’ ἅ κεν παύσῃσι μελαινάων ὀδυνάων.	-u u - --u u--- uu--	dactylic hexameter	feminine penthemimeral, trithemimeral
Ἦ καὶ Ταλθύβιον θεῖον κήρυκα προσηύδα·	- - -uu- -- --u u--	dactylic hexameter	masculine penthemimeral, hepthemimeral
Ταλθύβι’ ὅττι τάχιστα Μαχάονα δεῦρο κάλεσσον	-uu -u u-u u-uu -u u--	dactylic hexameter	feminine penthemimeral
φῶτ’ Ἀσκληπιοῦ υἱὸν ἀμύμονος ἰητῆρος,	- --uu -u u-uu ----	dactylic hexameter	feminine penthemimeral
ὄφρα ἴδῃ Μενέλαον ἀρήϊον Ἀτρέος υἱόν,	-u u- uu-u u-uu -uu --	dactylic hexameter	feminine penthemimeral, trithemimeral
ὅν τις ὀϊστεύσας ἔβαλεν τόξων ἐῢ εἰδὼς	- u u--- uu- -- uu --	dactylic hexameter	masculine penthemimeral, hepthemimeral
Τρώων ἢ Λυκίων, τῷ μὲν κλέος, ἄμμι δὲ πένθος.	-- - uu- - - uu -u u --	dactylic hexameter	masculine penthemimeral, hepthemimeral, trithemimeral
Ὣς ἔφατ’, οὐδ’ ἄρα οἱ κῆρυξ ἀπίθησεν ἀκούσας,	- uu - uu - -- uu-u u--	dactylic hexameter	masculine penthemimeral, hepthemimeral, trithemimeral
βῆ δ’ἰέναι κατὰ λαὸν Ἀχαιῶν χαλκοχιτώνων	- uu- uu -u u-- -uu--	dactylic hexameter	feminine penthemimeral, trithemimeral
παπταίνων ἥρωα Μαχάονα· τὸν δὲ νόησεν	--- --u u-uu - u u--	dactylic hexameter	feminine penthemimeral, trithemimeral
ἑσταότ’· ἀμφὶ δέ μιν κρατεραὶ στίχες ἀσπιστάων	-uu -u u - uu- uu ----	dactylic hexameter	masculine penthemimeral, hepthemimeral
λαῶν, οἵ οἱ ἕποντο Τρίκης ἐξ ἱπποβότοιο.	-- - u u-u u- - -uu--	dactylic hexameter	feminine penthemimeral, hepthemimeral, trithemimeral
Ἀγχοῦ δ’ἱστάμενος ἔπεα πτερόεντα προσηύδα·	-- -uu- uu- uu-u u--	dactylic hexameter	masculine penthemimeral, hepthemimeral
ὄρσ’ Ἀσκληπιάδη, καλέει κρείων Ἀγαμέμνων,	- --uu- uu- -- uu--	dactylic hexameter	masculine penthemimeral, hepthemimeral
ὄφρα ἴδῃς Μενέλαον ἀρήϊον ἀρχὸν Ἀχαιῶν,	-u u- uu-u u-uu -u u--	dactylic hexameter	feminine penthemimeral, trithemimeral
ὅν τις ὀϊστεύσας ἔβαλεν τόξων ἐῢ εἰδὼς	- u u--- uu- -- uu --	dactylic hexameter	masculine penthemimeral, hepthemimeral
Τρώων ἢ Λυκίων, τῷ μὲν κλέος, ἄμμι δὲ πένθος.	-- - uu- - - uu -u u --	dactylic hexameter	masculine penthemimeral, hepthemimeral, trithemimeral
Ὣς φάτο, τῷ δ’ἄρα θυμὸν ἐνὶ στήθεσσιν ὄρινε·	- uu - uu -u u- --u u--	dactylic hexameter	feminine penthemimeral, hepthemimeral, trithemimeral
βὰν δ’ἰέναι καθ’ ὅμιλον ἀνὰ στρατὸν εὐρὺν Ἀχαιῶν.	- uu- u u-u u- uu -u u--	dactylic hexameter	feminine penthemimeral, hepthemimeral, trithemimeral
Ἀλλ’ ὅτε δή ῥ’ἵκανον ὅθι ξανθὸς Μενέλαος	- uu - --u u- -- uu--	dactylic hexameter	feminine penthemimeral, hepthemimeral, trithemimeral
βλήμενος ἦν, περὶ δ’αὐτὸν ἀγηγέραθ’ ὅσσοι ἄριστοι	-uu - uu -u u-uu -u u--	dactylic hexameter	feminine penthemimeral, trithemimeral
κυκλόσ’, ὃ δ’ἐν μέσσοισι παρίστατο ἰσόθεος φώς,	-u u - --u u-uu -uu- -	dactylic hexameter	feminine penthemimeral, trithemimeral
αὐτίκα δ’ἐκ ζωστῆρος ἀρηρότος ἕλκεν ὀϊστόν·	-uu - --u u-uu -u u--	dactylic hexameter	feminine penthemimeral, trithemimeral
τοῦ δ’ἐξελκομένοιο πάλιν ἄγεν ὀξέες ὄγκοι.	- --uu-u u- uu -uu --	dactylic hexameter	feminine penthemimeral, hepthemimeral
Λῦσε δέ οἱ ζωστῆρα παναίολον ἠδ’ ὑπένερθε	-u u - --u u-uu - uu--	dactylic hexameter	feminine penthemimeral, trithemimeral
ζῶμά τε καὶ μίτρην, τὴν χαλκῆες κάμον ἄνδρες.	-u u - -- - --- uu --	dactylic hexameter	masculine penthemimeral, trithemimeral
Αὐτὰρ ἐπεὶ ἴδεν ἕλκος ὅθ’ ἔμπεσε πικρὸς ὀϊστός,	-u u- uu -u u -uu -u u--	dactylic hexameter	feminine penthemimeral, trithemimeral
αἷμ’ ἐκμυζήσας ἐπ’ ἄρ’ ἤπια φάρμακα εἰδὼς	- ---- u u -uu -uu --	dactylic hexameter	masculine penthemimeral
πάσσε, τά οἵ ποτε πατρὶ φίλα φρονέων πόρε Χείρων.	-u u - uu -u u- uu- uu --	dactylic hexameter	feminine penthemimeral, hepthemimeral, trithemimeral
Ὄφρα τοὶ ἀμφεπένοντο βοὴν ἀγαθὸν Μενέλαον,	-u u -uu-u u- uu- uu--	dactylic hexameter	feminine penthemimeral, hepthemimeral
τόφρα δ’ἐπὶ Τρώων στίχες ἤλυθον ἀσπιστάων·	-u u- -- uu -uu ----	dactylic hexameter	masculine penthemimeral, trithemimeral
οἳ δ’αὖτις κατὰ τεύχε’ ἔδυν, μνήσαντο δὲ χάρμης.	- -- uu -u u- --u u --	dactylic hexameter	feminine penthemimeral, hepthemimeral, trithemimeral
Ἔνθ’ οὐκ ἂν βρίζοντα ἴδοις Ἀγαμέμνονα δῖον	- - - --u u- uu-uu --	dactylic hexameter	feminine penthemimeral, hepthemimeral, trithemimeral
οὐδὲ καταπτώσσοντ’ οὐδ’ οὐκ ἐθέλοντα μάχεσθαι,	-u u--- - - uu-u u--	dactylic hexameter	masculine penthemimeral, hepthemimeral
ἀλλὰ μάλα σπεύδοντα μάχην ἐς κυδιάνειραν.	-u u- --u u- - -uu--	dactylic hexameter	feminine penthemimeral, hepthemimeral, trithemimeral
Ἵππους μὲν γὰρ ἔασε καὶ ἅρματα ποικίλα χαλκῷ·	-- - u u-u u -uu -uu --	dactylic hexameter	feminine penthemimeral, trithemimeral
καὶ τοὺς μὲν θεράπων ἀπάνευθ’ ἔχε φυσιόωντας	- - - uu- uu- uu -uu--	dactylic hexameter	masculine penthemimeral, hepthemimeral, trithemimeral
Εὐρυμέδων υἱὸς Πτολεμαίου Πειραΐδαο·	-uu- -- uu-- -uu--	dactylic hexameter	masculine penthemimeral, trithemimeral
τῷ μάλα πόλλ’ ἐπέτελλε παρισχέμεν ὁππότε κέν μιν	- uu - uu-u u-uu -uu - -	dactylic hexameter	feminine penthemimeral, trithemimeral
γυῖα λάβῃ κάματος πολέας διὰ κοιρανέοντα·	-u u- uu- uu- uu -uu--	dactylic hexameter	masculine penthemimeral, hepthemimeral, trithemimeral
αὐτὰρ ὃ πεζὸς ἐὼν ἐπεπωλεῖτο στίχας ἀνδρῶν·	-u u -u u- uu--- uu --	dactylic hexameter	masculine penthemimeral
καί ῥ’οὓς μὲν σπεύδοντας ἴδοι Δαναῶν ταχυπώλων,	- - - --u u- uu- uu--	dactylic hexameter	feminine penthemimeral, hepthemimeral, trithemimeral
τοὺς μάλα θαρσύνεσκε παριστάμενος ἐπέεσσιν·	- uu ---u u-uu- uu--	dactylic hexameter	feminine penthemimeral
Ἀργεῖοι μή πώ τι μεθίετε θούριδος ἀλκῆς·	--- - - u u-uu -uu --	dactylic hexameter	masculine penthemimeral, trithemimeral
οὐ γὰρ ἐπὶ ψευδέσσι πατὴρ Ζεὺς ἔσσετ’ ἀρωγός,	- u u- --u u- - -u u--	dactylic hexameter	feminine penthemimeral, hepthemimeral, trithemimeral
ἀλλ’ οἵ περ πρότεροι ὑπὲρ ὅρκια δηλήσαντο	- - - uu- uu -uu ----	dactylic hexameter	masculine penthemimeral, trithemimeral
τῶν ἤτοι αὐτῶν τέρενα χρόα γῦπες ἔδονται,	- -- -- uu- uu -u u--	dactylic hexameter	masculine penthemimeral, hepthemimeral, trithemimeral
ἡμεῖς αὖτ’ ἀλόχους τε φίλας καὶ νήπια τέκνα	-- - uu- u u- - -uu --	dactylic hexameter	masculine penthemimeral, hepthemimeral, trithemimeral
ἄξομεν ἐν νήεσσιν, ἐπὴν πτολίεθρον ἕλωμεν.	-uu - --u u- uu-u u--	dactylic hexameter	feminine penthemimeral, hepthemimeral, trithemimeral
Οὕς τινας αὖ μεθιέντας ἴδοι στυγεροῦ πολέμοιο,	- uu - uu-u u- uu- uu--	dactylic hexameter	feminine penthemimeral, hepthemimeral, trithemimeral
τοὺς μάλα νεικείεσκε χολωτοῖσιν ἐπέεσσιν·	- uu ---u u--- uu--	dactylic hexameter	feminine penthemimeral
Ἀργεῖοι ἰόμωροι ἐλεγχέες οὔ νυ σέβεσθε;	--- uu-u u-uu - u u--	dactylic hexameter	feminine penthemimeral, trithemimeral
τίφθ’ οὕτως ἔστητε τεθηπότες ἠΰτε νεβροί,	- -- --u u-uu -uu --	dactylic hexameter	feminine penthemimeral, trithemimeral
αἵ τ’ἐπεὶ οὖν ἔκαμον πολέος πεδίοιο θέουσαι	- uu - uu- uu- uu-u u--	dactylic hexameter	masculine penthemimeral, hepthemimeral, trithemimeral
ἑστᾶσ’, οὐδ’ ἄρα τίς σφι μετὰ φρεσὶ γίγνεται ἀλκή·	-- - uu - u u- uu -uu --	dactylic hexameter	masculine penthemimeral, hepthemimeral, trithemimeral
ὣς ὑμεῖς ἔστητε τεθηπότες οὐδὲ μάχεσθε.	- -- --u u-uu -u u--	dactylic hexameter	feminine penthemimeral, trithemimeral
Ἦ μένετε Τρῶας σχεδὸν ἐλθέμεν ἔνθά τε νῆες	- uu- -- uu -uu -u u --	dactylic hexameter	masculine penthemimeral, trithemimeral
εἰρύατ’ εὔπρυμνοι πολιῆς ἐπὶ θινὶ θαλάσσης,	-uu --- uu- uu -u u--	dactylic hexameter	masculine penthemimeral, hepthemimeral
ὄφρα ἴδητ’ αἴ κ’ὔμμιν ὑπέρσχῃ χεῖρα Κρονίων;	-u u- - -u u-- -u u--	dactylic hexameter	feminine penthemimeral, trithemimeral
ὣς ὅ γε κοιρανέων ἐπεπωλεῖτο στίχας ἀνδρῶν·	- u u -uu- uu--- uu --	dactylic hexameter	masculine penthemimeral
ἦλθε δ’ἐπὶ Κρήτεσσι κιὼν ἀνὰ οὐλαμὸν ἀνδρῶν.	-u u- --u u- uu -uu --	dactylic hexameter	feminine penthemimeral, hepthemimeral, trithemimeral
Οἳ δ’ἀμφ’ Ἰδομενῆα δαΐφρονα θωρήσσοντο·	- - -uu-u u-uu ----	dactylic hexameter	feminine penthemimeral
Ἰδομενεὺς μὲν ἐνὶ προμάχοις συῒ εἴκελος ἀλκήν,	-uu- u u- uu- uu -uu --	dactylic hexameter	masculine penthemimeral, hepthemimeral, trithemimeral
Μηριόνης δ’ἄρα οἱ πυμάτας ὄτρυνε φάλαγγας.	-uu- uu - uu- --u u--	dactylic hexameter	masculine penthemimeral, hepthemimeral, trithemimeral
Τοὺς δὲ ἰδὼν γήθησεν ἄναξ ἀνδρῶν Ἀγαμέμνων,	- u u- --u u- -- uu--	dactylic hexameter	feminine penthemimeral, hepthemimeral, trithemimeral
αὐτίκα δ’Ἰδομενῆα προσηύδα μειλιχίοισιν·	-uu -uu-u u-- -uu--	dactylic hexameter	feminine penthemimeral
Ἰδομενεῦ περὶ μέν σε τίω Δαναῶν ταχυπώλων	-uu- uu - u u- uu- uu--	dactylic hexameter	masculine penthemimeral, hepthemimeral, trithemimeral
ἠμὲν ἐνὶ πτολέμῳ ἠδ’ ἀλλοίῳ ἐπὶ ἔργῳ	-u u- uu- - --- uu --	dactylic hexameter	masculine penthemimeral, trithemimeral
ἠδ’ ἐν δαίθ’, ὅτε πέρ τε γερούσιον αἴθοπα οἶνον	- - - uu - u u-uu -uu --	dactylic hexameter	masculine penthemimeral, trithemimeral
Ἀργείων οἳ ἄριστοι ἐνὶ κρητῆρι κέρωνται.	--- u u-u u- --u u--	dactylic hexameter	feminine penthemimeral, hepthemimeral, trithemimeral
Εἴ περ γάρ τ’ἄλλοι γε κάρη κομόωντες Ἀχαιοὶ	- - - -- u u- uu-u u--	dactylic hexameter	masculine penthemimeral, hepthemimeral, trithemimeral
δαιτρὸν πίνωσιν, σὸν δὲ πλεῖον δέπας αἰεὶ	-- --- - - -- uu --	dactylic hexameter	masculine penthemimeral, hepthemimeral
ἕστηχ’, ὥς περ ἐμοί, πιέειν ὅτε θυμὸς ἀνώγοι.	-- - u u- uu- uu -u u--	dactylic hexameter	masculine penthemimeral, hepthemimeral, trithemimeral
Ἀλλ’ ὄρσευ πόλεμον δ’οἷος πάρος εὔχεαι εἶναι.	- -- uu- -- uu -uu --	dactylic hexameter	masculine penthemimeral, hepthemimeral, trithemimeral
Τὸν δ’αὖτ’ Ἰδομενεὺς Κρητῶν ἀγὸς ἀντίον ηὔδα·	- - -uu- -- uu -uu --	dactylic hexameter	masculine penthemimeral, hepthemimeral
Ἀτρεΐδη μάλα μέν τοι ἐγὼν ἐρίηρος ἑταῖρος	-uu- uu - u u- uu-u u--	dactylic hexameter	masculine penthemimeral, hepthemimeral, trithemimeral
ἔσσομαι, ὡς τὸ πρῶτον ὑπέστην καὶ κατένευσα·	-uu - - -u u-- - uu--	dactylic hexameter	feminine penthemimeral, trithemimeral
ἀλλ’ ἄλλους ὄτρυνε κάρη κομόωντας Ἀχαιοὺς	- -- --u u- uu-u u--	dactylic hexameter	feminine penthemimeral, hepthemimeral, trithemimeral
ὄφρα τάχιστα μαχώμεθ’, ἐπεὶ σύν γ’ὅρκι’ ἔχευαν	-u u-u u-u u- - -u u--	dactylic hexameter	feminine penthemimeral, hepthemimeral
Τρῶες· τοῖσιν δ’αὖ θάνατος καὶ κήδε’ ὀπίσσω	-- -- - uu- - -u u--	dactylic hexameter	masculine penthemimeral, hepthemimeral
ἔσσετ’ ἐπεὶ πρότεροι ὑπὲρ ὅρκια δηλήσαντο.	-u u- uu- uu -uu ----	dactylic hexameter	masculine penthemimeral, trithemimeral
Ὣς ἔφατ’, Ἀτρεΐδης δὲ παρῴχετο γηθόσυνος κῆρ·	- uu -uu- u u-uu -uu- -	dactylic hexameter	masculine penthemimeral
ἦλθε δ’ἐπ’ Αἰάντεσσι κιὼν ἀνὰ οὐλαμὸν ἀνδρῶν·	-u u ---u u- uu -uu --	dactylic hexameter	feminine penthemimeral, hepthemimeral
τὼ δὲ κορυσσέσθην, ἅμα δὲ νέφος εἵπετο πεζῶν.	- u u--- uu - uu -uu --	dactylic hexameter	masculine penthemimeral, hepthemimeral
Ὡς δ’ὅτ’ ἀπὸ σκοπιῆς εἶδεν νέφος αἰπόλος ἀνὴρ	- u u- uu- -- uu -uu --	dactylic hexameter	masculine penthemimeral, hepthemimeral, trithemimeral
ἐρχόμενον κατὰ πόντον ὑπὸ Ζεφύροιο ἰωῆς·	-uu- uu -u u- uu-u u--	dactylic hexameter	feminine penthemimeral, hepthemimeral, trithemimeral
τῷ δέ τ’ἄνευθεν ἐόντι μελάντερον ἠΰτε πίσσα	- u u-u u-u u-uu -uu --	dactylic hexameter	feminine penthemimeral
φαίνετ’ ἰὸν κατὰ πόντον, ἄγει δέ τε λαίλαπα πολλήν,	-u u- uu -u u- u u -uu --	dactylic hexameter	feminine penthemimeral, hepthemimeral, trithemimeral
ῥίγησέν τε ἰδών, ὑπό τε σπέος ἤλασε μῆλα·	--- u u- uu - uu -uu --	dactylic hexameter	masculine penthemimeral, hepthemimeral, trithemimeral
τοῖαι ἅμ’ Αἰάντεσσι διοτρεφέων αἰζηῶν	-u u ---u u-uu- ---	dactylic hexameter	feminine penthemimeral
δήϊον ἐς πόλεμον πυκιναὶ κίνυντο φάλαγγες	-uu - uu- uu- --u u--	dactylic hexameter	masculine penthemimeral, hepthemimeral, trithemimeral
κυάνεαι, σάκεσίν τε καὶ ἔγχεσι πεφρικυῖαι.	-uu- uu- u u -uu ----	dactylic hexameter	masculine penthemimeral, trithemimeral
Καὶ τοὺς μὲν γήθησεν ἰδὼν κρείων Ἀγαμέμνων,	- - - --u u- -- uu--	dactylic hexameter	feminine penthemimeral, hepthemimeral, trithemimeral
καί σφεας φωνήσας ἔπεα πτερόεντα προσηύδα·	- - --- uu- uu-u u--	dactylic hexameter	masculine penthemimeral, hepthemimeral
Αἴαντ’ Ἀργείων ἡγήτορε χαλκοχιτώνων,	-- --- --uu -uu--	dactylic hexameter	masculine penthemimeral
σφῶϊ μέν· οὐ γὰρ ἔοικ’ ὀτρυνέμεν· οὔ τι κελεύω·	-u u - u u- --uu - u u--	dactylic hexameter	masculine penthemimeral, trithemimeral
αὐτὼ γὰρ μάλα λαὸν ἀνώγετον ἶφι μάχεσθαι.	-- - uu -u u-uu -u u--	dactylic hexameter	feminine penthemimeral, trithemimeral
Αἲ γὰρ Ζεῦ τε πάτερ καὶ Ἀθηναίη καὶ Ἄπολλον	- - - u u- u u--- u u--	dactylic hexameter	masculine penthemimeral, trithemimeral
τοῖος πᾶσιν θυμὸς ἐνὶ στήθεσσι γένοιτο·	-- -- -u u- --u u--	dactylic hexameter	feminine penthemimeral, hepthemimeral
τώ κε τάχ’ ἠμύσειε πόλις Πριάμοιο ἄνακτος	- u u ---u u- uu-u u--	dactylic hexameter	feminine penthemimeral, hepthemimeral
χερσὶν ὑφ’ ἡμετέρῃσιν ἁλοῦσά τε περθομένη τε.	-u u -uu-u u-u u -uu- -	dactylic hexameter	feminine penthemimeral
Ὣς εἰπὼν τοὺς μὲν λίπεν αὐτοῦ, βῆ δὲ μετ’ ἄλλους·	- -- - - uu -- - u u --	dactylic hexameter	masculine penthemimeral, trithemimeral
ἔνθ’ ὅ γε Νέστορ’ ἔτετμε λιγὺν Πυλίων ἀγορητὴν	- u u -u u-u u- uu- uu--	dactylic hexameter	feminine penthemimeral, hepthemimeral
οὓς ἑτάρους στέλλοντα καὶ ὀτρύνοντα μάχεσθαι	- uu- --u u ---u u--	dactylic hexameter	feminine penthemimeral, trithemimeral
ἀμφὶ μέγαν Πελάγοντα Ἀλάστορά τε Χρομίον τε	-u u- uu-u u-uu - uu- -	dactylic hexameter	feminine penthemimeral, trithemimeral
Αἵμονά τε κρείοντα Βίαντά τε ποιμένα λαῶν·	-uu - --u u-u u -uu --	dactylic hexameter	feminine penthemimeral, trithemimeral
ἱππῆας μὲν πρῶτα σὺν ἵπποισιν καὶ ὄχεσφι,	--- - -u u --- u u--	dactylic hexameter	feminine penthemimeral, trithemimeral
πεζοὺς δ’ἐξόπιθε στῆσεν πολέας τε καὶ ἐσθλοὺς	-- -uu- -- uu- u u --	dactylic hexameter	masculine penthemimeral, hepthemimeral
ἕρκος ἔμεν πολέμοιο· κακοὺς δ’ἐς μέσσον ἔλασσεν,	-u u- uu-u u- - -u u--	dactylic hexameter	feminine penthemimeral, hepthemimeral, trithemimeral
ὄφρα καὶ οὐκ ἐθέλων τις ἀναγκαίῃ πολεμίζοι.	-u u - uu- u u--- uu--	dactylic hexameter	masculine penthemimeral, trithemimeral
Ἱππεῦσιν μὲν πρῶτ’ ἐπετέλλετο· τοὺς γὰρ ἀνώγει	--- - - uu-uu - u u--	dactylic hexameter	masculine penthemimeral, trithemimeral
σφοὺς ἵππους ἐχέμεν μηδὲ κλονέεσθαι ὁμίλῳ·	- -- uu- -- uu-u u--	dactylic hexameter	masculine penthemimeral, hepthemimeral, trithemimeral
μηδέ τις ἱπποσύνῃ τε καὶ ἠνορέηφι πεποιθὼς	-u u -uu- u u -uu-u u--	dactylic hexameter	masculine penthemimeral
οἶος πρόσθ’ ἄλλων μεμάτω Τρώεσσι μάχεσθαι,	-- - -- uu- --u u--	dactylic hexameter	masculine penthemimeral, hepthemimeral, trithemimeral
μηδ’ ἀναχωρείτω· ἀλαπαδνότεροι γὰρ ἔσεσθε.	- uu--- uu-uu- u u--	dactylic hexameter	masculine penthemimeral
Ὃς δέ κ’ἀνὴρ ἀπὸ ὧν ὀχέων ἕτερ’ ἅρμαθ’ ἵκηται	- u u- uu - uu- uu -u u--	dactylic hexameter	masculine penthemimeral, hepthemimeral, trithemimeral
ἔγχει ὀρεξάσθω, ἐπεὶ ἦ πολὺ φέρτερον οὕτω.	-u u--- uu - uu -uu --	dactylic hexameter	masculine penthemimeral, hepthemimeral
Ὧδε καὶ οἱ πρότεροι πόλεας καὶ τείχε’ ἐπόρθεον	-u u - uu- uu- - -u u--	dactylic hexameter	masculine penthemimeral, hepthemimeral, trithemimeral
τόνδε νόον καὶ θυμὸν ἐνὶ στήθεσσιν ἔχοντες.	-u u- - -u u- --u u--	dactylic hexameter	feminine penthemimeral, hepthemimeral, trithemimeral
Ὣς ὃ γέρων ὄτρυνε πάλαι πολέμων ἐῢ εἰδώς·	- u u- --u u- uu- uu --	dactylic hexameter	feminine penthemimeral, hepthemimeral, trithemimeral
καὶ τὸν μὲν γήθησεν ἰδὼν κρείων Ἀγαμέμνων,	- - - --u u- -- uu--	dactylic hexameter	feminine penthemimeral, hepthemimeral, trithemimeral
καί μιν φωνήσας ἔπεα πτερόεντα προσηύδα·	- - --- uu- uu-u u--	dactylic hexameter	masculine penthemimeral, hepthemimeral
ὦ γέρον εἴθ’ ὡς θυμὸς ἐνὶ στήθεσσι φίλοισιν	- uu - - -u u- --u u--	dactylic hexameter	feminine penthemimeral, hepthemimeral, trithemimeral
ὥς τοι γούναθ’ ἕποιτο, βίη δέ τοι ἔμπεδος εἴη·	- - -u u-u u- u u -uu --	dactylic hexameter	feminine penthemimeral, hepthemimeral
ἀλλά σε γῆρας τείρει ὁμοίϊον· ὡς ὄφελέν τις	-u u -- -u u-uu - uu- -	dactylic hexameter	feminine penthemimeral
ἀνδρῶν ἄλλος ἔχειν, σὺ δὲ κουροτέροισι μετεῖναι.	-- -u u- u u -uu-u u--	dactylic hexameter	masculine penthemimeral
Τὸν δ’ἠμείβετ’ ἔπειτα Γερήνιος ἱππότα Νέστωρ·	- --u u-u u-uu -uu --	dactylic hexameter	feminine penthemimeral
Ἀτρεΐδη μάλα μέν τοι ἐγὼν ἐθέλοιμι καὶ αὐτὸς	-uu- uu - u u- uu-u u --	dactylic hexameter	masculine penthemimeral, hepthemimeral, trithemimeral
ὣς ἔμεν ὡς ὅτε δῖον Ἐρευθαλίωνα κατέκταν.	- uu - uu -u u-uu-u u--	dactylic hexameter	feminine penthemimeral, trithemimeral
Ἀλλ’ οὔ πως ἅμα πάντα θεοὶ δόσαν ἀνθρώποισιν·	- - - uu -u u- uu ----	dactylic hexameter	feminine penthemimeral, hepthemimeral, trithemimeral
εἰ τότε κοῦρος ἔα νῦν αὖτέ με γῆρας ὀπάζει.	- uu -u u- - -u u -u u--	dactylic hexameter	masculine penthemimeral
Ἀλλὰ καὶ ὧς ἱππεῦσι μετέσσομαι ἠδὲ κελεύσω	-u u - --u u-uu -u u--	dactylic hexameter	feminine penthemimeral, trithemimeral
βουλῇ καὶ μύθοισι· τὸ γὰρ γέρας ἐστὶ γερόντων.	-- - --u u - uu -u u--	dactylic hexameter	feminine penthemimeral, hepthemimeral, trithemimeral
Αἰχμὰς δ’αἰχμάσσουσι νεώτεροι, οἵ περ ἐμεῖο	-- ---u u-uu - u u--	dactylic hexameter	feminine penthemimeral
ὁπλότεροι γεγάασι πεποίθασίν τε βίηφιν.	-uu- uu-u u--- u u--	dactylic hexameter	feminine penthemimeral, trithemimeral
Ὣς ἔφατ’, Ἀτρεΐδης δὲ παρῴχετο γηθόσυνος κῆρ.	- uu -uu- u u-uu -uu- -	dactylic hexameter	masculine penthemimeral
Εὗρ’ υἱὸν Πετεῶο Μενεσθῆα πλήξιππον	- -- uu-u u--- ---	dactylic hexameter	feminine penthemimeral, trithemimeral
ἑσταότ’· ἀμφὶ δ’Ἀθηναῖοι μήστωρες ἀϋτῆς·	-uu -u u--- --u u--	dactylic hexameter	hepthemimeral
αὐτὰρ ὃ πλησίον ἑστήκει πολύμητις Ὀδυσσεύς,	-u u -uu --- uu-u u--	dactylic hexameter	hepthemimeral
πὰρ δὲ Κεφαλλήνων ἀμφὶ στίχες οὐκ ἀλαπαδναὶ	- u u--- -- uu - uu--	dactylic hexameter	masculine penthemimeral, hepthemimeral
ἕστασαν· οὐ γάρ πώ σφιν ἀκούετο λαὸς ἀϋτῆς,	-uu - - - u u-uu -u u--	dactylic hexameter	masculine penthemimeral, trithemimeral
ἀλλὰ νέον συνορινόμεναι κίνυντο φάλαγγες	-u u- uu-uu- --u u--	dactylic hexameter	hepthemimeral, trithemimeral
Τρώων ἱπποδάμων καὶ Ἀχαιῶν· οἳ δὲ μένοντες	-- -uu- u u-- - u u--	dactylic hexameter	masculine penthemimeral
ἕστασαν ὁππότε πύργος Ἀχαιῶν ἄλλος ἐπελθὼν	-uu -uu -u u-- -u u--	dactylic hexameter	feminine penthemimeral
Τρώων ὁρμήσειε καὶ ἄρξειαν πολέμοιο.	-- ---u u --- uu--	dactylic hexameter	feminine penthemimeral
Τοὺς δὲ ἰδὼν νείκεσσεν ἄναξ ἀνδρῶν Ἀγαμέμνων,	- u u- --u u- -- uu--	dactylic hexameter	feminine penthemimeral, hepthemimeral, trithemimeral
καί σφεας φωνήσας ἔπεα πτερόεντα προσηύδα·	- - --- uu- uu-u u--	dactylic hexameter	masculine penthemimeral, hepthemimeral
ὦ υἱὲ Πετεῶο διοτρεφέος βασιλῆος,	- -- uu-u u-uu- uu--	dactylic hexameter	feminine penthemimeral, trithemimeral
καὶ σὺ κακοῖσι δόλοισι κεκασμένε κερδαλεόφρον	- u u-u u-u u-uu -uu--	dactylic hexameter	feminine penthemimeral
τίπτε καταπτώσσοντες ἀφέστατε, μίμνετε δ’ἄλλους;	-u u---u u-uu -uu --	dactylic hexameter	feminine penthemimeral
σφῶϊν μέν τ’ἐπέοικε μετὰ πρώτοισιν ἐόντας	-- - uu-u u- --u u--	dactylic hexameter	feminine penthemimeral, hepthemimeral, trithemimeral
ἑστάμεν ἠδὲ μάχης καυστείρης ἀντιβολῆσαι·	-uu -u u- --- -uu--	dactylic hexameter	masculine penthemimeral
πρώτω γὰρ καὶ δαιτὸς ἀκουάζεσθον ἐμεῖο,	-- - - -u u---u u--	dactylic hexameter	feminine penthemimeral, trithemimeral
ὁππότε δαῖτα γέρουσιν ἐφοπλίζωμεν Ἀχαιοί.	-uu -u u-u u---u u--	dactylic hexameter	feminine penthemimeral
Ἔνθα φίλ’ ὀπταλέα κρέα ἔδμεναι ἠδὲ κύπελλα	-u u -uu- uu -uu -u u--	dactylic hexameter	masculine penthemimeral
οἴνου πινέμεναι μελιηδέος ὄφρ’ ἐθέλητον·	-- -uu- uu-uu - uu--	dactylic hexameter	masculine penthemimeral
νῦν δὲ φίλως χ’ὁρόῳτε καὶ εἰ δέκα πύργοι Ἀχαιῶν	- u u- uu-u u - uu -u u--	dactylic hexameter	feminine penthemimeral, hepthemimeral, trithemimeral
ὑμείων προπάροιθε μαχοίατο νηλέϊ χαλκῷ.	--- uu-u u-uu -uu --	dactylic hexameter	feminine penthemimeral, trithemimeral
Τὸν δ’ἄρ’ ὑπόδρα ἰδὼν προσέφη πολύμητις Ὀδυσσεύς·	- u u-u u- uu- uu-u u--	dactylic hexameter	masculine penthemimeral, hepthemimeral
Ἀτρεΐδη ποῖόν σε ἔπος φύγεν ἕρκος ὀδόντων;	-uu- -- u u- uu -u u--	dactylic hexameter	masculine penthemimeral, hepthemimeral, trithemimeral
πῶς δὴ φῂς πολέμοιο μεθιέμεν ὁππότ’ Ἀχαιοὶ	- - - uu-u u-uu -u u--	dactylic hexameter	feminine penthemimeral, trithemimeral
Τρωσὶν ἐφ’ ἱπποδάμοισιν ἐγείρομεν ὀξὺν Ἄρηα;	-u u -uu-u u-uu -u u--	dactylic hexameter	feminine penthemimeral
ὄψεαι αἴ κ’ἐθέλῃσθα καὶ αἴ κέν τοι τὰ μεμήλῃ	-uu - uu-u u - - - u u--	dactylic hexameter	feminine penthemimeral, hepthemimeral, trithemimeral
Τηλεμάχοιο φίλον πατέρα προμάχοισι μιγέντα	-uu-u u- uu- uu-u u--	dactylic hexameter	masculine penthemimeral, hepthemimeral
Τρώων ἱπποδάμων· σὺ δὲ ταῦτ’ ἀνεμώλια βάζεις.	-- -uu- u u - uu-uu --	dactylic hexameter	masculine penthemimeral, hepthemimeral
Τὸν δ’ἐπιμειδήσας προσέφη κρείων Ἀγαμέμνων	- uu--- uu- -- uu--	dactylic hexameter	masculine penthemimeral, hepthemimeral
ὡς γνῶ χωομένοιο· πάλιν δ’ὅ γε λάζετο μῦθον·	- - -uu-u u- u u -uu --	dactylic hexameter	feminine penthemimeral, hepthemimeral
διογενὲς Λαερτιάδη πολυμήχαν’ Ὀδυσσεῦ	-uu- --uu- uu-u u--	dactylic hexameter	hepthemimeral, trithemimeral
οὔτέ σε νεικείω περιώσιον οὔτε κελεύω·	-u u --- uu-uu -u u--	dactylic hexameter	masculine penthemimeral
οἶδα γὰρ ὥς τοι θυμὸς ἐνὶ στήθεσσι φίλοισιν	-u u - - -u u- --u u--	dactylic hexameter	feminine penthemimeral, hepthemimeral, trithemimeral
ἤπια δήνεα οἶδε· τὰ γὰρ φρονέεις ἅ τ’ἐγώ περ.	-uu -uu -u u - uu- u u- -	dactylic hexameter	feminine penthemimeral, hepthemimeral
Ἀλλ’ ἴθι ταῦτα δ’ὄπισθεν ἀρεσσόμεθ’ εἴ τι κακὸν νῦν	- uu -u u-u u-uu - u u- -	dactylic hexameter	feminine penthemimeral
εἴρηται, τὰ δὲ πάντα θεοὶ μεταμώνια θεῖεν.	--- u u -u u- uu-uu --	dactylic hexameter	feminine penthemimeral, hepthemimeral, trithemimeral
Ὣς εἰπὼν τοὺς μὲν λίπεν αὐτοῦ, βῆ δὲ μετ’ ἄλλους.	- -- - - uu -- - u u --	dactylic hexameter	masculine penthemimeral, trithemimeral
Εὗρε δὲ Τυδέος υἱὸν ὑπέρθυμον Διομήδεα	-u u -uu -u u--- uu--	dactylic hexameter	feminine penthemimeral
ἑσταότ’ ἔν θ’ἵπποισι καὶ ἅρμασι κολλητοῖσι·	-uu - --u u -uu ----	dactylic hexameter	feminine penthemimeral, trithemimeral
πὰρ δέ οἱ ἑστήκει Σθένελος Καπανήϊος υἱός.	- u u --- uu- uu-uu --	dactylic hexameter	masculine penthemimeral, hepthemimeral
Καὶ τὸν μὲν νείκεσσεν ἰδὼν κρείων Ἀγαμέμνων,	- - - --u u- -- uu--	dactylic hexameter	feminine penthemimeral, hepthemimeral, trithemimeral
καί μιν φωνήσας ἔπεα πτερόεντα προσηύδα·	- - --- uu- uu-u u--	dactylic hexameter	masculine penthemimeral, hepthemimeral
ὤ μοι Τυδέος υἱὲ δαΐφρονος ἱπποδάμοιο	- - -uu -u u-uu -uu--	dactylic hexameter	feminine penthemimeral
τί πτώσσεις, τί δ’ὀπιπεύεις πολέμοιο γεφύρας;	- -- u u--- uu-u u--	dactylic hexameter	hepthemimeral, trithemimeral
οὐ μὲν Τυδέϊ γ’ὧδε φίλον πτωσκαζέμεν ἦεν,	- - -uu -u u- --uu --	dactylic hexameter	feminine penthemimeral, hepthemimeral
ἀλλὰ πολὺ πρὸ φίλων ἑτάρων δηίοισι μάχεσθαι,	-u u- u u- uu- --u u--	dactylic hexameter	masculine penthemimeral, hepthemimeral, trithemimeral
ὡς φάσαν οἵ μιν ἴδοντο πονεύμενον· οὐ γὰρ ἔγωγε	- uu - u u-u u-uu - u u--	dactylic hexameter	feminine penthemimeral, trithemimeral
ἤντησ’ οὐδὲ ἴδον· περὶ δ’ἄλλων φασὶ γενέσθαι.	-- -u u- uu -- -u u--	dactylic hexameter	masculine penthemimeral
Ἤτοι μὲν γὰρ ἄτερ πολέμου εἰσῆλθε Μυκήνας	-- - u u- uu- --u u--	dactylic hexameter	masculine penthemimeral, hepthemimeral, trithemimeral
ξεῖνος ἅμ’ ἀντιθέῳ Πολυνείκεϊ λαὸν ἀγείρων·	-u u -uu- uu-uu -u u--	dactylic hexameter	masculine penthemimeral
οἳ δὲ τότ’ ἐστρατόωνθ’ ἱερὰ πρὸς τείχεα Θήβης,	- u u -uu- uu- - -uu --	dactylic hexameter	masculine penthemimeral, hepthemimeral
καί ῥα μάλα λίσσοντο δόμεν κλειτοὺς ἐπικούρους·	- u u- --u u- -- uu--	dactylic hexameter	feminine penthemimeral, hepthemimeral, trithemimeral
οἳ δ’ἔθελον δόμεναι καὶ ἐπῄνεον ὡς ἐκέλευον·	- uu- uu- u u-uu - uu--	dactylic hexameter	masculine penthemimeral, trithemimeral
ἀλλὰ Ζεὺς ἔτρεψε παραίσια σήματα φαίνων.	-- - --u u-uu -uu --	dactylic hexameter	feminine penthemimeral, trithemimeral
Οἳ δ’ἐπεὶ οὖν ᾤχοντο ἰδὲ πρὸ ὁδοῦ ἐγένοντο,	- uu - --u u- u u- uu--	dactylic hexameter	feminine penthemimeral, hepthemimeral, trithemimeral
Ἀσωπὸν δ’ἵκοντο βαθύσχοινον λεχεποίην,	--- --u u--- uu--	dactylic hexameter	feminine penthemimeral, trithemimeral
ἔνθ’ αὖτ’ ἀγγελίην ἐπὶ Τυδῆ στεῖλαν Ἀχαιοί.	- - -uu- uu -- -u u--	dactylic hexameter	masculine penthemimeral
Αὐτὰρ ὃ βῆ, πολέας δὲ κιχήσατο Καδμεΐωνας	-u u - uu- u u-uu -uu--	dactylic hexameter	masculine penthemimeral, trithemimeral
δαινυμένους κατὰ δῶμα βίης Ἐτεοκληείης.	-uu- uu -u u- uu----	dactylic hexameter	feminine penthemimeral, hepthemimeral, trithemimeral
Ἔνθ’ οὐδὲ ξεῖνός περ ἐὼν ἱππηλάτα Τυδεὺς	- -- -- u u- --uu --	dactylic hexameter	masculine penthemimeral, hepthemimeral, trithemimeral
τάρβει, μοῦνος ἐὼν πολέσιν μετὰ Καδμείοισιν,	-- -u u- uu- uu ----	dactylic hexameter	masculine penthemimeral, hepthemimeral
ἀλλ’ ὅ γ’ἀεθλεύειν προκαλίζετο, πάντα δ’ἐνίκα	- u u--- uu-uu -u u--	dactylic hexameter	masculine penthemimeral
ῥηϊδίως· τοίη οἱ ἐπίρροθος ἦεν Ἀθήνη.	-uu- -- u u-uu -u u--	dactylic hexameter	masculine penthemimeral, trithemimeral
Οἳ δὲ χολωσάμενοι Καδμεῖοι κέντορες ἵππων	- u u-uu- --- -uu --	dactylic hexameter	masculine penthemimeral
ἂψ ἄρ’ ἀνερχομένῳ πυκινὸν λόχον εἷσαν ἄγοντες	- u u-uu- uu- uu -u u--	dactylic hexameter	masculine penthemimeral, hepthemimeral
κούρους πεντήκοντα· δύω δ’ἡγήτορες ἦσαν,	-- ---u u- --uu --	dactylic hexameter	feminine penthemimeral, hepthemimeral
Μαίων Αἱμονίδης ἐπιείκελος ἀθανάτοισιν,	-- -uu- uu-uu -uu--	dactylic hexameter	masculine penthemimeral
υἱός τ’Αὐτοφόνοιο μενεπτόλεμος Πολυφόντης.	-- -uu-u u-uu- uu--	dactylic hexameter	feminine penthemimeral
Τυδεὺς μὲν καὶ τοῖσιν ἀεικέα πότμον ἐφῆκε·	-- - - -u u-uu -u u--	dactylic hexameter	feminine penthemimeral, trithemimeral
πάντας ἔπεφν’, ἕνα δ’οἶον ἵει οἶκον δὲ νέεσθαι·	-u u- uu -u u- -- u u--	dactylic hexameter	feminine penthemimeral, hepthemimeral, trithemimeral
Μαίον’ ἄρα προέηκε θεῶν τεράεσσι πιθήσας.	-u u- uu-u u- uu-u u--	dactylic hexameter	feminine penthemimeral, hepthemimeral, trithemimeral
Τοῖος ἔην Τυδεὺς Αἰτώλιος· ἀλλὰ τὸν υἱὸν	-u u- -- --uu -u u --	dactylic hexameter	masculine penthemimeral, trithemimeral
γείνατο εἷο χέρεια μάχῃ, ἀγορῇ δέ τ’ἀμείνω.	-uu -u u-u u- uu- u u--	dactylic hexameter	feminine penthemimeral, hepthemimeral
Ὣς φάτο, τὸν δ’οὔ τι προσέφη κρατερὸς Διομήδης	- uu - - - uu- uu- uu--	dactylic hexameter	masculine penthemimeral, hepthemimeral, trithemimeral
αἰδεσθεὶς βασιλῆος ἐνιπὴν αἰδοίοιο·	--- uu-u u-- ----	dactylic hexameter	feminine penthemimeral, trithemimeral
τὸν δ’υἱὸς Καπανῆος ἀμείψατο κυδαλίμοιο·	- -- uu-u u-uu -uu--	dactylic hexameter	feminine penthemimeral, trithemimeral
Ἀτρεΐδη μὴ ψεύδε’ ἐπιστάμενος σάφα εἰπεῖν·	-uu- - -u u-uu- uu --	dactylic hexameter	feminine penthemimeral, trithemimeral
ἡμεῖς τοι πατέρων μέγ’ ἀμείνονες εὐχόμεθ’ εἶναι·	-- - uu- u u-uu -uu --	dactylic hexameter	masculine penthemimeral, trithemimeral
ἡμεῖς καὶ Θήβης ἕδος εἵλομεν ἑπταπύλοιο	-- - -- uu -uu -uu--	dactylic hexameter	masculine penthemimeral, trithemimeral
παυρότερον λαὸν ἀγαγόνθ’ ὑπὸ τεῖχος ἄρειον,	-uu- uu --- uu -u u--	dactylic hexameter	hepthemimeral, trithemimeral
πειθόμενοι τεράεσσι θεῶν καὶ Ζηνὸς ἀρωγῇ·	-uu- uu-u u- - -u u--	dactylic hexameter	feminine penthemimeral, hepthemimeral, trithemimeral
κεῖνοι δὲ σφετέρῃσιν ἀτασθαλίῃσιν ὄλοντο·	-- - uu-u u-uu-u u--	dactylic hexameter	feminine penthemimeral, trithemimeral
τὼ μή μοι πατέρας ποθ’ ὁμοίῃ ἔνθεο τιμῇ.	- - - uu- u u-- -uu --	dactylic hexameter	masculine penthemimeral, trithemimeral
Τὸν δ’ἄρ’ ὑπόδρα ἰδὼν προσέφη κρατερὸς Διομήδης·	- u u-u u- uu- uu- uu--	dactylic hexameter	masculine penthemimeral, hepthemimeral
τέττα, σιωπῇ ἧσο, ἐμῷ δ’ἐπιπείθεο μύθῳ·	-u u-- -u u- uu-uu --	dactylic hexameter	feminine penthemimeral, hepthemimeral
οὐ γὰρ ἐγὼ νεμεσῶ Ἀγαμέμνονι ποιμένι λαῶν	- u u- uu- uu-uu -uu --	dactylic hexameter	masculine penthemimeral, trithemimeral
ὀτρύνοντι μάχεσθαι ἐϋκνήμιδας Ἀχαιούς·	---u u-u u---u u--	dactylic hexameter	feminine penthemimeral
τούτῳ μὲν γὰρ κῦδος ἅμ’ ἕψεται εἴ κεν Ἀχαιοὶ	-- - - -u u -uu - u u--	dactylic hexameter	feminine penthemimeral, trithemimeral
Τρῶας δῃώσωσιν ἕλωσί τε Ἴλιον ἱρήν,	-- ---u u-u u -uu --	dactylic hexameter	feminine penthemimeral
τούτῳ δ’αὖ μέγα πένθος Ἀχαιῶν δῃωθέντων.	-- - uu -u u-- ----	dactylic hexameter	feminine penthemimeral, trithemimeral
Ἀλλ’ ἄγε δὴ καὶ νῶϊ μεδώμεθα θούριδος ἀλκῆς.	- uu - - -u u-uu -uu --	dactylic hexameter	feminine penthemimeral, trithemimeral
Ἦ ῥα καὶ ἐξ ὀχέων σὺν τεύχεσιν ἆλτο χαμᾶζε·	- u u - uu- - -uu -u u--	dactylic hexameter	masculine penthemimeral, trithemimeral
δεινὸν δ’ἔβραχε χαλκὸς ἐπὶ στήθεσσιν ἄνακτος	-- -uu -u u- --u u--	dactylic hexameter	feminine penthemimeral, hepthemimeral
ὀρνυμένου· ὑπό κεν ταλασίφρονά περ δέος εἷλεν.	-uu- uu - uu-uu - uu --	dactylic hexameter	masculine penthemimeral, trithemimeral
Ὡς δ’ὅτ’ ἐν αἰγιαλῷ πολυηχέϊ κῦμα θαλάσσης	- u u -uu- uu-uu -u u--	dactylic hexameter	masculine penthemimeral
ὄρνυτ’ ἐπασσύτερον Ζεφύρου ὕπο κινήσαντος·	-u u-uu- uu- uu ----	dactylic hexameter	masculine penthemimeral, hepthemimeral
πόντῳ μέν τε πρῶτα κορύσσεται, αὐτὰρ ἔπειτα	-- - - -u u-uu -u u--	dactylic hexameter	feminine penthemimeral, trithemimeral
χέρσῳ ῥηγνύμενον μεγάλα βρέμει, ἀμφὶ δέ τ’ἄκρας	-- -uu- uu- uu -u u --	dactylic hexameter	masculine penthemimeral, hepthemimeral
κυρτὸν ἐὸν κορυφοῦται, ἀποπτύει δ’ἁλὸς ἄχνην·	-u u- uu-u u--- uu --	dactylic hexameter	feminine penthemimeral, trithemimeral
ὣς τότ’ ἐπασσύτεραι Δαναῶν κίνυντο φάλαγγες	- u u-uu- uu- --u u--	dactylic hexameter	masculine penthemimeral, hepthemimeral
νωλεμέως πόλεμον δέ· κέλευε δὲ οἷσιν ἕκαστος	-uu- uu- u u-u u -u u--	dactylic hexameter	masculine penthemimeral, trithemimeral
ἡγεμόνων· οἳ δ’ἄλλοι ἀκὴν ἴσαν, οὐδέ κε φαίης	-uu- - -u u- uu -u u --	dactylic hexameter	feminine penthemimeral, hepthemimeral, trithemimeral
τόσσον λαὸν ἕπεσθαι ἔχοντ’ ἐν στήθεσιν αὐδήν,	-- -u u-u u- - -uu --	dactylic hexameter	feminine penthemimeral, hepthemimeral
σιγῇ δειδιότες σημάντορας· ἀμφὶ δὲ πᾶσι	-- -uu- --uu -u u --	dactylic hexameter	masculine penthemimeral
τεύχεα ποικίλ’ ἔλαμπε, τὰ εἱμένοι ἐστιχόωντο.	-uu -u u-u u -uu -uu--	dactylic hexameter	feminine penthemimeral
Τρῶες δ’,ὥς τ’ὄϊες πολυπάμονος ἀνδρὸς ἐν αὐλῇ	-- - uu- uu-uu -u u --	dactylic hexameter	masculine penthemimeral, trithemimeral
μυρίαι ἑστήκασιν ἀμελγόμεναι γάλα λευκὸν	-uu ---u u-uu- uu --	dactylic hexameter	feminine penthemimeral
ἀζηχὲς μεμακυῖαι ἀκούουσαι ὄπα ἀρνῶν,	--- uu-u u--- uu --	dactylic hexameter	feminine penthemimeral, trithemimeral
ὣς Τρώων ἀλαλητὸς ἀνὰ στρατὸν εὐρὺν ὀρώρει·	- -- uu-u u- uu -u u--	dactylic hexameter	feminine penthemimeral, hepthemimeral, trithemimeral
οὐ γὰρ πάντων ἦεν ὁμὸς θρόος οὐδ’ ἴα γῆρυς,	- - -- -u u- uu - uu --	dactylic hexameter	feminine penthemimeral, hepthemimeral
ἀλλὰ γλῶσσα μέμικτο, πολύκλητοι δ’ἔσαν ἄνδρες.	-- -u u-u u--- uu --	dactylic hexameter	feminine penthemimeral
Ὄρσε δὲ τοὺς μὲν Ἄρης, τοὺς δὲ γλαυκῶπις Ἀθήνη	-u u - u u- - - --u u--	dactylic hexameter	masculine penthemimeral, hepthemimeral, trithemimeral
Δεῖμός τ’ἠδὲ Φόβος καὶ Ἔρις ἄμοτον μεμαυῖα,	-- -u u- u u- uu- uu--	dactylic hexameter	masculine penthemimeral, hepthemimeral
Ἄρεος ἀνδροφόνοιο κασιγνήτη ἑτάρη τε,	-uu -uu-u u--- uu- -	dactylic hexameter	feminine penthemimeral
ἥ τ’ὀλίγη μὲν πρῶτα κορύσσεται, αὐτὰρ ἔπειτα	- uu- - -u u-uu -u u--	dactylic hexameter	feminine penthemimeral, trithemimeral
οὐρανῷ ἐστήριξε κάρη καὶ ἐπὶ χθονὶ βαίνει·	-uu ---u u- u u- uu --	dactylic hexameter	feminine penthemimeral, hepthemimeral
ἥ σφιν καὶ τότε νεῖκος ὁμοίϊον ἔμβαλε μέσσῳ	- - - uu -u u-uu -uu --	dactylic hexameter	feminine penthemimeral, trithemimeral
ἐρχομένη καθ’ ὅμιλον ὀφέλλουσα στόνον ἀνδρῶν.	-uu- u u-u u--- uu --	dactylic hexameter	feminine penthemimeral, trithemimeral
Οἳ δ’ὅτε δή ῥ’ἐς χῶρον ἕνα ξυνιόντες ἵκοντο,	- uu - - -u u- uu-u u--	dactylic hexameter	feminine penthemimeral, hepthemimeral, trithemimeral
σύν ῥ’ἔβαλον ῥινούς, σὺν δ’ἔγχεα καὶ μένε’ ἀνδρῶν	- uu- -- - -uu - uu --	dactylic hexameter	masculine penthemimeral, trithemimeral
χαλκεοθωρήκων· ἀτὰρ ἀσπίδες ὀμφαλόεσσαι	-uu--- uu -uu -uu--	dactylic hexameter	masculine penthemimeral
ἔπληντ’ ἀλλήλῃσι, πολὺς δ’ὀρυμαγδὸς ὀρώρει.	-- ---u u- uu-u u--	dactylic hexameter	feminine penthemimeral, hepthemimeral
Ἔνθα δ’ἅμ’ οἰμωγή τε καὶ εὐχωλὴ πέλεν ἀνδρῶν	-u u --- u u --- uu --	dactylic hexameter	masculine penthemimeral
ὀλλύντων τε καὶ ὀλλυμένων, ῥέε δ’αἵματι γαῖα.	--- u u -uu- uu -uu --	dactylic hexameter	hepthemimeral, trithemimeral
Ὡς δ’ὅτε χείμαρροι ποταμοὶ κατ’ ὄρεσφι ῥέοντες	- uu --- uu- u u-u u--	dactylic hexameter	masculine penthemimeral, hepthemimeral
ἐς μισγάγκειαν συμβάλλετον ὄβριμον ὕδωρ	- ---- --uu -uu --	dactylic hexameter	masculine penthemimeral
κρουνῶν ἐκ μεγάλων κοίλης ἔντοσθε χαράδρης,	-- - uu- -- --u u--	dactylic hexameter	masculine penthemimeral, hepthemimeral, trithemimeral
τῶν δέ τε τηλόσε δοῦπον ἐν οὔρεσιν ἔκλυε ποιμήν·	- u u -uu -u u -uu -uu --	dactylic hexameter	feminine penthemimeral
ὣς τῶν μισγομένων γένετο ἰαχή τε πόνος τε.	- - -uu- uu- uu- u u- -	dactylic hexameter	masculine penthemimeral, hepthemimeral
Πρῶτος δ’Ἀντίλοχος Τρώων ἕλεν ἄνδρα κορυστὴν	-- -uu- -- uu -u u--	dactylic hexameter	masculine penthemimeral, hepthemimeral
ἐσθλὸν ἐνὶ προμάχοισι Θαλυσιάδην Ἐχέπωλον·	-u u- uu-u u-uu- uu--	dactylic hexameter	feminine penthemimeral, trithemimeral
τόν ῥ’ἔβαλε πρῶτος κόρυθος φάλον ἱπποδασείης,	- uu- -- uu- uu -uu--	dactylic hexameter	masculine penthemimeral, hepthemimeral, trithemimeral
ἐν δὲ μετώπῳ πῆξε, πέρησε δ’ἄρ’ ὀστέον εἴσω	- u u-- -u u-u u -uu --	dactylic hexameter	feminine penthemimeral
αἰχμὴ χαλκείη· τὸν δὲ σκότος ὄσσε κάλυψεν,	-- --- - - uu -u u--	dactylic hexameter	masculine penthemimeral, hepthemimeral
ἤριπε δ’ὡς ὅτε πύργος ἐνὶ κρατερῇ ὑσμίνῃ.	-uu - uu -u u- uu- ---	dactylic hexameter	feminine penthemimeral, hepthemimeral, trithemimeral
Τὸν δὲ πεσόντα ποδῶν ἔλαβε κρείων Ἐλεφήνωρ	- u u-u u- uu- -- uu--	dactylic hexameter	masculine penthemimeral, hepthemimeral
Χαλκωδοντιάδης μεγαθύμων ἀρχὸς Ἀβάντων,	---uu- uu-- -u u--	dactylic hexameter	masculine penthemimeral
ἕλκε δ’ὑπ’ ἐκ βελέων, λελιημένος ὄφρα τάχιστα	-u u - uu- uu-uu -u u--	dactylic hexameter	masculine penthemimeral, trithemimeral
τεύχεα συλήσειε· μίνυνθα δέ οἱ γένεθ’ ὁρμή.	-uu ---u u-u u - uu --	dactylic hexameter	feminine penthemimeral
Νεκρὸν γὰρ ἐρύοντα ἰδὼν μεγάθυμος Ἀγήνωρ	-- - uu-u u- uu-u u--	dactylic hexameter	feminine penthemimeral, hepthemimeral, trithemimeral
πλευρά, τά οἱ κύψαντι παρ’ ἀσπίδος ἐξεφαάνθη,	-u u - --u u -uu -uu--	dactylic hexameter	feminine penthemimeral, trithemimeral
οὔτησε ξυστῷ χαλκήρεϊ, λῦσε δὲ γυῖα.	--- -- --uu -u u --	dactylic hexameter	masculine penthemimeral, trithemimeral
Ὣς τὸν μὲν λίπε θυμός, ἐπ’ αὐτῷ δ’ἔργον ἐτύχθη	- - - uu -u u -- -u u--	dactylic hexameter	feminine penthemimeral, trithemimeral
ἀργαλέον Τρώων καὶ Ἀχαιῶν· οἳ δὲ λύκοι ὣς	-uu- -- u u-- - u u- -	dactylic hexameter	masculine penthemimeral, trithemimeral
ἀλλήλοις ἐπόρουσαν, ἀνὴρ δ’ἄνδρ’ ἐδνοπάλιζεν.	--- uu-u u- - -uu--	dactylic hexameter	feminine penthemimeral, hepthemimeral, trithemimeral
Ἔνθ’ ἔβαλ’ Ἀνθεμίωνος υἱὸν Τελαμώνιος Αἴας	- uu -uu-u u- uu-uu --	dactylic hexameter	feminine penthemimeral, hepthemimeral
ἠΐθεον θαλερὸν Σιμοείσιον, ὅν ποτε μήτηρ	-uu- uu- uu-uu - uu --	dactylic hexameter	masculine penthemimeral, trithemimeral
Ἴδηθεν κατιοῦσα παρ’ ὄχθῃσιν Σιμόεντος	--- uu-u u --- uu--	dactylic hexameter	feminine penthemimeral, trithemimeral
γείνατ’, ἐπεί ῥα τοκεῦσιν ἅμ’ ἕσπετο μῆλα ἰδέσθαι·	-u u- u u-u u -uu -u u--	dactylic hexameter	feminine penthemimeral, trithemimeral
τοὔνεκά μιν κάλεον Σιμοείσιον· οὐδὲ τοκεῦσι	-uu - uu- uu-uu -u u--	dactylic hexameter	masculine penthemimeral, trithemimeral
θρέπτρα φίλοις ἀπέδωκε, μινυνθάδιος δέ οἱ αἰὼν	-u u- uu-u u-uu- u u --	dactylic hexameter	feminine penthemimeral, trithemimeral
ἔπλεθ’ ὑπ’ Αἴαντος μεγαθύμου δουρὶ δαμέντι.	-u u --- uu-- -u u--	dactylic hexameter	masculine penthemimeral
Πρῶτον γάρ μιν ἰόντα βάλε στῆθος παρὰ μαζὸν	-- - u u-u u- -- uu --	dactylic hexameter	feminine penthemimeral, hepthemimeral, trithemimeral
δεξιόν· ἀντικρὺ δὲ δι’ ὤμου χάλκεον ἔγχος	-uu --- u u -- -uu --	dactylic hexameter	masculine penthemimeral
ἦλθεν· ὃ δ’ἐν κονίῃσι χαμαὶ πέσεν αἴγειρος ὣς	-u u - uu-u u- uu --- -	dactylic hexameter	feminine penthemimeral, hepthemimeral, trithemimeral
ἥ ῥά τ’ἐν εἱαμενῇ ἕλεος μεγάλοιο πεφύκει	- u u -uu- uu- uu-u u--	dactylic hexameter	masculine penthemimeral, hepthemimeral
λείη, ἀτάρ τέ οἱ ὄζοι ἐπ’ ἀκροτάτῃ πεφύασι·	-u u- u u -u u -uu- uu--	dactylic hexameter	feminine penthemimeral, trithemimeral
τὴν μέν θ’ἁρματοπηγὸς ἀνὴρ αἴθωνι σιδήρῳ	- - -uu-u u- --u u--	dactylic hexameter	feminine penthemimeral, hepthemimeral
ἐξέταμ’, ὄφρα ἴτυν κάμψῃ περικαλλέϊ δίφρῳ·	-uu -u u- -- uu-uu --	dactylic hexameter	masculine penthemimeral, hepthemimeral
ἣ μέν τ’ἀζομένη κεῖται ποταμοῖο παρ’ ὄχθας.	- - -uu- -- uu-u u --	dactylic hexameter	masculine penthemimeral, hepthemimeral
Τοῖον ἄρ’ Ἀνθεμίδην Σιμοείσιον ἐξενάριξεν	-u u -uu- uu-uu -uu--	dactylic hexameter	masculine penthemimeral
Αἴας διογενής· τοῦ δ’Ἄντιφος αἰολοθώρηξ	-- -uu- - -uu -uu--	dactylic hexameter	masculine penthemimeral
Πριαμίδης καθ’ ὅμιλον ἀκόντισεν ὀξέϊ δουρί.	-uu- u u-u u-uu -uu --	dactylic hexameter	feminine penthemimeral, trithemimeral
Τοῦ μὲν ἅμαρθ’, ὃ δὲ Λεῦκον Ὀδυσσέος ἐσθλὸν ἑταῖρον	- u u- u u -u u-uu -u u--	dactylic hexameter	feminine penthemimeral, trithemimeral
βεβλήκει βουβῶνα, νέκυν ἑτέρωσ’ ἐρύοντα·	--- --u u- uu- uu--	dactylic hexameter	feminine penthemimeral, hepthemimeral, trithemimeral
ἤριπε δ’ἀμφ’ αὐτῷ, νεκρὸς δέ οἱ ἔκπεσε χειρός.	-uu - -- -- u u -uu --	dactylic hexameter	masculine penthemimeral, hepthemimeral, trithemimeral
Τοῦ δ’Ὀδυσεὺς μάλα θυμὸν ἀποκταμένοιο χολώθη,	- uu- uu -u u-uu-u u--	dactylic hexameter	feminine penthemimeral, trithemimeral
βῆ δὲ διὰ προμάχων κεκορυθμένος αἴθοπι χαλκῷ,	- u u- uu- uu-uu -uu --	dactylic hexameter	masculine penthemimeral, trithemimeral
στῆ δὲ μάλ’ ἐγγὺς ἰὼν καὶ ἀκόντισε δουρὶ φαεινῷ	- u u -u u- u u-uu -u u--	dactylic hexameter	masculine penthemimeral
ἀμφὶ ἓ παπτήνας· ὑπὸ δὲ Τρῶες κεκάδοντο	-u u --- uu - -- uu--	dactylic hexameter	masculine penthemimeral, hepthemimeral
ἀνδρὸς ἀκοντίσσαντος· ὃ δ’οὐχ ἅλιον βέλος ἧκεν,	-u u---u u - uu- uu --	dactylic hexameter	feminine penthemimeral, hepthemimeral
ἀλλ’ υἱὸν Πριάμοιο νόθον βάλε Δημοκόωντα	- -- uu-u u- uu -uu--	dactylic hexameter	feminine penthemimeral, hepthemimeral, trithemimeral
ὅς οἱ Ἀβυδόθεν ἦλθε παρ’ ἵππων ὠκειάων.	- u u-uu -u u -- ----	dactylic hexameter	feminine penthemimeral
Τόν ῥ’Ὀδυσεὺς ἑτάροιο χολωσάμενος βάλε δουρὶ	- uu- uu-u u-uu- uu --	dactylic hexameter	feminine penthemimeral, trithemimeral
κόρσην· ἣ δ’ἑτέροιο διὰ κροτάφοιο πέρησεν	-- - uu-u u- uu-u u--	dactylic hexameter	feminine penthemimeral, hepthemimeral, trithemimeral
αἰχμὴ χαλκείη· τὸν δὲ σκότος ὄσσε κάλυψε,	-- --- - - uu -u u--	dactylic hexameter	masculine penthemimeral, hepthemimeral
δούπησεν δὲ πεσών, ἀράβησε δὲ τεύχε’ ἐπ’ αὐτῷ.	--- u u- uu-u u -u u --	dactylic hexameter	masculine penthemimeral, trithemimeral
Χώρησαν δ’ὑπό τε πρόμαχοι καὶ φαίδιμος Ἕκτωρ·	--- uu - uu- - -uu --	dactylic hexameter	masculine penthemimeral, hepthemimeral, trithemimeral
Ἀργεῖοι δὲ μέγα ἴαχον, ἐρύσαντο δὲ νεκρούς,	--- u u- uu- uu-u u --	dactylic hexameter	masculine penthemimeral, hepthemimeral, trithemimeral
ἴθυσαν δὲ πολὺ προτέρω· νεμέσησε δ’Ἀπόλλων	--- u u- uu- uu-u u--	dactylic hexameter	masculine penthemimeral, hepthemimeral, trithemimeral
Περγάμου ἐκκατιδών, Τρώεσσι δὲ κέκλετ’ ἀΰσας·	-uu -uu- --u u -u u--	dactylic hexameter	masculine penthemimeral
ὄρνυσθ’ ἱππόδαμοι Τρῶες μηδ’ εἴκετε χάρμης	-- -uu- -- - -uu --	dactylic hexameter	masculine penthemimeral, hepthemimeral
Ἀργείοις, ἐπεὶ οὔ σφι λίθος χρὼς οὐδὲ σίδηρος	--- uu - u u- - -u u--	dactylic hexameter	masculine penthemimeral, hepthemimeral, trithemimeral
χαλκὸν ἀνασχέσθαι ταμεσίχροα βαλλομένοισιν·	-u u--- uu-uu -uu--	dactylic hexameter	masculine penthemimeral
οὐ μὰν οὐδ’ Ἀχιλεὺς Θέτιδος πάϊς ἠϋκόμοιο	- - - uu- uu- uu -uu--	dactylic hexameter	masculine penthemimeral, hepthemimeral, trithemimeral
μάρναται, ἀλλ’ ἐπὶ νηυσὶ χόλον θυμαλγέα πέσσει.	-uu - uu -u u- --uu --	dactylic hexameter	feminine penthemimeral, hepthemimeral, trithemimeral
Ὣς φάτ’ ἀπὸ πτόλιος δεινὸς θεός· αὐτὰρ Ἀχαιοὺς	- u u- uu- -- uu -u u--	dactylic hexameter	masculine penthemimeral, hepthemimeral, trithemimeral
ὦρσε Διὸς θυγάτηρ κυδίστη Τριτογένεια	-u u- uu- --- -uu--	dactylic hexameter	masculine penthemimeral, trithemimeral
ἐρχομένη καθ’ ὅμιλον, ὅθι μεθιέντας ἴδοιτο.	-uu- u u-u u- uu-u u--	dactylic hexameter	feminine penthemimeral, hepthemimeral, trithemimeral
Ἔνθ’ Ἀμαρυγκείδην Διώρεα μοῖρα πέδησε·	- uu--- --uu -u u--	dactylic hexameter	masculine penthemimeral
χερμαδίῳ γὰρ βλῆτο παρὰ σφυρὸν ὀκριόεντι	-uu- - -u u- uu -uu--	dactylic hexameter	feminine penthemimeral, hepthemimeral, trithemimeral
κνήμην δεξιτερήν· βάλε δὲ Θρῃκῶν ἀγὸς ἀνδρῶν	-- -uu- uu - -- uu --	dactylic hexameter	masculine penthemimeral, hepthemimeral
Πείρως Ἰμβρασίδης ὃς ἄρ’ Αἰνόθεν εἰληλούθει.	-- -uu- u u -uu ----	dactylic hexameter	masculine penthemimeral
Ἀμφοτέρω δὲ τένοντε καὶ ὀστέα λᾶας ἀναιδὴς	-uu- u u-u u -uu -u u--	dactylic hexameter	feminine penthemimeral, trithemimeral
ἄχρις ἀπηλοίησεν· ὃ δ’ὕπτιος ἐν κονίῃσι	-u u---u u -uu - uu--	dactylic hexameter	feminine penthemimeral
κάππεσεν ἄμφω χεῖρε φίλοις ἑτάροισι πετάσσας	-uu -- -u u- uu-u u--	dactylic hexameter	feminine penthemimeral, hepthemimeral
θυμὸν ἀποπνείων· ὃ δ’ἐπέδραμεν ὅς ῥ’ἔβαλέν περ	-u u--- u u-uu - uu- -	dactylic hexameter	masculine penthemimeral
Πείροος, οὖτα δὲ δουρὶ παρ’ ὀμφαλόν· ἐκ δ’ἄρα πᾶσαι	-uu -u u -u u -uu - uu --	dactylic hexameter	feminine penthemimeral
χύντο χαμαὶ χολάδες, τὸν δὲ σκότος ὄσσε κάλυψε.	-u u- uu- - - uu -u u--	dactylic hexameter	masculine penthemimeral, hepthemimeral, trithemimeral
Τὸν δὲ Θόας Αἰτωλὸς ἀπεσσύμενον βάλε δουρὶ	- u u- --u u-uu- uu --	dactylic hexameter	feminine penthemimeral, trithemimeral
στέρνον ὑπὲρ μαζοῖο, πάγη δ’ἐν πνεύμονι χαλκός·	-u u- --u u- - -uu --	dactylic hexameter	feminine penthemimeral, hepthemimeral, trithemimeral
ἀγχίμολον δέ οἱ ἦλθε Θόας, ἐκ δ’ὄβριμον ἔγχος	-uu- u u -u u- - -uu --	dactylic hexameter	feminine penthemimeral, hepthemimeral, trithemimeral
ἐσπάσατο στέρνοιο, ἐρύσσατο δὲ ξίφος ὀξύ,	-uu- --u u-uu - uu --	dactylic hexameter	feminine penthemimeral, trithemimeral
τῷ ὅ γε γαστέρα τύψε μέσην, ἐκ δ’αἴνυτο θυμόν.	- u u -uu -u u- - -uu --	dactylic hexameter	feminine penthemimeral, hepthemimeral
Τεύχεα δ’οὐκ ἀπέδυσε· περίστησαν γὰρ ἑταῖροι	-uu - uu-u u--- u u--	dactylic hexameter	feminine penthemimeral, trithemimeral
Θρήϊκες ἀκρόκομοι δολίχ’ ἔγχεα χερσὶν ἔχοντες,	-uu -uu- uu -uu -u u--	dactylic hexameter	masculine penthemimeral
οἵ ἑ μέγαν περ ἐόντα καὶ ἴφθιμον καὶ ἀγαυὸν	- u u- u u-u u --- u u--	dactylic hexameter	feminine penthemimeral, trithemimeral
ὦσαν ἀπὸ σφείων· ὃ δὲ χασσάμενος πελεμίχθη.	-u u- -- u u -uu- uu--	dactylic hexameter	masculine penthemimeral, trithemimeral
Ὣς τώ γ’ἐν κονίῃσι παρ’ ἀλλήλοισι τετάσθην,	- - - uu-u u ---u u--	dactylic hexameter	feminine penthemimeral, trithemimeral
ἤτοι ὃ μὲν Θρῃκῶν, ὃ δ’Ἐπειῶν χαλκοχιτώνων	-u u - -- u u-- -uu--	dactylic hexameter	masculine penthemimeral, trithemimeral
ἡγεμόνες· πολλοὶ δὲ περὶ κτείνοντο καὶ ἄλλοι.	-uu- -- u u- --u u --	dactylic hexameter	masculine penthemimeral, hepthemimeral, trithemimeral
Ἔνθά κεν οὐκέτι ἔργον ἀνὴρ ὀνόσαιτο μετελθών,	-u u -uu -u u- uu-u u--	dactylic hexameter	feminine penthemimeral, hepthemimeral
ὅς τις ἔτ’ ἄβλητος καὶ ἀνούτατος ὀξέϊ χαλκῷ	- u u --- u u-uu -uu --	dactylic hexameter	masculine penthemimeral
δινεύοι κατὰ μέσσον, ἄγοι δέ ἑ Παλλὰς Ἀθήνη	--- uu -u u- u u -u u--	dactylic hexameter	feminine penthemimeral, hepthemimeral, trithemimeral
χειρὸς ἑλοῦσ’, αὐτὰρ βελέων ἀπερύκοι ἐρωήν·	-u u- -- uu- uu-u u--	dactylic hexameter	masculine penthemimeral, hepthemimeral, trithemimeral
πολλοὶ γὰρ Τρώων καὶ Ἀχαιῶν ἤματι κείνῳ	-- - -- u u-- -uu --	dactylic hexameter	masculine penthemimeral, trithemimeral
πρηνέες ἐν κονίῃσι παρ’ ἀλλήλοισι τέταντο.	-uu - uu-u u ---u u--	dactylic hexameter	feminine penthemimeral, trithemimeral
