ἀλλ’ ὅτε δὴ πόρον ἷξον ἐϋρρεῖος ποταμοῖο	- uu - uu -u u--- uu--	dactylic hexameter	feminine penthemimeral, trithemimeral
Ξάνθου δινήεντος, ὃν ἀθάνατος τέκετο Ζεύς,	-- ---u u -uu- uu- -	dactylic hexameter	feminine penthemimeral
ἔνθα διατμήξας τοὺς μὲν πεδίον δὲ δίωκε	-u u--- - - uu- u u--	dactylic hexameter	masculine penthemimeral, hepthemimeral
πρὸς πόλιν, ᾗ περ Ἀχαιοὶ ἀτυζόμενοι φοβέοντο	- uu - u u-u u-uu- uu--	dactylic hexameter	feminine penthemimeral, trithemimeral
ἤματι τῷ προτέρῳ, ὅτε μαίνετο φαίδιμος Ἕκτωρ·	-uu - uu- uu -uu -uu --	dactylic hexameter	masculine penthemimeral, trithemimeral
τῇ ῥ’οἵ γε προχέοντο πεφυζότες, ἠέρα δ’Ἥρη	- - - uu-u u-uu -uu --	dactylic hexameter	feminine penthemimeral, trithemimeral
πίτνα πρόσθε βαθεῖαν ἐρυκέμεν· ἡμίσεες δὲ	-- -u u-u u-uu -uu- -	dactylic hexameter	feminine penthemimeral
ἐς ποταμὸν εἰλεῦντο βαθύρροον ἀργυροδίνην,	- uu- --u u-uu -uu--	dactylic hexameter	feminine penthemimeral, trithemimeral
ἐν δ’ἔπεσον μεγάλῳ πατάγῳ, βράχε δ’αἰπὰ ῥέεθρα,	- uu- uu- uu- uu -u u--	dactylic hexameter	masculine penthemimeral, hepthemimeral, trithemimeral
ὄχθαι δ’ἀμφὶ περὶ μεγάλ’ ἴαχον· οἳ δ’ἀλαλητῷ	-- -u u- uu -uu - uu--	dactylic hexameter	masculine penthemimeral
ἔννεον ἔνθα καὶ ἔνθα ἑλισσόμενοι περὶ δίνας.	-uu -u u -u u-uu- uu --	dactylic hexameter	feminine penthemimeral
ὡς δ’ὅθ’ ὑπὸ ῥιπῆς πυρὸς ἀκρίδες ἠερέθονται	- u u- -- uu -uu -uu--	dactylic hexameter	masculine penthemimeral, trithemimeral
φευγέμεναι ποταμὸν δέ· τὸ δὲ φλέγει ἀκάματον πῦρ	-uu- uu- u u - uu -uu- -	dactylic hexameter	masculine penthemimeral, hepthemimeral, trithemimeral
ὄρμενον ἐξαίφνης, ταὶ δὲ πτώσσουσι καθ’ ὕδωρ·	-uu --- - - --u u --	dactylic hexameter	masculine penthemimeral, hepthemimeral
ὣς ὑπ’ Ἀχιλλῆος Ξάνθου βαθυδινήεντος	- u u--- -- uu----	dactylic hexameter	masculine penthemimeral, hepthemimeral
πλῆτο ῥόος κελάδων ἐπιμὶξ ἵππων τε καὶ ἀνδρῶν.	-u u- uu- uu- -- u u --	dactylic hexameter	masculine penthemimeral, hepthemimeral, trithemimeral
αὐτὰρ ὃ διογενὴς δόρυ μὲν λίπεν αὐτοῦ ἐπ’ ὄχθῃ	-u u -uu- uu - uu -u u --	dactylic hexameter	masculine penthemimeral, hepthemimeral
κεκλιμένον μυρίκῃσιν, ὃ δ’ἔσθορε δαίμονι ἶσος	-uu- uu-u u -uu -uu --	dactylic hexameter	feminine penthemimeral, trithemimeral
φάσγανον οἶον ἔχων, κακὰ δὲ φρεσὶ μήδετο ἔργα,	-uu -u u- uu - uu -uu --	dactylic hexameter	masculine penthemimeral, hepthemimeral
τύπτε δ’ἐπιστροφάδην· τῶν δὲ στόνος ὄρνυτ’ ἀεικὴς	-u u-uu- - - uu -u u--	dactylic hexameter	masculine penthemimeral, hepthemimeral
ἄορι θεινομένων, ἐρυθαίνετο δ’αἵματι ὕδωρ.	-uu -uu- uu-uu -uu --	dactylic hexameter	masculine penthemimeral
ὡς δ’ὑπὸ δελφῖνος μεγακήτεος ἰχθύες ἄλλοι	- uu --- uu-uu -uu --	dactylic hexameter	masculine penthemimeral
φεύγοντες πιμπλᾶσι μυχοὺς λιμένος εὐόρμου	--- --u u- uu- ---	dactylic hexameter	feminine penthemimeral, hepthemimeral, trithemimeral
δειδιότες· μάλα γάρ τε κατεσθίει ὅν κε λάβῃσιν·	-uu- uu - u u-uu - u u--	dactylic hexameter	masculine penthemimeral, trithemimeral
ὣς Τρῶες ποταμοῖο κατὰ δεινοῖο ῥέεθρα	- -- uu-u u- --u u--	dactylic hexameter	feminine penthemimeral, hepthemimeral, trithemimeral
πτῶσσον ὑπὸ κρημνούς. ὃ δ’ἐπεὶ κάμε χεῖρας ἐναίρων,	-u u- -- u u- uu -u u--	dactylic hexameter	masculine penthemimeral, hepthemimeral, trithemimeral
ζωοὺς ἐκ ποταμοῖο δυώδεκα λέξατο κούρους	-- - uu-u u-uu -uu --	dactylic hexameter	feminine penthemimeral, trithemimeral
ποινὴν Πατρόκλοιο Μενοιτιάδαο θανόντος·	-- ---u u-uu-u u--	dactylic hexameter	feminine penthemimeral
τοὺς ἐξῆγε θύραζε τεθηπότας ἠΰτε νεβρούς,	- --u u-u u-uu -uu --	dactylic hexameter	feminine penthemimeral
δῆσε δ’ὀπίσσω χεῖρας ἐϋτμήτοισιν ἱμᾶσι,	-u u-- -u u---u u--	dactylic hexameter	feminine penthemimeral
τοὺς αὐτοὶ φορέεσκον ἐπὶ στρεπτοῖσι χιτῶσι,	- -- uu-u u- --u u--	dactylic hexameter	feminine penthemimeral, hepthemimeral, trithemimeral
δῶκε δ’ἑταίροισιν κατάγειν κοίλας ἐπὶ νῆας.	-u u--- uu- -- uu --	dactylic hexameter	masculine penthemimeral, hepthemimeral
αὐτὰρ ὃ ἂψ ἐπόρουσε δαϊζέμεναι μενεαίνων.	-u u - uu-u u-uu- uu--	dactylic hexameter	feminine penthemimeral, trithemimeral
ἔνθ’ υἷι Πριάμοιο συνήντετο Δαρδανίδαο	- -- uu-u u-uu -uu--	dactylic hexameter	feminine penthemimeral, trithemimeral
ἐκ ποταμοῦ φεύγοντι Λυκάονι, τόν ῥά ποτ’ αὐτὸς	- uu- --u u-uu - u u --	dactylic hexameter	feminine penthemimeral, trithemimeral
ἦγε λαβὼν ἐκ πατρὸς ἀλωῆς οὐκ ἐθέλοντα	-u u- - -u u-- - uu--	dactylic hexameter	feminine penthemimeral, trithemimeral
ἐννύχιος προμολών· ὃ δ’ἐρινεὸν ὀξέϊ χαλκῷ	-uu- uu- u u-uu -uu --	dactylic hexameter	masculine penthemimeral, trithemimeral
τάμνε νέους ὄρπηκας, ἵν’ ἅρματος ἄντυγες εἶεν·	-u u- --u u -uu -uu --	dactylic hexameter	feminine penthemimeral, trithemimeral
τῷ δ’ἄρ’ ἀνώϊστον κακὸν ἤλυθε δῖος Ἀχιλλεύς.	- u u--- uu -uu -u u--	dactylic hexameter	masculine penthemimeral
καὶ τότε μέν μιν Λῆμνον ἐϋκτιμένην ἐπέρασσε	- uu - - -u u-uu- uu--	dactylic hexameter	feminine penthemimeral, trithemimeral
νηυσὶν ἄγων, ἀτὰρ υἱὸς Ἰήσονος ὦνον ἔδωκε·	-u u- uu -u u-uu -u u--	dactylic hexameter	feminine penthemimeral, trithemimeral
κεῖθεν δὲ ξεῖνός μιν ἐλύσατο πολλὰ δ’ἔδωκεν	-- - -- u u-uu -u u--	dactylic hexameter	masculine penthemimeral, trithemimeral
Ἴμβριος Ἠετίων, πέμψεν δ’ἐς δῖαν Ἀρίσβην·	-uu -uu- -- - -u u--	dactylic hexameter	masculine penthemimeral, hepthemimeral
ἔνθεν ὑπεκπροφυγὼν πατρώϊον ἵκετο δῶμα.	-u u-uu- --uu -uu --	dactylic hexameter	masculine penthemimeral
ἕνδεκα δ’ἤματα θυμὸν ἐτέρπετο οἷσι φίλοισιν	-uu -uu -u u-uu -u u--	dactylic hexameter	feminine penthemimeral
ἐλθὼν ἐκ Λήμνοιο· δυωδεκάτῃ δέ μιν αὖτις	-- - --u u-uu- u u --	dactylic hexameter	feminine penthemimeral, trithemimeral
χερσὶν Ἀχιλλῆος θεὸς ἔμβαλεν, ὅς μιν ἔμελλε	-u u--- uu -uu - u u--	dactylic hexameter	masculine penthemimeral
πέμψειν εἰς Ἀΐδαο καὶ οὐκ ἐθέλοντα νέεσθαι.	-- - uu-u u - uu-u u--	dactylic hexameter	feminine penthemimeral, hepthemimeral, trithemimeral
τὸν δ’ὡς οὖν ἐνόησε ποδάρκης δῖος Ἀχιλλεὺς	- - - uu-u u-- -u u--	dactylic hexameter	feminine penthemimeral, trithemimeral
γυμνὸν ἄτερ κόρυθός τε καὶ ἀσπίδος, οὐδ’ ἔχεν ἔγχος,	-u u- uu- u u -uu - uu --	dactylic hexameter	masculine penthemimeral, trithemimeral
ἀλλὰ τὰ μέν ῥ’ἀπὸ πάντα χαμαὶ βάλε· τεῖρε γὰρ ἱδρὼς	-u u - uu -u u- uu -u u --	dactylic hexameter	feminine penthemimeral, hepthemimeral, trithemimeral
φεύγοντ’ ἐκ ποταμοῦ, κάματος δ’ὑπὸ γούνατ’ ἐδάμνα·	-- - uu- uu- uu -u u--	dactylic hexameter	masculine penthemimeral, hepthemimeral, trithemimeral
ὀχθήσας δ’ἄρα εἶπε πρὸς ὃν μεγαλήτορα θυμόν·	--- uu -u u - uu-uu --	dactylic hexameter	feminine penthemimeral, hepthemimeral, trithemimeral
ὢ πόποι ἦ μέγα θαῦμα τόδ’ ὀφθαλμοῖσιν ὁρῶμαι·	- uu - uu -u u ---u u--	dactylic hexameter	feminine penthemimeral, trithemimeral
ἦ μάλα δὴ Τρῶες μεγαλήτορες οὕς περ ἔπεφνον	- uu - -- uu-uu - u u--	dactylic hexameter	masculine penthemimeral, trithemimeral
αὖτις ἀναστήσονται ὑπὸ ζόφου ἠερόεντος,	-u u---u u- uu -uu--	dactylic hexameter	feminine penthemimeral, hepthemimeral
οἷον δὴ καὶ ὅδ’ ἦλθε φυγὼν ὕπο νηλεὲς ἦμαρ	-- - u u -u u- uu -uu --	dactylic hexameter	feminine penthemimeral, hepthemimeral, trithemimeral
Λῆμνον ἐς ἠγαθέην πεπερημένος· οὐδέ μιν ἔσχε	-u u -uu- uu-uu -u u --	dactylic hexameter	masculine penthemimeral
πόντος ἁλὸς πολιῆς, ὃ πολέας ἀέκοντας ἐρύκει.	-u u- uu- u u- uu-u u--	dactylic hexameter	masculine penthemimeral, hepthemimeral, trithemimeral
ἀλλ’ ἄγε δὴ καὶ δουρὸς ἀκωκῆς ἡμετέροιο	- uu - - -u u-- -uu--	dactylic hexameter	feminine penthemimeral, trithemimeral
γεύσεται, ὄφρα ἴδωμαι ἐνὶ φρεσὶν ἠδὲ δαείω	-uu -u u-u u- uu -u u--	dactylic hexameter	feminine penthemimeral, hepthemimeral
ἢ ἄρ’ ὁμῶς καὶ κεῖθεν ἐλεύσεται, ἦ μιν ἐρύξει	- u u- - -u u-uu - u u--	dactylic hexameter	feminine penthemimeral, trithemimeral
γῆ φυσίζοος, ἥ τε κατὰ κρατερόν περ ἐρύκει.	- --uu - u u- uu- u u--	dactylic hexameter	masculine penthemimeral, hepthemimeral
ὣς ὅρμαινε μένων· ὃ δέ οἱ σχεδὸν ἦλθε τεθηπὼς	- --u u- u u - uu -u u--	dactylic hexameter	masculine penthemimeral, hepthemimeral
γούνων ἅψασθαι μεμαώς, περὶ δ’ἤθελε θυμῷ	-- --- uu- uu -uu --	dactylic hexameter	masculine penthemimeral, hepthemimeral
ἐκφυγέειν θάνατόν τε κακὸν καὶ κῆρα μέλαιναν.	-uu- uu- u u- - -u u--	dactylic hexameter	masculine penthemimeral, hepthemimeral, trithemimeral
ἤτοι ὃ μὲν δόρυ μακρὸν ἀνέσχετο nbsp;δῖος Ἀχιλλεὺς	-u u - uu -u u-uu -u u--	dactylic hexameter	feminine penthemimeral, trithemimeral
οὐτάμεναι μεμαώς, ὃ δ’ὑπέδραμε καὶ λάβε γούνων	-uu- uu- u u-uu - uu --	dactylic hexameter	masculine penthemimeral, trithemimeral
κύψας· ἐγχείη δ’ἄρ’ ὑπὲρ νώτου ἐνὶ γαίῃ	-- --- u u- -- uu --	dactylic hexameter	masculine penthemimeral, hepthemimeral
ἔστη ἱεμένη χροὸς ἄμεναι ἀνδρομέοιο.	-- -uu- uu -uu -uu--	dactylic hexameter	masculine penthemimeral
αὐτὰρ ὃ τῇ ἑτέρῃ μὲν ἑλὼν ἐλλίσσετο γούνων,	-u u - uu- u u- --uu --	dactylic hexameter	masculine penthemimeral, hepthemimeral, trithemimeral
τῇ δ’ἑτέρῃ ἔχεν ἔγχος ἀκαχμένον οὐδὲ μεθίει·	- uu- uu -u u-uu -u u--	dactylic hexameter	feminine penthemimeral, trithemimeral
καί μιν φωνήσας ἔπεα πτερόεντα προσηύδα·	- - --- uu- uu-u u--	dactylic hexameter	masculine penthemimeral, hepthemimeral
γουνοῦμαι σ’Ἀχιλεῦ· σὺ δέ μ’αἴδεο καί μ’ἐλέησον·	--- uu- u u -uu - uu--	dactylic hexameter	masculine penthemimeral, trithemimeral
ἀντί τοί εἰμ’ ἱκέταο διοτρεφὲς αἰδοίοιο·	-u u - uu-u u-uu ----	dactylic hexameter	feminine penthemimeral, trithemimeral
πὰρ γὰρ σοὶ πρώτῳ πασάμην Δημήτερος ἀκτὴν	- - - -- uu- --uu --	dactylic hexameter	masculine penthemimeral, hepthemimeral, trithemimeral
ἤματι τῷ ὅτε μ’εἷλες ἐϋκτιμένῃ ἐν ἀλωῇ,	-uu - uu -u u-uu- u u--	dactylic hexameter	feminine penthemimeral, trithemimeral
καί μ’ἐπέρασσας ἄνευθεν ἄγων πατρός τε φίλων τε	- uu-u u-u u- -- u u- -	dactylic hexameter	feminine penthemimeral, hepthemimeral
Λῆμνον ἐς ἠγαθέην, ἑκατόμβοιον δέ τοι ἦλφον.	-u u -uu- uu--- u u --	dactylic hexameter	masculine penthemimeral
νῦν δὲ λύμην τρὶς τόσσα πορών· ἠὼς δέ μοί ἐστιν	- u u- - -u u- -- u u --	dactylic hexameter	feminine penthemimeral, hepthemimeral, trithemimeral
ἥδε δυωδεκάτη, ὅτ’ ἐς Ἴλιον εἰλήλουθα	-u u-uu- u u -uu ----	dactylic hexameter	masculine penthemimeral
πολλὰ παθών· νῦν αὖ με τεῇς ἐν χερσὶν ἔθηκε	-u u- - - u u- - -u u--	dactylic hexameter	masculine penthemimeral, hepthemimeral, trithemimeral
μοῖρ’ ὀλοή· μέλλω που ἀπεχθέσθαι Διὶ πατρί,	- uu- -- u u--- uu --	dactylic hexameter	masculine penthemimeral, trithemimeral
ὅς με σοὶ αὖτις δῶκε· μινυνθάδιον δέ με μήτηρ	- u u -- -u u-uu- u u --	dactylic hexameter	feminine penthemimeral
γείνατο Λαοθόη θυγάτηρ Ἄλταο γέροντος	-uu -uu- uu- --u u--	dactylic hexameter	masculine penthemimeral, hepthemimeral
Ἄλτεω, ὃς Λελέγεσσι φιλοπτολέμοισιν ἀνάσσει	-uu - uu-u u-uu-u u--	dactylic hexameter	feminine penthemimeral, trithemimeral
Πήδασον αἰπήεσσαν ἔχων ἐπὶ Σατνιόεντι.	-uu ---u u- uu -uu--	dactylic hexameter	feminine penthemimeral, hepthemimeral
τοῦ δ’ἔχε θυγατέρα Πρίαμος, πολλὰς δὲ καὶ ἄλλας·	- uu -uu- uu- -- u u --	dactylic hexameter	masculine penthemimeral, hepthemimeral
τῆς δὲ δύω γενόμεσθα, σὺ δ’ἄμφω δειροτομήσεις,	- u u- uu-u u -- -uu--	dactylic hexameter	feminine penthemimeral, trithemimeral
ἤτοι τὸν πρώτοισι μετὰ πρυλέεσσι δάμασσας	-- - --u u- uu-u u--	dactylic hexameter	feminine penthemimeral, hepthemimeral, trithemimeral
ἀντίθεον Πολύδωρον, ἐπεὶ βάλες ὀξέϊ δουρί·	-uu- uu-u u- uu -uu --	dactylic hexameter	feminine penthemimeral, hepthemimeral, trithemimeral
νῦν δὲ δὴ ἐνθάδ’ ἐμοὶ κακὸν ἔσσεται· οὐ γὰρ ὀΐω	- u u -u u- uu -uu - u u--	dactylic hexameter	masculine penthemimeral
σὰς χεῖρας φεύξεσθαι, ἐπεί ῥ’ἐπέλασσέ γε δαίμων.	- -- --u u- uu-u u --	dactylic hexameter	feminine penthemimeral, hepthemimeral, trithemimeral
ἄλλο δέ τοι ἐρέω, σὺ δ’ἐνὶ φρεσὶ βάλλεο σῇσι·	-u u - uu- u u- uu -uu --	dactylic hexameter	masculine penthemimeral, hepthemimeral, trithemimeral
μή με κτεῖν’, ἐπεὶ οὐχ ὁμογάστριος Ἕκτορός εἰμι,	- - - uu - uu-uu -uu --	dactylic hexameter	masculine penthemimeral, trithemimeral
ὅς τοι ἑταῖρον ἔπεφνεν ἐνηέα τε κρατερόν τε.	- u u-u u-u u-uu - uu- -	dactylic hexameter	feminine penthemimeral
ὣς ἄρα μιν Πριάμοιο προσηύδα φαίδιμος υἱὸς	- uu - uu-u u-- -uu --	dactylic hexameter	feminine penthemimeral, trithemimeral
λισσόμενος ἐπέεσσιν, ἀμείλικτον δ’ὄπ’ ἄκουσε·	-uu- uu-u u--- u u--	dactylic hexameter	feminine penthemimeral, trithemimeral
νήπιε μή μοι ἄποινα πιφαύσκεο μηδ’ ἀγόρευε·	-uu - u u-u u-uu - uu--	dactylic hexameter	feminine penthemimeral, trithemimeral
πρὶν μὲν γὰρ Πάτροκλον ἐπισπεῖν αἴσιμον ἦμαρ	- - - --u u-- -uu --	dactylic hexameter	feminine penthemimeral, trithemimeral
τόφρά τί μοι πεφιδέσθαι ἐνὶ φρεσὶ φίλτερον ἦεν	-u u - uu-u u- uu -uu --	dactylic hexameter	feminine penthemimeral, hepthemimeral, trithemimeral
Τρώων, καὶ πολλοὺς ζωοὺς ἕλον ἠδ’ ἐπέρασσα·	-- - -- -- uu - uu--	dactylic hexameter	masculine penthemimeral, hepthemimeral, trithemimeral
νῦν δ’οὐκ ἔσθ’ ὅς τις θάνατον φύγῃ ὅν κε θεός γε	- - - - - uu- uu - u u- -	dactylic hexameter	masculine penthemimeral, hepthemimeral, trithemimeral
Ἰλίου προπάροιθεν ἐμῇς ἐν χερσὶ βάλῃσι	--- uu-u u- - -u u--	dactylic hexameter	feminine penthemimeral, hepthemimeral, trithemimeral
καὶ πάντων Τρώων, περὶ δ’αὖ Πριάμοιό γε παίδων.	- -- -- uu - uu-u u --	dactylic hexameter	masculine penthemimeral, hepthemimeral, trithemimeral
ἀλλὰ φίλος θάνε καὶ σύ· τί ἦ ὀλοφύρεαι οὕτως;	-u u- uu - u u - uu-uu --	dactylic hexameter	masculine penthemimeral, hepthemimeral, trithemimeral
κάτθανε καὶ Πάτροκλος, ὅ περ σέο πολλὸν ἀμείνων.	-uu - --u u - uu -u u--	dactylic hexameter	feminine penthemimeral, hepthemimeral, trithemimeral
οὐχ ὁράᾳς οἷος καὶ ἐγὼ καλός τε μέγας τε;	- uu- -- u u- -- u u- -	dactylic hexameter	masculine penthemimeral, hepthemimeral, trithemimeral
πατρὸς δ’εἴμ’ ἀγαθοῖο, θεὰ δέ με γείνατο μήτηρ·	-- - uu-u u- u u -uu --	dactylic hexameter	feminine penthemimeral, hepthemimeral, trithemimeral
ἀλλ’ ἔπι τοι καὶ ἐμοὶ θάνατος καὶ μοῖρα κραταιή·	- uu - u u- uu- - -u u--	dactylic hexameter	masculine penthemimeral, hepthemimeral, trithemimeral
ἔσσεται ἢ ἠὼς ἢ δείλη ἢ μέσον ἦμαρ	-uu - -- - -- - uu --	dactylic hexameter	masculine penthemimeral, trithemimeral
ὁππότε τις καὶ ἐμεῖο Ἄρῃ ἐκ θυμὸν ἕληται	-uu - u u-u u- - -u u--	dactylic hexameter	feminine penthemimeral, hepthemimeral, trithemimeral
ἢ ὅ γε δουρὶ βαλὼν ἢ ἀ πὸ νευρῆφιν ὀϊστῷ.	- u u -u u- - - --u u--	dactylic hexameter	masculine penthemimeral, hepthemimeral
ὣς φάτο, τοῦ δ’αὐτοῦ λύτο γούνατα καὶ φίλον ἦτορ·	- uu - -- uu -uu - uu --	dactylic hexameter	masculine penthemimeral, trithemimeral
ἔγχος μέν ῥ’ἀφέηκεν, ὃ δ’ἕζετο χεῖρε πετάσσας	-- - uu-u u -uu -u u--	dactylic hexameter	feminine penthemimeral, trithemimeral
ἀμφοτέρας· Ἀχιλεὺς δὲ ἐρυσσάμενος ξίφος ὀξὺ	-uu- uu- u u-uu- uu --	dactylic hexameter	masculine penthemimeral, trithemimeral
τύψε κατὰ κληῖδα παρ’ αὐχένα, πᾶν δέ οἱ εἴσω	-u u- --u u -uu - u u --	dactylic hexameter	feminine penthemimeral, trithemimeral
δῦ ξίφος ἄμφηκες· ὃ δ’ἄρα πρηνὴς ἐπὶ γαίῃ	- uu --- u u- -- uu --	dactylic hexameter	masculine penthemimeral, hepthemimeral
κεῖτο ταθείς, ἐκ δ’αἷμα μέλαν ῥέε, δεῦε δὲ γαῖαν.	-u u- - -u u- uu -u u --	dactylic hexameter	feminine penthemimeral, hepthemimeral, trithemimeral
τὸν δ’Ἀχιλεὺς ποταμὸν δὲ λαβὼν ποδὸς ἧκε φέρεσθαι,	- uu- uu- u u- uu -u u--	dactylic hexameter	masculine penthemimeral, hepthemimeral, trithemimeral
καί οἱ ἐπευχόμενος ἔπεα πτερόεντ’ ἀγόρευεν·	- u u-uu- uu- uu- uu--	dactylic hexameter	masculine penthemimeral, hepthemimeral
ἐνταυθοῖ νῦν κεῖσο μετ’ ἰχθύσιν, οἵ σ’ὠτειλὴν	--- - -u u -uu - ---	dactylic hexameter	feminine penthemimeral, trithemimeral
αἷμ’ ἀπολιχμήσονται ἀκηδέες· οὐδέ σε μήτηρ	- uu---u u-uu -u u --	dactylic hexameter	feminine penthemimeral
ἐνθεμένη λεχέεσσι γοήσεται, ἀλλὰ Σκάμανδρος	-uu- uu-u u-uu -u u--	dactylic hexameter	feminine penthemimeral, trithemimeral
οἴσει δινήεις εἴσω ἁλὸς εὐρέα κόλπον·	-- --- -- uu -uu --	dactylic hexameter	masculine penthemimeral, hepthemimeral
θρῴσκων τις κατὰ κῦμα μέλαιναν φρῖχ’ ὑπαΐξει	-- - uu -u u-- - uu--	dactylic hexameter	feminine penthemimeral, trithemimeral
ἰχθύς, ὅς κε φάγῃσι Λυκάονος ἀργέτα δημόν.	-- - u u-u u-uu -uu --	dactylic hexameter	feminine penthemimeral, trithemimeral
φθείρεσθ’ εἰς ὅ κεν ἄστυ κιχείομεν Ἰλίου ἱρῆς	-- - u u -u u-uu -uu --	dactylic hexameter	feminine penthemimeral, trithemimeral
ὑμεῖς μὲν φεύγοντες, ἐγὼ δ’ὄπιθεν κεραΐζων.	-- - --u u- uu- uu--	dactylic hexameter	feminine penthemimeral, hepthemimeral, trithemimeral
οὐδ’ ὑμῖν ποταμός περ ἐΰρροος ἀργυροδίνης	- -- uu- u u-uu -uu--	dactylic hexameter	masculine penthemimeral, trithemimeral
ἀρκέσει, ᾧ δὴ δηθὰ πολέας ἱερεύετε ταύρους,	-uu - - -u u- uu-uu --	dactylic hexameter	feminine penthemimeral, hepthemimeral, trithemimeral
ζωοὺς δ’ἐν δίνῃσι καθίετε μώνυχας ἵππους.	-- - --u u-uu -uu --	dactylic hexameter	feminine penthemimeral, trithemimeral
ἀλλὰ καὶ ὧς ὀλέεσθε κακὸν μόρον, εἰς ὅ κε πάντες	-u u - uu-u u- uu - u u --	dactylic hexameter	feminine penthemimeral, hepthemimeral, trithemimeral
τίσετε Πατρόκλοιο φόνον καὶ λοιγὸν Ἀχαιῶν,	-uu ---u u- - -u u--	dactylic hexameter	feminine penthemimeral, hepthemimeral
οὓς ἐπὶ νηυσὶ θοῇσιν ἐπέφνετε νόσφιν ἐμεῖο.	- uu -u u-u u-uu -u u--	dactylic hexameter	feminine penthemimeral
ὣς ἄρ’ ἔφη, ποταμὸς δὲ χολώσατο κηρόθι μᾶλλον,	- u u- uu- u u-uu -uu --	dactylic hexameter	masculine penthemimeral, trithemimeral
ὅρμηνεν δ’ἀνὰ θυμὸν ὅπως παύσειε πόνοιο	--- uu -u u- --u u--	dactylic hexameter	feminine penthemimeral, hepthemimeral, trithemimeral
δῖον Ἀχιλλῆα, Τρώεσσι δὲ λοιγὸν ἀλάλκοι.	-u u--- --u u -u u--	dactylic hexameter	masculine penthemimeral
τόφρα δὲ Πηλέος υἱὸς ἔχων δολιχόσκιον ἔγχος	-u u -uu -u u- uu-uu --	dactylic hexameter	feminine penthemimeral, hepthemimeral
Ἀστεροπαίῳ ἐπᾶλτο κατακτάμεναι μενεαίνων	-uu-u u-u u-uu- uu--	dactylic hexameter	feminine penthemimeral
υἱέϊ Πηλεγόνος· τὸν δ’Ἀξιὸς εὐρυρέεθρος	-uu -uu- - -uu -uu--	dactylic hexameter	masculine penthemimeral
γείνατο καὶ Περίβοια Ἀκεσσαμενοῖο θυγατρῶν	-uu - uu-u u-uu-u u--	dactylic hexameter	feminine penthemimeral, trithemimeral
πρεσβυτάτη· τῇ γάρ ῥα μίγη ποταμὸς βαθυδίνης.	-uu- - - u u- uu- uu--	dactylic hexameter	masculine penthemimeral, hepthemimeral, trithemimeral
τῷ ῥ’Ἀχιλεὺς ἐπόρουσεν, ὃ δ’ἀντίος ἐκ ποταμοῖο	- uu- uu-u u -uu - uu--	dactylic hexameter	feminine penthemimeral, trithemimeral
ἔστη ἔχων δύο δοῦρε· μένος δέ οἱ ἐν φρεσὶ θῆκε	-u u- uu -u u- u u - uu --	dactylic hexameter	feminine penthemimeral, hepthemimeral, trithemimeral
Ξάνθος, ἐπεὶ κεχόλωτο δαϊκταμένων αἰζηῶν,	-u u- uu-u u-uu- ---	dactylic hexameter	feminine penthemimeral, trithemimeral
τοὺς Ἀχιλεὺς ἐδάϊζε κατὰ ῥόον οὐδ’ ἐλέαιρεν.	- uu- uu-u u- uu - uu--	dactylic hexameter	feminine penthemimeral, hepthemimeral, trithemimeral
οἳ δ’ὅτε δὴ σχεδὸν ἦσαν ἐπ’ ἀλλήλοισιν ἰόντες,	- uu - uu -u u ---u u--	dactylic hexameter	feminine penthemimeral, trithemimeral
τὸν πρότερος προσέειπε ποδάρκης δῖος Ἀχιλλεύς·	- uu- uu-u u-- -u u--	dactylic hexameter	feminine penthemimeral, trithemimeral
τίς πόθεν εἰς ἀνδρῶν ὅ μευ ἔτλης ἀντίος ἐλθεῖν;	- uu - -- u u -- -uu --	dactylic hexameter	masculine penthemimeral, trithemimeral
δυστήνων δέ τε παῖδες ἐμῷ μένει ἀντιόωσι.	--- u u -u u- uu -uu--	dactylic hexameter	feminine penthemimeral, hepthemimeral, trithemimeral
τὸν δ’αὖ Πηλεγόνος προσεφώνεε φαίδιμος υἱός·	- - -uu- uu-uu -uu --	dactylic hexameter	masculine penthemimeral
Πηλεΐδη μεγάθυμε τί ἦ γενεὴν ἐρεείνεις;	-uu- uu-u u - uu- uu--	dactylic hexameter	feminine penthemimeral, hepthemimeral, trithemimeral
εἴμ’ ἐκ Παιονίης ἐριβώλου τηλόθ’ ἐούσης	- - -uu- uu-- -u u--	dactylic hexameter	masculine penthemimeral
Παίονας ἄνδρας ἄγων δολιχεγχέας· ἥδε δέ μοι νῦν	-uu -u u- uu-uu -u u - -	dactylic hexameter	masculine penthemimeral
ἠὼς ἑνδεκάτη ὅτε Ἴλιον εἰλήλουθα.	-- -uu- uu -uu ----	dactylic hexameter	masculine penthemimeral
αὐτὰρ ἐμοὶ γενεὴ ἐξ Ἀξιοῦ εὐρὺ ῥέοντος	-u u- uu- - -uu -u u--	dactylic hexameter	masculine penthemimeral, trithemimeral
Ἀξιοῦ, ὃς κάλλιστον ὕδωρ ἐπὶ γαῖαν ἵησιν,	-uu - --u u- uu -u u--	dactylic hexameter	feminine penthemimeral, hepthemimeral, trithemimeral
ὃς τέκε Πηλεγόνα κλυτὸν ἔγχεϊ· τὸν δ’ἐμέ φασι	- uu -uu- uu -uu - uu --	dactylic hexameter	masculine penthemimeral
γείνασθαι· νῦν αὖτε μαχώμεθα φαίδιμ’ Ἀχιλλεῦ.	--- - -u u-uu -u u--	dactylic hexameter	feminine penthemimeral, trithemimeral
ὣς φάτ’ ἀπειλήσας, ὃ δ’ἀνέσχετο δῖος Ἀχιλλεὺς	- u u--- u u-uu -u u--	dactylic hexameter	masculine penthemimeral
Πηλιάδα μελίην· ὃ δ’ἁμαρτῇ δούρασιν ἀμφὶς	-uu- uu- u u-- -uu --	dactylic hexameter	masculine penthemimeral, trithemimeral
ἥρως Ἀστεροπαῖος, ἐπεὶ περιδέξιος ἦεν.	-- -uu-u u- uu-uu --	dactylic hexameter	feminine penthemimeral, hepthemimeral
καί ῥ’ἑτέρῳ μὲν δουρὶ σάκος βάλεν, οὐδὲ διὰ πρὸ	- uu- - -u u- uu -u u- -	dactylic hexameter	feminine penthemimeral, hepthemimeral, trithemimeral
ῥῆξε σάκος· χρυσὸς γὰρ ἐρύκακε δῶρα θεοῖο·	-u u- -- u u-uu -u u--	dactylic hexameter	masculine penthemimeral, trithemimeral
τῷ δ’ἑτέρῳ μιν πῆχυν ἐπιγράβδην βάλε χειρὸς	- uu- - -u u--- uu --	dactylic hexameter	feminine penthemimeral, trithemimeral
δεξιτερῆς, σύτο δ’αἷμα κελαινεφές· ἣ δ’ὑπὲρ αὐτοῦ	-uu- uu -u u-uu - uu --	dactylic hexameter	feminine penthemimeral, trithemimeral
γαίῃ ἐνεστήρικτο λιλαιομένη χροὸς ἆσαι.	-u u---u u-uu- uu --	dactylic hexameter	feminine penthemimeral
δεύτερος αὖτ’ Ἀχιλεὺς μελίην ἰθυπτίωνα	-uu - uu- uu- -----	dactylic hexameter	masculine penthemimeral, hepthemimeral, trithemimeral
Ἀστεροπαίῳ ἐφῆκε κατακτάμεναι μενεαίνων.	-uu-u u-u u-uu- uu--	dactylic hexameter	feminine penthemimeral
καὶ τοῦ μέν ῥ’ἀφάμαρτεν, ὃ δ’ὑψηλὴν βάλεν ὄχθην,	- - - uu-u u --- uu --	dactylic hexameter	feminine penthemimeral, trithemimeral
μεσσοπαγὲς δ’ἄρ’ ἔθηκε κατ’ ὄχθης μείλινον ἔγχος.	-uu- u u-u u -- -uu --	dactylic hexameter	feminine penthemimeral, trithemimeral
Πηλεΐδης δ’ἄορ ὀξὺ ἐρυσσάμενος παρὰ μηροῦ	-uu- uu -u u-uu- uu --	dactylic hexameter	feminine penthemimeral, trithemimeral
ἆλτ’ ἐπί οἱ μεμαώς· ὃ δ’ἄρα μελίην Ἀχιλῆος	- uu - uu- u u- uu- uu--	dactylic hexameter	masculine penthemimeral, hepthemimeral, trithemimeral
οὐ δύνατ’ ἐκ κρημνοῖο ἐρύσσαι χειρὶ παχείῃ.	- uu - --u u-- -u u--	dactylic hexameter	feminine penthemimeral, trithemimeral
τρὶς μέν μιν πελέμιξεν ἐρύσσασθαι μενεαίνων,	- - - uu-u u--- uu--	dactylic hexameter	feminine penthemimeral, trithemimeral
τρὶς δὲ μεθῆκε βίης· τὸ δὲ τέτρατον ἤθελε θυμῷ	- u u-u u- u u -uu -uu --	dactylic hexameter	masculine penthemimeral
ἆξαι ἐπιγνάμψας δόρυ μείλινον Αἰακίδαο,	-u u--- uu -uu -uu--	dactylic hexameter	masculine penthemimeral
ἀλλὰ πρὶν Ἀχιλεὺς σχεδὸν ἄορι θυμὸν ἀπηύρα.	-- - uu- uu -uu -u u--	dactylic hexameter	masculine penthemimeral, trithemimeral
γαστέρα γάρ μιν τύψε παρ’ ὀμφαλόν, ἐκ δ’ἄρα πᾶσαι	-uu - - -u u -uu - uu --	dactylic hexameter	feminine penthemimeral, trithemimeral
χύντο χαμαὶ χολάδες· τὸν δὲ σκότος ὄσσε κάλυψεν	-u u- uu- - - uu -u u--	dactylic hexameter	masculine penthemimeral, hepthemimeral, trithemimeral
ἀσθμαίνοντ’· Ἀχιλεὺς δ’ἄρ’ ἐνὶ στήθεσσιν ὀρούσας	--- uu- u u- --u u--	dactylic hexameter	masculine penthemimeral, hepthemimeral, trithemimeral
τεύχεά τ’ἐξενάριξε καὶ εὐχόμενος ἔπος ηὔδα·	-uu -uu-u u -uu- uu --	dactylic hexameter	feminine penthemimeral
κεῖσ’ οὕτως· χαλεπόν τοι ἐρισθενέος Κρονίωνος	- -- uu- u u-uu- uu--	dactylic hexameter	masculine penthemimeral, trithemimeral
παισὶν ἐριζέμεναι ποταμοῖό περ ἐκγεγαῶτι.	-u u-uu- uu-u u -uu--	dactylic hexameter	masculine penthemimeral
φῆσθα σὺ μὲν ποταμοῦ γένος ἔμμεναι εὐρὺ ῥέοντος,	-u u - uu- uu -uu -u u--	dactylic hexameter	masculine penthemimeral, trithemimeral
αὐτὰρ ἐγὼ γενεὴν μεγάλου Διὸς εὔχομαι εἶναι.	-u u- uu- uu- uu -uu --	dactylic hexameter	masculine penthemimeral, hepthemimeral, trithemimeral
τίκτέ μ’ἀνὴρ πολλοῖσιν ἀνάσσων Μυρμιδόνεσσι	-u u- --u u-- -uu--	dactylic hexameter	feminine penthemimeral, trithemimeral
Πηλεὺς Αἰακίδης· ὃ δ’ἄρ’ Αἰακὸς ἐκ Διὸς ἦεν.	-- -uu- u u -uu - uu --	dactylic hexameter	masculine penthemimeral
τὼ κρείσσων μὲν Ζεὺς ποταμῶν ἁλιμυρηέντων,	- -- - - uu- uu----	dactylic hexameter	masculine penthemimeral, hepthemimeral, trithemimeral
κρείσσων αὖτε Διὸς γενεὴ ποταμοῖο τέτυκται.	-- -u u- uu- uu-u u--	dactylic hexameter	masculine penthemimeral, hepthemimeral
καὶ γὰρ σοὶ ποταμός γε πάρα μέγας, εἰ δύναταί τι	- - - uu- u u- uu - uu- -	dactylic hexameter	masculine penthemimeral, hepthemimeral, trithemimeral
χραισμεῖν· ἀλλ’ οὐκ ἔστι Διὶ Κρονίωνι μάχεσθαι,	-- - - -u u- uu-u u--	dactylic hexameter	feminine penthemimeral, hepthemimeral, trithemimeral
τῷ οὐδὲ κρείων Ἀχελώϊος ἰσοφαρίζει,	- -- -- uu-uu -uu--	dactylic hexameter	masculine penthemimeral, trithemimeral
οὐδὲ βαθυρρείταο μέγα σθένος Ὠκεανοῖο,	-u u---u u- uu -uu--	dactylic hexameter	feminine penthemimeral, hepthemimeral
ἐξ οὗ περ πάντες ποταμοὶ καὶ πᾶσα θάλασσα	- - - -- uu- - -u u--	dactylic hexameter	masculine penthemimeral, hepthemimeral, trithemimeral
καὶ πᾶσαι κρῆναι καὶ φρείατα μακρὰ νάουσιν·	- -- -- - -uu -u u--	dactylic hexameter	masculine penthemimeral, trithemimeral
ἀλλὰ καὶ ὃς δείδοικε Διὸς μεγάλοιο κεραυνὸν	-u u - --u u- uu-u u--	dactylic hexameter	feminine penthemimeral, hepthemimeral, trithemimeral
δεινήν τε βροντήν, ὅτ’ ἀπ’ οὐρανόθεν σμαραγήσῃ.	-- - -- u u -uu- uu--	dactylic hexameter	masculine penthemimeral, trithemimeral
ἦ ῥα, καὶ ἐκ κρημνοῖο ἐρύσσατο χάλκεον ἔγχος,	- u u - --u u-uu -uu --	dactylic hexameter	feminine penthemimeral, trithemimeral
τὸν δὲ κατ’ αὐτόθι λεῖπεν, ἐπεὶ φίλον ἦτορ ἀπηύρα,	- u u -uu -u u- uu -u u--	dactylic hexameter	feminine penthemimeral, hepthemimeral
κείμενον ἐν ψαμάθοισι, δίαινε δέ μιν μέλαν ὕδωρ.	-uu - uu-u u-u u - uu --	dactylic hexameter	feminine penthemimeral, trithemimeral
τὸν μὲν ἄρ’ ἐγχέλυές τε καὶ ἰχθύες ἀμφεπένοντο	- u u -uu- u u -uu -uu--	dactylic hexameter	masculine penthemimeral
δημὸν ἐρεπτόμενοι ἐπινεφρίδιον κείροντες·	-u u-uu- uu-uu- ---	dactylic hexameter	masculine penthemimeral
αὐτὰρ ὃ βῆ ῥ’ἰέναι μετὰ Παίονας ἱπποκορυστάς,	-u u - uu- uu -uu -uu--	dactylic hexameter	masculine penthemimeral, trithemimeral
οἵ ῥ’ἔτι πὰρ ποταμὸν πεφοβήατο δινήεντα,	- uu - uu- uu-uu ----	dactylic hexameter	masculine penthemimeral, trithemimeral
ὡς εἶδον τὸν ἄριστον ἐνὶ κρατερῇ ὑσμίνῃ	- -- u u-u u- uu- ---	dactylic hexameter	feminine penthemimeral, hepthemimeral, trithemimeral
χέρσ’ ὕπο Πηλεΐδαο καὶ ἄορι ἶφι δαμέντα.	- uu -uu-u u -uu -u u--	dactylic hexameter	feminine penthemimeral
ἔνθ’ ἕλε Θερσίλοχόν τε Μύδωνά τε Ἀστύπυλόν τε	- uu -uu- u u-u u -uu- -	dactylic hexameter	masculine penthemimeral
Μνῆσόν τε Θρασίον τε καὶ Αἴνιον ἠδ’ Ὀφελέστην·	-- - uu- u u -uu - uu--	dactylic hexameter	masculine penthemimeral, trithemimeral
καί νύ κ’ἔτι πλέονας κτάνε Παίονας ὠκὺς Ἀχιλλεύς,	- u u- uu- uu -uu -u u--	dactylic hexameter	masculine penthemimeral, trithemimeral
εἰ μὴ χωσάμενος προσέφη ποταμὸς βαθυδίνης	- - -uu- uu- uu- uu--	dactylic hexameter	masculine penthemimeral, hepthemimeral
ἀνέρι εἰσάμενος, βαθέης δ’ἐκ φθέγξατο δίνης·	-uu -uu- uu- - -uu --	dactylic hexameter	masculine penthemimeral, hepthemimeral
ὦ Ἀχιλεῦ, περὶ μὲν κρατέεις, περὶ δ’αἴσυλα ῥέζεις	- uu- uu - uu- uu -uu --	dactylic hexameter	masculine penthemimeral, hepthemimeral, trithemimeral
ἀνδρῶν· αἰεὶ γάρ τοι ἀμύνουσιν θεοὶ αὐτοί.	-- -- - u u--- uu --	dactylic hexameter	masculine penthemimeral
εἴ τοι Τρῶας ἔδωκε Κρόνου παῖς πάντας ὀλέσσαι,	- - -u u-u u- - -u u--	dactylic hexameter	feminine penthemimeral, hepthemimeral
ἐξ ἐμέθεν γ’ἐλάσας πεδίον κάτα μέρμερα ῥέζε·	- uu- uu- uu- uu -uu --	dactylic hexameter	masculine penthemimeral, hepthemimeral, trithemimeral
πλήθει γὰρ δή μοι νεκύων ἐρατεινὰ ῥέεθρα,	-- - - - uu- uu-u u--	dactylic hexameter	masculine penthemimeral, hepthemimeral, trithemimeral
οὐδέ τί πῃ δύναμαι προχέειν ῥόον εἰς ἅλα δῖαν	-u u - uu- uu- uu - uu --	dactylic hexameter	masculine penthemimeral, hepthemimeral, trithemimeral
στεινόμενος νεκύεσσι, σὺ δὲ κτείνεις ἀϊδήλως.	-uu- uu-u u - -- uu--	dactylic hexameter	feminine penthemimeral, hepthemimeral, trithemimeral
ἀλλ’ ἄγε δὴ καὶ ἔασον· ἄγη μ’ἔχει ὄρχαμε λαῶν.	- uu - u u-u u- uu -uu --	dactylic hexameter	feminine penthemimeral, hepthemimeral, trithemimeral
τὸν δ’ἀπαμειβόμενος προσέφη πόδας ὠκὺς Ἀχιλλεύς·	- uu-uu- uu- uu -u u--	dactylic hexameter	masculine penthemimeral, hepthemimeral
ἔσται ταῦτα Σκάμανδρε διοτρεφές, ὡς σὺ κελεύεις.	-- -u u-u u-uu - u u--	dactylic hexameter	feminine penthemimeral
Τρῶας δ’οὐ πρὶν λήξω ὑπερφιάλους ἐναρίζων,	-- - - -u u-uu- uu--	dactylic hexameter	feminine penthemimeral, trithemimeral
πρὶν ἔλσαι κατὰ ἄστυ καὶ Ἕκτορι πειρηθῆναι	- -- uu -u u -uu ----	dactylic hexameter	feminine penthemimeral, trithemimeral
ἀντιβίην, ἤ κέν με δαμάσσεται, ἦ κεν ἐγὼ τόν.	-uu- - - u u-uu - u u- -	dactylic hexameter	masculine penthemimeral, trithemimeral
ὣς εἰπὼν Τρώεσσιν ἐπέσσυτο δαίμονι ἶσος·	- -- --u u-uu -uu --	dactylic hexameter	feminine penthemimeral, trithemimeral
καὶ τότ’ Ἀπόλλωνα προσέφη ποταμὸς βαθυδίνης·	- u u--- uu- uu- uu--	dactylic hexameter	masculine penthemimeral, hepthemimeral
ὢ πόποι ἀργυρότοξε Διὸς τέκος οὐ σύ γε βουλὰς	- uu -uu-u u- uu - u u --	dactylic hexameter	feminine penthemimeral, hepthemimeral
εἰρύσαο Κρονίωνος, ὅ τοι μάλα πόλλ’ ἐπέτελλε	-uu- uu-u u - uu - uu--	dactylic hexameter	feminine penthemimeral, hepthemimeral, trithemimeral
Τρωσὶ παρεστάμεναι καὶ ἀμύνειν, εἰς ὅ κεν ἔλθῃ	-u u-uu- u u-- - u u --	dactylic hexameter	masculine penthemimeral
δείελος ὀψὲ δύων, σκιάσῃ δ’ἐρίβωλον ἄρουραν.	-uu -u u- uu- uu-u u--	dactylic hexameter	masculine penthemimeral, hepthemimeral
ἦ, καὶ Ἀχιλλεὺς μὲν δουρικλυτὸς ἔνθορε μέσσῳ	- u u-- - --uu -uu --	dactylic hexameter	masculine penthemimeral
κρημνοῦ ἀπαΐξας· ὃ δ’ἐπέσσυτο οἴδματι θύων,	-u u--- u u-uu -uu --	dactylic hexameter	masculine penthemimeral
πάντα δ’ὄρινε ῥέεθρα κυκώμενος, ὦσε δὲ νεκροὺς	-u u-u u-u u-uu -u u --	dactylic hexameter	feminine penthemimeral
πολλούς, οἵ ῥα κατ’ αὐτὸν ἅλις ἔσαν, οὓς κτάν’ Ἀχιλλεύς	-- - u u -u u- uu - u u--	dactylic hexameter	feminine penthemimeral, hepthemimeral, trithemimeral
τοὺς ἔκβαλλε θύραζε μεμυκὼς ἠΰτε ταῦρος	- --u u-u u-- -uu --	dactylic hexameter	feminine penthemimeral
χέρσον δέ· ζωοὺς δὲ σάω κατὰ καλὰ ῥέεθρα,	-- - -- u u- uu -u u--	dactylic hexameter	masculine penthemimeral, hepthemimeral, trithemimeral
κρύπτων ἐν δίνῃσι βαθείῃσιν nbsp;μεγάλῃσι.	-- - --u u--- uu--	dactylic hexameter	feminine penthemimeral, trithemimeral
δεινὸν δ’ἀμφ’ Ἀχιλῆα κυκώμενον ἵστατο κῦμα,	-- - uu-u u-uu -uu --	dactylic hexameter	feminine penthemimeral, trithemimeral
ὤθει δ’ἐν σάκεϊ πίπτων ῥόος· οὐδὲ πόδεσσιν	-- - uu- -- uu -u u--	dactylic hexameter	masculine penthemimeral, hepthemimeral, trithemimeral
εἶχε στηρίξασθαι· ὃ δὲ πτελέην ἕλε χερσὶν	-- ---u u - uu- uu --	dactylic hexameter	feminine penthemimeral, hepthemimeral
εὐφυέα μεγάλην· ἣ δ’ἐκ ῥιζῶν ἐριποῦσα	-uu- uu- - - -- uu--	dactylic hexameter	masculine penthemimeral, hepthemimeral, trithemimeral
κρημνὸν ἅπαντα διῶσεν, ἐπέσχε δὲ καλὰ ῥέεθρα	-u u-u u-u u-u u -u u--	dactylic hexameter	feminine penthemimeral
ὄζοισιν πυκινοῖσι, γεφύρωσεν δέ μιν αὐτὸν	--- uu-u u--- u u --	dactylic hexameter	feminine penthemimeral, trithemimeral
εἴσω πᾶσ’ ἐριποῦσ’· ὃ δ’ἄρ’ ἐκ δίνης ἀνορούσας	-- - uu- u u - -- uu--	dactylic hexameter	masculine penthemimeral, hepthemimeral, trithemimeral
ἤϊξεν πεδίοιο ποσὶ κραιπνοῖσι πέτεσθαι	--- uu-u u- --u u--	dactylic hexameter	feminine penthemimeral, hepthemimeral, trithemimeral
δείσας· οὐδέ τ’ἔληγε θεὸς μέγας, ὦρτο δ’ἐπ’ αὐτῷ	-- -u u-u u- uu -u u --	dactylic hexameter	feminine penthemimeral, hepthemimeral
ἀκροκελαινιόων, ἵνα μιν παύσειε πόνοιο	-uu-uu- uu - --u u--	dactylic hexameter	masculine penthemimeral, hepthemimeral
δῖον Ἀχιλλῆα, Τρώεσσι δὲ λοιγὸν ἀλάλκοι.	-u u--- --u u -u u--	dactylic hexameter	masculine penthemimeral
Πηλεΐδης δ’ἀπόρουσεν ὅσον τ’ἐπὶ δουρὸς ἐρωή,	-uu- uu-u u- uu -u u--	dactylic hexameter	feminine penthemimeral, hepthemimeral, trithemimeral
αἰετοῦ οἴματ’ ἔχων μέλανος τοῦ θηρητῆρος,	-uu -u u- uu- - ----	dactylic hexameter	masculine penthemimeral, hepthemimeral
ὅς θ’ἅμα κάρτιστός τε καὶ ὤκιστος πετεηνῶν·	- uu --- u u --- uu--	dactylic hexameter	masculine penthemimeral
τῷ ἐϊκὼς ἤϊξεν, ἐπὶ στήθεσσι δὲ χαλκὸς	- uu- --u u- --u u --	dactylic hexameter	feminine penthemimeral, hepthemimeral, trithemimeral
σμερδαλέον κονάβιζεν· ὕπαιθα δὲ τοῖο λιασθεὶς	-uu- uu-u u-u u -u u--	dactylic hexameter	feminine penthemimeral, trithemimeral
φεῦγ’, ὃ δ’ὄπισθε ῥέων ἕπετο μεγάλῳ ὀρυμαγδῷ.	- u u-u u- uu- uu- uu--	dactylic hexameter	masculine penthemimeral, hepthemimeral
ὡς δ’ὅτ’ ἀνὴρ ὀχετηγὸς ἀπὸ κρήνης μελανύδρου	- u u- uu-u u- -- uu--	dactylic hexameter	feminine penthemimeral, hepthemimeral, trithemimeral
ἂμ φυτὰ καὶ κήπους ὕδατι ῥόον ἡγεμονεύῃ	- uu - -- uu- uu -uu--	dactylic hexameter	masculine penthemimeral, hepthemimeral, trithemimeral
χερσὶ μάκελλαν ἔχων, ἀμάρης ἐξ ἔχματα βάλλων·	-u u-u u- uu- - -uu --	dactylic hexameter	masculine penthemimeral, hepthemimeral
τοῦ μέν τε προρέοντος ὑπὸ ψηφῖδες ἅπασαι	- - - uu-u u- --u u--	dactylic hexameter	feminine penthemimeral, hepthemimeral, trithemimeral
ὀχλεῦνται· τὸ δέ τ’ὦκα κατειβόμενον κελαρύζει	--- u u -u u-uu- uu--	dactylic hexameter	feminine penthemimeral, trithemimeral
χώρῳ ἔνι προαλεῖ, φθάνει δέ τε καὶ τὸν ἄγοντα·	-u u- uu- -- u u - u u--	dactylic hexameter	masculine penthemimeral, hepthemimeral, trithemimeral
ὣς αἰεὶ Ἀχιλῆα κιχήσατο κῦμα ῥόοιο	- -- uu-u u-uu -u u--	dactylic hexameter	feminine penthemimeral, trithemimeral
καὶ λαιψηρὸν ἐόντα· θεοὶ δέ τε φέρτεροι ἀνδρῶν.	- --u u-u u- u u -uu --	dactylic hexameter	feminine penthemimeral, hepthemimeral
ὁσσάκι δ’ὁρμήσειε ποδάρκης δῖος Ἀχιλλεὺς	-uu ---u u-- -u u--	dactylic hexameter	feminine penthemimeral
στῆναι ἐναντίβιον καὶ γνώμεναι εἴ μιν ἅπαντες	-u u-uu- - -uu - u u--	dactylic hexameter	masculine penthemimeral
ἀθάνατοι φοβέουσι, τοὶ οὐρανὸν εὐρὺν ἔχουσι,	-uu- uu-u u -uu -u u--	dactylic hexameter	feminine penthemimeral, trithemimeral
τοσσάκι μιν μέγα κῦμα διιπετέος ποταμοῖο	-uu - uu -u u-uu- uu--	dactylic hexameter	feminine penthemimeral, trithemimeral
πλάζ’ ὤμους καθύπερθεν· ὃ δ’ὑψόσε ποσσὶν ἐπήδα	- -- uu-u u -uu -u u--	dactylic hexameter	feminine penthemimeral, trithemimeral
θυμῷ ἀνιάζων· ποταμὸς δ’ὑπὸ γούνατ’ ἐδάμνα	-u u--- uu- uu -u u--	dactylic hexameter	masculine penthemimeral, hepthemimeral
λάβρος ὕπαιθα ῥέων, κονίην δ’ὑπέρεπτε ποδοῖιν.	-u u-u u- uu- uu-u u--	dactylic hexameter	masculine penthemimeral, hepthemimeral
Πηλεΐδης δ’ᾤμωξεν ἰδὼν εἰς οὐρανὸν εὐρύν·	-uu- --u u- - -uu --	dactylic hexameter	feminine penthemimeral, hepthemimeral, trithemimeral
Ζεῦ πάτερ ὡς οὔ τίς με θεῶν ἐλεεινὸν ὑπέστη	- uu - - - u u- uu-u u--	dactylic hexameter	masculine penthemimeral, hepthemimeral, trithemimeral
ἐκ ποταμοῖο σαῶσαι· ἔπειτα δὲ καί τι πάθοιμι.	- uu-u u-u u-u u - u u--	dactylic hexameter	feminine penthemimeral
ἄλλος δ’οὔ τις μοι τόσον αἴτιος Οὐρανιώνων,	-- - - - uu -uu -uu--	dactylic hexameter	masculine penthemimeral, trithemimeral
ἀλλὰ φίλη μήτηρ, ἥ με ψεύδεσσιν ἔθελγεν·	-u u- -- - - --u u--	dactylic hexameter	masculine penthemimeral, hepthemimeral, trithemimeral
ἥ μ’ἔφατο Τρώων ὑπὸ τείχεϊ θωρηκτάων	- uu- -- uu -uu ----	dactylic hexameter	masculine penthemimeral, trithemimeral
λαιψηροῖς ὀλέεσθαι Ἀπόλλωνος βελέεσσιν.	--- uu-u u--- uu--	dactylic hexameter	feminine penthemimeral, trithemimeral
ὥς μ’ὄφελ’ Ἕκτωρ κτεῖναι ὃς ἐνθάδε γ’ἔτραφ’ ἄριστος·	- uu -- -u u -uu -u u--	dactylic hexameter	feminine penthemimeral
τώ κ’ἀγαθὸς μὲν ἔπεφν’, ἀγαθὸν δέ κεν ἐξενάριξε·	- uu- u u- uu- u u -uu--	dactylic hexameter	masculine penthemimeral, hepthemimeral, trithemimeral
νῦν δέ με λευγαλέῳ θανάτῳ εἵμαρτο ἁλῶναι	- u u -uu- uu- --u u--	dactylic hexameter	masculine penthemimeral, hepthemimeral
ἐρχθέντ’ ἐν μεγάλῳ ποταμῷ ὡς παῖδα συφορβόν,	-- - uu- uu- - -u u--	dactylic hexameter	masculine penthemimeral, hepthemimeral, trithemimeral
ὅν ῥά τ’ἔναυλος ἀποέρσῃ χειμῶνι περῶντα.	- u u-u u--- --u u--	dactylic hexameter	hepthemimeral
ὣς φάτο, τῷ δὲ μάλ’ ὦκα Ποσειδάων καὶ Ἀθήνη	- uu - u u -u u--- u u--	dactylic hexameter	feminine penthemimeral, trithemimeral
στήτην ἐγγὺς ἰόντε, δέμας δ’ἄνδρεσσιν ἐΐκτην,	-- -u u-u u- --u u--	dactylic hexameter	feminine penthemimeral, hepthemimeral
χειρὶ δὲ χεῖρα λαβόντες ἐπιστώσαντ’ ἐπέεσσι.	-u u -u u-u u--- uu--	dactylic hexameter	feminine penthemimeral
τοῖσι δὲ μύθων ἦρχε Ποσειδάων ἐνοσίχθων·	-u u -- -u u--- uu--	dactylic hexameter	feminine penthemimeral
Πηλεΐδη μήτ’ ἄρ τι λίην τρέε μήτέ τι τάρβει·	-uu- - - u u- uu -u u --	dactylic hexameter	masculine penthemimeral, hepthemimeral, trithemimeral
τοίω γάρ τοι νῶϊ θεῶν ἐπιταρρόθω εἰμὲν	-- - - -u u- uu-uu --	dactylic hexameter	feminine penthemimeral, hepthemimeral, trithemimeral
Ζηνὸς ἐπαινήσαντος ἐγὼ καὶ Παλλὰς Ἀθήνη·	-u u---u u- - -u u--	dactylic hexameter	feminine penthemimeral, hepthemimeral
ὡς οὔ τοι ποταμῷ γε δαμήμεναι αἴσιμόν ἐστιν,	- - - uu- u u-uu -uu --	dactylic hexameter	masculine penthemimeral, trithemimeral
ἀλλ’ ὅδε μὲν τάχα λωφήσει, σὺ δὲ εἴσεαι αὐτός·	- uu - uu --- u u -uu --	dactylic hexameter	hepthemimeral, trithemimeral
αὐτάρ τοι πυκινῶς ὑποθησόμεθ’ αἴ κε πίθηαι·	-- - uu- uu-uu - u u--	dactylic hexameter	masculine penthemimeral, trithemimeral
μὴ πρὶν παύειν χεῖρας ὁμοιΐου πολέμοιο	- - -- -u u--- uu--	dactylic hexameter	feminine penthemimeral
πρὶν κατὰ Ἰλιόφι κλυτὰ τείχεα λαὸν ἐέλσαι	- uu -uu- uu -uu -u u--	dactylic hexameter	masculine penthemimeral
Τρωϊκόν, ὅς κε φύγῃσι· σὺ δ’Ἕκτορι θυμὸν ἀπούρας	-uu - u u-u u -uu -u u--	dactylic hexameter	feminine penthemimeral, trithemimeral
ἂψ ἐπὶ νῆας ἴμεν· δίδομεν δέ τοι εὖχος ἀρέσθαι.	- uu -u u- uu- u u -u u--	dactylic hexameter	masculine penthemimeral, hepthemimeral
τὼ μὲν ἄρ’ ὣς εἰπόντε μετ’ ἀθανάτους ἀπεβήτην·	- u u - --u u -uu- uu--	dactylic hexameter	feminine penthemimeral, trithemimeral
αὐτὰρ ὃ βῆ, μέγα γάρ ῥα θεῶν ὄτρυνεν ἐφετμή,	-u u - uu - u u- --u u--	dactylic hexameter	masculine penthemimeral, hepthemimeral, trithemimeral
ἐς πεδίον· τὸ δὲ πᾶν πλῆθ’ ὕδατος ἐκχυμένοιο,	- uu- u u - - -uu -uu--	dactylic hexameter	masculine penthemimeral, trithemimeral
πολλὰ δὲ τεύχεα καλὰ δαὶ κταμένων αἰζηῶν	-u u -uu -- - uu- ---	dactylic hexameter	hepthemimeral
πλῶον καὶ νέκυες· τοῦ δ’ὑψόσε γούνατ’ ἐπήδα	-- - uu- - -uu -u u--	dactylic hexameter	masculine penthemimeral, trithemimeral
πρὸς ῥόον ἀΐσσοντος ἀν’ ἰθύν, οὐδέ μιν ἴσχεν	- uu ---u u -- -u u --	dactylic hexameter	feminine penthemimeral
εὐρὺ ῥέων ποταμός· μέγα γὰρ σθένος ἔμβαλ’ Ἀθήνη.	-u u- uu- uu - uu -u u--	dactylic hexameter	masculine penthemimeral, hepthemimeral, trithemimeral
οὐδὲ Σκάμανδρος ἔληγε τὸ ὃν μένος, ἀλλ’ ἔτι μᾶλλον	-u u-u u-u u - uu - uu --	dactylic hexameter	feminine penthemimeral, hepthemimeral
χώετο Πηλεΐωνι, κόρυσσε δὲ κῦμα ῥόοιο	-uu -uu-u u-u u -u u--	dactylic hexameter	feminine penthemimeral
ὑψόσ’ ἀειρόμενος, Σιμόεντι δὲ κέκλετ’ ἀΰσας·	-u u-uu- uu-u u -u u--	dactylic hexameter	masculine penthemimeral
φίλε κασίγνητε σθένος ἀνέρος ἀμφότεροί περ	-u u--- uu -uu -uu- -	dactylic hexameter	masculine penthemimeral
σχῶμεν, ἐπεὶ τάχα ἄστυ μέγα Πριάμοιο ἄνακτος	-u u- uu -u u- uu-u u--	dactylic hexameter	feminine penthemimeral, hepthemimeral, trithemimeral
ἐκπέρσει, Τρῶες δὲ κατὰ μόθον οὐ μενέουσιν.	--- -- u u- uu - uu--	dactylic hexameter	masculine penthemimeral, hepthemimeral, trithemimeral
ἀλλ’ ἐπάμυνε τάχιστα, καὶ ἐμπίπληθι ῥέεθρα	- uu-u u-u u ---u u--	dactylic hexameter	feminine penthemimeral
ὕδατος ἐκ πηγέων, πάντας δ’ὀρόθυνον ἐναύλους,	-uu - -- -- uu-u u--	dactylic hexameter	masculine penthemimeral, hepthemimeral, trithemimeral
ἵστη δὲ μέγα κῦμα, πολὺν δ’ὀρυμαγδὸν ὄρινε	-- - uu -u u- uu-u u--	dactylic hexameter	feminine penthemimeral, hepthemimeral, trithemimeral
φιτρῶν καὶ λάων, ἵνα παύσομεν ἄγριον ἄνδρα	-- - -- uu -uu -uu --	dactylic hexameter	masculine penthemimeral, trithemimeral
ὃς δὴ νῦν κρατέει, μέμονεν δ’ὅ γε ἶσα θεοῖσι.	- - - uu- uu- u u -u u--	dactylic hexameter	masculine penthemimeral, hepthemimeral, trithemimeral
φημὶ γὰρ οὔτε βίην χραισμησέμεν οὔτέ τι εἶδος	-u u -u u- --uu -u u --	dactylic hexameter	masculine penthemimeral
οὔτε τὰ τεύχεα καλά, τά που μάλα νειόθι λίμνης	-u u -uu -u u - uu -uu --	dactylic hexameter	feminine penthemimeral, hepthemimeral
κείσεθ’ ὑπ’ ἰλύος κεκαλυμμένα· κὰδ δέ μιν αὐτὸν	-u u --- uu-uu - u u --	dactylic hexameter	masculine penthemimeral
εἰλύσω ψαμάθοισιν ἅλις χέραδος περιχεύας	--- uu-u u- uu- uu--	dactylic hexameter	feminine penthemimeral, hepthemimeral, trithemimeral
μυρίον, οὐδέ οἱ ὀστέ’ ἐπιστήσονται Ἀχαιοὶ	-uu -u u -u u---u u--	dactylic hexameter	feminine penthemimeral
ἀλλέξαι· τόσσην οἱ ἄσιν καθύπερθε καλύψω.	--- -- u u- uu-u u--	dactylic hexameter	masculine penthemimeral, hepthemimeral, trithemimeral
αὐτοῦ οἱ καὶ σῆμα τετεύξεται, οὐδέ τί μιν χρεὼ	-- - - -u u-uu -u u - -	dactylic hexameter	feminine penthemimeral, trithemimeral
ἔσται τυμβοχόης, ὅτε μιν θάπτωσιν Ἀχαιοί.	-- -uu- uu - --u u--	dactylic hexameter	masculine penthemimeral, hepthemimeral
ἦ, καὶ ἐπῶρτ’ Ἀχιλῆϊ κυκώμενος ὑψόσε θύων	- u u- uu-u u-uu -uu --	dactylic hexameter	feminine penthemimeral, trithemimeral
μορμύρων ἀφρῷ τε καὶ αἵματι καὶ νεκύεσσι.	--- -- u u -uu - uu--	dactylic hexameter	masculine penthemimeral, trithemimeral
πορφύρεον δ’ἄρα κῦμα διιπετέος ποταμοῖο	-uu- uu -u u-uu- uu--	dactylic hexameter	feminine penthemimeral, trithemimeral
ἵστατ’ ἀειρόμενον, κατὰ δ’ᾕρεε Πηλεΐωνα·	-u u-uu- uu -uu -uu--	dactylic hexameter	masculine penthemimeral
Ἥρη δὲ μέγ’ ἄϋσε περιδείσασ’ Ἀχιλῆϊ	-- - u u-u u--- uu--	dactylic hexameter	feminine penthemimeral, trithemimeral
μή μιν ἀποέρσειε μέγας ποταμὸς βαθυδίνης,	- u u---u u- uu- uu--	dactylic hexameter	feminine penthemimeral, hepthemimeral
αὐτίκα δ’Ἥφαιστον προσεφώνεεν ὃν φίλον υἱόν·	-uu --- uu-uu - uu --	dactylic hexameter	masculine penthemimeral
ὄρσεο κυλλοπόδιον ἐμὸν τέκος· ἄντα σέθεν γὰρ	-uu -uu-u u- uu -u u- -	dactylic hexameter	feminine penthemimeral, hepthemimeral
Ξάνθον δινήεντα μάχῃ ἠΐσκομεν εἶναι·	-- ---u u- --uu --	dactylic hexameter	feminine penthemimeral, hepthemimeral
ἀλλ’ ἐπάμυνε τάχιστα, πιφαύσκεο δὲ φλόγα πολλήν.	- uu-u u-u u-uu - uu --	dactylic hexameter	feminine penthemimeral
αὐτὰρ ἐγὼ Ζεφύροιο καὶ ἀργεστᾶο Νότοιο	-u u- uu-u u ---u u--	dactylic hexameter	feminine penthemimeral, trithemimeral
εἴσομαι ἐξ ἁλόθεν χαλεπὴν ὄρσουσα θύελλαν,	-uu - uu- uu- --u u--	dactylic hexameter	masculine penthemimeral, hepthemimeral, trithemimeral
ἥ κεν ἀπὸ Τρώων κεφαλὰς καὶ τεύχεα κήαι	- u u- -- uu- - -uu --	dactylic hexameter	masculine penthemimeral, hepthemimeral, trithemimeral
φλέγμα κακὸν φορέουσα· σὺ δὲ Ξάνθοιο παρ’ ὄχθας	-u u- uu-u u - --u u --	dactylic hexameter	feminine penthemimeral, hepthemimeral, trithemimeral
δένδρεα καῖ’, ἐν δ’αὐτὸν ἵει πυρί· μὴ δέ σε πάμπαν	-uu - - -u u- uu - u u --	dactylic hexameter	feminine penthemimeral, hepthemimeral, trithemimeral
μειλιχίοις ἐπέεσσιν ἀποτρεπέτω καὶ ἀρειῇ·	-uu- uu-u u-uu- u u--	dactylic hexameter	feminine penthemimeral, trithemimeral
μὴ δὲ πρὶν ἀπόπαυε τεὸν μένος, ἀλλ’ ὁπότ’ ἂν δὴ	- - - uu-u u- uu - uu - -	dactylic hexameter	feminine penthemimeral, hepthemimeral, trithemimeral
φθέγξομ’ ἐγὼν ἰάχουσα, τότε σχεῖν ἀκάματον πῦρ.	-u u- uu-u u- - -uu- -	dactylic hexameter	feminine penthemimeral, hepthemimeral, trithemimeral
ὣς ἔφαθ’, Ἥφαιστος δὲ τιτύσκετο θεσπιδαὲς πῦρ.	- uu --- u u-uu -uu- -	dactylic hexameter	masculine penthemimeral
πρῶτα μὲν ἐν πεδίῳ πῦρ δαίετο, καῖε δὲ νεκροὺς	-u u - uu- - -uu -u u --	dactylic hexameter	masculine penthemimeral, trithemimeral
πολλούς, οἵ ῥα κατ’ αὐτὸν ἅλις ἔσαν, οὓς κτάν’ Ἀχιλλεύς·	-- - u u -u u- uu - u u--	dactylic hexameter	feminine penthemimeral, hepthemimeral, trithemimeral
πᾶν δ’ἐξηράνθη πεδίον, σχέτο δ’ἀγλαὸν ὕδωρ.	- ---- uu- uu -uu --	dactylic hexameter	masculine penthemimeral, hepthemimeral
ὡς δ’ὅτ’ ὀπωρινὸς Βορέης νεοαρδέ’ ἀλωὴν	- u u--- uu- uu-u u--	dactylic hexameter	masculine penthemimeral, hepthemimeral
αἶψ’ ἀγξηράνῃ· χαίρει δέ μιν ὅς τις ἐθείρῃ·	- ---- -- u u - u u--	dactylic hexameter	masculine penthemimeral, hepthemimeral
ὣς ἐξηράνθη πεδίον πᾶν, κὰδ δ’ἄρα νεκροὺς	- ---- uu- - - uu --	dactylic hexameter	masculine penthemimeral, hepthemimeral
κῆεν· ὃ δ’ἐς ποταμὸν τρέψε φλόγα παμφανόωσαν.	-u u - uu- -- uu -uu--	dactylic hexameter	masculine penthemimeral, hepthemimeral, trithemimeral
καίοντο πτελέαι τε καὶ ἰτέαι ἠδὲ μυρῖκαι,	--- uu- u u -uu -u u--	dactylic hexameter	masculine penthemimeral, trithemimeral
καίετο δὲ λωτός τε ἰδὲ θρύον ἠδὲ κύπειρον,	-uu - -- u u- uu -u u--	dactylic hexameter	masculine penthemimeral, hepthemimeral, trithemimeral
τὰ περὶ καλὰ ῥέεθρα ἅλις ποταμοῖο πεφύκει·	- uu -u u-u u- uu-u u--	dactylic hexameter	feminine penthemimeral, hepthemimeral
τείροντ’ ἐγχέλυές τε καὶ ἰχθύες οἳ κατὰ δίνας,	-- -uu- u u -uu - uu --	dactylic hexameter	masculine penthemimeral
οἳ κατὰ καλὰ ῥέεθρα κυβίστων ἔνθα καὶ ἔνθα	- uu -u u-u u-- -u u --	dactylic hexameter	feminine penthemimeral
πνοιῇ τειρόμενοι πολυμήτιος Ἡφαίστοιο.	-- -uu- uu-uu ----	dactylic hexameter	masculine penthemimeral
καίετο δ’ἲς ποταμοῖο ἔπος τ’ἔφατ’ ἔκ τ’ὀνόμαζεν·	-uu - uu-u u- uu - uu--	dactylic hexameter	feminine penthemimeral, hepthemimeral, trithemimeral
Ἥφαιστ’, οὔ τις σοί γε θεῶν δύνατ’ ἀντιφερίζειν,	-- - - - u u- uu -uu--	dactylic hexameter	masculine penthemimeral, hepthemimeral, trithemimeral
οὐδ’ ἂν ἐγὼ σοί γ’ὧδε πυρὶ φλεγέθοντι μαχοίμην.	- u u- - -u u- uu-u u--	dactylic hexameter	feminine penthemimeral, hepthemimeral, trithemimeral
λῆγ’ ἔριδος, Τρῶας δὲ καὶ αὐτίκα δῖος Ἀχιλλεὺς	- uu- -- u u -uu -u u--	dactylic hexameter	masculine penthemimeral, trithemimeral
ἄστεος ἐξελάσειε· τί μοι ἔριδος καὶ ἀρωγῆς;	-uu -uu-u u - uu- u u--	dactylic hexameter	feminine penthemimeral, hepthemimeral
φῆ πυρὶ καιόμενος, ἀνὰ δ’ἔφλυε καλὰ ῥέεθρα.	- uu -uu- uu -uu -u u--	dactylic hexameter	masculine penthemimeral
ὡς δὲ λέβης ζεῖ ἔνδον ἐπειγόμενος πυρὶ πολλῷ	- u u- - -u u-uu- uu --	dactylic hexameter	feminine penthemimeral, trithemimeral
κνίσην μελδόμενος ἁπαλοτρεφέος σιάλοιο	-- -uu- uu-uu- uu--	dactylic hexameter	masculine penthemimeral
πάντοθεν ἀμβολάδην, ὑπὸ δὲ ξύλα κάγκανα κεῖται,	-uu -uu- uu - uu -uu --	dactylic hexameter	masculine penthemimeral, hepthemimeral
ὣς τοῦ καλὰ ῥέεθρα πυρὶ φλέγετο, ζέε δ’ὕδωρ·	- - -u u-u u- uu- uu --	dactylic hexameter	feminine penthemimeral, hepthemimeral
οὐδ’ ἔθελε προρέειν, ἀλλ’ ἴσχετο· τεῖρε δ’ἀϋτμὴ	- uu- uu- - -uu -u u--	dactylic hexameter	masculine penthemimeral, trithemimeral
Ἡφαίστοιο βίηφι πολύφρονος. αὐτὰρ ὅ γ’Ἥρην	---u u-u u-uu -u u --	dactylic hexameter	feminine penthemimeral
πολλὰ λισσόμενος ἔπεα πτερόεντα προσηύδα·	-- -uu- uu- uu-u u--	dactylic hexameter	masculine penthemimeral, hepthemimeral
Ἥρη τίπτε σὸς υἱὸς ἐμὸν ῥόον ἔχραε κήδειν	-- -u u -u u- uu -uu --	dactylic hexameter	feminine penthemimeral, hepthemimeral
ἐξ ἄλλων; οὐ μέν τοι ἐγὼ τόσον αἴτιός εἰμι	- -- - - u u- uu -uu --	dactylic hexameter	masculine penthemimeral, hepthemimeral, trithemimeral
ὅσσον οἱ ἄλλοι πάντες, ὅσοι Τρώεσσιν ἀρωγοί.	-u u -- -u u- --u u--	dactylic hexameter	feminine penthemimeral, hepthemimeral
ἀλλ’ ἤτοι μὲν ἐγὼν ἀποπαύσομαι εἰ σὺ κελεύεις,	- -- u u- uu-uu - u u--	dactylic hexameter	masculine penthemimeral, trithemimeral
παυέσθω δὲ καὶ οὗτος· ἐγὼ δ’ἐπὶ καὶ τόδ’ ὀμοῦμαι,	--- u u -u u- uu - u u--	dactylic hexameter	feminine penthemimeral, hepthemimeral, trithemimeral
μή ποτ’ ἐπὶ Τρώεσσιν ἀλεξήσειν κακὸν ἦμαρ,	- u u- --u u--- uu --	dactylic hexameter	feminine penthemimeral, trithemimeral
μὴ δ’ὁπότ’ ἂν Τροίη μαλερῷ πυρὶ πᾶσα δάηται	- uu - -- uu- uu -u u--	dactylic hexameter	masculine penthemimeral, hepthemimeral, trithemimeral
καιομένη, καίωσι δ’ ἀρήϊοι υἷες Ἀχαιῶν.	-uu- --u u-uu -u u--	dactylic hexameter	feminine penthemimeral, trithemimeral
αὐτὰρ ἐπεὶ τό γ’ἄκουσε θεὰ λευκώλενος Ἥρη,	-u u- u u-u u- --uu --	dactylic hexameter	feminine penthemimeral, hepthemimeral, trithemimeral
αὐτίκ’ ἄρ’ Ἥφαιστον προσεφώνεεν ὃν φίλον υἱόν·	-u u --- uu-uu - uu --	dactylic hexameter	masculine penthemimeral
Ἥφαιστε σχέο τέκνον ἀγακλεές· οὐ γὰρ ἔοικεν	--- uu -u u-uu - u u--	dactylic hexameter	feminine penthemimeral, trithemimeral
ἀθάνατον θεὸν ὧδε βροτῶν ἕνεκα στυφελίζειν.	-uu- uu -u u- uu- uu--	dactylic hexameter	feminine penthemimeral, hepthemimeral, trithemimeral
ὣς ἔφαθ’, Ἥφαιστος δὲ κατέσβεσε θεσπιδαὲς πῦρ,	- uu --- u u-uu -uu- -	dactylic hexameter	masculine penthemimeral
ἄψορρον δ’ἄρα κῦμα κατέσσυτο καλὰ ῥέεθρα.	--- uu -u u-uu -u u--	dactylic hexameter	feminine penthemimeral, trithemimeral
αὐτὰρ ἐπεὶ Ξάνθοιο δάμη μένος, οἳ μὲν ἔπειτα	-u u- --u u- uu - u u--	dactylic hexameter	feminine penthemimeral, hepthemimeral, trithemimeral
παυσάσθην, Ἥρη γὰρ ἐρύκακε χωομένη περ·	--- -- u u-uu -uu- -	dactylic hexameter	masculine penthemimeral, trithemimeral
ἐν δ’ἄλλοισι θεοῖσιν ἔρις πέσε βεβριθυῖα	- --u u-u u- uu ----	dactylic hexameter	feminine penthemimeral, hepthemimeral
ἀργαλέη, δίχα δέ σφιν ἐνὶ φρεσὶ θυμὸς ἄητο·	-uu- uu - u u- uu -u u--	dactylic hexameter	masculine penthemimeral, hepthemimeral, trithemimeral
σὺν δ’ἔπεσον μεγάλῳ πατάγῳ, βράχε δ’εὐρεῖα χθών,	- uu- uu- uu- uu --- -	dactylic hexameter	masculine penthemimeral, hepthemimeral, trithemimeral
ἀμφὶ δὲ σάλπιγξεν μέγας οὐρανός. ἄϊε δὲ Ζεὺς	-u u --- uu -uu -uu - -	dactylic hexameter	masculine penthemimeral
ἥμενος Οὐλύμπῳ· ἐγέλασσε δέ οἱ φίλον ἦτορ	-uu --- uu-u u - uu --	dactylic hexameter	masculine penthemimeral
γηθοσύνῃ, ὅθ’ ὁρᾶτο θεοὺς ἔριδι ξυνιόντας.	-uu- u u-u u- uu- uu--	dactylic hexameter	feminine penthemimeral, hepthemimeral, trithemimeral
ἔνθ’ οἵ γ’οὐκέτι δηρὸν ἀφέστασαν· ἦρχε γὰρ Ἄρης	- - -uu -u u-uu -u u --	dactylic hexameter	feminine penthemimeral
ῥινοτόρος, καὶ πρῶτος Ἀθηναίῃ ἐπόρουσε	-uu- - -u u--- uu--	dactylic hexameter	feminine penthemimeral, trithemimeral
χάλκεον ἔγχος ἔχων, καὶ ὀνείδειον φάτο μῦθον·	-uu -u u- u u--- uu --	dactylic hexameter	masculine penthemimeral
τίπτ’ αὖτ’ ὦ κυνάμυια θεοὺς ἔριδι ξυνελαύνεις	- - - uu-u u- uu- uu--	dactylic hexameter	feminine penthemimeral, hepthemimeral, trithemimeral
θάρσος ἄητον ἔχουσα, μέγας δέ σε θυμὸς ἀνῆκεν;	-u u-u u-u u- u u -u u--	dactylic hexameter	feminine penthemimeral, hepthemimeral
ἦ οὐ μέμνῃ ὅτε Τυδεΐδην Διομήδε’ ἀνῆκας	- -- uu -uu- uu-u u--	dactylic hexameter	hepthemimeral, trithemimeral
οὐτάμεναι, αὐτὴ δὲ πανόψιον ἔγχος ἑλοῦσα	-uu- -- u u-uu -u u--	dactylic hexameter	masculine penthemimeral, trithemimeral
ἰθὺς ἐμεῦ ὦσας, διὰ δὲ χρόα καλὸν ἔδαψας;	-u u- -- uu - uu -u u--	dactylic hexameter	masculine penthemimeral, hepthemimeral, trithemimeral
τώ σ’αὖ νῦν ὀΐω ἀποτισέμεν ὅσσα ἔοργας.	- - - uu- uu-uu -u u--	dactylic hexameter	masculine penthemimeral, trithemimeral
ὣς εἰπὼν οὔτησε κατ’ αἰγίδα θυσσανόεσσαν	- -- --u u -uu -uu--	dactylic hexameter	feminine penthemimeral, trithemimeral
σμερδαλέην, ἣν οὐδὲ Διὸς δάμνησι κεραυνός·	-uu- - -u u- --u u--	dactylic hexameter	feminine penthemimeral, hepthemimeral, trithemimeral
τῇ μιν Ἄρης οὔτησε μιαιφόνος ἔγχεϊ μακρῷ.	- u u- --u u-uu -uu --	dactylic hexameter	feminine penthemimeral, trithemimeral
ἣ δ’ἀναχασσαμένη λίθον εἵλετο χειρὶ παχείῃ	- uu-uu- uu -uu -u u--	dactylic hexameter	masculine penthemimeral
κείμενον ἐν πεδίῳ μέλανα τρηχύν τε μέγαν τε,	-uu - uu- uu- -- u u- -	dactylic hexameter	masculine penthemimeral, hepthemimeral, trithemimeral
τόν ῥ’ἄνδρες πρότεροι θέσαν ἔμμεναι οὖρον ἀρούρης·	- -- uu- uu -uu -u u--	dactylic hexameter	masculine penthemimeral, trithemimeral
τῷ βάλε θοῦρον Ἄρηα κατ’ αὐχένα, λῦσε δὲ γυῖα.	- uu -u u-u u -uu -u u --	dactylic hexameter	feminine penthemimeral
ἑπτὰ δ’ἐπέσχε πέλεθρα πεσών, ἐκόνισε δὲ χαίτας,	-u u-u u-u u- uu-u u --	dactylic hexameter	feminine penthemimeral, hepthemimeral
τεύχεά τ’ἀμφαράβησε· γέλασσε δὲ Παλλὰς Ἀθήνη,	-uu -uu-u u-u u -u u--	dactylic hexameter	feminine penthemimeral
καί οἱ ἐπευχομένη ἔπεα πτερόεντα προσηύδα·	- u u-uu- uu- uu-u u--	dactylic hexameter	masculine penthemimeral, hepthemimeral
νηπύτι’ οὐδέ νύ πώ περ ἐπεφράσω ὅσσον ἀρείων	-uu -u u - u u-uu -u u--	dactylic hexameter	masculine penthemimeral
εὔχομ’ ἐγὼν ἔμεναι, ὅτι μοι μένος ἰσοφαρίζεις.	-u u- uu- uu - uu -uu--	dactylic hexameter	masculine penthemimeral, hepthemimeral, trithemimeral
οὕτω κεν τῆς μητρὸς ἐρινύας ἐξαποτίνοις,	-- - - -u u-uu -uu--	dactylic hexameter	feminine penthemimeral, trithemimeral
ἥ τοι χωομένη κακὰ μήδεται οὕνεκ’ Ἀχαιοὺς	- - -uu- uu -uu -u u--	dactylic hexameter	masculine penthemimeral
κάλλιπες, αὐτὰρ Τρωσὶν ὑπερφιάλοισιν ἀμύνεις.	-uu -- -u u-uu-u u--	dactylic hexameter	feminine penthemimeral
ὣς ἄρα φωνήσασα πάλιν τρέπεν ὄσσε φαεινώ·	- uu ---u u- uu -u u--	dactylic hexameter	feminine penthemimeral, hepthemimeral
τὸν δ’ἄγε χειρὸς ἑλοῦσα Διὸς θυγάτηρ Ἀφροδίτη	- uu -u u-u u- uu- uu--	dactylic hexameter	feminine penthemimeral, hepthemimeral
πυκνὰ μάλα στενάχοντα· μόγις δ’ἐσαγείρετο θυμόν.	-u u- uu-u u- uu-uu --	dactylic hexameter	feminine penthemimeral, hepthemimeral, trithemimeral
τὴν δ’ὡς οὖν ἐνόησε θεὰ λευκώλενος Ἥρη,	- - - uu-u u- --uu --	dactylic hexameter	feminine penthemimeral, hepthemimeral, trithemimeral
αὐτίκ’ Ἀθηναίην ἔπεα πτερόεντα προσηύδα·	-u u--- uu- uu-u u--	dactylic hexameter	masculine penthemimeral, hepthemimeral
ὢ πόποι αἰγιόχοιο Διὸς τέκος Ἀτρυτώνη	- uu -uu-u u- uu ----	dactylic hexameter	feminine penthemimeral, hepthemimeral
καὶ δ’αὖθ’ ἡ κυνάμυια ἄγει βροτολοιγὸν Ἄρηα	- - - uu-u u- uu-u u--	dactylic hexameter	feminine penthemimeral, hepthemimeral, trithemimeral
δηΐου ἐκ πολέμοιο κατὰ κλόνον· ἀλλὰ μέτελθε.	-uu - uu-u u- uu -u u--	dactylic hexameter	feminine penthemimeral, hepthemimeral, trithemimeral
ὣς φάτ’, Ἀθηναίη δὲ μετέσσυτο, χαῖρε δὲ θυμῷ,	- u u--- u u-uu -u u --	dactylic hexameter	masculine penthemimeral
καί ῥ’ἐπιεισαμένη πρὸς στήθεα χειρὶ παχείῃ	- uu-uu- - -uu -u u--	dactylic hexameter	masculine penthemimeral
ἤλασε· τῆς δ’αὐτοῦ λύτο γούνατα καὶ φίλον ἦτορ.	-uu - -- uu -uu - uu --	dactylic hexameter	masculine penthemimeral, trithemimeral
τὼ μὲν ἄρ’ ἄμφω κεῖντο ἐπὶ χθονὶ πουλυβοτείρῃ,	- u u -- -u u- uu -uu--	dactylic hexameter	feminine penthemimeral, hepthemimeral
ἣ δ’ἄρ’ ἐπευχομένη ἔπεα πτερόεντ’ ἀγόρευε·	- u u-uu- uu- uu- uu--	dactylic hexameter	masculine penthemimeral, hepthemimeral
τοιοῦτοι νῦν πάντες ὅσοι Τρώεσσιν ἀρωγοὶ	--- - -u u- --u u--	dactylic hexameter	feminine penthemimeral, hepthemimeral, trithemimeral
εἶεν, ὅτ’ Ἀργείοισι μαχοίατο θωρηκτῇσιν,	-u u ---u u-uu ----	dactylic hexameter	feminine penthemimeral
ὧδέ τε θαρσαλέοι καὶ τλήμονες, ὡς Ἀφροδίτη	-u u -uu- - -uu - uu--	dactylic hexameter	masculine penthemimeral
ἦλθεν Ἄρῃ ἐπίκουρος ἐμῷ μένει ἀντιόωσα·	-u u- uu-u u- uu -uu--	dactylic hexameter	feminine penthemimeral, hepthemimeral, trithemimeral
τώ κεν δὴ πάλαι ἄμμες ἐπαυσάμεθα πτολέμοιο	- - - uu -u u-uu- uu--	dactylic hexameter	feminine penthemimeral, trithemimeral
Ἰλίου ἐκπέρσαντες ἐϋκτίμενον πτολίεθρον.	-uu ---u u-uu- uu--	dactylic hexameter	feminine penthemimeral
ὣς φάτο, μείδησεν δὲ θεὰ λευκώλενος Ἥρη.	- uu --- u u- --uu --	dactylic hexameter	masculine penthemimeral, hepthemimeral
αὐτὰρ Ἀπόλλωνα προσέφη κρείων ἐνοσίχθων·	-u u--- uu- -- uu--	dactylic hexameter	masculine penthemimeral, hepthemimeral
Φοῖβε τί ἢ δὴ νῶϊ διέσταμεν; οὐδὲ ἔοικεν	-u u - - -u u-uu -u u--	dactylic hexameter	feminine penthemimeral, trithemimeral
ἀρξάντων ἑτέρων· τὸ μὲν αἴσχιον αἴ κ’ἀμαχητὶ	--- uu- u u -uu - uu--	dactylic hexameter	masculine penthemimeral, trithemimeral
ἴομεν Οὔλυμπον δὲ Διὸς ποτὶ χαλκοβατὲς δῶ.	-uu --- u u- uu -uu- -	dactylic hexameter	masculine penthemimeral, hepthemimeral
ἄρχε· σὺ γὰρ γενεῆφι νεώτερος· οὐ γὰρ ἔμοιγε	-u u - uu-u u-uu - u u--	dactylic hexameter	feminine penthemimeral, trithemimeral
καλόν, ἐπεὶ πρότερος γενόμην καὶ πλείονα οἶδα.	-u u- uu- uu- - -uu --	dactylic hexameter	masculine penthemimeral, hepthemimeral, trithemimeral
νηπύτι’ ὡς ἄνοον κραδίην ἔχες· οὐδέ νυ τῶν περ	-uu - uu- uu- uu -u u - -	dactylic hexameter	masculine penthemimeral, hepthemimeral, trithemimeral
μέμνηαι ὅσα δὴ πάθομεν κακὰ Ἴλιον ἀμφὶ	--- uu - uu- uu -uu --	dactylic hexameter	masculine penthemimeral, hepthemimeral, trithemimeral
μοῦνοι νῶϊ θεῶν, ὅτ’ ἀγήνορι Λαομέδοντι	-- -u u- u u-uu -uu--	dactylic hexameter	masculine penthemimeral
πὰρ Διὸς ἐλθόντες θητεύσαμεν εἰς ἐνιαυτὸν	- uu --- --uu - uu--	dactylic hexameter	masculine penthemimeral
μισθῷ ἔπι ῥητῷ· ὃ δὲ σημαίνων ἐπέτελλεν.	-u u- -- u u --- uu--	dactylic hexameter	masculine penthemimeral, trithemimeral
ἤτοι ἐγὼ Τρώεσσι πόλιν πέρι τεῖχος ἔδειμα	-u u- --u u- uu -u u--	dactylic hexameter	feminine penthemimeral, hepthemimeral, trithemimeral
εὐρύ τε καὶ μάλα καλόν, ἵν’ ἄρρηκτος πόλις εἴη·	-u u - uu -u u --- uu --	dactylic hexameter	feminine penthemimeral, trithemimeral
Φοῖβε σὺ δ’εἰλίποδας ἕλικας βοῦς βουκολέεσκες	-u u -uu- uu- - -uu--	dactylic hexameter	masculine penthemimeral, hepthemimeral
Ἴδης ἐν κνημοῖσι πολυπτύχου ὑληέσσης.	-- - --u u-uu ----	dactylic hexameter	feminine penthemimeral, trithemimeral
ἀλλ’ ὅτε δὴ μισθοῖο τέλος πολυγηθέες ὧραι	- uu - --u u- uu-uu --	dactylic hexameter	feminine penthemimeral, hepthemimeral, trithemimeral
ἐξέφερον, τότε νῶϊ βιήσατο μισθὸν ἅπαντα	-uu- uu -u u-uu -u u--	dactylic hexameter	feminine penthemimeral, trithemimeral
Λαομέδων ἔκπαγλος, ἀπειλήσας δ’ἀπέπεμπε.	-uu- --u u--- uu--	dactylic hexameter	feminine penthemimeral, trithemimeral
σὺν μὲν ὅ γ’ἠπείλησε πόδας καὶ χεῖρας ὕπερθε	- u u ---u u- - -u u--	dactylic hexameter	feminine penthemimeral, hepthemimeral
δήσειν, καὶ περάαν νήσων ἔπι τηλεδαπάων·	-- - uu- -- uu -uu--	dactylic hexameter	masculine penthemimeral, hepthemimeral, trithemimeral
στεῦτο δ’ὅ γ’ἀμφοτέρων ἀπολεψέμεν οὔατα χαλκῷ.	-u u -uu- uu-uu -uu --	dactylic hexameter	masculine penthemimeral
νῶϊ δὲ ἄψορροι κίομεν κεκοτηότι θυμῷ	-u u --- uu- uu-uu --	dactylic hexameter	masculine penthemimeral, hepthemimeral
μισθοῦ χωόμενοι, τὸν ὑποστὰς οὐκ ἐτέλεσσε.	-- -uu- u u-- - uu--	dactylic hexameter	masculine penthemimeral
τοῦ δὴ νῦν λαοῖσι φέρεις χάριν, οὐδὲ μεθ’ ἡμέων	- - - --u u- uu -u u --	dactylic hexameter	feminine penthemimeral, hepthemimeral, trithemimeral
πειρᾷ ὥς κε Τρῶες ὑπερφίαλοι ἀπόλωνται	-- - - -u u-uu- uu--	dactylic hexameter	feminine penthemimeral, trithemimeral
πρόχνυ κακῶς σὺν παισὶ καὶ αἰδοίῃς ἀλόχοισι	-u u- - -u u --- uu--	dactylic hexameter	feminine penthemimeral, trithemimeral
τὸν δ’αὖτε προσέειπεν ἄναξ ἑκάεργος Ἀπόλλων·	- -- uu-u u- uu-u u--	dactylic hexameter	feminine penthemimeral, hepthemimeral, trithemimeral
ἐννοσίγαι’ οὐκ ἄν με σαόφρονα μυθήσαιο	-uu- - - u u-uu ----	dactylic hexameter	masculine penthemimeral, trithemimeral
ἔμμεναι, εἰ δὴ σοί γε βροτῶν ἕνεκα πτολεμίξω	-uu - - - u u- uu- uu--	dactylic hexameter	masculine penthemimeral, hepthemimeral, trithemimeral
δειλῶν, οἳ φύλλοισιν ἐοικότες ἄλλοτε μέν τε	-- - --u u-uu -uu - -	dactylic hexameter	feminine penthemimeral, trithemimeral
ζαφλεγέες τελέθουσιν ἀρούρης καρπὸν ἔδοντες,	-uu- uu-u u-- -u u--	dactylic hexameter	feminine penthemimeral, trithemimeral
ἄλλοτε δὲ φθινύθουσιν ἀκήριοι. ἀλλὰ τάχιστα	-uu - uu-u u-uu -u u--	dactylic hexameter	feminine penthemimeral, trithemimeral
παυώμεσθα μάχης· οἳ δ’αὐτοὶ δηριαάσθων.	---u u- - -- -uu--	dactylic hexameter	masculine penthemimeral
ὣς ἄρα φωνήσας πάλιν ἐτράπετ’· αἴδετο γάρ ῥα	- uu --- uu -uu -uu - -	dactylic hexameter	masculine penthemimeral
πατροκασιγνήτοιο μιγήμεναι ἐν παλάμῃσι.	-uu---u u-uu - uu--	dactylic hexameter	feminine penthemimeral
τὸν δὲ κασιγνήτη μάλα νείκεσε πότνια θηρῶν	- u u--- uu -uu -uu --	dactylic hexameter	masculine penthemimeral
Ἄρτεμις ἀγροτέρη, καὶ ὀνείδειον φάτο μῦθον·	-uu -uu- u u--- uu --	dactylic hexameter	masculine penthemimeral
φεύγεις δὴ ἑκάεργε, Ποσειδάωνι δὲ νίκην	-- - uu-u u---u u --	dactylic hexameter	feminine penthemimeral, trithemimeral
πᾶσαν ἐπέτρεψας, μέλεον δέ οἱ εὖχος ἔδωκας·	-u u--- uu- u u -u u--	dactylic hexameter	masculine penthemimeral, hepthemimeral
νηπύτιε τί νυ τόξον ἔχεις ἀνεμώλιον αὔτως;	-uu- u u -u u- uu-uu --	dactylic hexameter	feminine penthemimeral, hepthemimeral, trithemimeral
μή σευ νῦν ἔτι πατρὸς ἐνὶ μεγάροισιν ἀκούσω	- - - uu -u u- uu-u u--	dactylic hexameter	feminine penthemimeral, hepthemimeral, trithemimeral
εὐχομένου, ὡς τὸ πρὶν ἐν ἀθανάτοισι θεοῖσιν,	-uu- - - u u -uu-u u--	dactylic hexameter	masculine penthemimeral, trithemimeral
ἄντα Ποσειδάωνος ἐναντίβιον πολεμίζειν.	-u u---u u-uu- uu--	dactylic hexameter	feminine penthemimeral
ὣς φάτο, τὴν δ’οὔ τι προσέφη ἑκάεργος Ἀπόλλων,	- uu - - - uu- uu-u u--	dactylic hexameter	masculine penthemimeral, hepthemimeral, trithemimeral
ἀλλὰ χολωσαμένη Διὸς αἰδοίη παράκοιτις	-u u-uu- uu --- uu--	dactylic hexameter	masculine penthemimeral
νείκεσεν ἰοχέαιραν ὀνειδείοις ἐπέεσσι·	-uu -uu-u u--- uu--	dactylic hexameter	feminine penthemimeral
πῶς δὲ σὺ νῦν μέμονας κύον ἀδεὲς ἀντί’ ἐμεῖο	- u u - uu- uu -uu -u u--	dactylic hexameter	masculine penthemimeral, trithemimeral
στήσεσθαι; χαλεπή τοι ἐγὼ μένος ἀντιφέρεσθαι	--- uu- u u- uu -uu--	dactylic hexameter	masculine penthemimeral, hepthemimeral, trithemimeral
τοξοφόρῳ περ ἐούσῃ, ἐπεὶ σὲ λέοντα γυναιξὶ	-uu- u u-u u- u u-u u--	dactylic hexameter	feminine penthemimeral, hepthemimeral, trithemimeral
Ζεὺς θῆκεν, καὶ ἔδωκε κατακτάμεν ἥν κ’ἐθέλῃσθα.	- -- u u-u u-uu - uu--	dactylic hexameter	feminine penthemimeral, trithemimeral
ἤτοι βέλτερόν ἐστι κατ’ οὔρεα θῆρας ἐναίρειν	-- -uu -u u -uu -u u--	dactylic hexameter	feminine penthemimeral
ἀγροτέρας τ’ἐλάφους ἢ κρείσσοσιν ἶφι μάχεσθαι.	-uu- uu- - -uu -u u--	dactylic hexameter	masculine penthemimeral, trithemimeral
εἰ δ’ἐθέλεις πολέμοιο δαήμεναι, ὄφρ’ ἐῢ εἰδῇς	- uu- uu-u u-uu - uu --	dactylic hexameter	feminine penthemimeral, trithemimeral
ὅσσον φερτέρη εἴμ’, ὅτι μοι μένος ἀντιφερίζεις.	-- -uu - uu - uu -uu--	dactylic hexameter	masculine penthemimeral, hepthemimeral
ἦ ῥα, καὶ ἀμφοτέρας ἐπὶ καρπῷ χεῖρας ἔμαρπτε	- u u -uu- uu -- -u u--	dactylic hexameter	masculine penthemimeral
σκαιῇ, δεξιτερῇ δ’ἄρ’ ἀπ’ ὤμων αἴνυτο τόξα,	-- -uu- u u -- -uu --	dactylic hexameter	masculine penthemimeral
αὐτοῖσιν δ’ἄρ’ ἔθεινε παρ’ οὔατα μειδιόωσα	--- u u-u u -uu -uu--	dactylic hexameter	feminine penthemimeral, trithemimeral
ἐντροπαλιζομένην· ταχέες δ’ἔκπιπτον ὀϊστοί.	-uu-uu- uu- --u u--	dactylic hexameter	masculine penthemimeral, hepthemimeral
δακρυόεσσα δ’ὕπαιθα θεὰ φύγεν ὥς τε πέλεια,	-uu-u u-u u- uu - u u--	dactylic hexameter	feminine penthemimeral, hepthemimeral
ἥ ῥά θ’ὑπ’ ἴρηκος κοίλην εἰσέπτατο πέτρην	- u u --- -- --uu --	dactylic hexameter	masculine penthemimeral, hepthemimeral
χηραμόν· οὐδ’ ἄρα τῇ γε ἁλώμεναι αἴσιμον ἦεν·	-uu - uu - u u-uu -uu --	dactylic hexameter	masculine penthemimeral, trithemimeral
ὣς ἣ δακρυόεσσα φύγεν, λίπε δ’αὐτόθι τόξα.	- - -uu-u u- uu -uu --	dactylic hexameter	feminine penthemimeral, hepthemimeral
Λητὼ δὲ προσέειπε διάκτορος ἀργεϊφόντης·	-- - uu-u u-uu -uu--	dactylic hexameter	feminine penthemimeral, trithemimeral
Λητοῖ ἐγὼ δέ τοι οὔ τι μαχήσομαι· ἀργαλέον δὲ	-u u- u u - u u-uu -uu- -	dactylic hexameter	masculine penthemimeral, trithemimeral
πληκτίζεσθ’ ἀλόχοισι Διὸς νεφεληγερέταο·	--- uu-u u- uu-uu--	dactylic hexameter	feminine penthemimeral, hepthemimeral, trithemimeral
ἀλλὰ μάλα πρόφρασσα μετ’ ἀθανάτοισι θεοῖσιν	-u u- --u u -uu-u u--	dactylic hexameter	feminine penthemimeral, trithemimeral
εὔχεσθαι ἐμὲ νικῆσαι κρατερῆφι βίηφιν.	--- uu --- uu-u u--	dactylic hexameter	hepthemimeral, trithemimeral
ὣς ἄρ’ ἔφη, Λητὼ δὲ συναίνυτο καμπύλα τόξα	- u u- -- u u-uu -uu --	dactylic hexameter	masculine penthemimeral, trithemimeral
πεπτεῶτ’ ἄλλυδις ἄλλα μετὰ στροφάλιγγι κονίης.	-- -uu -u u- uu-u u--	dactylic hexameter	feminine penthemimeral, hepthemimeral
ἣ μὲν τόξα λαβοῦσα πάλιν κίε θυγατέρος ἧς·	- - -u u-u u- uu -uu- -	dactylic hexameter	feminine penthemimeral, hepthemimeral
ἣ δ’ἄρ’ Ὄλυμπον ἵκανε Διὸς ποτὶ χαλκοβατὲς δῶ,	- u u-u u-u u- uu -uu- -	dactylic hexameter	feminine penthemimeral, hepthemimeral
δακρυόεσσα δὲ πατρὸς ἐφέζετο γούνασι κούρη,	-uu-u u -u u-uu -uu --	dactylic hexameter	feminine penthemimeral
ἀμφὶ δ’ἄρ’ ἀμβρόσιος ἑανὸς τρέμε· τὴν δὲ προτὶ οἷ	-u u -uuu u-- uu - u u- -	anapaestic	
εἷλε πατὴρ Κρονίδης, καὶ ἀνείρετο ἡδὺ γελάσσας·	-u u- uu- u u-uu -u u--	dactylic hexameter	masculine penthemimeral, trithemimeral
τίς νύ σε τοιάδ’ ἔρεξε φίλον τέκος Οὐρανιώνων	- u u -u u-u u- uu -uu--	dactylic hexameter	feminine penthemimeral, hepthemimeral
μαψιδίως, ὡς εἴ τι κακὸν ῥέζουσαν ἐνωπῇ;	-uu- - - u u- --u u--	dactylic hexameter	masculine penthemimeral, hepthemimeral, trithemimeral
τὸν δ’αὖτε προσέειπεν ἐϋστέφανος κελαδεινή·	- -- uu-u u-uu- uu--	dactylic hexameter	feminine penthemimeral, trithemimeral
σή μ’ἄλοχος στυφέλιξε πάτερ λευκώλενος Ἥρη,	- uu- uu-u u- --uu --	dactylic hexameter	feminine penthemimeral, hepthemimeral, trithemimeral
ἐξ ἧς ἀθανάτοισιν ἔρις καὶ νεῖκος ἐφῆπται.	- - -uu-u u- - -u u--	dactylic hexameter	feminine penthemimeral, hepthemimeral
ὣς οἳ μὲν τοιαῦτα πρὸς ἀλλήλους ἀγόρευον·	- - - --u u --- uu--	dactylic hexameter	feminine penthemimeral, trithemimeral
αὐτὰρ Ἀπόλλων Φοῖβος ἐδύσετο Ἴλιον ἱρήν·	-u u-- -u u-uu -uu --	dactylic hexameter	feminine penthemimeral
μέμβλετο γάρ οἱ τεῖχος ἐϋδμήτοιο πόληος	-uu - - -u u---u u--	dactylic hexameter	feminine penthemimeral, trithemimeral
μὴ Δαναοὶ πέρσειαν ὑπὲρ μόρον ἤματι κείνῳ.	- uu- --u u- uu -uu --	dactylic hexameter	feminine penthemimeral, hepthemimeral, trithemimeral
οἳ δ’ἄλλοι πρὸς Ὄλυμπον ἴσαν θεοὶ αἰὲν ἐόντες,	- -- u u-u u- uu -u u--	dactylic hexameter	feminine penthemimeral, hepthemimeral, trithemimeral
οἳ μὲν χωόμενοι, οἳ δὲ μέγα κυδιόωντες·	- - -uu- - - uu -uu--	dactylic hexameter	masculine penthemimeral, hepthemimeral
κὰδ δ’ἷζον παρὰ πατρὶ κελαινεφεῖ· αὐτὰρ Ἀχιλλεὺς	- -- uu -u u-uu -u u--	dactylic hexameter	feminine penthemimeral, trithemimeral
Τρῶας ὁμῶς αὐτούς τ’ὄλεκεν καὶ μώνυχας ἵππους.	-u u- -- uu- - -uu --	dactylic hexameter	masculine penthemimeral, hepthemimeral, trithemimeral
ὡς δ’ὅτε καπνὸς ἰὼν εἰς οὐρανὸν εὐρὺν ἵκηται	- uu -u u- - -uu -u u--	dactylic hexameter	masculine penthemimeral
ἄστεος αἰθομένοιο, θεῶν δέ ἑ μῆνις ἀνῆκε,	-uu -uu-u u- u u -u u--	dactylic hexameter	feminine penthemimeral, hepthemimeral
πᾶσι δ’ἔθηκε πόνον, πολλοῖσι δὲ κήδε’ ἐφῆκεν,	-u u-u u- --u u -u u--	dactylic hexameter	masculine penthemimeral
ὣς Ἀχιλεὺς Τρώεσσι πόνον καὶ κήδε’ ἔθηκεν.	- uu- --u u- - -u u--	dactylic hexameter	feminine penthemimeral, hepthemimeral, trithemimeral
ἑστήκει δ’ὃ γέρων Πρίαμος θείου ἐπὶ πύργου,	--- u u- uu- -- uu --	dactylic hexameter	masculine penthemimeral, hepthemimeral, trithemimeral
ἐς δ’ἐνόησ’ Ἀχιλῆα πελώριον· αὐτὰρ ὑπ’ αὐτοῦ	- uu- uu-u u-uu -u u --	dactylic hexameter	feminine penthemimeral, trithemimeral
Τρῶες ἄφαρ κλονέοντο πεφυζότες, οὐδέ τις ἀλκὴ	-u u- uu-u u-uu -u u --	dactylic hexameter	feminine penthemimeral, trithemimeral
γίγνεθ’· ὃ δ’οἰμώξας ἀπὸ πύργου βαῖνε χαμᾶζε	-u u --- uu -- -u u--	dactylic hexameter	masculine penthemimeral
ὀτρύνων παρὰ τεῖχος ἀγακλειτοὺς πυλαωρούς·	--- uu -u u--- uu--	dactylic hexameter	feminine penthemimeral, trithemimeral
πεπταμένας ἐν χερσὶ πύλας ἔχετ’ εἰς ὅ κε λαοὶ	-uu- - -u u- uu - u u --	dactylic hexameter	feminine penthemimeral, hepthemimeral, trithemimeral
ἔλθωσι προτὶ ἄστυ πεφυζότες· ἦ γὰρ Ἀχιλλεὺς	--- uu -u u-uu - u u--	dactylic hexameter	feminine penthemimeral, trithemimeral
ἐγγὺς ὅδε κλονέων· νῦν οἴω λοίγι’ ἔσεσθαι.	-u u- uu- - -- -u u--	dactylic hexameter	masculine penthemimeral, trithemimeral
αὐτὰρ ἐπεί κ’ἐς τεῖχος ἀναπνεύσωσιν ἀλέντες,	-u u- - -u u---u u--	dactylic hexameter	feminine penthemimeral, trithemimeral
αὖτις ἐπανθέμεναι σανίδας πυκινῶς ἀραρυίας·	-u u-uu- uu- uu- uu--	dactylic hexameter	masculine penthemimeral, hepthemimeral
δείδια γὰρ μὴ οὖλος ἀνὴρ ἐς τεῖχος ἅληται.	-uu - - -u u- - -u u--	dactylic hexameter	feminine penthemimeral, hepthemimeral, trithemimeral
ὣς ἔφαθ’, οἳ δ’ἄνεσάν τε πύλας καὶ ἀπῶσαν ὀχῆας·	- uu - uu- u u- u u-u u--	dactylic hexameter	masculine penthemimeral, hepthemimeral, trithemimeral
αἳ δὲ πετασθεῖσαι τεῦξαν φάος· αὐτὰρ Ἀπόλλων	- u u--- -- uu -u u--	dactylic hexameter	masculine penthemimeral, hepthemimeral
ἀντίος ἐξέθορε Τρώων ἵνα λοιγὸν ἀλάλκοι.	-uu -uu- -- uu -u u--	dactylic hexameter	masculine penthemimeral, hepthemimeral
οἳ δ’ἰθὺς πόλιος καὶ τείχεος ὑψηλοῖο	- -- uu- - -uu ----	dactylic hexameter	masculine penthemimeral, trithemimeral
δίψῃ καρχαλέοι κεκονιμένοι ἐκ πεδίοιο	-- -uu- uu-uu - uu--	dactylic hexameter	masculine penthemimeral
φεῦγον· ὃ δὲ σφεδανὸν ἔφεπ’ ἔγχεϊ, λύσσα δέ οἱ κῆρ	-u u - uu- uu -uu -u u - -	dactylic hexameter	masculine penthemimeral, trithemimeral
αἰὲν ἔχε κρατερή, μενέαινε δὲ κῦδος ἀρέσθαι.	-u u- uu- uu-u u -u u--	dactylic hexameter	masculine penthemimeral, trithemimeral
ἔνθά κεν ὑψίπυλον Τροίην ἕλον υἷες Ἀχαιῶν,	-u u -uu- -- uu -u u--	dactylic hexameter	masculine penthemimeral, hepthemimeral
εἰ μὴ Ἀπόλλων Φοῖβος Ἀγήνορα δῖον ἀνῆκε	- u u-- -u u-uu -u u--	dactylic hexameter	feminine penthemimeral
φῶτ’ Ἀντήνορος υἱὸν ἀμύμονά τε κρατερόν τε.	- --uu -u u-uu - uu- -	dactylic hexameter	feminine penthemimeral
ἐν μέν οἱ κραδίῃ θάρσος βάλε, πὰρ δέ οἱ αὐτὸς	- - - uu- -- uu - u u --	dactylic hexameter	masculine penthemimeral, hepthemimeral, trithemimeral
ἔστη, ὅπως θανάτοιο βαρείας χεῖρας ἀλάλκοι	-u u- uu-u u-- -u u--	dactylic hexameter	feminine penthemimeral, trithemimeral
φηγῷ κεκλιμένος· κεκάλυπτο δ’ἄρ’ ἠέρι πολλῇ.	-- -uu- uu-u u -uu --	dactylic hexameter	masculine penthemimeral
αὐτὰρ ὅ γ’ὡς ἐνόησεν Ἀχιλλῆα πτολίπορθον	-u u - uu-u u--- uu--	dactylic hexameter	feminine penthemimeral, trithemimeral
ἔστη, πολλὰ δέ οἱ κραδίη πόρφυρε μένοντι·	-- -u u - uu- --u u--	dactylic hexameter	masculine penthemimeral, hepthemimeral
ὀχθήσας δ’ἄρα εἶπε πρὸς ὃν μεγαλήτορα θυμόν·	--- uu -u u - uu-uu --	dactylic hexameter	feminine penthemimeral, hepthemimeral, trithemimeral
ὤ μοι ἐγών· εἰ μέν κεν ὑπὸ κρατεροῦ Ἀχιλῆος	- u u- - - u u- uu- uu--	dactylic hexameter	masculine penthemimeral, hepthemimeral, trithemimeral
φεύγω, τῇ περ οἱ ἄλλοι ἀτυζόμενοι κλονέονται,	-- - u u -u u-uu- uu--	dactylic hexameter	feminine penthemimeral, trithemimeral
αἱρήσει με καὶ ὧς, καὶ ἀνάλκιδα δειροτομήσει.	--- u u - u u-uu -uu--	dactylic hexameter	masculine penthemimeral, trithemimeral
εἰ δ’ἂν ἐγὼ τούτους μὲν ὑποκλονέεσθαι ἐάσω	- u u- -- u u-uu-u u--	dactylic hexameter	masculine penthemimeral, trithemimeral
Πηλεΐδῃ Ἀχιλῆϊ, ποσὶν δ’ἀπὸ τείχεος ἄλλῃ	-uu- uu-u u- uu -uu --	dactylic hexameter	feminine penthemimeral, hepthemimeral, trithemimeral
φεύγω πρὸς πεδίον Ἰλήϊον, ὄφρ’ ἂν ἵκωμαι	-- - uu- --uu - u u--	dactylic hexameter	masculine penthemimeral, trithemimeral
Ἴδης τε κνημοὺς κατά τε ῥωπήϊα δύω·	-- - -- uu - --uu --	dactylic hexameter	masculine penthemimeral, hepthemimeral, trithemimeral
ἑσπέριος δ’ἂν ἔπειτα λοεσσάμενος ποταμοῖο	-uu- u u-u u-uu- uu--	dactylic hexameter	feminine penthemimeral, trithemimeral
ἱδρῶ ἀποψυχθεὶς προτὶ Ἴλιον ἀπονεοίμην·	-u u--- uu -uu -uu--	dactylic hexameter	masculine penthemimeral
ἀλλὰ τί ἤ μοι ταῦτα φίλος διελέξατο θυμός;	-u u - - -u u- uu-uu --	dactylic hexameter	feminine penthemimeral, hepthemimeral, trithemimeral
μή μ’ἀπαειρόμενον πόλιος πεδίον δὲ νοήσῃ	- uu-uu- uu- uu- u u--	dactylic hexameter	masculine penthemimeral, hepthemimeral
καί με μεταΐξας μάρψῃ ταχέεσσι πόδεσσιν.	- u u--- -- uu-u u--	dactylic hexameter	masculine penthemimeral, hepthemimeral
οὐκέτ’ ἔπειτ’ ἔσται θάνατον καὶ κῆρας ἀλύξαι·	-u u- -- uu- - -u u--	dactylic hexameter	masculine penthemimeral, hepthemimeral, trithemimeral
λίην γὰρ κρατερὸς περὶ πάντων ἔστ’ ἀνθρώπων.	-- - uu- uu -- - ---	dactylic hexameter	masculine penthemimeral, trithemimeral
εἰ δέ κέ οἱ προπάροιθε πόλεος κατεναντίον ἔλθω·	- u u - uu-u u- uu-uu --	dactylic hexameter	feminine penthemimeral, hepthemimeral, trithemimeral
καὶ γάρ θην τούτῳ τρωτὸς χρὼς ὀξέϊ χαλκῷ,	- - - -- -- - -uu --	dactylic hexameter	masculine penthemimeral, hepthemimeral, trithemimeral
ἐν δὲ ἴα ψυχή, θνητὸν δέ ἕ φασ’ ἄνθρωποι	- u u- -- -- u u - ---	dactylic hexameter	masculine penthemimeral, hepthemimeral, trithemimeral
ἔμμεναι· αὐτάρ οἱ Κρονίδης Ζεὺς κῦδος ὀπάζει.	-uu -- - uu- - -u u--	dactylic hexameter	masculine penthemimeral, hepthemimeral
ὣς εἰπὼν Ἀχιλῆα ἀλεὶς μένεν, ἐν δέ οἱ ἦτορ	- -- uu-u u- uu - u u --	dactylic hexameter	feminine penthemimeral, hepthemimeral, trithemimeral
ἄλκιμον ὁρμᾶτο πτολεμίζειν ἠδὲ μάχεσθαι.	-uu --- uu-- -u u--	dactylic hexameter	masculine penthemimeral
ἠΰτε πάρδαλις εἶσι βαθείης ἐκ ξυλόχοιο	-uu -uu -u u-- - uu--	dactylic hexameter	feminine penthemimeral
ἀνδρὸς θηρητῆρος ἐναντίον, οὐδέ τι θυμῷ	-- ---u u-uu -u u --	dactylic hexameter	feminine penthemimeral
ταρβεῖ οὐδὲ φοβεῖται, ἐπεί κεν ὑλαγμὸν ἀκούσῃ·	-- -u u-u u- u u-u u--	dactylic hexameter	feminine penthemimeral, hepthemimeral
εἴ περ γὰρ φθάμενός μιν ἢ οὐτάσῃ ἠὲ βάλῃσιν,	- - - uu- u u -uu -u u--	dactylic hexameter	masculine penthemimeral, trithemimeral
ἀλλά τε καὶ περὶ δουρὶ πεπαρμένη οὐκ ἀπολήγει	-u u - uu -u u-uu - uu--	dactylic hexameter	feminine penthemimeral, trithemimeral
ἀλκῆς, πρίν γ’ἠὲ ξυμβλήμεναι ἠὲ δαμῆναι·	-- - -- --uu -u u--	dactylic hexameter	masculine penthemimeral, trithemimeral
ὣς Ἀντήνορος υἱὸς ἀγαυοῦ δῖος Ἀγήνωρ	- --uu -u u-- -u u--	dactylic hexameter	feminine penthemimeral
οὐκ ἔθελεν φεύγειν, πρὶν πειρήσαιτ’ Ἀχιλῆος.	- uu- -- - --- uu--	dactylic hexameter	masculine penthemimeral, trithemimeral
ἀλλ’ ὅ γ’ἄρ’ ἀσπίδα μὲν πρόσθ’ ἔσχετο πάντοσ’ ἐΐσην,	- u u -uu - - -uu -u u--	dactylic hexameter	masculine penthemimeral
ἐγχείῃ δ’αὐτοῖο τιτύσκετο, καὶ μέγ’ ἀΰτει·	--- --u u-uu - u u--	dactylic hexameter	feminine penthemimeral, trithemimeral
ἦ δή που μάλ’ ἔολπας ἐνὶ φρεσὶ φαίδιμ’ Ἀχιλλεῦ	- - - u u-u u- uu -u u--	dactylic hexameter	feminine penthemimeral, hepthemimeral, trithemimeral
ἤματι τῷδε πόλιν πέρσειν Τρώων ἀγερώχων	-uu -u u- -- -- uu--	dactylic hexameter	masculine penthemimeral, hepthemimeral
νηπύτι’· ἦ τ’ἔτι πολλὰ τετεύξεται ἄλγε’ ἐπ’ αὐτῇ.	-uu - uu -u u-uu -u u --	dactylic hexameter	feminine penthemimeral, trithemimeral
ἐν γάρ οἱ πολέες τε καὶ ἄλκιμοι ἀνέρες εἰμέν,	- - - uu- u u -uu -uu --	dactylic hexameter	masculine penthemimeral, trithemimeral
οἳ καὶ πρόσθε φίλων τοκέων ἀλόχων τε καὶ υἱῶν	- - -u u- uu- uu- u u --	dactylic hexameter	masculine penthemimeral, hepthemimeral
Ἴλιον εἰρυόμεσθα· σὺ δ’ἐνθάδε πότμον ἐφέψεις	-uu -uu-u u -uu -u u--	dactylic hexameter	feminine penthemimeral
ὧδ’ ἔκπαγλος ἐὼν καὶ θαρσαλέος πολεμιστής.	- --u u- - -uu- uu--	dactylic hexameter	masculine penthemimeral
ἦ ῥα, καὶ ὀξὺν ἄκοντα βαρείης χειρὸς ἀφῆκε,	- u u -u u-u u-- -u u--	dactylic hexameter	feminine penthemimeral
καί ῥ’ἔβαλε κνήμην ὑπὸ γούνατος οὐδ’ ἀφάμαρτεν.	- uu- -- uu -uu - uu--	dactylic hexameter	masculine penthemimeral, trithemimeral
ἀμφὶ δέ οἱ κνημὶς νεοτεύκτου κασσιτέροιο	-u u - -- uu-- -uu--	dactylic hexameter	masculine penthemimeral, trithemimeral
σμερδαλέον κονάβησε· πάλιν δ’ἀπὸ χαλκὸς ὄρουσε	-uu- uu-u u- uu -u u--	dactylic hexameter	feminine penthemimeral, hepthemimeral, trithemimeral
βλημένου, οὐδ’ ἐπέρησε, θεοῦ δ’ἠρύκακε δῶρα.	-uu - uu-u u- --uu --	dactylic hexameter	feminine penthemimeral, hepthemimeral, trithemimeral
Πηλεΐδης δ’ὁρμήσατ’ Ἀγήνορος ἀντιθέοιο	-uu- --u u-uu -uu--	dactylic hexameter	feminine penthemimeral, trithemimeral
δεύτερος· οὐδ’ ἔτ’ ἔασεν Ἀπόλλων κῦδος ἀρέσθαι,	-uu - u u-u u-- -u u--	dactylic hexameter	feminine penthemimeral, trithemimeral
ἀλλά μιν ἐξήρπαξε, κάλυψε δ’ἄρ’ ἠέρι πολλῇ,	-u u ---u u-u u -uu --	dactylic hexameter	feminine penthemimeral
ἡσύχιον δ’ἄρα μιν πολέμου ἔκπεμπε νέεσθαι.	-uu- uu - uu- --u u--	dactylic hexameter	masculine penthemimeral, hepthemimeral, trithemimeral
αὐτὰρ ὃ Πηλεΐωνα δόλῳ ἀποέργαθε λαοῦ·	-u u -uu-u u- uu-uu --	dactylic hexameter	feminine penthemimeral, hepthemimeral
αὐτῷ γὰρ ἑκάεργος Ἀγήνορι πάντα ἐοικὼς	-- - uu-u u-uu -u u--	dactylic hexameter	feminine penthemimeral, trithemimeral
ἔστη πρόσθε ποδῶν, ὃ δ’ἐπέσσυτο ποσσὶ διώκειν·	-- -u u- u u-uu -u u--	dactylic hexameter	masculine penthemimeral
εἷος ὃ τὸν πεδίοιο διώκετο πυροφόροιο	-u u - uu-u u-uu -uu--	dactylic hexameter	feminine penthemimeral, trithemimeral
τρέψας πὰρ ποταμὸν βαθυδινήεντα Σκάμανδρον	-- - uu- uu---u u--	dactylic hexameter	masculine penthemimeral, trithemimeral
τυτθὸν ὑπεκπροθέοντα· δόλῳ δ’ἄρ’ ἔθελγεν Ἀπόλλων	-u u-uu-u u- u u-u u--	dactylic hexameter	feminine penthemimeral, hepthemimeral
ὡς αἰεὶ ἔλποιτο κιχήσεσθαι ποσὶν οἷσι·	- -- --u u--- uu --	dactylic hexameter	feminine penthemimeral, trithemimeral
τόφρ’ ἄλλοι Τρῶες πεφοβημένοι ἦλθον ὁμίλῳ	- -- -- uu-uu -u u--	dactylic hexameter	masculine penthemimeral, trithemimeral
ἀσπάσιοι προτὶ ἄστυ, πόλις δ’ἔμπλητο ἀλέντων.	-uu- uu -u u- --u u--	dactylic hexameter	feminine penthemimeral, hepthemimeral, trithemimeral
οὐδ’ ἄρα τοί γ’ἔτλαν πόλιος καὶ τείχεος ἐκτὸς	- uu - -- uu- - -uu --	dactylic hexameter	masculine penthemimeral, hepthemimeral, trithemimeral
μεῖναι ἔτ’ ἀλλήλους, καὶ γνώμεναι ὅς τε πεφεύγοι	-u u --- - -uu - u u--	dactylic hexameter	masculine penthemimeral
ὅς τ’ἔθαν’ ἐν πολέμῳ· ἀλλ’ ἐσσυμένως ἐσέχυντο	- uu - uu- - -uu- uu--	dactylic hexameter	masculine penthemimeral, trithemimeral
ἐς πόλιν, ὅν τινα τῶν γε πόδες καὶ γοῦνα σαώσαι.	- uu - uu - u u- - -u u--	dactylic hexameter	masculine penthemimeral, hepthemimeral, trithemimeral
