μῆνιν ἄειδε θεὰ Πηληϊάδεω Ἀχιλῆος	-u u-u u- --uu- uu--	dactylic hexameter	masculine penthemimeral
οὐλομένην, ἣ μυρί’ Ἀχαιοῖς ἄλγε’ ἔθηκε,	-uu- - -u u-- -u u--	dactylic hexameter	feminine penthemimeral, trithemimeral
πολλὰς δ’ἰφθίμους ψυχὰς Ἄϊδι προΐαψεν	-- --- -- uu- uu--	dactylic hexameter	masculine penthemimeral, hepthemimeral
ἡρώων, αὐτοὺς δὲ ἑλώρια τεῦχε κύνεσσιν	--- -- u u-uu -u u--	dactylic hexameter	masculine penthemimeral, trithemimeral
οἰωνοῖσί τε πᾶσι, Διὸς δ’ἐτελείετο βουλή,	---u u -u u- uu-uu --	dactylic hexameter	feminine penthemimeral, hepthemimeral
ἐξ οὗ δὴ τὰ πρῶτα διαστήτην ἐρίσαντε	- - - - -u u--- uu--	dactylic hexameter	feminine penthemimeral, trithemimeral
Ἀτρεΐδης τε ἄναξ ἀνδρῶν καὶ δῖος Ἀχιλλεύς.	-uu- u u- -- - -u u--	dactylic hexameter	masculine penthemimeral, hepthemimeral, trithemimeral
τίς τ’ἄρ σφωε θεῶν ἔριδι ξυνέηκε μάχεσθαι;	- - -u u- uu- uu-u u--	dactylic hexameter	masculine penthemimeral, hepthemimeral
Λητοῦς καὶ Διὸς υἱός· ὃ γὰρ βασιλῆϊ χολωθεὶς	-- - uu -u u - uu-u u--	dactylic hexameter	feminine penthemimeral, hepthemimeral, trithemimeral
νοῦσον ἀνὰ στρατὸν ὄρσε κακήν, ὀλέκοντο δὲ λαοί,	-u u- uu -u u- uu-u u --	dactylic hexameter	feminine penthemimeral, hepthemimeral, trithemimeral
οὕνεκα τὸν Χρύσην ἠτίμασεν ἀρητῆρα	-uu - -- --uu ----	dactylic hexameter	masculine penthemimeral, trithemimeral
Ἀτρεΐδης· ὃ γὰρ ἦλθε θοὰς ἐπὶ νῆας Ἀχαιῶν	-uu- u u -u u- uu -u u--	dactylic hexameter	feminine penthemimeral, hepthemimeral, trithemimeral
λυσόμενός τε θύγατρα φέρων τ’ἀπερείσι’ ἄποινα,	-uu- u u-u u- uu-u u--	dactylic hexameter	feminine penthemimeral, hepthemimeral, trithemimeral
στέμματ’ ἔχων ἐν χερσὶν ἑκηβόλου Ἀπόλλωνος	-u u- - -u u-uu ----	dactylic hexameter	feminine penthemimeral, trithemimeral
χρυσέῳ ἀνὰ σκήπτρῳ, καὶ λίσσετο πάντας Ἀχαιούς,	-u u- -- - -uu -u u--	dactylic hexameter	masculine penthemimeral, trithemimeral
Ἀτρεΐδα δὲ μάλιστα δύω, κοσμήτορε λαῶν·	-uu- u u-u u- --uu --	dactylic hexameter	feminine penthemimeral, hepthemimeral, trithemimeral
Ἀτρεΐδαι τε καὶ ἄλλοι ἐϋκνήμιδες Ἀχαιοί,	-uu- u u -u u---u u--	dactylic hexameter	feminine penthemimeral, trithemimeral
ὑμῖν μὲν θεοὶ δοῖεν Ὀλύμπια δώματ’ ἔχοντες	-- - - -u u-uu -u u--	dactylic hexameter	feminine penthemimeral, trithemimeral
ἐκπέρσαι Πριάμοιο πόλιν, εὖ δ’οἴκαδ’ ἱκέσθαι·	--- uu-u u- - -u u--	dactylic hexameter	feminine penthemimeral, hepthemimeral, trithemimeral
παῖδα δ’ἐμοὶ λύσαιτε φίλην, τὰ δ’ἄποινα δέχεσθαι,	-u u- --u u- u u-u u--	dactylic hexameter	feminine penthemimeral, hepthemimeral, trithemimeral
ἁζόμενοι Διὸς υἱὸν ἑκηβόλον Ἀπόλλωνα.	-uu- uu -u u-uu ----	dactylic hexameter	feminine penthemimeral, trithemimeral
ἔνθ’ ἄλλοι μὲν πάντες ἐπευφήμησαν Ἀχαιοὶ	- -- - -u u---u u--	dactylic hexameter	feminine penthemimeral, trithemimeral
αἰδεῖσθαί θ’ἱερῆα καὶ ἀγλαὰ δέχθαι ἄποινα·	--- uu-u u -uu -u u--	dactylic hexameter	feminine penthemimeral, trithemimeral
ἀλλ’ οὐκ Ἀτρεΐδῃ Ἀγαμέμνονι ἥνδανε θυμῷ,	- - -uu- uu-uu -uu --	dactylic hexameter	masculine penthemimeral
ἀλλὰ κακῶς ἀφίει, κρατερὸν δ’ἐπὶ μῦθον ἔτελλε·	-u u- uu- uu- uu -u u--	dactylic hexameter	masculine penthemimeral, hepthemimeral, trithemimeral
μή σε γέρον κοίλῃσιν ἐγὼ παρὰ νηυσὶ κιχείω	- u u- --u u- uu -u u--	dactylic hexameter	feminine penthemimeral, hepthemimeral, trithemimeral
ἢ νῦν δηθύνοντ’ ἢ ὕστερον αὖτις ἰόντα,	- - --- - -uu -u u--	dactylic hexameter	masculine penthemimeral
μή νύ τοι οὐ χραίσμῃ σκῆπτρον καὶ στέμμα θεοῖο·	- u u - -- -- - -u u--	dactylic hexameter	masculine penthemimeral, hepthemimeral, trithemimeral
τὴν δ’ἐγὼ οὐ λύσω· πρίν μιν καὶ γῆρας ἔπεισιν	- uu - -- - - - -u u--	dactylic hexameter	masculine penthemimeral, hepthemimeral, trithemimeral
ἡμετέρῳ ἐνὶ οἴκῳ ἐν Ἄργεϊ τηλόθι πάτρης	-uu- uu -u u -uu -uu --	dactylic hexameter	feminine penthemimeral, trithemimeral
ἱστὸν ἐποιχομένην καὶ ἐμὸν λέχος ἀντιόωσαν·	-u u-uu- u u- uu -uu--	dactylic hexameter	masculine penthemimeral, hepthemimeral
ἀλλ’ ἴθι μή μ’ἐρέθιζε σαώτερος ὥς κε νέηαι.	- uu - uu-u u-uu - u u--	dactylic hexameter	feminine penthemimeral, trithemimeral
ὣς ἔφατ’, ἔδεισεν δ’ὃ γέρων καὶ ἐπείθετο μύθῳ·	- uu --- u u- u u-uu --	dactylic hexameter	masculine penthemimeral, hepthemimeral
βῆ δ’ἀκέων παρὰ θῖνα πολυφλοίσβοιο θαλάσσης·	- uu- uu -u u---u u--	dactylic hexameter	feminine penthemimeral, trithemimeral
πολλὰ δ’ἔπειτ’ ἀπάνευθε κιὼν ἠρᾶθ’ ὃ γεραιὸς	-u u- uu-u u- -- u u--	dactylic hexameter	feminine penthemimeral, hepthemimeral, trithemimeral
Ἀπόλλωνι ἄνακτι, τὸν ἠΰκομος τέκε Λητώ·	---u u-u u -uu- uu --	dactylic hexameter	feminine penthemimeral
κλῦθί μευ ἀργυρότοξ’, ὃς Χρύσην ἀμφιβέβηκας	-u u -uu- - -- -uu--	dactylic hexameter	masculine penthemimeral
Κίλλάν τε ζαθέην Τενέδοιό τε ἶφι ἀνάσσεις,	-- - uu- uu-u u -u u--	dactylic hexameter	masculine penthemimeral, trithemimeral
Σμινθεῦ εἴ ποτέ τοι χαρίεντ’ ἐπὶ νηὸν ἔρεψα,	-- - uu - uu- uu -u u--	dactylic hexameter	masculine penthemimeral, hepthemimeral, trithemimeral
ἢ εἰ δή ποτέ τοι κατὰ πίονα μηρί’ ἔκηα	- - - uu - uu -uu -u u--	dactylic hexameter	masculine penthemimeral, trithemimeral
ταύρων ἠδ’ αἰγῶν, τὸ δέ μοι κρήηνον ἐέλδωρ·	-- - -- u u - --u u--	dactylic hexameter	masculine penthemimeral, hepthemimeral, trithemimeral
τίσειαν Δαναοὶ ἐμὰ δάκρυα σοῖσι βέλεσσιν.	--- uu- uu -uu -u u--	dactylic hexameter	masculine penthemimeral, trithemimeral
ὣς ἔφατ’ εὐχόμενος, τοῦ δ’ἔκλυε Φοῖβος Ἀπόλλων,	- uu -uu- - -uu -u u--	dactylic hexameter	masculine penthemimeral
βῆ δὲ κατ’ Οὐλύμποιο καρήνων χωόμενος κῆρ,	- u u ---u u-- -uu- -	dactylic hexameter	feminine penthemimeral
τόξ’ ὤμοισιν ἔχων ἀμφηρεφέα τε φαρέτρην·	- --u u- --uu- u u--	dactylic hexameter	masculine penthemimeral
ἔκλαγξαν δ’ἄρ’ ὀϊστοὶ ἐπ’ ὤμων χωομένοιο,	--- u u-u u -- -uu--	dactylic hexameter	feminine penthemimeral, trithemimeral
αὐτοῦ κινηθέντος· ὃ δ’ἤϊε νυκτὶ ἐοικώς.	-- ---u u -uu -u u--	dactylic hexameter	feminine penthemimeral
ἕζετ’ ἔπειτ’ ἀπάνευθε νεῶν, μετὰ δ’ἰὸν ἕηκε·	-u u- uu-u u- uu -u u--	dactylic hexameter	feminine penthemimeral, hepthemimeral, trithemimeral
δεινὴ δὲ κλαγγὴ γένετ’ ἀργυρέοιο βιοῖο·	-- - -- uu -uu-u u--	dactylic hexameter	masculine penthemimeral, trithemimeral
οὐρῆας μὲν πρῶτον ἐπῴχετο καὶ κύνας ἀργούς,	--- - -u u-uu - uu --	dactylic hexameter	feminine penthemimeral, trithemimeral
αὐτὰρ ἔπειτ’ αὐτοῖσι βέλος ἐχεπευκὲς ἐφιεὶς	-u u- --u u- uu-u u--	dactylic hexameter	feminine penthemimeral, hepthemimeral, trithemimeral
βάλλ’· αἰεὶ δὲ πυραὶ νεκύων καίοντο θαμειαί.	- -- u u- uu- --u u--	dactylic hexameter	masculine penthemimeral, hepthemimeral, trithemimeral
ἐννῆμαρ μὲν ἀνὰ στρατὸν ᾤχετο κῆλα θεοῖο,	--- u u- uu -uu -u u--	dactylic hexameter	masculine penthemimeral, trithemimeral
τῇ δεκάτῃ δ’ἀγορὴν δὲ καλέσσατο λαὸν Ἀχιλλεύς·	- uu- uu- u u-uu -u u--	dactylic hexameter	masculine penthemimeral, trithemimeral
τῷ γὰρ ἐπὶ φρεσὶ θῆκε θεὰ λευκώλενος Ἥρη·	- u u- uu -u u- --uu --	dactylic hexameter	feminine penthemimeral, hepthemimeral, trithemimeral
κήδετο γὰρ Δαναῶν, ὅτι ῥα θνήσκοντας ὁρᾶτο.	-uu - uu- uu - --u u--	dactylic hexameter	masculine penthemimeral, hepthemimeral, trithemimeral
οἳ δ’ἐπεὶ οὖν ἤγερθεν ὁμηγερέες τε γένοντο,	- uu - --u u-uu- u u--	dactylic hexameter	feminine penthemimeral, trithemimeral
τοῖσι δ’ἀνιστάμενος μετέφη πόδας ὠκὺς Ἀχιλλεύς·	-u u-uu- uu- uu -u u--	dactylic hexameter	masculine penthemimeral, hepthemimeral
Ἀτρεΐδη νῦν ἄμμε παλιμπλαγχθέντας ὀΐω	-uu- - -u u---u u--	dactylic hexameter	feminine penthemimeral, trithemimeral
ἂψ ἀπονοστήσειν, εἴ κεν θάνατόν γε φύγοιμεν,	- uu--- - - uu- u u--	dactylic hexameter	masculine penthemimeral, hepthemimeral
εἰ δὴ ὁμοῦ πόλεμός τε δαμᾷ καὶ λοιμὸς Ἀχαιούς·	- u u- uu- u u- - -u u--	dactylic hexameter	masculine penthemimeral, hepthemimeral, trithemimeral
ἀλλ’ ἄγε δή τινα μάντιν ἐρείομεν ἢ ἱερῆα	- uu - uu -u u-uu - uu--	dactylic hexameter	feminine penthemimeral, trithemimeral
ἢ καὶ ὀνειροπόλον, καὶ γάρ τ’ὄναρ ἐκ Διός ἐστιν,	- u u-uu- - - uu - uu --	dactylic hexameter	masculine penthemimeral, hepthemimeral
ὅς κ’εἴποι ὅ τι τόσσον ἐχώσατο Φοῖβος Ἀπόλλων,	- -- u u -u u-uu -u u--	dactylic hexameter	feminine penthemimeral, trithemimeral
εἴτ’ ἄρ’ ὅ γ’εὐχωλῆς ἐπιμέμφεται ἠδ’ ἑκατόμβης,	- u u --- uu-uu - uu--	dactylic hexameter	masculine penthemimeral
αἴ κέν πως ἀρνῶν κνίσης αἰγῶν τε τελείων	- - - -- -- -- u u--	dactylic hexameter	masculine penthemimeral, hepthemimeral, trithemimeral
βούλεται ἀντιάσας ἡμῖν ἀπὸ λοιγὸν ἀμῦναι.	-uu -uu- -- uu -u u--	dactylic hexameter	masculine penthemimeral, hepthemimeral
ἤτοι ὅ γ’ὣς εἰπὼν κατ’ ἄρ’ ἕζετο· τοῖσι δ’ἀνέστη	-u u - -- u u -uu -u u--	dactylic hexameter	masculine penthemimeral, trithemimeral
Κάλχας Θεστορίδης οἰωνοπόλων ὄχ’ ἄριστος,	-- -uu- --uu- u u--	dactylic hexameter	masculine penthemimeral
ὃς ᾔδη τά τ’ἐόντα τά τ’ἐσσόμενα πρό τ’ἐόντα,	- -- u u-u u -uu- u u--	dactylic hexameter	feminine penthemimeral, trithemimeral
καὶ νήεσσ’ ἡγήσατ’ Ἀχαιῶν Ἴλιον εἴσω	- -- --u u-- -uu --	dactylic hexameter	feminine penthemimeral, trithemimeral
ἣν διὰ μαντοσύνην, τήν οἱ πόρε Φοῖβος Ἀπόλλων·	- uu -uu- - - uu -u u--	dactylic hexameter	masculine penthemimeral, hepthemimeral
ὅ σφιν ἐὺ φρονέων ἀγορήσατο καὶ μετέειπεν·	- u u- uu- uu-uu - uu--	dactylic hexameter	masculine penthemimeral, trithemimeral
ὦ Ἀχιλεῦ κέλεαί με Διῒ φίλε μυθήσασθαι	- uu- uu- u u- uu ----	dactylic hexameter	masculine penthemimeral, hepthemimeral, trithemimeral
μῆνιν Ἀπόλλωνος ἑκατηβελέταο ἄνακτος·	-u u--- uu-uu-u u--	dactylic hexameter	masculine penthemimeral
τοὶ γὰρ ἐγὼν ἐρέω· σὺ δὲ σύνθεο καί μοι ὄμοσσον	- u u- uu- u u -uu - u u--	dactylic hexameter	masculine penthemimeral, trithemimeral
ἦ μέν μοι πρόφρων ἔπεσιν καὶ χερσὶν ἀρήξειν·	- - - -- uu- - -u u--	dactylic hexameter	masculine penthemimeral, hepthemimeral, trithemimeral
ἦ γὰρ ὀΐομαι ἄνδρα χολωσέμεν, ὃς μέγα πάντων	- u u-uu -u u-uu - uu --	dactylic hexameter	feminine penthemimeral
Ἀργείων κρατέει καί οἱ πείθονται Ἀχαιοί·	--- uu- - - --u u--	dactylic hexameter	masculine penthemimeral, hepthemimeral, trithemimeral
κρείσσων γὰρ βασιλεὺς ὅτε χώσεται ἀνδρὶ χέρηϊ·	-- - uu- uu -uu -u u--	dactylic hexameter	masculine penthemimeral, trithemimeral
εἴ περ γάρ τε χόλον γε καὶ αὐτῆμαρ καταπέψῃ,	- - - u u- u u --- uu--	dactylic hexameter	masculine penthemimeral, trithemimeral
ἀλλά τε καὶ μετόπισθεν ἔχει κότον, ὄφρα τελέσσῃ,	-u u - uu-u u- uu -u u--	dactylic hexameter	feminine penthemimeral, hepthemimeral, trithemimeral
ἐν στήθεσσιν ἑοῖσι· σὺ δὲ φράσαι εἴ με σαώσεις.	- --u u-u u - uu - u u--	dactylic hexameter	feminine penthemimeral, hepthemimeral
τὸν δ’ἀπαμειβόμενος προσέφη πόδας ὠκὺς Ἀχιλλεύς·	- uu-uu- uu- uu -u u--	dactylic hexameter	masculine penthemimeral, hepthemimeral
’θαρσήσας μάλα εἰπὲ θεοπρόπιον ὅ τι οἶσθα·	--- uu -u u-uu- u u --	dactylic hexameter	feminine penthemimeral, trithemimeral
οὐ μὰ γὰρ Ἀπόλλωνα Διῒ φίλον, ᾧ τε σὺ Κάλχαν	- u u ---u u- uu - u u --	dactylic hexameter	feminine penthemimeral, hepthemimeral
εὐχόμενος Δαναοῖσι θεοπροπίας ἀναφαίνεις,	-uu- uu-u u-uu- uu--	dactylic hexameter	feminine penthemimeral, trithemimeral
οὔ τις ἐμεῦ ζῶντος καὶ ἐπὶ χθονὶ δερκομένοιο	- u u- -- u u- uu -uu--	dactylic hexameter	masculine penthemimeral, hepthemimeral, trithemimeral
σοὶ κοίλῃς παρὰ νηυσί βαρείας χεῖρας ἐποίσει	- -- uu -u u-- -u u--	dactylic hexameter	feminine penthemimeral, trithemimeral
συμπάντων Δαναῶν, οὐδ’ ἢν Ἀγαμέμνονα εἴπῃς,	--- uu- - - uu-uu --	dactylic hexameter	masculine penthemimeral, hepthemimeral, trithemimeral
ὃς νῦν πολλὸν ἄριστος Ἀχαιῶν εὔχεται εἶναι.	- - -u u-u u-- -uu --	dactylic hexameter	feminine penthemimeral
καὶ τότε δὴ θάρσησε καὶ ηὔδα μάντις ἀμύμων·	- uu - --u u -- -u u--	dactylic hexameter	feminine penthemimeral, trithemimeral
οὔ τ’ἄρ ὅ γ’εὐχωλῆς ἐπιμέμφεται οὐδ’ ἑκατόμβης,	- u u --- uu-uu - uu--	dactylic hexameter	masculine penthemimeral
ἀλλ’ ἕνεκ’ ἀρητῆρος ὃν ἠτίμησ’ Ἀγαμέμνων,	- uu ---u u --- uu--	dactylic hexameter	feminine penthemimeral
οὐδ’ ἀπέλυσε θύγατρα καὶ οὐκ ἀπεδέξατ’ ἄποινα,	- uu-u u-u u - uu-u u--	dactylic hexameter	feminine penthemimeral, hepthemimeral
τοὔνεκ’ ἄρ’ ἄλγε’ ἔδωκεν ἑκηβόλος ἠδ’ ἔτι δώσει·	-u u -u u-u u-uu - uu --	dactylic hexameter	feminine penthemimeral
οὐδ’ ὅ γε πρὶν Δαναοῖσιν ἀεικέα λοιγὸν ἀπώσει	- u u - uu-u u-uu -u u--	dactylic hexameter	feminine penthemimeral, trithemimeral
πρίν γ’ἀπὸ πατρὶ φίλῳ δόμεναι ἑλικώπιδα κούρην	- uu -u u- uu- uu-uu --	dactylic hexameter	masculine penthemimeral, hepthemimeral
ἀπριάτην ἀνάποινον, ἄγειν θ’ἱερὴν ἑκατόμβην	-uu- uu-u u- uu- uu--	dactylic hexameter	feminine penthemimeral, hepthemimeral, trithemimeral
ἐς Χρύσην· τότε κέν μιν ἱλασσάμενοι πεπίθοιμεν.	- -- uu - u u-uu- uu--	dactylic hexameter	masculine penthemimeral, trithemimeral
ἤτοι ὅ γ’ὣς εἰπὼν κατ’ ἄρ’ ἕζετο· τοῖσι δ’ἀνέστη	-u u - -- u u -uu -u u--	dactylic hexameter	masculine penthemimeral, trithemimeral
ἥρως Ἀτρεΐδης εὐρὺ κρείων Ἀγαμέμνων	-- -uu- -- -- uu--	dactylic hexameter	masculine penthemimeral, hepthemimeral
ἀχνύμενος· μένεος δὲ μέγα φρένες ἀμφιμέλαιναι	-uu- uu- u u- uu -uu--	dactylic hexameter	masculine penthemimeral, hepthemimeral, trithemimeral
πίμπλαντ’, ὄσσε δέ οἱ πυρὶ λαμπετόωντι ἐΐκτην·	-- -u u - uu -uu-u u--	dactylic hexameter	masculine penthemimeral
Κάλχαντα πρώτιστα κάκ’ ὀσσόμενος προσέειπε·	--- --u u -uu- uu--	dactylic hexameter	feminine penthemimeral, trithemimeral
μάντι κακῶν οὐ πώ ποτέ μοι τὸ κρήγυον εἶπας·	-u u- - - uu - - -uu --	dactylic hexameter	masculine penthemimeral, hepthemimeral, trithemimeral
αἰεί τοι τὰ κάκ’ ἐστὶ φίλα φρεσὶ μαντεύεσθαι,	-- - u u -u u- uu ----	dactylic hexameter	feminine penthemimeral, hepthemimeral, trithemimeral
ἐσθλὸν δ’οὔτέ τί πω εἶπας ἔπος οὔτ’ ἐτέλεσσας·	-- -u u - -- uu - uu--	dactylic hexameter	masculine penthemimeral, hepthemimeral
καὶ νῦν ἐν Δαναοῖσι θεοπροπέων ἀγορεύεις	- - - uu-u u-uu- uu--	dactylic hexameter	feminine penthemimeral, trithemimeral
ὡς δὴ τοῦδ’ ἕνεκά σφιν ἑκηβόλος ἄλγεα τεύχει,	- - - uu- u u-uu -uu --	dactylic hexameter	masculine penthemimeral, trithemimeral
οὕνεκ’ ἐγὼ κούρης Χρυσηΐδος ἀγλά’ ἄποινα	-u u- -- --uu -u u--	dactylic hexameter	masculine penthemimeral, trithemimeral
οὐκ ἔθελον δέξασθαι, ἐπεὶ πολὺ βούλομαι αὐτὴν	- uu- --u u- uu -uu --	dactylic hexameter	feminine penthemimeral, hepthemimeral, trithemimeral
οἴκοι ἔχειν· καὶ γάρ ῥα Κλυταιμνήστρης προβέβουλα	-u u- - - u u--- uu--	dactylic hexameter	masculine penthemimeral, trithemimeral
κουριδίης ἀλόχου, ἐπεὶ οὔ ἑθέν ἐστι χερείων,	-uu- uu- uu - uu -u u--	dactylic hexameter	masculine penthemimeral, hepthemimeral, trithemimeral
οὐ δέμας οὐδὲ φυήν, οὔτ’ ἂρ φρένας οὔτέ τι ἔργα.	- uu -u u- - - uu -u u --	dactylic hexameter	masculine penthemimeral, hepthemimeral
ἀλλὰ καὶ ὧς ἐθέλω δόμεναι πάλιν εἰ τό γ’ἄμεινον·	-u u - uu- uu- uu - u u--	dactylic hexameter	masculine penthemimeral, hepthemimeral, trithemimeral
βούλομ’ ἐγὼ λαὸν σῶν ἔμμεναι ἢ ἀπολέσθαι·	-u u- -- - -uu - uu--	dactylic hexameter	masculine penthemimeral, trithemimeral
αὐτὰρ ἐμοὶ γέρας αὐτίχ’ ἑτοιμάσατ’ ὄφρα μὴ οἶος	-u u- uu -u u-uu -u u --	dactylic hexameter	feminine penthemimeral, trithemimeral
Ἀργείων ἀγέραστος ἔω, ἐπεὶ οὐδὲ ἔοικε·	--- uu-u u- uu -u u--	dactylic hexameter	feminine penthemimeral, hepthemimeral, trithemimeral
λεύσσετε γὰρ τό γε πάντες ὅ μοι γέρας ἔρχεται ἄλλῃ.	-uu - u u -u u - uu -uu --	dactylic hexameter	feminine penthemimeral, hepthemimeral, trithemimeral
τὸν δ’ἠμείβετ’ ἔπειτα ποδάρκης δῖος Ἀχιλλεύς·	- --u u-u u-- -u u--	dactylic hexameter	feminine penthemimeral
Ἀτρεΐδη κύδιστε φιλοκτεανώτατε πάντων,	-uu- --u u-uu-uu --	dactylic hexameter	feminine penthemimeral, trithemimeral
πῶς γάρ τοι δώσουσι γέρας μεγάθυμοι Ἀχαιοί;	- - - --u u- uu-u u--	dactylic hexameter	feminine penthemimeral, hepthemimeral, trithemimeral
οὐδέ τί που ἴδμεν ξυνήϊα κείμενα πολλά·	-u u - -- --uu -uu --	dactylic hexameter	masculine penthemimeral, trithemimeral
ἀλλὰ τὰ μὲν πολίων ἐξεπράθομεν, τὰ δέδασται,	-u u - uu- --uu- u u--	dactylic hexameter	masculine penthemimeral, trithemimeral
λαοὺς δ’οὐκ ἐπέοικε παλίλλογα ταῦτ’ ἐπαγείρειν.	-- - uu-u u-uu - uu--	dactylic hexameter	feminine penthemimeral, trithemimeral
ἀλλὰ σὺ μὲν νῦν τήνδε θεῷ πρόες· αὐτὰρ Ἀχαιοὶ	-u u - - -u u- uu -u u--	dactylic hexameter	feminine penthemimeral, hepthemimeral, trithemimeral
τριπλῇ τετραπλῇ τ’ἀποτείσομεν, αἴ κέ ποθι Ζεὺς	-- --- uu-uu - u u- -	dactylic hexameter	masculine penthemimeral
δῷσι πόλιν Τροίην εὐτείχεον ἐξαλαπάξαι.	-u u- -- --uu -uu--	dactylic hexameter	masculine penthemimeral, trithemimeral
τὸν δ’ἀπαμειβόμενος προσέφη κρείων Ἀγαμέμνων·	- uu-uu- uu- -- uu--	dactylic hexameter	masculine penthemimeral, hepthemimeral
μὴ δ’οὕτως ἀγαθός περ ἐὼν θεοείκελ’ Ἀχιλλεῦ	- -- uu- u u- uu-u u--	dactylic hexameter	masculine penthemimeral, hepthemimeral, trithemimeral
κλέπτε νόῳ, ἐπεὶ οὐ παρελεύσεαι οὐδέ με πείσεις.	-u u- uu - uu-uu -u u --	dactylic hexameter	masculine penthemimeral, trithemimeral
ἦ ἐθέλεις ὄφρ’ αὐτὸς ἔχῃς γέρας, αὐτὰρ ἔμ’ αὔτως	- uu- - -u u- uu -u u --	dactylic hexameter	feminine penthemimeral, hepthemimeral, trithemimeral
ἧσθαι δευόμενον, κέλεαι δέ με τήνδ’ ἀποδοῦναι;	-- -uu- uu- u u - uu--	dactylic hexameter	masculine penthemimeral, hepthemimeral
ἀλλ’ εἰ μὲν δώσουσι γέρας μεγάθυμοι Ἀχαιοὶ	- - - --u u- uu-u u--	dactylic hexameter	feminine penthemimeral, hepthemimeral, trithemimeral
ἄρσαντες κατὰ θυμὸν ὅπως ἀντάξιον ἔσται·	--- uu -u u- --uu --	dactylic hexameter	feminine penthemimeral, hepthemimeral, trithemimeral
εἰ δέ κε μὴ δώωσιν ἐγὼ δέ κεν αὐτὸς ἕλωμαι	- u u - --u u- u u -u u--	dactylic hexameter	feminine penthemimeral, hepthemimeral, trithemimeral
ἢ τεὸν ἢ Αἴαντος ἰὼν γέρας, ἢ Ὀδυσῆος	- uu - --u u- uu - uu--	dactylic hexameter	feminine penthemimeral, hepthemimeral, trithemimeral
ἄξω ἑλών· ὃ δέ κεν κεχολώσεται ὅν κεν ἵκωμαι.	-u u- u u - uu-uu - u u--	dactylic hexameter	masculine penthemimeral, trithemimeral
ἀλλ’ ἤτοι μὲν ταῦτα μεταφρασόμεσθα καὶ αὖτις,	- -- - -u u-uu-u u --	dactylic hexameter	feminine penthemimeral, trithemimeral
νῦν δ’ἄγε νῆα μέλαιναν ἐρύσσομεν εἰς ἅλα δῖαν,	- uu -u u-u u-uu - uu --	dactylic hexameter	feminine penthemimeral
ἐν δ’ἐρέτας ἐπιτηδὲς ἀγείρομεν, ἐς δ’ἑκατόμβην	- uu- uu-u u-uu - uu--	dactylic hexameter	feminine penthemimeral, trithemimeral
θείομεν, ἂν δ’αὐτὴν Χρυσηΐδα καλλιπάρῃον	-uu - -- --uu -uu--	dactylic hexameter	masculine penthemimeral, trithemimeral
βήσομεν· εἷς δέ τις ἀρχὸς ἀνὴρ βουληφόρος ἔστω,	-uu - u u -u u- --uu --	dactylic hexameter	feminine penthemimeral, hepthemimeral, trithemimeral
ἢ Αἴας ἢ Ἰδομενεὺς ἢ δῖος Ὀδυσσεὺς	- -- - -uu- - -u u--	dactylic hexameter	hepthemimeral, trithemimeral
ἠὲ σὺ Πηλεΐδη πάντων ἐκπαγλότατ’ ἀνδρῶν,	-u u -uu- -- --uu --	dactylic hexameter	masculine penthemimeral, hepthemimeral
ὄφρ’ ἥμιν ἑκάεργον ἱλάσσεαι ἱερὰ ῥέξας.	- -- uu-u u-uu -uu --	dactylic hexameter	feminine penthemimeral, trithemimeral
τὸν δ’ἄρ’ ὑπόδρα ἰδὼν προσέφη πόδας ὠκὺς Ἀχιλλεύς·	- u u-u u- uu- uu -u u--	dactylic hexameter	masculine penthemimeral, hepthemimeral
’ὤ μοι ἀναιδείην ἐπιειμένε κερδαλεόφρον	- u u--- uu-uu -uu--	dactylic hexameter	masculine penthemimeral
πῶς τίς τοι πρόφρων ἔπεσιν πείθηται Ἀχαιῶν	- - - -- uu- --u u--	dactylic hexameter	masculine penthemimeral, hepthemimeral, trithemimeral
ἢ ὁδὸν ἐλθέμεναι ἢ ἀνδράσιν ἶφι μάχεσθαι;	- uu -uu- - -uu -u u--	dactylic hexameter	masculine penthemimeral
οὐ γὰρ ἐγὼ Τρώων ἕνεκ’ ἤλυθον αἰχμητάων	- u u- -- uu -uu ----	dactylic hexameter	masculine penthemimeral, trithemimeral
δεῦρο μαχησόμενος, ἐπεὶ οὔ τί μοι αἴτιοί εἰσιν·	-u u-uu- uu - u u -uu --	dactylic hexameter	masculine penthemimeral, hepthemimeral
οὐ γὰρ πώποτ’ ἐμὰς βοῦς ἤλασαν οὐδὲ μὲν ἵππους,	- - -u u- - -uu -u u --	dactylic hexameter	masculine penthemimeral
οὐδέ ποτ’ ἐν Φθίῃ ἐριβώλακι βωτιανείρῃ	-u u - -- uu-uu -uu--	dactylic hexameter	masculine penthemimeral, trithemimeral
καρπὸν ἐδηλήσαντ’, ἐπεὶ ἦ μάλα πολλὰ μεταξὺ	-u u--- uu - uu -u u--	dactylic hexameter	masculine penthemimeral, hepthemimeral
οὔρεά τε σκιόεντα θάλασσά τε ἠχήεσσα·	-uu - uu-u u-u u ----	dactylic hexameter	feminine penthemimeral, trithemimeral
ἀλλὰ σοὶ ὦ μέγ’ ἀναιδὲς ἅμ’ ἑσπόμεθ’ ὄφρα σὺ χαίρῃς,	-u u - u u-u u -uu -u u --	dactylic hexameter	feminine penthemimeral, trithemimeral
τιμὴν ἀρνύμενοι Μενελάῳ σοί τε κυνῶπα	-- -uu- uu-- - u u--	dactylic hexameter	masculine penthemimeral
πρὸς Τρώων· τῶν οὔ τι μετατρέπῃ οὐδ’ ἀλεγίζεις·	- -- - - u u-uu - uu--	dactylic hexameter	masculine penthemimeral, trithemimeral
καὶ δή μοι γέρας αὐτὸς ἀφαιρήσεσθαι ἀπειλεῖς,	- - - uu -u u---u u--	dactylic hexameter	feminine penthemimeral, trithemimeral
ᾧ ἔπι πολλὰ μόγησα, δόσαν δέ μοι υἷες Ἀχαιῶν.	- uu -u u-u u- u u -u u--	dactylic hexameter	feminine penthemimeral, hepthemimeral
οὐ μὲν σοί ποτε ἶσον ἔχω γέρας ὁππότ’ Ἀχαιοὶ	- - - uu -u u- uu -u u--	dactylic hexameter	feminine penthemimeral, hepthemimeral, trithemimeral
Τρώων ἐκπέρσωσ’ εὖ ναιόμενον πτολίεθρον·	-- --- - -uu- uu--	dactylic hexameter	masculine penthemimeral
ἀλλὰ τὸ μὲν πλεῖον πολυάϊκος πολέμοιο	-u u - -- uu--- uu--	dactylic hexameter	masculine penthemimeral, trithemimeral
χεῖρες ἐμαὶ διέπουσ’· ἀτὰρ ἤν ποτε δασμὸς ἵκηται,	-u u- uu- uu - uu -u u--	dactylic hexameter	masculine penthemimeral, hepthemimeral, trithemimeral
σοὶ τὸ γέρας πολὺ μεῖζον, ἐγὼ δ’ὀλίγον τε φίλον τε	- u u- uu -u u- uu- u u- -	dactylic hexameter	feminine penthemimeral, hepthemimeral, trithemimeral
ἔρχομ’ ἔχων ἐπὶ νῆας, ἐπεί κε κάμω πολεμίζων.	-u u- uu -u u- u u- uu--	dactylic hexameter	feminine penthemimeral, hepthemimeral, trithemimeral
νῦν δ’εἶμι Φθίην δ’,ἐπεὶ ἦ πολὺ φέρτερόν ἐστιν	- -- -- uu - uu -uu --	dactylic hexameter	masculine penthemimeral, hepthemimeral, trithemimeral
οἴκαδ’ ἴμεν σὺν νηυσὶ κορωνίσιν, οὐδέ σ’ὀΐω	-u u- - -u u-uu -u u--	dactylic hexameter	feminine penthemimeral, trithemimeral
ἐνθάδ’ ἄτιμος ἐὼν ἄφενος καὶ πλοῦτον ἀφύξειν.	-u u-u u- uu- - -u u--	dactylic hexameter	masculine penthemimeral, hepthemimeral
τὸν δ’ἠμείβετ’ ἔπειτα ἄναξ ἀνδρῶν Ἀγαμέμνων·	- --u u-u u- -- uu--	dactylic hexameter	feminine penthemimeral, hepthemimeral
φεῦγε μάλ’ εἴ τοι θυμὸς ἐπέσσυται, οὐδέ σ’ἔγωγε	-u u - - -u u-uu -u u--	dactylic hexameter	feminine penthemimeral, trithemimeral
λίσσομαι εἵνεκ’ ἐμεῖο μένειν· πάρ’ ἔμοιγε καὶ ἄλλοι	-uu -u u-u u- u u-u u --	dactylic hexameter	feminine penthemimeral, hepthemimeral
οἵ κέ με τιμήσουσι, μάλιστα δὲ μητίετα Ζεύς.	- u u ---u u-u u -uu- -	dactylic hexameter	feminine penthemimeral
ἔχθιστος δέ μοί ἐσσι διοτρεφέων βασιλήων·	--- u u -u u-uu- uu--	dactylic hexameter	feminine penthemimeral, trithemimeral
αἰεὶ γάρ τοι ἔρις τε φίλη πόλεμοί τε μάχαι τε·	-- - u u- u u- uu- u u- -	dactylic hexameter	masculine penthemimeral, hepthemimeral, trithemimeral
εἰ μάλα καρτερός ἐσσι, θεός που σοὶ τό γ’ἔδωκεν·	- uu -uu -u u- - - u u--	dactylic hexameter	feminine penthemimeral, hepthemimeral
οἴκαδ’ ἰὼν σὺν νηυσί τε σῇς καὶ σοῖς ἑτάροισι	-u u- - -u u - - - uu--	dactylic hexameter	feminine penthemimeral, hepthemimeral, trithemimeral
Μυρμιδόνεσσιν ἄνασσε, σέθεν δ’ἐγὼ οὐκ ἀλεγίζω,	-uu-u u-u u- uu - uu--	dactylic hexameter	feminine penthemimeral, hepthemimeral
οὐδ’ ὄθομαι κοτέοντος· ἀπειλήσω δέ τοι ὧδε·	- uu- uu-u u--- u u --	dactylic hexameter	feminine penthemimeral, trithemimeral
ὡς ἔμ’ ἀφαιρεῖται Χρυσηΐδα Φοῖβος Ἀπόλλων,	- u u--- --uu -u u--	dactylic hexameter	masculine penthemimeral
τὴν μὲν ἐγὼ σὺν νηΐ τ’ ἐμῇ καὶ ἐμοῖς ἑτάροισι	- u u- - -u u- u u- uu--	dactylic hexameter	feminine penthemimeral, hepthemimeral, trithemimeral
πέμψω, ἐγὼ δέ κ’ἄγω Βρισηΐδα καλλιπάρῃον	-u u- u u- --uu -uu--	dactylic hexameter	masculine penthemimeral, trithemimeral
αὐτὸς ἰὼν κλισίην δὲ τὸ σὸν γέρας ὄφρ’ ἐῢ εἰδῇς	-u u- uu- u u - uu - uu --	dactylic hexameter	masculine penthemimeral, hepthemimeral, trithemimeral
ὅσσον φέρτερός εἰμι σέθεν, στυγέῃ δὲ καὶ ἄλλος	-- -uu -u u- uu- u u --	dactylic hexameter	feminine penthemimeral, hepthemimeral
ἶσον ἐμοὶ φάσθαι καὶ ὁμοιωθήμεναι ἄντην.	-u u- -- u u---uu --	dactylic hexameter	masculine penthemimeral, trithemimeral
ὣς φάτο· Πηλεΐωνι δ’ ἄχος γένετ’, ἐν δέ οἱ ἦτορ	- uu -uu-u u- uu - u u --	dactylic hexameter	feminine penthemimeral, hepthemimeral
στήθεσσιν λασίοισι διάνδιχα μερμήριξεν,	--- uu-u u-uu ----	dactylic hexameter	feminine penthemimeral, trithemimeral
ἢ ὅ γε φάσγανον ὀξὺ ἐρυσσάμενος παρὰ μηροῦ	- u u -uu -u u-uu- uu --	dactylic hexameter	feminine penthemimeral
τοὺς μὲν ἀναστήσειεν, ὃ δ’Ἀτρεΐδην ἐναρίζοι,	- u u---u u -uu- uu--	dactylic hexameter	feminine penthemimeral
ἦε χόλον παύσειεν ἐρητύσειέ τε θυμόν.	-u u- --u u---u u --	dactylic hexameter	feminine penthemimeral, trithemimeral
ἧος ὃ ταῦθ’ ὥρμαινε κατὰ φρένα καὶ κατὰ θυμόν,	-u u - --u u- uu - uu --	dactylic hexameter	feminine penthemimeral, hepthemimeral, trithemimeral
ἕλκετο δ’ἐκ κολεοῖο μέγα ξίφος, ἦλθε δ’Ἀθήνη	-uu - uu-u u- uu -u u--	dactylic hexameter	feminine penthemimeral, hepthemimeral, trithemimeral
οὐρανόθεν· πρὸ γὰρ ἧκε θεὰ λευκώλενος Ἥρη	-uu- u u -u u- --uu --	dactylic hexameter	feminine penthemimeral, hepthemimeral, trithemimeral
ἄμφω ὁμῶς θυμῷ φιλέουσά τε κηδομένη τε·	-u u- -- uu-u u -uu- -	dactylic hexameter	masculine penthemimeral, trithemimeral
στῆ δ’ὄπιθεν, ξανθῆς δὲ κόμης ἕλε Πηλεΐωνα	- uu- -- u u- uu -uu--	dactylic hexameter	masculine penthemimeral, hepthemimeral, trithemimeral
οἴῳ φαινομένη· τῶν δ’ἄλλων οὔ τις ὁρᾶτο·	-- -uu- - -- - u u--	dactylic hexameter	masculine penthemimeral
θάμβησεν δ’Ἀχιλεύς, μετὰ δ’ἐτράπετ’, αὐτίκα δ’ἔγνω	--- uu- uu -uu -uu --	dactylic hexameter	masculine penthemimeral, trithemimeral
Παλλάδ’ Ἀθηναίην· δεινὼ δέ οἱ ὄσσε φάανθεν·	-u u--- -- u u -u u--	dactylic hexameter	masculine penthemimeral, hepthemimeral
καί μιν φωνήσας ἔπεα πτερόεντα προσηύδα·	- - --- uu- uu-u u--	dactylic hexameter	masculine penthemimeral, hepthemimeral
τίπτ’ αὖτ’ αἰγιόχοιο Διὸς τέκος εἰλήλουθας;	- - -uu-u u- uu ----	dactylic hexameter	feminine penthemimeral, hepthemimeral
ἦ ἵνα ὕβριν ἴδῃ Ἀγαμέμνονος Ἀτρεΐδαο;	- uu -u u- uu-uu -uu--	dactylic hexameter	masculine penthemimeral
ἀλλ’ ἔκ τοι ἐρέω, τὸ δὲ καὶ τελέεσθαι ὀΐω·	- - - uu- u u - uu-u u--	dactylic hexameter	masculine penthemimeral, hepthemimeral, trithemimeral
ᾗς ὑπεροπλίῃσι τάχ’ ἄν ποτε θυμὸν ὀλέσσῃ.	- uu---u u - uu -u u--	dactylic hexameter	feminine penthemimeral, hepthemimeral
τὸν δ’αὖτε προσέειπε θεὰ γλαυκῶπις Ἀθήνη·	- -- uu-u u- --u u--	dactylic hexameter	feminine penthemimeral, hepthemimeral, trithemimeral
ἦλθον ἐγὼ παύσουσα τὸ σὸν μένος, αἴ κε πίθηαι,	-u u- --u u - uu - u u--	dactylic hexameter	feminine penthemimeral, hepthemimeral, trithemimeral
οὐρανόθεν· πρὸ δέ μ’ἧκε θεὰ λευκώλενος Ἥρη	-uu- u u -u u- --uu --	dactylic hexameter	feminine penthemimeral, hepthemimeral, trithemimeral
ἄμφω ὁμῶς θυμῷ φιλέουσά τε κηδομένη τε·	-u u- -- uu-u u -uu- -	dactylic hexameter	masculine penthemimeral, trithemimeral
ἀλλ’ ἄγε λῆγ’ ἔριδος, μηδὲ ξίφος ἕλκεο χειρί·	- uu - uu- -- uu -uu --	dactylic hexameter	masculine penthemimeral, hepthemimeral, trithemimeral
ἀλλ’ ἤτοι ἔπεσιν μὲν ὀνείδισον ὡς ἔσεταί περ·	- -- uu- u u-uu - uu- -	dactylic hexameter	masculine penthemimeral, trithemimeral
ὧδε γὰρ ἐξερέω, τὸ δὲ καὶ τετελεσμένον ἔσται·	-u u -uu- u u - uu-uu --	dactylic hexameter	masculine penthemimeral, hepthemimeral
καί ποτέ τοι τρὶς τόσσα παρέσσεται ἀγλαὰ δῶρα	- uu - - -u u-uu -uu --	dactylic hexameter	feminine penthemimeral, trithemimeral
ὕβριος εἵνεκα τῆσδε· σὺ δ’ἴσχεο, πείθεο δ’ἡμῖν.	-uu -uu -u u -uu -uu --	dactylic hexameter	feminine penthemimeral
τὴν δ’ἀπαμειβόμενος προσέφη πόδας ὠκὺς Ἀχιλλεύς·	- uu-uu- uu- uu -u u--	dactylic hexameter	masculine penthemimeral, hepthemimeral
’χρὴ μὲν σφωΐτερόν γε θεὰ ἔπος εἰρύσσασθαι	- - -uu- u u- uu ----	dactylic hexameter	masculine penthemimeral, hepthemimeral
καὶ μάλα περ θυμῷ κεχολωμένον· ὧς γὰρ ἄμεινον·	- uu - -- uu-uu - u u--	dactylic hexameter	masculine penthemimeral, trithemimeral
ὅς κε θεοῖς ἐπιπείθηται μάλα τ’ἔκλυον αὐτοῦ.	- u u- uu--- uu -uu --	dactylic hexameter	hepthemimeral, trithemimeral
ἦ καὶ ἐπ’ ἀργυρέῃ κώπῃ σχέθε χεῖρα βαρεῖαν,	- u u -uu- -- uu -u u--	dactylic hexameter	masculine penthemimeral, hepthemimeral
ἂψ δ’ἐς κουλεὸν ὦσε μέγα ξίφος, οὐδ’ ἀπίθησε	- - -uu -u u- uu - uu--	dactylic hexameter	feminine penthemimeral, hepthemimeral
μύθῳ Ἀθηναίης· ἣ δ’Οὔλυμπον δὲ βεβήκει	-u u--- - --- u u--	dactylic hexameter	masculine penthemimeral
δώματ’ ἐς αἰγιόχοιο Διὸς μετὰ δαίμονας ἄλλους.	-u u -uu-u u- uu -uu --	dactylic hexameter	feminine penthemimeral, hepthemimeral
Πηλεΐδης δ’ἐξαῦτις ἀταρτηροῖς ἐπέεσσιν	-uu- --u u--- uu--	dactylic hexameter	feminine penthemimeral, trithemimeral
Ἀτρεΐδην προσέειπε, καὶ οὔ πω λῆγε χόλοιο·	-uu- uu-u u - - -u u--	dactylic hexameter	feminine penthemimeral, hepthemimeral, trithemimeral
οἰνοβαρές, κυνὸς ὄμματ’ ἔχων, κραδίην δ’&nbnbsp;ἐλάφοιο,	-uu- uu -u u- uu- uu--	dactylic hexameter	feminine penthemimeral, hepthemimeral, trithemimeral
οὔτέ ποτ’ ἐς πόλεμον ἅμα λαῷ θωρηχθῆναι	-u u - uu- uu -- ----	dactylic hexameter	masculine penthemimeral, trithemimeral
οὔτε λόχον δ’ἰέναι σὺν ἀριστήεσσιν Ἀχαιῶν	-u u- uu- u u---u u--	dactylic hexameter	masculine penthemimeral, trithemimeral
τέτληκας θυμῷ· τὸ δέ τοι κὴρ εἴδεται εἶναι.	--- -- u u - - -uu --	dactylic hexameter	masculine penthemimeral, hepthemimeral, trithemimeral
ἦ πολὺ λώϊόν ἐστι κατὰ στρατὸν εὐρὺν Ἀχαιῶν	- uu -uu -u u- uu -u u--	dactylic hexameter	feminine penthemimeral, hepthemimeral
δῶρ’ ἀποαιρεῖσθαι ὅς τις σέθεν ἀντίον εἴπῃ·	- uu--- - - uu -uu --	dactylic hexameter	masculine penthemimeral, hepthemimeral
δημοβόρος βασιλεὺς ἐπεὶ οὐτιδανοῖσιν ἀνάσσεις·	-uu- uu- uu -uu-u u--	dactylic hexameter	masculine penthemimeral, trithemimeral
ἦ γὰρ ἂν Ἀτρεΐδη νῦν ὕστατα λωβήσαιο.	- u u -uu- - -uu ----	dactylic hexameter	masculine penthemimeral
ἀλλ’ ἔκ τοι ἐρέω καὶ ἐπὶ μέγαν ὅρκον ὀμοῦμαι·	- - - uu- u u- uu -u u--	dactylic hexameter	masculine penthemimeral, hepthemimeral, trithemimeral
ναὶ μὰ τόδε σκῆπτρον, τὸ μὲν οὔ ποτε φύλλα καὶ ὄζους	- u u- -- u u - uu -u u --	dactylic hexameter	masculine penthemimeral, hepthemimeral, trithemimeral
φύσει, ἐπεὶ δὴ πρῶτα τομὴν ἐν ὄρεσσι λέλοιπεν,	-u u- - -u u- u u-u u--	dactylic hexameter	feminine penthemimeral, hepthemimeral, trithemimeral
οὐδ’ ἀναθηλήσει· περὶ γάρ ῥά ἑ χαλκὸς ἔλεψε	- uu--- uu - u u -u u--	dactylic hexameter	masculine penthemimeral, hepthemimeral
φύλλά τε καὶ φλοιόν· νῦν αὖτέ μιν υἷες Ἀχαιῶν	-u u - -- - -u u -u u--	dactylic hexameter	masculine penthemimeral, trithemimeral
ἐν παλάμῃς φορέουσι δικασπόλοι, οἵ τε θέμιστας	- uu- uu-u u-uu - u u--	dactylic hexameter	feminine penthemimeral, trithemimeral
πρὸς Διὸς εἰρύαται· ὃ δέ τοι μέγας ἔσσεται ὅρκος·	- uu -uu- u u - uu -uu --	dactylic hexameter	masculine penthemimeral, hepthemimeral
ἦ ποτ’ Ἀχιλλῆος ποθὴ ἵξεται υἷας Ἀχαιῶν	- u u--- uu -uu -u u--	dactylic hexameter	masculine penthemimeral
σύμπαντας· τότε δ’οὔ τι δυνήσεαι ἀχνύμενός περ	--- uu - u u-uu -uu- -	dactylic hexameter	masculine penthemimeral, trithemimeral
χραισμεῖν, εὖτ’ ἂν πολλοὶ ὑφ’ Ἕκτορος ἀνδροφόνοιο	-- - - -u u -uu -uu--	dactylic hexameter	feminine penthemimeral, trithemimeral
θνήσκοντες πίπτωσι· σὺ δ’ἔνδοθι θυμὸν ἀμύξεις	--- --u u -uu -u u--	dactylic hexameter	feminine penthemimeral, trithemimeral
χωόμενος ὅ τ’ἄριστον Ἀχαιῶν οὐδὲν ἔτισας.	-uu- u u-u u-- -u u--	dactylic hexameter	feminine penthemimeral, trithemimeral
ὣς φάτο Πηλεΐδης, ποτὶ δὲ σκῆπτρον βάλε γαίῃ	- uu -uu- uu - -- uu --	dactylic hexameter	masculine penthemimeral, hepthemimeral
χρυσείοις ἥλοισι πεπαρμένον, ἕζετο δ’αὐτός·	--- --u u-uu -uu --	dactylic hexameter	feminine penthemimeral, trithemimeral
Ἀτρεΐδης δ’ἑτέρωθεν ἐμήνιε· τοῖσι δὲ Νέστωρ	-uu- uu-u u-uu -u u --	dactylic hexameter	feminine penthemimeral, trithemimeral
ἡδυεπὴς ἀνόρουσε λιγὺς Πυλίων ἀγορητής,	-uu- uu-u u- uu- uu--	dactylic hexameter	feminine penthemimeral, hepthemimeral, trithemimeral
τοῦ καὶ ἀπὸ γλώσσης μέλιτος γλυκίων ῥέεν αὐδή·	- u u- -- uu- uu- uu --	dactylic hexameter	masculine penthemimeral, hepthemimeral, trithemimeral
τῷ δ’ἤδη δύο μὲν γενεαὶ μερόπων ἀνθρώπων	- -- uu - uu- uu- ---	dactylic hexameter	masculine penthemimeral, hepthemimeral, trithemimeral
ἐφθίαθ’, οἵ οἱ πρόσθεν ἅμα τράφεν ἠδ’ ἐγένοντο	-uu - - -u u- uu - uu--	dactylic hexameter	feminine penthemimeral, hepthemimeral, trithemimeral
ἐν Πύλῳ ἠγαθέῃ, μετὰ δὲ τριτάτοισιν ἄνασσεν·	- uu -uu- uu - uu-u u--	dactylic hexameter	masculine penthemimeral, hepthemimeral
ὅ σφιν ἐὺ φρονέων ἀγορήσατο καὶ μετέειπεν·	- u u- uu- uu-uu - uu--	dactylic hexameter	masculine penthemimeral, trithemimeral
ὦ πόποι ἦ μέγα πένθος Ἀχαιΐδα γαῖαν ἱκάνει·	- uu - uu -u u-uu -u u--	dactylic hexameter	feminine penthemimeral, trithemimeral
ἦ κεν γηθήσαι Πρίαμος Πριάμοιό τε παῖδες	- - --- uu- uu-u u --	dactylic hexameter	masculine penthemimeral, hepthemimeral
ἄλλοι τε Τρῶες μέγα κεν κεχαροίατο θυμῷ	-- - -- uu - uu-uu --	dactylic hexameter	masculine penthemimeral, hepthemimeral, trithemimeral
εἰ σφῶϊν τάδε πάντα πυθοίατο μαρναμένοιϊν,	- -- uu -u u-uu -uu--	dactylic hexameter	feminine penthemimeral, trithemimeral
οἳ περὶ μὲν βουλὴν Δαναῶν, περὶ δ’ἐστὲ μάχεσθαι.	- uu - -- uu- uu -u u--	dactylic hexameter	masculine penthemimeral, hepthemimeral, trithemimeral
ἀλλὰ πίθεσθ’· ἄμφω δὲ νεωτέρω ἐστὸν ἐμεῖο·	-u u- -- u u-uu -u u--	dactylic hexameter	masculine penthemimeral, trithemimeral
ἤδη γάρ ποτ’ ἐγὼ καὶ ἀρείοσιν ἠέ περ ὑμῖν	-- - u u- u u-uu -u u --	dactylic hexameter	masculine penthemimeral, trithemimeral
ἀνδράσιν ὡμίλησα, καὶ οὔ ποτέ μ’οἵ γ’ἀθέριζον.	-uu ---u u - uu - uu--	dactylic hexameter	feminine penthemimeral, hepthemimeral
οὐ γάρ πω τοίους ἴδον ἀνέρας οὐδὲ ἴδωμαι,	- - - -- uu -uu -u u--	dactylic hexameter	masculine penthemimeral, trithemimeral
οἷον Πειρίθοόν τε Δρύαντά τε ποιμένα λαῶν	-- -uu- u u-u u -uu --	dactylic hexameter	masculine penthemimeral
Καινέα τ’Ἐξάδιόν τε καὶ ἀντίθεον Πολύφημον	-uu -uu- u u -uu- uu--	dactylic hexameter	masculine penthemimeral
Θησέα τ’Αἰγεΐδην, ἐπιείκελον ἀθανάτοισιν·	-uu -uu- uu-uu -uu--	dactylic hexameter	masculine penthemimeral
κάρτιστοι δὴ κεῖνοι ἐπιχθονίων τράφεν ἀνδρῶν·	--- - -u u-uu- uu --	dactylic hexameter	feminine penthemimeral, trithemimeral
κάρτιστοι μὲν ἔσαν καὶ καρτίστοις ἐμάχοντο	--- u u- - --- uu--	dactylic hexameter	masculine penthemimeral, trithemimeral
φηρσὶν ὀρεσκῴοισι καὶ ἐκπάγλως ἀπόλεσσαν.	-u u---u u --- uu--	dactylic hexameter	feminine penthemimeral
καὶ μὲν τοῖσιν ἐγὼ μεθομίλεον ἐκ Πύλου ἐλθὼν	- - -u u- uu-uu - uu --	dactylic hexameter	masculine penthemimeral
τηλόθεν ἐξ ἀπίης γαίης· καλέσαντο γὰρ αὐτοί·	-uu - uu- -- uu-u u --	dactylic hexameter	masculine penthemimeral, hepthemimeral, trithemimeral
καὶ μαχόμην κατ’ ἔμ’ αὐτὸν ἐγώ· κείνοισι δ’ἂν οὔ τις	- uu- u u -u u- --u u - -	dactylic hexameter	feminine penthemimeral, hepthemimeral, trithemimeral
τῶν οἳ νῦν βροτοί εἰσιν ἐπιχθόνιοι μαχέοιτο·	- - - uu -u u-uu- uu--	dactylic hexameter	feminine penthemimeral, trithemimeral
καὶ μέν μευ βουλέων ξύνιεν πείθοντό τε μύθῳ·	- - - -- uu- --u u --	dactylic hexameter	masculine penthemimeral, hepthemimeral, trithemimeral
ἀλλὰ πίθεσθε καὶ ὔμμες, ἐπεὶ πείθεσθαι ἄμεινον·	-u u-u u -u u- --u u--	dactylic hexameter	feminine penthemimeral, hepthemimeral
μήτε σὺ τόνδ’ ἀγαθός περ ἐὼν ἀποαίρεο κούρην,	-u u - uu- u u- uu-uu --	dactylic hexameter	masculine penthemimeral, hepthemimeral, trithemimeral
ἀλλ’ ἔα ὥς οἱ πρῶτα δόσαν γέρας υἷες Ἀχαιῶν·	- uu - - -u u- uu -u u--	dactylic hexameter	feminine penthemimeral, hepthemimeral, trithemimeral
μήτε σὺ Πηλείδη θελ’ ἐριζέμεναι βασιλῆϊ	-u u --- u u-uu- uu--	dactylic hexameter	masculine penthemimeral
ἀντιβίην, ἐπεὶ οὔ ποθ’ ὁμοίης ἔμμορε τιμῆς	-uu- uu - u u-- -uu --	dactylic hexameter	masculine penthemimeral, trithemimeral
σκηπτοῦχος βασιλεύς, ᾧ τε Ζεὺς κῦδος ἔδωκεν.	--- uu- - - - -u u--	dactylic hexameter	masculine penthemimeral, hepthemimeral, trithemimeral
εἰ δὲ σὺ καρτερός ἐσσι θεὰ δέ σε γείνατο μήτηρ,	- u u -uu -u u- u u -uu --	dactylic hexameter	feminine penthemimeral, hepthemimeral
ἀλλ’ ὅ γε φέρτερός ἐστιν ἐπεὶ πλεόνεσσιν ἀνάσσει.	- u u -uu -u u- uu-u u--	dactylic hexameter	feminine penthemimeral, hepthemimeral
Ἀτρεΐδη σὺ δὲ παῦε τεὸν μένος· αὐτὰρ ἔγωγε	-uu- u u -u u- uu -u u--	dactylic hexameter	feminine penthemimeral, hepthemimeral, trithemimeral
λίσσομ’ Ἀχιλλῆϊ μεθέμεν χόλον, ὃς μέγα πᾶσιν	-u u--- uu- uu - uu --	dactylic hexameter	masculine penthemimeral, hepthemimeral
ἕρκος Ἀχαιοῖσιν πέλεται πολέμοιο κακοῖο.	-u u--- uu- uu-u u--	dactylic hexameter	masculine penthemimeral, hepthemimeral
τὸν δ’ἀπαμειβόμενος προσέφη κρείων Ἀγαμέμνων·	- uu-uu- uu- -- uu--	dactylic hexameter	masculine penthemimeral, hepthemimeral
ναὶ δὴ ταῦτά γε πάντα γέρον κατὰ μοῖραν ἔειπες·	- - -u u -u u- uu -u u--	dactylic hexameter	feminine penthemimeral, hepthemimeral
ἀλλ’ ὅδ’ ἀνὴρ ἐθέλει περὶ πάντων ἔμμεναι ἄλλων,	- u u- uu- uu -- -uu --	dactylic hexameter	masculine penthemimeral, trithemimeral
πάντων μὲν κρατέειν ἐθέλει, πάντεσσι δ’ἀνάσσειν,	-- - uu- uu- --u u--	dactylic hexameter	masculine penthemimeral, hepthemimeral, trithemimeral
πᾶσι δὲ σημαίνειν, ἅ τιν’ οὐ πείσεσθαι ὀΐω·	-u u --- u u - --u u--	dactylic hexameter	masculine penthemimeral, hepthemimeral
εἰ δέ μιν αἰχμητὴν ἔθεσαν θεοὶ αἰὲν ἐόντες	- u u --- uu- uu -u u--	dactylic hexameter	masculine penthemimeral, hepthemimeral
τοὔνεκά οἱ προθέουσιν ὀνείδεα μυθήσασθαι;	-uu - uu-u u-uu ----	dactylic hexameter	feminine penthemimeral, trithemimeral
τὸν δ’ἄρ’ ὑποβλήδην ἠμείβετο δῖος Ἀχιλλεύς·	- u u--- --uu -u u--	dactylic hexameter	masculine penthemimeral
ἦ γάρ κεν δειλός τε καὶ οὐτιδανὸς καλεοίμην	- - - -- u u -uu- uu--	dactylic hexameter	masculine penthemimeral, trithemimeral
εἰ δὴ σοὶ πᾶν ἔργον ὑπείξομαι ὅττί κεν εἴπῃς·	- - - - -u u-uu -u u --	dactylic hexameter	feminine penthemimeral, trithemimeral
ἄλλοισιν δὴ ταῦτ’ ἐπιτέλλεο, μὴ γὰρ ἔμοιγε	--- - - uu-uu - u u--	dactylic hexameter	masculine penthemimeral, trithemimeral
σήμαιν’· οὐ γὰρ ἔγωγ’ ἔτι σοὶ πείσεσθαι ὀΐω.	-- - u u- uu - --u u--	dactylic hexameter	masculine penthemimeral, hepthemimeral, trithemimeral
ἄλλο δέ τοι ἐρέω, σὺ δ’ἐνὶ φρεσὶ βάλλεο σῇσι·	-u u - uu- u u- uu -uu --	dactylic hexameter	masculine penthemimeral, hepthemimeral, trithemimeral
χερσὶ μὲν οὔ τοι ἔγωγε μαχήσομαι εἵνεκα κούρης	-u u - u u-u u-uu -uu --	dactylic hexameter	feminine penthemimeral, trithemimeral
οὔτε σοὶ οὔτέ τῳ ἄλλῳ, ἐπεί μ’ἀφέλεσθέ γε δόντες·	-u u -u u -u u- uu-u u --	dactylic hexameter	feminine penthemimeral, hepthemimeral
τῶν δ’ἄλλων ἅ μοί ἐστι θοῇ παρὰ νηῒ μελαίνῃ	- -- u u -u u- uu -u u--	dactylic hexameter	feminine penthemimeral, hepthemimeral, trithemimeral
τῶν οὐκ ἄν τι φέροις ἀνελὼν ἀέκοντος ἐμεῖο·	- - - u u- uu- uu-u u--	dactylic hexameter	masculine penthemimeral, hepthemimeral, trithemimeral
εἰ δ’ἄγε μὴν πείρησαι ἵνα γνώωσι καὶ οἵδε·	- uu - --u u- --u u --	dactylic hexameter	feminine penthemimeral, hepthemimeral, trithemimeral
αἶψά τοι αἷμα κελαινὸν ἐρωήσει περὶ δουρί.	-u u -u u-u u--- uu --	dactylic hexameter	feminine penthemimeral
ὣς τώ γ’ἀντιβίοισι μαχεσσαμένω ἐπέεσσιν	- - -uu-u u-uu- uu--	dactylic hexameter	feminine penthemimeral
ἀνστήτην, λῦσαν δ’ἀγορὴν παρὰ νηυσὶν Ἀχαιῶν·	--- -- uu- uu -u u--	dactylic hexameter	masculine penthemimeral, hepthemimeral, trithemimeral
Πηλεΐδης μὲν ἐπὶ κλισίας καὶ νῆας ἐΐσας	-uu- u u- uu- - -u u--	dactylic hexameter	masculine penthemimeral, hepthemimeral, trithemimeral
ἤϊε σύν τε Μενοιτιάδῃ καὶ οἷς ἑτάροισιν·	-uu - u u-uu- - - uu--	dactylic hexameter	hepthemimeral, trithemimeral
Ἀτρεΐδης δ’ἄρα νῆα θοὴν ἅλα δὲ προέρυσσεν,	-uu- uu -u u- uu - uu--	dactylic hexameter	feminine penthemimeral, hepthemimeral, trithemimeral
ἐν δ’ἐρέτας ἔκρινεν ἐείκοσιν, ἐς δ’ἑκατόμβην	- uu- --u u-uu - uu--	dactylic hexameter	feminine penthemimeral, trithemimeral
βῆσε θεῷ, ἀνὰ δὲ Χρυσηΐδα καλλιπάρῃον	-u u- uu - --uu -uu--	dactylic hexameter	masculine penthemimeral, trithemimeral
εἷσεν ἄγων· ἐν δ’ἀρχὸς ἔβη πολύμητις Ὀδυσσεύς.	-u u- - -u u- uu-u u--	dactylic hexameter	feminine penthemimeral, hepthemimeral, trithemimeral
οἳ μὲν ἔπειτ’ ἀναβάντες ἐπέπλεον ὑγρὰ κέλευθα,	- u u- uu-u u-uu -u u--	dactylic hexameter	feminine penthemimeral, trithemimeral
λαοὺς δ’Ἀτρεΐδης ἀπολυμαίνεσθαι ἄνωγεν·	-- -uu- uu---u u--	dactylic hexameter	masculine penthemimeral
οἳ δ’ἀπελυμαίνοντο καὶ εἰς ἅλα λύματα βάλλον,	- uu---u u - uu -uu --	dactylic hexameter	feminine penthemimeral, hepthemimeral
ἕρδον δ’Ἀπόλλωνι τεληέσσας nbsp;ἑκατόμβας	-- ---u u--- uu--	dactylic hexameter	feminine penthemimeral
ταύρων ἠδ’ αἰγῶν παρὰ θῖν’ ἁλὸς ἀτρυγέτοιο·	-- - -- uu - uu -uu--	dactylic hexameter	masculine penthemimeral, hepthemimeral, trithemimeral
κνίση δ’οὐρανὸν ἷκεν ἑλισσομένη περὶ καπνῷ.	-- -uu -u u-uu- uu --	dactylic hexameter	feminine penthemimeral
ὣς οἳ μὲν τὰ πένοντο κατὰ στρατόν· οὐδ’ Ἀγαμέμνων	- - - u u-u u- uu - uu--	dactylic hexameter	feminine penthemimeral, hepthemimeral, trithemimeral
λῆγ’ ἔριδος τὴν πρῶτον ἐπηπείλησ’ Ἀχιλῆϊ,	- uu- - -u u--- uu--	dactylic hexameter	feminine penthemimeral, trithemimeral
ἀλλ’ ὅ γε Ταλθύβιόν τε καὶ Εὐρυβάτην προσέειπε,	- u u -uu- u u -uu- uu--	dactylic hexameter	masculine penthemimeral
τώ οἱ ἔσαν κήρυκε καὶ ὀτρηρὼ θεράποντε·	- u u- --u u --- uu--	dactylic hexameter	feminine penthemimeral, trithemimeral
ἔρχεσθον κλισίην Πηληϊάδεω Ἀχιλῆος·	--- uu- --uu- uu--	dactylic hexameter	masculine penthemimeral, trithemimeral
χειρὸς ἑλόντ’ ἀγέμεν Βρισηΐδα καλλιπάρῃον·	-u u- uu- --uu -uu--	dactylic hexameter	masculine penthemimeral, trithemimeral
εἰ δέ κε μὴ δώῃσιν ἐγὼ δέ κεν αὐτὸς ἕλωμαι	- u u - --u u- u u -u u--	dactylic hexameter	feminine penthemimeral, hepthemimeral, trithemimeral
ἐλθὼν σὺν πλεόνεσσι· τό οἱ καὶ ῥίγιον ἔσται.	-- - uu-u u - - -uu --	dactylic hexameter	feminine penthemimeral, hepthemimeral, trithemimeral
ὣς εἰπὼν προΐει, κρατερὸν δ’ἐπὶ μῦθον ἔτελλε·	- -- uu- uu- uu -u u--	dactylic hexameter	masculine penthemimeral, hepthemimeral, trithemimeral
τὼ δ’ἀέκοντε βάτην παρὰ θῖν’ ἁλὸς ἀτρυγέτοιο,	- uu-u u- uu - uu -uu--	dactylic hexameter	masculine penthemimeral, hepthemimeral
Μυρμιδόνων δ’ἐπί τε κλισίας καὶ νῆας ἱκέσθην,	-uu- uu - uu- - -u u--	dactylic hexameter	masculine penthemimeral, hepthemimeral, trithemimeral
τὸν δ’εὗρον παρά τε κλισίῃ καὶ νηῒ μελαίνῃ	- -- uu - uu- - -u u--	dactylic hexameter	masculine penthemimeral, hepthemimeral, trithemimeral
ἥμενον· οὐδ’ ἄρα τώ γε ἰδὼν γήθησεν Ἀχιλλεύς.	-uu - uu - u u- --u u--	dactylic hexameter	masculine penthemimeral, hepthemimeral, trithemimeral
τὼ μὲν ταρβήσαντε καὶ αἰδομένω βασιλῆα	- - ---u u -uu- uu--	dactylic hexameter	feminine penthemimeral
στήτην, οὐδέ τί μιν προσεφώνεον οὐδ’ ἐρέοντο·	-- -u u - uu-uu - uu--	dactylic hexameter	masculine penthemimeral
αὐτὰρ ὃ ἔγνω ᾗσιν ἐνὶ φρεσὶ φώνησέν τε·	-u u -- -u u- uu --- -	dactylic hexameter	feminine penthemimeral, hepthemimeral
χαίρετε κήρυκες Διὸς ἄγγελοι ἠδὲ καὶ ἀνδρῶν,	-uu --- uu -uu -u u --	dactylic hexameter	masculine penthemimeral
ἆσσον ἴτ’· οὔ τί μοι ὔμμες ἐπαίτιοι ἀλλ’ Ἀγαμέμνων,	-u u - u u -u u-uu - uu--	dactylic hexameter	feminine penthemimeral, trithemimeral
ὃ σφῶϊ προΐει Βρισηΐδος εἵνεκα κούρης.	- -- uu- --uu -uu --	dactylic hexameter	masculine penthemimeral, trithemimeral
ἀλλ’ ἄγε διογενὲς Πατρόκλεες ἔξαγε κούρην	- uu -uu- --uu -uu --	dactylic hexameter	masculine penthemimeral
καί σφωϊν δὸς ἄγειν· τὼ δ’αὐτὼ μάρτυροι ἔστων	- -- u u- - -- -uu --	dactylic hexameter	masculine penthemimeral, trithemimeral
πρός τε θεῶν μακάρων πρός τε θνητῶν ἀνθρώπων	- u u- uu- - - -- ---	dactylic hexameter	masculine penthemimeral, hepthemimeral, trithemimeral
καὶ πρὸς τοῦ βασιλῆος ἀπηνέος εἴ ποτε δ’αὖτε	- - - uu-u u-uu - uu --	dactylic hexameter	feminine penthemimeral, trithemimeral
χρειὼ ἐμεῖο γένηται ἀεικέα λοιγὸν ἀμῦναι	-u u-u u-u u-uu -u u--	dactylic hexameter	feminine penthemimeral
τοῖς ἄλλοις· ἦ γὰρ ὅ γ’ὀλοιῇσι φρεσὶ θύει,	- -- - - u u--- uu --	dactylic hexameter	masculine penthemimeral, trithemimeral
οὐδέ τι οἶδε νοῆσαι ἅμα πρόσσω καὶ ὀπίσσω,	-u u -u u-u u- -- u u--	dactylic hexameter	feminine penthemimeral, hepthemimeral
ὅππως οἱ παρὰ νηυσὶ σόοι μαχέοιντο Ἀχαιοί.	-- - uu -u u- uu-u u--	dactylic hexameter	feminine penthemimeral, hepthemimeral, trithemimeral
ὣς φάτο, Πάτροκλος δὲ φίλῳ ἐπεπείθεθ’ ἑταίρῳ,	- uu --- u u- uu-u u--	dactylic hexameter	masculine penthemimeral, hepthemimeral
ἐκ δ’ἄγαγε κλισίης Βρισηΐδα καλλιπάρῃον,	- uu- uu- --uu -uu--	dactylic hexameter	masculine penthemimeral, trithemimeral
δῶκε δ’ἄγειν· τὼ δ’αὖτις ἴτην παρὰ νῆας Ἀχαιῶν·	-u u- - -u u- uu -u u--	dactylic hexameter	feminine penthemimeral, hepthemimeral, trithemimeral
ἣ δ’ἀέκουσ’ ἅμα τοῖσι γυνὴ κίεν· αὐτὰρ Ἀχιλλεὺς	- uu- uu -u u- uu -u u--	dactylic hexameter	feminine penthemimeral, hepthemimeral, trithemimeral
δακρύσας ἑτάρων ἄφαρ ἕζετο νόσφι λιασθείς,	--- uu- uu -uu -u u--	dactylic hexameter	masculine penthemimeral, trithemimeral
θῖν’ ἔφ’ ἁλὸς πολιῆς, ὁρόων ἐπ’ ἀπείρονα πόντον·	- u u- uu- uu- u u-uu --	dactylic hexameter	masculine penthemimeral, hepthemimeral, trithemimeral
πολλὰ δὲ μητρὶ φίλῃ ἠρήσατο χεῖρας ὀρεγνύς·	-u u -u u- --uu -u u--	dactylic hexameter	masculine penthemimeral
μῆτερ ἐπεί μ’ἔτεκές γε μινυνθάδιόν περ ἐόντα,	-u u- uu- u u-uu- u u--	dactylic hexameter	masculine penthemimeral, trithemimeral
τιμήν πέρ μοι ὄφελλεν Ὀλύμπιος ἐγγυαλίξαι	-- - u u-u u-uu -uu--	dactylic hexameter	feminine penthemimeral, trithemimeral
Ζεὺς ὑψιβρεμέτης· νῦν δ’οὐδέ με τυτθὸν ἔτισεν·	- --uu- - -u u -u u--	dactylic hexameter	masculine penthemimeral
ἦ γάρ μ’Ἀτρεΐδης εὐρὺ κρείων Ἀγαμέμνων	- - -uu- -- -- uu--	dactylic hexameter	masculine penthemimeral, hepthemimeral
ἠτίμησεν· ἑλὼν γὰρ ἔχει γέρας αὐτὸς ἀπούρας.	---u u- u u- uu -u u--	dactylic hexameter	masculine penthemimeral, hepthemimeral
ὣς φάτο δάκρυ χέων, τοῦ δ’ἔκλυε πότνια μήτηρ	- uu -u u- - -uu -uu --	dactylic hexameter	masculine penthemimeral
ἡμένη ἐν βένθεσσιν ἁλὸς παρὰ πατρὶ γέροντι·	-uu - --u u- uu -u u--	dactylic hexameter	feminine penthemimeral, hepthemimeral, trithemimeral
καρπαλίμως δ’ἀνέδυ πολιῆς ἁλὸς ἠΰτ’ ὀμίχλη,	-uu- uu- uu- uu -u u--	dactylic hexameter	masculine penthemimeral, hepthemimeral, trithemimeral
καί ῥα πάροιθ’ αὐτοῖο καθέζετο δάκρυ χέοντος,	- u u- --u u-uu -u u--	dactylic hexameter	feminine penthemimeral, trithemimeral
χειρί τέ μιν κατέρεξεν ἔπος τ’ἔφατ’ ἔκ τ’ὀνόμαζε·	-u u - uu-u u- uu - uu--	dactylic hexameter	feminine penthemimeral, hepthemimeral, trithemimeral
τέκνον τί κλαίεις; τί δέ σε φρένας ἵκετο πένθος;	-- - -- u u - uu -uu --	dactylic hexameter	masculine penthemimeral, hepthemimeral, trithemimeral
ἐξαύδα, μὴ κεῦθε νόῳ, ἵνα εἴδομεν ἄμφω.	--- - -u u- uu -uu --	dactylic hexameter	feminine penthemimeral, hepthemimeral, trithemimeral
τὴν δὲ βαρὺ στενάχων προσέφη πόδας ὠκὺς Ἀχιλλεύς·	- u u- uu- uu- uu -u u--	dactylic hexameter	masculine penthemimeral, hepthemimeral, trithemimeral
οἶσθα· τί ἤ τοι ταῦτα ἰδυίῃ πάντ’ ἀγορεύω;	-u u - - -u u-- - uu--	dactylic hexameter	feminine penthemimeral, trithemimeral
ᾠχόμεθ’ ἐς Θήβην ἱερὴν πόλιν Ἠετίωνος,	-uu - -- uu- uu -uu--	dactylic hexameter	masculine penthemimeral, hepthemimeral, trithemimeral
τὴν δὲ διεπράθομέν τε καὶ ἤγομεν ἐνθάδε πάντα·	- u u-uu- u u -uu -uu --	dactylic hexameter	masculine penthemimeral
καὶ τὰ μὲν εὖ δάσσαντο μετὰ σφίσιν υἷες Ἀχαιῶν,	- u u - --u u- uu -u u--	dactylic hexameter	feminine penthemimeral, hepthemimeral, trithemimeral
ἐκ δ’ἕλον Ἀτρεΐδῃ Χρυσηΐδα καλλιπάρῃον.	- uu -uu- --uu -uu--	dactylic hexameter	masculine penthemimeral
Χρύσης δ’αὖθ’ ἱερεὺς ἑκατηβόλου Ἀπόλλωνος	-- - uu- uu-uu ----	dactylic hexameter	masculine penthemimeral, trithemimeral
ἦλθε θοὰς ἐπὶ νῆας Ἀχαιῶν χαλκοχιτώνων	-u u- uu -u u-- -uu--	dactylic hexameter	feminine penthemimeral, trithemimeral
λυσόμενός τε θύγατρα φέρων τ’ἀπερείσι’ ἄποινα,	-uu- u u-u u- uu-u u--	dactylic hexameter	feminine penthemimeral, hepthemimeral, trithemimeral
στέμματ’ ἔχων ἐν χερσὶν ἑκηβόλου Ἀπόλλωνος	-u u- - -u u-uu ----	dactylic hexameter	feminine penthemimeral, trithemimeral
χρυσέῳ ἀνὰ σκήπτρῳ, καὶ λίσσετο πάντας Ἀχαιούς,	-u u- -- - -uu -u u--	dactylic hexameter	masculine penthemimeral, trithemimeral
Ἀτρεΐδα δὲ μάλιστα δύω κοσμήτορε λαῶν.	-uu- u u-u u- --uu --	dactylic hexameter	feminine penthemimeral, hepthemimeral, trithemimeral
ἔνθ’ ἄλλοι μὲν πάντες ἐπευφήμησαν Ἀχαιοὶ	- -- - -u u---u u--	dactylic hexameter	feminine penthemimeral, trithemimeral
αἰδεῖσθαί θ’ἱερῆα καὶ ἀγλαὰ δέχθαι ἄποινα·	--- uu-u u -uu -u u--	dactylic hexameter	feminine penthemimeral, trithemimeral
ἀλλ’ οὐκ Ἀτρεΐδῃ Ἀγαμέμνονι ἥνδανε θυμῷ,	- - -uu- uu-uu -uu --	dactylic hexameter	masculine penthemimeral
ἀλλὰ κακῶς ἀφίει, κρατερὸν δ’ἐπὶ μῦθον ἔτελλε·	-u u- uu- uu- uu -u u--	dactylic hexameter	masculine penthemimeral, hepthemimeral, trithemimeral
χωόμενος δ’ὁ γέρων πάλιν ᾤχετο· τοῖο δ’Ἀπόλλων	-uu- u u- uu -uu -u u--	dactylic hexameter	masculine penthemimeral, trithemimeral
εὐξαμένου ἤκουσεν, ἐπεὶ μάλα οἱ φίλος ἦεν,	-uu- --u u- uu - uu --	dactylic hexameter	feminine penthemimeral, hepthemimeral, trithemimeral
ἧκε δ’ἐπ’ Ἀργείοισι κακὸν βέλος· οἳ δέ νυ λαοὶ	-u u ---u u- uu - u u --	dactylic hexameter	feminine penthemimeral, hepthemimeral
θνῇσκον ἐπασσύτεροι, τὰ δ’ἐπῴχετο κῆλα θεοῖο	-u u-uu- u u-uu -u u--	dactylic hexameter	masculine penthemimeral
πάντῃ ἀνὰ στρατὸν εὐρὺν Ἀχαιῶν· ἄμμι δὲ μάντις	-u u- uu -u u-- -u u --	dactylic hexameter	feminine penthemimeral, trithemimeral
εὖ εἰδὼς ἀγόρευε θεοπροπίας ἑκάτοιο.	- -- uu-u u-uu- uu--	dactylic hexameter	feminine penthemimeral, trithemimeral
αὐτίκ’ ἐγὼ πρῶτος κελόμην θεὸν ἱλάσκεσθαι·	-u u- -- uu- uu ----	dactylic hexameter	masculine penthemimeral, hepthemimeral, trithemimeral
Ἀτρεΐωνα δ’ἔπειτα χόλος λάβεν, αἶψα δ’ἀναστὰς	-uu-u u-u u- uu -u u--	dactylic hexameter	feminine penthemimeral, hepthemimeral
ἠπείλησεν μῦθον ὃ δὴ τετελεσμένος ἐστί·	---- -u u - uu-uu --	dactylic hexameter	feminine penthemimeral, hepthemimeral
τὴν μὲν γὰρ σὺν νηῒ θοῇ ἑλίκωπες Ἀχαιοὶ	- - - - -u u- uu-u u--	dactylic hexameter	feminine penthemimeral, hepthemimeral, trithemimeral
ἐς Χρύσην πέμπουσιν, ἄγουσι δὲ δῶρα ἄνακτι·	- -- --u u-u u -u u--	dactylic hexameter	feminine penthemimeral, trithemimeral
τὴν δὲ νέον κλισίηθεν ἔβαν κήρυκες ἄγοντες	- u u- uu-u u- --u u--	dactylic hexameter	feminine penthemimeral, hepthemimeral, trithemimeral
κούρην Βρισῆος τήν μοι δόσαν υἷες Ἀχαιῶν.	-- --- - - uu -u u--	dactylic hexameter	masculine penthemimeral, hepthemimeral
ἀλλὰ σὺ εἰ δύνασαί γε περίσχεο παιδὸς ἑῆος·	-u u - uu- u u-uu -u u--	dactylic hexameter	masculine penthemimeral, trithemimeral
ἐλθοῦσ’ Οὔλυμπον δὲ Δία λίσαι, εἴ ποτε δή τι	-- --- u u- uu - uu - -	dactylic hexameter	masculine penthemimeral, hepthemimeral
ἢ ἔπει ὤνησας κραδίην Διὸς ἠὲ καὶ ἔργῳ.	- uu --- uu- uu -u u --	dactylic hexameter	masculine penthemimeral, hepthemimeral
πολλάκι γάρ σεο πατρὸς ἐνὶ μεγάροισιν ἄκουσα	-uu - uu -u u- uu-u u--	dactylic hexameter	feminine penthemimeral, hepthemimeral, trithemimeral
εὐχομένης ὅτ’ ἔφησθα κελαινεφέϊ Κρονίωνι	-uu- u u-u u-uu- uu--	dactylic hexameter	feminine penthemimeral, trithemimeral
οἴη ἐν ἀθανάτοισιν ἀεικέα λοιγὸν ἀμῦναι,	-u u -uu-u u-uu -u u--	dactylic hexameter	feminine penthemimeral
ὁππότε μιν ξυνδῆσαι Ὀλύμπιοι ἤθελον ἄλλοι	-uu - --u u-uu -uu --	dactylic hexameter	feminine penthemimeral, trithemimeral
Ἥρη τ’ἠδὲ Ποσειδάων καὶ Παλλὰς Ἀθήνη·	-- -u u--- - -u u--	dactylic hexameter	hepthemimeral
ἀλλὰ σὺ τόν γ’ἐλθοῦσα θεὰ ὑπελύσαο δεσμῶν,	-u u - --u u- uu-uu --	dactylic hexameter	feminine penthemimeral, hepthemimeral, trithemimeral
ὦχ’ ἑκατόγχειρον καλέσασ’ ἐς μακρὸν Ὄλυμπον,	- uu--- uu- - -u u--	dactylic hexameter	masculine penthemimeral, hepthemimeral
ὃν Βριάρεων καλέουσι θεοί, ἄνδρες δέ τε πάντες	- uu- uu-u u- -- u u --	dactylic hexameter	feminine penthemimeral, hepthemimeral, trithemimeral
Αἰγαίων’, ὃ γὰρ αὖτε βίην οὗ πατρὸς ἀμείνων·	--- u u -u u- - -u u--	dactylic hexameter	feminine penthemimeral, hepthemimeral, trithemimeral
ὅς ῥα παρὰ Κρονίωνι καθέζετο κύδεϊ γαίων·	- u u- uu-u u-uu -uu --	dactylic hexameter	feminine penthemimeral, trithemimeral
τὸν καὶ ὑπέδεισαν μάκαρες θεοὶ οὐδ’ ἔτ’ ἔδησαν.	- u u--- uu- uu - u u--	dactylic hexameter	masculine penthemimeral, hepthemimeral
τῶν νῦν μιν μνήσασα παρέζεο καὶ λαβὲ γούνων	- - - --u u-uu - uu --	dactylic hexameter	feminine penthemimeral, trithemimeral
αἴ κέν πως ἐθέλῃσιν ἐπὶ Τρώεσσιν ἀρῆξαι,	- - - uu-u u- --u u--	dactylic hexameter	feminine penthemimeral, hepthemimeral, trithemimeral
τοὺς δὲ κατὰ πρύμνας τε καὶ ἀμφ’ ἅλα ἔλσαι Ἀχαιοὺς	- u u- -- u u - uu -u u--	dactylic hexameter	masculine penthemimeral, hepthemimeral, trithemimeral
κτεινομένους, ἵνα πάντες ἐπαύρωνται βασιλῆος,	-uu- uu -u u--- uu--	dactylic hexameter	feminine penthemimeral, trithemimeral
γνῷ δὲ καὶ Ἀτρεΐδης εὐρὺ κρείων Ἀγαμέμνων	- u u -uu- -- -- uu--	dactylic hexameter	masculine penthemimeral, hepthemimeral
ἣν ἄτην ὅ τ’ἄριστον Ἀχαιῶν οὐδὲν ἔτισεν.	- -- u u-u u-- -u u--	dactylic hexameter	feminine penthemimeral, trithemimeral
τὸν δ’ἠμείβετ’ ἔπειτα Θέτις κατὰ δάκρυ χέουσα·	- --u u-u u- uu -u u--	dactylic hexameter	feminine penthemimeral, hepthemimeral
ὤ μοι τέκνον ἐμόν, τί νύ σ’ἔτρεφον αἰνὰ τεκοῦσα;	- - -u u- u u -uu -u u--	dactylic hexameter	masculine penthemimeral
αἴθ’ ὄφελες παρὰ νηυσὶν ἀδάκρυτος καὶ ἀπήμων	- uu- uu -u u--- u u--	dactylic hexameter	feminine penthemimeral, trithemimeral
ἧσθαι, ἐπεί νύ τοι αἶσα μίνυνθά περ οὔ τι μάλα δήν·	-u u- u u -u u-u u - u u- -	dactylic hexameter	feminine penthemimeral, trithemimeral
νῦν δ’ἅμα τ’ὠκύμορος καὶ ὀϊζυρὸς περὶ πάντων	- uu -uu- u u--- uu --	dactylic hexameter	masculine penthemimeral
ἔπλεο· τώ σε κακῇ αἴσῃ τέκον ἐν μεγάροισι.	-uu - u u- -- uu - uu--	dactylic hexameter	masculine penthemimeral, hepthemimeral, trithemimeral
τοῦτο δέ τοι ἐρέουσα ἔπος Διὶ τερπικεραύνῳ	-u u - uu-u u- uu -uu--	dactylic hexameter	feminine penthemimeral, hepthemimeral, trithemimeral
εἶμ’ αὐτὴ πρὸς Ὄλυμπον ἀγάννιφον αἴ κε πίθηται.	- -- u u-u u-uu - u u--	dactylic hexameter	feminine penthemimeral, trithemimeral
ἀλλὰ σὺ μὲν νῦν νηυσὶ παρήμενος ὠκυπόροισι	-u u - - -u u-uu -uu--	dactylic hexameter	feminine penthemimeral, trithemimeral
μήνι’ Ἀχαιοῖσιν, πολέμου δ’ἀποπαύεο πάμπαν·	-u u--- uu- uu-uu --	dactylic hexameter	masculine penthemimeral, hepthemimeral
Ζεὺς γὰρ ἐς Ὠκεανὸν μετ’ ἀμύμονας Αἰθιοπῆας	- u u -uu- u u-uu -uu--	dactylic hexameter	masculine penthemimeral
χθιζὸς ἔβη κατὰ δαῖτα, θεοὶ δ’ἅμα πάντες ἕποντο·	-u u- uu -u u- uu -u u--	dactylic hexameter	feminine penthemimeral, hepthemimeral, trithemimeral
δωδεκάτῃ δέ τοι αὖτις ἐλεύσεται Οὔλυμπον δέ,	-uu- u u -u u-uu --- -	dactylic hexameter	feminine penthemimeral, trithemimeral
καὶ τότ’ ἔπειτά τοι εἶμι Διὸς ποτὶ χαλκοβατὲς δῶ,	- u u-u u -u u- uu -uu- -	dactylic hexameter	feminine penthemimeral, hepthemimeral
καί μιν γουνάσομαι καί μιν πείσεσθαι ὀΐω.	- - -uu- - - --u u--	dactylic hexameter	masculine penthemimeral, hepthemimeral
ὣς ἄρα φωνήσασ’ ἀπεβήσετο, τὸν δὲ λίπ’ αὐτοῦ	- uu --- uu-uu - u u --	dactylic hexameter	masculine penthemimeral
χωόμενον κατὰ θυμὸν ἐϋζώνοιο γυναικὸς	-uu- uu -u u---u u--	dactylic hexameter	feminine penthemimeral, trithemimeral
τήν ῥα βίῃ ἀέκοντος ἀπηύρων· αὐτὰρ Ὀδυσσεὺς	- u u- uu-u u-- -u u--	dactylic hexameter	feminine penthemimeral, trithemimeral
ἐς Χρύσην ἵκανεν ἄγων ἱερὴν ἑκατόμβην.	- -- --u u- uu- uu--	dactylic hexameter	feminine penthemimeral, hepthemimeral, trithemimeral
οἳ δ’ὅτε δὴ λιμένος πολυβενθέος ἐντὸς ἵκοντο	- uu - uu- uu-uu -u u--	dactylic hexameter	masculine penthemimeral, trithemimeral
ἱστία μὲν στείλαντο, θέσαν δ’ἐν νηῒ μελαίνῃ,	-uu - --u u- - -u u--	dactylic hexameter	feminine penthemimeral, hepthemimeral, trithemimeral
ἱστὸν δ’ἱστοδόκῃ πέλασαν προτόνοισιν ὑφέντες	-- -uu- uu- uu-u u--	dactylic hexameter	masculine penthemimeral, hepthemimeral
καρπαλίμως, τὴν δ’εἰς ὅρμον προέρεσσαν ἐρετμοῖς.	-uu- - - -- uu-u u--	dactylic hexameter	masculine penthemimeral, hepthemimeral, trithemimeral
ἐκ δ’εὐνὰς ἔβαλον, κατὰ δὲ πρυμνήσι’ ἔδησαν·	- -- uu- uu - --u u--	dactylic hexameter	masculine penthemimeral, hepthemimeral, trithemimeral
ἐκ δὲ καὶ αὐτοὶ βαῖνον ἐπὶ ῥηγμῖνι θαλάσσης,	- u u -- -u u- --u u--	dactylic hexameter	feminine penthemimeral, hepthemimeral
ἐκ δ’ἑκατόμβην βῆσαν ἑκηβόλῳ Ἀπόλλωνι·	- uu-- -u u-uu ----	dactylic hexameter	feminine penthemimeral
ἐκ δὲ Χρυσηῒς νηὸς βῆ ποντοπόροιο.	- - --- -- - -uu--	dactylic hexameter	masculine penthemimeral, hepthemimeral
τὴν μὲν ἔπειτ’ ἐπὶ βωμὸν ἄγων πολύμητις Ὀδυσσεὺς	- u u- uu -u u- uu-u u--	dactylic hexameter	feminine penthemimeral, hepthemimeral, trithemimeral
πατρὶ φίλῳ ἐν χερσὶ τίθει καί μιν προσέειπεν·	-u u- - -u u- - - uu--	dactylic hexameter	feminine penthemimeral, hepthemimeral, trithemimeral
ὦ Χρύση, πρό μ’ἔπεμψεν ἄναξ ἀνδρῶν Ἀγαμέμνων	- -- u u-u u- -- uu--	dactylic hexameter	feminine penthemimeral, hepthemimeral, trithemimeral
παῖδά τε σοὶ ἀγέμεν, Φοίβῳ θ’ἱερὴν ἑκατόμβην	-u u - uu- -- uu- uu--	dactylic hexameter	masculine penthemimeral, hepthemimeral, trithemimeral
ῥέξαι ὑπὲρ Δαναῶν ὄφρ’ ἱλασόμεσθα ἄνακτα,	-u u- uu- - -uu-u u--	dactylic hexameter	masculine penthemimeral, trithemimeral
ὃς νῦν Ἀργείοισι πολύστονα κήδε’ ἐφῆκεν.	- - ---u u-uu -u u--	dactylic hexameter	feminine penthemimeral
ὣς εἰπὼν ἐν χερσὶ τίθει, ὃ δὲ δέξατο χαίρων	- -- - -u u- u u -uu --	dactylic hexameter	feminine penthemimeral, hepthemimeral, trithemimeral
παῖδα φίλην· τοὶ δ’ὦκα θεῷ ἱερὴν ἑκατόμβην	-u u- - -u u- uu- uu--	dactylic hexameter	feminine penthemimeral, hepthemimeral, trithemimeral
ἑξείης ἔστησαν ἐΰδμητον περὶ βωμόν,	--- --u u--- uu --	dactylic hexameter	feminine penthemimeral, trithemimeral
χερνίψαντο δ’ἔπειτα καὶ οὐλοχύτας ἀνέλοντο.	---u u-u u -uu- uu--	dactylic hexameter	feminine penthemimeral
τοῖσιν δὲ Χρύσης μεγάλ’ εὔχετο χεῖρας ἀνασχών·	-- - -- uu -uu -u u--	dactylic hexameter	masculine penthemimeral, trithemimeral
κλῦθί μευ ἀργυρότοξ’, ὃς Χρύσην ἀμφιβέβηκας	-u u -uu- - -- -uu--	dactylic hexameter	masculine penthemimeral
Κίλλαν τε ζαθέην Τενέδοιό τε ἶφι ἀνάσσεις·	-- - uu- uu-u u -u u--	dactylic hexameter	masculine penthemimeral, trithemimeral
ἦ μὲν δή ποτ’ ἐμεῦ πάρος ἔκλυες εὐξαμένοιο,	- - - u u- uu -uu -uu--	dactylic hexameter	masculine penthemimeral, trithemimeral
τίμησας μὲν ἐμέ, μέγα δ’ἴψαο λαὸν Ἀχαιῶν·	--- u u- uu -uu -u u--	dactylic hexameter	masculine penthemimeral, trithemimeral
ἠδ’ ἔτι καὶ νῦν μοι τόδ’ ἐπικρήηνον ἐέλδωρ·	- uu - - - u u---u u--	dactylic hexameter	masculine penthemimeral, trithemimeral
ἤδη νῦν Δαναοῖσιν ἀεικέα λοιγὸν ἄμυνον.	-- - uu-u u-uu -u u--	dactylic hexameter	feminine penthemimeral, trithemimeral
ὣς ἔφατ’ εὐχόμενος, τοῦ δ’ἔκλυε Φοῖβος Ἀπόλλων.	- uu -uu- - -uu -u u--	dactylic hexameter	masculine penthemimeral
αὐτὰρ ἐπεί ῥ’εὔξαντο καὶ οὐλοχύτας προβάλοντο,	-u u- --u u -uu- uu--	dactylic hexameter	feminine penthemimeral, trithemimeral
αὐέρυσαν μὲν πρῶτα καὶ ἔσφαξαν καὶ ἔδειραν,	-uu- - -u u --- u u--	dactylic hexameter	feminine penthemimeral, trithemimeral
μηρούς τ’ἐξέταμον κατά τε κνίσῃ ἐκάλυψαν	-- -uu- uu - -- uu--	dactylic hexameter	masculine penthemimeral, hepthemimeral
δίπτυχα ποιήσαντες, ἐπ’ αὐτῶν δ’ὠμοθέτησαν·	-uu ---u u -- -uu--	dactylic hexameter	feminine penthemimeral
καῖε δ’ἐπὶ σχίζῃς ὁ γέρων, ἐπὶ δ’αἴθοπα οἶνον	-u u- -- u u- uu -uu --	dactylic hexameter	masculine penthemimeral, hepthemimeral, trithemimeral
λεῖβε· νέοι δὲ παρ’ αὐτὸν ἔχον πεμπώβολα χερσίν.	-u u- u u -u u- --uu --	dactylic hexameter	feminine penthemimeral, hepthemimeral, trithemimeral
αὐτὰρ ἐπεὶ κατὰ μῆρε κάη καὶ σπλάγχνα πάσαντο,	-u u- uu -u u- - -u u--	dactylic hexameter	feminine penthemimeral, hepthemimeral, trithemimeral
μίστυλλόν τ’ἄρα τἆλλα καὶ ἀμφ’ ὀβελοῖσιν ἔπειραν,	--- uu -u u - uu-u u--	dactylic hexameter	feminine penthemimeral, hepthemimeral, trithemimeral
ὤπτησάν τε περιφραδέως, ἐρύσαντό τε πάντα.	--- u u-uu- uu-u u --	dactylic hexameter	hepthemimeral, trithemimeral
αὐτὰρ ἐπεὶ παύσαντο πόνου τετύκοντό τε δαῖτα	-u u- --u u- uu-u u --	dactylic hexameter	feminine penthemimeral, hepthemimeral, trithemimeral
δαίνυντ’, οὐδέ τι θυμὸς ἐδεύετο δαιτὸς ἐΐσης.	-- -u u -u u-uu -u u--	dactylic hexameter	feminine penthemimeral
αὐτὰρ ἐπεὶ πόσιος καὶ ἐδητύος ἐξ ἔρον ἕντο,	-u u- uu- u u-uu - uu --	dactylic hexameter	masculine penthemimeral, trithemimeral
κοῦροι μὲν κρητῆρας ἐπεστέψαντο ποτοῖο,	-- - --u u---u u--	dactylic hexameter	feminine penthemimeral, trithemimeral
νώμησαν δ’ἄρα πᾶσιν ἐπαρξάμενοι δεπάεσσιν·	--- uu -u u-uu- uu--	dactylic hexameter	feminine penthemimeral, trithemimeral
οἳ δὲ πανημέριοι μολπῇ θεὸν ἱλάσκοντο	- u u-uu- -- uu ----	dactylic hexameter	masculine penthemimeral, hepthemimeral
καλὸν ἀείδοντες παιήονα κοῦροι Ἀχαιῶν	-u u--- --uu -u u--	dactylic hexameter	masculine penthemimeral
μέλποντες ἑκάεργον· ὃ δὲ φρένα τέρπετ’ ἀκούων.	--- uu-u u - uu -u u--	dactylic hexameter	feminine penthemimeral, hepthemimeral, trithemimeral
ἦμος δ’ἠέλιος κατέδυ καὶ ἐπὶ κνέφας ἦλθε,	-- -uu- uu- u u- uu --	dactylic hexameter	masculine penthemimeral, hepthemimeral
δὴ τότε κοιμήσαντο παρὰ πρυμνήσια νηός·	- uu ---u u- --uu --	dactylic hexameter	feminine penthemimeral, hepthemimeral
ἦμος δ’ἠριγένεια φάνη ῥοδοδάκτυλος Ἠώς,	-- -uu-u u- uu-uu --	dactylic hexameter	feminine penthemimeral, hepthemimeral
καὶ τότ’ ἔπειτ’ ἀνάγοντο μετὰ στρατὸν εὐρὺν Ἀχαιῶν·	- u u- uu-u u- uu -u u--	dactylic hexameter	feminine penthemimeral, hepthemimeral, trithemimeral
τοῖσιν δ’ἴκμενον οὖρον ἵει ἑκάεργος Ἀπόλλων·	-- -uu -u u- uu-u u--	dactylic hexameter	feminine penthemimeral, hepthemimeral
οἳ δ’ἱστὸν στήσαντ’ ἀνά θ’ἱστία λευκὰ πέτασσαν,	- -- -- uu -uu -u u--	dactylic hexameter	masculine penthemimeral, trithemimeral
ἐν δ’ἄνεμος πρῆσεν μέσον ἱστίον, ἀμφὶ δὲ κῦμα	- uu- -- uu -uu -u u --	dactylic hexameter	masculine penthemimeral, trithemimeral
στείρῃ πορφύρεον μεγάλ’ ἴαχε νηὸς ἰούσης·	-- -uu- uu -uu -u u--	dactylic hexameter	masculine penthemimeral
ἣ δ’ἔθεεν κατὰ κῦμα διαπρήσσουσα κέλευθον.	- uu- uu -u u---u u--	dactylic hexameter	feminine penthemimeral, trithemimeral
αὐτὰρ ἐπεί ῥ’ἵκοντο κατὰ στρατὸν εὐρὺν Ἀχαιῶν,	-u u- --u u- uu -u u--	dactylic hexameter	feminine penthemimeral, hepthemimeral, trithemimeral
νῆα μὲν οἵ γε μέλαιναν ἐπ’ ἠπείροιο ἔρυσσαν	-u u - u u-u u ---u u--	dactylic hexameter	feminine penthemimeral, trithemimeral
ὑψοῦ ἐπὶ ψαμάθοις, ὑπὸ δ’ἕρματα μακρὰ τάνυσσαν·	-u u- uu- uu -uu -u u--	dactylic hexameter	masculine penthemimeral, trithemimeral
αὐτοὶ δ’ἐσκίδναντο κατὰ κλισίας τε νέας τε.	-- ---u u- uu- u u- -	dactylic hexameter	feminine penthemimeral, hepthemimeral
αὐτὰρ ὃ μήνιε νηυσὶ παρήμενος ὠκυπόροισι	-u u -uu -u u-uu -uu--	dactylic hexameter	feminine penthemimeral
διογενὴς Πηλῆος υἱὸς πόδας ὠκὺς Ἀχιλλεύς·	-uu- --u u- uu -u u--	dactylic hexameter	feminine penthemimeral, hepthemimeral, trithemimeral
οὔτέ ποτ’ εἰς ἀγορὴν πωλέσκετο κυδιάνειραν	-u u - uu- --uu -uu--	dactylic hexameter	masculine penthemimeral, trithemimeral
οὔτέ ποτ’ ἐς πόλεμον, ἀλλὰ φθινύθεσκε φίλον κῆρ	-u u - uu- -- uu-u u- -	dactylic hexameter	masculine penthemimeral, hepthemimeral, trithemimeral
αὖθι μένων, ποθέεσκε δ’ ἀϋτήν τε πτόλεμόν τε.	-u u- uu-u u-- - uu- -	dactylic hexameter	feminine penthemimeral, trithemimeral
ἀλλ’ ὅτε δή ῥ’ἐκ τοῖο δυωδεκάτη γένετ’ ἠώς,	- uu - - -u u-uu- uu --	dactylic hexameter	feminine penthemimeral, trithemimeral
καὶ τότε δὴ πρὸς Ὄλυμπον ἴσαν θεοὶ αἰὲν ἐόντες	- uu - u u-u u- uu -u u--	dactylic hexameter	feminine penthemimeral, hepthemimeral, trithemimeral
πάντες ἅμα, Ζεὺς δ’ἦρχε· Θέτις δ’οὐ λήθετ’ ἐφετμέων	-u u- - -u u- - -u u--	dactylic hexameter	feminine penthemimeral, hepthemimeral, trithemimeral
παιδὸς ἑοῦ, ἀλλ’ ἥ γ’ἀνεδύσετο κῦμα θαλάσσης.	-u u- - - uu-uu -u u--	dactylic hexameter	masculine penthemimeral, trithemimeral
ἠερίη δ’ἀνέβη μέγαν οὐρανὸν Οὔλυμπόν τε.	-uu- uu- uu -uu --- -	dactylic hexameter	masculine penthemimeral, trithemimeral
εὗρεν δ’εὐρύοπα Κρονίδην ἄτερ ἥμενον ἄλλων	-- -uu- uu- uu -uu --	dactylic hexameter	masculine penthemimeral, hepthemimeral
ἀκροτάτῃ κορυφῇ πολυδειράδος Οὐλύμποιο·	-uu- uu- uu-uu ----	dactylic hexameter	masculine penthemimeral, trithemimeral
καί ῥα πάροιθ’ αὐτοῖο καθέζετο, καὶ λάβε γούνων	- u u- --u u-uu - uu --	dactylic hexameter	feminine penthemimeral, trithemimeral
σκαιῇ, δεξιτερῇ δ’ἄρ’ ὑπ’ ἀνθερεῶνος ἑλοῦσα	-- -uu- u u -uu-u u--	dactylic hexameter	masculine penthemimeral
λισσομένη προσέειπε Δία Κρονίωνα ἄνακτα·	-uu- uu-u u- uu-u u--	dactylic hexameter	feminine penthemimeral, hepthemimeral, trithemimeral
Ζεῦ πάτερ εἴ ποτε δή σε μετ’ ἀθανάτοισιν ὄνησα	- uu - uu - u u -uu-u u--	dactylic hexameter	masculine penthemimeral, trithemimeral
ἢ ἔπει ἢ ἔργῳ, τόδε μοι κρήηνον ἐέλδωρ·	- uu - -- uu - --u u--	dactylic hexameter	masculine penthemimeral, hepthemimeral, trithemimeral
τίμησόν μοι υἱὸν ὃς ὠκυμορώτατος ἄλλων	--- - -u u -uu-uu --	dactylic hexameter	feminine penthemimeral, trithemimeral
ἔπλετ’· ἀτάρ μιν νῦν γε ἄναξ ἀνδρῶν Ἀγαμέμνων	-u u- - - u u- -- uu--	dactylic hexameter	masculine penthemimeral, hepthemimeral, trithemimeral
ἠτίμησεν· ἑλὼν γὰρ ἔχει γέρας αὐτὸς ἀπούρας.	---u u- u u- uu -u u--	dactylic hexameter	masculine penthemimeral, hepthemimeral
ἀλλὰ σύ πέρ μιν τῖσον Ὀλύμπιε μητίετα Ζεῦ·	-u u - - -u u-uu -uu- -	dactylic hexameter	feminine penthemimeral, trithemimeral
τόφρα δ’ἐπὶ Τρώεσσι τίθει κράτος ὄφρ’ ἂν Ἀχαιοὶ	-u u- --u u- uu - u u--	dactylic hexameter	feminine penthemimeral, hepthemimeral, trithemimeral
υἱὸν ἐμὸν τίσωσιν ὀφέλλωσίν τέ ἑ τιμῇ.	-u u- --u u--- u u --	dactylic hexameter	feminine penthemimeral, trithemimeral
ὣς φάτο· τὴν δ’οὔ τι προσέφη νεφεληγερέτα Ζεύς,	- uu - - - uu- uu-uu- -	dactylic hexameter	masculine penthemimeral, hepthemimeral, trithemimeral
ἀλλ’ ἀκέων δὴν ἧστο· Θέτις δ’ὡς ἥψατο γούνων	- uu- - -u u- - -uu --	dactylic hexameter	feminine penthemimeral, hepthemimeral, trithemimeral
ὣς ἔχετ’ ἐμπεφυυῖα, καὶ εἴρετο δεύτερον αὖτις·	- uu -uu-u u -uu -uu --	dactylic hexameter	feminine penthemimeral
νημερτὲς μὲν δή μοι ὑπόσχεο καὶ κατάνευσον	--- - - u u-uu - uu--	dactylic hexameter	masculine penthemimeral, trithemimeral
ἢ ἀπόειπ’, ἐπεὶ οὔ τοι ἔπι δέος, ὄφρ’ ἐῢ εἰδέω	- uu- uu - u u- uu - uu --	dactylic hexameter	masculine penthemimeral, hepthemimeral, trithemimeral
ὅσσον ἐγὼ μετὰ πᾶσιν ἀτιμοτάτη θεός εἰμι.	-u u- uu -u u-uu- uu --	dactylic hexameter	feminine penthemimeral, trithemimeral
τὴν δὲ μέγ’ ὀχθήσας προσέφη νεφεληγερέτα Ζεύς·	- u u --- uu- uu-uu- -	dactylic hexameter	masculine penthemimeral, hepthemimeral
’ἦ δὴ λοίγια ἔργ’ ὅ τέ μ’ἐχθοδοπῆσαι ἐφήσεις	- - -uu - u u -uu-u u--	dactylic hexameter	masculine penthemimeral
Ἥρῃ ὅτ’ ἄν μ’ἐρέθῃσιν ὀνειδείοις ἐπέεσσιν·	-u u - uu-u u--- uu--	dactylic hexameter	feminine penthemimeral, trithemimeral
ἣ δὲ καὶ αὔτως μ’αἰεὶ ἐν ἀθανάτοισι θεοῖσι	- u u -- -u u -uu-u u--	dactylic hexameter	feminine penthemimeral
νεικεῖ, καί τέ μέ φησι μάχῃ Τρώεσσιν ἀρήγειν.	-- - u u -u u- --u u--	dactylic hexameter	feminine penthemimeral, hepthemimeral, trithemimeral
ἀλλὰ σὺ μὲν νῦν αὖτις ἀπόστιχε μή τι νοήσῃ	-u u - - -u u-uu - u u--	dactylic hexameter	feminine penthemimeral, trithemimeral
Ἥρη· ἐμοὶ δέ κε ταῦτα μελήσεται ὄφρα τελέσσω·	-u u- u u -u u-uu -u u--	dactylic hexameter	feminine penthemimeral, trithemimeral
εἰ δ’ἄγε τοι κεφαλῇ κατανεύσομαι ὄφρα πεποίθῃς·	- uu - uu- uu-uu -u u--	dactylic hexameter	masculine penthemimeral, trithemimeral
τοῦτο γὰρ ἐξ ἐμέθεν γε μετ’ ἀθανάτοισι μέγιστον	-u u - uu- u u -uu-u u--	dactylic hexameter	masculine penthemimeral, trithemimeral
τέκμωρ· οὐ γὰρ ἐμὸν παλινάγρετον οὐδ’ ἀπατηλὸν	-- - u u- uu-uu - uu--	dactylic hexameter	masculine penthemimeral, trithemimeral
οὐδ’ ἀτελεύτητον ὅ τί κεν κεφαλῇ κατανεύσω.	- uu--- u u - uu- uu--	dactylic hexameter	masculine penthemimeral, hepthemimeral
ἦ καὶ κυανέῃσιν ἐπ’ ὀφρύσι νεῦσε Κρονίων·	- - -uu-u u -uu -u u--	dactylic hexameter	feminine penthemimeral
ἀμβρόσιαι δ’ἄρα χαῖται ἐπερρώσαντο ἄνακτος	-uu- uu -u u---u u--	dactylic hexameter	feminine penthemimeral, trithemimeral
κρατὸς ἀπ’ ἀθανάτοιο· μέγαν δ’ἐλέλιξεν Ὄλυμπον.	-u u -uu-u u- uu-u u--	dactylic hexameter	feminine penthemimeral, hepthemimeral
τώ γ’ὣς βουλεύσαντε διέτμαγεν· ἣ μὲν ἔπειτα	- - ---u u-uu - u u--	dactylic hexameter	feminine penthemimeral
εἰς ἅλα ἆλτο βαθεῖαν ἀπ’ αἰγλήεντος Ὀλύμπου,	- uu -u u-u u ---u u--	dactylic hexameter	feminine penthemimeral
Ζεὺς δὲ ἑὸν πρὸς δῶμα· θεοὶ δ’ἅμα πάντες ἀνέσταν	- u u- - -u u- uu -u u--	dactylic hexameter	feminine penthemimeral, hepthemimeral, trithemimeral
ἐξ ἑδέων σφοῦ πατρὸς ἐναντίον· οὐδέ τις ἔτλη	- uu- - -u u-uu -u u --	dactylic hexameter	feminine penthemimeral, trithemimeral
μεῖναι ἐπερχόμενον, ἀλλ’ ἀντίοι ἔσταν ἅπαντες.	-u u-uu- - -uu -u u--	dactylic hexameter	masculine penthemimeral
ὣς ὃ μὲν ἔνθα καθέζετ’ ἐπὶ θρόνου· οὐδέ μιν Ἥρη	- u u -u u-u u- uu -u u --	dactylic hexameter	feminine penthemimeral, hepthemimeral
ἠγνοίησεν ἰδοῦσ’ ὅτι οἱ συμφράσσατο βουλὰς	---u u- uu - --uu --	dactylic hexameter	masculine penthemimeral, hepthemimeral
ἀργυρόπεζα Θέτις θυγάτηρ ἁλίοιο γέροντος.	-uu-u u- uu- uu-u u--	dactylic hexameter	masculine penthemimeral, hepthemimeral
αὐτίκα κερτομίοισι Δία Κρονίωνα προσηύδα·	-uu -uu-u u- uu-u u--	dactylic hexameter	feminine penthemimeral, hepthemimeral
τίς δ’αὖ τοι δολομῆτα θεῶν συμφράσσατο βουλάς;	- - - uu-u u- --uu --	dactylic hexameter	feminine penthemimeral, hepthemimeral, trithemimeral
αἰεί τοι φίλον ἐστὶν ἐμεῦ ἀπὸ νόσφιν ἐόντα	-- - uu -u u- uu -u u--	dactylic hexameter	feminine penthemimeral, hepthemimeral, trithemimeral
κρυπτάδια φρονέοντα δικαζέμεν· οὐδέ τί πώ μοι	-uu- uu-u u-uu -u u - -	dactylic hexameter	feminine penthemimeral, trithemimeral
πρόφρων τέτληκας εἰπεῖν ἔπος ὅττι νοήσῃς.	-- --- -- uu -u u--	dactylic hexameter	masculine penthemimeral, hepthemimeral
τὴν δ’ἠμείβετ’ ἔπειτα πατὴρ ἀνδρῶν τε θεῶν τε·	- --u u-u u- -- u u- -	dactylic hexameter	feminine penthemimeral, hepthemimeral
Ἥρη μὴ δὴ πάντας ἐμοὺς ἐπιέλπεο μύθους	-- - - -u u- uu-uu --	dactylic hexameter	feminine penthemimeral, hepthemimeral, trithemimeral
εἰδήσειν· χαλεποί τοι ἔσοντ’ ἀλόχῳ περ ἐούσῃ·	--- uu- u u- uu- u u--	dactylic hexameter	masculine penthemimeral, hepthemimeral, trithemimeral
ἀλλ’ ὃν μέν κ’ἐπιεικὲς ἀκουέμεν οὔ τις ἔπειτα	- - - uu-u u-uu - u u--	dactylic hexameter	feminine penthemimeral, trithemimeral
οὔτε θεῶν πρότερος τὸν εἴσεται οὔτ’ ἀνθρώπων·	-u u- uu- - -uu - ---	dactylic hexameter	masculine penthemimeral, trithemimeral
ὃν δέ κ’ἐγὼν ἀπάνευθε θεῶν ἐθέλωμι νοῆσαι	- u u- uu-u u- uu-u u--	dactylic hexameter	feminine penthemimeral, hepthemimeral, trithemimeral
μή τι σὺ ταῦτα ἕκαστα διείρεο μηδὲ μετάλλα.	- u u -u u-u u-uu -u u--	dactylic hexameter	feminine penthemimeral
τὸν δ’ἠμείβετ’ ἔπειτα βοῶπις πότνια Ἥρη·	- --u u-u u-- -uu --	dactylic hexameter	feminine penthemimeral
αἰνότατε Κρονίδη ποῖον τὸν μῦθον ἔειπες;	-uu- uu- -- - -u u--	dactylic hexameter	masculine penthemimeral, hepthemimeral, trithemimeral
καὶ λίην σε πάρος γ’οὔτ’ εἴρομαι οὔτε μεταλλῶ,	- -- u u- - -uu -u u--	dactylic hexameter	masculine penthemimeral, trithemimeral
ἀλλὰ μάλ’ εὔκηλος τὰ φράζεαι ἅσσ’ ἐθέλῃσθα.	-u u --- - -uu - uu--	dactylic hexameter	masculine penthemimeral
νῦν δ’αἰνῶς δείδοικα κατὰ φρένα μή σε παρείπῃ	- -- --u u- uu - u u--	dactylic hexameter	feminine penthemimeral, hepthemimeral, trithemimeral
ἀργυρόπεζα Θέτις θυγάτηρ ἁλίοιο γέροντος·	-uu-u u- uu- uu-u u--	dactylic hexameter	masculine penthemimeral, hepthemimeral
ἠερίη γὰρ σοί γε παρέζετο καὶ λάβε γούνων·	-uu- - - u u-uu - uu --	dactylic hexameter	masculine penthemimeral, trithemimeral
τῇ σ’ὀΐω κατανεῦσαι ἐτήτυμον ὡς Ἀχιλῆα	- uu- uu-u u-uu - uu--	dactylic hexameter	feminine penthemimeral, trithemimeral
τιμήσῃς, ὀλέσῃς δὲ πολέας ἐπὶ νηυσὶν Ἀχαιῶν.	--- uu- u u- uu -u u--	dactylic hexameter	masculine penthemimeral, hepthemimeral, trithemimeral
τὴν δ’ἀπαμειβόμενος προσέφη νεφεληγερέτα Ζεύς·	- uu-uu- uu- uu-uu- -	dactylic hexameter	masculine penthemimeral, hepthemimeral
δαιμονίη αἰεὶ μὲν ὀΐεαι οὐδέ σε λήθω·	-uu- -- u u-uu -u u --	dactylic hexameter	masculine penthemimeral, trithemimeral
πρῆξαι δ’ἔμπης οὔ τι δυνήσεαι, ἀλλ’ ἀπὸ θυμοῦ	-- -- - u u-uu - uu --	dactylic hexameter	masculine penthemimeral
μᾶλλον ἐμοὶ ἔσεαι· τὸ δέ τοι καὶ ῥίγιον ἔσται.	-u u- uu- u u - - -uu --	dactylic hexameter	masculine penthemimeral, hepthemimeral, trithemimeral
εἰ δ’οὕτω τοῦτ’ ἐστὶν ἐμοὶ μέλλει φίλον εἶναι·	- -- - -u u- -- uu --	dactylic hexameter	feminine penthemimeral, hepthemimeral, trithemimeral
ἀλλ’ ἀκέουσα κάθησο, ἐμῷ δ’ἐπιπείθεο μύθῳ,	- uu-u u-u u- uu-uu --	dactylic hexameter	feminine penthemimeral, hepthemimeral
μή νύ τοι οὐ χραίσμωσιν ὅσοι θεοί εἰσ’ ἐν Ὀλύμπῳ	- u u - --u u- uu - u u--	dactylic hexameter	feminine penthemimeral, hepthemimeral, trithemimeral
ἆσσον ἰόνθ’, ὅτε κέν τοι ἀάπτους χεῖρας ἐφείω.	-u u- uu - u u-- -u u--	dactylic hexameter	masculine penthemimeral, trithemimeral
ὣς ἔφατ’ ἔδεισεν δὲ βοῶπις πότνια Ἥρη,	- uu --- u u-- -uu --	dactylic hexameter	masculine penthemimeral
καί ῥ’ἀκέουσα καθῆστο ἐπιγνάμψασα φίλον κῆρ·	- uu-u u-u u---u u- -	dactylic hexameter	feminine penthemimeral
ὄχθησαν δ’ἀνὰ δῶμα Διὸς θεοὶ Οὐρανίωνες·	--- uu -u u- uu -uu--	dactylic hexameter	feminine penthemimeral, hepthemimeral, trithemimeral
τοῖσιν δ’Ἥφαιστος κλυτοτέχνης ἦρχ’ ἀγορεύειν	-- --- uu-- - uu--	dactylic hexameter	masculine penthemimeral
μητρὶ φίλῃ ἐπίηρα φέρων λευκωλένῳ Ἥρῃ·	-u u- uu-u u- --uu --	dactylic hexameter	feminine penthemimeral, hepthemimeral, trithemimeral
ἦ δὴ λοίγια ἔργα τάδ’ ἔσσεται οὐδ’ ἔτ’ ἀνεκτά,	- - -uu -u u -uu - u u--	dactylic hexameter	feminine penthemimeral
εἰ δὴ σφὼ ἕνεκα θνητῶν ἐριδαίνετον ὧδε,	- - - uu- -- uu-uu --	dactylic hexameter	masculine penthemimeral, hepthemimeral, trithemimeral
ἐν δὲ θεοῖσι κολῳὸν ἐλαύνετον· οὐδέ τι δαιτὸς	- u u-u u-u u-uu -u u --	dactylic hexameter	feminine penthemimeral
ἐσθλῆς ἔσσεται ἦδος, ἐπεὶ τὰ χερείονα νικᾷ.	-- -uu -u u- u u-uu --	dactylic hexameter	feminine penthemimeral, hepthemimeral
μητρὶ δ’ἐγὼ παράφημι καὶ αὐτῇ περ νοεούσῃ	-u u- uu-u u -- - uu--	dactylic hexameter	feminine penthemimeral, trithemimeral
πατρὶ φίλῳ ἐπίηρα φέρειν Διί, ὄφρα μὴ αὖτε	-u u- uu-u u- uu -u u --	dactylic hexameter	feminine penthemimeral, hepthemimeral, trithemimeral
νεικείῃσι πατήρ, σὺν δ’ἡμῖν δαῖτα ταράξῃ.	---u u- - -- -u u--	dactylic hexameter	masculine penthemimeral
εἴ περ γάρ κ’ἐθέλῃσιν Ὀλύμπιος ἀστεροπητὴς	- - - uu-u u-uu -uu--	dactylic hexameter	feminine penthemimeral, trithemimeral
ἐξ ἑδέων στυφελίξαι· ὃ γὰρ πολὺ φέρτατός ἐστιν.	- uu- uu-u u - uu -uu --	dactylic hexameter	feminine penthemimeral, hepthemimeral, trithemimeral
ἀλλὰ σὺ τὸν ἐπέεσσι καθάπτεσθαι μαλακοῖσιν·	-u u - uu-u u--- uu--	dactylic hexameter	feminine penthemimeral, trithemimeral
αὐτίκ’ ἔπειθ’ ἵλαος Ὀλύμπιος ἔσσεται ἡμῖν.	-u u- --u u-uu -uu --	dactylic hexameter	feminine penthemimeral, trithemimeral
ὣς ἄρ’ ἔφη καὶ ἀναΐξας δέπας ἀμφικύπελλον	- u u- u u--- uu -uu--	dactylic hexameter	hepthemimeral, trithemimeral
μητρὶ φίλῃ ἐν χειρὶ τίθει καί μιν προσέειπε·	-u u- - -u u- - - uu--	dactylic hexameter	feminine penthemimeral, hepthemimeral, trithemimeral
’τέτλαθι μῆτερ ἐμή, καὶ ἀνάσχεο κηδομένη περ,	-uu -u u- u u-uu -uu- -	dactylic hexameter	masculine penthemimeral
μή σε φίλην περ ἐοῦσαν ἐν ὀφθαλμοῖσιν ἴδωμαι	- u u- u u-u u ---u u--	dactylic hexameter	feminine penthemimeral, trithemimeral
θεινομένην, τότε δ’οὔ τι δυνήσομαι ἀχνύμενός περ	-uu- uu - u u-uu -uu- -	dactylic hexameter	masculine penthemimeral, trithemimeral
χραισμεῖν· ἀργαλέος γὰρ Ὀλύμπιος ἀντιφέρεσθαι·	-- -uu- u u-uu -uu--	dactylic hexameter	masculine penthemimeral
ἤδη γάρ με καὶ ἄλλοτ’ ἀλεξέμεναι μεμαῶτα	-- - u u -u u-uu- uu--	dactylic hexameter	feminine penthemimeral, trithemimeral
ῥῖψε ποδὸς τεταγὼν ἀπὸ βηλοῦ θεσπεσίοιο,	-u u- uu- uu -- -uu--	dactylic hexameter	masculine penthemimeral, trithemimeral
πᾶν δ’ἦμαρ φερόμην, ἅμα δ’ἠελίῳ καταδύντι	- -- uu- uu -uu- uu--	dactylic hexameter	masculine penthemimeral, trithemimeral
κάππεσον ἐν Λήμνῳ, ὀλίγος δ’ἔτι θυμὸς ἐνῆεν·	-uu - -- uu- uu -u u--	dactylic hexameter	masculine penthemimeral, hepthemimeral, trithemimeral
ἔνθά με Σίντιες ἄνδρες ἄφαρ κομίσαντο πεσόντα.	-u u -uu -u u- uu-u u--	dactylic hexameter	feminine penthemimeral, hepthemimeral
ὣς φάτο, μείδησεν δὲ θεὰ λευκώλενος Ἥρη,	- uu --- u u- --uu --	dactylic hexameter	masculine penthemimeral, hepthemimeral
μειδήσασα δὲ παιδὸς ἐδέξατο χειρὶ κύπελλον·	---u u -u u-uu -u u--	dactylic hexameter	feminine penthemimeral
αὐτὰρ ὃ τοῖς ἄλλοισι θεοῖς ἐνδέξια πᾶσιν	-u u - --u u- --uu --	dactylic hexameter	feminine penthemimeral, hepthemimeral, trithemimeral
οἰνοχόει γλυκὺ νέκταρ ἀπὸ κρητῆρος ἀφύσσων·	-uu- uu -u u- --u u--	dactylic hexameter	feminine penthemimeral, hepthemimeral, trithemimeral
ἄσβεστος δ’ἄρ’ ἐνῶρτο γέλως μακάρεσσι θεοῖσιν	--- u u-u u- uu-u u--	dactylic hexameter	feminine penthemimeral, hepthemimeral, trithemimeral
ὡς ἴδον Ἥφαιστον διὰ δώματα ποιπνύοντα.	- uu --- uu -uu ----	dactylic hexameter	masculine penthemimeral
ὣς τότε μὲν πρόπαν ἦμαρ ἐς ἠέλιον καταδύντα	- uu - uu -u u -uu- uu--	dactylic hexameter	feminine penthemimeral, trithemimeral
δαίνυντ’, οὐδέ τι θυμὸς ἐδεύετο δαιτὸς ἐΐσης,	-- -u u -u u-uu -u u--	dactylic hexameter	feminine penthemimeral
οὐ μὲν φόρμιγγος περικαλλέος ἣν ἔχ’ Ἀπόλλων,	- - --- uu-uu - u u--	dactylic hexameter	masculine penthemimeral
Μουσάων θ’αἳ ἄειδον ἀμειβόμεναι ὀπὶ καλῇ.	--- u u-u u-uu- uu --	dactylic hexameter	feminine penthemimeral, trithemimeral
αὐτὰρ ἐπεὶ κατέδυ λαμπρὸν φάος ἠελίοιο,	-u u- uu- -- uu -uu--	dactylic hexameter	masculine penthemimeral, hepthemimeral, trithemimeral
οἳ μὲν κακκείοντες ἔβαν οἶκον δὲ ἕκαστος,	- - ---u u- -- u u--	dactylic hexameter	feminine penthemimeral, hepthemimeral
ἧχι ἑκάστῳ δῶμα περικλυτὸς ἀμφιγυήεις	-u u-- -u u-uu -uu--	dactylic hexameter	feminine penthemimeral
Ἥφαιστος ποίησεν ἰδυίῃσι πραπίδεσσι·	--- --u u--- uu--	dactylic hexameter	feminine penthemimeral, trithemimeral
Ζεὺς δὲ πρὸς ὃν λέχος ἤϊ’ Ὀλύμπιος ἀστεροπητής,	- u u - uu -u u-uu -uu--	dactylic hexameter	feminine penthemimeral, trithemimeral
ἔνθα πάρος κοιμᾶθ’ ὅτε μιν γλυκὺς ὕπνος ἱκάνοι·	-u u- -- uu - uu -u u--	dactylic hexameter	masculine penthemimeral, hepthemimeral, trithemimeral
ἔνθα καθεῦδ’ ἀναβάς, παρὰ δὲ χρυσόθρονος Ἥρη.	-u u- uu- uu - --uu --	dactylic hexameter	masculine penthemimeral, hepthemimeral, trithemimeral
