Ἠὼς μὲν κροκόπεπλος ἐκίδνατο πᾶσαν ἐπ’ αἶαν,	-- - uu-u u-uu -u u --	dactylic hexameter	feminine penthemimeral, trithemimeral
Ζεὺς δὲ θεῶν ἀγορὴν ποιήσατο τερπικέραυνος	- u u- uu- --uu -uu--	dactylic hexameter	masculine penthemimeral, trithemimeral
ἀκροτάτῃ κορυφῇ πολυδειράδος Οὐλύμποιο·	-uu- uu- uu-uu ----	dactylic hexameter	masculine penthemimeral, trithemimeral
αὐτὸς δέ σφ’ἀγόρευε, θεοὶ δ’ὑπὸ πάντες ἄκουον·	-- - uu-u u- uu -u u--	dactylic hexameter	feminine penthemimeral, hepthemimeral, trithemimeral
κέκλυτέ μευ πάντές τε θεοὶ πᾶσαί τε θέαιναι,	-uu - -- u u- -- u u--	dactylic hexameter	masculine penthemimeral, hepthemimeral, trithemimeral
ὄφρ’ εἴπω τά με θυμὸς ἐνὶ στήθεσσι κελεύει.	- -- u u -u u- --u u--	dactylic hexameter	feminine penthemimeral, hepthemimeral, trithemimeral
μήτέ τις οὖν θήλεια θεὸς τό γε μήτέ τις ἄρσην	-u u - --u u- u u -u u --	dactylic hexameter	feminine penthemimeral, hepthemimeral, trithemimeral
πειράτω διακέρσαι ἐμὸν ἔπος, ἀλλ’ ἅμα πάντες	--- uu-u u- uu - uu --	dactylic hexameter	feminine penthemimeral, hepthemimeral, trithemimeral
αἰνεῖτ’, ὄφρα τάχιστα τελευτήσω τάδε ἔργα.	-- -u u-u u--- uu --	dactylic hexameter	feminine penthemimeral
ὃν δ’ἂν ἐγὼν ἀπάνευθε θεῶν ἐθέλοντα νοήσω	- u u- uu-u u- uu-u u--	dactylic hexameter	feminine penthemimeral, hepthemimeral, trithemimeral
ἐλθόντ’ ἢ Τρώεσσιν ἀρηγέμεν ἢ Δαναοῖσι	-- - --u u-uu - uu--	dactylic hexameter	feminine penthemimeral, trithemimeral
πληγεὶς οὐ κατὰ κόσμον ἐλεύσεται Οὔλυμπον δέ·	-- - uu -u u-uu --- -	dactylic hexameter	feminine penthemimeral, trithemimeral
ἤ μιν ἑλὼν ῥίψω ἐς Τάρταρον ἠερόεντα	- u u- -- - -uu -uu--	dactylic hexameter	masculine penthemimeral, trithemimeral
τῆλε μάλ’, ἧχι βάθιστον ὑπὸ χθονός ἐστι βέρεθρον,	-u u -u u-u u- uu -u u--	dactylic hexameter	feminine penthemimeral, hepthemimeral
ἔνθα σιδήρειαί τε πύλαι καὶ χάλκεος οὐδός,	-u u--- u u- - -uu --	dactylic hexameter	masculine penthemimeral, hepthemimeral
τόσσον ἔνερθ’ Ἀΐδεω ὅσον οὐρανός ἐστ’ ἀπὸ γαίης·	-u u- uu- uu -uu - uu --	dactylic hexameter	masculine penthemimeral, trithemimeral
γνώσετ’ ἔπειθ’ ὅσον εἰμὶ θεῶν κάρτιστος ἁπάντων.	-u u- uu -u u- --u u--	dactylic hexameter	feminine penthemimeral, hepthemimeral, trithemimeral
εἰ δ’ἄγε πειρήσασθε θεοὶ ἵνα εἴδετε πάντες·	- uu ---u u- uu -uu --	dactylic hexameter	feminine penthemimeral, hepthemimeral
σειρὴν χρυσείην ἐξ οὐρανόθεν κρεμάσαντες	-- --- - -uu- uu--	dactylic hexameter	masculine penthemimeral
πάντές τ’ἐξάπτεσθε θεοὶ πᾶσαί τε θέαιναι·	-- ---u u- -- u u--	dactylic hexameter	feminine penthemimeral, hepthemimeral
ἀλλ’ οὐκ ἂν ἐρύσαιτ’ ἐξ οὐρανόθεν πεδίον δὲ	- - - uu- - -uu- uu- -	dactylic hexameter	masculine penthemimeral, trithemimeral
Ζῆν’ ὕπατον μήστωρ’, οὐδ’ εἰ μάλα πολλὰ κάμοιτε.	- uu- -- - - uu -u u--	dactylic hexameter	masculine penthemimeral, hepthemimeral, trithemimeral
ἀλλ’ ὅτε δὴ καὶ ἐγὼ πρόφρων ἐθέλοιμι ἐρύσσαι,	- uu - u u- -- uu-u u--	dactylic hexameter	masculine penthemimeral, hepthemimeral, trithemimeral
αὐτῇ κεν γαίῃ ἐρύσαιμ’ αὐτῇ τε θαλάσσῃ·	-- - -- uu- -- u u--	dactylic hexameter	masculine penthemimeral, hepthemimeral, trithemimeral
σειρὴν μέν κεν ἔπειτα περὶ ῥίον Οὐλύμποιο	-- - u u-u u- uu ----	dactylic hexameter	feminine penthemimeral, hepthemimeral, trithemimeral
δησαίμην, τὰ δέ κ’αὖτε μετήορα πάντα γένοιτο.	--- u u -u u-uu -u u--	dactylic hexameter	feminine penthemimeral, trithemimeral
τόσσον ἐγὼ περί τ’εἰμὶ θεῶν περί τ’εἴμ’ ἀνθρώπων.	-u u- uu -u u- uu - ---	dactylic hexameter	feminine penthemimeral, hepthemimeral, trithemimeral
ὣς ἔφαθ’, οἱ δ’ἄρα πάντες ἀκὴν ἐγένοντο σιωπῇ	- uu - uu -u u- uu-u u--	dactylic hexameter	feminine penthemimeral, hepthemimeral, trithemimeral
μῦθον ἀγασσάμενοι· μάλα γὰρ κρατερῶς ἀγόρευσεν.	-u u-uu- uu - uu- uu--	dactylic hexameter	masculine penthemimeral, hepthemimeral
ὀψὲ δὲ δὴ μετέειπε θεὰ γλαυκῶπις Ἀθήνη·	-u u - uu-u u- --u u--	dactylic hexameter	feminine penthemimeral, hepthemimeral, trithemimeral
ὦ πάτερ ἡμέτερε Κρονίδη ὕπατε κρειόντων	- uu -uu- uu- uu- ---	dactylic hexameter	masculine penthemimeral, hepthemimeral
εὖ νυ καὶ ἡμεῖς ἴδμεν ὅ τοι σθένος οὐκ ἐπιεικτόν·	- u u -- -u u - uu - uu--	dactylic hexameter	feminine penthemimeral, hepthemimeral
ἀλλ’ ἔμπης Δαναῶν ὀλοφυρόμεθ’ αἰχμητάων,	- -- uu- uu-uu ----	dactylic hexameter	masculine penthemimeral, trithemimeral
οἵ κεν δὴ κακὸν οἶτον ἀναπλήσαντες ὄλωνται.	- - - uu -u u---u u--	dactylic hexameter	feminine penthemimeral, trithemimeral
ἀλλ’ ἤτοι πολέμου μὲν ἀφεξόμεθ’ ὡς σὺ κελεύεις·	- -- uu- u u-uu - u u--	dactylic hexameter	masculine penthemimeral, trithemimeral
βουλὴν δ’Ἀργείοις ὑποθησόμεθ’ ἥ τις ὀνήσει,	-- --- uu-uu - u u--	dactylic hexameter	masculine penthemimeral
ὡς μὴ πάντες ὄλωνται ὀδυσσαμένοιο τεοῖο.	- - -u u-u u-uu-u u--	dactylic hexameter	feminine penthemimeral
τὴν δ’ἐπιμειδήσας προσέφη νεφεληγερέτα Ζεύς·	- uu--- uu- uu-uu- -	dactylic hexameter	masculine penthemimeral, hepthemimeral
θάρσει Τριτογένεια φίλον τέκος· οὔ νύ τι θυμῷ	-- -uu-u u- uu - u u --	dactylic hexameter	feminine penthemimeral, hepthemimeral
πρόφρονι μυθέομαι, ἐθέλω δέ τοι ἤπιος εἶναι.	-uu -uu- uu- u u -uu --	dactylic hexameter	masculine penthemimeral, hepthemimeral
ὣς εἰπὼν ὑπ’ ὄχεσφι τιτύσκετο χαλκόποδ’ ἵππω	- -- u u-u u-uu -uu --	dactylic hexameter	feminine penthemimeral, trithemimeral
ὠκυπέτα χρυσέῃσιν ἐθείρῃσιν κομόωντε,	-uu- uu-u u--- uu--	dactylic hexameter	feminine penthemimeral, trithemimeral
χρυσὸν δ’αὐτὸς ἔδυνε περὶ χροΐ, γέντο δ’ἱμάσθλην	-- -u u-u u- uu -u u--	dactylic hexameter	feminine penthemimeral, hepthemimeral
χρυσείην εὔτυκτον, ἑοῦ δ’ἐπεβήσετο δίφρου,	--- --u u- uu-uu --	dactylic hexameter	feminine penthemimeral, hepthemimeral, trithemimeral
μάστιξεν δ’ἐλάαν· τὼ δ’οὐκ ἀέκοντε πετέσθην	--- uu- - - uu-u u--	dactylic hexameter	masculine penthemimeral, hepthemimeral, trithemimeral
μεσσηγὺς γαίης τε καὶ οὐρανοῦ ἀστερόεντος.	--- -- u u -uu -uu--	dactylic hexameter	masculine penthemimeral, trithemimeral
Ἴδην δ’ἵκανεν πολυπίδακα μητέρα θηρῶν	-- --- uu-uu -uu --	dactylic hexameter	masculine penthemimeral
Γάργαρον, ἔνθά τέ οἱ τέμενος βωμός τε θυήεις.	-uu -u u - uu- -- u u--	dactylic hexameter	masculine penthemimeral, hepthemimeral
ἔνθ’ ἵππους ἔστησε πατὴρ ἀνδρῶν τε θεῶν τε	- -- --u u- -- u u- -	dactylic hexameter	feminine penthemimeral, hepthemimeral, trithemimeral
λύσας ἐξ ὀχέων, κατὰ δ’ἠέρα πουλὺν ἔχευεν.	-- - uu- uu -uu -u u--	dactylic hexameter	masculine penthemimeral, trithemimeral
αὐτὸς δ’ἐν κορυφῇσι καθέζετο κύδεϊ γαίων	-- - uu-u u-uu -uu --	dactylic hexameter	feminine penthemimeral, trithemimeral
εἰσορόων Τρώων τε πόλιν καὶ νῆας Ἀχαιῶν.	-uu- -- u u- - -u u--	dactylic hexameter	masculine penthemimeral, hepthemimeral, trithemimeral
οἳ δ’ἄρα δεῖπνον ἕλοντο κάρη κομόωντες Ἀχαιοὶ	- uu -u u-u u- uu-u u--	dactylic hexameter	feminine penthemimeral, hepthemimeral
ῥίμφα κατὰ κλισίας, ἀπὸ δ’αὐτοῦ θωρήσσοντο.	-u u- uu- uu -- ----	dactylic hexameter	masculine penthemimeral, trithemimeral
Τρῶες δ’αὖθ’ ἑτέρωθεν ἀνὰ πτόλιν ὁπλίζοντο	-- - uu-u u- uu ----	dactylic hexameter	feminine penthemimeral, hepthemimeral, trithemimeral
παυρότεροι· μέμασαν δὲ καὶ ὧς ὑσμῖνι μάχεσθαι	-uu- uu- u u - --u u--	dactylic hexameter	masculine penthemimeral, hepthemimeral, trithemimeral
χρειοῖ ἀναγκαίῃ, πρό τε παίδων καὶ πρὸ γυναικῶν.	-u u--- u u -- - u u--	dactylic hexameter	masculine penthemimeral
πᾶσαι δ’ὠΐγνυντο πύλαι, ἐκ δ’ἔσσυτο λαός,	-- ---u u- - -uu --	dactylic hexameter	feminine penthemimeral, hepthemimeral
πεζοί θ’ἱππῆές τε· πολὺς δ’ὀρυμαγδὸς ὀρώρει.	-- --- u u- uu-u u--	dactylic hexameter	masculine penthemimeral, hepthemimeral
οἳ δ’ὅτε δή ῥ’ἐς χῶρον ἕνα ξυνιόντες ἵκοντο	- uu - - -u u- uu-u u--	dactylic hexameter	feminine penthemimeral, hepthemimeral, trithemimeral
σύν ῥ’ἔβαλον ῥινούς, σὺν δ’ἔγχεα καὶ μένε’ ἀνδρῶν	- uu- -- - -uu - uu --	dactylic hexameter	masculine penthemimeral, trithemimeral
χαλκεοθωρήκων· ἀτὰρ ἀσπίδες ὀμφαλόεσσαι	-uu--- uu -uu -uu--	dactylic hexameter	masculine penthemimeral
ἔπληντ’ ἀλλήλῃσι, πολὺς δ’ὀρυμαγδὸς ὀρώρει.	-- ---u u- uu-u u--	dactylic hexameter	feminine penthemimeral, hepthemimeral
ἔνθα δ’ἅμ’ οἰμωγή τε καὶ εὐχωλὴ πέλεν ἀνδρῶν	-u u --- u u --- uu --	dactylic hexameter	masculine penthemimeral
ὀλλύντων τε καὶ ὀλλυμένων, ῥέε δ’αἵματι γαῖα.	--- u u -uu- uu -uu --	dactylic hexameter	hepthemimeral, trithemimeral
ὄφρα μὲν ἠὼς ἦν καὶ ἀέξετο ἱερὸν ἦμαρ,	-u u -- - u u-uu -uu --	dactylic hexameter	masculine penthemimeral
τόφρα μάλ’ ἀμφοτέρων βέλε’ ἥπτετο, πῖπτε δὲ λαός.	-u u -uu- uu -uu -u u --	dactylic hexameter	masculine penthemimeral
ἦμος δ’Ἠέλιος μέσον οὐρανὸν ἀμφιβεβήκει,	-- -uu- uu -uu -uu--	dactylic hexameter	masculine penthemimeral
καὶ τότε δὴ χρύσεια πατὴρ ἐτίταινε τάλαντα·	- uu - --u u- uu-u u--	dactylic hexameter	feminine penthemimeral, hepthemimeral, trithemimeral
ἐν δ’ἐτίθει δύο κῆρε τανηλεγέος θανάτοιο	- uu- uu -u u-uu- uu--	dactylic hexameter	feminine penthemimeral, trithemimeral
Τρώων θ’ἱπποδάμων καὶ Ἀχαιῶν χαλκοχιτώνων,	-- -uu- u u-- -uu--	dactylic hexameter	masculine penthemimeral
ἕλκε δὲ μέσσα λαβών· ῥέπε δ’αἴσιμον ἦμαρ Ἀχαιῶν.	-u u -u u- uu -uu -u u--	dactylic hexameter	masculine penthemimeral
αἳ μὲν Ἀχαιῶν κῆρες ἐπὶ χθονὶ πουλυβοτείρῃ	- u u-- -u u- uu -uu--	dactylic hexameter	feminine penthemimeral, hepthemimeral
ἑζέσθην, Τρώων δὲ πρὸς οὐρανὸν εὐρὺν ἄερθεν·	--- -- u u -uu -u u--	dactylic hexameter	masculine penthemimeral, trithemimeral
αὐτὸς δ’ἐξ Ἴδης μεγάλ’ ἔκτυπε, δαιόμενον δὲ	-- - -- uu -uu -uu- -	dactylic hexameter	masculine penthemimeral, trithemimeral
ἧκε σέλας μετὰ λαὸν Ἀχαιῶν· οἳ δὲ ἰδόντες	-u u- uu -u u-- - u u--	dactylic hexameter	feminine penthemimeral, trithemimeral
θάμβησαν, καὶ πάντας ὑπὸ χλωρὸν δέος εἷλεν.	--- - -u u- -- uu --	dactylic hexameter	feminine penthemimeral, hepthemimeral, trithemimeral
ἔνθ’ οὔτ’ Ἰδομενεὺς τλῆ μίμνειν οὔτ’ Ἀγαμέμνων,	- - -uu- - -- - uu--	dactylic hexameter	masculine penthemimeral
οὔτε δύ’ Αἴαντες μενέτην θεράποντες Ἄρηος·	-u u --- uu- uu-u u--	dactylic hexameter	masculine penthemimeral, hepthemimeral
Νέστωρ οἶος ἔμιμνε Γερήνιος οὖρος Ἀχαιῶν	-- -u u-u u-uu -u u--	dactylic hexameter	feminine penthemimeral
οὔ τι ἑκών, ἀλλ’ ἵππος ἐτείρετο, τὸν βάλεν ἰῷ	- u u- - -u u-uu - uu --	dactylic hexameter	feminine penthemimeral, trithemimeral
δῖος Ἀλέξανδρος Ἑλένης πόσις ἠϋκόμοιο	-u u--- uu- uu -uu--	dactylic hexameter	masculine penthemimeral, hepthemimeral
ἄκρην κὰκ κορυφήν, ὅθι τε πρῶται τρίχες ἵππων	-- - uu- uu - -- uu --	dactylic hexameter	masculine penthemimeral, hepthemimeral, trithemimeral
κρανίῳ ἐμπεφύασι, μάλιστα δὲ καίριόν ἐστιν.	-uu -uu-u u-u u -uu --	dactylic hexameter	feminine penthemimeral
ἀλγήσας δ’ἀνέπαλτο, βέλος δ’εἰς ἐγκέφαλον δῦ,	--- uu-u u- - -uu- -	dactylic hexameter	feminine penthemimeral, hepthemimeral, trithemimeral
σὺν δ’ἵππους ἐτάραξε κυλινδόμενος περὶ χαλκῷ.	- -- uu-u u-uu- uu --	dactylic hexameter	feminine penthemimeral, trithemimeral
ὄφρ’ ὁ γέρων ἵπποιο παρηορίας ἀπέταμνε	- u u- --u u-uu- uu--	dactylic hexameter	feminine penthemimeral, trithemimeral
φασγάνῳ ἀΐσσων, τόφρ’ Ἕκτορος ὠκέες ἵπποι	-uu --- - -uu -uu --	dactylic hexameter	masculine penthemimeral
ἦλθον ἀν’ ἰωχμὸν θρασὺν ἡνίοχον φορέοντες	-u u --- uu -uu- uu--	dactylic hexameter	masculine penthemimeral
Ἕκτορα· καί νύ κεν ἔνθ’ ὁ γέρων ἀπὸ θυμὸν ὄλεσσεν	-uu - u u - u u- uu -u u--	dactylic hexameter	masculine penthemimeral, hepthemimeral, trithemimeral
εἰ μὴ ἄρ’ ὀξὺ νόησε βοὴν ἀγαθὸς Διομήδης·	- u u -u u-u u- uu- uu--	dactylic hexameter	feminine penthemimeral, hepthemimeral
σμερδαλέον δ’ἐβόησεν ἐποτρύνων Ὀδυσῆα·	-uu- uu-u u--- uu--	dactylic hexameter	feminine penthemimeral, trithemimeral
διογενὲς Λαερτιάδη πολυμήχαν’ Ὀδυσσεῦ	-uu- --uu- uu-u u--	dactylic hexameter	hepthemimeral, trithemimeral
πῇ φεύγεις μετὰ νῶτα βαλὼν κακὸς ὣς ἐν ὁμίλῳ;	- -- uu -u u- uu - u u--	dactylic hexameter	feminine penthemimeral, hepthemimeral, trithemimeral
μή τίς τοι φεύγοντι μεταφρένῳ ἐν δόρυ πήξῃ·	- - - --u u-uu - uu --	dactylic hexameter	feminine penthemimeral, trithemimeral
ἀλλὰ μέν’ ὄφρα γέροντος ἀπώσομεν ἄγριον ἄνδρα.	-u u -u u-u u-uu -uu --	dactylic hexameter	feminine penthemimeral
ὣς ἔφατ’, οὐδ’ ἐσάκουσε πολύτλας δῖος Ὀδυσσεύς,	- uu - uu-u u-- -u u--	dactylic hexameter	feminine penthemimeral, trithemimeral
ἀλλὰ παρήϊξεν κοίλας ἐπὶ νῆας Ἀχαιῶν.	-u u--- -- uu -u u--	dactylic hexameter	masculine penthemimeral, hepthemimeral
Τυδεΐδης δ’αὐτός περ ἐὼν προμάχοισιν ἐμίχθη,	-uu- -- u u- uu-u u--	dactylic hexameter	masculine penthemimeral, hepthemimeral, trithemimeral
στῆ δὲ πρόσθ’ ἵππων Νηληϊάδαο γέροντος,	- - - -- --uu-u u--	dactylic hexameter	masculine penthemimeral, trithemimeral
καί μιν φωνήσας ἔπεα πτερόεντα προσηύδα·	- - --- uu- uu-u u--	dactylic hexameter	masculine penthemimeral, hepthemimeral
ὦ γέρον ἦ μάλα δή σε νέοι τείρουσι μαχηταί,	- uu - uu - u u- --u u--	dactylic hexameter	masculine penthemimeral, hepthemimeral, trithemimeral
σὴ δὲ βίη λέλυται, χαλεπὸν δέ σε γῆρας ὀπάζει,	- u u- uu- uu- u u -u u--	dactylic hexameter	masculine penthemimeral, hepthemimeral, trithemimeral
ἠπεδανὸς δέ νύ τοι θεράπων, βραδέες δέ τοι ἵπποι.	-uu- u u - uu- uu- u u --	dactylic hexameter	masculine penthemimeral, hepthemimeral, trithemimeral
ἀλλ’ ἄγ’ ἐμῶν ὀχέων ἐπιβήσεο, ὄφρα ἴδηαι	- u u- uu- uu-uu -u u--	dactylic hexameter	masculine penthemimeral, trithemimeral
οἷοι Τρώϊοι ἵπποι ἐπιστάμενοι πεδίοιο	-- -uu -u u-uu- uu--	dactylic hexameter	feminine penthemimeral
κραιπνὰ μάλ’ ἔνθα καὶ ἔνθα διωκέμεν ἠδὲ φέβεσθαι,	-u u -u u -u u-uu -u u--	dactylic hexameter	feminine penthemimeral
οὕς ποτ’ ἀπ’ Αἰνείαν ἑλόμην μήστωρε φόβοιο.	- u u --- uu- --u u--	dactylic hexameter	masculine penthemimeral, hepthemimeral
τούτω μὲν θεράποντε κομείτων, τώδε δὲ νῶϊ	-- - uu-u u-- -u u --	dactylic hexameter	feminine penthemimeral, trithemimeral
Τρωσὶν ἐφ’ ἱπποδάμοις ἰθύνομεν, ὄφρα καὶ Ἕκτωρ	-u u -uu- --uu -u u --	dactylic hexameter	masculine penthemimeral
εἴσεται εἰ καὶ ἐμὸν δόρυ μαίνεται ἐν παλάμῃσιν.	-uu - u u- uu -uu - uu--	dactylic hexameter	masculine penthemimeral, trithemimeral
ὣς ἔφατ’, οὐδ’ ἀπίθησε Γερήνιος ἱππότα Νέστωρ.	- uu - uu-u u-uu -uu --	dactylic hexameter	feminine penthemimeral, trithemimeral
Νεστορέας μὲν ἔπειθ’ ἵππους θεράποντε κομείτην	-uu- u u- -- uu-u u--	dactylic hexameter	masculine penthemimeral, hepthemimeral, trithemimeral
ἴφθιμοι Σθένελός τε καὶ Εὐρυμέδων ἀγαπήνωρ.	--- uu- u u -uu- uu--	dactylic hexameter	masculine penthemimeral, trithemimeral
τὼ δ’εἰς ἀμφοτέρω Διομήδεος ἅρματα βήτην·	- - -uu- uu-uu -uu --	dactylic hexameter	masculine penthemimeral
Νέστωρ δ’ἐν χείρεσσι λάβ’ ἡνία σιγαλόεντα,	-- - --u u -uu -uu--	dactylic hexameter	feminine penthemimeral, trithemimeral
μάστιξεν δ’ἵππους· τάχα δ’Ἕκτορος ἄγχι γένοντο.	--- -- uu -uu -u u--	dactylic hexameter	masculine penthemimeral, trithemimeral
τοῦ δ’ἰθὺς μεμαῶτος ἀκόντισε Τυδέος υἱός·	- -- uu-u u-uu -uu --	dactylic hexameter	feminine penthemimeral, trithemimeral
καὶ τοῦ μέν ῥ’ἀφάμαρτεν, ὃ δ’ἡνίοχον θεράποντα	- - - uu-u u -uu- uu--	dactylic hexameter	feminine penthemimeral, trithemimeral
υἱὸν ὑπερθύμου Θηβαίου Ἠνιοπῆα	-u u--- --- -uu--	dactylic hexameter	masculine penthemimeral
ἵππων ἡνί’ ἔχοντα βάλε στῆθος παρὰ μαζόν.	-- -u u-u u- -- uu --	dactylic hexameter	feminine penthemimeral, hepthemimeral
ἤριπε δ’ἐξ ὀχέων, ὑπερώησαν δέ οἱ ἵπποι	-uu - uu- uu--- u u --	dactylic hexameter	masculine penthemimeral, trithemimeral
ὠκύποδες· τοῦ δ’αὖθι λύθη ψυχή τε μένος τε.	-uu- - -u u- -- u u- -	dactylic hexameter	feminine penthemimeral, hepthemimeral, trithemimeral
Ἕκτορα δ’αἰνὸν ἄχος πύκασε φρένας ἡνιόχοιο·	-uu -u u- uu- uu -uu--	dactylic hexameter	masculine penthemimeral, hepthemimeral
τὸν μὲν ἔπειτ’ εἴασε καὶ ἀχνύμενός περ ἑταίρου	- u u- --u u -uu- u u--	dactylic hexameter	feminine penthemimeral, trithemimeral
κεῖσθαι, ὃ δ’ἡνίοχον μέθεπε θρασύν· οὐδ’ ἄρ’ ἔτι δὴν	-u u -uu- uu- uu - u u- -	dactylic hexameter	masculine penthemimeral, hepthemimeral
ἵππω δευέσθην σημάντορος· αἶψα γὰρ εὗρεν	-- --- --uu -u u --	dactylic hexameter	masculine penthemimeral
Ἰφιτίδην Ἀρχεπτόλεμον θρασύν, ὅν ῥα τόθ’ ἵππων	-uu- --uu- uu - u u --	dactylic hexameter	hepthemimeral, trithemimeral
ὠκυπόδων ἐπέβησε, δίδου δέ οἱ ἡνία χερσίν.	-uu- uu-u u- u u -uu --	dactylic hexameter	feminine penthemimeral, hepthemimeral, trithemimeral
ἔνθά κε λοιγὸς ἔην καὶ ἀμήχανα ἔργα γένοντο,	-u u -u u- u u-uu -u u--	dactylic hexameter	masculine penthemimeral
καί νύ κε σήκασθεν κατὰ Ἴλιον ἠΰτε ἄρνες,	- u u --- uu -uu -uu --	dactylic hexameter	masculine penthemimeral
εἰ μὴ ἄρ’ ὀξὺ νόησε πατὴρ ἀνδρῶν τε θεῶν τε·	- u u -u u-u u- -- u u- -	dactylic hexameter	feminine penthemimeral, hepthemimeral
βροντήσας δ’ἄρα δεινὸν ἀφῆκ’ ἀργῆτα κεραυνόν,	--- uu -u u- --u u--	dactylic hexameter	feminine penthemimeral, hepthemimeral, trithemimeral
κὰδ δὲ πρόσθ’ ἵππων Διομήδεος ἧκε χαμᾶζε·	- - - -- uu-uu -u u--	dactylic hexameter	masculine penthemimeral, trithemimeral
δεινὴ δὲ φλὸξ ὦρτο θεείου καιομένοιο,	-- - - -u u-- -uu--	dactylic hexameter	feminine penthemimeral, trithemimeral
τὼ δ’ἵππω δείσαντε καταπτήτην ὑπ’ ὄχεσφι·	- -- --u u--- u u--	dactylic hexameter	feminine penthemimeral, trithemimeral
Νέστορα δ’ἐκ χειρῶν φύγον ἡνία σιγαλόεντα,	-uu - -- uu -uu -uu--	dactylic hexameter	masculine penthemimeral, trithemimeral
δεῖσε δ’ὅ γ’ἐν θυμῷ, Διομήδεα δὲ προσέειπε·	-u u - -- uu-uu - uu--	dactylic hexameter	masculine penthemimeral, trithemimeral
Τυδεΐδη ἄγε δ’αὖτε φόβον δ’ἔχε μώνυχας ἵππους.	-uu- uu -u u- uu -uu --	dactylic hexameter	feminine penthemimeral, hepthemimeral, trithemimeral
ἦ οὐ γιγνώσκεις ὅ τοι ἐκ Διὸς οὐχ ἕπετ’ ἀλκή;	- - --- u u - uu - uu --	dactylic hexameter	masculine penthemimeral, hepthemimeral
νῦν μὲν γὰρ τούτῳ Κρονίδης Ζεὺς κῦδος ὀπάζει	- - - -- uu- - -u u--	dactylic hexameter	masculine penthemimeral, hepthemimeral, trithemimeral
σήμερον· ὕστερον αὖτε καὶ ἡμῖν, αἴ κ’ἐθέλῃσι,	-uu -uu -u u -- - uu--	dactylic hexameter	feminine penthemimeral
δώσει· ἀνὴρ δέ κεν οὔ τι Διὸς νόον εἰρύσσαιτο	-u u- u u - u u- uu ----	dactylic hexameter	masculine penthemimeral, hepthemimeral, trithemimeral
οὐδὲ μάλ’ ἴφθιμος, ἐπεὶ ἦ πολὺ φέρτερός ἐστι.	-u u --- uu - uu -uu --	dactylic hexameter	masculine penthemimeral, hepthemimeral
τὸν δ’ἠμείβετ’ ἔπειτα βοὴν ἀγαθὸς Διομήδης·	- --u u-u u- uu- uu--	dactylic hexameter	feminine penthemimeral, hepthemimeral
ναὶ δὴ ταῦτά γε πάντα γέρον κατὰ μοῖραν ἔειπες·	- - -u u -u u- uu -u u--	dactylic hexameter	feminine penthemimeral, hepthemimeral
ἀλλὰ τόδ’ αἰνὸν ἄχος κραδίην καὶ θυμὸν ἱκάνει·	-u u -u u- uu- - -u u--	dactylic hexameter	masculine penthemimeral, hepthemimeral
Ἕκτωρ γάρ ποτε φήσει ἐνὶ Τρώεσσ’ ἀγορεύων·	-- - uu -u u- -- uu--	dactylic hexameter	feminine penthemimeral, hepthemimeral, trithemimeral
Τυδεΐδης ὑπ’ ἐμεῖο φοβεύμενος ἵκετο νῆας.	-uu- u u-u u-uu -uu --	dactylic hexameter	feminine penthemimeral, trithemimeral
ὥς ποτ’ ἀπειλήσει· τότε μοι χάνοι εὐρεῖα χθών.	- u u--- uu - uu --- -	dactylic hexameter	masculine penthemimeral, hepthemimeral
τὸν δ’ἠμείβετ’ ἔπειτα Γερήνιος ἱππότα Νέστωρ·	- --u u-u u-uu -uu --	dactylic hexameter	feminine penthemimeral
ὤ μοι Τυδέος υἱὲ δαΐφρονος, οἷον ἔειπες.	- - -uu -u u-uu -u u--	dactylic hexameter	feminine penthemimeral
εἴ περ γάρ σ’Ἕκτωρ γε κακὸν καὶ ἀνάλκιδα φήσει,	- - - -- u u- u u-uu --	dactylic hexameter	masculine penthemimeral, hepthemimeral, trithemimeral
ἀλλ’ οὐ πείσονται Τρῶες καὶ Δαρδανίωνες	- - --- -- - -uu--	dactylic hexameter	masculine penthemimeral, hepthemimeral
καὶ Τρώων ἄλοχοι μεγαθύμων ἀσπιστάων,	- -- uu- uu-- ----	dactylic hexameter	masculine penthemimeral, trithemimeral
τάων ἐν κονίῃσι βάλες θαλεροὺς παρακοίτας.	-- - uu-u u- uu- uu--	dactylic hexameter	feminine penthemimeral, hepthemimeral, trithemimeral
ὣς ἄρα φωνήσας φύγαδε τράπε μώνυχας ἵππους	- uu --- uu- uu -uu --	dactylic hexameter	masculine penthemimeral, hepthemimeral
αὖτις ἀν’ ἰωχμόν· ἐπὶ δὲ Τρῶές τε καὶ Ἕκτωρ	-u u --- uu - -- u u --	dactylic hexameter	masculine penthemimeral, hepthemimeral
ἠχῇ θεσπεσίῃ βέλεα στονόεντα χέοντο.	-- -uu- uu- uu-u u--	dactylic hexameter	masculine penthemimeral, hepthemimeral
τῷ δ’ἐπὶ μακρὸν ἄϋσε μέγας κορυθαίολος Ἕκτωρ·	- uu -u u-u u- uu-uu --	dactylic hexameter	feminine penthemimeral, hepthemimeral
Τυδεΐδη περὶ μέν σε τίον Δαναοὶ ταχύπωλοι	-uu- uu - u u- uu- uu--	dactylic hexameter	masculine penthemimeral, hepthemimeral, trithemimeral
ἕδρῃ τε κρέασίν τε ἰδὲ πλείοις δεπάεσσι·	-- - uu- u u- -- uu--	dactylic hexameter	masculine penthemimeral, hepthemimeral, trithemimeral
νῦν δέ σ’ἀτιμήσουσι· γυναικὸς ἄρ’ ἀντὶ τέτυξο.	- u u---u u-u u -u u--	dactylic hexameter	feminine penthemimeral
ἔρρε κακὴ γλήνη, ἐπεὶ οὐκ εἴξαντος ἐμεῖο	-u u- -- uu - --u u--	dactylic hexameter	masculine penthemimeral, hepthemimeral, trithemimeral
πύργων ἡμετέρων ἐπιβήσεαι, οὐδὲ γυναῖκας	-- -uu- uu-uu -u u--	dactylic hexameter	masculine penthemimeral
ἄξεις ἐν νήεσσι· πάρος τοι δαίμονα δώσω.	-- - --u u- - -uu --	dactylic hexameter	feminine penthemimeral, hepthemimeral, trithemimeral
ὣς φάτο, Τυδεΐδης δὲ διάνδιχα μερμήριξεν	- uu -uu- u u-uu ----	dactylic hexameter	masculine penthemimeral
ἵππους τε στρέψαι καὶ ἐναντίβιον μαχέσασθαι.	-- - -- u u-uu- uu--	dactylic hexameter	masculine penthemimeral, trithemimeral
τρὶς μὲν μερμήριξε κατὰ φρένα καὶ κατὰ θυμόν,	- - ---u u- uu - uu --	dactylic hexameter	feminine penthemimeral, hepthemimeral
τρὶς δ’ἄρ’ ἀπ’ Ἰδαίων ὀρέων κτύπε μητίετα Ζεὺς	- u u --- uu- uu -uu- -	dactylic hexameter	masculine penthemimeral, hepthemimeral
σῆμα τιθεὶς Τρώεσσι μάχης ἑτεραλκέα νίκην.	-u u- --u u- uu-uu --	dactylic hexameter	feminine penthemimeral, hepthemimeral, trithemimeral
Ἕκτωρ δὲ Τρώεσσιν ἐκέκλετο μακρὸν ἀΰσας·	-- - --u u-uu -u u--	dactylic hexameter	feminine penthemimeral, trithemimeral
Τρῶες καὶ Λύκιοι καὶ Δάρδανοι ἀγχιμαχηταὶ	-- - uu- - -uu -uu--	dactylic hexameter	masculine penthemimeral, trithemimeral
ἀνέρες ἔστε φίλοι, μνήσασθε δὲ θούριδος ἀλκῆς.	-uu -u u- --u u -uu --	dactylic hexameter	masculine penthemimeral
γιγνώσκω δ’ὅτι μοι πρόφρων κατένευσε Κρονίων	--- uu - -- uu-u u--	dactylic hexameter	masculine penthemimeral, hepthemimeral, trithemimeral
νίκην καὶ μέγα κῦδος, ἀτὰρ Δαναοῖσί γε πῆμα·	-- - uu -u u- uu-u u --	dactylic hexameter	feminine penthemimeral, hepthemimeral, trithemimeral
νήπιοι οἳ ἄρα δὴ τάδε τείχεα μηχανόωντο	-uu - uu - uu -uu -uu--	dactylic hexameter	masculine penthemimeral, trithemimeral
ἀβλήχρ’ οὐδενόσωρα· τὰ δ’οὐ μένος ἁμὸν ἐρύξει·	-- -uu-u u - uu -u u--	dactylic hexameter	feminine penthemimeral, hepthemimeral
ἵπποι δὲ ῥέα τάφρον ὑπερθορέονται ὀρυκτήν.	-- - uu -u u-uu-u u--	dactylic hexameter	feminine penthemimeral, trithemimeral
ἀλλ’ ὅτε κεν δὴ νηυσὶν ἔπι γλαφυρῇσι γένωμαι,	- uu - - -u u- uu-u u--	dactylic hexameter	feminine penthemimeral, hepthemimeral, trithemimeral
μνημοσύνη τις ἔπειτα πυρὸς δηίοιο γενέσθω,	-uu- u u-u u- --u u--	dactylic hexameter	feminine penthemimeral, hepthemimeral, trithemimeral
ὡς πυρὶ νῆας ἐνιπρήσω, κτείνω δὲ καὶ αὐτοὺς	- uu -u u--- -- u u --	dactylic hexameter	hepthemimeral
Ἀργείους παρὰ νηυσὶν ἀτυζομένους ὑπὸ καπνοῦ.	--- uu -u u-uu- uu --	dactylic hexameter	feminine penthemimeral, trithemimeral
ὣς εἰπὼν ἵπποισιν ἐκέκλετο φώνησέν τε·	- -- --u u-uu --- -	dactylic hexameter	feminine penthemimeral, trithemimeral
Ξάνθέ τε καὶ σὺ Πόδαργε καὶ Αἴθων Λάμπέ τε δῖε	-u u - u u-u u -- -u u --	dactylic hexameter	feminine penthemimeral, trithemimeral
νῦν μοι τὴν κομιδὴν ἀποτίνετον, ἣν μάλα πολλὴν	- - - uu- uu-uu - uu --	dactylic hexameter	masculine penthemimeral, trithemimeral
Ἀνδρομάχη θυγάτηρ μεγαλήτορος Ἠετίωνος	-uu- uu- uu-uu -uu--	dactylic hexameter	masculine penthemimeral, trithemimeral
ὑμῖν πὰρ προτέροισι μελίφρονα πυρὸν ἔθηκεν	-- - uu-u u-uu -u u--	dactylic hexameter	feminine penthemimeral, trithemimeral
οἶνόν τ’ἐγκεράσασα πιεῖν, ὅτε θυμὸς ἀνώγοι,	-- -uu-u u- uu -u u--	dactylic hexameter	feminine penthemimeral, hepthemimeral
ἢ ἐμοί, ὅς πέρ οἱ θαλερὸς πόσις εὔχομαι εἶναι.	- uu - - - uu- uu -uu --	dactylic hexameter	masculine penthemimeral, hepthemimeral, trithemimeral
ἀλλ’ ἐφομαρτεῖτον καὶ σπεύδετον ὄφρα λάβωμεν	- uu--- - -uu -u u--	dactylic hexameter	masculine penthemimeral
ἀσπίδα Νεστορέην, τῆς νῦν κλέος οὐρανὸν ἵκει	-uu -uu- - - uu -uu --	dactylic hexameter	masculine penthemimeral, hepthemimeral
πᾶσαν χρυσείην ἔμεναι, κανόνας τε καὶ αὐτήν,	-- --- uu- uu- u u --	dactylic hexameter	masculine penthemimeral, hepthemimeral
αὐτὰρ ἀπ’ ὤμοιιν Διομήδεος ἱπποδάμοιο	-u u --- uu-uu -uu--	dactylic hexameter	masculine penthemimeral
δαιδάλεον θώρηκα, τὸν Ἥφαιστος κάμε τεύχων.	-uu- --u u --- uu --	dactylic hexameter	feminine penthemimeral, trithemimeral
εἰ τούτω κε λάβοιμεν, ἐελποίμην κεν Ἀχαιοὺς	- -- u u-u u--- u u--	dactylic hexameter	feminine penthemimeral, trithemimeral
αὐτονυχὶ νηῶν ἐπιβησέμεν ὠκειάων.	-uu- -- uu-uu ----	dactylic hexameter	masculine penthemimeral, trithemimeral
ὣς ἔφατ’ εὐχόμενος, νεμέσησε δὲ πότνια Ἥρη,	- uu -uu- uu-u u -uu --	dactylic hexameter	masculine penthemimeral
σείσατο δ’εἰνὶ θρόνῳ, ἐλέλιξε δὲ μακρὸν Ὄλυμπον,	-uu -u u- uu-u u -u u--	dactylic hexameter	masculine penthemimeral
καί ῥα Ποσειδάωνα μέγαν θεὸν ἀντίον ηὔδα·	- u u---u u- uu -uu --	dactylic hexameter	feminine penthemimeral, hepthemimeral
ὢ πόποι ἐννοσίγαι’ εὐρυσθενές, οὐδέ νυ σοί περ	- uu -uu- --uu -u u - -	dactylic hexameter	masculine penthemimeral
ὀλλυμένων Δαναῶν ὀλοφύρεται ἐν φρεσὶ θυμός.	-uu- uu- uu-uu - uu --	dactylic hexameter	masculine penthemimeral, trithemimeral
οἳ δέ τοι εἰς Ἑλίκην τε καὶ Αἰγὰς δῶρ’ ἀνάγουσι	- u u - uu- u u -- - uu--	dactylic hexameter	masculine penthemimeral, trithemimeral
πολλά τε καὶ χαρίεντα· σὺ δέ σφισι βούλεο νίκην.	-u u - uu-u u - uu -uu --	dactylic hexameter	feminine penthemimeral, hepthemimeral, trithemimeral
εἴ περ γάρ κ’ἐθέλοιμεν, ὅσοι Δαναοῖσιν ἀρωγοί,	- - - uu-u u- uu-u u--	dactylic hexameter	feminine penthemimeral, hepthemimeral, trithemimeral
Τρῶας ἀπώσασθαι καὶ ἐρυκέμεν εὐρύοπα Ζῆν,	-u u--- u u-uu -uu- -	dactylic hexameter	masculine penthemimeral
αὐτοῦ κ’ἔνθ’ ἀκάχοιτο καθήμενος οἶος ἐν Ἴδῃ.	-- - uu-u u-uu -u u --	dactylic hexameter	feminine penthemimeral, trithemimeral
τὴν δὲ μέγ’ ὀχθήσας προσέφη κρείων ἐνοσίχθων·	- u u --- uu- -- uu--	dactylic hexameter	masculine penthemimeral, hepthemimeral
Ἥρη ἀπτοεπὲς ποῖον τὸν μῦθον ἔειπες.	-- -uu- -- - -u u--	dactylic hexameter	masculine penthemimeral, hepthemimeral
οὐκ ἂν ἔγωγ’ ἐθέλοιμι Διὶ Κρονίωνι μάχεσθαι	- u u- uu-u u- uu-u u--	dactylic hexameter	feminine penthemimeral, hepthemimeral, trithemimeral
ἡμέας τοὺς ἄλλους, ἐπεὶ ἦ πολὺ φέρτερός ἐστιν.	-u- - -- uu - uu -uu --	lyric	
ὣς οἳ μὲν τοιαῦτα πρὸς ἀλλήλους ἀγόρευον·	- - - --u u --- uu--	dactylic hexameter	feminine penthemimeral, trithemimeral
τῶν δ’ὅσον ἐκ νηῶν ἀπὸ πύργου τάφρος ἔεργε	- uu - -- uu -- -u u--	dactylic hexameter	masculine penthemimeral, trithemimeral
πλῆθεν ὁμῶς ἵππων τε καὶ ἀνδρῶν ἀσπιστάων	-u u- -- u u -- ----	dactylic hexameter	masculine penthemimeral, trithemimeral
εἰλομένων· εἴλει δὲ θοῷ ἀτάλαντος Ἄρηϊ	-uu- -- u u- uu-u u--	dactylic hexameter	masculine penthemimeral, hepthemimeral, trithemimeral
Ἕκτωρ Πριαμίδης, ὅτε οἱ Ζεὺς κῦδος ἔδωκε.	-- -uu- uu - - -u u--	dactylic hexameter	masculine penthemimeral, hepthemimeral
καί νύ κ’ἐνέπρησεν πυρὶ κηλέῳ νῆας ἐΐσας,	- - uu-- -- -u- -u uuu	lyric	
εἰ μὴ ἐπὶ φρεσὶ θῆκ’ Ἀγαμέμνονι πότνια Ἥρη	- u u- uu - uu-uu -uu --	dactylic hexameter	masculine penthemimeral, trithemimeral
αὐτῷ ποιπνύσαντι θοῶς ὀτρῦναι Ἀχαιούς.	-- ---u u- --u u--	dactylic hexameter	feminine penthemimeral, hepthemimeral
βῆ δ’ἰέναι παρά τε κλισίας καὶ νῆας Ἀχαιῶν	- uu- uu - uu- - -u u--	dactylic hexameter	masculine penthemimeral, hepthemimeral, trithemimeral
πορφύρεον μέγα φᾶρος ἔχων ἐν χειρὶ παχείῃ,	-uu- uu -u u- - -u u--	dactylic hexameter	feminine penthemimeral, hepthemimeral, trithemimeral
στῆ δ’ἐπ’ Ὀδυσσῆος μεγακήτεϊ νηῒ μελαίνῃ,	- u u--- uu-uu -u u--	dactylic hexameter	masculine penthemimeral
ἥ ῥ’ἐν μεσσάτῳ ἔσκε γεγωνέμεν ἀμφοτέρωσε,	- - -uu -u u-uu -uu--	dactylic hexameter	feminine penthemimeral
ἠμὲν ἐπ’ Αἴαντος κλισίας Τελαμωνιάδαο	-u u --- uu- uu-uu--	dactylic hexameter	masculine penthemimeral, hepthemimeral
ἠδ’ ἐπ’ Ἀχιλλῆος, τοί ῥ’ἔσχατα νῆας ἐΐσας	- u u--- - -uu -u u--	dactylic hexameter	masculine penthemimeral
εἴρυσαν, ἠνορέῃ πίσυνοι καὶ κάρτεϊ χειρῶν·	-uu -uu- uu- - -uu --	dactylic hexameter	masculine penthemimeral, hepthemimeral
ἤϋσεν δὲ διαπρύσιον Δαναοῖσι γεγωνώς·	--- u u-uu- uu-u u--	dactylic hexameter	hepthemimeral, trithemimeral
αἰδὼς Ἀργεῖοι, κάκ’ ἐλέγχεα, εἶδος ἀγητοί·	-- --- u u-uu -u u--	dactylic hexameter	masculine penthemimeral
πῇ ἔβαν εὐχωλαί, ὅτε δὴ φάμεν εἶναι ἄριστοι,	- uu --- uu - uu -u u--	dactylic hexameter	masculine penthemimeral, hepthemimeral
ἃς ὁπότ’ ἐν Λήμνῳ κενεαυχέες ἠγοράασθε,	- uu - -- uu-uu -uu--	dactylic hexameter	masculine penthemimeral, trithemimeral
ἔσθοντες κρέα πολλὰ βοῶν ὀρθοκραιράων	--- uu -u u- -----	dactylic hexameter	feminine penthemimeral, hepthemimeral, trithemimeral
πίνοντες κρητῆρας ἐπιστεφέας οἴνοιο,	--- --u u-uu- ---	dactylic hexameter	feminine penthemimeral, trithemimeral
Τρώων ἄνθ’ ἑκατόν τε διηκοσίων τε ἕκαστος	-- - uu- u u-uu- u u--	dactylic hexameter	masculine penthemimeral, trithemimeral
στήσεσθ’ ἐν πολέμῳ· νῦν δ’οὐδ’ ἑνὸς ἄξιοί εἰμεν	-- - uu- - - uu -uu --	dactylic hexameter	masculine penthemimeral, hepthemimeral, trithemimeral
Ἕκτορος, ὃς τάχα νῆας ἐνιπρήσει πυρὶ κηλέῳ.	-uu - uu -u u--- uu --	dactylic hexameter	feminine penthemimeral, trithemimeral
Ζεῦ πάτερ, ἦ ῥά τιν’ ἤδη ὑπερμενέων βασιλήων	- uu - u u -u u-uu- uu--	dactylic hexameter	feminine penthemimeral, trithemimeral
τῇδ’ ἄτῃ ἄασας καί μιν μέγα κῦδος ἀπηύρας;	- -- uu- - - uu -u u--	dactylic hexameter	masculine penthemimeral, hepthemimeral, trithemimeral
οὐ μὲν δή ποτέ φημι τεὸν περικαλλέα βωμὸν	- - - uu -u u- uu-uu --	dactylic hexameter	feminine penthemimeral, hepthemimeral, trithemimeral
νηῒ πολυκλήϊδι παρελθέμεν ἐνθάδε ἔρρων,	-u u---u u-uu -uu --	dactylic hexameter	feminine penthemimeral
ἀλλ’ ἐπὶ πᾶσι βοῶν δημὸν καὶ μηρί’ ἔκηα	- uu -u u- -- - -u u--	dactylic hexameter	masculine penthemimeral, hepthemimeral
ἱέμενος Τροίην εὐτείχεον ἐξαλαπάξαι.	-uu- -- --uu -uu--	dactylic hexameter	masculine penthemimeral, trithemimeral
ἀλλὰ Ζεῦ τόδε πέρ μοι ἐπικρήηνον ἐέλδωρ·	-- - uu - u u---u u--	dactylic hexameter	masculine penthemimeral, trithemimeral
αὐτοὺς δή περ ἔασον ὑπεκφυγέειν καὶ ἀλύξαι,	-- - u u-u u-uu- u u--	dactylic hexameter	feminine penthemimeral, trithemimeral
μηδ’ οὕτω Τρώεσσιν ἔα δάμνασθαι Ἀχαιούς.	- -- --u u- --u u--	dactylic hexameter	feminine penthemimeral, hepthemimeral, trithemimeral
ὣς φάτο, τὸν δὲ πατὴρ ὀλοφύρατο δάκρυ χέοντα,	- uu - u u- uu-uu -u u--	dactylic hexameter	masculine penthemimeral, trithemimeral
νεῦσε δέ οἱ λαὸν σόον ἔμμεναι οὐδ’ ἀπολέσθαι.	-u u - -- uu -uu - uu--	dactylic hexameter	masculine penthemimeral, trithemimeral
αὐτίκα δ’αἰετὸν ἧκε τελειότατον πετεηνῶν,	-uu -uu -u u-uu- uu--	dactylic hexameter	feminine penthemimeral
νεβρὸν ἔχοντ’ ὀνύχεσσι τέκος ἐλάφοιο ταχείης·	-u u- uu-u u- uu-u u--	dactylic hexameter	feminine penthemimeral, hepthemimeral, trithemimeral
πὰρ δὲ Διὸς βωμῷ περικαλλέϊ κάββαλε νεβρόν,	- u u- -- uu-uu -uu --	dactylic hexameter	masculine penthemimeral, trithemimeral
ἔνθα πανομφαίῳ Ζηνὶ ῥέζεσκον Ἀχαιοί.	-u u--- -- --u u--	dactylic hexameter	masculine penthemimeral, hepthemimeral
οἳ δ’ὡς οὖν εἴδονθ’ ὅ τ’ἄρ’ ἐκ Διὸς ἤλυθεν ὄρνις,	- - - -- u u - uu -uu --	dactylic hexameter	masculine penthemimeral, hepthemimeral, trithemimeral
μᾶλλον ἐπὶ Τρώεσσι θόρον, μνήσαντο δὲ χάρμης.	-u u- --u u- --u u --	dactylic hexameter	feminine penthemimeral, hepthemimeral, trithemimeral
ἔνθ’ οὔ τις πρότερος Δαναῶν πολλῶν περ ἐόντων	- - - uu- uu- -- u u--	dactylic hexameter	masculine penthemimeral, hepthemimeral, trithemimeral
εὔξατο Τυδεΐδαο πάρος σχέμεν ὠκέας ἵππους	-uu -uu-u u- uu -uu --	dactylic hexameter	feminine penthemimeral, hepthemimeral
τάφρου τ’ἐξελάσαι καὶ ἐναντίβιον μαχέσασθαι,	-- -uu- u u-uu- uu--	dactylic hexameter	masculine penthemimeral
ἀλλὰ πολὺ πρῶτος Τρώων ἕλεν ἄνδρα κορυστὴν	-u u- -- -- uu -u u--	dactylic hexameter	masculine penthemimeral, hepthemimeral, trithemimeral
Φραδμονίδην Ἀγέλαον· ὃ μὲν φύγαδ’ ἔτραπεν ἵππους·	-uu- uu-u u - uu -uu --	dactylic hexameter	feminine penthemimeral, hepthemimeral, trithemimeral
τῷ δὲ μεταστρεφθέντι μεταφρένῳ ἐν δόρυ πῆξεν	- u u---u u-uu - uu --	dactylic hexameter	feminine penthemimeral
ὤμων μεσσηγύς, διὰ δὲ στήθεσφιν ἔλασσεν·	-- --- uu - --u u--	dactylic hexameter	masculine penthemimeral, hepthemimeral
ἤριπε δ’ἐξ ὀχέων, ἀράβησε δὲ τεύχε’ ἐπ’ αὐτῷ.	-uu - uu- uu-u u -u u --	dactylic hexameter	masculine penthemimeral, trithemimeral
τὸν δὲ μετ’ Ἀτρεΐδαι Ἀγαμέμνων καὶ Μενέλαος,	- u u -uu- uu-- - uu--	dactylic hexameter	masculine penthemimeral
τοῖσι δ’ἐπ’ Αἴαντες θοῦριν ἐπιειμένοι ἀλκήν,	-u u --- -- uu-uu --	dactylic hexameter	masculine penthemimeral, hepthemimeral
τοῖσι δ’ἐπ’ Ἰδομενεὺς καὶ ὀπάων Ἰδομενῆος	-u u -uu- u u-- -uu--	dactylic hexameter	masculine penthemimeral
Μηριόνης ἀτάλαντος Ἐνυαλίῳ ἀνδρειφόντῃ,	-uu- uu-u u-uu ----	dactylic hexameter	feminine penthemimeral, trithemimeral
τοῖσι δ’ἐπ’ Εὐρύπυλος Εὐαίμονος ἀγλαὸς υἱός·	-u u -uu- --uu -uu --	dactylic hexameter	masculine penthemimeral
Τεῦκρος δ’εἴνατος ἦλθε παλίντονα τόξα τιταίνων,	-- -uu -u u-uu -u u--	dactylic hexameter	feminine penthemimeral
στῆ δ’ἄρ’ ὑπ’ Αἴαντος σάκεϊ Τελαμωνιάδαο.	- u u --- uu- uu-uu--	dactylic hexameter	masculine penthemimeral, hepthemimeral
ἔνθ’ Αἴας μὲν ὑπεξέφερεν σάκος· αὐτὰρ ὅ γ’ἥρως	- -- u u-uu- uu -u u --	dactylic hexameter	hepthemimeral, trithemimeral
παπτήνας, ἐπεὶ ἄρ τιν’ ὀϊστεύσας ἐν ὁμίλῳ	--- uu - u u--- u u--	dactylic hexameter	masculine penthemimeral, trithemimeral
βεβλήκοι, ὃ μὲν αὖθι πεσὼν ἀπὸ θυμὸν ὄλεσσεν,	--- u u -u u- uu -u u--	dactylic hexameter	feminine penthemimeral, hepthemimeral, trithemimeral
αὐτὰρ ὃ αὖτις ἰὼν πάϊς ὣς ὑπὸ μητέρα δύσκεν	-u u -u u- uu - uu -uu --	dactylic hexameter	masculine penthemimeral, hepthemimeral
εἰς Αἴανθ’· ὃ δέ μιν σάκεϊ κρύπτασκε φαεινῷ.	- -- u u - uu- --u u--	dactylic hexameter	masculine penthemimeral, hepthemimeral, trithemimeral
ἔνθα τίνα πρῶτον Τρώων ἕλε Τεῦκρος ἀμύμων;	-u u- -- -- uu -u u--	dactylic hexameter	masculine penthemimeral, hepthemimeral, trithemimeral
Ὀρσίλοχον μὲν πρῶτα καὶ Ὄρμενον ἠδ’ Ὀφελέστην	-uu- - -u u -uu - uu--	dactylic hexameter	feminine penthemimeral, trithemimeral
Δαίτορά τε Χρομίον τε καὶ ἀντίθεον Λυκοφόντην	-uu - uu- u u -uu- uu--	dactylic hexameter	masculine penthemimeral, trithemimeral
καὶ Πολυαιμονίδην Ἀμοπάονα καὶ Μελάνιππον,	- uu-uu- uu-uu - uu--	dactylic hexameter	masculine penthemimeral
πάντας ἐπασσυτέρους πέλασε χθονὶ πουλυβοτείρῃ.	-u u-uu- uu- uu -uu--	dactylic hexameter	masculine penthemimeral, hepthemimeral
τὸν δὲ ἰδὼν γήθησεν ἄναξ ἀνδρῶν Ἀγαμέμνων	- u u- --u u- -- uu--	dactylic hexameter	feminine penthemimeral, hepthemimeral, trithemimeral
τόξου ἄπο κρατεροῦ Τρώων ὀλέκοντα φάλαγγας·	-u u- uu- -- uu-u u--	dactylic hexameter	masculine penthemimeral, hepthemimeral, trithemimeral
στῆ δὲ παρ’ αὐτὸν ἰὼν καί μιν πρὸς μῦθον ἔειπε·	- u u -u u- - - - -u u--	dactylic hexameter	masculine penthemimeral, hepthemimeral
Τεῦκρε φίλη κεφαλή, Τελαμώνιε κοίρανε λαῶν	-u u- uu- uu-uu -uu --	dactylic hexameter	masculine penthemimeral, trithemimeral
βάλλ’ οὕτως, αἴ κέν τι φόως Δαναοῖσι γένηαι	- -- - - u u- uu-u u--	dactylic hexameter	masculine penthemimeral, hepthemimeral, trithemimeral
πατρί τε σῷ Τελαμῶνι, ὅ σ’ἔτρεφε τυτθὸν ἐόντα,	-u u - uu-u u -uu -u u--	dactylic hexameter	feminine penthemimeral, trithemimeral
καί σε νόθον περ ἐόντα κομίσσατο ᾧ ἐνὶ οἴκῳ·	- u u- u u-u u-uu - uu --	dactylic hexameter	feminine penthemimeral, trithemimeral
τὸν καὶ τηλόθ’ ἐόντα ἐϋκλείης ἐπίβησον.	- - -u u-u u--- uu--	dactylic hexameter	feminine penthemimeral
σοὶ δ’ἐγὼ ἐξερέω ὡς καὶ τετελεσμένον ἔσται·	- uu -uu- - - uu-uu --	dactylic hexameter	masculine penthemimeral, hepthemimeral
αἴ κέν μοι δώῃ Ζεύς τ’αἰγίοχος καὶ Ἀθήνη	- - - -- - -uu- u u--	dactylic hexameter	masculine penthemimeral, trithemimeral
Ἰλίου ἐξαλαπάξαι ἐϋκτίμενον πτολίεθρον,	-uu -uu-u u-uu- uu--	dactylic hexameter	feminine penthemimeral
πρώτῳ τοι μετ’ ἐμὲ πρεσβήϊον ἐν χερὶ θήσω,	-- - u u- --uu - uu --	dactylic hexameter	masculine penthemimeral, trithemimeral
ἢ τρίποδ’ ἠὲ δύω ἵππους αὐτοῖσιν ὄχεσφιν	- uu -u u- -- --u u--	dactylic hexameter	masculine penthemimeral, hepthemimeral
ἠὲ γυναῖχ’, ἥ κέν τοι ὁμὸν λέχος εἰσαναβαίνοι.	-u u- - - u u- uu -uu--	dactylic hexameter	masculine penthemimeral, hepthemimeral, trithemimeral
τὸν δ’ἀπαμειβόμενος προσεφώνεε Τεῦκρος ἀμύμων·	- uu-uu- uu-uu -u u--	dactylic hexameter	masculine penthemimeral
Ἀτρεΐδη κύδιστε τί με σπεύδοντα καὶ αὐτὸν	-uu- --u u - --u u --	dactylic hexameter	feminine penthemimeral, hepthemimeral, trithemimeral
ὀτρύνεις; οὐ μέν τοι ὅση δύναμίς γε πάρεστι	--- - - u u- uu- u u--	dactylic hexameter	masculine penthemimeral, hepthemimeral, trithemimeral
παύομαι, ἀλλ’ ἐξ οὗ προτὶ Ἴλιον ὠσάμεθ’ αὐτοὺς	-uu - - - uu -uu -uu --	dactylic hexameter	masculine penthemimeral, trithemimeral
ἐκ τοῦ δὴ τόξοισι δεδεγμένος ἄνδρας ἐναίρω.	- - - --u u-uu -u u--	dactylic hexameter	feminine penthemimeral, trithemimeral
ὀκτὼ δὴ προέηκα τανυγλώχινας ὀϊστούς,	-- - uu-u u---u u--	dactylic hexameter	feminine penthemimeral, trithemimeral
πάντες δ’ἐν χροῂ πῆχθεν ἀρηϊθόων ἀιζηῶν·	-- - - -u u-uu- uu--	dactylic hexameter	feminine penthemimeral, trithemimeral
τοῦτον δ’οὐ δύναμαι βαλέειν κύνα λυσσητῆρα.	-- - uu- uu- uu ----	dactylic hexameter	masculine penthemimeral, hepthemimeral, trithemimeral
ἦ ῥα καὶ ἄλλον ὀϊστὸν ἀπὸ νευρῆφιν ἴαλλεν	- u u -u u-u u- --u u--	dactylic hexameter	feminine penthemimeral, hepthemimeral
Ἕκτορος ἀντικρύ, βαλέειν δέ ἑ ἵετο θυμός·	-uu --- uu- u u -uu --	dactylic hexameter	masculine penthemimeral, hepthemimeral
καὶ τοῦ μέν ῥ’ἀφάμαρθ’, ὃ δ’ἀμύμονα Γοργυθίωνα	- - - uu- u u-uu -uu--	dactylic hexameter	masculine penthemimeral, trithemimeral
υἱὸν ἐῢν Πριάμοιο κατὰ στῆθος βάλεν ᾇῷ,	-u u- uu-u u- -- uu --	dactylic hexameter	feminine penthemimeral, hepthemimeral, trithemimeral
τόν ῥ’ἐξ Αἰσύμηθεν ὀπυιομένη τέκε μήτηρ	- - ---u u-uu- uu --	dactylic hexameter	feminine penthemimeral
καλὴ Καστιάνειρα δέμας ἐϊκυῖα θεῇσι.	-- -uu-u u- uu-u u--	dactylic hexameter	feminine penthemimeral, hepthemimeral
μήκων δ’ὡς ἑτέρωσε κάρη βάλεν, ἥ τ’ἐνὶ κήπῳ	-- - uu-u u- uu - uu --	dactylic hexameter	feminine penthemimeral, hepthemimeral, trithemimeral
καρπῷ βριθομένη νοτίῃσί τε εἰαρινῇσιν,	-- -uu- uu-u u -uu--	dactylic hexameter	masculine penthemimeral
ὣς ἑτέρωσ’ ἤμυσε κάρη πήληκι βαρυνθέν.	- uu- --u u- --u u--	dactylic hexameter	feminine penthemimeral, hepthemimeral, trithemimeral
Τεῦκρος δ’ἄλλον ὀϊστὸν ἀπὸ νευρῆφιν ἴαλλεν	-- -u u-u u- --u u--	dactylic hexameter	feminine penthemimeral, hepthemimeral
Ἕκτορος ἀντικρύ, βαλέειν δέ ἑ ἵετο θυμός.	-uu --- uu- u u -uu --	dactylic hexameter	masculine penthemimeral, hepthemimeral
ἀλλ’ ὅ γε καὶ τόθ’ ἅμαρτε· παρέσφηλεν γὰρ Ἀπόλλων·	- u u - u u-u u--- u u--	dactylic hexameter	feminine penthemimeral, trithemimeral
ἀλλ’ Ἀρχεπτόλεμον θρασὺν Ἕκτορος ἡνιοχῆα	- --uu- uu -uu -uu--	dactylic hexameter	masculine penthemimeral
ἱέμενον πόλεμον δὲ βάλε στῆθος παρὰ μαζόν·	-uu- uu- u u- -- uu --	dactylic hexameter	masculine penthemimeral, hepthemimeral, trithemimeral
ἤριπε δ’ἐξ ὀχέων, ὑπερώησαν δέ οἱ ἵπποι	-uu - uu- uu--- u u --	dactylic hexameter	masculine penthemimeral, trithemimeral
ὠκύποδες· τοῦ δ’αὖθι λύθη ψυχή τε μένος τε.	-uu- - -u u- -- u u- -	dactylic hexameter	feminine penthemimeral, hepthemimeral, trithemimeral
Ἕκτορα δ’αἰνὸν ἄχος πύκασε φρένας ἡνιόχοιο·	-uu -u u- uu- uu -uu--	dactylic hexameter	masculine penthemimeral, hepthemimeral
τὸν μὲν ἔπειτ’ εἴασε καὶ ἀχνύμενός περ ἑταίρου,	- u u- --u u -uu- u u--	dactylic hexameter	feminine penthemimeral, trithemimeral
Κεβριόνην δ’ἐκέλευσεν ἀδελφεὸν ἐγγὺς ἐόντα	-uu- uu-u u-uu -u u--	dactylic hexameter	feminine penthemimeral, trithemimeral
ἵππων ἡνί’ ἑλεῖν· ὃ δ’ἄρ’ οὐκ ἀπίθησεν ἀκούσας.	-- -u u- u u - uu-u u--	dactylic hexameter	masculine penthemimeral, hepthemimeral
αὐτὸς δ’ἐκ δίφροιο χαμαὶ θόρε παμφανόωντος	-- - --u u- uu -uu--	dactylic hexameter	feminine penthemimeral, hepthemimeral, trithemimeral
σμερδαλέα ἰάχων· ὃ δὲ χερμάδιον λάβε χειρί,	-uu- uu- u u -uu- uu --	dactylic hexameter	masculine penthemimeral, trithemimeral
βῆ δ’εὐθὺς Τεύκρου, βαλέειν δέ ἑ θυμὸς ἀνώγει.	- -- -- uu- u u -u u--	dactylic hexameter	masculine penthemimeral, hepthemimeral, trithemimeral
ἤτοι ὃ μὲν φαρέτρης ἐξείλετο πικρὸν ὀϊστόν,	-u u - uu- --uu -u u--	dactylic hexameter	masculine penthemimeral, trithemimeral
θῆκε δ’ἐπὶ νευρῇ· τὸν δ’αὖ κορυθαίολος Ἕκτωρ	-u u- -- - - uu-uu --	dactylic hexameter	masculine penthemimeral, hepthemimeral, trithemimeral
αὐερύοντα παρ’ ὦμον, ὅθι κληῂς ἀποέργει	-uu-u u -u u- -- uu--	dactylic hexameter	feminine penthemimeral, hepthemimeral
αὐχένα τε στῆθός τε, μάλιστα δὲ καίριόν ἐστι,	-uu - -- u u-u u -uu --	dactylic hexameter	masculine penthemimeral, trithemimeral
τῇ ῥ’ἐπὶ οἷ μεμαῶτα βάλεν λίθῳ ὀκριόεντι,	- uu - uu-u u- uu -uu--	dactylic hexameter	feminine penthemimeral, hepthemimeral, trithemimeral
ῥῆξε δέ οἱ νευρήν· νάρκησε δὲ χεὶρ ἐπὶ καρπῷ,	-u u - -- --u u - uu --	dactylic hexameter	masculine penthemimeral, trithemimeral
στῆ δὲ γνὺξ ἐριπών, τόξον δέ οἱ ἔκπεσε χειρός.	- - - uu- -- u u -uu --	dactylic hexameter	masculine penthemimeral, hepthemimeral, trithemimeral
Αἴας δ’οὐκ ἀμέλησε κασιγνήτοιο πεσόντος,	-- - uu-u u---u u--	dactylic hexameter	feminine penthemimeral, trithemimeral
ἀλλὰ θέων περίβη καί οἱ σάκος ἀμφεκάλυψε.	-u u- uu- - - uu -uu--	dactylic hexameter	masculine penthemimeral, hepthemimeral, trithemimeral
τὸν μὲν ἔπειθ’ ὑποδύντε δύω ἐρίηρες ἑταῖροι	- u u- uu-u u- uu-u u--	dactylic hexameter	feminine penthemimeral, hepthemimeral, trithemimeral
Μηκιστεὺς Ἐχίοιο πάϊς καὶ δῖος Ἀλάστωρ	--- uu-u u- - -u u--	dactylic hexameter	feminine penthemimeral, hepthemimeral, trithemimeral
νῆας ἔπι γλαφυρὰς φερέτην βαρέα στενάχοντα.	-u u- uu- uu- uu- uu--	dactylic hexameter	masculine penthemimeral, hepthemimeral, trithemimeral
ἂψ δ’αὖτις Τρώεσσιν Ὀλύμπιος ἐν μένος ὦρσεν·	- -- --u u-uu - uu --	dactylic hexameter	feminine penthemimeral, trithemimeral
οἳ δ’ἰθὺς τάφροιο βαθείης ὦσαν Ἀχαιούς·	- -- --u u-- -u u--	dactylic hexameter	feminine penthemimeral, trithemimeral
Ἕκτωρ δ’ἐν πρώτοισι κίε σθένεϊ βλεμεαίνων.	-- - --u u- uu- uu--	dactylic hexameter	feminine penthemimeral, hepthemimeral, trithemimeral
ὡς δ’ὅτε τίς τε κύων συὸς ἀγρίου ἠὲ λέοντος	- uu - u u- uu -uu -u u--	dactylic hexameter	masculine penthemimeral, trithemimeral
ἅπτηται κατόπισθε ποσὶν ταχέεσσι διώκων	--- uu-u u- uu-u u--	dactylic hexameter	feminine penthemimeral, hepthemimeral, trithemimeral
ἰσχία τε γλουτούς τε, ἑλισσόμενόν τε δοκεύει,	-uu - -- u u-uu- u u--	dactylic hexameter	masculine penthemimeral, trithemimeral
ὣς Ἕκτωρ ὤπαζε κάρη κομόωντας Ἀχαιούς,	- -- --u u- uu-u u--	dactylic hexameter	feminine penthemimeral, hepthemimeral, trithemimeral
αἰὲν ἀποκτείνων τὸν ὀπίστατον· οἳ δὲ φέβοντο.	-u u--- u u-uu - u u--	dactylic hexameter	masculine penthemimeral
αὐτὰρ ἐπεὶ διά τε σκόλοπας καὶ τάφρον ἔβησαν	-u u- uu - uu- - -u u--	dactylic hexameter	masculine penthemimeral, hepthemimeral, trithemimeral
φεύγοντες, πολλοὶ δὲ δάμεν Τρώων ὑπὸ χερσίν,	--- -- u u- -- uu --	dactylic hexameter	masculine penthemimeral, hepthemimeral, trithemimeral
οἳ μὲν δὴ παρὰ νηυσὶν ἐρητύοντο μένοντες,	- - - uu -u u---u u--	dactylic hexameter	feminine penthemimeral, trithemimeral
ἀλλήλοισί τε κεκλόμενοι καὶ πᾶσι θεοῖσι	---u u -uu- - -u u--	dactylic hexameter	hepthemimeral
χεῖρας ἀνίσχοντες μεγάλ’ εὐχετόωντο ἕκαστος·	-u u--- uu -uu-u u--	dactylic hexameter	masculine penthemimeral
Ἕκτωρ δ’ἀμφιπεριστρώφα καλλίτριχας ἵππους	-- -uu--- --uu --	dactylic hexameter	hepthemimeral
Γοργοῦς ὄμματ’ ἔχων ἠδὲ βροτολοιγοῦ Ἄρηος.	-- -u u- -- uu-u u--	dactylic hexameter	masculine penthemimeral, hepthemimeral
τοὺς δὲ ἰδοῦσ’ ἐλέησε θεὰ λευκώλενος Ἥρη,	- u u- uu-u u- --uu --	dactylic hexameter	feminine penthemimeral, hepthemimeral, trithemimeral
αἶψα δ’Ἀθηναίην ἔπεα πτερόεντα προσηύδα·	-u u--- uu- uu-u u--	dactylic hexameter	masculine penthemimeral, hepthemimeral
ὢ πόποι αἰγιόχοιο Διὸς τέκος οὐκέτι νῶϊ	- uu -uu-u u- uu -uu --	dactylic hexameter	feminine penthemimeral, hepthemimeral
ὀλλυμένων Δαναῶν κεκαδησόμεθ’ ὑστάτιόν περ;	-uu- uu- uu-uu -uu- -	dactylic hexameter	masculine penthemimeral, trithemimeral
οἵ κεν δὴ κακὸν οἶτον ἀναπλήσαντες ὄλωνται	- - - uu -u u---u u--	dactylic hexameter	feminine penthemimeral, trithemimeral
ἀνδρὸς ἑνὸς ῥιπῇ, ὃ δὲ μαίνεται οὐκέτ’ ἀνεκτῶς	-u u- -- u u -uu -u u--	dactylic hexameter	masculine penthemimeral, trithemimeral
Ἕκτωρ Πριαμίδης, καὶ δὴ κακὰ πολλὰ ἔοργε.	-- -uu- - - uu -u u--	dactylic hexameter	masculine penthemimeral, hepthemimeral
τὴν δ’αὖτε προσέειπε θεὰ γλαυκῶπις Ἀθήνη·	- -- uu-u u- --u u--	dactylic hexameter	feminine penthemimeral, hepthemimeral, trithemimeral
καὶ λίην οὗτός γε μένος θυμόν τ’ὀλέσειε	- -- -- u u- -- uu--	dactylic hexameter	masculine penthemimeral, hepthemimeral, trithemimeral
χερσὶν ὑπ’ Ἀργείων φθίμενος ἐν πατρίδι γαίῃ·	-u u --- uu- - -uu --	dactylic hexameter	masculine penthemimeral, hepthemimeral
ἀλλὰ πατὴρ οὑμὸς φρεσὶ μαίνεται οὐκ ἀγαθῇσι	-u u- -- uu -uu - uu--	dactylic hexameter	masculine penthemimeral, trithemimeral
σχέτλιος, αἰὲν ἀλιτρός, ἐμῶν μενέων ἀπερωεύς·	-uu -u u-u u- uu- uu--	dactylic hexameter	feminine penthemimeral, hepthemimeral
οὐδέ τι τῶν μέμνηται, ὅ οἱ μάλα πολλάκις υἱὸν	-u u - --u u - uu -uu --	dactylic hexameter	feminine penthemimeral, hepthemimeral, trithemimeral
τειρόμενον σώεσκον ὑπ’ Εὐρυσθῆος ἀέθλων.	-uu- --u u ---u u--	dactylic hexameter	feminine penthemimeral, trithemimeral
ἤτοι ὃ μὲν κλαίεσκε πρὸς οὐρανόν, αὐτὰρ ἐμὲ Ζεὺς	-u u - --u u -uu -u u- -	dactylic hexameter	feminine penthemimeral, trithemimeral
τῷ ἐπαλεξήσουσαν ἀπ’ οὐρανόθεν προΐαλλεν.	- uu---u u -uu- uu--	dactylic hexameter	feminine penthemimeral
εἰ γὰρ ἐγὼ τάδε ᾔδε’ ἐνὶ φρεσὶ πευκαλίμῃσιν	- u u- uu -u u- uu -uu--	dactylic hexameter	feminine penthemimeral, hepthemimeral, trithemimeral
εὖτέ μιν εἰς Ἀΐδαο πυλάρταο προὔπεμψεν	-u u - uu-u u--- ---	dactylic hexameter	feminine penthemimeral, trithemimeral
ἐξ Ἐρέβευς ἄξοντα κύνα στυγεροῦ Ἀΐδαο,	- uu- --u u- uu- uu--	dactylic hexameter	feminine penthemimeral, hepthemimeral, trithemimeral
οὐκ ἂν ὑπεξέφυγε Στυγὸς ὕδατος αἰπὰ ῥέεθρα.	- u u-uu- uu -uu -u u--	dactylic hexameter	masculine penthemimeral
νῦν δ’ἐμὲ μὲν στυγέει, Θέτιδος δ’ἐξήνυσε βουλάς,	- uu - uu- uu- --uu --	dactylic hexameter	masculine penthemimeral, hepthemimeral, trithemimeral
ἥ οἱ γούνατ’ ἔκυσσε καὶ ἔλλαβε χειρὶ γενείου,	- - -u u-u u -uu -u u--	dactylic hexameter	feminine penthemimeral
λισσομένη τιμῆσαι Ἀχιλλῆα πτολίπορθον.	-uu- --u u--- uu--	dactylic hexameter	feminine penthemimeral, trithemimeral
ἔσται μὰν ὅτ’ ἂν αὖτε φίλην γλαυκώπιδα εἴπῃ.	-- - u u -u u- --uu --	dactylic hexameter	feminine penthemimeral, hepthemimeral, trithemimeral
ἀλλὰ σὰ μὲν νῦν νῶϊν ἐπέντυε μώνυχας ἵππους,	-u u - - -u u-uu -uu --	dactylic hexameter	feminine penthemimeral, trithemimeral
ὄφρ’ ἂν ἐγὼ καταδῦσα Διὸς δόμον αἰγιόχοιο	- u u- uu-u u- uu -uu--	dactylic hexameter	feminine penthemimeral, hepthemimeral, trithemimeral
τεύχεσιν ἐς πόλεμον θωρήξομαι, ὄφρα ἴδωμαι	-uu - uu- --uu -u u--	dactylic hexameter	masculine penthemimeral, trithemimeral
ἢ νῶϊ Πριάμοιο πάϊς κορυθαίολος Ἕκτωρ	- -- uu-u u- uu-uu --	dactylic hexameter	feminine penthemimeral, hepthemimeral, trithemimeral
γηθήσει προφανέντε ἀνὰ πτολέμοιο γεφύρας,	--- uu-u u- uu-u u--	dactylic hexameter	feminine penthemimeral, hepthemimeral, trithemimeral
ἦ τις καὶ Τρώων κορέει κύνας ἠδ’ οἰωνοὺς	- - - -- uu- uu - ---	dactylic hexameter	masculine penthemimeral, hepthemimeral, trithemimeral
δημῷ καὶ σάρκεσσι, πεσὼν ἐπὶ νηυσὶν Ἀχαιῶν.	-- - --u u- uu -u u--	dactylic hexameter	feminine penthemimeral, hepthemimeral, trithemimeral
ὣς ἔφατ’, οὐδ’ ἀπίθησε θεὰ λευκώλενος Ἥρη.	- uu - uu-u u- --uu --	dactylic hexameter	feminine penthemimeral, hepthemimeral, trithemimeral
ἣ μὲν ἐποιχομένη χρυσάμπυκας ἔντυεν ἵππους	- u u-uu- --uu -uu --	dactylic hexameter	masculine penthemimeral
Ἥρη πρέσβα θεὰ θυγάτηρ μεγάλοιο Κρόνοιο·	-- -u u- uu- uu-u u--	dactylic hexameter	masculine penthemimeral, hepthemimeral
αὐτὰρ Ἀθηναίη κούρη Διὸς αἰγιόχοιο	-u u--- -- uu -uu--	dactylic hexameter	masculine penthemimeral, hepthemimeral
πέπλον μὲν κατέχευεν ἑανὸν πατρὸς ἐπ’ οὔδει	-- - uu-u u-- -u u --	dactylic hexameter	feminine penthemimeral, trithemimeral
ποικίλον, ὅν ῥ’αὐτὴ ποιήσατο καὶ κάμε χερσίν,	-uu - -- --uu - uu --	dactylic hexameter	masculine penthemimeral, trithemimeral
ἣ δὲ χιτῶν’ ἐνδῦσα Διὸς νεφεληγερέταο	- u u- --u u- uu-uu--	dactylic hexameter	feminine penthemimeral, hepthemimeral, trithemimeral
τεύχεσιν ἐς πόλεμον θωρήσσετο δακρυόεντα.	-uu - uu- --uu -uu--	dactylic hexameter	masculine penthemimeral, trithemimeral
ἐς δ’ὄχεα φλόγεα ποσὶ βήσετο, λάζετο δ’ἔγχος	- uu- uu- uu -uu -uu --	dactylic hexameter	masculine penthemimeral, trithemimeral
βριθὺ μέγα στιβαρόν, τῷ δάμνησι στίχας ἀνδρῶν	-u u- uu- - --- uu --	dactylic hexameter	masculine penthemimeral, trithemimeral
ἡρώων, τοῖσίν τε κοτέσσεται ὀβριμοπάτρη.	--- -- u u-uu -uu--	dactylic hexameter	masculine penthemimeral, trithemimeral
Ἥρη δὲ μάστιγι θοῶς ἐπεμαίετ’ ἄρ’ ἵππους·	-- - --u u- uu-u u --	dactylic hexameter	feminine penthemimeral, hepthemimeral, trithemimeral
αὐτόμαται δὲ πύλαι μύκον οὐρανοῦ ἃς ἔχον Ὧραι,	-uu- u u- uu -uu - uu --	dactylic hexameter	masculine penthemimeral, trithemimeral
τῇς ἐπιτέτραπται μέγας οὐρανὸς Οὔλυμπός τε	- uu--- uu -uu --- -	dactylic hexameter	masculine penthemimeral
ἠμὲν ἀνακλῖναι πυκινὸν νέφος ἠδ’ ἐπιθεῖναι.	-u u--- uu- uu - uu--	dactylic hexameter	masculine penthemimeral, hepthemimeral
τῇ ῥα δι’ αὐτάων κεντρηνεκέας ἔχον ἵππους.	- u u --- --uu- uu --	dactylic hexameter	masculine penthemimeral
Ζεὺς δὲ πατὴρ Ἴδηθεν ἐπεὶ ἴδε χώσατ’ ἄρ’ αἰνῶς,	- u u- --u u- uu -u u --	dactylic hexameter	feminine penthemimeral, hepthemimeral, trithemimeral
Ἶριν δ’ὄτρυνε χρυσόπτερον ἀγγελέουσαν·	-- --- --uu -uu--	dactylic hexameter	masculine penthemimeral
βάσκ’ ἴθι Ἶρι ταχεῖα, πάλιν τρέπε μηδ’ ἔα ἄντην	- uu -u u-u u- uu - uu --	dactylic hexameter	feminine penthemimeral, hepthemimeral
ἔρχεσθ’· οὐ γὰρ καλὰ συνοισόμεθα πτόλεμον δέ.	-- - - -u u-uu- uu- -	dactylic hexameter	feminine penthemimeral, trithemimeral
ὧδε γὰρ ἐξερέω, τὸ δὲ καὶ τετελεσμένον ἔσται·	-u u -uu- u u - uu-uu --	dactylic hexameter	masculine penthemimeral, hepthemimeral
γυιώσω μέν σφωϊν ὑφ’ ἅρμασιν ὠκέας ἵππους,	--- - -u u -uu -uu --	dactylic hexameter	feminine penthemimeral, trithemimeral
αὐτὰς δ’ἐκ δίφρου βαλέω κατά θ’ἅρματα ἄξω·	-- - -- uu- uu -uu --	dactylic hexameter	masculine penthemimeral, hepthemimeral, trithemimeral
οὐδέ κεν ἐς δεκάτους περιτελλομένους ἐνιαυτοὺς	-u u - uu- uu-uu- uu--	dactylic hexameter	masculine penthemimeral, trithemimeral
ἕλκε’ ἀπαλθήσεσθον, ἅ κεν μάρπτῃσι κεραυνός·	-u u---u u - --u u--	dactylic hexameter	feminine penthemimeral, hepthemimeral
ὄφρα ἰδῇ γλαυκῶπις ὅτ’ ἂν ᾧ πατρὶ μάχηται.	-u u- --u u - - -u u--	dactylic hexameter	feminine penthemimeral, hepthemimeral, trithemimeral
Ἥρῃ δ’οὔ τι τόσον νεμεσίζομαι οὐδὲ χολοῦμαι·	-- - u u- uu-uu -u u--	dactylic hexameter	masculine penthemimeral, trithemimeral
αἰεὶ γάρ μοι ἔωθεν ἐνικλᾶν ὅττί κεν εἴπω.	-- - u u-u u-- -u u --	dactylic hexameter	feminine penthemimeral, trithemimeral
ὣς ἔφατ’, ὦρτο δὲ Ἶρις ἀελλόπος ἀγγελέουσα,	- uu -u u -u u-uu -uu--	dactylic hexameter	feminine penthemimeral
βῆ δ’ἐξ Ἰδαίων ὀρέων ἐς μακρὸν Ὄλυμπον.	- - --- uu- - -u u--	dactylic hexameter	masculine penthemimeral, hepthemimeral
πρώτῃσιν δὲ πύλῃσι πολυπτύχου Οὐλύμποιο	--- u u-u u-uu ----	dactylic hexameter	feminine penthemimeral, trithemimeral
ἀντομένη κατέρυκε, Διὸς δέ σφ’ἔννεπε μῦθον·	-uu- uu-u u- - -uu --	dactylic hexameter	feminine penthemimeral, hepthemimeral, trithemimeral
πῇ μέματον; τί σφῶϊν ἐνὶ φρεσὶ μαίνεται ἦτορ;	- uu- - -u u- uu -uu --	dactylic hexameter	feminine penthemimeral, hepthemimeral, trithemimeral
οὐκ ἐάᾳ Κρονίδης ἐπαμυνέμεν Ἀργείοισιν.	- -- uu- uu-uu ----	dactylic hexameter	masculine penthemimeral, trithemimeral
ὧδε γὰρ ἠπείλησε Κρόνου πάϊς, ᾗ τελέει περ,	-u u ---u u- uu - uu- -	dactylic hexameter	feminine penthemimeral, hepthemimeral
γυιώσειν μὲν σφῶϊν ὑφ’ ἅρμασιν ὠκέας ἵππους,	--- - -u u -uu -uu --	dactylic hexameter	feminine penthemimeral, trithemimeral
αὐτὰς δ’ἐκ δίφρου βαλέειν κατά θ’ἅρματα ἄξειν·	-- - -- uu- uu -uu --	dactylic hexameter	masculine penthemimeral, hepthemimeral, trithemimeral
οὐδέ κεν ἐς δεκάτους περιτελλομένους ἐνιαυτοὺς	-u u - uu- uu-uu- uu--	dactylic hexameter	masculine penthemimeral, trithemimeral
ἕλκε’ ἀπαλθήσεσθον, ἅ κεν μάρπτῃσι κεραυνός·	-u u---u u - --u u--	dactylic hexameter	feminine penthemimeral, hepthemimeral
ὄφρα ἰδῇς γλαυκῶπι ὅτ’ ἂν σῷ πατρὶ μάχηαι.	-u u- --u u - - -u u--	dactylic hexameter	feminine penthemimeral, hepthemimeral, trithemimeral
Ἥρῃ δ’οὔ τι τόσον νεμεσίζεται οὐδὲ χολοῦται·	-- - u u- uu-uu -u u--	dactylic hexameter	masculine penthemimeral, trithemimeral
αἰεὶ γάρ οἱ ἔωθεν ἐνικλᾶν ὅττι κεν εἴπῃ·	-- - u u-u u-- -u u --	dactylic hexameter	feminine penthemimeral, trithemimeral
ἀλλὰ σύ γ’αἰνοτάτη κύον ἀδεὲς εἰ ἐτεόν γε	-u u -uu- uu -uu - uu- -	dactylic hexameter	masculine penthemimeral
τολμήσεις Διὸς ἄντα πελώριον ἔγχος ἀεῖραι.	--- uu -u u-uu -u u--	dactylic hexameter	feminine penthemimeral, trithemimeral
ἣ μὲν ἄρ’ ὣς εἰποῦσ’ ἀπέβη πόδας ὠκέα Ἶρις,	- u u - -- uu- uu -uu --	dactylic hexameter	masculine penthemimeral, hepthemimeral, trithemimeral
αὐτὰρ Ἀθηναίην Ἥρη πρὸς μῦθον ἔειπεν·	-u u--- -- - -u u--	dactylic hexameter	masculine penthemimeral, hepthemimeral
ὢ πόποι αἰγιόχοιο Διὸς τέκος, οὐκέτ’ ἔγωγε	- uu -uu-u u- uu -u u--	dactylic hexameter	feminine penthemimeral, hepthemimeral
νῶϊ ἐῶ Διὸς ἄντα βροτῶν ἕνεκα πτολεμίζειν·	-u u- uu -u u- uu- uu--	dactylic hexameter	feminine penthemimeral, hepthemimeral, trithemimeral
τῶν ἄλλος μὲν ἀποφθίσθω, ἄλλος δὲ βιώτω,	- -- u u--- -- u u--	dactylic hexameter	hepthemimeral, trithemimeral
ὅς κε τύχῃ· κεῖνος δὲ τὰ ἃ φρονέων ἐνὶ θυμῷ	- u u- -- u u - uu- uu --	dactylic hexameter	masculine penthemimeral, hepthemimeral, trithemimeral
Τρωσί τε καὶ Δαναοῖσι δικαζέτω, ὡς ἐπιεικές.	-u u - uu-u u-uu - uu--	dactylic hexameter	feminine penthemimeral, trithemimeral
ὣς ἄρα φωνήσασα πάλιν τρέπε μώνυχας ἵππους·	- uu ---u u- uu -uu --	dactylic hexameter	feminine penthemimeral, hepthemimeral
τῇσιν δ’Ὧραι μὲν λῦσαν καλλίτριχας ἵππους,	-- -- - -- --uu --	dactylic hexameter	masculine penthemimeral, hepthemimeral
καὶ τοὺς μὲν κατέδησαν ἐπ’ ἀμβροσίῃσι κάπῃσιν,	- - - uu-u u -uu-u u--	dactylic hexameter	feminine penthemimeral, trithemimeral
ἅρματα δ’ἔκλιναν πρὸς ἐνώπια παμφανόωντα·	-uu --- u u-uu -uu--	dactylic hexameter	masculine penthemimeral
αὐταὶ δὲ χρυσέοισιν ἐπὶ κλισμοῖσι κάθιζον	-- - uu-u u- --u u--	dactylic hexameter	feminine penthemimeral, hepthemimeral, trithemimeral
μίγδ’ ἄλλοισι θεοῖσι, φίλον τετιημέναι ἦτορ.	- --u u-u u- uu-uu --	dactylic hexameter	feminine penthemimeral, hepthemimeral
Ζεὺς δὲ πατὴρ Ἴδηθεν ἐΰτροχον ἅρμα καὶ ἵππους	- u u- --u u-uu -u u --	dactylic hexameter	feminine penthemimeral, trithemimeral
Οὔλυμπον δὲ δίωκε, θεῶν δ’ἐξίκετο θώκους.	--- u u-u u- --uu --	dactylic hexameter	feminine penthemimeral, hepthemimeral, trithemimeral
τῷ δὲ καὶ ἵππους μὲν λῦσε κλυτὸς ἐννοσίγαιος,	- u u -- - -- uu -uu--	dactylic hexameter	masculine penthemimeral, hepthemimeral
ἅρματα δ’ἂμ βωμοῖσι τίθει κατὰ λῖτα πετάσσας·	-uu - --u u- uu -u u--	dactylic hexameter	feminine penthemimeral, hepthemimeral, trithemimeral
αὐτὸς δὲ χρύσειον ἐπὶ θρόνον εὐρύοπα Ζεὺς	-- - --u u- uu -uu- -	dactylic hexameter	feminine penthemimeral, hepthemimeral, trithemimeral
ἕζετο, τῷ δ’ὑπὸ ποσσὶ μέγας πελεμίζετ’ Ὄλυμπος.	-uu - uu -u u- uu-u u--	dactylic hexameter	feminine penthemimeral, hepthemimeral, trithemimeral
αἳ δ’οἶαι Διὸς ἀμφὶς Ἀθηναίη τε καὶ Ἥρη	- -- uu -u u--- u u --	dactylic hexameter	feminine penthemimeral, trithemimeral
ἥσθην, οὐδέ τί μιν προσεφώνεον οὐδ’ ἐρέοντο·	-- -u u - uu-uu - uu--	dactylic hexameter	masculine penthemimeral
αὐτὰρ ὃ ἔγνω ᾗσιν ἐνὶ φρεσὶ φώνησέν τε·	-u u -- -u u- uu --- -	dactylic hexameter	feminine penthemimeral, hepthemimeral
τίφθ’ οὕτω τετίησθον Ἀθηναίη τε καὶ Ἥρη;	- -- uu-u u--- u u --	dactylic hexameter	feminine penthemimeral, trithemimeral
οὐ μέν θην κάμετόν γε μάχῃ ἔνι κυδιανείρῃ	- - - uu- u u- uu -uu--	dactylic hexameter	masculine penthemimeral, hepthemimeral, trithemimeral
ὀλλῦσαι Τρῶας, τοῖσιν κότον αἰνὸν ἔθεσθε.	--- -- -- uu -u u--	dactylic hexameter	masculine penthemimeral, hepthemimeral, trithemimeral
πάντως, οἷον ἐμόν γε μένος καὶ χεῖρες ἄαπτοι,	-- -u u- u u- - -u u--	dactylic hexameter	masculine penthemimeral, hepthemimeral
οὐκ ἄν με τρέψειαν ὅσοι θεοί εἰσ’ ἐν Ὀλύμπῳ.	- - - --u u- uu - u u--	dactylic hexameter	feminine penthemimeral, hepthemimeral, trithemimeral
σφῶϊν δὲ πρίν περ τρόμος ἔλλαβε φαίδιμα γυῖα	-- - - - uu -uu -uu --	dactylic hexameter	masculine penthemimeral, trithemimeral
πρὶν πόλεμόν τε ἰδεῖν πολέμοιό τε μέρμερα ἔργα.	- uu- u u- uu-u u -uu --	dactylic hexameter	masculine penthemimeral, trithemimeral
ὧδε γὰρ ἐξερέω, τὸ δέ κεν τετελεσμένον ἦεν·	-u u -uu- u u - uu-uu --	dactylic hexameter	masculine penthemimeral, hepthemimeral
οὐκ ἂν ἐφ’ ὑμετέρων ὀχέων πληγέντε κεραυνῷ	- u u -uu- uu- --u u--	dactylic hexameter	masculine penthemimeral, hepthemimeral
ἂψ ἐς Ὄλυμπον ἵκεσθον, ἵν’ ἀθανάτων ἕδος ἐστίν.	- u u-u u-u u -uu- uu --	dactylic hexameter	feminine penthemimeral
ὣς ἔφαθ’, αἳ δ’ἐπέμυξαν Ἀθηναίη τε καὶ Ἥρη·	- uu - uu-u u--- u u --	dactylic hexameter	feminine penthemimeral, trithemimeral
πλησίαι αἵ γ’ἥσθην, κακὰ δὲ Τρώεσσι μεδέσθην.	-uu - -- uu - --u u--	dactylic hexameter	masculine penthemimeral, hepthemimeral, trithemimeral
ἤτοι Ἀθηναίη ἀκέων ἦν οὐδέ τι εἶπε	-u u--- uu- - -u u --	dactylic hexameter	masculine penthemimeral, hepthemimeral
σκυζομένη Διὶ πατρί, χόλος δέ μιν ἄγριος ᾕρει·	-uu- uu -u u- u u -uu --	dactylic hexameter	feminine penthemimeral, hepthemimeral, trithemimeral
Ἥρῃ δ’οὐκ ἔχαδε στῆθος χόλον, ἀλλὰ προσηύδα·	-- - uu- -- uu -u u--	dactylic hexameter	masculine penthemimeral, hepthemimeral, trithemimeral
αἰνότατε Κρονίδη ποῖον τὸν μῦθον ἔειπες.	-uu- uu- -- - -u u--	dactylic hexameter	masculine penthemimeral, hepthemimeral, trithemimeral
εὖ νυ καὶ ἡμεῖς ἴδμεν ὅ τοι σθένος οὐκ ἀλαπαδνόν·	- u u -- -u u - uu - uu--	dactylic hexameter	feminine penthemimeral, hepthemimeral
ἀλλ’ ἔμπης Δαναῶν ὀλοφυρόμεθ’ αἰχμητάων,	- -- uu- uu-uu ----	dactylic hexameter	masculine penthemimeral, trithemimeral
οἵ κεν δὴ κακὸν οἶτον ἀναπλήσαντες ὄλωνται.	- - - uu -u u---u u--	dactylic hexameter	feminine penthemimeral, trithemimeral
ἀλλ’ ἤτοι πολέμου μὲν ἀφεξόμεθ’, εἰ σὺ κελεύεις·	- -- uu- u u-uu - u u--	dactylic hexameter	masculine penthemimeral, trithemimeral
βουλὴν δ’Ἀργείοις ὑποθησόμεθ’ ἥ τις ὀνήσει,	-- --- uu-uu - u u--	dactylic hexameter	masculine penthemimeral
ὡς μὴ πάντες ὄλωνται ὀδυσσαμένοιο τεοῖο.	- - -u u-u u-uu-u u--	dactylic hexameter	feminine penthemimeral
τὴν δ’ἀπαμειβόμενος προσέφη νεφεληγερέτα Ζεύς·	- uu-uu- uu- uu-uu- -	dactylic hexameter	masculine penthemimeral, hepthemimeral
ἠοῦς δὴ καὶ μᾶλλον ὑπερμενέα Κρονίωνα	-- - - -u u-uu- uu--	dactylic hexameter	feminine penthemimeral, trithemimeral
ὄψεαι, αἴ κ’ἐθέλῃσθα, βοῶπις πότνια Ἥρη	-uu - uu-u u-- -uu --	dactylic hexameter	feminine penthemimeral, trithemimeral
ὀλλύντ’ Ἀργείων πουλὺν στρατὸν αἰχμητάων·	-- --- -- uu ----	dactylic hexameter	masculine penthemimeral, hepthemimeral
οὐ γὰρ πρὶν πολέμου ἀποπαύσεται ὄβριμος Ἕκτωρ	- - - uu- uu-uu -uu --	dactylic hexameter	masculine penthemimeral, trithemimeral
πρὶν ὄρθαι παρὰ ναῦφι ποδώκεα Πηλεΐωνα,	- -- uu -u u-uu -uu--	dactylic hexameter	feminine penthemimeral, trithemimeral
ἤματι τῷ ὅτ’ ἂν οἳ μὲν ἐπὶ πρύμνῃσι μάχωνται	-uu - u u - u u- --u u--	dactylic hexameter	masculine penthemimeral, hepthemimeral, trithemimeral
στείνει ἐν αἰνοτάτῳ περὶ Πατρόκλοιο θανόντος·	-u u -uu- uu ---u u--	dactylic hexameter	masculine penthemimeral
ὣς γὰρ θέσφατόν ἐστι· σέθεν δ’ἐγὼ οὐκ ἀλεγίζω	- - -uu -u u- uu - uu--	dactylic hexameter	feminine penthemimeral, hepthemimeral
χωομένης, οὐδ’ εἴ κε τὰ νείατα πείραθ’ ἵκηαι	-uu- - - u u -uu -u u--	dactylic hexameter	masculine penthemimeral, trithemimeral
γαίης καὶ πόντοιο, ἵν’ Ἰάπετός τε Κρόνος τε	-- - --u u -uu- u u- -	dactylic hexameter	feminine penthemimeral, trithemimeral
ἥμενοι οὔτ’ αὐγῇς Ὑπερίονος Ἠελίοιο	-uu - -- uu-uu -uu--	dactylic hexameter	masculine penthemimeral, trithemimeral
τέρποντ’ οὔτ’ ἀνέμοισι, βαθὺς δέ τε Τάρταρος ἀμφίς·	-- - uu-u u- u u -uu --	dactylic hexameter	feminine penthemimeral, hepthemimeral, trithemimeral
οὐδ’ ἢν ἔνθ’ ἀφίκηαι ἀλωμένη, οὔ σευ ἔγωγε	- - - uu-u u-uu - u u--	dactylic hexameter	feminine penthemimeral, trithemimeral
σκυζομένης ἀλέγω, ἐπεὶ οὐ σέο κύντερον ἄλλο.	-uu- uu- uu - uu -uu --	dactylic hexameter	masculine penthemimeral, hepthemimeral, trithemimeral
ὣς φάτο, τὸν δ’οὔ τι προσέφη λευκώλενος Ἥρη.	- uu - - - uu- --uu --	dactylic hexameter	masculine penthemimeral, hepthemimeral, trithemimeral
ἐν δ’ἔπεσ’ Ὠκεανῷ λαμπρὸν φάος ἠελίοιο	- uu -uu- -- uu -uu--	dactylic hexameter	masculine penthemimeral, hepthemimeral
ἕλκον νύκτα μέλαιναν ἐπὶ ζείδωρον ἄρουραν.	-- -u u-u u- --u u--	dactylic hexameter	feminine penthemimeral, hepthemimeral
Τρωσὶν μέν ῥ’ἀέκουσιν ἔδυ φάος, αὐτὰρ Ἀχαιοῖς	-- - uu-u u- uu -u u--	dactylic hexameter	feminine penthemimeral, hepthemimeral, trithemimeral
ἀσπασίη τρίλλιστος ἐπήλυθε νὺξ ἐρεβεννή.	-uu- --u u-uu - uu--	dactylic hexameter	feminine penthemimeral, trithemimeral
Τρώων αὖτ’ ἀγορὴν ποιήσατο φαίδιμος Ἕκτωρ	-- - uu- --uu -uu --	dactylic hexameter	masculine penthemimeral, trithemimeral
νόσφι νεῶν ἀγαγὼν ποταμῷ ἔπι δινήεντι,	-u u- uu- uu- uu ----	dactylic hexameter	masculine penthemimeral, hepthemimeral, trithemimeral
ἐν καθαρῷ ὅθι δὴ νεκύων διεφαίνετο χῶρος.	- uu- uu - uu- uu-uu --	dactylic hexameter	masculine penthemimeral, hepthemimeral, trithemimeral
ἐξ ἵππων δ’ἀποβάντες ἐπὶ χθόνα μῦθον ἄκουον	- -- uu-u u- uu -u u--	dactylic hexameter	feminine penthemimeral, hepthemimeral, trithemimeral
τόν ῥ’Ἕκτωρ ἀγόρευε Διῒ φίλος· ἐν δ’ἄρα χειρὶ	- -- uu-u u- uu - uu --	dactylic hexameter	feminine penthemimeral, hepthemimeral, trithemimeral
ἔγχος ἔχ’ ἑνδεκάπηχυ· πάροιθε δὲ λάμπετο δουρὸς	-u u -uu-u u-u u -uu --	dactylic hexameter	feminine penthemimeral
αἰχμὴ χαλκείη, περὶ δὲ χρύσεος θέε πόρκης,	-- --- uu - uu- uu --	dactylic hexameter	masculine penthemimeral, hepthemimeral
τῷ ὅ γ’ἐρεισάμενος ἔπεα Τρώεσσι μετηύδα·	- u u-uu- uu- --u u--	dactylic hexameter	masculine penthemimeral, hepthemimeral
κέκλυτέ μευ Τρῶες καὶ Δάρδανοι ἠδ’ ἐπίκουροι·	-uu - -- - -uu - uu--	dactylic hexameter	masculine penthemimeral, trithemimeral
νῦν ἐφάμην νῆάς τ’ὀλέσας καὶ πάντας Ἀχαιοὺς	- uu- -- uu- - -u u--	dactylic hexameter	masculine penthemimeral, hepthemimeral, trithemimeral
ἂψ ἀπονοστήσειν προτὶ Ἴλιον ἠνεμόεσσαν·	- uu--- uu -uu -uu--	dactylic hexameter	masculine penthemimeral
ἀλλὰ πρὶν κνέφας ἦλθε, τὸ νῦν ἐσάωσε μάλιστα	-- - uu -u u - uu-u u--	dactylic hexameter	feminine penthemimeral, hepthemimeral, trithemimeral
Ἀργείους καὶ νῆας ἐπὶ ῥηγμῖνι θαλάσσης.	--- - -u u- --u u--	dactylic hexameter	feminine penthemimeral, hepthemimeral, trithemimeral
ἀλλ’ ἤτοι νῦν μὲν πειθώμεθα νυκτὶ μελαίνῃ	- -- - - --uu -u u--	dactylic hexameter	masculine penthemimeral, trithemimeral
δόρπά τ’ἐφοπλισόμεσθα· ἀτὰρ καλλίτριχας ἵππους	-u u-uu-u u- --uu --	dactylic hexameter	feminine penthemimeral, hepthemimeral
λύσαθ’ ὑπὲξ ὀχέων, παρὰ δέ σφισι βάλλετ’ ἐδωδήν·	-u u- uu- uu - uu -u u--	dactylic hexameter	masculine penthemimeral, hepthemimeral, trithemimeral
ἐκ πόλιος δ’ἄξεσθε βόας καὶ ἴφια μῆλα	- uu- --u u- - -uu --	dactylic hexameter	feminine penthemimeral, hepthemimeral, trithemimeral
καρπαλίμως, οἶνον δὲ μελίφρονα οἰνίζεσθε	-uu- -- u u-uu ----	dactylic hexameter	masculine penthemimeral, trithemimeral
σῖτόν τ’ἐκ μεγάρων, ἐπὶ δὲ ξύλα πολλὰ λέγεσθε,	-- - uu- uu - uu -u u--	dactylic hexameter	masculine penthemimeral, hepthemimeral, trithemimeral
ὥς κεν παννύχιοι μέσφ’ ἠοῦς ἠριγενείης	- - -uu- - -- -uu--	dactylic hexameter	masculine penthemimeral
καίωμεν πυρὰ πολλά, σέλας δ’εἰς οὐρανὸν ἵκῃ,	--- uu -u u- - -uu --	dactylic hexameter	feminine penthemimeral, hepthemimeral, trithemimeral
μή πως καὶ διὰ νύκτα κάρη κομόωντες Ἀχαιοὶ	- - - uu -u u- uu-u u--	dactylic hexameter	feminine penthemimeral, hepthemimeral, trithemimeral
φεύγειν ὁρμήσωνται ἐπ’ εὐρέα νῶτα θαλάσσης.	-- ---u u -uu -u u--	dactylic hexameter	feminine penthemimeral
μὴ μὰν ἀσπουδί γε νεῶν ἐπιβαῖεν ἕκηλοι,	- - --- u u- uu-u u--	dactylic hexameter	masculine penthemimeral, hepthemimeral
ἀλλ’ ὥς τις τούτων γε βέλος καὶ οἴκοθι πέσσῃ	- - - -- u u- - -uu --	dactylic hexameter	masculine penthemimeral, hepthemimeral, trithemimeral
βλήμενος ἢ ἰῷ ἢ ἔγχεϊ ὀξυόεντι	-uu - -- - -uu -uu--	dactylic hexameter	masculine penthemimeral, trithemimeral
νηὸς ἐπιθρῴσκων, ἵνα τις στυγέῃσι καὶ ἄλλος	-u u--- uu - uu-u u --	dactylic hexameter	masculine penthemimeral, hepthemimeral
Τρωσὶν ἐφ’ ἱπποδάμοισι φέρειν πολύδακρυν Ἄρηα.	-u u -uu-u u- uu-u u--	dactylic hexameter	feminine penthemimeral, hepthemimeral
κήρυκες δ’ἀνὰ ἄστυ Διῒ φίλοι ἀγγελλόντων	--- uu -u u- uu ----	dactylic hexameter	feminine penthemimeral, hepthemimeral, trithemimeral
παῖδας πρωθήβας πολιοκροτάφους τε γέροντας	-- --- uu-uu- u u--	dactylic hexameter	masculine penthemimeral
λέξασθαι περὶ ἄστυ θεοδμήτων ἐπὶ πύργων·	--- uu -u u--- uu --	dactylic hexameter	feminine penthemimeral, trithemimeral
θηλύτεραι δὲ γυναῖκες ἐνὶ μεγάροισιν ἑκάστη	-uu- u u-u u- uu-u u--	dactylic hexameter	feminine penthemimeral, hepthemimeral, trithemimeral
πῦρ μέγα καιόντων· φυλακὴ δέ τις ἔμπεδος ἔστω	- uu --- uu- u u -uu --	dactylic hexameter	masculine penthemimeral, hepthemimeral
μὴ λόχος εἰσέλθῃσι πόλιν λαῶν ἀπεόντων.	- uu ---u u- -- uu--	dactylic hexameter	feminine penthemimeral, hepthemimeral
ὧδ’ ἔστω Τρῶες μεγαλήτορες ὡς ἀγορεύω·	- -- -- uu-uu - uu--	dactylic hexameter	masculine penthemimeral, trithemimeral
μῦθος δ’ὃς μὲν νῦν ὑγιὴς εἰρημένος ἔστω,	-- - - - uu- --uu --	dactylic hexameter	masculine penthemimeral, hepthemimeral, trithemimeral
τὸν δ’ἠοῦς Τρώεσσι μεθ’ ἱπποδάμοις ἀγορεύσω.	- -- --u u -uu- uu--	dactylic hexameter	feminine penthemimeral, trithemimeral
ἔλπομαι εὐχόμενος Διί τ’ἄλλοισίν τε θεοῖσιν	-uu -uu- uu --- u u--	dactylic hexameter	masculine penthemimeral
ἐξελάαν ἐνθένδε κύνας κηρεσσιφορήτους,	-uu- --u u- --uu--	dactylic hexameter	feminine penthemimeral, hepthemimeral, trithemimeral
οὓς κῆρες φορέουσι μελαινάων ἐπὶ νηῶν.	- -- uu-u u--- uu --	dactylic hexameter	feminine penthemimeral, trithemimeral
ἀλλ’ ἤτοι ἐπὶ νυκτὶ φυλάξομεν ἡμέας αὐτούς,	- -- uu -u u-uu -uu --	dactylic hexameter	feminine penthemimeral, trithemimeral
πρῶϊ δ’ὑπηοῖοι σὺν τεύχεσι θωρηχθέντες	-u u--- - -uu ----	dactylic hexameter	masculine penthemimeral
νηυσὶν ἔπι γλαφυρῇσιν ἐγείρομεν ὀξὺν Ἄρηα.	-u u- uu-u u-uu -u u--	dactylic hexameter	feminine penthemimeral, trithemimeral
εἴσομαι εἴ κέ μ’ὁ Τυδεΐδης κρατερὸς Διομήδης	-uu - u u -uu- uu- uu--	dactylic hexameter	hepthemimeral, trithemimeral
πὰρ νηῶν πρὸς τεῖχος ἀπώσεται, ἤ κεν ἐγὼ τὸν	- -- - -u u-uu - u u- -	dactylic hexameter	feminine penthemimeral, trithemimeral
χαλκῷ δῃώσας ἔναρα βροτόεντα φέρωμαι.	-- --- uu- uu-u u--	dactylic hexameter	masculine penthemimeral, hepthemimeral
αὔριον ἣν ἀρετὴν διαείσεται, εἴ κ’ἐμὸν ἔγχος	-uu - uu- uu-uu - uu --	dactylic hexameter	masculine penthemimeral, trithemimeral
μείνῃ ἐπερχόμενον· ἀλλ’ ἐν πρώτοισιν ὀΐω	-u u-uu- - - --u u--	dactylic hexameter	masculine penthemimeral, hepthemimeral
κείσεται οὐτηθείς, πολέες δ’ἀμφ’ αὐτὸν ἑταῖροι	-uu --- uu- - -u u--	dactylic hexameter	masculine penthemimeral, hepthemimeral
ἠελίου ἀνιόντος ἐς αὔριον· εἰ γὰρ ἐγὼν ὣς	-uu- uu-u u -uu - u u- -	dactylic hexameter	feminine penthemimeral, trithemimeral
εἴην ἀθάνατος καὶ ἀγήρως ἤματα πάντα,	-- -uu- u u-- -uu --	dactylic hexameter	masculine penthemimeral
τιοίμην δ’ὡς τίετ’ Ἀθηναίη καὶ Ἀπόλλων,	--- - -u u--- u u--	dactylic hexameter	feminine penthemimeral, trithemimeral
ὡς νῦν ἡμέρη ἥδε κακὸν φέρει Ἀργείοισιν.	- - -uu -u u- uu ----	dactylic hexameter	feminine penthemimeral, hepthemimeral
ὣς Ἕκτωρ ἀγόρευ’, ἐπὶ δὲ Τρῶες κελάδησαν.	- -- uu- uu - -- uu--	dactylic hexameter	masculine penthemimeral, hepthemimeral, trithemimeral
οἳ δ’ἵππους μὲν λῦσαν ὑπὸ ζυγοῦ ἱδρώοντας,	- -- - -u u- uu ----	dactylic hexameter	feminine penthemimeral, hepthemimeral, trithemimeral
δῆσαν δ’ἱμάντεσσι παρ’ ἅρμασιν οἷσιν ἕκαστος·	-- ---u u -uu -u u--	dactylic hexameter	feminine penthemimeral
ἐκ πόλιος δ’ἄξοντο βόας καὶ ἴφια μῆλα	- uu- --u u- - -uu --	dactylic hexameter	feminine penthemimeral, hepthemimeral, trithemimeral
καρπαλίμως, οἶνον δὲ μελίφρονα οἰνίζοντο,	-uu- -- u u-uu ----	dactylic hexameter	masculine penthemimeral, trithemimeral
σῖτόν τ’ἐκ μεγάρων, ἐπὶ δὲ ξύλα πολλὰ λέγοντο.	-- - uu- uu - uu -u u--	dactylic hexameter	masculine penthemimeral, hepthemimeral, trithemimeral
κνίσην δ’ἐκ πεδίου ἄνεμοι φέρον οὐρανὸν εἴσω.	-- - uu- uu- uu -uu --	dactylic hexameter	masculine penthemimeral, hepthemimeral, trithemimeral
οἳ δὲ μέγα φρονέοντες ἐπὶ πτολέμοιο γεφύρας	- u u- uu-u u- uu-u u--	dactylic hexameter	feminine penthemimeral, hepthemimeral, trithemimeral
εἴατο παννύχιοι, πυρὰ δέ σφισι καίετο πολλά.	-uu -uu- uu - uu -uu --	dactylic hexameter	masculine penthemimeral, hepthemimeral
ὡς δ’ὅτ’ ἐν οὐρανῷ ἄστρα φαεινὴν ἀμφὶ σελήνην	- u u -uu -u u-- -u u--	dactylic hexameter	feminine penthemimeral
φαίνετ’ ἀριπρεπέα, ὅτε τ’ἔπλετο νήνεμος αἰθήρ·	-u u-uu- uu -uu -uu --	dactylic hexameter	masculine penthemimeral
ἔκ τ’ἔφανεν πᾶσαι σκοπιαὶ καὶ πρώονες ἄκροι	- uu- -- uu- - -uu --	dactylic hexameter	masculine penthemimeral, hepthemimeral, trithemimeral
καὶ νάπαι· οὐρανόθεν δ’ἄρ’ ὑπερράγη ἄσπετος αἰθήρ,	- uu -uu- u u-uu -uu --	dactylic hexameter	masculine penthemimeral
πάντα δὲ εἴδεται ἄστρα, γέγηθε δέ τε φρένα ποιμήν·	-u u -uu -u u-u u - uu --	dactylic hexameter	feminine penthemimeral
τόσσα μεσηγὺ νεῶν ἠδὲ Ξάνθοιο ῥοάων	-u u-u u- -- --u u--	dactylic hexameter	masculine penthemimeral, hepthemimeral
Τρώων καιόντων πυρὰ φαίνετο Ἰλιόθι πρό.	-- --- uu -uu -uu- -	dactylic hexameter	masculine penthemimeral
χίλι’ ἄρ’ ἐν πεδίῳ πυρὰ καίετο, πὰρ δὲ ἑκάστῳ	-u u - uu- uu -uu - u u--	dactylic hexameter	masculine penthemimeral, trithemimeral
εἴατο πεντήκοντα σέλᾳ πυρὸς αἰθομένοιο.	-uu ---u u- uu -uu--	dactylic hexameter	feminine penthemimeral, hepthemimeral
ἵπποι δὲ κρῖ λευκὸν ἐρεπτόμενοι καὶ ὀλύρας	-- - - -u u-uu- u u--	dactylic hexameter	feminine penthemimeral, trithemimeral
ἑσταότες παρ’ ὄχεσφιν ἐΰθρονον Ἠῶ μίμνον.	-uu- u u-u u-uu -- --	dactylic hexameter	feminine penthemimeral, trithemimeral
