ἄλλοι μὲν παρὰ νηυσὶν ἀριστῆες Παναχαιῶν	-- - uu -u u--- uu--	dactylic hexameter	feminine penthemimeral, trithemimeral
εὗδον παννύχιοι μαλακῷ δεδμημένοι ὕπνῳ·	-- -uu- uu- --uu --	dactylic hexameter	masculine penthemimeral, hepthemimeral
ἀλλ’ οὐκ Ἀτρεΐδην Ἀγαμέμνονα ποιμένα λαῶν	- - -uu- uu-uu -uu --	dactylic hexameter	masculine penthemimeral
ὕπνος ἔχε γλυκερὸς πολλὰ φρεσὶν ὁρμαίνοντα.	-u u- uu- -- uu ----	dactylic hexameter	masculine penthemimeral, hepthemimeral, trithemimeral
ὡς δ’ὅτ’ ἂν ἀστράπτῃ πόσις Ἥρης ἠϋκόμοιο	- u u --- uu -- -uu--	dactylic hexameter	masculine penthemimeral
τεύχων ἢ πολὺν ὄμβρον ἀθέσφατον ἠὲ χάλαζαν	-- - uu -u u-uu -u u--	dactylic hexameter	feminine penthemimeral, trithemimeral
ἢ νιφετόν, ὅτε πέρ τε χιὼν ἐπάλυνεν ἀρούρας,	- uu- uu - u u- uu-u u--	dactylic hexameter	masculine penthemimeral, hepthemimeral, trithemimeral
ἠέ ποθι πτολέμοιο μέγα στόμα πευκεδανοῖο,	-u u- uu-u u- uu -uu--	dactylic hexameter	feminine penthemimeral, hepthemimeral, trithemimeral
ὣς πυκίν’ ἐν στήθεσσιν ἀνεστενάχιζ’ Ἀγαμέμνων	- uu - --u u-uu- uu--	dactylic hexameter	feminine penthemimeral, trithemimeral
νειόθεν ἐκ κραδίης, τρομέοντο δέ οἱ φρένες ἐντός.	-uu - uu- uu-u u - uu --	dactylic hexameter	masculine penthemimeral, trithemimeral
ἤτοι ὅτ’ ἐς πεδίον τὸ Τρωϊκὸν ἀθρήσειε,	-u u - uu- - -uu ----	dactylic hexameter	masculine penthemimeral, trithemimeral
θαύμαζεν πυρὰ πολλὰ τὰ καίετο Ἰλιόθι πρὸ	--- uu -u u -uu -uu- -	dactylic hexameter	feminine penthemimeral, trithemimeral
αὐλῶν συρίγγων τ’ἐνοπὴν ὅμαδόν τ’ἀνθρώπων.	-- --- uu- uu- ---	dactylic hexameter	masculine penthemimeral, hepthemimeral
αὐτὰρ ὅτ’ ἐς νῆάς τε ἴδοι καὶ λαὸν Ἀχαιῶν,	-u u - -- u u- - -u u--	dactylic hexameter	masculine penthemimeral, hepthemimeral, trithemimeral
πολλὰς ἐκ κεφαλῆς προθελύμνους ἕλκετο χαίτας	-- - uu- uu-- -uu --	dactylic hexameter	masculine penthemimeral, trithemimeral
ὑψόθ’ ἐόντι Διί, μέγα δ’ἔστενε κυδάλιμον κῆρ.	-u u-u u- uu -uu -uu- -	dactylic hexameter	masculine penthemimeral
ἥδε δέ οἱ κατὰ θυμὸν ἀρίστη φαίνετο βουλὴ	-u u - uu -u u-- -uu --	dactylic hexameter	feminine penthemimeral, trithemimeral
Νέστορ’ ἔπι πρῶτον Νηλήϊον ἐλθέμεν ἀνδρῶν,	-u u- -- --uu -uu --	dactylic hexameter	masculine penthemimeral, trithemimeral
εἴ τινά οἱ σὺν μῆτιν ἀμύμονα τεκτήναιτο,	- uu - - -u u-uu ----	dactylic hexameter	feminine penthemimeral, trithemimeral
ἥ τις ἀλεξίκακος πᾶσιν Δαναοῖσι γένοιτο.	- u u-uu- -- uu-u u--	dactylic hexameter	masculine penthemimeral, hepthemimeral
ὀρθωθεὶς δ’ἔνδυνε περὶ στήθεσσι χιτῶνα,	--- --u u- --u u--	dactylic hexameter	feminine penthemimeral, hepthemimeral, trithemimeral
ποσσὶ δ’ὑπὸ λιπαροῖσιν ἐδήσατο καλὰ πέδιλα,	-u u- uu-u u-uu -u u--	dactylic hexameter	feminine penthemimeral, trithemimeral
ἀμφὶ δ’ἔπειτα δαφοινὸν ἑέσσατο δέρμα λέοντος	-u u-u u-u u-uu -u u--	dactylic hexameter	feminine penthemimeral
αἴθωνος μεγάλοιο ποδηνεκές, εἵλετο δ’ἔγχος.	--- uu-u u-uu -uu --	dactylic hexameter	feminine penthemimeral, trithemimeral
ὣς δ’αὔτως Μενέλαον ἔχε τρόμος· οὐδὲ γὰρ αὐτῷ	- -- uu-u u- uu -u u --	dactylic hexameter	feminine penthemimeral, hepthemimeral, trithemimeral
ὕπνος ἐπὶ βλεφάροισιν ἐφίζανε· μή τι πάθοιεν	-u u- uu-u u-uu - u u--	dactylic hexameter	feminine penthemimeral, trithemimeral
Ἀργεῖοι, τοὶ δὴ ἕθεν εἵνεκα πουλὺν ἐφ’ ὑγρὴν	--- - - uu -uu -u u --	dactylic hexameter	masculine penthemimeral, trithemimeral
ἤλυθον ἐς Τροίην πόλεμον θρασὺν ὁρμαίνοντες.	-uu - -- uu- uu ----	dactylic hexameter	masculine penthemimeral, hepthemimeral, trithemimeral
παρδαλέῃ μὲν πρῶτα μετάφρενον εὐρὺ κάλυψε	-uu- - -u u-uu -u u--	dactylic hexameter	feminine penthemimeral, trithemimeral
ποικίλῃ, αὐτὰρ ἐπὶ στεφάνην κεφαλῆφιν ἀείρας	-uu -u u- uu- uu-u u--	dactylic hexameter	masculine penthemimeral, hepthemimeral
θήκατο χαλκείην, δόρυ δ’εἵλετο χειρὶ παχείῃ.	-uu --- uu -uu -u u--	dactylic hexameter	masculine penthemimeral
βῆ δ’ἴμεν ἀνστήσων ὃν ἀδελφεόν, ὃς μέγα πάντων	- uu --- u u-uu - uu --	dactylic hexameter	masculine penthemimeral
Ἀργείων ἤνασσε, θεὸς δ’ὣς τίετο δήμῳ.	--- --u u- - -uu --	dactylic hexameter	feminine penthemimeral, hepthemimeral, trithemimeral
τὸν δ’εὗρ’ ἀμφ’ ὤμοισι τιθήμενον ἔντεα καλὰ	- - - --u u-uu -uu --	dactylic hexameter	feminine penthemimeral, trithemimeral
νηῒ πάρα πρύμνῃ· τῷ δ’ἀσπάσιος γένετ’ ἐλθών.	-u u- -- - -uu- uu --	dactylic hexameter	masculine penthemimeral, trithemimeral
τὸν πρότερος προσέειπε βοὴν ἀγαθὸς Μενέλαος·	- uu- uu-u u- uu- uu--	dactylic hexameter	feminine penthemimeral, hepthemimeral, trithemimeral
τίφθ’ οὕτως ἠθεῖε κορύσσεαι; ἦ τιν’ ἑταίρων	- -- --u u-uu - u u--	dactylic hexameter	feminine penthemimeral, trithemimeral
ὀτρυνέεις Τρώεσσιν ἐπίσκοπον; ἀλλὰ μάλ’ αἰνῶς	-uu- --u u-uu -u u --	dactylic hexameter	feminine penthemimeral, trithemimeral
δείδω μὴ οὔ τίς τοι ὑπόσχηται τόδε ἔργον	-- - - - u u--- uu --	dactylic hexameter	masculine penthemimeral, trithemimeral
ἄνδρας δυσμενέας σκοπιαζέμεν οἶος ἐπελθὼν	-- -uu- uu-uu -u u--	dactylic hexameter	masculine penthemimeral
νύκτα δι’ ἀμβροσίην· μάλα τις θρασυκάρδιος ἔσται.	-u u -uu- uu - uu-uu --	dactylic hexameter	masculine penthemimeral, hepthemimeral
τὸν δ’ἀπαμειβόμενος προσέφη κρείων Ἀγαμέμνων·	- uu-uu- uu- -- uu--	dactylic hexameter	masculine penthemimeral, hepthemimeral
χρεὼ βουλῆς ἐμὲ καὶ σὲ διοτρεφὲς ὦ Μενέλαε	- -- uu - u u-uu - uu--	dactylic hexameter	masculine penthemimeral, trithemimeral
κερδαλέης, ἥ τίς κεν ἐρύσσεται ἠδὲ σαώσει	-uu- - - u u-uu -u u--	dactylic hexameter	masculine penthemimeral, trithemimeral
Ἀργείους καὶ νῆας, ἐπεὶ Διὸς ἐτράπετο φρήν.	--- - -u u- uu -uu- -	dactylic hexameter	feminine penthemimeral, hepthemimeral, trithemimeral
Ἑκτορέοις ἄρα μᾶλλον ἐπὶ φρένα θῆχ’ ἱεροῖσιν·	-uu- uu -u u- uu - uu--	dactylic hexameter	feminine penthemimeral, hepthemimeral, trithemimeral
οὐ γάρ πω ἰδόμην, οὐδ’ ἔκλυον αὐδήσαντος	- - - uu- - -uu ----	dactylic hexameter	masculine penthemimeral, trithemimeral
ἄνδρ’ ἕνα τοσσάδε μέρμερ’ ἐπ’ ἤματι μητίσασθαι,	- uu -uu -u u -uu ----	dactylic hexameter	feminine penthemimeral
ὅσσ’ Ἕκτωρ ἔρρεξε Διῒ φίλος υἷας Ἀχαιῶν	- -- --u u- uu -u u--	dactylic hexameter	feminine penthemimeral, hepthemimeral, trithemimeral
αὔτως, οὔτε θεᾶς υἱὸς φίλος οὔτε θεοῖο.	-- -u u- -- uu -u u--	dactylic hexameter	masculine penthemimeral, hepthemimeral
ἔργα δ’ἔρεξ’ ὅσα φημὶ μελησέμεν Ἀργείοισι	-u u- uu -u u-uu ----	dactylic hexameter	feminine penthemimeral, trithemimeral
δηθά τε καὶ δολιχόν· τόσα γὰρ κακὰ μήσατ’ Ἀχαιούς.	-u u - uu- uu - uu -u u--	dactylic hexameter	masculine penthemimeral, hepthemimeral, trithemimeral
ἀλλ’ ἴθι νῦν Αἴαντα καὶ Ἰδομενῆα κάλεσσον	- uu - --u u -uu-u u--	dactylic hexameter	feminine penthemimeral, trithemimeral
ῥίμφα θέων παρὰ νῆας· ἐγὼ δ’ἐπὶ Νέστορα δῖον	-u u- uu -u u- uu -uu --	dactylic hexameter	feminine penthemimeral, hepthemimeral, trithemimeral
εἶμι, καὶ ὀτρυνέω ἀνστήμεναι, αἴ κ’ἐθέλῃσιν	-u u --- --uu - uu--	dactylic hexameter	masculine penthemimeral
ἐλθεῖν ἐς φυλάκων ἱερὸν τέλος ἠδ’ ἐπιτεῖλαι.	-- - uu- uu- uu - uu--	dactylic hexameter	masculine penthemimeral, hepthemimeral, trithemimeral
κείνῳ γάρ κε μάλιστα πιθοίατο· τοῖο γὰρ υἱὸς	-- - u u-u u-uu -u u --	dactylic hexameter	feminine penthemimeral, trithemimeral
σημαίνει φυλάκεσσι καὶ Ἰδομενῆος ὀπάων	--- uu-u u -uu-u u--	dactylic hexameter	feminine penthemimeral, trithemimeral
Μηριόνης· τοῖσιν γὰρ ἐπετράπομέν γε μάλιστα.	-uu- -- u u-uu- u u--	dactylic hexameter	masculine penthemimeral, trithemimeral
τὸν δ’ἠμείβετ’ ἔπειτα βοὴν ἀγαθὸς Μενέλαος·	- --u u-u u- uu- uu--	dactylic hexameter	feminine penthemimeral, hepthemimeral
πῶς γάρ μοι μύθῳ ἐπιτέλλεαι ἠδὲ κελεύεις;	- - - -- uu-uu -u u--	dactylic hexameter	masculine penthemimeral, trithemimeral
αὖθι μένω μετὰ τοῖσι δεδεγμένος εἰς ὅ κεν ἔλθῃς,	-u u- uu -u u-uu - u u --	dactylic hexameter	feminine penthemimeral, trithemimeral
ἦε θέω μετὰ σ’αὖτις, ἐπὴν εὖ τοῖς ἐπιτείλω;	-u u- uu -u u- - - uu--	dactylic hexameter	feminine penthemimeral, hepthemimeral, trithemimeral
τὸν δ’αὖτε προσέειπεν ἄναξ ἀνδρῶν Ἀγαμέμνων,	- -- uu-u u- -- uu--	dactylic hexameter	feminine penthemimeral, hepthemimeral, trithemimeral
αὖθι μένειν, μή πως ἀβροτάξομεν ἀλλήλοιιν	-u u- - - uu-uu ----	dactylic hexameter	masculine penthemimeral, trithemimeral
ἐρχομένω· πολλαὶ γὰρ ἀνὰ στρατόν εἰσι κέλευθοι.	-uu- -- u u- uu -u u--	dactylic hexameter	masculine penthemimeral, hepthemimeral, trithemimeral
φθέγγεο δ’ᾗ κεν ἴῃσθα καὶ ἐγρήγορθαι ἄνωχθι	-uu - u u-u u ---u u--	dactylic hexameter	feminine penthemimeral, trithemimeral
πατρόθεν ἐκ γενεῆς ὀνομάζων ἄνδρα ἕκαστον	-uu - uu- uu-- -u u--	dactylic hexameter	masculine penthemimeral, trithemimeral
πάντας κυδαίνων· μηδὲ μεγαλίζεο θυμῷ,	-- --- -- uu-uu --	dactylic hexameter	masculine penthemimeral, hepthemimeral
ἀλλὰ καὶ αὐτοί περ πονεώμεθα· ὧδέ που ἄμμι	-u u -- - uu-uu -u u --	dactylic hexameter	masculine penthemimeral
Ζεὺς ἐπὶ γιγνομένοισιν ἵει κακότητα βαρεῖαν.	- uu -uu-u u- uu-u u--	dactylic hexameter	feminine penthemimeral, hepthemimeral
ὣς εἰπὼν ἀπέπεμπεν ἀδελφεὸν εὖ ἐπιτείλας·	- -- uu-u u-uu - uu--	dactylic hexameter	feminine penthemimeral, trithemimeral
αὐτὰρ ὃ βῆ ῥ’ἰέναι μετὰ Νέστορα ποιμένα λαῶν·	-u u - uu- uu -uu -uu --	dactylic hexameter	masculine penthemimeral, trithemimeral
τὸν δ’εὗρεν παρά τε κλισίῃ καὶ νηῒ μελαίνῃ	- -- uu - uu- - -u u--	dactylic hexameter	masculine penthemimeral, hepthemimeral, trithemimeral
εὐνῇ ἔνι μαλακῇ· παρὰ δ’ἔντεα ποικίλ’ ἔκειτο	-u u- uu- uu -uu -u u--	dactylic hexameter	masculine penthemimeral, trithemimeral
ἀσπὶς καὶ δύο δοῦρε φαεινή τε τρυφάλεια.	-- - uu -u u-- - uu--	dactylic hexameter	feminine penthemimeral, trithemimeral
πὰρ δὲ ζωστὴρ κεῖτο παναίολος, ᾧ ῥ’ὁ γεραιὸς	- - -- -u u-uu - u u--	dactylic hexameter	feminine penthemimeral
ζώννυθ’ ὅτ’ ἐς πόλεμον φθισήνορα θωρήσσοιτο	-u u - uu- --uu ----	dactylic hexameter	masculine penthemimeral, trithemimeral
λαὸν ἄγων, ἐπεὶ οὐ μὲν ἐπέτρεπε γήραϊ λυγρῷ.	-u u- uu - u u-uu -uu --	dactylic hexameter	masculine penthemimeral, trithemimeral
ὀρθωθεὶς δ’ἄρ’ ἐπ’ ἀγκῶνος κεφαλὴν ἐπαείρας	--- u u --- uu- uu--	dactylic hexameter	hepthemimeral, trithemimeral
Ἀτρεΐδην προσέειπε καὶ ἐξερεείνετο μύθῳ·	-uu- uu-u u -uu-uu --	dactylic hexameter	feminine penthemimeral, trithemimeral
τίς δ’οὗτος κατὰ νῆας ἀνὰ στρατὸν ἔρχεαι οἶος	- -- uu -u u- uu -uu --	dactylic hexameter	feminine penthemimeral, hepthemimeral, trithemimeral
νύκτα δι’ ὀρφναίην, ὅτε θ’εὕδουσι βροτοὶ ἄλλοι,	-u u --- uu --- uu --	dactylic hexameter	masculine penthemimeral
ἠέ τιν’ οὐρήων διζήμενος, ἤ τιν’ ἑταίρων;	-u u --- --uu - u u--	dactylic hexameter	masculine penthemimeral
φθέγγεο, μηδ’ ἀκέων ἐπ’ ἔμ’ ἔρχεο· τίπτε δέ σε χρεώ;	-uu - uu- u u -uu -u u - -	dactylic hexameter	masculine penthemimeral, trithemimeral
τὸν δ’ἠμείβετ’ ἔπειτα ἄναξ ἀνδρῶν Ἀγαμέμνων·	- --u u-u u- -- uu--	dactylic hexameter	feminine penthemimeral, hepthemimeral
ὦ Νέστορ Νηληϊάδη μέγα κῦδος Ἀχαιῶν	- -- --uu- uu -u u--	dactylic hexameter	hepthemimeral, trithemimeral
γνώσεαι Ἀτρεΐδην Ἀγαμέμνονα, τὸν περὶ πάντων	-uu -uu- uu-uu - uu --	dactylic hexameter	masculine penthemimeral
Ζεὺς ἐνέηκε πόνοισι διαμπερὲς εἰς ὅ κ’ἀϋτμὴ	- uu-u u-u u-uu - u u--	dactylic hexameter	feminine penthemimeral
ἐν στήθεσσι μένῃ καί μοι φίλα γούνατ’ ὀρώρῃ.	- --u u- - - uu -u u--	dactylic hexameter	masculine penthemimeral, hepthemimeral
πλάζομαι ὧδ’ ἐπεὶ οὔ μοι ἐπ’ ὄμμασι νήδυμος ὕπνος	-uu - uu - u u -uu -uu --	dactylic hexameter	masculine penthemimeral, trithemimeral
ἱζάνει, ἀλλὰ μέλει πόλεμος καὶ κήδε’ Ἀχαιῶν.	-uu -u u- uu- - -u u--	dactylic hexameter	masculine penthemimeral, hepthemimeral
αἰνῶς γὰρ Δαναῶν περιδείδια, οὐδέ μοι ἦτορ	-- - uu- uu-uu -u u --	dactylic hexameter	masculine penthemimeral, trithemimeral
ἔμπεδον, ἀλλ’ ἀλαλύκτημαι, κραδίη δέ μοι ἔξω	-uu - uu--- uu- u u --	dactylic hexameter	hepthemimeral, trithemimeral
στηθέων ἐκθρῴσκει, τρομέει δ’ὑπὸ φαίδιμα γυῖα.	-- --- uu- uu -uu --	dactylic hexameter	masculine penthemimeral, hepthemimeral
ἀλλ’ εἴ τι δραίνεις, ἐπεὶ οὐδὲ σέ γ’ὕπνος ἱκάνει,	- - - -- uu -u u -u u--	dactylic hexameter	masculine penthemimeral, trithemimeral
δεῦρ’ ἐς τοὺς φύλακας καταβήομεν, ὄφρα ἴδωμεν	- - - uu- uu-uu -u u--	dactylic hexameter	masculine penthemimeral, trithemimeral
μὴ τοὶ μὲν καμάτῳ ἀδηκότες ἠδὲ καὶ ὕπνῳ	- - - uu- --uu -u u --	dactylic hexameter	masculine penthemimeral, trithemimeral
κοιμήσωνται, ἀτὰρ φυλακῆς ἐπὶ πάγχυ λάθωνται.	---u u- uu- uu -u u--	dactylic hexameter	masculine penthemimeral, hepthemimeral
δυσμενέες δ’ἄνδρες σχεδὸν εἵαται· οὐδέ τι ἴδμεν	-uu- -- uu -uu -u u --	dactylic hexameter	masculine penthemimeral, trithemimeral
μή πως καὶ διὰ νύκτα μενοινήσωσι μάχεσθαι.	- - - uu -u u---u u--	dactylic hexameter	feminine penthemimeral, trithemimeral
τὸν δ’ἠμείβετ’ ἔπειτα Γερήνιος ἱππότα Νέστωρ·	- --u u-u u-uu -uu --	dactylic hexameter	feminine penthemimeral
Ἀτρεΐδη κύδιστε ἄναξ ἀνδρῶν Ἀγάμεμνον	-uu- --u u- -- uu--	dactylic hexameter	feminine penthemimeral, hepthemimeral, trithemimeral
οὔ θην Ἕκτορι πάντα νοήματα μητίετα Ζεὺς	- - -uu -u u-uu -uu- -	dactylic hexameter	feminine penthemimeral
ἐκτελέει, ὅσα πού νυν ἐέλπεται· ἀλλά μιν οἴω	-uu- uu - u u-uu -u u --	dactylic hexameter	masculine penthemimeral, trithemimeral
κήδεσι μοχθήσειν καὶ πλείοσιν, εἴ κεν Ἀχιλλεὺς	-uu --- - -uu - u u--	dactylic hexameter	masculine penthemimeral
ἐκ χόλου ἀργαλέοιο μεταστρέψῃ φίλον ἦτορ.	- uu -uu-u u--- uu --	dactylic hexameter	feminine penthemimeral
σοὶ δὲ μάλ’ ἕψομ’ ἐγώ· ποτὶ δ’αὖ καὶ ἐγείρομεν ἄλλους	- u u -u u- uu - u u-uu --	dactylic hexameter	masculine penthemimeral, hepthemimeral
ἠμὲν Τυδεΐδην δουρὶ κλυτὸν ἠδ’ Ὀδυσῆα	-- -uu- -- uu - uu--	dactylic hexameter	masculine penthemimeral, hepthemimeral
ἠδ’ Αἴαντα ταχὺν καὶ Φυλέος ἄλκιμον υἱόν.	- --u u- - -uu -uu --	dactylic hexameter	masculine penthemimeral
ἀλλ’ εἴ τις καὶ τούσδε μετοιχόμενος καλέσειεν	- - - - -u u-uu- uu--	dactylic hexameter	feminine penthemimeral, trithemimeral
ἀντίθεόν τ’Αἴαντα καὶ Ἰδομενῆα ἄνακτα·	-uu- --u u -uu-u u--	dactylic hexameter	feminine penthemimeral, trithemimeral
τῶν γὰρ νῆες ἔασιν ἑκαστάτω, οὐδὲ μάλ’ ἐγγύς.	- - -u u-u u-uu -u u --	dactylic hexameter	feminine penthemimeral
ἀλλὰ φίλον περ ἐόντα καὶ αἰδοῖον Μενέλαον	-u u- u u-u u --- uu--	dactylic hexameter	feminine penthemimeral, trithemimeral
νεικέσω, εἴ πέρ μοι νεμεσήσεαι, οὐδ’ ἐπικεύσω	-uu - - - uu-uu - uu--	dactylic hexameter	masculine penthemimeral, trithemimeral
ὡς εὕδει, σοὶ δ’οἴῳ ἐπέτρεψεν πονέεσθαι.	- -- - -u u--- uu--	dactylic hexameter	feminine penthemimeral, trithemimeral
νῦν ὄφελεν κατὰ πάντας ἀριστῆας πονέεσθαι	- uu- uu -u u--- uu--	dactylic hexameter	feminine penthemimeral, trithemimeral
λισσόμενος· χρειὼ γὰρ ἱκάνεται οὐκέτ’ ἀνεκτός.	-uu- -- u u-uu -u u--	dactylic hexameter	masculine penthemimeral, trithemimeral
τὸν δ’αὖτε προσέειπεν ἄναξ ἀνδρῶν Ἀγαμέμνων·	- -- uu-u u- -- uu--	dactylic hexameter	feminine penthemimeral, hepthemimeral, trithemimeral
ὦ γέρον ἄλλοτε μέν σε καὶ αἰτιάασθαι ἄνωγα·	- uu -uu - u u -uu-u u--	dactylic hexameter	masculine penthemimeral
πολλάκι γὰρ μεθιεῖ τε καὶ οὐκ ἐθέλει πονέεσθαι	-uu - uu- u u - uu- uu--	dactylic hexameter	masculine penthemimeral, hepthemimeral, trithemimeral
οὔτ’ ὄκνῳ εἴκων οὔτ’ ἀφραδίῃσι νόοιο,	- -- -- - -uu-u u--	dactylic hexameter	masculine penthemimeral, trithemimeral
ἀλλ’ ἐμέ τ’εἰσορόων καὶ ἐμὴν ποτιδέγμενος ὁρμήν.	- uu -uu- u u- uu-uu --	dactylic hexameter	masculine penthemimeral, hepthemimeral
νῦν δ’ἐμέο πρότερος μάλ’ ἐπέγρετο καί μοι ἐπέστη·	- uu- uu- u u-uu - u u--	dactylic hexameter	masculine penthemimeral, trithemimeral
τὸν μὲν ἐγὼ προέηκα καλήμεναι οὓς σὺ μεταλλᾷς.	- u u- uu-u u-uu - u u--	dactylic hexameter	feminine penthemimeral, trithemimeral
ἀλλ’ ἴομεν· κείνους δὲ κιχησόμεθα πρὸ πυλάων	- uu- -- u u-uu- u u--	dactylic hexameter	masculine penthemimeral, trithemimeral
ἐν φυλάκεσσ’, ἵνα γάρ σφιν ἐπέφραδον ἠγερέθεσθαι.	- uu- uu - u u-uu -uu--	dactylic hexameter	masculine penthemimeral, trithemimeral
τὸν δ’ἠμείβετ’ ἔπειτα Γερήνιος ἱππότα Νέστωρ·	- --u u-u u-uu -uu --	dactylic hexameter	feminine penthemimeral
οὕτως οὔ τίς οἱ νεμεσήσεται οὐδ’ ἀπιθήσει	-- - - - uu-uu - uu--	dactylic hexameter	masculine penthemimeral, trithemimeral
Ἀργείων, ὅτε κέν τιν’ ἐποτρύνῃ καὶ ἀνώγῃ.	--- uu - u u--- u u--	dactylic hexameter	masculine penthemimeral, trithemimeral
ὣς εἰπὼν ἔνδυνε περὶ στήθεσσι χιτῶνα,	- -- --u u- --u u--	dactylic hexameter	feminine penthemimeral, hepthemimeral, trithemimeral
ποσσὶ δ’ὑπὸ λιπαροῖσιν ἐδήσατο καλὰ πέδιλα,	-u u- uu-u u-uu -u u--	dactylic hexameter	feminine penthemimeral, trithemimeral
ἀμφὶ δ’ἄρα χλαῖναν περονήσατο φοινικόεσσαν	-u u- -- uu-uu -uu--	dactylic hexameter	masculine penthemimeral, trithemimeral
διπλῆν ἐκταδίην, οὔλη δ’ἐπενήνοθε λάχνη.	-- -uu- -- uu-uu --	dactylic hexameter	masculine penthemimeral, hepthemimeral
εἵλετο δ’ἄλκιμον ἔγχος ἀκαχμένον ὀξέϊ χαλκῷ,	-uu -uu -u u-uu -uu --	dactylic hexameter	feminine penthemimeral
βῆ δ’ἰέναι κατὰ νῆας Ἀχαιῶν χαλκοχιτώνων.	- uu- uu -u u-- -uu--	dactylic hexameter	feminine penthemimeral, trithemimeral
πρῶτον ἔπειτ’ Ὀδυσῆα Διὶ μῆτιν ἀτάλαντον	-u u- uu-u u- -- uu--	dactylic hexameter	feminine penthemimeral, hepthemimeral, trithemimeral
ἐξ ὕπνου ἀνέγειρε Γερήνιος ἱππότα Νέστωρ	- -- uu-u u-uu -uu --	dactylic hexameter	feminine penthemimeral, trithemimeral
φθεγξάμενος· τὸν δ’αἶψα περὶ φρένας ἤλυθ’ ἰωή,	-uu- - -u u- uu -u u--	dactylic hexameter	feminine penthemimeral, hepthemimeral, trithemimeral
ἐκ δ’ἦλθε κλισίης καί σφεας πρὸς μῦθον ἔειπε·	- -- uu- - - - -u u--	dactylic hexameter	masculine penthemimeral, hepthemimeral, trithemimeral
τίφθ’ οὕτω κατὰ νῆας ἀνὰ στρατὸν οἶοι ἀλᾶσθε	- -- uu -u u- uu -u u--	dactylic hexameter	feminine penthemimeral, hepthemimeral, trithemimeral
νύκτα δι’ ἀμβροσίην, ὅ τι δὴ χρειὼ τόσον ἵκει;	-u u -uu- u u - -- uu --	dactylic hexameter	masculine penthemimeral, hepthemimeral
τὸν δ’ἠμείβετ’ ἔπειτα Γερήνιος ἱππότα Νέστωρ·	- --u u-u u-uu -uu --	dactylic hexameter	feminine penthemimeral
διογενὲς Λαερτιάδη πολυμήχαν’ Ὀδυσσεῦ	-uu- --uu- uu-u u--	dactylic hexameter	hepthemimeral, trithemimeral
μὴ νεμέσα· τοῖον γὰρ ἄχος βεβίηκεν Ἀχαιούς.	- uu- -- u u- uu-u u--	dactylic hexameter	masculine penthemimeral, hepthemimeral, trithemimeral
ἀλλ’ ἕπε’, ὄφρα καὶ ἄλλον ἐγείρομεν ὅν τ’ἐπέοικε	- uu -u u -u u-uu - uu--	dactylic hexameter	feminine penthemimeral
βουλὰς βουλεύειν, ἢ φευγέμεν ἠὲ μάχεσθαι.	-- --- - -uu -u u--	dactylic hexameter	masculine penthemimeral
ὣς φάθ’, ὃ δὲ κλισίην δὲ κιὼν πολύμητις Ὀδυσσεὺς	- u u - uu- u u- uu-u u--	dactylic hexameter	masculine penthemimeral, hepthemimeral, trithemimeral
ποικίλον ἀμφ’ ὤμοισι σάκος θέτο, βῆ δὲ μετ’ αὐτούς.	-uu - --u u- uu - u u --	dactylic hexameter	feminine penthemimeral, hepthemimeral, trithemimeral
βὰν δ’ἐπὶ Τυδεΐδην Διομήδεα· τὸν δὲ κίχανον	- uu -uu- uu-uu - u u--	dactylic hexameter	masculine penthemimeral
ἐκτὸς ἀπὸ κλισίης σὺν τεύχεσιν· ἀμφὶ δ’ἑταῖροι	-u u- uu- - -uu -u u--	dactylic hexameter	masculine penthemimeral, trithemimeral
εὗδον, ὑπὸ κρασὶν δ’ἔχον ἀσπίδας· ἔγχεα δέ σφιν	-u u- -- uu -uu -uu - -	dactylic hexameter	masculine penthemimeral, trithemimeral
ὄρθ’ ἐπὶ σαυρωτῆρος ἐλήλατο, τῆλε δὲ χαλκὸς	- uu ---u u-uu -u u --	dactylic hexameter	feminine penthemimeral
λάμφ’ ὥς τε στεροπὴ πατρὸς Διός· αὐτὰρ ὅ γ’ἥρως	- - - uu- -- uu -u u --	dactylic hexameter	masculine penthemimeral, hepthemimeral, trithemimeral
εὗδ’, ὑπὸ δ’ἔστρωτο ῥινὸν βοὸς ἀγραύλοιο,	- uu --- -- uu ----	dactylic hexameter	masculine penthemimeral, hepthemimeral
αὐτὰρ ὑπὸ κράτεσφι τάπης τετάνυστο φαεινός.	-u u- --u u- uu-u u--	dactylic hexameter	feminine penthemimeral, hepthemimeral, trithemimeral
τὸν παρστὰς ἀνέγειρε Γερήνιος ἱππότα Νέστωρ,	- -- uu-u u-uu -uu --	dactylic hexameter	feminine penthemimeral, trithemimeral
λὰξ ποδὶ κινήσας, ὄτρυνέ τε νείκεσέ τ’ἄντην·	- uu --- --u u -uu --	dactylic hexameter	masculine penthemimeral
ἔγρεο Τυδέος υἱέ· τί πάννυχον ὕπνον ἀωτεῖς;	-uu -uu -u u -uu -u u--	dactylic hexameter	feminine penthemimeral
οὐκ ἀΐεις ὡς Τρῶες ἐπὶ θρωσμῷ πεδίοιο	- uu- - -u u- -- uu--	dactylic hexameter	feminine penthemimeral, hepthemimeral, trithemimeral
εἵαται ἄγχι νεῶν, ὀλίγος δ’ἔτι χῶρος ἐρύκει;	-uu -u u- uu- uu -u u--	dactylic hexameter	masculine penthemimeral, hepthemimeral
ὣς φάθ’, ὃ δ’ἐξ ὕπνοιο μάλα κραιπνῶς ἀνόρουσε,	- u u - --u u- -- uu--	dactylic hexameter	feminine penthemimeral, hepthemimeral, trithemimeral
καί μιν φωνήσας ἔπεα πτερόεντα προσηύδα·	- - --- uu- uu-u u--	dactylic hexameter	masculine penthemimeral, hepthemimeral
σχέτλιός ἐσσι γεραιέ· σὺ μὲν πόνου οὔ ποτε λήγεις.	-uu -u u-u u - uu - uu --	dactylic hexameter	feminine penthemimeral, hepthemimeral
οὔ νυ καὶ ἄλλοι ἔασι νεώτεροι υἷες Ἀχαιῶν	- u u -u u-u u-uu -u u--	dactylic hexameter	feminine penthemimeral
οἵ κεν ἔπειτα ἕκαστον ἐγείρειαν βασιλήων	- u u-u u-u u--- uu--	dactylic hexameter	feminine penthemimeral
πάντῃ ἐποιχόμενοι; σὺ δ’ἀμήχανός ἐσσι γεραιέ.	-u u-uu- u u-uu -u u--	dactylic hexameter	masculine penthemimeral
τὸν δ’αὖτε προσέειπε Γερήνιος ἱππότα Νέστωρ·	- -- uu-u u-uu -uu --	dactylic hexameter	feminine penthemimeral, trithemimeral
ναὶ δὴ ταῦτά γε πάντα φίλος κατὰ μοῖραν ἔειπες.	- - -u u -u u- uu -u u--	dactylic hexameter	feminine penthemimeral, hepthemimeral
εἰσὶν μέν μοι παῖδες ἀμύμονες, εἰσὶ δὲ λαοὶ	-- - - -u u-uu -u u --	dactylic hexameter	feminine penthemimeral, trithemimeral
καὶ πολέες, τῶν κέν τις ἐποιχόμενος καλέσειεν·	- uu- - - u u-uu- uu--	dactylic hexameter	masculine penthemimeral, trithemimeral
ἀλλὰ μάλα μεγάλη χρειὼ βεβίηκεν Ἀχαιούς.	-u u- uu- -- uu-u u--	dactylic hexameter	masculine penthemimeral, hepthemimeral, trithemimeral
νῦν γὰρ δὴ πάντεσσιν ἐπὶ ξυροῦ ἵσταται ἀκμῆς	- - - --u u- uu -uu --	dactylic hexameter	feminine penthemimeral, hepthemimeral, trithemimeral
ἢ μάλα λυγρὸς ὄλεθρος Ἀχαιοῖς ἠὲ βιῶναι.	- uu -u u-u u-- -u u--	dactylic hexameter	feminine penthemimeral
ἀλλ’ ἴθι νῦν Αἴαντα ταχὺν καὶ Φυλέος υἱὸν	- uu - --u u- - -uu --	dactylic hexameter	feminine penthemimeral, hepthemimeral, trithemimeral
ἄνστησον· σὺ γάρ ἐσσι νεώτερος· εἴ μ’ἐλεαίρεις.	--- u u -u u-uu - uu--	dactylic hexameter	feminine penthemimeral, trithemimeral
ὣς φάθ’, ὃ δ’ἀμφ’ ὤμοισιν ἑέσσατο δέρμα λέοντος	- u u - --u u-uu -u u--	dactylic hexameter	feminine penthemimeral, trithemimeral
αἴθωνος μεγάλοιο ποδηνεκές, εἵλετο δ’ἔγχος.	--- uu-u u-uu -uu --	dactylic hexameter	feminine penthemimeral, trithemimeral
βῆ δ’ἰέναι, τοὺς δ’ἔνθεν ἀναστήσας ἄγεν ἥρως.	- uu- - -u u--- uu --	dactylic hexameter	feminine penthemimeral, trithemimeral
οἳ δ’ὅτε δὴ φυλάκεσσιν ἐν ἀγρομένοισιν ἔμιχθεν,	- uu - uu-u u -uu-u u--	dactylic hexameter	feminine penthemimeral, trithemimeral
οὐδὲ μὲν εὕδοντας φυλάκων ἡγήτορας εὗρον,	-u u --- uu- --uu --	dactylic hexameter	masculine penthemimeral, hepthemimeral
ἀλλ’ ἐγρηγορτὶ σὺν τεύχεσιν εἵατο πάντες.	- ---- - -uu -uu --	dactylic hexameter	masculine penthemimeral
ὡς δὲ κύνες περὶ μῆλα δυσωρήσωνται ἐν αὐλῇ	- u u- uu -u u---u u --	dactylic hexameter	feminine penthemimeral, trithemimeral
θηρὸς ἀκούσαντες κρατερόφρονος, ὅς τε καθ’ ὕλην	-u u--- uu-uu - u u --	dactylic hexameter	masculine penthemimeral
ἔρχηται δι’ ὄρεσφι· πολὺς δ’ὀρυμαγδὸς ἐπ’ αὐτῷ	--- u u-u u- uu-u u --	dactylic hexameter	feminine penthemimeral, hepthemimeral, trithemimeral
ἀνδρῶν ἠδὲ κυνῶν, ἀπό τέ σφισιν ὕπνος ὄλωλεν·	-- -u u- uu - uu -u u--	dactylic hexameter	masculine penthemimeral, hepthemimeral
ὣς τῶν νήδυμος ὕπνος ἀπὸ βλεφάροιιν ὀλώλει	- - -uu -u u- uu-u u--	dactylic hexameter	feminine penthemimeral, hepthemimeral
νύκτα φυλασσομένοισι κακήν· πεδίον δὲ γὰρ αἰεὶ	-u u-uu-u u- uu- u u --	dactylic hexameter	feminine penthemimeral, hepthemimeral
τετράφαθ’, ὁππότ’ ἐπὶ Τρώων ἀΐοιεν ἰόντων.	-uu -u u- -- uu-u u--	dactylic hexameter	masculine penthemimeral, hepthemimeral
τοὺς δ’ὃ γέρων γήθησεν ἰδὼν θάρσυνέ τε μύθῳ	- u u- --u u- --u u --	dactylic hexameter	feminine penthemimeral, hepthemimeral, trithemimeral
καί σφεας φωνήσας ἔπεα πτερόεντα προσηύδα·	- - --- uu- uu-u u--	dactylic hexameter	masculine penthemimeral, hepthemimeral
οὕτω νῦν φίλα τέκνα φυλάσσετε· μηδέ τιν’ ὕπνος	-- - uu -u u-uu -u u --	dactylic hexameter	feminine penthemimeral, trithemimeral
αἱρείτω, μὴ χάρμα γενώμεθα δυσμενέεσσιν.	--- - -u u-uu -uu--	dactylic hexameter	feminine penthemimeral, trithemimeral
ὣς εἰπὼν τάφροιο διέσσυτο· τοὶ δ’ἅμ’ ἕποντο	- -- --u u-uu - u u--	dactylic hexameter	feminine penthemimeral, trithemimeral
Ἀργείων βασιλῆες ὅσοι κεκλήατο βουλήν.	--- uu-u u- --uu --	dactylic hexameter	feminine penthemimeral, hepthemimeral, trithemimeral
τοῖς δ’ἅμα Μηριόνης καὶ Νέστορος ἀγλαὸς υἱὸς	- uu -uu- - -uu -uu --	dactylic hexameter	masculine penthemimeral
ἤϊσαν· αὐτοὶ γὰρ κάλεον συμμητιάασθαι.	-uu -- - uu- --uu--	dactylic hexameter	masculine penthemimeral, hepthemimeral
τάφρον δ’ἐκδιαβάντες ὀρυκτὴν ἑδριόωντο	-- -uu-u u-- -uu--	dactylic hexameter	feminine penthemimeral
ἐν καθαρῷ, ὅθι δὴ νεκύων διεφαίνετο χῶρος	- uu- uu - uu- uu-uu --	dactylic hexameter	masculine penthemimeral, hepthemimeral, trithemimeral
πιπτόντων· ὅθεν αὖτις ἀπετράπετ’ ὄβριμος Ἕκτωρ	--- uu -u u-uu -uu --	dactylic hexameter	feminine penthemimeral, trithemimeral
ὀλλὺς Ἀργείους, ὅτε δὴ περὶ νὺξ ἐκάλυψεν.	-- --- uu - uu - uu--	dactylic hexameter	masculine penthemimeral, hepthemimeral
ἔνθα καθεζόμενοι ἔπε’ ἀλλήλοισι πίφαυσκον·	-u u-uu- uu ---u u--	dactylic hexameter	masculine penthemimeral
τοῖσι δὲ μύθων ἦρχε Γερήνιος ἱππότα Νέστωρ·	-u u -- -u u-uu -uu --	dactylic hexameter	feminine penthemimeral
ὦ φίλοι οὐκ ἂν δή τις ἀνὴρ πεπίθοιθ’ ἑῷ αὐτοῦ	- uu - - - u u- uu- uu --	dactylic hexameter	masculine penthemimeral, hepthemimeral, trithemimeral
θυμῷ τολμήεντι μετὰ Τρῶας μεγαθύμους	-- ---u u- -- uu--	dactylic hexameter	feminine penthemimeral, hepthemimeral
ἐλθεῖν, εἴ τινά που δηίων ἕλοι ἐσχατόωντα,	-- - uu - -- uu -uu--	dactylic hexameter	masculine penthemimeral, hepthemimeral, trithemimeral
ἤ τινά που καὶ φῆμιν ἐνὶ Τρώεσσι πύθοιτο,	- uu - - -u u- --u u--	dactylic hexameter	feminine penthemimeral, hepthemimeral, trithemimeral
ἅσσά τε μητιόωσι μετὰ σφίσιν, ἢ μεμάασιν	-u u -uu-u u- uu - uu--	dactylic hexameter	feminine penthemimeral, hepthemimeral
αὖθι μένειν παρὰ νηυσὶν ἀπόπροθεν, ἦε πόλιν δὲ	-u u- uu -u u-uu -u u- -	dactylic hexameter	feminine penthemimeral, trithemimeral
ἂψ ἀναχωρήσουσιν, ἐπεὶ δαμάσαντό γ’Ἀχαιούς.	- uu---u u- uu-u u--	dactylic hexameter	feminine penthemimeral, hepthemimeral
ταῦτά κε πάντα πύθοιτο, καὶ ἂψ εἰς ἡμέας ἔλθοι	-u u -u u-u u - - -uu --	dactylic hexameter	feminine penthemimeral, hepthemimeral
ἀσκηθής· μέγα κέν οἱ ὑπουράνιον κλέος εἴη	--- uu - u u-uu- uu --	dactylic hexameter	masculine penthemimeral, trithemimeral
πάντας ἐπ’ ἀνθρώπους, καί οἱ δόσις ἔσσεται ἐσθλή·	-u u --- - - uu -uu --	dactylic hexameter	masculine penthemimeral, hepthemimeral
ὅσσοι γὰρ νήεσσιν ἐπικρατέουσιν ἄριστοι	-- - --u u-uu-u u--	dactylic hexameter	feminine penthemimeral, trithemimeral
τῶν πάντων οἱ ἕκαστος ὄϊν δώσουσι μέλαιναν	- -- u u-u u- --u u--	dactylic hexameter	feminine penthemimeral, hepthemimeral, trithemimeral
θῆλυν ὑπόρρηνον· τῇ μὲν κτέρας οὐδὲν ὁμοῖον,	-u u--- - - uu -u u--	dactylic hexameter	masculine penthemimeral, hepthemimeral
αἰεὶ δ’ἐν δαίτῃσι καὶ εἰλαπίνῃσι παρέσται.	-- - --u u -uu-u u--	dactylic hexameter	feminine penthemimeral, trithemimeral
ὣς ἔφαθ’, οἳ δ’ἄρα πάντες ἀκὴν ἐγένοντο σιωπῇ.	- uu - uu -u u- uu-u u--	dactylic hexameter	feminine penthemimeral, hepthemimeral, trithemimeral
τοῖσι δὲ καὶ μετέειπε βοὴν ἀγαθὸς Διομήδης·	-u u - uu-u u- uu- uu--	dactylic hexameter	feminine penthemimeral, hepthemimeral, trithemimeral
Νέστορ ἔμ’ ὀτρύνει κραδίη καὶ θυμὸς ἀγήνωρ	-u u --- uu- - -u u--	dactylic hexameter	masculine penthemimeral, hepthemimeral
ἀνδρῶν δυσμενέων δῦναι στρατὸν ἐγγὺς ἐόντων	-- -uu- -- uu -u u--	dactylic hexameter	masculine penthemimeral, hepthemimeral
Τρώων· ἀλλ’ εἴ τίς μοι ἀνὴρ ἅμ’ ἕποιτο καὶ ἄλλος	-- - - - u u- u u-u u --	dactylic hexameter	masculine penthemimeral, hepthemimeral, trithemimeral
μᾶλλον θαλπωρὴ καὶ θαρσαλεώτερον ἔσται.	-- --- - -uu-uu --	dactylic hexameter	masculine penthemimeral
σύν τε δύ’ ἐρχομένω καί τε πρὸ ὃ τοῦ ἐνόησεν	- u u -uu- - - u u - uu--	dactylic hexameter	masculine penthemimeral, hepthemimeral
ὅππως κέρδος ἔῃ· μοῦνος δ’εἴ πέρ τε νοήσῃ	-- -u u- -- - - u u--	dactylic hexameter	masculine penthemimeral, hepthemimeral
ἀλλά τέ οἱ βράσσων τε νόος, λεπτὴ δέ τε μῆτις.	-u u - -- u u- -- u u --	dactylic hexameter	masculine penthemimeral, hepthemimeral, trithemimeral
ὣς ἔφαθ’, οἳ δ’ἔθελον Διομήδεϊ πολλοὶ ἕπεσθαι.	- uu - uu- uu-uu -u u--	dactylic hexameter	masculine penthemimeral, trithemimeral
ἠθελέτην Αἴαντε δύω θεράποντες Ἄρηος,	-uu- --u u- uu-u u--	dactylic hexameter	feminine penthemimeral, hepthemimeral, trithemimeral
ἤθελε Μηριόνης, μάλα δ’ἤθελε Νέστορος υἱός,	-uu -uu- uu -uu -uu --	dactylic hexameter	masculine penthemimeral
ἤθελε δ’Ἀτρεΐδης δουρικλειτὸς Μενέλαος,	-uu -uu- ---- uu--	dactylic hexameter	masculine penthemimeral
ἤθελε δ’ὁ τλήμων Ὀδυσεὺς καταδῦναι ὅμιλον	-uu - -- uu- uu-u u--	dactylic hexameter	masculine penthemimeral, hepthemimeral, trithemimeral
Τρώων· αἰεὶ γάρ οἱ ἐνὶ φρεσὶ θυμὸς ἐτόλμα.	-- -- - u u- uu -u u--	dactylic hexameter	masculine penthemimeral, hepthemimeral
τοῖσι δὲ καὶ μετέειπεν ἄναξ ἀνδρῶν Ἀγαμέμνων·	-u u - uu-u u- -- uu--	dactylic hexameter	feminine penthemimeral, hepthemimeral, trithemimeral
Τυδεΐδη Διόμηδες ἐμῷ κεχαρισμένε θυμῷ	-uu- uu-u u- uu-uu --	dactylic hexameter	feminine penthemimeral, hepthemimeral, trithemimeral
τὸν μὲν δὴ ἕταρόν γ’αἱρήσεαι ὅν κ’ἐθέλῃσθα,	- - - uu- --uu - uu--	dactylic hexameter	masculine penthemimeral, trithemimeral
φαινομένων τὸν ἄριστον, ἐπεὶ μεμάασί γε πολλοί.	-uu- u u-u u- uu-u u --	dactylic hexameter	feminine penthemimeral, hepthemimeral, trithemimeral
μηδὲ σύ γ’αἰδόμενος σῇσι φρεσὶ τὸν μὲν ἀρείω	-u u -uu- -- uu - u u--	dactylic hexameter	masculine penthemimeral, hepthemimeral
καλλείπειν, σὺ δὲ χείρον’ ὀπάσσεαι αἰδοῖ εἴκων	--- u u -u u-uu -- --	dactylic hexameter	feminine penthemimeral, trithemimeral
ἐς γενεὴν ὁρόων, μηδ’ εἰ βασιλεύτερός ἐστιν.	- uu- uu- - - uu-uu --	dactylic hexameter	masculine penthemimeral, hepthemimeral, trithemimeral
ὣς ἔφατ’, ἔδεισεν δὲ περὶ ξανθῷ Μενελάῳ.	- uu --- u u- -- uu--	dactylic hexameter	masculine penthemimeral, hepthemimeral
τοῖς δ’αὖτις μετέειπε βοὴν ἀγαθὸς Διομήδης·	- -- uu-u u- uu- uu--	dactylic hexameter	feminine penthemimeral, hepthemimeral, trithemimeral
εἰ μὲν δὴ ἕταρόν γε κελεύετέ μ’αὐτὸν ἑλέσθαι,	- - - uu- u u-uu -u u--	dactylic hexameter	masculine penthemimeral, trithemimeral
πῶς ἂν ἔπειτ’ Ὀδυσῆος ἐγὼ θείοιο λαθοίμην,	- u u- uu-u u- --u u--	dactylic hexameter	feminine penthemimeral, hepthemimeral, trithemimeral
οὗ πέρι μὲν πρόφρων κραδίη καὶ θυμὸς ἀγήνωρ	- uu - -- uu- - -u u--	dactylic hexameter	masculine penthemimeral, hepthemimeral, trithemimeral
ἐν πάντεσσι πόνοισι, φιλεῖ δέ ἑ Παλλὰς Ἀθήνη.	- --u u-u u- u u -u u--	dactylic hexameter	feminine penthemimeral, hepthemimeral
τούτου γ’ἑσπομένοιο καὶ ἐκ πυρὸς αἰθομένοιο	-- -uu-u u - uu -uu--	dactylic hexameter	feminine penthemimeral, hepthemimeral
ἄμφω νοστήσαιμεν, ἐπεὶ περίοιδε νοῆσαι.	-- ---u u- uu-u u--	dactylic hexameter	feminine penthemimeral, hepthemimeral
τὸν δ’αὖτε προσέειπε πολύτλας δῖος Ὀδυσσεύς·	- -- uu-u u-- -u u--	dactylic hexameter	feminine penthemimeral, trithemimeral
Τυδεΐδη μήτ’ ἄρ με μάλ’ αἴνεε μήτέ τι νείκει·	-uu- - - u u -uu -u u --	dactylic hexameter	masculine penthemimeral, trithemimeral
εἰδόσι γάρ τοι ταῦτα μετ’ Ἀργείοις ἀγορεύεις.	-uu - - -u u --- uu--	dactylic hexameter	feminine penthemimeral, trithemimeral
ἀλλ’ ἴομεν· μάλα γὰρ νὺξ ἄνεται, ἐγγύθι δ’ἠώς,	- uu- uu - - -uu -uu --	dactylic hexameter	masculine penthemimeral, trithemimeral
ἄστρα δὲ δὴ προβέβηκε, παροίχωκεν δὲ πλέων νὺξ	-u u - uu-u u--- - - -	dactylic hexameter	feminine penthemimeral, trithemimeral
τῶν δύο μοιράων, τριτάτη δ’ἔτι μοῖρα λέλειπται.	- uu --- uu- uu -u u--	dactylic hexameter	masculine penthemimeral, hepthemimeral
ὣς εἰπόνθ’ ὅπλοισιν ἔνι δεινοῖσιν ἐδύτην.	- -- --u u- --u u--	dactylic hexameter	feminine penthemimeral, hepthemimeral, trithemimeral
Τυδεΐδῃ μὲν δῶκε μενεπτόλεμος Θρασυμήδης	-uu- - -u u-uu- uu--	dactylic hexameter	feminine penthemimeral, trithemimeral
φάσγανον ἄμφηκες· τὸ δ’ἑὸν παρὰ νηῒ λέλειπτο·	-uu --- u u- uu -u u--	dactylic hexameter	masculine penthemimeral, hepthemimeral
καὶ σάκος· ἀμφὶ δέ οἱ κυνέην κεφαλῆφιν ἔθηκε	- uu -u u - uu- uu-u u--	dactylic hexameter	masculine penthemimeral, hepthemimeral
ταυρείην, ἄφαλόν τε καὶ ἄλλοφον, ἥ τε καταῖτυξ	--- uu- u u -uu - u u--	dactylic hexameter	masculine penthemimeral, trithemimeral
κέκληται, ῥύεται δὲ κάρη θαλερῶν αἰζηῶν.	--- uu- u u- uu- ---	dactylic hexameter	masculine penthemimeral, hepthemimeral, trithemimeral
Μηριόνης δ’Ὀδυσῆϊ δίδου βιὸν ἠδὲ φαρέτρην	-uu- uu-u u- uu -u u--	dactylic hexameter	feminine penthemimeral, hepthemimeral, trithemimeral
καὶ ξίφος, ἀμφὶ δέ οἱ κυνέην κεφαλῆφιν ἔθηκε	- uu -u u - uu- uu-u u--	dactylic hexameter	masculine penthemimeral, hepthemimeral
ῥινοῦ ποιητήν· πολέσιν δ’ἔντοσθεν ἱμᾶσιν	-- --- uu- --u u--	dactylic hexameter	masculine penthemimeral, hepthemimeral
ἐντέτατο στερεῶς· ἔκτοσθε δὲ λευκοὶ ὀδόντες	-uu- uu- --u u -u u--	dactylic hexameter	masculine penthemimeral, trithemimeral
ἀργιόδοντος ὑὸς θαμέες ἔχον ἔνθα καὶ ἔνθα	-uu-u u- uu- uu -u u --	dactylic hexameter	masculine penthemimeral, hepthemimeral
εὖ καὶ ἐπισταμένως· μέσσῃ δ’ἐνὶ πῖλος ἀρήρει.	- u u-uu- -- uu -u u--	dactylic hexameter	masculine penthemimeral, hepthemimeral
τήν ῥά ποτ’ ἐξ Ἐλεῶνος Ἀμύντορος Ὀρμενίδαο	- u u - uu-u u-uu -uu--	dactylic hexameter	feminine penthemimeral, trithemimeral
ἐξέλετ’ Αὐτόλυκος πυκινὸν δόμον ἀντιτορήσας,	-uu -uu- uu- uu -uu--	dactylic hexameter	masculine penthemimeral, hepthemimeral
Σκάνδειαν δ’ἄρα δῶκε Κυθηρίῳ Ἀμφιδάμαντι·	--- uu -u u-uu -uu--	dactylic hexameter	feminine penthemimeral, trithemimeral
Ἀμφιδάμας δὲ Μόλῳ δῶκε ξεινήϊον εἶναι,	-uu- u u- -- --uu --	dactylic hexameter	masculine penthemimeral, hepthemimeral, trithemimeral
αὐτὰρ ὃ Μηριόνῃ δῶκεν ᾧ παιδὶ φορῆναι·	-u u -uu- -- - -u u--	dactylic hexameter	masculine penthemimeral, hepthemimeral
δὴ τότ’ Ὀδυσσῆος πύκασεν κάρη ἀμφιτεθεῖσα.	- u u--- uu- uu -uu--	dactylic hexameter	masculine penthemimeral, hepthemimeral
τὼ δ’ἐπεὶ οὖν ὅπλοισιν ἔνι δεινοῖσιν ἐδύτην,	- uu - --u u- --u u--	dactylic hexameter	feminine penthemimeral, hepthemimeral, trithemimeral
βάν ῥ’ἰέναι, λιπέτην δὲ κατ’ αὐτόθι πάντας ἀρίστους.	- uu- uu- u u -uu -u u--	dactylic hexameter	masculine penthemimeral, trithemimeral
τοῖσι δὲ δεξιὸν ἧκεν ἐρῳδιὸν ἐγγὺς ὁδοῖο	-u u -uu -u u-uu -u u--	dactylic hexameter	feminine penthemimeral
Παλλὰς Ἀθηναίη· τοὶ δ’οὐκ ἴδον ὀφθαλμοῖσι	-u u--- - - uu ----	dactylic hexameter	masculine penthemimeral, hepthemimeral
νύκτα δι’ ὀρφναίην, ἀλλὰ κλάγξαντος ἄκουσαν.	-u u --- -- --u u--	dactylic hexameter	masculine penthemimeral, hepthemimeral
χαῖρε δὲ τῷ ὄρνιθ’ Ὀδυσεύς, ἠρᾶτο δ’Ἀθήνῃ·	-u u - -- uu- --u u--	dactylic hexameter	masculine penthemimeral, hepthemimeral, trithemimeral
κλῦθί μευ αἰγιόχοιο Διὸς τέκος, ἥ τέ μοι αἰεὶ	-u u -uu-u u- uu - u u --	dactylic hexameter	feminine penthemimeral, hepthemimeral
ἐν πάντεσσι πόνοισι παρίστασαι, οὐδέ σε λήθω	- --u u-u u-uu -u u --	dactylic hexameter	feminine penthemimeral
κινύμενος· νῦν αὖτε μάλιστά με φῖλαι Ἀθήνη,	-uu- - -u u-u u -u u--	dactylic hexameter	feminine penthemimeral, trithemimeral
δὸς δὲ πάλιν ἐπὶ νῆας ἐϋκλεῖας ἀφικέσθαι	- u u- uu -u u--- uu--	dactylic hexameter	feminine penthemimeral, trithemimeral
ῥέξαντας μέγα ἔργον, ὅ κε Τρώεσσι μελήσῃ.	--- uu -u u - --u u--	dactylic hexameter	feminine penthemimeral, hepthemimeral, trithemimeral
δεύτερος αὖτ’ ἠρᾶτο βοὴν ἀγαθὸς Διομήδης·	-uu - --u u- uu- uu--	dactylic hexameter	feminine penthemimeral, hepthemimeral, trithemimeral
κέκλυθι νῦν καὶ ἐμεῖο Διὸς τέκος Ἀτρυτώνη·	-uu - u u-u u- uu ----	dactylic hexameter	feminine penthemimeral, hepthemimeral, trithemimeral
σπεῖό μοι ὡς ὅτε πατρὶ ἅμ’ ἕσπεο Τυδέϊ δίῳ	-u u - uu -u u -uu -uu --	dactylic hexameter	feminine penthemimeral, trithemimeral
ἐς Θήβας, ὅτε τε πρὸ Ἀχαιῶν ἄγγελος ᾔει.	- -- uu - u u-- -uu --	dactylic hexameter	masculine penthemimeral, trithemimeral
τοὺς δ’ἄρ’ ἐπ’ Ἀσωπῷ λίπε χαλκοχίτωνας Ἀχαιούς,	- u u --- uu -uu-u u--	dactylic hexameter	masculine penthemimeral
αὐτὰρ ὃ μειλίχιον μῦθον φέρε Καδμείοισι	-u u -uu- -- uu ----	dactylic hexameter	masculine penthemimeral, hepthemimeral
κεῖσ’· ἀτὰρ ἂψ ἀπιὼν μάλα μέρμερα μήσατο ἔργα	- uu - uu- uu -uu -uu --	dactylic hexameter	masculine penthemimeral, trithemimeral
σὺν σοὶ δῖα θεά, ὅτε οἱ πρόφρασσα παρέστης.	- - -u u- uu - --u u--	dactylic hexameter	masculine penthemimeral, hepthemimeral
ὣς νῦν μοι ἐθέλουσα παρίσταο καί με φύλασσε.	- - - uu-u u-uu - u u--	dactylic hexameter	feminine penthemimeral, trithemimeral
σοὶ δ’αὖ ἐγὼ ῥέξω βοῦν ἦνιν εὐρυμέτωπον	- u u- -- - -- -uu--	dactylic hexameter	masculine penthemimeral, trithemimeral
ἀδμήτην, ἣν οὔ πω ὑπὸ ζυγὸν ἤγαγεν ἀνήρ·	--- - - u u- uu -uu --	dactylic hexameter	masculine penthemimeral, hepthemimeral, trithemimeral
τήν τοι ἐγὼ ῥέξω χρυσὸν κέρασιν περιχεύας.	- u u- -- -- uu- uu--	dactylic hexameter	masculine penthemimeral, hepthemimeral, trithemimeral
ὣς ἔφαν εὐχόμενοι, τῶν δ’ἔκλυε Παλλὰς Ἀθήνη.	- uu -uu- - -uu -u u--	dactylic hexameter	masculine penthemimeral
οἳ δ’ἐπεὶ ἠρήσαντο Διὸς κούρῃ μεγάλοιο,	- uu ---u u- -- uu--	dactylic hexameter	feminine penthemimeral, hepthemimeral
βάν ῥ’ἴμεν ὥς τε λέοντε δύω διὰ νύκτα μέλαιναν	- uu - u u-u u- uu -u u--	dactylic hexameter	feminine penthemimeral, hepthemimeral, trithemimeral
ἂμ φόνον, ἂν νέκυας, διά τ’ἔντεα καὶ μέλαν αἷμα.	- uu - uu- uu -uu - uu --	dactylic hexameter	masculine penthemimeral, trithemimeral
οὐδὲ μὲν οὐδὲ Τρῶας ἀγήνορας εἴασεν Ἕκτωρ	-u u -- -u u-uu -uu --	dactylic hexameter	feminine penthemimeral
εὕδειν, ἀλλ’ ἄμυδις κικλήσκετο πάντας ἀρίστους,	-- - uu- --uu -u u--	dactylic hexameter	masculine penthemimeral, trithemimeral
ὅσσοι ἔσαν Τρώων ἡγήτορες ἠδὲ μέδοντες·	-u u- -- --uu -u u--	dactylic hexameter	masculine penthemimeral, trithemimeral
τοὺς ὅ γε συγκαλέσας πυκινὴν ἀρτύνετο βουλήν·	- u u -uu- uu- --uu --	dactylic hexameter	masculine penthemimeral, hepthemimeral
τίς κέν μοι τόδε ἔργον ὑποσχόμενος τελέσειε	- - - uu -u u-uu- uu--	dactylic hexameter	feminine penthemimeral, trithemimeral
δώρῳ ἔπι μεγάλῳ; μισθὸς δέ οἱ ἄρκιος ἔσται.	-u u- uu- -- u u -uu --	dactylic hexameter	masculine penthemimeral, hepthemimeral, trithemimeral
δώσω γὰρ δίφρόν τε δύω τ’ἐριαύχενας ἵππους	-- - -- u u- uu-uu --	dactylic hexameter	masculine penthemimeral, hepthemimeral, trithemimeral
οἵ κεν ἄριστοι ἔωσι θοῇς ἐπὶ νηυσὶν Ἀχαιῶν	- u u-u u-u u- uu -u u--	dactylic hexameter	feminine penthemimeral, hepthemimeral
ὅς τίς κε τλαίη, οἷ τ’αὐτῷ κῦδος ἄροιτο,	- - - -- - -- -u u--	dactylic hexameter	masculine penthemimeral, trithemimeral
νηῶν ὠκυπόρων σχεδὸν ἐλθέμεν, ἔκ τε πυθέσθαι	-- -uu- uu -uu - u u--	dactylic hexameter	masculine penthemimeral
ἠέ φυλάσσονται νῆες θοαὶ ὡς τὸ πάρος περ,	-u u--- -- uu - u u- -	dactylic hexameter	masculine penthemimeral, hepthemimeral
ἦ ἤδη χείρεσσιν ὑφ’ ἡμετέρῃσι δαμέντες	- -- --u u -uu-u u--	dactylic hexameter	feminine penthemimeral, trithemimeral
φύξιν βουλεύουσι μετὰ σφίσιν, οὐδ’ ἐθέλουσι	-- ---u u- uu - uu--	dactylic hexameter	feminine penthemimeral, hepthemimeral
νύκτα φυλασσέμεναι, καμάτῳ ἀδηκότες αἰνῷ.	-u u-uu- uu- --uu --	dactylic hexameter	masculine penthemimeral, hepthemimeral
ὣς ἔφαθ’, οἳ δ’ἄρα πάντες ἀκὴν ἐγένοντο σιωπῇ.	- uu - uu -u u- uu-u u--	dactylic hexameter	feminine penthemimeral, hepthemimeral, trithemimeral
ἦν δέ τις ἐν Τρώεσσι Δόλων Εὐμήδεος υἱὸς	- u u - --u u- --uu --	dactylic hexameter	feminine penthemimeral, hepthemimeral, trithemimeral
κήρυκος θείοιο πολύχρυσος πολύχαλκος,	--- --u u--- uu--	dactylic hexameter	feminine penthemimeral, trithemimeral
ὃς δή τοι εἶδος μὲν ἔην κακός, ἀλλὰ ποδώκης·	- - - -- u u- uu -u u--	dactylic hexameter	masculine penthemimeral, hepthemimeral, trithemimeral
αὐτὰρ ὃ μοῦνος ἔην μετὰ πέντε κασιγνήτῃσιν.	-u u -u u- uu -u u----	dactylic hexameter	masculine penthemimeral
ὅς ῥα τότε Τρωσίν τε καὶ Ἕκτορι μῦθον ἔειπεν·	- u u- -- u u -uu -u u--	dactylic hexameter	masculine penthemimeral, trithemimeral
Ἕκτορ ἔμ’ ὀτρύνει κραδίη καὶ θυμὸς ἀγήνωρ	-u u --- uu- - -u u--	dactylic hexameter	masculine penthemimeral, hepthemimeral
νηῶν ὠκυπόρων σχεδὸν ἐλθέμεν ἔκ τε πυθέσθαι.	-- -uu- uu -uu - u u--	dactylic hexameter	masculine penthemimeral
ἀλλ’ ἄγε μοι τὸ σκῆπτρον ἀνάσχεο, καί μοι ὄμοσσον	- uu - - -u u-uu - u u--	dactylic hexameter	feminine penthemimeral, trithemimeral
ἦ μὲν τοὺς ἵππους τε καὶ ἅρματα ποικίλα χαλκῷ	- - - -- u u -uu -uu --	dactylic hexameter	masculine penthemimeral, trithemimeral
δωσέμεν, οἳ φορέουσιν ἀμύμονα Πηλεΐωνα,	-uu - uu-u u-uu -uu--	dactylic hexameter	feminine penthemimeral, trithemimeral
σοὶ δ’ἐγὼ οὐχ ἅλιος σκοπὸς ἔσσομαι οὐδ’ ἀπὸ δόξης·	- uu - uu- uu -uu - uu --	dactylic hexameter	masculine penthemimeral, trithemimeral
τόφρα γὰρ ἐς στρατὸν εἶμι διαμπερὲς ὄφρ’ ἂν ἵκωμαι	-u u - uu -u u-uu - u u--	dactylic hexameter	feminine penthemimeral, trithemimeral
νῆ’ Ἀγαμεμνονέην, ὅθι που μέλλουσιν ἄριστοι	- uu-uu- uu - --u u--	dactylic hexameter	masculine penthemimeral, hepthemimeral
βουλὰς βουλεύειν ἢ φευγέμεν ἠὲ μάχεσθαι.	-- --- - -uu -u u--	dactylic hexameter	masculine penthemimeral
ὣς φάθ’, ὃ δ’ἐν χερσὶ σκῆπτρον λάβε καί οἱ ὄμοσσεν·	- u u - -- -- uu - u u--	dactylic hexameter	masculine penthemimeral, hepthemimeral, trithemimeral
ἴστω νῦν Ζεὺς αὐτὸς ἐρίγδουπος πόσις Ἥρης	-- - - -u u--- uu --	dactylic hexameter	feminine penthemimeral, trithemimeral
μὴ μὲν τοῖς ἵπποισιν ἀνὴρ ἐποχήσεται ἄλλος	- - - --u u- uu-uu --	dactylic hexameter	feminine penthemimeral, hepthemimeral, trithemimeral
Τρώων, ἀλλά σέ φημι διαμπερὲς ἀγλαϊεῖσθαι.	-- -u u -u u-uu -uu--	dactylic hexameter	feminine penthemimeral
ὣς φάτο καί ῥ’ἐπίορκον ἐπώμοσε, τὸν δ’ὀρόθυνεν·	- uu - uu-u u-uu - uu--	dactylic hexameter	feminine penthemimeral, trithemimeral
αὐτίκα δ’ἀμφ’ ὤμοισιν ἐβάλλετο καμπύλα τόξα,	-uu - --u u-uu -uu --	dactylic hexameter	feminine penthemimeral, trithemimeral
ἕσσατο δ’ἔκτοσθεν ῥινὸν πολιοῖο λύκοιο,	-uu --- -- uu-u u--	dactylic hexameter	masculine penthemimeral, hepthemimeral
κρατὶ δ’ἐπὶ κτιδέην κυνέην, ἕλε δ’ὀξὺν ἄκοντα,	-u u- uu- uu- uu -u u--	dactylic hexameter	masculine penthemimeral, hepthemimeral, trithemimeral
βῆ δ’ἰέναι προτὶ νῆας ἀπὸ στρατοῦ· οὐδ’ ἄρ’ ἔμελλεν	- uu- uu -u u- uu - u u--	dactylic hexameter	feminine penthemimeral, hepthemimeral, trithemimeral
ἐλθὼν ἐκ νηῶν ἂψ Ἕκτορι μῦθον ἀποίσειν.	-- - -- - -uu -u u--	dactylic hexameter	masculine penthemimeral, trithemimeral
ἀλλ’ ὅτε δή ῥ’ἵππων τε καὶ ἀνδρῶν κάλλιφ’ ὅμιλον,	- uu - -- u u -- -u u--	dactylic hexameter	masculine penthemimeral, trithemimeral
βῆ ῥ’ἀν’ ὁδὸν μεμαώς· τὸν δὲ φράσατο προσιόντα	- u u- uu- - - uu- uu--	dactylic hexameter	masculine penthemimeral, hepthemimeral, trithemimeral
διογενὴς Ὀδυσεύς, Διομήδεα δὲ προσέειπεν·	-uu- uu- uu-uu - uu--	dactylic hexameter	masculine penthemimeral, trithemimeral
οὗτός τις Διόμηδες ἀπὸ στρατοῦ ἔρχεται ἀνήρ,	-- - uu-u u- uu -uu --	dactylic hexameter	feminine penthemimeral, hepthemimeral, trithemimeral
οὐκ οἶδ’ ἢ νήεσσιν ἐπίσκοπος ἡμετέρῃσιν,	- - - --u u-uu -uu--	dactylic hexameter	feminine penthemimeral, trithemimeral
ἦ τινα συλήσων νεκύων κατατεθνηώτων.	- uu --- uu- -uu---	anapaestic	
ἀλλ’ ἐῶμέν μιν πρῶτα παρεξελθεῖν πεδίοιο	- -- - -u u--- uu--	dactylic hexameter	feminine penthemimeral, trithemimeral
τυτθόν· ἔπειτα δέ κ’αὐτὸν ἐπαΐξαντες ἕλοιμεν	-u u-u u -u u---u u--	dactylic hexameter	feminine penthemimeral
καρπαλίμως· εἰ δ’ἄμμε παραφθαίησι πόδεσσιν,	-uu- - -u u---u u--	dactylic hexameter	feminine penthemimeral, trithemimeral
αἰεί μιν ἐπὶ νῆας ἀπὸ στρατόφι προτιειλεῖν	-- - uu -u u- uu- uu--	dactylic hexameter	feminine penthemimeral, hepthemimeral, trithemimeral
ἔγχει ἐπαΐσσων, μή πως προτὶ ἄστυ ἀλύξῃ.	-u u--- - - uu -u u--	dactylic hexameter	masculine penthemimeral, hepthemimeral
ὣς ἄρα φωνήσαντε παρὲξ ὁδοῦ ἐν νεκύεσσι	- uu ---u u- uu - uu--	dactylic hexameter	feminine penthemimeral, hepthemimeral
κλινθήτην· ὃ δ’ἄρ’ ὦκα παρέδραμεν ἀφραδίῃσιν.	--- u u -u u-uu -uu--	dactylic hexameter	feminine penthemimeral, trithemimeral
ἀλλ’ ὅτε δή ῥ’ἀπέην ὅσσόν τ’ἐπὶ οὖρα πέλονται	- uu - uu- -- uu -u u--	dactylic hexameter	masculine penthemimeral, hepthemimeral, trithemimeral
ἡμιόνων· αἱ γάρ τε βοῶν προφερέστεραί εἰσιν	-uu- - - u u- uu-uu --	dactylic hexameter	masculine penthemimeral, hepthemimeral, trithemimeral
ἑλκέμεναι νειοῖο βαθείης πηκτὸν ἄροτρον·	-uu- --u u-- -u u--	dactylic hexameter	feminine penthemimeral, trithemimeral
τὼ μὲν ἐπεδραμέτην, ὃ δ’ἄρ’ ἔστη δοῦπον ἀκούσας.	- u u-uu- u u -- -u u--	dactylic hexameter	masculine penthemimeral
ἔλπετο γὰρ κατὰ θυμὸν ἀποστρέψοντας ἑταίρους	-uu - uu -u u---u u--	dactylic hexameter	feminine penthemimeral, trithemimeral
ἐκ Τρώων ἰέναι πάλιν Ἕκτορος ὀτρύναντος.	- -- uu- uu -uu ----	dactylic hexameter	masculine penthemimeral, trithemimeral
ἀλλ’ ὅτε δή ῥ’ἄπεσαν δουρηνεκὲς ἢ καὶ ἔλασσον,	- uu - uu- --uu - u u--	dactylic hexameter	masculine penthemimeral, trithemimeral
γνῶ ῥ’ἄνδρας δηίους, λαιψηρὰ δὲ γούνατ’ ἐνώμα	- -- -- --u u -u u--	dactylic hexameter	masculine penthemimeral, trithemimeral
φευγέμεναι· τοὶ δ’αἶψα διώκειν ὁρμήθησαν.	-uu- - -u u-- ----	dactylic hexameter	feminine penthemimeral, trithemimeral
ὡς δ’ὅτε καρχαρόδοντε δύω κύνε εἰδότε θήρης	- uu -uu-u u- uu -uu --	dactylic hexameter	feminine penthemimeral, hepthemimeral
ἢ κεμάδ’ ἠὲ λαγωὸν ἐπείγετον ἐμμενὲς αἰεὶ	- uu -u u-u u-uu -uu --	dactylic hexameter	feminine penthemimeral
χῶρον ἀν’ ὑλήενθ’, ὃ δέ τε προθέῃσι μεμηκώς,	-u u --- u u - uu-u u--	dactylic hexameter	masculine penthemimeral, hepthemimeral
ὣς τὸν Τυδεΐδης ἠδ’ ὃ πτολίπορθος Ὀδυσσεὺς	- - -uu- - - uu-u u--	dactylic hexameter	masculine penthemimeral, hepthemimeral
λαοῦ ἀποτμήξαντε διώκετον ἐμμενὲς αἰεί.	-u u---u u-uu -uu --	dactylic hexameter	feminine penthemimeral
ἀλλ’ ὅτε δὴ τάχ’ ἔμελλε μιγήσεσθαι φυλάκεσσι	- uu - u u-u u--- uu--	dactylic hexameter	feminine penthemimeral, trithemimeral
φεύγων ἐς νῆας, τότε δὴ μένος ἔμβαλ’ Ἀθήνη	-- - -- uu - uu -u u--	dactylic hexameter	masculine penthemimeral, hepthemimeral, trithemimeral
Τυδεΐδῃ, ἵνα μή τις Ἀχαιῶν χαλκοχιτώνων	-uu- uu - u u-- -uu--	dactylic hexameter	masculine penthemimeral, trithemimeral
φθαίη ἐπευξάμενος βαλέειν, ὃ δὲ δεύτερος ἔλθοι.	-u u-uu- uu- u u -uu --	dactylic hexameter	masculine penthemimeral, hepthemimeral
δουρὶ δ’ἐπαΐσσων προσέφη κρατερὸς Διομήδης·	-u u--- uu- uu- uu--	dactylic hexameter	masculine penthemimeral, hepthemimeral
ἠὲ μέν’ ἠέ σε δουρὶ κιχήσομαι, οὐδέ σέ φημι	-u u -u u -u u-uu -u u --	dactylic hexameter	feminine penthemimeral
δηρὸν ἐμῆς ἀπὸ χειρὸς ἀλύξειν αἰπὺν ὄλεθρον.	-u u- uu -u u-- -u u--	dactylic hexameter	feminine penthemimeral, trithemimeral
ἦ ῥα καὶ ἔγχος ἀφῆκεν, ἑκὼν δ’ἡμάρτανε φωτός·	- u u -u u-u u- --uu --	dactylic hexameter	feminine penthemimeral, hepthemimeral
δεξιτερὸν δ’ὑπὲρ ὦμον ἐΰξου δουρὸς ἀκωκὴ	-uu- uu -u u-- -u u--	dactylic hexameter	feminine penthemimeral, trithemimeral
ἐν γαίῃ ἐπάγη· ὃ δ’ἄρ’ ἔστη τάρβησέν τε	- -- uu- u u -- --- -	dactylic hexameter	masculine penthemimeral, trithemimeral
βαμβαίνων· ἄραβος δὲ διὰ στόμα γίγνετ’ ὀδόντων·	--- uu- u u- uu -u u--	dactylic hexameter	masculine penthemimeral, hepthemimeral, trithemimeral
χλωρὸς ὑπαὶ δείους· τὼ δ’ἀσθμαίνοντε κιχήτην,	-u u- -- - ---u u--	dactylic hexameter	masculine penthemimeral, trithemimeral
χειρῶν δ’ἁψάσθην· ὃ δὲ δακρύσας ἔπος ηὔδα·	-- --- u u --- uu --	dactylic hexameter	masculine penthemimeral
ζωγρεῖτ’, αὐτὰρ ἐγὼν ἐμὲ λύσομαι· ἔστι γὰρ ἔνδον	-- -u u- uu -uu -u u --	dactylic hexameter	masculine penthemimeral
χαλκός τε χρυσός τε πολύκμητός τε σίδηρος,	-- - -- u u--- u u--	dactylic hexameter	masculine penthemimeral, trithemimeral
τῶν κ’ὔμμιν χαρίσαιτο πατὴρ ἀπερείσι’ ἄποινα	- -- uu-u u- uu-u u--	dactylic hexameter	feminine penthemimeral, hepthemimeral, trithemimeral
εἴ κεν ἐμὲ ζωὸν πεπύθοιτ’ ἐπὶ νηυσὶν Ἀχαιῶν.	- u u- -- uu- uu -u u--	dactylic hexameter	masculine penthemimeral, hepthemimeral, trithemimeral
τὸν δ’ἀπαμειβόμενος προσέφη πολύμητις Ὀδυσσεύς·	- uu-uu- uu- uu-u u--	dactylic hexameter	masculine penthemimeral, hepthemimeral
θάρσει, μηδέ τί τοι θάνατος καταθύμιος ἔστω.	-- -u u - uu- uu-uu --	dactylic hexameter	masculine penthemimeral, hepthemimeral
ἀλλ’ ἄγε μοι τόδε εἰπὲ καὶ ἀτρεκέως κατάλεξον·	- uu - uu -u u -uu- uu--	dactylic hexameter	feminine penthemimeral, trithemimeral
πῇ δη οὕτως ἐπὶ νῆας ἀπὸ στρατοῦ ἔρχεαι οἷος	- -- uu -u u- uu -uu --	dactylic hexameter	feminine penthemimeral, hepthemimeral, trithemimeral
νύκτα δι’ ὀρφναίην, ὅτε θ’εὕδουσι βροτοὶ ἄλλοι;	-u u --- uu --- uu --	dactylic hexameter	masculine penthemimeral
ἤ τινα συλήσων νεκύων κατατεθνηώτων;	- uu --- uu- uu----	dactylic hexameter	masculine penthemimeral, hepthemimeral
ἦ σ’Ἕκτωρ προέηκε διασκοπιᾶσθαι ἕκαστα	- -- uu-u u-uu-u u--	dactylic hexameter	feminine penthemimeral, trithemimeral
νῆας ἔπι γλαφυράς; ἦ σ’αὐτὸν θυμὸς ἀνῆκε;	-u u- uu- - -- -u u--	dactylic hexameter	masculine penthemimeral, trithemimeral
τὸν δ’ἠμείβετ’ ἔπειτα Δόλων, ὑπὸ δ’ἔτρεμε γυῖα·	- --u u-u u- uu -uu --	dactylic hexameter	feminine penthemimeral, hepthemimeral
πολλῇσίν μ’ἄτῃσι παρὲκ νόον ἤγαγεν Ἕκτωρ,	--- --u u- uu -uu --	dactylic hexameter	feminine penthemimeral, hepthemimeral, trithemimeral
ὅς μοι Πηλεΐωνος ἀγαυοῦ μώνυχας ἵππους	- - -uu-u u-- -uu --	dactylic hexameter	feminine penthemimeral
δωσέμεναι κατένευσε καὶ ἅρματα ποικίλα χαλκῷ,	-uu- uu-u u -uu -uu --	dactylic hexameter	feminine penthemimeral, trithemimeral
ἠνώγει δέ μ’ἰόντα θοὴν διὰ νύκτα μέλαιναν	--- u u-u u- uu -u u--	dactylic hexameter	feminine penthemimeral, hepthemimeral, trithemimeral
ἀνδρῶν δυσμενέων σχεδὸν ἐλθέμεν, ἔκ τε πυθέσθαι	-- -uu- uu -uu - u u--	dactylic hexameter	masculine penthemimeral
ἠὲ φυλάσσονται νῆες θοαὶ ὡς τὸ πάρος περ,	-u u--- -- uu - u u- -	dactylic hexameter	masculine penthemimeral, hepthemimeral
ἦ ἤδη χείρεσσιν ὑφ’ ἡμετέρῃσι δαμέντες	- -- --u u -uu-u u--	dactylic hexameter	feminine penthemimeral, trithemimeral
φύξιν βουλεύουσι μετὰ σφίσιν, οὐδ’ ἐθέλουσι	-- ---u u- uu - uu--	dactylic hexameter	feminine penthemimeral, hepthemimeral
νύκτα φυλασσέμεναι, καμάτῳ ἀδηκότες αἰνῷ.	-u u-uu- uu- --uu --	dactylic hexameter	masculine penthemimeral, hepthemimeral
τὸν δ’ἐπιμειδήσας προσέφη πολύμητις Ὀδυσσεύς·	- uu--- uu- uu-u u--	dactylic hexameter	masculine penthemimeral, hepthemimeral
ἦ ῥά νύ τοι μεγάλων δώρων ἐπεμαίετο θυμὸς	- u u - uu- -- uu-uu --	dactylic hexameter	masculine penthemimeral, hepthemimeral, trithemimeral
ἵππων Αἰακίδαο δαίφρονος· οἳ δ’ἀλεγεινοὶ	-- ---uu -uu - uu--	dactylic hexameter	
ἀνδράσι γε θνητοῖσι δαμήμεναι ἠδ’ ὀχέεσθαι	-uu - --u u-uu - uu--	dactylic hexameter	feminine penthemimeral, trithemimeral
ἄλλῳ γ’ἢ Ἀχιλῆϊ, τὸν ἀθανάτη τέκε μήτηρ.	-- - uu-u u -uu- uu --	dactylic hexameter	feminine penthemimeral, trithemimeral
ἀλλ’ ἄγε μοι τόδε εἰπὲ καὶ ἀτρεκέως κατάλεξον·	- uu - uu -u u -uu- uu--	dactylic hexameter	feminine penthemimeral, trithemimeral
ποῦ νῦν δεῦρο κιὼν λίπες Ἕκτορα ποιμένα λαῶν;	- - -u u- uu -uu -uu --	dactylic hexameter	masculine penthemimeral
ποῦ δέ οἱ ἔντεα κεῖται ἀρήϊα, ποῦ δέ οἱ ἵπποι;	- u u -uu -u u-uu - u u --	dactylic hexameter	feminine penthemimeral
πῶς δαὶ τῶν ἄλλων Τρώων φυλακαί τε καὶ εὐναί;	- - - -- -- uu- u u --	dactylic hexameter	masculine penthemimeral, hepthemimeral, trithemimeral
ἅσσά τε μητιόωσι μετὰ σφίσιν, ἢ μεμάασιν	-u u -uu-u u- uu - uu--	dactylic hexameter	feminine penthemimeral, hepthemimeral
αὖθι μένειν παρὰ νηυσὶν ἀπόπροθεν, ἦε πόλιν δὲ	-u u- uu -u u-uu -u u- -	dactylic hexameter	feminine penthemimeral, trithemimeral
ἂψ ἀναχωρήσουσιν, ἐπεὶ δαμάσαντό γ’Ἀχαιούς.	- uu---u u- uu-u u--	dactylic hexameter	feminine penthemimeral, hepthemimeral
τὸν δ’αὖτε προσέειπε Δόλων Εὐμήδεος υἱός·	- -- uu-u u- --uu --	dactylic hexameter	feminine penthemimeral, hepthemimeral, trithemimeral
τοὶ γὰρ ἐγώ τοι ταῦτα μάλ’ ἀτρεκέως καταλέξω.	- u u- - -u u -uu- uu--	dactylic hexameter	feminine penthemimeral, trithemimeral
Ἕκτωρ μὲν μετὰ τοῖσιν, ὅσοι βουληφόροι εἰσί,	-- - uu -u u- --uu --	dactylic hexameter	feminine penthemimeral, hepthemimeral, trithemimeral
βουλὰς βουλεύει θείου παρὰ σήματι Ἴλου	-- --- -- uu -uu --	dactylic hexameter	masculine penthemimeral, hepthemimeral
νόσφιν ἀπὸ φλοίσβου· φυλακὰς δ’ἃς εἴρεαι ἥρως	-u u- -- uu- - -uu --	dactylic hexameter	masculine penthemimeral, hepthemimeral, trithemimeral
οὔ τις κεκριμένη ῥύεται στρατὸν οὐδὲ φυλάσσει.	- - -uu- uu- uu -u u--	dactylic hexameter	masculine penthemimeral, hepthemimeral
ὅσσαι μὲν Τρώων πυρὸς ἐσχάραι, οἷσιν ἀνάγκη	-- - -- uu -uu -u u--	dactylic hexameter	masculine penthemimeral, trithemimeral
οἷ δ’ἐγρηγόρθασι φυλασσέμεναί τε κέλονται	- ----u u-uu- u u--	dactylic hexameter	feminine penthemimeral
ἀλλήλοις· ἀτὰρ αὖτε πολύκλητοι ἐπίκουροι	--- uu -u u--- uu--	dactylic hexameter	feminine penthemimeral, trithemimeral
εὕδουσι· Τρωσὶν γὰρ ἐπιτραπέουσι φυλάσσειν·	--- -- u u-uu-u u--	dactylic hexameter	masculine penthemimeral, trithemimeral
οὐ γάρ σφιν παῖδες σχεδὸν εἵαται οὐδὲ γυναῖκες.	- - - -- uu -uu -u u--	dactylic hexameter	masculine penthemimeral, trithemimeral
τὸν δ’ἀπαμειβόμενος προσέφη πολύμητις Ὀδυσσεύς·	- uu-uu- uu- uu-u u--	dactylic hexameter	masculine penthemimeral, hepthemimeral
πῶς γὰρ νῦν Τρώεσσι μεμιγμένοι ἱπποδάμοισιν	- - - --u u-uu -uu--	dactylic hexameter	feminine penthemimeral, trithemimeral
εὕδουσ’ ἦ ἀπάνευθε; δίειπέ μοι ὄφρα δαείω.	-- - uu-u u-u u -u u--	dactylic hexameter	feminine penthemimeral, trithemimeral
τὸν δ’ἠμείβετ’ ἔπειτα Δόλων Εὐμήδεος υἱός·	- --u u-u u- --uu --	dactylic hexameter	feminine penthemimeral, hepthemimeral
τοὶ γὰρ ἐγὼ καὶ ταῦτα μάλ’ ἀτρεκέως καταλέξω.	- u u- - -u u -uu- uu--	dactylic hexameter	feminine penthemimeral, trithemimeral
πρὸς μὲν ἁλὸς Κᾶρες καὶ Παίονες ἀγκυλότοξοι	- u u- -- - -uu -uu--	dactylic hexameter	masculine penthemimeral, trithemimeral
καὶ Λέλεγες καὶ Καύκωνες δῖοί τε Πελασγοί,	- uu- - --- -- u u--	dactylic hexameter	hepthemimeral, trithemimeral
πρὸς Θύμβρης δ’ἔλαχον Λύκιοι Μυσοί τ’ἀγέρωχοι	- -- uu- uu- -- uu--	dactylic hexameter	masculine penthemimeral, hepthemimeral, trithemimeral
καὶ Φρύγες ἱππόμαχοι καὶ Μῄονες ἱπποκορυσταί.	- uu -uu- - -uu -uu--	dactylic hexameter	masculine penthemimeral
ἀλλὰ τί ἢ ἐμὲ ταῦτα διεξερέεσθε ἕκαστα;	-u u - uu -u u-uu-u u--	dactylic hexameter	feminine penthemimeral, trithemimeral
εἰ γὰρ δὴ μέματον Τρώων καταδῦναι ὅμιλον	- - - uu- -- uu-u u--	dactylic hexameter	masculine penthemimeral, hepthemimeral, trithemimeral
Θρήϊκες οἷδ’ ἀπάνευθε νεήλυδες ἔσχατοι ἄλλων·	-uu - uu-u u-uu -uu --	dactylic hexameter	feminine penthemimeral, trithemimeral
ἐν δέ σφιν ’Ρῆσος βασιλεὺς πάϊς Ἠϊονῆος.	- - - -- uu- uu -uu--	dactylic hexameter	masculine penthemimeral, hepthemimeral, trithemimeral
τοῦ δὴ καλλίστους ἵππους ἴδον ἠδὲ μεγίστους·	- - --- -- uu -u u--	dactylic hexameter	masculine penthemimeral, hepthemimeral
λευκότεροι χιόνος, θείειν δ’ἀνέμοισιν ὁμοῖοι·	-uu- uu- -- uu-u u--	dactylic hexameter	masculine penthemimeral, hepthemimeral, trithemimeral
ἅρμα δέ οἱ χρυσῷ τε καὶ ἀργύρῳ εὖ ἤσκηται·	-u u - -- u u -uu - ---	dactylic hexameter	masculine penthemimeral, trithemimeral
τεύχεα δὲ χρύσεια πελώρια θαῦμα ἰδέσθαι	-uu - --u u-uu -u u--	dactylic hexameter	feminine penthemimeral, trithemimeral
ἤλυθ’ ἔχων· τὰ μὲν οὔ τι καταθνητοῖσιν ἔοικεν	-u u- u u - u u---u u--	dactylic hexameter	masculine penthemimeral, trithemimeral
ἄνδρεσσιν φορέειν, ἀλλ’ ἀθανάτοισι θεοῖσιν.	--- uu- - -uu-u u--	dactylic hexameter	masculine penthemimeral, trithemimeral
ἀλλ’ ἐμὲ μὲν νῦν νηυσὶ πελάσσετον ὠκυπόροισιν,	- uu - - -u u-uu -uu--	dactylic hexameter	feminine penthemimeral, trithemimeral
ἠέ με δήσαντες λίπετ’ αὐτόθι νηλέϊ δεσμῷ,	-u u --- uu -uu -uu --	dactylic hexameter	masculine penthemimeral
ὄφρά κεν ἔλθητον καὶ πειρηθῆτον ἐμεῖο	-u u --- - ---u u--	dactylic hexameter	masculine penthemimeral
ἠὲ κατ’ αἶσαν ἔειπον ἐν ὑμῖν, ἦε καὶ οὐκί.	-u u -u u-u u -- -u u --	dactylic hexameter	feminine penthemimeral
τὸν δ’ἄρ’ ὑπόδρα ἰδὼν προσέφη κρατερὸς Διομήδης·	- u u-u u- uu- uu- uu--	dactylic hexameter	masculine penthemimeral, hepthemimeral
μὴ δή μοι φύξίν γε Δόλων ἐμβάλλεο θυμῷ·	- - - -- u u- --uu --	dactylic hexameter	masculine penthemimeral, hepthemimeral, trithemimeral
ἐσθλά περ ἀγγείλας, ἐπεὶ ἵκεο χεῖρας ἐς ἁμάς.	-u u --- uu -uu -u u --	dactylic hexameter	masculine penthemimeral
εἰ μὲν γάρ κέ σε νῦν ἀπολύσομεν ἠὲ μεθῶμεν,	- - - u u - uu-uu -u u--	dactylic hexameter	masculine penthemimeral, trithemimeral
ἦ τε καὶ ὕστερον εἶσθα θοὰς ἐπὶ νῆας Ἀχαιῶν	- u u -uu -u u- uu -u u--	dactylic hexameter	feminine penthemimeral, hepthemimeral
ἠὲ διοπτεύσων ἢ ἐναντίβιον πολεμίξων·	-u u--- u u-uu- uu--	dactylic hexameter	masculine penthemimeral
εἰ δέ κ’ἐμῇς ὑπὸ χερσὶ δαμεὶς ἀπὸ θυμὸν ὀλέσσῃς,	- u u- uu -u u- uu -u u--	dactylic hexameter	feminine penthemimeral, hepthemimeral, trithemimeral
οὐκέτ’ ἔπειτα σὺ πῆμά ποτ’ ἔσσεαι Ἀργείοισιν.	-u u-u u -u u -uu ----	dactylic hexameter	feminine penthemimeral
ἦ, καὶ ὃ μέν μιν ἔμελλε γενείου χειρὶ παχείῃ	- u u - u u-u u-- -u u--	dactylic hexameter	feminine penthemimeral, trithemimeral
ἁψάμενος λίσσεσθαι, ὃ δ’αὐχένα μέσσον ἔλασσε	-uu- --u u -uu -u u--	dactylic hexameter	feminine penthemimeral, trithemimeral
φασγάνῳ ἀΐξας, ἀπὸ δ’ἄμφω κέρσε τένοντε·	-uu --- uu -- -u u--	dactylic hexameter	masculine penthemimeral
φθεγγομένου δ’ἄρα τοῦ γε κάρη κονίῃσιν ἐμίχθη.	-uu- uu - u u- uu-u u--	dactylic hexameter	masculine penthemimeral, hepthemimeral, trithemimeral
τοῦ δ’ἀπὸ μὲν κτιδέην κυνέην κεφαλῆφιν ἕλοντο	- uu - uu- uu- uu-u u--	dactylic hexameter	masculine penthemimeral, hepthemimeral, trithemimeral
καὶ λυκέην καὶ τόξα παλίντονα καὶ δόρυ μακρόν·	- uu- - -u u-uu - uu --	dactylic hexameter	feminine penthemimeral, trithemimeral
καὶ τά γ’Ἀθηναίῃ ληΐτιδι δῖος Ὀδυσσεὺς	- u u--- --uu -u u--	dactylic hexameter	masculine penthemimeral
ὑψόσ’ ἀνέσχεθε χειρὶ καὶ εὐχόμενος ἔπος ηὔδα·	-u u-uu -u u -uu- uu --	dactylic hexameter	feminine penthemimeral
χαῖρε θεὰ τοῖσδεσσι· σὲ γὰρ πρώτην ἐν Ὀλύμπῳ	-u u- --u u - -- u u--	dactylic hexameter	feminine penthemimeral, hepthemimeral, trithemimeral
πάντων ἀθανάτων ἐπιδωσόμεθ’· ἀλλὰ καὶ αὖτις	-- -uu- uu-uu -u u --	dactylic hexameter	masculine penthemimeral
πέμψον ἐπὶ Θρῃκῶν ἀνδρῶν ἵππους τε καὶ εὐνάς.	-u u- -- -- -- u u --	dactylic hexameter	masculine penthemimeral, hepthemimeral, trithemimeral
ὣς ἄρ’ ἐφώνησεν, καὶ ἀπὸ ἕθεν ὑψόσ’ ἀείρας	- u u--- u u- uu -u u--	dactylic hexameter	masculine penthemimeral, hepthemimeral
θῆκεν ἀνὰ μυρίκην· δέελον δ’ἐπὶ σῆμά τ’ἔθηκε	-u u- uu- uu- uu -u u--	dactylic hexameter	masculine penthemimeral, hepthemimeral, trithemimeral
συμμάρψας δόνακας μυρίκης τ’ἐριθηλέας ὄζους,	--- uu- uu- uu-uu --	dactylic hexameter	masculine penthemimeral, hepthemimeral, trithemimeral
μὴ λάθοι αὖτις ἰόντε θοὴν διὰ νύκτα μέλαιναν.	- uu -u u-u u- uu -u u--	dactylic hexameter	feminine penthemimeral, hepthemimeral
τὼ δὲ βάτην προτέρω διά τ’ἔντεα καὶ μέλαν αἷμα,	- u u- uu- uu -uu - uu --	dactylic hexameter	masculine penthemimeral, trithemimeral
αἶψα δ’ἐπὶ Θρῃκῶν ἀνδρῶν τέλος ἷξον ἰόντες.	-u u- -- -- uu -u u--	dactylic hexameter	masculine penthemimeral, hepthemimeral, trithemimeral
οἳ δ’εὗδον καμάτῳ ἀδηκότες, ἔντεα δέ σφιν	- -- uu- --uu -uu - -	dactylic hexameter	masculine penthemimeral, trithemimeral
καλὰ παρ’ αὐτοῖσι χθονὶ κέκλιτο εὖ κατὰ κόσμον	-u u --- uu -uu - uu --	dactylic hexameter	masculine penthemimeral
τριστοιχί· παρὰ δέ σφιν ἑκάστῳ δίζυγες ἵπποι.	--- uu - u u-- -uu --	dactylic hexameter	masculine penthemimeral, trithemimeral
’Ρῆσος δ’ἐν μέσῳ εὗδε, παρ’ αὐτῷ δ’ὠκέες ἵπποι	-- - uu -u u -- -uu --	dactylic hexameter	feminine penthemimeral, trithemimeral
ἐξ ἐπιδιφριάδος πυμάτης ἱμᾶσι δέδεντο.	- uu-uu- uu- --u u--	dactylic hexameter	masculine penthemimeral, hepthemimeral
τὸν δ’Ὀδυσεὺς προπάροιθεν ἰδὼν Διομήδεϊ δεῖξεν·	- uu- uu-u u- uu-uu --	dactylic hexameter	feminine penthemimeral, hepthemimeral, trithemimeral
οὗτός τοι Διόμηδες ἀνήρ, οὗτοι δέ τοι ἵπποι,	-- - uu-u u- -- u u --	dactylic hexameter	feminine penthemimeral, hepthemimeral, trithemimeral
οὓς νῶϊν πίφαυσκε Δόλων ὃν ἐπέφνομεν ἡμεῖς.	- -- --u u- u u-uu --	dactylic hexameter	feminine penthemimeral, hepthemimeral, trithemimeral
ἀλλ’ ἄγε δὴ πρόφερε κρατερὸν μένος· οὐδέ τί σε χρὴ	- uu - uu- uu- uu -u u - -	dactylic hexameter	masculine penthemimeral, hepthemimeral, trithemimeral
ἑστάμεναι μέλεον σὺν τεύχεσιν, ἀλλὰ λύ’ ἵππους·	-uu- uu- - -uu -u u --	dactylic hexameter	masculine penthemimeral, trithemimeral
ἠὲ σύ γ’ἄνδρας ἔναιρε, μελήσουσιν δ’ἐμοὶ ἵπποι.	-u u -u u-u u--- uu --	dactylic hexameter	feminine penthemimeral
ὣς φάτο, τῷ δ’ἔμπνευσε μένος γλαυκῶπις Ἀθήνη,	- uu - --u u- --u u--	dactylic hexameter	feminine penthemimeral, hepthemimeral, trithemimeral
κτεῖνε δ’ἐπιστροφάδην· τῶν δὲ στόνος ὄρνυτ’ ἀεικὴς	-u u-uu- - - uu -u u--	dactylic hexameter	masculine penthemimeral, hepthemimeral
ἄορι θεινομένων, ἐρυθαίνετο δ’αἵματι γαῖα.	-uu -uu- uu-uu -uu --	dactylic hexameter	masculine penthemimeral
ὡς δὲ λέων μήλοισιν ἀσημάντοισιν ἐπελθὼν	- u u- --u u---u u--	dactylic hexameter	feminine penthemimeral, trithemimeral
αἴγεσιν ἢ ὀΐεσσι κακὰ φρονέων ἐνορούσῃ,	-uu - uu-u u- uu- uu--	dactylic hexameter	feminine penthemimeral, hepthemimeral, trithemimeral
ὣς μὲν Θρήϊκας ἄνδρας ἐπῴχετο Τυδέος υἱὸς	- - -uu -u u-uu -uu --	dactylic hexameter	feminine penthemimeral
ὄφρα δυώδεκ’ ἔπεφνεν· ἀτὰρ πολύμητις Ὀδυσσεὺς	-u u-u u-u u- uu-u u--	dactylic hexameter	feminine penthemimeral, hepthemimeral
ὅν τινα Τυδεΐδης ἄορι πλήξειε παραστὰς	- uu -uu- uu- --u u--	dactylic hexameter	masculine penthemimeral, hepthemimeral
τὸν δ’Ὀδυσεὺς μετόπισθε λαβὼν ποδὸς ἐξερύσασκε,	- uu- uu-u u- uu -uu--	dactylic hexameter	feminine penthemimeral, hepthemimeral, trithemimeral
τὰ φρονέων κατὰ θυμὸν ὅπως καλλίτριχες ἵπποι	- uu- uu -u u- --uu --	dactylic hexameter	feminine penthemimeral, hepthemimeral, trithemimeral
ῥεῖα διέλθοιεν μηδὲ τρομεοίατο θυμῷ	-u u--- -- uu-uu --	dactylic hexameter	masculine penthemimeral, hepthemimeral
νεκροῖς ἀμβαίνοντες· ἀήθεσσον γὰρ ἔτ’ αὐτῶν.	-- ---u u--- u u --	dactylic hexameter	feminine penthemimeral
ἀλλ’ ὅτε δὴ βασιλῆα κιχήσατο Τυδέος υἱός,	- uu - uu-u u-uu -uu --	dactylic hexameter	feminine penthemimeral, trithemimeral
τὸν τρισκαιδέκατον μελιηδέα θυμὸν ἀπηύρα	- --uu- uu-uu -u u--	dactylic hexameter	masculine penthemimeral
ἀσθμαίνοντα· κακὸν γὰρ ὄναρ κεφαλῆφιν ἐπέστη	---u u- u u- uu-u u--	dactylic hexameter	masculine penthemimeral, hepthemimeral
τὴν νύκτ’ Οἰνεΐδαο πάϊς διὰ μῆτιν Ἀθήνης.	- - -uu-u u- uu -u u--	dactylic hexameter	feminine penthemimeral, hepthemimeral
τόφρα δ’ἄρ’ ὃ τλήμων Ὀδυσεὺς λύε μώνυχας ἵππους,	-u u - -- uu- uu -uu --	dactylic hexameter	masculine penthemimeral, hepthemimeral, trithemimeral
σὺν δ’ἤειρεν ἱμᾶσι καὶ ἐξήλαυνεν ὁμίλου	- --u u-u u ---u u--	dactylic hexameter	feminine penthemimeral
τόξῳ ἐπιπλήσσων, ἐπεὶ οὐ μάστιγα φαεινὴν	-u u--- uu - --u u--	dactylic hexameter	masculine penthemimeral, hepthemimeral
ποικίλου ἐκ δίφροιο νοήσατο χερσὶν ἑλέσθαι·	-uu - --u u-uu -u u--	dactylic hexameter	feminine penthemimeral, trithemimeral
ῥοίζησεν δ’ἄρα πιφαύσκων Διομήδεϊ δίῳ.	--- uu --- uu-uu --	dactylic hexameter	hepthemimeral, trithemimeral
αὐτὰρ ὃ μερμήριζε μένων ὅ τι κύντατον ἕρδοι,	-u u ---u u- u u -uu --	dactylic hexameter	feminine penthemimeral, hepthemimeral
ἢ ὅ γε δίφρον ἑλών, ὅθι ποικίλα τεύχε’ ἔκειτο,	- u u -u u- uu -uu -u u--	dactylic hexameter	masculine penthemimeral
ῥυμοῦ ἐξερύοι ἢ ἐκφέροι ὑψόσ’ ἀείρας,	-- -uu- - -uu -u u--	dactylic hexameter	masculine penthemimeral
ἦ ἔτι τῶν πλεόνων Θρῃκῶν ἀπὸ θυμὸν ἕλοιτο.	- uu - uu- -- uu -u u--	dactylic hexameter	masculine penthemimeral, hepthemimeral, trithemimeral
εἷος ὃ ταῦθ’ ὥρμαινε κατὰ φρένα, τόφρα δ’Ἀθήνη	-u u - --u u- uu -u u--	dactylic hexameter	feminine penthemimeral, hepthemimeral, trithemimeral
ἐγγύθεν ἱσταμένη προσέφη Διομήδεα δῖον·	-uu -uu- uu- uu-uu --	dactylic hexameter	masculine penthemimeral, hepthemimeral
νόστου δὴ μνῆσαι μεγαθύμου Τυδέος υἱὲ	-- - -- uu-- -uu --	dactylic hexameter	masculine penthemimeral, trithemimeral
νῆας ἔπι γλαφυράς, μὴ καὶ πεφοβημένος ἔλθῃς,	-u u- uu- - - uu-uu --	dactylic hexameter	masculine penthemimeral, hepthemimeral, trithemimeral
μή πού τις καὶ Τρῶας ἐγείρῃσιν θεὸς ἄλλος.	- - - - -u u--- uu --	dactylic hexameter	feminine penthemimeral, trithemimeral
ὣς φάθ’, ὃ δὲ ξυνέηκε θεᾶς ὄπα φωνησάσης,	- u u - uu-u u- uu ----	dactylic hexameter	feminine penthemimeral, hepthemimeral, trithemimeral
καρπαλίμως δ’ἵππων ἐπεβήσετο· κόψε δ’Ὀδυσσεὺς	-uu- -- uu-uu -u u--	dactylic hexameter	masculine penthemimeral, trithemimeral
τόξῳ· τοὶ δ’ἐπέτοντο θοὰς ἐπὶ νῆας Ἀχαιῶν.	-- - uu-u u- uu -u u--	dactylic hexameter	feminine penthemimeral, hepthemimeral, trithemimeral
οὐδ’ ἀλαοσκοπιὴν εἶχ’ ἀργυρότοξος Ἀπόλλων	- uu-uu- - -uu-u u--	dactylic hexameter	masculine penthemimeral
ὡς ἴδ’ Ἀθηναίην μετὰ Τυδέος υἱὸν ἕπουσαν·	- u u--- uu -uu -u u--	dactylic hexameter	masculine penthemimeral
τῇ κοτέων Τρώων κατεδύσετο πουλὺν ὅμιλον,	- uu- -- uu-uu -u u--	dactylic hexameter	masculine penthemimeral, trithemimeral
ὦρσεν δὲ Θρῃκῶν βουληφόρον Ἱπποκόωντα	-- - -- --uu -uu--	dactylic hexameter	masculine penthemimeral, trithemimeral
’Ρήσου ἀνεψιὸν ἐσθλόν· ὃ δ’ἐξ ὕπνου ἀνορούσας	-u u-uu -u u - -- uu--	dactylic hexameter	feminine penthemimeral, hepthemimeral
ὡς ἴδε χῶρον ἐρῆμον, ὅθ’ ἕστασαν ὠκέες ἵπποι,	- uu -u u-u u -uu -uu --	dactylic hexameter	feminine penthemimeral
ἄνδράς τ’ἀσπαίροντας ἐν ἀργαλέῃσι φονῇσιν,	-- ---u u -uu-u u--	dactylic hexameter	feminine penthemimeral
ᾤμωξέν τ’ἄρ’ ἔπειτα φίλον τ’ὀνόμηνεν ἑταῖρον.	--- u u-u u- uu-u u--	dactylic hexameter	feminine penthemimeral, hepthemimeral, trithemimeral
Τρώων δὲ κλαγγή τε καὶ ἄσπετος ὦρτο κυδοιμὸς	-- - -- u u -uu -u u--	dactylic hexameter	masculine penthemimeral, trithemimeral
θυνόντων ἄμυδις· θηεῦντο δὲ μέρμερα ἔργα	--- uu- --u u -uu --	dactylic hexameter	masculine penthemimeral, trithemimeral
ὅσσ’ ἄνδρες ῥέξαντες ἔβαν κοίλας ἐπὶ νῆας.	- -- --u u- -- uu --	dactylic hexameter	feminine penthemimeral, hepthemimeral, trithemimeral
οἳ δ’ὅτε δή ῥ’ἵκανον ὅθι σκοπὸν Ἕκτορος ἔκταν,	- uu - --u u- uu -uu --	dactylic hexameter	feminine penthemimeral, hepthemimeral, trithemimeral
ἔνθ’ Ὀδυσεὺς μὲν ἔρυξε Διῒ φίλος ὠκέας ἵππους,	- uu- u u-u u- uu -uu --	dactylic hexameter	feminine penthemimeral, hepthemimeral, trithemimeral
Τυδεΐδης δὲ χαμᾶζε θορὼν ἔναρα βροτόεντα	-uu- u u-u u- uu- uu--	dactylic hexameter	feminine penthemimeral, hepthemimeral, trithemimeral
ἐν χείρεσσ’ Ὀδυσῆϊ τίθει, ἐπεβήσετο δ’ἵππων·	- -- uu-u u- uu-uu --	dactylic hexameter	feminine penthemimeral, hepthemimeral, trithemimeral
μάστιξεν δ’ἵππους, τὼ δ’οὐκ ἀέκοντε πετέσθην	--- -- - - uu-u u--	dactylic hexameter	masculine penthemimeral, hepthemimeral, trithemimeral
νῆας ἔπι γλαφυράς· τῇ γὰρ φίλον ἔπλετο θυμῷ.	-u u- uu- - - uu -uu --	dactylic hexameter	masculine penthemimeral, hepthemimeral, trithemimeral
Νέστωρ δὲ πρῶτος κτύπον ἄϊε φώνησέν τε·	-- - -- uu -uu --- -	dactylic hexameter	masculine penthemimeral, trithemimeral
ὦ φίλοι Ἀργείων ἡγήτορες ἠδὲ μέδοντες	- uu --- --uu -u u--	dactylic hexameter	masculine penthemimeral
ψεύσομαι, ἦ ἔτυμον ἐρέω; κέλεται δέ με θυμός.	-uu - uu- uu- uu- u u --	dactylic hexameter	masculine penthemimeral, hepthemimeral, trithemimeral
ἵππων μ’ὠκυπόδων ἀμφὶ κτύπος οὔατα βάλλει.	-- -uu- -- uu -uu --	dactylic hexameter	masculine penthemimeral, hepthemimeral
αἲ γὰρ δὴ Ὀδυσεύς τε καὶ ὃ κρατερὸς Διομήδης	- - - uu- u u - uu- uu--	dactylic hexameter	masculine penthemimeral, hepthemimeral, trithemimeral
ὧδ’ ἄφαρ ἐκ Τρώων ἐλασαίατο μώνυχας ἵππους·	- uu - -- uu-uu -uu --	dactylic hexameter	masculine penthemimeral, trithemimeral
ἀλλ’ αἰνῶς δείδοικα κατὰ φρένα μή τι πάθωσιν	- -- --u u- uu - u u--	dactylic hexameter	feminine penthemimeral, hepthemimeral, trithemimeral
Ἀργείων οἳ ἄριστοι ὑπὸ Τρώων ὀρυμαγδοῦ.	--- u u-u u- -- uu--	dactylic hexameter	feminine penthemimeral, hepthemimeral, trithemimeral
οὔ πω πᾶν εἴρητο ἔπος ὅτ’ ἄρ’ ἤλυθον αὐτοί.	- - - --u u- u u -uu --	dactylic hexameter	feminine penthemimeral, hepthemimeral, trithemimeral
καί ῥ’οἳ μὲν κατέβησαν ἐπὶ χθόνα, τοὶ δὲ χαρέντες	- - - uu-u u- uu - u u--	dactylic hexameter	feminine penthemimeral, hepthemimeral, trithemimeral
δεξιῇ ἠσπάζοντο ἔπεσσί τε μειλιχίοισι·	-uu ---u u-u u -uu--	dactylic hexameter	feminine penthemimeral
πρῶτος δ’ἐξερέεινε Γερήνιος ἱππότα Νέστωρ·	-- -uu-u u-uu -uu --	dactylic hexameter	feminine penthemimeral
εἴπ’ ἄγε μ’ὦ πολύαιν’ Ὀδυσεῦ μέγα κῦδος Ἀχαιῶν	- uu - uu- uu- uu -u u--	dactylic hexameter	masculine penthemimeral, hepthemimeral, trithemimeral
ὅππως τοῦσδ’ ἵππους λάβετον καταδύντες ὅμιλον	-- - -- uu- uu-u u--	dactylic hexameter	masculine penthemimeral, hepthemimeral, trithemimeral
Τρώων, ἦ τίς σφωε πόρεν θεὸς ἀντιβολήσας.	-- - - -u u- uu -uu--	dactylic hexameter	feminine penthemimeral, hepthemimeral, trithemimeral
αἰνῶς ἀκτίνεσσιν ἐοικότες ἠελίοιο.	-- ---u u-uu -uu--	dactylic hexameter	feminine penthemimeral
αἰεὶ μὲν Τρώεσσ’ ἐπιμίσγομαι, οὐδέ τί φημι	-- - -- uu-uu -u u --	dactylic hexameter	masculine penthemimeral, trithemimeral
μιμνάζειν παρὰ νηυσὶ γέρων περ ἐὼν πολεμιστής·	--- uu -u u- u u- uu--	dactylic hexameter	feminine penthemimeral, hepthemimeral, trithemimeral
ἀλλ’ οὔ πω τοίους ἵππους ἴδον οὐδὲ νόησα.	- - - -- -- uu -u u--	dactylic hexameter	masculine penthemimeral, hepthemimeral, trithemimeral
ἀλλά τιν’ ὔμμ’ ὀΐω δόμεναι θεὸν ἀντιάσαντα·	-u u - uu- uu- uu -uu--	dactylic hexameter	masculine penthemimeral, hepthemimeral, trithemimeral
ἀμφοτέρω γὰρ σφῶϊ φιλεῖ νεφεληγερέτα Ζεὺς	-uu- - -u u- uu-uu- -	dactylic hexameter	feminine penthemimeral, hepthemimeral, trithemimeral
κούρη τ’αἰγιόχοιο Διὸς γλαυκῶπις Ἀθήνη.	-- -uu-u u- --u u--	dactylic hexameter	feminine penthemimeral, hepthemimeral
τὸν δ’ἀπαμειβόμενος προσέφη πολύμητις Ὀδυσσεύς·	- uu-uu- uu- uu-u u--	dactylic hexameter	masculine penthemimeral, hepthemimeral
ὦ Νέστορ Νηληϊάδη μέγα κῦδος Ἀχαιῶν	- -- --uu- uu -u u--	dactylic hexameter	hepthemimeral, trithemimeral
ῥεῖα θεός γ’ἐθέλων καὶ ἀμείνονας ἠέ περ οἵδε	-u u- uu- u u-uu -u u --	dactylic hexameter	masculine penthemimeral, trithemimeral
ἵππους δωρήσαιτ’, ἐπεὶ ἢ πολὺ φέρτεροί εἰσιν.	-- --- uu - uu -uu --	dactylic hexameter	masculine penthemimeral, hepthemimeral
ἵπποι δ’οἵδε γεραιὲ νεήλυδες οὓς ἐρεείνεις	-- -u u-u u-uu - uu--	dactylic hexameter	feminine penthemimeral
Θρηΐκιοι· τὸν δέ σφιν ἄνακτ’ ἀγαθὸς Διομήδης	-uu- - - u u- uu- uu--	dactylic hexameter	masculine penthemimeral, hepthemimeral, trithemimeral
ἔκτανε, πὰρ δ’ἑτάρους δυοκαίδεκα πάντας ἀρίστους.	-uu - uu- uu-uu -u u--	dactylic hexameter	masculine penthemimeral, trithemimeral
τὸν τρισκαιδέκατον σκοπὸν εἵλομεν ἐγγύθι νηῶν,	- --uu- uu -uu -uu --	dactylic hexameter	masculine penthemimeral
τόν ῥα διοπτῆρα στρατοῦ ἔμμεναι ἡμετέροιο	- u u--- uu -uu -uu--	dactylic hexameter	masculine penthemimeral
Ἕκτωρ τε προέηκε καὶ ἄλλοι Τρῶες ἀγαυοί.	-- - uu-u u -- -u u--	dactylic hexameter	feminine penthemimeral, trithemimeral
ὣς εἰπὼν τάφροιο διήλασε μώνυχας ἵππους	- -- --u u-uu -uu --	dactylic hexameter	feminine penthemimeral, trithemimeral
καγχαλόων· ἅμα δ’ἄλλοι ἴσαν χαίροντες Ἀχαιοί.	-uu- uu -u u- --u u--	dactylic hexameter	feminine penthemimeral, hepthemimeral, trithemimeral
οἳ δ’ὅτε Τυδεΐδεω κλισίην εὔτυκτον ἵκοντο,	- uu -uu- uu- --u u--	dactylic hexameter	masculine penthemimeral, hepthemimeral
ἵππους μὲν κατέδησαν ἐϋτμήτοισιν ἱμᾶσι	-- - uu-u u---u u--	dactylic hexameter	feminine penthemimeral, trithemimeral
φάτνῃ ἐφ’ ἱππείῃ, ὅθι περ Διομήδεος ἵπποι	-u u --- uu - uu-uu --	dactylic hexameter	masculine penthemimeral, hepthemimeral
ἕστασαν ὠκύποδες μελιηδέα πυρὸν ἔδοντες·	-uu -uu- uu-uu -u u--	dactylic hexameter	masculine penthemimeral
νηῒ δ’ἐνὶ πρυμνῇ ἔναρα βροτόεντα Δόλωνος	-u u- -- uu- uu-u u--	dactylic hexameter	masculine penthemimeral, hepthemimeral, trithemimeral
θῆκ’ Ὀδυσεύς, ὄφρ’ ἱρὸν ἑτοιμασσαίατ’ Ἀθήνῃ.	- uu- - -u u---u u--	dactylic hexameter	feminine penthemimeral, trithemimeral
αὐτοὶ δ’ἱδρῶ πολλὸν ἀπενίζοντο θαλάσσῃ	-- -- -u u---u u--	dactylic hexameter	feminine penthemimeral
ἐσβάντες κνήμας τε ἰδὲ λόφον ἀμφί τε μηρούς.	--- -- u u- uu -u u --	dactylic hexameter	masculine penthemimeral, hepthemimeral, trithemimeral
αὐτὰρ ἐπεί σφιν κῦμα θαλάσσης ἱδρῶ πολλὸν	-u u- - -u u-- -- --	dactylic hexameter	feminine penthemimeral, trithemimeral
νίψεν ἀπὸ χρωτὸς καὶ ἀνέψυχθεν φίλον ἦτορ,	-u u- -- u u--- uu --	dactylic hexameter	masculine penthemimeral, trithemimeral
ἔς ῥ’ἀσαμίνθους βάντες ἐϋξέστας λούσαντο.	- uu-- -u u--- ---	dactylic hexameter	feminine penthemimeral
τὼ δὲ λοεσσαμένω καὶ ἀλειψαμένω λίπ’ ἐλαίῳ	- u u-uu- u u-uu- u u--	dactylic hexameter	masculine penthemimeral
δείπνῳ ἐφιζανέτην, ἀπὸ δὲ κρητῆρος Ἀθήνῃ	-u u-uu- uu - --u u--	dactylic hexameter	masculine penthemimeral, hepthemimeral
πλείου ἀφυσσόμενοι λεῖβον μελιηδέα οἶνον.	-u u-uu- -- uu-uu --	dactylic hexameter	masculine penthemimeral, hepthemimeral
