ὣς οἳ μὲν παρὰ νηυσὶ κορωνίσι θωρήσσοντο	- - - uu -u u-uu ----	dactylic hexameter	feminine penthemimeral, trithemimeral
ἀμφὶ σὲ Πηλέος υἱὲ μάχης ἀκόρητον Ἀχαιοί,	-u u -uu -u u- uu-u u--	dactylic hexameter	feminine penthemimeral, hepthemimeral
Τρῶες δ’αὖθ’ ἑτέρωθεν ἐπὶ θρωσμῷ πεδίοιο·	-- - uu-u u- -- uu--	dactylic hexameter	feminine penthemimeral, hepthemimeral, trithemimeral
Ζεὺς δὲ Θέμιστα κέλευσε θεοὺς ἀγορὴν δὲ καλέσσαι	- u u-u u-u u- uu- u u--	dactylic hexameter	feminine penthemimeral, hepthemimeral
κρατὸς ἀπ’ Οὐλύμποιο πολυπτύχου· ἣ δ’ἄρα πάντῃ	-u u ---u u-uu - uu --	dactylic hexameter	feminine penthemimeral
φοιτήσασα κέλευσε Διὸς πρὸς δῶμα νέεσθαι.	---u u-u u- - -u u--	dactylic hexameter	feminine penthemimeral, hepthemimeral
οὔτέ τις οὖν ποταμῶν ἀπέην νόσφ’ Ὠκεανοῖο,	-u u - uu- uu- - -uu--	dactylic hexameter	masculine penthemimeral, hepthemimeral, trithemimeral
οὔτ’ ἄρα νυμφάων αἵ τ’ἄλσεα καλὰ νέμονται	- uu --- - -uu -u u--	dactylic hexameter	masculine penthemimeral
καὶ πηγὰς ποταμῶν καὶ πίσεα ποιήεντα.	- -- uu- - -uu ----	dactylic hexameter	masculine penthemimeral, trithemimeral
ἐλθόντες δ’ἐς δῶμα Διὸς νεφεληγερέταο	--- - -u u- uu-uu--	dactylic hexameter	feminine penthemimeral, hepthemimeral, trithemimeral
ξεστῇς αἰθούσῃσιν ἐνίζανον, ἃς Διὶ πατρὶ	-- ---u u-uu - uu --	dactylic hexameter	feminine penthemimeral
Ἥφαιστος ποίησεν ἰδυίῃσι πραπίδεσσιν.	--- --u u--- uu--	dactylic hexameter	feminine penthemimeral, trithemimeral
ὣς οἳ μὲν Διὸς ἔνδον ἀγηγέρατ’· οὐδ’ ἐνοσίχθων	- - - uu -u u-uu - uu--	dactylic hexameter	feminine penthemimeral, trithemimeral
νηκούστησε θεᾶς, ἀλλ’ ἐξ ἁλὸς ἦλθε μετ’ αὐτούς,	---u u- - - uu -u u --	dactylic hexameter	masculine penthemimeral, hepthemimeral
ἷζε δ’ἄρ’ ἐν μέσσοισι, Διὸς δ’ἐξείρετο βουλήν·	-u u - --u u- --uu --	dactylic hexameter	feminine penthemimeral, hepthemimeral, trithemimeral
τίπτ’ αὖτ’ ἀργικέραυνε θεοὺς ἀγορὴν δὲ κάλεσσας;	- - -uu-u u- uu- u u--	dactylic hexameter	feminine penthemimeral, hepthemimeral
ἦ τι περὶ Τρώων καὶ Ἀχαιῶν μερμηρίζεις;	- u u- -- u u-- ----	dactylic hexameter	masculine penthemimeral, trithemimeral
τῶν γὰρ νῦν ἄγχιστα μάχη πόλεμός τε δέδηε.	- - - --u u- uu- u u--	dactylic hexameter	feminine penthemimeral, hepthemimeral, trithemimeral
τὸν δ’ἀπαμειβόμενος προσέφη νεφεληγερέτα Ζεύς·	- uu-uu- uu- uu-uu- -	dactylic hexameter	masculine penthemimeral, hepthemimeral
ἔγνως ἐννοσίγαιε ἐμὴν ἐν στήθεσι βουλὴν	-- -uu-u u- - -uu --	dactylic hexameter	feminine penthemimeral, hepthemimeral
ὧν ἕνεκα ξυνάγειρα· μέλουσί μοι ὀλλύμενοί περ.	- uu- uu-u u-u u -uu- -	dactylic hexameter	feminine penthemimeral, trithemimeral
ἀλλ’ ἤτοι μὲν ἐγὼ μενέω πτυχὶ Οὐλύμποιο	- -- u u- uu- uu ----	dactylic hexameter	masculine penthemimeral, hepthemimeral, trithemimeral
ἥμενος, ἔνθ’ ὁρόων φρένα τέρψομαι· οἳ δὲ δὴ ἄλλοι	-uu - uu- uu -uu - u u --	dactylic hexameter	masculine penthemimeral, trithemimeral
ἔρχεσθ’ ὄφρ’ ἂν ἵκησθε μετὰ Τρῶας καὶ Ἀχαιούς,	-- - u u-u u- -- u u--	dactylic hexameter	feminine penthemimeral, hepthemimeral, trithemimeral
ἀμφοτέροισι δ’ἀρήγεθ’ ὅπῃ νόος ἐστὶν ἑκάστου.	-uu-u u-u u- uu -u u--	dactylic hexameter	feminine penthemimeral, hepthemimeral
εἰ γὰρ Ἀχιλλεὺς οἶος ἐπὶ Τρώεσσι μαχεῖται	- u u-- -u u- --u u--	dactylic hexameter	feminine penthemimeral, hepthemimeral
οὐδὲ μίνυνθ’ ἕξουσι ποδώκεα Πηλεΐωνα.	-u u- --u u-uu -uu--	dactylic hexameter	feminine penthemimeral, trithemimeral
καὶ δέ τί μιν καὶ πρόσθεν ὑποτρομέεσκον ὁρῶντες·	- u u - - -u u-uu-u u--	dactylic hexameter	feminine penthemimeral, trithemimeral
νῦν δ’ὅτε δὴ καὶ θυμὸν ἑταίρου χώεται αἰνῶς	- uu - - -u u-- -uu --	dactylic hexameter	feminine penthemimeral, trithemimeral
δείδω μὴ καὶ τεῖχος ὑπέρμορον ἐξαλαπάξῃ.	-- - - -u u-uu -uu--	dactylic hexameter	feminine penthemimeral, trithemimeral
ὣς ἔφατο Κρονίδης, πόλεμον δ’ἀλίαστον ἔγειρε.	- uu- uu- uu- uu-u u--	dactylic hexameter	masculine penthemimeral, hepthemimeral, trithemimeral
βὰν δ’ἴμεναι πόλεμον δὲ θεοὶ δίχα θυμὸν ἔχοντες·	- uu- uu- u u- uu -u u--	dactylic hexameter	masculine penthemimeral, hepthemimeral, trithemimeral
Ἥρη μὲν μετ’ ἀγῶνα νεῶν καὶ Παλλὰς Ἀθήνη	-- - u u-u u- - -u u--	dactylic hexameter	feminine penthemimeral, hepthemimeral, trithemimeral
ἠδὲ Ποσειδάων γαιήοχος ἠδ’ ἐριούνης	-u u--- --uu - uu--	dactylic hexameter	masculine penthemimeral
Ἑρμείας, ὃς ἐπὶ φρεσὶ πευκαλίμῃσι κέκασται·	--- u u- uu -uu-u u--	dactylic hexameter	masculine penthemimeral, trithemimeral
Ἥφαιστος δ’ἅμα τοῖσι κίε σθένεϊ βλεμεαίνων	--- uu -u u- uu- uu--	dactylic hexameter	feminine penthemimeral, hepthemimeral, trithemimeral
χωλεύων, ὑπὸ δὲ κνῆμαι ῥώοντο ἀραιαί.	--- uu - -- --u u--	dactylic hexameter	masculine penthemimeral, hepthemimeral, trithemimeral
ἐς δὲ Τρῶας Ἄρης κορυθαίολος, αὐτὰρ ἅμ’ αὐτῷ	- - -u u- uu-uu -u u --	dactylic hexameter	masculine penthemimeral
Φοῖβος ἀκερσεκόμης ἠδ’ Ἄρτεμις ἰοχέαιρα	-u u-uu- - -uu -uu--	dactylic hexameter	masculine penthemimeral
Λητώ τε Ξάνθός τε φιλομειδής τ’Ἀφροδίτη.	-- - -- u u--- uu--	dactylic hexameter	masculine penthemimeral, trithemimeral
εἷος μέν ῥ’ἀπάνευθε θεοὶ θνητῶν ἔσαν ἀνδρῶν,	-- - uu-u u- -- uu --	dactylic hexameter	feminine penthemimeral, hepthemimeral, trithemimeral
τεῖος Ἀχαιοὶ μὲν μέγα κύδανον, οὕνεκ’ Ἀχιλλεὺς	-u u-- - uu -uu -u u--	dactylic hexameter	masculine penthemimeral
ἐξεφάνη, δηρὸν δὲ μάχης ἐπέπαυτ’ ἀλεγεινῆς·	-uu- -- u u- uu- uu--	dactylic hexameter	masculine penthemimeral, hepthemimeral, trithemimeral
Τρῶας δὲ τρόμος αἰνὸς ὑπήλυθε γυῖα ἕκαστον	-- - uu -u u-uu -u u--	dactylic hexameter	feminine penthemimeral, trithemimeral
δειδιότας, ὅθ’ ὁρῶντο ποδώκεα Πηλεΐωνα	-uu- u u-u u-uu -uu--	dactylic hexameter	feminine penthemimeral, trithemimeral
τεύχεσι λαμπόμενον βροτολοιγῷ ἶσον Ἄρηϊ.	-uu -uu- uu-- -u u--	dactylic hexameter	masculine penthemimeral
αὐτὰρ ἐπεὶ μεθ’ ὅμιλον Ὀλύμπιοι ἤλυθον ἀνδρῶν,	-u u- u u-u u-uu -uu --	dactylic hexameter	feminine penthemimeral, trithemimeral
ὦρτο δ’Ἔρις κρατερὴ λαοσσόος, αὖε δ’Ἀθήνη	-u u- uu- --uu -u u--	dactylic hexameter	masculine penthemimeral, trithemimeral
στᾶσ’ ὁτὲ μὲν παρὰ τάφρον ὀρυκτὴν τείχεος ἐκτός,	- uu - uu -u u-- -uu --	dactylic hexameter	feminine penthemimeral, trithemimeral
ἄλλοτ’ ἐπ’ ἀκτάων ἐριδούπων μακρὸν ἀΰτει.	-u u --- uu-- -u u--	dactylic hexameter	masculine penthemimeral
αὖε δ’Ἄρης ἑτέρωθεν ἐρεμνῇ λαίλαπι ἶσος	-u u- uu-u u-- -uu --	dactylic hexameter	feminine penthemimeral, trithemimeral
ὀξὺ κατ’ ἀκροτάτης πόλιος Τρώεσσι κελεύων,	-u u -uu- uu- --u u--	dactylic hexameter	masculine penthemimeral, hepthemimeral
ἄλλοτε πὰρ Σιμόεντι θέων ἐπὶ Καλλικολώνῃ.	-uu - uu-u u- uu -uu--	dactylic hexameter	feminine penthemimeral, hepthemimeral, trithemimeral
ὣς τοὺς ἀμφοτέρους μάκαρες θεοὶ ὀτρύνοντες	- - -uu- uu- uu ----	dactylic hexameter	masculine penthemimeral, hepthemimeral
σύμβαλον, ἐν δ’αὐτοῖς ἔριδα ῥήγνυντο βαρεῖαν·	-uu - -- uu- --u u--	dactylic hexameter	masculine penthemimeral, hepthemimeral, trithemimeral
δεινὸν δὲ βρόντησε πατὴρ ἀνδρῶν τε θεῶν τε	-- - --u u- -- u u- -	dactylic hexameter	feminine penthemimeral, hepthemimeral, trithemimeral
ὑψόθεν· αὐτὰρ νέρθε Ποσειδάων ἐτίναξε	-uu -- -u u--- uu--	dactylic hexameter	feminine penthemimeral
γαῖαν ἀπειρεσίην ὀρέων τ’αἰπεινὰ κάρηνα.	-u u-uu- uu- --u u--	dactylic hexameter	masculine penthemimeral, hepthemimeral
πάντες δ’ἐσσείοντο πόδες πολυπίδακος Ἴδης	-- ---u u- uu-uu --	dactylic hexameter	feminine penthemimeral, hepthemimeral
καὶ κορυφαί, Τρώων τε πόλις καὶ νῆες Ἀχαιῶν.	- uu- -- u u- - -u u--	dactylic hexameter	masculine penthemimeral, hepthemimeral, trithemimeral
ἔδεισεν δ’ὑπένερθεν ἄναξ ἐνέρων Ἀϊδωνεύς,	--- uu-u u- uu- uu--	dactylic hexameter	feminine penthemimeral, hepthemimeral, trithemimeral
δείσας δ’ἐκ θρόνου ἆλτο καὶ ἴαχε, μή οἱ ὕπερθε	-- - uu -u u -uu - u u--	dactylic hexameter	feminine penthemimeral, trithemimeral
γαῖαν ἀναρρήξειε Ποσειδάων ἐνοσίχθων,	-u u---u u--- uu--	dactylic hexameter	feminine penthemimeral
οἰκία δὲ θνητοῖσι καὶ ἀθανάτοισι φανείη	-uu - --u u -uu-u u--	dactylic hexameter	feminine penthemimeral, trithemimeral
σμερδαλέ’ εὐρώεντα, τά τε στυγέουσι θεοί περ·	-uu ---u u - uu-u u- -	dactylic hexameter	feminine penthemimeral, hepthemimeral
τόσσος ἄρα κτύπος ὦρτο θεῶν ἔριδι ξυνιόντων.	-u u- uu -u u- uu- uu--	dactylic hexameter	feminine penthemimeral, hepthemimeral, trithemimeral
ἤτοι μὲν γὰρ ἔναντα Ποσειδάωνος ἄνακτος	-- - u u-u u---u u--	dactylic hexameter	feminine penthemimeral, trithemimeral
ἵστατ’ Ἀπόλλων Φοῖβος ἔχων ἰὰ πτερόεντα,	-u u-- -u u- -- uu--	dactylic hexameter	feminine penthemimeral, hepthemimeral
ἄντα δ’Ἐνυαλίοιο θεὰ γλαυκῶπις Ἀθήνη·	-u u-uu-u u- --u u--	dactylic hexameter	feminine penthemimeral, hepthemimeral
Ἥρῃ δ’ἀντέστη χρυσηλάκατος κελαδεινὴ	-- --- --uu- uu--	dactylic hexameter	masculine penthemimeral
Ἄρτεμις ἰοχέαιρα κασιγνήτη ἑκάτοιο·	-uu -uu-u u--- uu--	dactylic hexameter	feminine penthemimeral
Λητοῖ δ’ἀντέστη σῶκος ἐριούνιος Ἑρμῆς,	-- --- -- uu-uu --	dactylic hexameter	masculine penthemimeral, hepthemimeral
ἄντα δ’ἄρ’ Ἡφαίστοιο μέγας ποταμὸς βαθυδίνης,	-u u ---u u- uu- uu--	dactylic hexameter	feminine penthemimeral, hepthemimeral
ὃν Ξάνθον καλέουσι θεοί, ἄνδρες δὲ Σκάμανδρον.	- -- uu-u u- -- u u--	dactylic hexameter	feminine penthemimeral, hepthemimeral, trithemimeral
ὣς οἳ μὲν θεοὶ ἄντα θεῶν ἴσαν· αὐτὰρ Ἀχιλλεὺς	- - - uu -u u- uu -u u--	dactylic hexameter	feminine penthemimeral, hepthemimeral, trithemimeral
Ἕκτορος ἄντα μάλιστα λιλαίετο δῦναι ὅμιλον	-uu -u u-u u-uu -u u--	dactylic hexameter	feminine penthemimeral
Πριαμίδεω· τοῦ γάρ ῥα μάλιστά ἑ θυμὸς ἀνώγει	-uu- - - u u-u u -u u--	dactylic hexameter	masculine penthemimeral, trithemimeral
αἵματος ἆσαι Ἄρηα ταλαύρινον πολεμιστήν.	-uu -u u-u u--- uu--	dactylic hexameter	feminine penthemimeral
Αἰνείαν δ’ἰθὺς λαοσσόος ὦρσεν Ἀπόλλων	--- -- --uu -u u--	dactylic hexameter	masculine penthemimeral, trithemimeral
ἀντία Πηλεΐωνος, ἐνῆκε δέ οἱ μένος ἠΰ·	-uu -uu-u u-u u - uu --	dactylic hexameter	feminine penthemimeral
υἱέϊ δὲ Πριάμοιο Λυκάονι εἴσατο φωνήν·	-uu - uu-u u-uu -uu --	dactylic hexameter	feminine penthemimeral, trithemimeral
τῷ μιν ἐεισάμενος προσέφη Διὸς υἱὸς Ἀπόλλων·	- u u-uu- uu- uu -u u--	dactylic hexameter	masculine penthemimeral, hepthemimeral
Αἰνεία Τρώων βουληφόρε ποῦ τοι ἀπειλαὶ	--- -- --uu - u u--	dactylic hexameter	masculine penthemimeral, trithemimeral
ἃς Τρώων βασιλεῦσιν ὑπίσχεο οἰνοποτάζων	- -- uu-u u-uu -uu--	dactylic hexameter	feminine penthemimeral, trithemimeral
Πηλεΐδεω Ἀχιλῆος ἐναντίβιον πολεμίξειν;	-uu- uu-u u-uu- uu--	dactylic hexameter	feminine penthemimeral, trithemimeral
τὸν δ’αὖτ’ Αἰνείας ἀπαμειβόμενος προσέειπε·	- - --- uu-uu- uu--	dactylic hexameter	masculine penthemimeral
Πριαμίδη τί με ταῦτα καὶ οὐκ ἐθέλοντα κελεύεις	-uu- u u -u u - uu-u u--	dactylic hexameter	feminine penthemimeral, hepthemimeral, trithemimeral
ἀντία Πηλεΐωνος ὑπερθύμοιο μάχεσθαι;	-uu -uu-u u---u u--	dactylic hexameter	feminine penthemimeral
οὐ μὲν γὰρ νῦν πρῶτα ποδώκεος ἄντ’ Ἀχιλῆος	- - - - -u u-uu - uu--	dactylic hexameter	feminine penthemimeral, trithemimeral
στήσομαι, ἀλλ’ ἤδη με καὶ ἄλλοτε δουρὶ φόβησεν	-uu - -- u u -uu -u u--	dactylic hexameter	masculine penthemimeral, trithemimeral
ἐξ Ἴδης, ὅτε βουσὶν ἐπήλυθεν ἡμετέρῃσι,	- -- uu -u u-uu -uu--	dactylic hexameter	feminine penthemimeral, trithemimeral
πέρσε δὲ Λυρνησσὸν καὶ Πήδασον· αὐτὰρ ἐμὲ Ζεὺς	-u u --- - -uu -u u- -	dactylic hexameter	masculine penthemimeral
εἰρύσαθ’, ὅς μοι ἐπῶρσε μένος λαιψηρά τε γοῦνα.	-uu - u u-u u- --u u --	dactylic hexameter	feminine penthemimeral, hepthemimeral, trithemimeral
ἦ κ’ἐδάμην ὑπὸ χερσὶν Ἀχιλλῆος καὶ Ἀθήνης,	- uu- uu -u u--- u u--	dactylic hexameter	feminine penthemimeral, trithemimeral
ἥ οἱ πρόσθεν ἰοῦσα τίθει φάος ἠδ’ ἐκέλευεν	- - -u u-u u- uu - uu--	dactylic hexameter	feminine penthemimeral, hepthemimeral
ἔγχεϊ χαλκείῳ Λέλεγας καὶ Τρῶας ἐναίρειν.	-uu --- uu- - -u u--	dactylic hexameter	masculine penthemimeral, hepthemimeral
τὼ οὐκ ἔστ’ Ἀχιλῆος ἐναντίον ἄνδρα μάχεσθαι·	- - - uu-u u-uu -u u--	dactylic hexameter	feminine penthemimeral, trithemimeral
αἰεὶ γὰρ πάρα εἷς γε θεῶν ὃς λοιγὸν ἀμύνει.	-- - uu - u u- - -u u--	dactylic hexameter	masculine penthemimeral, hepthemimeral, trithemimeral
καὶ δ’ἄλλως τοῦ γ’ἰθὺ βέλος πέτετ’, οὐδ’ ἀπολήγει	- -- - -u u- uu - uu--	dactylic hexameter	feminine penthemimeral, hepthemimeral, trithemimeral
πρὶν χροὸς ἀνδρομέοιο διελθέμεν. εἰ δὲ θεός περ	- uu -uu-u u-uu - u u- -	dactylic hexameter	feminine penthemimeral
ἶσον τείνειεν πολέμου τέλος, οὔ κε μάλα ῥέα	-- --- uu- uu - u u- -	dactylic hexameter	masculine penthemimeral, hepthemimeral
νικήσει’, οὐδ’ εἰ παγχάλκεος εὔχεται εἶναι.	--- - - --uu -uu --	dactylic hexameter	masculine penthemimeral, trithemimeral
τὸν δ’αὖτε προσέειπεν ἄναξ Διὸς υἱὸς Ἀπόλλων·	- -- uu-u u- uu -u u--	dactylic hexameter	feminine penthemimeral, hepthemimeral, trithemimeral
ἥρως ἀλλ’ ἄγε καὶ σὺ θεοῖς αἰειγενέτῃσιν	-- - uu - u u- --uu--	dactylic hexameter	masculine penthemimeral, hepthemimeral, trithemimeral
εὔχεο· καὶ δὲ σέ φασι Διὸς κούρης Ἀφροδίτης	-uu - u u -u u- -- uu--	dactylic hexameter	feminine penthemimeral, hepthemimeral, trithemimeral
ἐκγεγάμεν, κεῖνος δὲ χερείονος ἐκ θεοῦ ἐστίν·	-uu- -- u u-uu - uu --	dactylic hexameter	masculine penthemimeral, trithemimeral
ἣ μὲν γὰρ Διός ἐσθ’, ἣ δ’ἐξ ἁλίοιο γέροντος.	- - - uu - - - uu-u u--	dactylic hexameter	masculine penthemimeral, hepthemimeral, trithemimeral
ἀλλ’ ἰθὺς φέρε χαλκὸν ἀτειρέα, μηδέ σε πάμπαν	- -- uu -u u-uu -u u --	dactylic hexameter	feminine penthemimeral, trithemimeral
λευγαλέοις ἐπέεσσιν ἀποτρεπέτω καὶ ἀρειῇ.	-uu- uu-u u-uu- u u--	dactylic hexameter	feminine penthemimeral, trithemimeral
ὣς εἰπὼν ἔμπνευσε μένος μέγα ποιμένι λαῶν,	- -- --u u- uu -uu --	dactylic hexameter	feminine penthemimeral, hepthemimeral, trithemimeral
βῆ δὲ διὰ προμάχων κεκορυθμένος αἴθοπι χαλκῷ.	- u u- uu- uu-uu -uu --	dactylic hexameter	masculine penthemimeral, trithemimeral
οὐδ’ ἔλαθ’ Ἀγχίσαο πάϊς λευκώλενον Ἥρην	- uu ---u u- --uu --	dactylic hexameter	feminine penthemimeral, hepthemimeral
ἀντία Πηλεΐωνος ἰὼν ἀνὰ οὐλαμὸν ἀνδρῶν·	-uu -uu-u u- uu -uu --	dactylic hexameter	feminine penthemimeral, hepthemimeral
ἣ δ’ἄμυδις στήσασα θεοὺς μετὰ μῦθον ἔειπε·	- uu- --u u- uu -u u--	dactylic hexameter	feminine penthemimeral, hepthemimeral, trithemimeral
φράζεσθον δὴ σφῶϊ Ποσείδαον καὶ Ἀθήνη	--- - -u u--- u u--	dactylic hexameter	feminine penthemimeral, trithemimeral
ἐν φρεσὶν ὑμετέρῃσιν, ὅπως ἔσται τάδε ἔργα.	- uu -uu-u u- -- uu --	dactylic hexameter	feminine penthemimeral, hepthemimeral
Αἰνείας ὅδ’ ἔβη κεκορυθμένος αἴθοπι χαλκῷ	--- u u- uu-uu -uu --	dactylic hexameter	masculine penthemimeral, trithemimeral
ἀντία Πηλεΐωνος, ἀνῆκε δὲ Φοῖβος Ἀπόλλων.	-uu -uu-u u-u u -u u--	dactylic hexameter	feminine penthemimeral
ἀλλ’ ἄγεθ’, ἡμεῖς πέρ μιν ἀποτρωπῶμεν ὀπίσσω	- uu -- - u u---u u--	dactylic hexameter	masculine penthemimeral
αὐτόθεν, ἤ τις ἔπειτα καὶ ἡμείων Ἀχιλῆϊ	-uu - u u-u u --- uu--	dactylic hexameter	feminine penthemimeral, trithemimeral
παρσταίη, δοίη δὲ κράτος μέγα, μηδέ τι θυμῷ	--- -- u u- uu -u u --	dactylic hexameter	masculine penthemimeral, hepthemimeral, trithemimeral
δευέσθω, ἵνα εἰδῇ ὅ μιν φιλέουσιν ἄριστοι	--- uu -u u - uu-u u--	dactylic hexameter	feminine penthemimeral, hepthemimeral, trithemimeral
ἀθανάτων, οἳ δ’αὖτ’ ἀνεμώλιοι οἳ τὸ πάρος περ	-uu- - - uu-uu - u u- -	dactylic hexameter	masculine penthemimeral, trithemimeral
Τρωσὶν ἀμύνουσιν πόλεμον καὶ δηϊοτῆτα.	-u u--- uu- - -uu--	dactylic hexameter	masculine penthemimeral, hepthemimeral
πάντες δ’Οὐλύμποιο κατήλθομεν ἀντιόωντες	-- ---u u-uu -uu--	dactylic hexameter	feminine penthemimeral
τῆσδε μάχης, ἵνα μή τι μετὰ Τρώεσσι πάθῃσι	-u u- uu - u u- --u u--	dactylic hexameter	masculine penthemimeral, hepthemimeral, trithemimeral
σήμερον· ὕστερον αὖτε τὰ πείσεται ἅσσά οἱ αἶσα	-uu -uu -u u -uu -u u --	dactylic hexameter	feminine penthemimeral
γιγνομένῳ ἐπένησε λίνῳ ὅτε μιν τέκε μήτηρ.	-uu- uu-u u- uu - uu --	dactylic hexameter	feminine penthemimeral, hepthemimeral, trithemimeral
εἰ δ’Ἀχιλεὺς οὐ ταῦτα θεῶν ἐκ πεύσεται ὀμφῆς	- uu- - -u u- - -uu --	dactylic hexameter	feminine penthemimeral, hepthemimeral, trithemimeral
δείσετ’ ἔπειθ’, ὅτε κέν τις ἐναντίβιον θεὸς ἔλθῃ	-u u- uu - u u-uu- uu --	dactylic hexameter	masculine penthemimeral, trithemimeral
ἐν πολέμῳ· χαλεποὶ δὲ θεοὶ φαίνεσθαι ἐναργεῖς.	- uu- uu- u u- --u u--	dactylic hexameter	masculine penthemimeral, hepthemimeral, trithemimeral
τὴν δ’ἠμείβετ’ ἔπειτα Ποσειδάων ἐνοσίχθων·	- --u u-u u--- uu--	dactylic hexameter	feminine penthemimeral
Ἥρη μὴ χαλέπαινε παρ’ ἐκ νόον· οὐδέ τί σε χρή.	-- - uu-u u - uu -u u - -	dactylic hexameter	feminine penthemimeral, hepthemimeral, trithemimeral
οὐκ ἂν ἔγωγ’ ἐθέλοιμι θεοὺς ἔριδι ξυνελάσσαι	- u u- uu-u u- uu- uu--	dactylic hexameter	feminine penthemimeral, hepthemimeral, trithemimeral
ἡμέας τοὺς ἄλλους, ἐπεὶ ἦ πολὺ φέρτεροί εἰμεν·	-- - -- uu - uu -uu --	dactylic hexameter	masculine penthemimeral, hepthemimeral, trithemimeral
ἀλλ’ ἡμεῖς μὲν ἔπειτα καθεζώμεσθα κιόντες	- -- u u-u u---u u--	dactylic hexameter	feminine penthemimeral, trithemimeral
ἐκ πάτου ἐς σκοπιήν, πόλεμος δ’ἄνδρεσσι μελήσει.	- uu - uu- uu- --u u--	dactylic hexameter	masculine penthemimeral, hepthemimeral, trithemimeral
εἰ δέ κ’Ἄρης ἄρχωσι μάχης ἢ Φοῖβος Ἀπόλλων,	- u u- --u u- - -u u--	dactylic hexameter	feminine penthemimeral, hepthemimeral, trithemimeral
ἢ Ἀχιλῆ’ ἴσχωσι καὶ οὐκ εἰῶσι μάχεσθαι,	- uu- --u u - --u u--	dactylic hexameter	feminine penthemimeral, hepthemimeral, trithemimeral
αὐτίκ’ ἔπειτα καὶ ἄμμι παρ’ αὐτόθι νεῖκος ὀρεῖται	-u u-u u -u u -uu -u u--	dactylic hexameter	feminine penthemimeral
φυλόπιδος· μάλα δ’ὦκα διακρινθέντας ὀΐω	-uu- uu -u u---u u--	dactylic hexameter	feminine penthemimeral, trithemimeral
ἂψ ἴμεν Οὔλυμπον δὲ θεῶν μεθ’ ὁμήγυριν ἄλλων	- uu --- u u- u u-uu --	dactylic hexameter	masculine penthemimeral, hepthemimeral
ἡμετέρῃς ὑπὸ χερσὶν ἀναγκαίηφι δαμέντας.	-uu- uu -u u---u u--	dactylic hexameter	feminine penthemimeral, trithemimeral
ὣς ἄρα φωνήσας ἡγήσατο κυανοχαίτης	- uu --- --uu -uu--	dactylic hexameter	masculine penthemimeral
τεῖχος ἐς ἀμφίχυτον Ἡρακλῆος θείοιο	-u u -uu- ---- ---	dactylic hexameter	masculine penthemimeral
ὑψηλόν, τό ῥά οἱ Τρῶες καὶ Παλλὰς Ἀθήνη	--- u u - -- - -u u--	dactylic hexameter	masculine penthemimeral, hepthemimeral, trithemimeral
ποίεον, ὄφρα τὸ κῆτος ὑπεκπροφυγὼν ἀλέαιτο,	-uu -u u -u u-uu- uu--	dactylic hexameter	feminine penthemimeral
ὁππότε μιν σεύαιτο ἀπ’ ἠϊόνος πεδίον δέ.	-uu - --u u -uu- uu- -	dactylic hexameter	feminine penthemimeral, trithemimeral
ἔνθα Ποσειδάων κατ’ ἄρ’ ἕζετο καὶ θεοὶ ἄλλοι,	-u u--- u u -uu - uu --	dactylic hexameter	masculine penthemimeral
ἀμφὶ δ’ἄρ’ ἄρρηκτον νεφέλην ὤμοισιν ἕσαντο·	-u u --- uu- --u u--	dactylic hexameter	masculine penthemimeral, hepthemimeral
οἳ δ’ἑτέρωσε καθῖζον ἐπ’ ὀφρύσι Καλλικολώνης	- uu-u u-u u -uu -uu--	dactylic hexameter	feminine penthemimeral
ἀμφὶ σὲ ἤϊε Φοῖβε καὶ Ἄρηα πτολίπορθον.	-u u -uu -u u --- uu--	dactylic hexameter	feminine penthemimeral
ὣς οἳ μέν ῥ’ἑκάτερθε καθήατο μητιόωντες	- - - uu-u u-uu -uu--	dactylic hexameter	feminine penthemimeral, trithemimeral
βουλάς· ἀρχέμεναι δὲ δυσηλεγέος πολέμοιο	-- -uu- u u-uu- uu--	dactylic hexameter	masculine penthemimeral
ὄκνεον ἀμφότεροι, Ζεὺς δ’ἥμενος ὕψι κέλευε.	-uu -uu- - -uu -u u--	dactylic hexameter	masculine penthemimeral
τῶν δ’ἅπαν ἐπλήσθη πεδίον καὶ λάμπετο χαλκῷ	- uu --- uu- - -uu --	dactylic hexameter	masculine penthemimeral, hepthemimeral
ἀνδρῶν ἠδ’ ἵππων· κάρκαιρε δὲ γαῖα πόδεσσιν	-- - -- --u u -u u--	dactylic hexameter	masculine penthemimeral, trithemimeral
ὀρνυμένων ἄμυδις. δύο δ’ἀνέρες ἔξοχ’ ἄριστοι	-uu- uu- uu -uu -u u--	dactylic hexameter	masculine penthemimeral, trithemimeral
ἐς μέσον ἀμφοτέρων συνίτην μεμαῶτε μάχεσθαι	- uu -uu- uu- uu-u u--	dactylic hexameter	masculine penthemimeral, hepthemimeral
Αἰνείας τ’Ἀγχισιάδης καὶ δῖος Ἀχιλλεύς.	--- --uu- - -u u--	dactylic hexameter	hepthemimeral, trithemimeral
Αἰνείας δὲ πρῶτος ἀπειλήσας ἐβεβήκει	--- - -u u--- uu--	dactylic hexameter	feminine penthemimeral, trithemimeral
νευστάζων κόρυθι βριαρῇ· ἀτὰρ ἀσπίδα θοῦριν	--- uu- uu- uu -uu --	dactylic hexameter	masculine penthemimeral, hepthemimeral, trithemimeral
πρόσθεν ἔχε στέρνοιο, τίνασσε δὲ χάλκεον ἔγχος.	-u u- --u u-u u -uu --	dactylic hexameter	feminine penthemimeral, trithemimeral
Πηλεΐδης δ’ἑτέρωθεν ἐναντίον ὦρτο λέων ὣς	-uu- uu-u u-uu -u u- -	dactylic hexameter	feminine penthemimeral, trithemimeral
σίντης, ὅν τε καὶ ἄνδρες ἀποκτάμεναι μεμάασιν	-- - u u -u u-uu- uu--	dactylic hexameter	feminine penthemimeral, trithemimeral
ἀγρόμενοι πᾶς δῆμος· ὃ δὲ πρῶτον μὲν ἀτίζων	-uu- - -u u - -- u u--	dactylic hexameter	feminine penthemimeral, hepthemimeral, trithemimeral
ἔρχεται, ἀλλ’ ὅτε κέν τις ἀρηϊθόων αἰζηῶν	-uu - uu - u u-uu- ---	dactylic hexameter	masculine penthemimeral, trithemimeral
δουρὶ βάλῃ ἐάλη τε χανών, περί τ’ἀφρὸς ὀδόντας	-u u- uu- u u- uu -u u--	dactylic hexameter	masculine penthemimeral, hepthemimeral, trithemimeral
γίγνεται, ἐν δέ τέ οἱ κραδίῃ στένει ἄλκιμον ἦτορ,	-uu - u u - uu- uu -uu --	dactylic hexameter	masculine penthemimeral, hepthemimeral, trithemimeral
οὐρῇ δὲ πλευράς τε καὶ ἰσχία ἀμφοτέρωθεν	-- - -- u u -uu -uu--	dactylic hexameter	masculine penthemimeral, trithemimeral
μαστίεται, ἑὲ δ’αὐτὸν ἐποτρύνει μαχέσασθαι,	-uu- uu -u u--- uu--	dactylic hexameter	feminine penthemimeral, trithemimeral
γλαυκιόων δ’ἰθὺς φέρεται μένει, ἤν τινα πέφνῃ	-uu- -- uu- uu - uu --	dactylic hexameter	masculine penthemimeral, hepthemimeral, trithemimeral
ἀνδρῶν, ἢ αὐτὸς φθίεται πρώτῳ ἐν ὁμίλῳ·	-- - -- uu- -- u u--	dactylic hexameter	masculine penthemimeral, hepthemimeral, trithemimeral
ὣς Ἀχιλῆ’ ὄτρυνε μένος καὶ θυμὸς ἀγήνωρ	- uu- --u u- - -u u--	dactylic hexameter	feminine penthemimeral, hepthemimeral, trithemimeral
ἀντίον ἐλθέμεναι μεγαλήτορος Αἰνείαο.	-uu -uu- uu-uu ----	dactylic hexameter	masculine penthemimeral
οἳ δ’ὅτε δὴ σχεδὸν ἦσαν ἐπ’ ἀλλήλοισιν ἰόντες,	- uu - uu -u u ---u u--	dactylic hexameter	feminine penthemimeral, trithemimeral
τὸν πρότερος προσέειπε ποδάρκης δῖος Ἀχιλλεύς·	- uu- uu-u u-- -u u--	dactylic hexameter	feminine penthemimeral, trithemimeral
Αἰνεία τί σὺ τόσσον ὁμίλου πολλὸν ἐπελθὼν	--- u u -u u-- -u u--	dactylic hexameter	feminine penthemimeral, trithemimeral
ἔστης; ἦ σέ γε θυμὸς ἐμοὶ μαχέσασθαι ἀνώγει	-- - u u -u u- uu-u u--	dactylic hexameter	feminine penthemimeral, hepthemimeral, trithemimeral
ἐλπόμενον Τρώεσσιν ἀνάξειν ἱπποδάμοισι	-uu- --u u-- -uu--	dactylic hexameter	feminine penthemimeral, trithemimeral
τιμῆς τῆς Πριάμου; ἀτὰρ εἴ κεν ἔμ’ ἐξεναρίξῃς,	-- - uu- uu - u u -uu--	dactylic hexameter	masculine penthemimeral, hepthemimeral, trithemimeral
οὔ τοι τοὔνεκά γε Πρίαμος γέρας ἐν χερὶ θήσει·	- - -uu - uu- uu - uu --	dactylic hexameter	masculine penthemimeral, hepthemimeral
εἰσὶν γάρ οἱ παῖδες, ὃ δ’ἔμπεδος οὐδ’ ἀεσίφρων.	-- - - -u u -uu - uu--	dactylic hexameter	feminine penthemimeral, trithemimeral
ἦ νύ τί τοι Τρῶες τέμενος τάμον ἔξοχον ἄλλων	- u u - -- uu- uu -uu --	dactylic hexameter	masculine penthemimeral, hepthemimeral, trithemimeral
καλὸν φυταλιῆς καὶ ἀρούρης, ὄφρα νέμηαι	-- -uu- u u-- -u u--	dactylic hexameter	masculine penthemimeral
αἴ κεν ἐμὲ κτείνῃς; χαλεπῶς δέ σ’ἔολπα τὸ ῥέξειν.	- u u- -- uu- u u-u u --	dactylic hexameter	masculine penthemimeral, hepthemimeral, trithemimeral
ἤδη μὲν σέ γέ φημι καὶ ἄλλοτε δουρὶ φοβῆσαι.	-- - u u -u u -uu -u u--	dactylic hexameter	feminine penthemimeral, trithemimeral
ἦ οὐ μέμνῃ ὅτε πέρ σε βοῶν ἄπο μοῦνον ἐόντα	- -- uu - u u- uu -u u--	dactylic hexameter	masculine penthemimeral, hepthemimeral, trithemimeral
σεῦα κατ’ Ἰδαίων ὀρέων ταχέεσσι πόδεσσι	-u u --- uu- uu-u u--	dactylic hexameter	masculine penthemimeral, hepthemimeral
καρπαλίμως; τότε δ’οὔ τι μετατροπαλίζεο φεύγων.	-uu- uu - u u-uu-uu --	dactylic hexameter	masculine penthemimeral, trithemimeral
ἔνθεν δ’ἐς Λυρνησσὸν ὑπέκφυγες· αὐτὰρ ἐγὼ τὴν	-- - --u u-uu -u u- -	dactylic hexameter	feminine penthemimeral, trithemimeral
πέρσα μεθορμηθεὶς σὺν Ἀθήνῃ καὶ Διὶ πατρί,	-u u--- u u-- - uu --	dactylic hexameter	masculine penthemimeral
ληϊάδας δὲ γυναῖκας ἐλεύθερον ἦμαρ ἀπούρας	-uu- u u-u u-uu -u u--	dactylic hexameter	feminine penthemimeral, trithemimeral
ἦγον· ἀτὰρ σὲ Ζεὺς ἐρρύσατο καὶ θεοὶ ἄλλοι.	-u u- - - --uu - uu --	dactylic hexameter	masculine penthemimeral, trithemimeral
ἀλλ’ οὐ νῦν ἐρύεσθαι ὀΐομαι, ὡς ἐνὶ θυμῷ	- - - uu-u u-uu - uu --	dactylic hexameter	feminine penthemimeral, trithemimeral
βάλλεαι· ἀλλά σ’ἔγωγ’ ἀναχωρήσαντα κελεύω	-uu -u u- uu---u u--	dactylic hexameter	masculine penthemimeral
ἐς πληθὺν ἰέναι, μηδ’ ἀντίος ἵστασ’ ἐμεῖο,	- -- uu- - -uu -u u--	dactylic hexameter	masculine penthemimeral, trithemimeral
πρίν τι κακὸν παθέειν· ῥεχθὲν δέ τε νήπιος ἔγνω.	- u u- uu- -- u u -uu --	dactylic hexameter	masculine penthemimeral, hepthemimeral, trithemimeral
τὸν δ’αὖτ’ Αἰνείας ἀπαμείβετο φώνησέν τε·	- - --- uu-uu --- -	dactylic hexameter	masculine penthemimeral
Πηλεΐδη μὴ δὴ ἐπέεσσί με νηπύτιον ὣς	-uu- - - uu-u u -uu- -	dactylic hexameter	masculine penthemimeral, trithemimeral
ἔλπεο δειδίξεσθαι, ἐπεὶ σάφα οἶδα καὶ αὐτὸς	-uu ---u u- uu -u u --	dactylic hexameter	feminine penthemimeral, hepthemimeral
ἠμὲν κερτομίας ἠδ’ αἴσυλα μυθήσασθαι.	-- -uu- - -uu ----	dactylic hexameter	masculine penthemimeral
ἴδμεν δ’ἀλλήλων γενεήν, ἴδμεν δὲ τοκῆας	-- --- uu- -- u u--	dactylic hexameter	masculine penthemimeral, hepthemimeral
πρόκλυτ’ ἀκούοντες ἔπεα θνητῶν ἀνθρώπων·	-u u--- uu- -- ---	dactylic hexameter	masculine penthemimeral, hepthemimeral
ὄψει δ’οὔτ’ ἄρ πω σὺ ἐμοὺς ἴδες οὔτ’ ἄρ’ ἐγὼ σούς.	-- - - - u u- uu - u u- -	dactylic hexameter	masculine penthemimeral, hepthemimeral, trithemimeral
φασὶ σὲ μὲν Πηλῆος ἀμύμονος ἔκγονον εἶναι,	-u u - --u u-uu -uu --	dactylic hexameter	feminine penthemimeral, trithemimeral
μητρὸς δ’ἐκ Θέτιδος καλλιπλοκάμου ἁλοσύδνης·	-- - uu- --uu- uu--	dactylic hexameter	masculine penthemimeral, trithemimeral
αὐτὰρ ἐγὼν υἱὸς μεγαλήτορος Ἀγχίσαο	-u u- -- uu-uu ----	dactylic hexameter	masculine penthemimeral, trithemimeral
εὔχομαι ἐκγεγάμεν, μήτηρ δέ μοί ἐστ’ Ἀφροδίτη·	-uu -uu- -- u u - uu--	dactylic hexameter	masculine penthemimeral, hepthemimeral
τῶν δὴ νῦν ἕτεροί γε φίλον παῖδα κλαύσονται	- - - uu- u u- -- ---	dactylic hexameter	masculine penthemimeral, hepthemimeral, trithemimeral
σήμερον· οὐ γάρ φημ’ ἐπέεσσί γε νηπυτίοισιν	-uu - - - uu-u u -uu--	dactylic hexameter	masculine penthemimeral, trithemimeral
ὧδε διακρινθέντε μάχης ἐξαπονέεσθαι.	-u u---u u- --uu--	dactylic hexameter	feminine penthemimeral, hepthemimeral
εἰ δ’ἐθέλεις καὶ ταῦτα δαήμεναι, ὄφρ’ ἐῢ εἰδῇς	- uu- - -u u-uu - uu --	dactylic hexameter	feminine penthemimeral, trithemimeral
ἡμετέρην γενεήν, πολλοὶ δέ μιν ἄνδρες ἴσασι·	-uu- uu- -- u u -u u--	dactylic hexameter	masculine penthemimeral, hepthemimeral, trithemimeral
Δάρδανον αὖ πρῶτον τέκετο νεφεληγερέτα Ζεύς,	-uu - -- uu- uu-uu- -	dactylic hexameter	masculine penthemimeral, hepthemimeral, trithemimeral
κτίσσε δὲ Δαρδανίην, ἐπεὶ οὔ πω Ἴλιος ἱρὴ	-u u -uu- uu - - -uu --	dactylic hexameter	masculine penthemimeral, hepthemimeral
ἐν πεδίῳ πεπόλιστο πόλις μερόπων ἀνθρώπων,	- uu- uu-u u- uu- ---	dactylic hexameter	feminine penthemimeral, hepthemimeral, trithemimeral
ἀλλ’ ἔθ’ ὑπωρείας ᾤκεον πολυπίδακος Ἴδης.	- u u--- -- uu-uu --	dactylic hexameter	masculine penthemimeral, hepthemimeral
Δάρδανος αὖ τέκεθ’ υἱὸν Ἐριχθόνιον βασιλῆα,	-uu - uu -u u-uu- uu--	dactylic hexameter	feminine penthemimeral, trithemimeral
ὃς δὴ ἀφνειότατος γένετο θνητῶν ἀνθρώπων·	- --uu- uu- -- ---	dactylic hexameter	masculine penthemimeral, hepthemimeral
τοῦ τρισχίλιαι ἵπποι ἕλος κάτα βουκολέοντο	- --uu -u u- uu -uu--	dactylic hexameter	feminine penthemimeral, hepthemimeral
θήλειαι, πώλοισιν ἀγαλλόμεναι ἀταλῇσι.	--- --u u-uu- uu--	dactylic hexameter	feminine penthemimeral, trithemimeral
τάων καὶ Βορέης ἠράσσατο βοσκομενάων,	-- - uu- --uu -uu--	dactylic hexameter	masculine penthemimeral, trithemimeral
ἵππῳ δ’εἰσάμενος παρελέξατο κυανοχαίτῃ·	-- -uu- uu-uu -uu--	dactylic hexameter	masculine penthemimeral
αἳ δ’ὑποκυσάμεναι ἔτεκον δυοκαίδεκα πώλους.	- uu-uu- uu- uu-uu --	dactylic hexameter	masculine penthemimeral, hepthemimeral
αἳ δ’ὅτε μὲν σκιρτῷεν ἐπὶ ζείδωρον ἄρουραν,	- uu - --u u- --u u--	dactylic hexameter	feminine penthemimeral, hepthemimeral, trithemimeral
ἄκρον ἐπ’ ἀνθερίκων καρπὸν θέον οὐδὲ κατέκλων·	-u u -uu- -- uu -u u--	dactylic hexameter	masculine penthemimeral, hepthemimeral
ἀλλ’ ὅτε δὴ σκιρτῷεν ἐπ’ εὐρέα νῶτα θαλάσσης,	- uu - --u u -uu -u u--	dactylic hexameter	feminine penthemimeral, trithemimeral
ἄκρον ἐπὶ ῥηγμῖνος ἁλὸς πολιοῖο θέεσκον.	-u u- --u u- uu-u u--	dactylic hexameter	feminine penthemimeral, hepthemimeral, trithemimeral
Τρῶα δ’Ἐριχθόνιος τέκετο nbsp;Τρώεσσιν ἄνακτα·	-u u-uu- uu- --u u--	dactylic hexameter	masculine penthemimeral, hepthemimeral
Τρωὸς δ’αὖ τρεῖς παῖδες ἀμύμονες ἐξεγένοντο	-- - - -u u-uu -uu--	dactylic hexameter	feminine penthemimeral, trithemimeral
Ἶλός τ’Ἀσσάρακός τε καὶ ἀντίθεος Γανυμήδης,	-- -uu- u u -uu- uu--	dactylic hexameter	masculine penthemimeral
ὃς δὴ κάλλιστος γένετο θνητῶν ἀνθρώπων·	- - --- uu- -- ---	dactylic hexameter	masculine penthemimeral, hepthemimeral
τὸν καὶ ἀνηρείψαντο θεοὶ Διὶ οἰνοχοεύειν	- u u---u u- uu -uu--	dactylic hexameter	feminine penthemimeral, hepthemimeral
κάλλεος εἵνεκα οἷο ἵν’ ἀθανάτοισι μετείη.	-uu -uu -u u -uu-u u--	dactylic hexameter	feminine penthemimeral
Ἶλος δ’αὖ τέκεθ’ υἱὸν ἀμύμονα Λαομέδοντα·	-- - uu -u u-uu -uu--	dactylic hexameter	feminine penthemimeral, trithemimeral
Λαομέδων δ’ἄρα Τιθωνὸν τέκετο Πρίαμόν τε	-uu- uu --- uu- uu- -	dactylic hexameter	hepthemimeral, trithemimeral
Λάμπόν τε Κλυτίον θ’Ἱκετάονά τ’ὄζον Ἄρηος·	-- - uu- uu-uu -u u--	dactylic hexameter	masculine penthemimeral, trithemimeral
Ἀσσάρακος δὲ Κάπυν, ὃ δ’ἄρ’ Ἀγχίσην τέκε παῖδα·	-uu- u u- u u --- uu --	dactylic hexameter	masculine penthemimeral, trithemimeral
αὐτὰρ ἔμ’ Ἀγχίσης, Πρίαμος δ’ἔτεχ’ Ἕκτορα δῖον.	-u u --- uu- uu -uu --	dactylic hexameter	masculine penthemimeral, hepthemimeral
ταύτης τοι γενεῆς τε καὶ αἵματος εὔχομαι εἶναι.	-- - uu- u u -uu -uu --	dactylic hexameter	masculine penthemimeral, trithemimeral
Ζεὺς δ’ἀρετὴν ἄνδρεσσιν ὀφέλλει τε μινύθει τε	- uu- --u u-- - uu- -	dactylic hexameter	feminine penthemimeral, trithemimeral
ὅππως κεν ἐθέλῃσιν· ὃ γὰρ κάρτιστος ἁπάντων.	-- - uu-u u - --u u--	dactylic hexameter	feminine penthemimeral, hepthemimeral, trithemimeral
ἀλλ’ ἄγε μηκέτι ταῦτα λεγώμεθα νηπύτιοι ὣς	- uu -uu -u u-uu -uu- -	dactylic hexameter	feminine penthemimeral
ἑσταότ’ ἐν μέσσῃ ὑσμίνῃ δηϊοτῆτος.	-uu - -- --- -uu--	dactylic hexameter	masculine penthemimeral, trithemimeral
ἔστι γὰρ ἀμφοτέροισιν ὀνείδεα μυθήσασθαι	-u u -uu-u u-uu ----	dactylic hexameter	feminine penthemimeral
πολλὰ μάλ’, οὐδ’ ἂν νηῦς ἑκατόζυγος ἄχθος ἄροιτο.	-u u - - - uu-uu -u u--	dactylic hexameter	masculine penthemimeral, trithemimeral
στρεπτὴ δὲ γλῶσσ’ ἐστὶ βροτῶν, πολέες δ’ἔνι μῦθοι	-- - - -u u- uu- uu --	dactylic hexameter	feminine penthemimeral, hepthemimeral, trithemimeral
παντοῖοι, ἐπέων δὲ πολὺς νομὸς ἔνθα καὶ ἔνθα.	--- uu- u u- uu -u u --	dactylic hexameter	masculine penthemimeral, hepthemimeral, trithemimeral
ὁπποῖόν κ’εἴπῃσθα ἔπος, τοῖόν κ’ἐπακούσαις.	--- --u u- -- uu--	dactylic hexameter	feminine penthemimeral, hepthemimeral, trithemimeral
ἀλλὰ τί ἢ ἔριδας καὶ νείκεα νῶϊν ἀνάγκη	-u u - uu- - -uu -u u--	dactylic hexameter	masculine penthemimeral, trithemimeral
νεικεῖν ἀλλήλοισιν ἐναντίον ὥς τε γυναῖκας,	-- ---u u-uu - u u--	dactylic hexameter	feminine penthemimeral
αἵ τε χολωσάμεναι ἔριδος πέρι θυμοβόροιο	- u u-uu- uu- uu -uu--	dactylic hexameter	masculine penthemimeral, hepthemimeral
νεικεῦσ’ ἀλλήλῃσι μέσην ἐς ἄγυιαν ἰοῦσαι	-- ---u u- u u-u u--	dactylic hexameter	feminine penthemimeral, hepthemimeral
πόλλ’ ἐτεά τε καὶ οὐκί· χόλος δέ τε καὶ τὰ κελεύει.	- uu- u u -u u- u u - u u--	dactylic hexameter	feminine penthemimeral, hepthemimeral, trithemimeral
ἀλκῆς δ’οὔ μ’ἐπέεσσιν ἀποτρέψεις μεμαῶτα	-- - uu-u u--- uu--	dactylic hexameter	feminine penthemimeral, trithemimeral
πρὶν χαλκῷ μαχέσασθαι ἐναντίον· ἀλλ’ ἄγε θᾶσσον	- -- uu-u u-uu - uu --	dactylic hexameter	feminine penthemimeral, trithemimeral
γευσόμεθ’ ἀλλήλων χαλκήρεσιν ἐγχείῃσιν.	-uu --- --uu ----	dactylic hexameter	masculine penthemimeral
ἦ ῥα καὶ ἐν δεινῷ σάκει ἤλασεν ὄβριμον ἔγχος	- u u - -- uu -uu -uu --	dactylic hexameter	masculine penthemimeral, trithemimeral
σμερδαλέῳ· μέγα δ’ἀμφὶ σάκος μύκε δουρὸς ἀκωκῇ.	-uu- uu -u u- uu -u u--	dactylic hexameter	feminine penthemimeral, hepthemimeral, trithemimeral
Πηλεΐδης δὲ σάκος μὲν ἀπὸ ἕο χειρὶ παχείῃ	-uu- u u- u u- uu -u u--	dactylic hexameter	masculine penthemimeral, hepthemimeral, trithemimeral
ἔσχετο ταρβήσας· φάτο γὰρ δολιχόσκιον ἔγχος	-uu --- uu - uu-uu --	dactylic hexameter	masculine penthemimeral, hepthemimeral
ῥέα διελεύσεσθαι μεγαλήτορος Αἰνείαο	- uu--- uu-uu ----	dactylic hexameter	masculine penthemimeral
νήπιος, οὐδ’ ἐνόησε κατὰ φρένα καὶ κατὰ θυμὸν	-uu - uu-u u- uu - uu --	dactylic hexameter	feminine penthemimeral, hepthemimeral, trithemimeral
ὡς οὐ ῥηΐδι’ ἐστὶ θεῶν ἐρικυδέα δῶρα	- - -uu -u u- uu-uu --	dactylic hexameter	feminine penthemimeral, hepthemimeral
ἀνδράσι γε θνητοῖσι δαμήμεναι οὐδ’ ὑποείκειν.	-uu - --u u-uu - uu--	dactylic hexameter	feminine penthemimeral, trithemimeral
οὐδὲ τότ’ Αἰνείαο δαΐφρονος ὄβριμον ἔγχος	-u u ---u u-uu -uu --	dactylic hexameter	feminine penthemimeral
ῥῆξε σάκος· χρυσὸς γὰρ ἐρύκακε, δῶρα θεοῖο·	-u u- -- u u-uu -u u--	dactylic hexameter	masculine penthemimeral, trithemimeral
ἀλλὰ δύω μὲν ἔλασσε διὰ πτύχας, αἳ δ’ἄρ’ ἔτι τρεῖς	-u u- u u-u u- uu - u u- -	dactylic hexameter	feminine penthemimeral, hepthemimeral, trithemimeral
ἦσαν, ἐπεὶ πέντε πτύχας ἤλασε κυλλοποδίων,	-u u- -- uu -uu -uu--	dactylic hexameter	masculine penthemimeral, trithemimeral
τὰς δύο χαλκείας, δύο δ’ἔνδοθι κασσιτέροιο,	- uu --- uu -uu -uu--	dactylic hexameter	masculine penthemimeral
τὴν δὲ μίαν χρυσῆν, τῇ ῥ’ἔσχετο μείλινον ἔγχος.	- u u- -- - -uu -uu --	dactylic hexameter	masculine penthemimeral, trithemimeral
δεύτερος αὖτ’ Ἀχιλεὺς προΐει δολιχόσκιον ἔγχος,	-uu - uu- uu- uu-uu --	dactylic hexameter	masculine penthemimeral, hepthemimeral, trithemimeral
καὶ βάλεν Αἰνείαο κατ’ ἀσπίδα πάντοσ’ ἐΐσην	- uu ---u u -uu -u u--	dactylic hexameter	feminine penthemimeral
ἄντυγ’ ὕπο πρώτην, ᾗ λεπτότατος θέε χαλκός,	-u u- -- - -uu- uu --	dactylic hexameter	masculine penthemimeral, trithemimeral
λεπτοτάτη δ’ἐπέην ῥινὸς βοός· ἣ δὲ διὰ πρὸ	-uu- uu- -- uu - u u- -	dactylic hexameter	masculine penthemimeral, hepthemimeral, trithemimeral
Πηλιὰς ἤϊξεν μελίη, λάκε δ’ἀσπὶς ὑπ’ αὐτῆς.	-uu --- uu- uu -u u --	dactylic hexameter	masculine penthemimeral, hepthemimeral
Αἰνείας δ’ἐάλη καὶ ἀπὸ ἕθεν ἀσπίδ’ ἀνέσχε	--- uu- u u- uu -u u--	dactylic hexameter	masculine penthemimeral, hepthemimeral, trithemimeral
δείσας· ἐγχείη δ’ἄρ’ ὑπὲρ νώτου ἐνὶ γαίῃ	-- --- u u- -- uu --	dactylic hexameter	masculine penthemimeral, hepthemimeral
ἔστη ἱεμένη, διὰ δ’ἀμφοτέρους ἕλε κύκλους	-- -uu- uu -uu- uu --	dactylic hexameter	masculine penthemimeral
ἀσπίδος ἀμφιβρότης· ὃ δ’ἀλευάμενος δόρυ μακρὸν	-uu -uu- u u-uu- uu --	dactylic hexameter	masculine penthemimeral
ἔστη, κὰδ δ’ἄχος οἱ χύτο μυρίον ὀφθαλμοῖσι,	-- - uu - uu -uu ----	dactylic hexameter	masculine penthemimeral, trithemimeral
ταρβήσας ὅ οἱ ἄγχι πάγη βέλος. αὐτὰρ Ἀχιλλεὺς	--- u u -u u- uu -u u--	dactylic hexameter	feminine penthemimeral, hepthemimeral, trithemimeral
ἐμμεμαὼς ἐπόρουσεν ἐρυσσάμενος ξίφος ὀξὺ	-uu- uu-u u-uu- uu --	dactylic hexameter	feminine penthemimeral, trithemimeral
σμερδαλέα ἰάχων· ὃ δὲ χερμάδιον λάβε χειρὶ	-uu- uu- u u -uu- uu --	dactylic hexameter	masculine penthemimeral, trithemimeral
Αἰνείας, μέγα ἔργον, ὃ οὐ δύο γ’ἄνδρε φέροιεν,	--- uu -u u - uu -u u--	dactylic hexameter	feminine penthemimeral, hepthemimeral, trithemimeral
οἷοι νῦν βροτοί εἰσ’· ὃ δέ μιν ῥέα πάλλε καὶ οἶος.	-- - uu - u u - uu -u u --	dactylic hexameter	masculine penthemimeral, hepthemimeral, trithemimeral
ἔνθά κεν Αἰνείας μὲν ἐπεσσύμενον βάλε πέτρῳ	-u u --- u u-uu- uu --	dactylic hexameter	masculine penthemimeral
ἢ κόρυθ’ ἠὲ σάκος, τό οἱ ἤρκεσε λυγρὸν ὄλεθρον,	- uu -u u- u u -uu -u u--	dactylic hexameter	masculine penthemimeral
τὸν δέ κε Πηλεΐδης σχεδὸν ἄορι θυμὸν ἀπηύρα,	- u u -uu- uu -uu -u u--	dactylic hexameter	masculine penthemimeral
εἰ μὴ ἄρ’ ὀξὺ νόησε Ποσειδάων ἐνοσίχθων·	- u u -u u-u u--- uu--	dactylic hexameter	feminine penthemimeral
αὐτίκα δ’ἀθανάτοισι θεοῖς μετὰ μῦθον ἔειπεν·	-uu -uu-u u- uu -u u--	dactylic hexameter	feminine penthemimeral, hepthemimeral
ὢ πόποι ἦ μοι ἄχος μεγαλήτορος Αἰνείαο,	- uu - u u- uu-uu ----	dactylic hexameter	masculine penthemimeral, trithemimeral
ὃς τάχα Πηλεΐωνι δαμεὶς Ἄϊδος δὲ κάτεισι	- uu -uu-u u- uu- u u--	dactylic hexameter	feminine penthemimeral, hepthemimeral
πειθόμενος μύθοισιν Ἀπόλλωνος ἑκάτοιο	-uu- --u u--- uu--	dactylic hexameter	feminine penthemimeral, trithemimeral
νήπιος, οὐδέ τί οἱ χραισμήσει λυγρὸν ὄλεθρον.	-uu -u u - --- -u u--	dactylic hexameter	masculine penthemimeral
ἀλλὰ τί ἢ νῦν οὗτος ἀναίτιος ἄλγεα πάσχει	-u u - - -u u-uu -uu --	dactylic hexameter	feminine penthemimeral, trithemimeral
μὰψ ἕνεκ’ ἀλλοτρίων ἀχέων, κεχαρισμένα δ’αἰεὶ	- uu -uu- uu- uu-uu --	dactylic hexameter	masculine penthemimeral, hepthemimeral
δῶρα θεοῖσι δίδωσι τοὶ οὐρανὸν εὐρὺν ἔχουσιν;	-u u-u u-u u -uu -u u--	dactylic hexameter	feminine penthemimeral
ἀλλ’ ἄγεθ’ ἡμεῖς πέρ μιν ὑπὲκ θανάτου ἀγάγωμεν,	- uu -- - u u- uu- uu--	dactylic hexameter	masculine penthemimeral, hepthemimeral
μή πως καὶ Κρονίδης κεχολώσεται, αἴ κεν Ἀχιλλεὺς	- - - uu- uu-uu - u u--	dactylic hexameter	masculine penthemimeral, trithemimeral
τόνδε κατακτείνῃ· μόριμον δέ οἵ ἐστ’ ἀλέασθαι,	-u u--- uu- u u - uu--	dactylic hexameter	masculine penthemimeral, hepthemimeral
ὄφρα μὴ ἄσπερμος γενεὴ καὶ ἄφαντος ὄληται	-u u --- uu- u u-u u--	dactylic hexameter	masculine penthemimeral, hepthemimeral
Δαρδάνου, ὃν Κρονίδης περὶ πάντων φίλατο παίδων	-uu - uu- uu -- -uu --	dactylic hexameter	masculine penthemimeral, trithemimeral
οἳ ἕθεν ἐξεγένοντο γυναικῶν τε θνητάων.	- uu -uu-u u-- - ---	dactylic hexameter	feminine penthemimeral
ἤδη γὰρ Πριάμου γενεὴν ἔχθηρε Κρονίων·	-- - uu- uu- --u u--	dactylic hexameter	masculine penthemimeral, hepthemimeral, trithemimeral
νῦν δὲ δὴ Αἰνείαο βίη Τρώεσσιν ἀνάξει	- u u ---u u- --u u--	dactylic hexameter	feminine penthemimeral, hepthemimeral
καὶ παίδων παῖδες, τοί κεν μετόπισθε γένωνται.	- -- -- - - uu-u u--	dactylic hexameter	masculine penthemimeral, hepthemimeral, trithemimeral
τὸν δ’ἠμείβετ’ ἔπειτα βοῶπις πότνια Ἥρη·	- --u u-u u-- -uu --	dactylic hexameter	feminine penthemimeral
ἐννοσίγαι’, αὐτὸς σὺ μετὰ φρεσὶ σῇσι νόησον	-uu- -- u u- uu -u u--	dactylic hexameter	masculine penthemimeral, hepthemimeral, trithemimeral
Αἰνείαν ἤ κέν μιν ἐρύσσεαι ἦ κεν ἐάσῃς	--- - - u u-uu - u u--	dactylic hexameter	masculine penthemimeral, trithemimeral
Πηλεΐδῃ Ἀχιλῆϊ δαμήμεναι, ἐσθλὸν ἐόντα.	-uu- uu-u u-uu -u u--	dactylic hexameter	feminine penthemimeral, trithemimeral
ἤτοι μὲν γὰρ νῶϊ πολέας ὠμόσσαμεν ὅρκους	-- - - -u u- --uu --	dactylic hexameter	feminine penthemimeral, hepthemimeral, trithemimeral
πᾶσι μετ’ ἀθανάτοισιν ἐγὼ καὶ Παλλὰς Ἀθήνη	-u u -uu-u u- - -u u--	dactylic hexameter	feminine penthemimeral, hepthemimeral
μή ποτ’ ἐπὶ Τρώεσσιν ἀλεξήσειν κακὸν ἦμαρ,	- u u- --u u--- uu --	dactylic hexameter	feminine penthemimeral, trithemimeral
μηδ’ ὁπότ’ ἂν Τροίη μαλερῷ πυρὶ πᾶσα δάηται	- uu - -- uu- uu -u u--	dactylic hexameter	masculine penthemimeral, hepthemimeral, trithemimeral
καιομένη, καίωσι δ’ ἀρήϊοι υἷες Ἀχαιῶν.	-uu- --u u-uu -u u--	dactylic hexameter	feminine penthemimeral, trithemimeral
αὐτὰρ ἐπεὶ τό γ’ἄκουσε Ποσειδάων ἐνοσίχθων,	-u u- u u-u u--- uu--	dactylic hexameter	feminine penthemimeral, trithemimeral
βῆ ῥ’ἴμεν ἄν τε μάχην καὶ ἀνὰ κλόνον ἐγχειάων,	- uu - u u- u u- uu ----	dactylic hexameter	masculine penthemimeral, hepthemimeral, trithemimeral
ἷξε δ’ὅθ’ Αἰνείας ἠδ’ ὃ κλυτὸς ἦεν Ἀχιλλεύς.	-u u --- - - uu -u u--	dactylic hexameter	masculine penthemimeral, hepthemimeral
αὐτίκα τῷ μὲν ἔπειτα κατ’ ὀφθαλμῶν χέεν ἀχλὺν	-uu - u u-u u --- uu --	dactylic hexameter	feminine penthemimeral, trithemimeral
Πηλεΐδῃ Ἀχιλῆϊ· ὃ δὲ μελίην εὔχαλκον	-uu- uu-u u - uu- ---	dactylic hexameter	feminine penthemimeral, hepthemimeral, trithemimeral
ἀσπίδος ἐξέρυσεν μεγαλήτορος Αἰνείαο·	-uu -uu- uu-uu ----	dactylic hexameter	masculine penthemimeral
καὶ τὴν μὲν προπάροιθε ποδῶν Ἀχιλῆος ἔθηκεν,	- - - uu-u u- uu-u u--	dactylic hexameter	feminine penthemimeral, hepthemimeral, trithemimeral
Αἰνείαν δ’ἔσσευεν ἀπὸ χθονὸς ὑψόσ’ ἀείρας.	--- --u u- uu -u u--	dactylic hexameter	feminine penthemimeral, hepthemimeral, trithemimeral
πολλὰς δὲ στίχας ἡρώων, πολλὰς δὲ καὶ ἵππων	-- - uu --- -- u u --	dactylic hexameter	hepthemimeral, trithemimeral
Αἰνείας ὑπερᾶλτο θεοῦ ἀπὸ χειρὸς ὀρούσας,	--- uu-u u- uu -u u--	dactylic hexameter	feminine penthemimeral, hepthemimeral, trithemimeral
ἷξε δ’ἐπ’ ἐσχατιὴν πολυάϊκος πολέμοιο,	-u u -uu- uu--- uu--	dactylic hexameter	masculine penthemimeral
ἔνθά τε Καύκωνες πόλεμον μέτα θωρήσσοντο.	-u u --- uu- uu ----	dactylic hexameter	masculine penthemimeral, hepthemimeral
τῷ δὲ μάλ’ ἐγγύθεν ἦλθε Ποσειδάων ἐνοσίχθων,	- u u -uu -u u--- uu--	dactylic hexameter	feminine penthemimeral
καί μιν φωνήσας ἔπεα πτερόεντα προσηύδα·	- - --- uu- uu-u u--	dactylic hexameter	masculine penthemimeral, hepthemimeral
Αἰνεία, τίς σ’ὧδε θεῶν ἀτέοντα κελεύει	--- - -u u- uu-u u--	dactylic hexameter	feminine penthemimeral, hepthemimeral, trithemimeral
ἀντία Πηλεΐωνος ὑπερθύμοιο μάχεσθαι,	-uu -uu-u u---u u--	dactylic hexameter	feminine penthemimeral
ὃς σεῦ ἅμα κρείσσων καὶ φίλτερος ἀθανάτοισιν;	- u u- -- - -uu -uu--	dactylic hexameter	masculine penthemimeral, trithemimeral
ἀλλ’ ἀναχωρῆσαι ὅτε κεν συμβλήσεαι αὐτῷ,	- uu--- uu - --uu --	dactylic hexameter	masculine penthemimeral, hepthemimeral
μὴ καὶ ὑπὲρ μοῖραν δόμον Ἄϊδος εἰσαφίκηαι.	- u u- -- uu -uu -uu--	dactylic hexameter	masculine penthemimeral, trithemimeral
αὐτὰρ ἐπεί κ’Ἀχιλεὺς θάνατον καὶ πότμον ἐπίσπῃ,	-u u- uu- uu- - -u u--	dactylic hexameter	masculine penthemimeral, hepthemimeral, trithemimeral
θαρσήσας δὴ ἔπειτα μετὰ πρώτοισι μάχεσθαι·	--- u u-u u- --u u--	dactylic hexameter	feminine penthemimeral, hepthemimeral, trithemimeral
οὐ μὲν γάρ τίς σ’ἄλλος Ἀχαιῶν ἐξεναρίξει.	- - - - -u u-- -uu--	dactylic hexameter	feminine penthemimeral, trithemimeral
ὣς εἰπὼν λίπεν αὐτόθ’, ἐπεὶ διεπέφραδε πάντα.	- -- uu -u u- uu-uu --	dactylic hexameter	feminine penthemimeral, hepthemimeral, trithemimeral
αἶψα δ’ἔπειτ’ Ἀχιλῆος ἀπ’ ὀφθαλμῶν σκέδασ’ ἀχλὺν	-u u- uu-u u --- uu --	dactylic hexameter	feminine penthemimeral, trithemimeral
θεσπεσίην· ὃ δ’ἔπειτα μέγ’ ἔξιδεν ὀφθαλμοῖσιν,	-uu- u u-u u -uu ----	dactylic hexameter	feminine penthemimeral, trithemimeral
ὀχθήσας δ’ἄρα εἶπε πρὸς ὃν μεγαλήτορα θυμόν·	--- uu -u u - uu-uu --	dactylic hexameter	feminine penthemimeral, hepthemimeral, trithemimeral
ὢ πόποι ἦ μέγα θαῦμα τόδ’ ὀφθαλμοῖσιν ὁρῶμαι·	- uu - uu -u u ---u u--	dactylic hexameter	feminine penthemimeral, trithemimeral
ἔγχος μὲν τόδε κεῖται ἐπὶ χθονός, οὐδέ τι φῶτα	-- - uu -u u- uu -u u --	dactylic hexameter	feminine penthemimeral, hepthemimeral, trithemimeral
λεύσσω, τῷ ἐφέηκα κατακτάμεναι μενεαίνων.	-- - uu-u u-uu- uu--	dactylic hexameter	feminine penthemimeral, trithemimeral
ἦ ῥα καὶ Αἰνείας φίλος ἀθανάτοισι θεοῖσιν	- u u --- uu -uu-u u--	dactylic hexameter	masculine penthemimeral
ἦεν· ἀτάρ μιν ἔφην μὰψ αὔτως εὐχετάασθαι.	-u u- u u- - -- -uu--	dactylic hexameter	masculine penthemimeral, trithemimeral
ἐρρέτω· οὔ οἱ θυμὸς ἐμεῦ ἔτι πειρηθῆναι	-uu - - -u u- uu ----	dactylic hexameter	feminine penthemimeral, hepthemimeral, trithemimeral
ἔσσεται, ὃς καὶ νῦν φύγεν ἄσμενος ἐκ θανάτοιο.	-uu - - - uu -uu - uu--	dactylic hexameter	masculine penthemimeral, trithemimeral
ἀλλ’ ἄγε δὴ Δαναοῖσι φιλοπτολέμοισι κελεύσας	- uu - uu-u u-uu-u u--	dactylic hexameter	feminine penthemimeral, trithemimeral
τῶν ἄλλων Τρώων πειρήσομαι ἀντίος ἐλθών.	- -- -- --uu -uu --	dactylic hexameter	masculine penthemimeral, trithemimeral
ἦ, καὶ ἐπὶ στίχας ἆλτο, κέλευε δὲ φωτὶ ἑκάστῳ·	- u u- uu -u u-u u -u u--	dactylic hexameter	feminine penthemimeral, trithemimeral
μηκέτι νῦν Τρώων ἑκὰς ἕστατε δῖοι Ἀχαιοί,	-uu - -- uu -uu -u u--	dactylic hexameter	masculine penthemimeral, trithemimeral
ἀλλ’ ἄγ’ ἀνὴρ ἄντ’ ἀνδρὸς ἴτω, μεμάτω δὲ μάχεσθαι.	- u u- - -u u- uu- u u--	dactylic hexameter	feminine penthemimeral, hepthemimeral, trithemimeral
ἀργαλέον δέ μοί ἐστι καὶ ἰφθίμῳ περ ἐόντι	-uu- u u -u u --- u u--	dactylic hexameter	feminine penthemimeral, trithemimeral
τοσσούσδ’ ἀνθρώπους ἐφέπειν καὶ πᾶσι μάχεσθαι·	-- --- uu- - -u u--	dactylic hexameter	masculine penthemimeral, hepthemimeral
οὐδέ κ’Ἄρης, ὅς περ θεὸς ἄμβροτος, οὐδέ κ’Ἀθήνη	-u u- - - uu -uu -u u--	dactylic hexameter	masculine penthemimeral, trithemimeral
τοσσῆσδ’ ὑσμίνης ἐφέποι στόμα καὶ πονέοιτο·	-- --- uu- uu - uu--	dactylic hexameter	masculine penthemimeral, hepthemimeral
ἀλλ’ ὅσσον μὲν ἐγὼ δύναμαι χερσίν τε ποσίν τε	- -- u u- uu- -- u u- -	dactylic hexameter	masculine penthemimeral, hepthemimeral, trithemimeral
καὶ σθένει, οὔ μ’ἔτι φημὶ μεθησέμεν οὐδ’ ἠβαιόν,	- uu - uu -u u-uu - ---	dactylic hexameter	feminine penthemimeral, trithemimeral
ἀλλὰ μάλα στιχὸς εἶμι διαμπερές, οὐδέ τιν’ οἴω	-u u- uu -u u-uu -u u --	dactylic hexameter	feminine penthemimeral, trithemimeral
Τρώων χαιρήσειν, ὅς τις σχεδὸν ἔγχεος ἔλθῃ.	-- --- - - uu -uu --	dactylic hexameter	masculine penthemimeral, hepthemimeral
ὣς φάτ’ ἐποτρύνων· Τρώεσσι δὲ φαίδιμος Ἕκτωρ	- u u--- --u u -uu --	dactylic hexameter	masculine penthemimeral
κέκλεθ’ ὁμοκλήσας, φάτο δ’ἴμεναι ἄντ’ Ἀχιλῆος·	-u u--- uu -uu - uu--	dactylic hexameter	masculine penthemimeral
Τρῶες ὑπέρθυμοι μὴ δείδιτε Πηλεΐωνα.	-u u--- - -uu -uu--	dactylic hexameter	masculine penthemimeral
καί κεν ἐγὼ ἐπέεσσι καὶ ἀθανάτοισι μαχοίμην,	- u u- uu-u u -uu-u u--	dactylic hexameter	feminine penthemimeral, trithemimeral
ἔγχεϊ δ’ἀργαλέον, ἐπεὶ ἦ πολὺ φέρτεροί εἰσιν.	-uu -uu- uu - uu -uu --	dactylic hexameter	masculine penthemimeral, hepthemimeral
οὐδ’ Ἀχιλεὺς πάντεσσι τέλος μύθοις ἐπιθήσει,	- uu- --u u- -- uu--	dactylic hexameter	feminine penthemimeral, hepthemimeral, trithemimeral
ἀλλὰ τὸ μὲν τελέει, τὸ δὲ καὶ μεσσηγὺ κολούει.	-u u - uu- u u - --u u--	dactylic hexameter	masculine penthemimeral, hepthemimeral, trithemimeral
τοῦ δ’ἐγὼ ἀντίος εἶμι καὶ εἰ πυρὶ χεῖρας ἔοικεν,	- uu -uu -u u - uu -u u--	dactylic hexameter	feminine penthemimeral, hepthemimeral
εἰ πυρὶ χεῖρας ἔοικε, μένος δ’αἴθωνι σιδήρῳ.	- uu -u u-u u- --u u--	dactylic hexameter	feminine penthemimeral, hepthemimeral
ὣς φάτ’ ἐποτρύνων, οἳ δ’ἀντίοι ἔγχε’ ἄειραν	- u u--- - -uu -u u--	dactylic hexameter	masculine penthemimeral
Τρῶες· τῶν δ’ἄμυδις μίχθη μένος, ὦρτο δ’ἀϋτή.	-- - uu- -- uu -u u--	dactylic hexameter	masculine penthemimeral, hepthemimeral, trithemimeral
καὶ τότ’ ἄρ’ Ἕκτορα εἶπε παραστὰς Φοῖβος Ἀπόλλων·	- u u -uu -u u-- -u u--	dactylic hexameter	feminine penthemimeral
Ἕκτορ μηκέτι πάμπαν Ἀχιλλῆϊ προμάχιζε,	-- -uu -u u--- uu--	dactylic hexameter	feminine penthemimeral
ἀλλὰ κατὰ πληθύν τε καὶ ἐκ φλοίσβοιο δέδεξο,	-u u- -- u u - --u u--	dactylic hexameter	masculine penthemimeral, hepthemimeral, trithemimeral
μή πώς σ’ἠὲ βάλῃ ἠὲ σχεδὸν ἄορι τύψῃ.	- - -u u- -- uu -uu --	dactylic hexameter	masculine penthemimeral, hepthemimeral
ὣς ἔφαθ’, Ἕκτωρ δ’αὖτις ἐδύσετο οὐλαμὸν ἀνδρῶν	- uu -- -u u-uu -uu --	dactylic hexameter	feminine penthemimeral
ταρβήσας, ὅτ’ ἄκουσε θεοῦ ὄπα φωνήσαντος.	--- u u-u u- uu ----	dactylic hexameter	feminine penthemimeral, hepthemimeral, trithemimeral
ἐν δ’Ἀχιλεὺς Τρώεσσι θόρε φρεσὶν εἱμένος ἀλκὴν	- uu- --u u- uu -uu --	dactylic hexameter	feminine penthemimeral, hepthemimeral, trithemimeral
σμερδαλέα ἰάχων, πρῶτον δ’ἕλεν Ἰφιτίωνα	-uu- uu- -- uu -uu--	dactylic hexameter	masculine penthemimeral, hepthemimeral, trithemimeral
ἐσθλὸν Ὀτρυντεΐδην πολέων ἡγήτορα λαῶν,	-u u-uu- uu- --uu --	dactylic hexameter	masculine penthemimeral, hepthemimeral
ὃν νύμφη τέκε νηῒς Ὀτρυντῆϊ πτολιπόρθῳ	- -- uu -u u--- uu--	dactylic hexameter	feminine penthemimeral, trithemimeral
Τμώλῳ ὕπο νιφόεντι Ὕδης ἐν πίονι δήμῳ·	-u u- uu-u u- - -uu --	dactylic hexameter	feminine penthemimeral, hepthemimeral, trithemimeral
τὸν δ’ἰθὺς μεμαῶτα βάλ’ ἔγχεϊ δῖος Ἀχιλλεὺς	- -- uu-u u -uu -u u--	dactylic hexameter	feminine penthemimeral, trithemimeral
μέσσην κὰκ κεφαλήν· ἣ δ’ἄνδιχα πᾶσα κεάσθη,	-- - uu- - -uu -u u--	dactylic hexameter	masculine penthemimeral, trithemimeral
δούπησεν δὲ πεσών, ὃ δ’ἐπεύξατο δῖος Ἀχιλλεύς·	--- u u- u u-uu -u u--	dactylic hexameter	masculine penthemimeral, trithemimeral
κεῖσαι Ὀτρυντεΐδη πάντων ἐκπαγλότατ’ ἀνδρῶν·	-u u-uu- -- --uu --	dactylic hexameter	masculine penthemimeral, hepthemimeral
ἐνθάδε τοι θάνατος, γενεὴ δέ τοί ἐστ’ ἐπὶ λίμνῃ	-uu - uu- uu- u u - uu --	dactylic hexameter	masculine penthemimeral, hepthemimeral, trithemimeral
Γυγαίῃ, ὅθι τοι τέμενος πατρώϊόν ἐστιν	--- uu - uu- --uu --	dactylic hexameter	masculine penthemimeral, hepthemimeral, trithemimeral
Ὕλλῳ ἐπ’ ἰχθυόεντι καὶ Ἕρμῳ δινήεντι.	-u u -uu-u u -- ----	dactylic hexameter	feminine penthemimeral
ὣς ἔφατ’ εὐχόμενος, τὸν δὲ σκότος ὄσσε κάλυψε.	- uu -uu- - - uu -u u--	dactylic hexameter	masculine penthemimeral, hepthemimeral
τὸν μὲν Ἀχαιῶν ἵπποι ἐπισσώτροις δατέοντο	- u u-- -u u--- uu--	dactylic hexameter	feminine penthemimeral
πρώτῃ ἐν ὑσμίνῃ· ὃ δ’ἐπ’ αὐτῷ Δημολέοντα	-u u --- u u -- -uu--	dactylic hexameter	masculine penthemimeral
ἐσθλὸν ἀλεξητῆρα μάχης Ἀντήνορος υἱὸν	-u u---u u- --uu --	dactylic hexameter	feminine penthemimeral, hepthemimeral
νύξε κατὰ κρόταφον, κυνέης διὰ χαλκοπαρῄου.	-u u- uu- uu- uu -uu--	dactylic hexameter	masculine penthemimeral, hepthemimeral, trithemimeral
οὐδ’ ἄρα χαλκείη κόρυς ἔσχεθεν, ἀλλὰ δι’ αὐτῆς	- uu --- uu -uu -u u --	dactylic hexameter	masculine penthemimeral
αἰχμὴ ἱεμένη ῥῆξ’ ὀστέον, ἐγκέφαλος δὲ	-- -uu- - -uu -uu- -	dactylic hexameter	masculine penthemimeral
ἔνδον ἅπας πεπάλακτο· δάμασσε δέ μιν μεμαῶτα.	-u u- uu-u u-u u - uu--	dactylic hexameter	feminine penthemimeral, trithemimeral
Ἱπποδάμαντα δ’ἔπειτα καθ’ ἵππων ἀΐξαντα	-uu-u u-u u -- ----	dactylic hexameter	feminine penthemimeral
πρόσθεν ἕθεν φεύγοντα μετάφρενον οὔτασε δουρί.	-u u- --u u-uu -uu --	dactylic hexameter	feminine penthemimeral, trithemimeral
αὐτὰρ ὃ θυμὸν ἄϊσθε καὶ ἤρυγεν, ὡς ὅτε ταῦρος	-u u -u u-u u -uu - uu --	dactylic hexameter	feminine penthemimeral
ἤρυγεν ἑλκόμενος Ἑλικώνιον ἀμφὶ ἄνακτα	-uu -uu- uu-uu -u u--	dactylic hexameter	masculine penthemimeral
κούρων ἑλκόντων· γάνυται δέ τε τοῖς ἐνοσίχθων·	-- --- uu- u u - uu--	dactylic hexameter	masculine penthemimeral, hepthemimeral
ὣς ἄρα τόν γ’ἐρυγόντα λίπ’ ὀστέα θυμὸς ἀγήνωρ·	- uu - uu-u u -uu -u u--	dactylic hexameter	feminine penthemimeral, trithemimeral
αὐτὰρ ὃ βῆ σὺν δουρὶ μετ’ ἀντίθεον Πολύδωρον	-u u - - -u u -uu- uu--	dactylic hexameter	feminine penthemimeral, trithemimeral
Πριαμίδην. τὸν δ’οὔ τι πατὴρ εἴασκε μάχεσθαι,	-uu- - - u u- --u u--	dactylic hexameter	masculine penthemimeral, hepthemimeral, trithemimeral
οὕνεκά οἱ μετὰ παισὶ νεώτατος ἔσκε γόνοιο,	-uu - uu -u u-uu -u u--	dactylic hexameter	feminine penthemimeral, trithemimeral
καί οἱ φίλτατος ἔσκε, πόδεσσι δὲ πάντας ἐνίκα	- - -uu -u u-u u -u u--	dactylic hexameter	feminine penthemimeral
δὴ τότε νηπιέῃσι ποδῶν ἀρετὴν ἀναφαίνων	- uu -uu-u u- uu- uu--	dactylic hexameter	feminine penthemimeral, hepthemimeral
θῦνε διὰ προμάχων, εἷος φίλον ὤλεσε θυμόν.	-u u- uu- -- uu -uu --	dactylic hexameter	masculine penthemimeral, hepthemimeral, trithemimeral
τὸν βάλε μέσσον ἄκοντι ποδάρκης δῖος Ἀχιλλεὺς	- uu -u u-u u-- -u u--	dactylic hexameter	feminine penthemimeral
νῶτα παραΐσσοντος, ὅθι ζωστῆρος ὀχῆες	-u u---u u- --u u--	dactylic hexameter	feminine penthemimeral, hepthemimeral
χρύσειοι σύνεχον καὶ διπλόος ἤντετο θώρηξ·	--- uu- - -uu -uu --	dactylic hexameter	masculine penthemimeral, trithemimeral
ἀντικρὺ δὲ διέσχε παρ’ ὀμφαλὸν ἔγχεος αἰχμή,	--- u u-u u -uu -uu --	dactylic hexameter	feminine penthemimeral, trithemimeral
γνὺξ δ’ἔριπ’ οἰμώξας, νεφέλη δέ μιν ἀμφεκάλυψε	- uu --- uu- u u -uu--	dactylic hexameter	masculine penthemimeral, hepthemimeral
κυανέη, προτὶ οἷ δ’ἔλαβ’ ἔντερα χερσὶ λιασθείς.	-uu- uu - uu -uu -u u--	dactylic hexameter	masculine penthemimeral, trithemimeral
Ἕκτωρ δ’ὡς ἐνόησε κασίγνητον Πολύδωρον	-- - uu-u u--- uu--	dactylic hexameter	feminine penthemimeral, trithemimeral
ἔντερα χερσὶν ἔχοντα λιαζόμενον ποτὶ γαίη	-uu -u u-u u-uu- uu --	dactylic hexameter	feminine penthemimeral
κάρ ῥά οἱ ὀφθαλμῶν κέχυτ’ ἀχλύς· οὐδ’ ἄρ’ ἔτ’ ἔτλη	- u u --- uu -- - u u --	dactylic hexameter	masculine penthemimeral
δηρὸν ἑκὰς στρωφᾶσθ’, ἀλλ’ ἀντίος ἦλθ’ Ἀχιλῆϊ	-u u- -- - -uu - uu--	dactylic hexameter	masculine penthemimeral, trithemimeral
ὀξὺ δόρυ κραδάων φλογὶ εἴκελος· αὐτὰρ Ἀχιλλεὺς	-u u- uu- uu -uu -u u--	dactylic hexameter	masculine penthemimeral, trithemimeral
ὡς εἶδ’, ὣς ἀνεπᾶλτο, καὶ εὐχόμενος ἔπος ηὔδα·	- - - uu-u u -uu- uu --	dactylic hexameter	feminine penthemimeral, trithemimeral
ἐγγὺς ἀνὴρ ὃς ἐμόν γε μάλιστ’ ἐσεμάσσατο θυμόν,	-u u- u u- u u- uu-uu --	dactylic hexameter	masculine penthemimeral, hepthemimeral, trithemimeral
ὅς μοι ἑταῖρον ἔπεφνε τετιμένον· οὐδ’ ἂν ἔτι δὴν	- u u-u u-u u-uu - u u- -	dactylic hexameter	feminine penthemimeral
ἀλλήλους πτώσσοιμεν ἀνὰ πτολέμοιο γεφύρας.	--- --u u- uu-u u--	dactylic hexameter	feminine penthemimeral, hepthemimeral, trithemimeral
ἦ, καὶ ὑπόδρα ἰδὼν προσεφώνεεν Ἕκτορα δῖον·	- u u-u u- uu-uu -uu --	dactylic hexameter	masculine penthemimeral
ἆσσον ἴθ’ ὥς κεν θᾶσσον ὀλέθρου πείραθ’ ἵκηαι.	-u u - - -u u-- -u u--	dactylic hexameter	feminine penthemimeral, trithemimeral
τὸν δ’οὐ ταρβήσας προσέφη κορυθαίολος Ἕκτωρ·	- - --- uu- uu-uu --	dactylic hexameter	masculine penthemimeral, hepthemimeral
Πηλεΐδη μὴ δὴ ἐπέεσσί με νηπύτιον ὣς	-uu- - - uu-u u -uu- -	dactylic hexameter	masculine penthemimeral, trithemimeral
ἔλπεο δειδίξεσθαι, ἐπεὶ σάφα οἶδα καὶ αὐτὸς	-uu ---u u- uu -u u --	dactylic hexameter	feminine penthemimeral, hepthemimeral
ἠμὲν κερτομίας ἠδ’ αἴσυλα μυθήσασθαι.	-- -uu- - -uu ----	dactylic hexameter	masculine penthemimeral
οἶδα δ’ὅτι σὺ μὲν ἐσθλός, ἐγὼ δὲ σέθεν πολὺ χείρων.	-u u- u u -u u- u u- uu --	dactylic hexameter	feminine penthemimeral, hepthemimeral, trithemimeral
ἀλλ’ ἤτοι μὲν ταῦτα θεῶν ἐν γούνασι κεῖται,	- -- - -u u- - -uu --	dactylic hexameter	feminine penthemimeral, hepthemimeral, trithemimeral
αἴ κέ σε χειρότερός περ ἐὼν ἀπὸ θυμὸν ἕλωμαι	- u u -uu- u u- uu -u u--	dactylic hexameter	masculine penthemimeral, hepthemimeral
δουρὶ βαλών, ἐπεὶ ἦ καὶ ἐμὸν βέλος ὀξὺ πάροιθεν.	-u u- uu - u u- uu -u u--	dactylic hexameter	masculine penthemimeral, hepthemimeral, trithemimeral
ἦ ῥα, καὶ ἀμπεπαλὼν προΐει δόρυ, καὶ τό γ’Ἀθήνη	- u u -uu- uu- uu - u u--	dactylic hexameter	masculine penthemimeral, hepthemimeral
πνοιῇ Ἀχιλλῆος πάλιν ἔτραπε κυδαλίμοιο	-u u--- uu -uu -uu--	dactylic hexameter	masculine penthemimeral
ἦκα μάλα ψύξασα· τὸ δ’ἂψ ἵκεθ’ Ἕκτορα δῖον,	-u u- --u u - uu -uu --	dactylic hexameter	feminine penthemimeral, hepthemimeral, trithemimeral
αὐτοῦ δὲ προπάροιθε ποδῶν πέσεν. αὐτὰρ Ἀχιλλεὺς	-- - uu-u u- uu -u u--	dactylic hexameter	feminine penthemimeral, hepthemimeral, trithemimeral
ἐμμεμαὼς ἐπόρουσε κατακτάμεναι μενεαίνων,	-uu- uu-u u-uu- uu--	dactylic hexameter	feminine penthemimeral, trithemimeral
σμερδαλέα ἰάχων· τὸν δ’ἐξήρπαξεν Ἀπόλλων	-uu- uu- - ---u u--	dactylic hexameter	masculine penthemimeral, trithemimeral
ῥεῖα μάλ’ ὥς τε θεός, ἐκάλυψε δ’ἄρ’ ἠέρι πολλῇ.	-u u - u u- uu-u u -uu --	dactylic hexameter	masculine penthemimeral, trithemimeral
τρὶς μὲν ἔπειτ’ ἐπόρουσε ποδάρκης δῖος Ἀχιλλεὺς	- u u- uu-u u-- -u u--	dactylic hexameter	feminine penthemimeral, trithemimeral
ἔγχεϊ χαλκείῳ, τρὶς δ’ἠέρα τύψε βαθεῖαν.	-uu --- - -uu -u u--	dactylic hexameter	masculine penthemimeral
ἀλλ’ ὅτε δὴ τὸ τέταρτον ἐπέσσυτο δαίμονι ἶσος,	- uu - u u-u u-uu -uu --	dactylic hexameter	feminine penthemimeral, trithemimeral
δεινὰ δ’ὁμοκλήσας ἔπεα πτερόεντα προσηύδα·	-u u--- uu- uu-u u--	dactylic hexameter	masculine penthemimeral, hepthemimeral
ἐξ αὖ νῦν ἔφυγες θάνατον κύον· ἦ τέ τοι ἄγχι	- - - uu- uu- uu - u u --	dactylic hexameter	masculine penthemimeral, hepthemimeral, trithemimeral
ἦλθε κακόν· νῦν αὖτέ σ’ ἐρύσατο Φοῖβος Ἀπόλλων,	-u u- - -u u-uu -u u--	dactylic hexameter	feminine penthemimeral, trithemimeral
ᾧ μέλλεις εὔχεσθαι ἰὼν ἐς δοῦπον ἀκόντων.	- -- --u u- - -u u--	dactylic hexameter	feminine penthemimeral, hepthemimeral, trithemimeral
ἦ θήν σ’ἐξανύω γε καὶ ὕστερον ἀντιβολήσας,	- - -uu- u u -uu -uu--	dactylic hexameter	masculine penthemimeral
εἴ πού τις καὶ ἔμοιγε θεῶν ἐπιτάρροθός ἐστι.	- - - u u-u u- uu-uu --	dactylic hexameter	feminine penthemimeral, hepthemimeral, trithemimeral
νῦν αὖ τοὺς ἄλλους ἐπιείσομαι, ὅν κε κιχείω.	- - - -- uu-uu - u u--	dactylic hexameter	masculine penthemimeral, trithemimeral
ὣς εἰπὼν Δρύοπ’ οὖτα κατ’ αὐχένα μέσσον ἄκοντι·	- -- uu -u u -uu -u u--	dactylic hexameter	feminine penthemimeral, trithemimeral
ἤριπε δὲ προπάροιθε ποδῶν· ὃ δὲ τὸν μὲν ἔασε,	-uu - uu-u u- u u - u u--	dactylic hexameter	feminine penthemimeral, hepthemimeral, trithemimeral
Δημοῦχον δὲ Φιλητορίδην ἠΰν τε μέγαν τε	--- u u-uu- -- u u- -	dactylic hexameter	hepthemimeral, trithemimeral
κὰγ γόνυ δουρὶ βαλὼν ἠρύκακε. τὸν μὲν ἔπειτα	- uu -u u- --uu - u u--	dactylic hexameter	masculine penthemimeral
οὐτάζων ξίφεϊ μεγάλῳ ἐξαίνυτο θυμόν·	--- uu- uu- --uu --	dactylic hexameter	masculine penthemimeral, hepthemimeral, trithemimeral
αὐτὰρ ὃ Λαόγονον καὶ Δάρδανον υἷε Βίαντος	-u u -uu- - -uu -u u--	dactylic hexameter	masculine penthemimeral
ἄμφω ἐφορμηθεὶς ἐξ ἵππων ὦσε χαμᾶζε,	-u u--- - -- -u u--	dactylic hexameter	masculine penthemimeral
τὸν μὲν δουρὶ βαλών, τὸν δὲ σχεδὸν ἄορι τύψας.	- - -u u- - - uu -uu --	dactylic hexameter	masculine penthemimeral, hepthemimeral
Τρῶα δ’Ἀλαστορίδην, ὃ μὲν ἀντίος ἤλυθε γούνων,	-u u-uu- u u -uu -uu --	dactylic hexameter	masculine penthemimeral
εἴ πώς εὑ πεφίδοιτο λαβὼν καὶ ζωὸν ἀφείη	- - - uu-u u- - -u u--	dactylic hexameter	feminine penthemimeral, hepthemimeral, trithemimeral
μηδὲ κατακτείνειεν ὁμηλικίην ἐλεήσας,	-u u---u u-uu- uu--	dactylic hexameter	feminine penthemimeral
νήπιος, οὐδὲ τὸ ᾔδη ὃ οὐ πείσεσθαι ἔμελλεν·	-uu -u u -u u - --u u--	dactylic hexameter	feminine penthemimeral, hepthemimeral
οὐ γάρ τι γλυκύθυμος ἀνὴρ ἦν οὐδ’ ἀγανόφρων,	- - - uu-u u- - - uu--	dactylic hexameter	feminine penthemimeral, hepthemimeral, trithemimeral
ἀλλὰ μάλ’ ἐμμεμαώς· ὃ μὲν ἥπτετο χείρεσι γούνων	-u u -uu- u u -uu -uu --	dactylic hexameter	masculine penthemimeral
ἱέμενος λίσσεσθ’, ὃ δὲ φασγάνῳ οὖτα καθ’ ἧπαρ·	-uu- -- u u -uu -u u --	dactylic hexameter	masculine penthemimeral, trithemimeral
ἐκ δέ οἱ ἧπαρ ὄλισθεν, ἀτὰρ μέλαν αἷμα κατ’ αὐτοῦ	- u u -u u-u u- uu -u u --	dactylic hexameter	feminine penthemimeral, hepthemimeral
κόλπον ἐνέπλησεν· τὸν δὲ σκότος ὄσσε κάλυψε	-u u--- - - uu -u u--	dactylic hexameter	masculine penthemimeral, hepthemimeral
θυμοῦ δευόμενον· ὃ δὲ Μούλιον οὖτα παραστὰς	-- -uu- u u -uu -u u--	dactylic hexameter	masculine penthemimeral
δουρὶ κατ’ οὖς· εἶθαρ δὲ δι’ οὔατος ἦλθ’ ἑτέροιο	-u u - -- u u -uu - uu--	dactylic hexameter	masculine penthemimeral, trithemimeral
αἰχμὴ χαλκείη· ὃ δ’Ἀγήνορος υἱὸν Ἔχεκλον	-- --- u u-uu -u u--	dactylic hexameter	masculine penthemimeral
μέσσην κὰκ κεφαλὴν ξίφει ἤλασε κωπήεντι,	-- - uu- uu -uu ----	dactylic hexameter	masculine penthemimeral, trithemimeral
πᾶν δ’ὑπεθερμάνθη ξίφος αἵματι· τὸν δὲ κατ’ ὄσσε	- uu--- uu -uu - u u --	dactylic hexameter	masculine penthemimeral
ἔλλαβε πορφύρεος θάνατος καὶ μοῖρα κραταιή.	-uu -uu- uu- - -u u--	dactylic hexameter	masculine penthemimeral, hepthemimeral
Δευκαλίωνα δ’ἔπειθ’, ἵνα τε ξυνέχουσι τένοντες	-uu-u u- uu - uu-u u--	dactylic hexameter	masculine penthemimeral, hepthemimeral
ἀγκῶνος, τῇ τόν γε φίλης διὰ χειρὸς ἔπειρεν	--- - - u u- uu -u u--	dactylic hexameter	masculine penthemimeral, hepthemimeral, trithemimeral
αἰχμῇ χαλκείῃ· ὃ δέ μιν μένε χεῖρα βαρυνθεὶς	-- --- u u - uu -u u--	dactylic hexameter	masculine penthemimeral, hepthemimeral
πρόσθ’ ὁρόων θάνατον· ὃ δὲ φασγάνῳ αὐχένα θείνας	- uu- uu- u u -uu -uu --	dactylic hexameter	masculine penthemimeral, trithemimeral
τῆλ’ αὐτῇ πήληκι κάρη βάλε· μυελὸς αὖτε	- -- --u u- uu -uu --	dactylic hexameter	feminine penthemimeral, hepthemimeral, trithemimeral
σφονδυλίων ἔκπαλθ’, ὃ δ’ἐπὶ χθονὶ κεῖτο τανυσθείς.	-uu- -- u u- uu -u u--	dactylic hexameter	masculine penthemimeral, hepthemimeral, trithemimeral
αὐτὰρ ὃ βῆ ῥ’ἰέναι μετ’ ἀμύμονα Πείρεω υἱὸν	-u u - uu- u u-uu -uu --	dactylic hexameter	masculine penthemimeral, trithemimeral
’Ρίγμον, ὃς ἐκ Θρῄκης ἐριβώλακος εἰληλούθει·	-u u - -- uu-uu ----	dactylic hexameter	masculine penthemimeral, trithemimeral
τὸν βάλε μέσσον ἄκοντι, πάγη δ’ἐν νηδύϊ χαλκός,	- uu -u u-u u- - -uu --	dactylic hexameter	feminine penthemimeral, hepthemimeral
ἤριπε δ’ἐξ ὀχέων· ὃ δ’Ἀρηΐθοον θεράποντα	-uu - uu- u u-uu- uu--	dactylic hexameter	masculine penthemimeral, trithemimeral
ἂψ ἵππους στρέψαντα μετάφρενον ὀξέϊ δουρὶ	- -- --u u-uu -uu --	dactylic hexameter	feminine penthemimeral, trithemimeral
νύξ’, ἀπὸ δ’ἅρματος ὦσε· κυκήθησαν δέ οἱ ἵπποι.	- uu -uu -u u--- u u --	dactylic hexameter	feminine penthemimeral
ὡς δ’ἀναμαιμάει βαθέ’ ἄγκεα θεσπιδαὲς πῦρ	- uu--- uu -uu -uu- -	dactylic hexameter	masculine penthemimeral
οὔρεος ἀζαλέοιο, βαθεῖα δὲ καίεται ὕλη,	-uu -uu-u u-u u -uu --	dactylic hexameter	feminine penthemimeral
πάντῃ τε κλονέων ἄνεμος φλόγα εἰλυφάζει,	-- - uu- uu- uu ----	dactylic hexameter	masculine penthemimeral, hepthemimeral, trithemimeral
ὣς ὅ γε πάντῃ θῦνε σὺν ἔγχεϊ δαίμονι ἶσος	- u u -- -u u -uu -uu --	dactylic hexameter	feminine penthemimeral
κτεινομένους ἐφέπων· ῥέε δ’αἵματι γαῖα μέλαινα.	-uu- uu- uu -uu -u u--	dactylic hexameter	masculine penthemimeral, trithemimeral
ὡς δ’ὅτε τις ζεύξῃ βόας ἄρσενας εὐρυμετώπους	- uu - -- uu -uu -uu--	dactylic hexameter	masculine penthemimeral, trithemimeral
τριβέμεναι κρῖ λευκὸν ἐϋκτιμένῃ ἐν ἀλωῇ,	-uu- - -u u-uu- u u--	dactylic hexameter	feminine penthemimeral, trithemimeral
ῥίμφά τε λέπτ’ ἐγένοντο βοῶν ὑπὸ πόσσ’ ἐριμύκων,	-u u - uu-u u- uu - uu--	dactylic hexameter	feminine penthemimeral, hepthemimeral, trithemimeral
ὣς ὑπ’ Ἀχιλλῆος μεγαθύμου μώνυχες ἵπποι	- u u--- uu-- -uu --	dactylic hexameter	masculine penthemimeral
στεῖβον ὁμοῦ νέκυάς τε καὶ ἀσπίδας· αἵματι δ’ἄξων	-u u- uu- u u -uu -uu --	dactylic hexameter	masculine penthemimeral, trithemimeral
νέρθεν ἅπας πεπάλακτο καὶ ἄντυγες αἳ περὶ δίφρον,	-u u- uu-u u -uu - uu --	dactylic hexameter	feminine penthemimeral, trithemimeral
ἃς ἄρ’ ἀφ’ ἱππείων ὁπλέων ῥαθάμιγγες ἔβαλλον	- u u --- -- uu-u u--	dactylic hexameter	masculine penthemimeral, hepthemimeral
αἵ τ’ἀπ’ ἐπισσώτρων· ὃ δὲ ἵετο κῦδος ἀρέσθαι	- u u--- u u -uu -u u--	dactylic hexameter	masculine penthemimeral
Πηλεΐδης, λύθρῳ δὲ παλάσσετο χεῖρας ἀάπτους.	-uu- -- u u-uu -u u--	dactylic hexameter	masculine penthemimeral, trithemimeral
