Ζεὺς δ’ἐπεὶ οὖν Τρῶάς τε καὶ Ἕκτορα νηυσὶ πέλασσε,	- uu - -- u u -uu -u u--	dactylic hexameter	masculine penthemimeral, trithemimeral
τοὺς μὲν ἔα παρὰ τῇσι πόνον τ’ἐχέμεν καὶ ὀϊζὺν	- u u- uu -u u- uu- u u--	dactylic hexameter	feminine penthemimeral, hepthemimeral, trithemimeral
νωλεμέως, αὐτὸς δὲ πάλιν τρέπεν ὄσσε φαεινὼ	-uu- -- u u- uu -u u--	dactylic hexameter	masculine penthemimeral, hepthemimeral, trithemimeral
νόσφιν ἐφ’ ἱπποπόλων Θρῃκῶν καθορώμενος αἶαν	-u u -uu- -- uu-uu --	dactylic hexameter	masculine penthemimeral, hepthemimeral
Μυσῶν τ’ἀγχεμάχων καὶ ἀγαυῶν ἱππημολγῶν	-- -uu- u u-- ----	dactylic hexameter	masculine penthemimeral
γλακτοφάγων Ἀβίων τε δικαιοτάτων ἀνθρώπων.	-uu- uu- u u-uu- ---	dactylic hexameter	masculine penthemimeral, trithemimeral
ἐς Τροίην δ’οὐ πάμπαν ἔτι τρέπεν ὄσσε φαεινώ·	- -- - -u u- uu -u u--	dactylic hexameter	feminine penthemimeral, hepthemimeral, trithemimeral
οὐ γὰρ ὅ γ’ἀθανάτων τινα ἔλπετο ὃν κατὰ θυμὸν	- u u -uu- uu -uu - uu --	dactylic hexameter	masculine penthemimeral
ἐλθόντ’ ἢ Τρώεσσιν ἀρηξέμεν ἢ Δαναοῖσιν.	-- - --u u-uu - uu--	dactylic hexameter	feminine penthemimeral, trithemimeral
οὐδ’ ἀλαοσκοπιὴν εἶχε κρείων ἐνοσίχθων·	- uu-uu- -- -- uu--	dactylic hexameter	masculine penthemimeral, hepthemimeral
καὶ γὰρ ὃ θαυμάζων ἧστο πτόλεμόν τε μάχην τε	- u u --- -- uu- u u- -	dactylic hexameter	masculine penthemimeral, hepthemimeral
ὑψοῦ ἐπ’ ἀκροτάτης κορυφῆς Σάμου ὑληέσσης	-u u -uu- uu- uu ----	dactylic hexameter	masculine penthemimeral, hepthemimeral
Θρηϊκίης· ἔνθεν γὰρ ἐφαίνετο πᾶσα μὲν Ἴδη,	-uu- -- u u-uu -u u --	dactylic hexameter	masculine penthemimeral, trithemimeral
φαίνετο δὲ Πριάμοιο πόλις καὶ νῆες Ἀχαιῶν.	-uu - uu-u u- - -u u--	dactylic hexameter	feminine penthemimeral, hepthemimeral, trithemimeral
ἔνθ’ ἄρ’ ὅ γ’ἐξ ἁλὸς ἕζετ’ ἰών, ἐλέαιρε δ’Ἀχαιοὺς	- u u - uu -u u- uu-u u--	dactylic hexameter	feminine penthemimeral, hepthemimeral, trithemimeral
Τρωσὶν δαμναμένους, Διὶ δὲ κρατερῶς ἐνεμέσσα.	-- -uu- uu - uu- uu--	dactylic hexameter	masculine penthemimeral, hepthemimeral
αὐτίκα δ’ἐξ ὄρεος κατεβήσετο παιπαλόεντος	-uu - uu- uu-uu -uu--	dactylic hexameter	masculine penthemimeral, trithemimeral
κραιπνὰ ποσὶ προβιβάς· τρέμε δ’οὔρεα μακρὰ καὶ ὕλη	-u u- uu- uu -uu -u u --	dactylic hexameter	masculine penthemimeral, trithemimeral
ποσσὶν ὑπ’ ἀθανάτοισι Ποσειδάωνος ἰόντος.	-u u -uu-u u---u u--	dactylic hexameter	feminine penthemimeral
τρὶς μὲν ὀρέξατ’ ἰών, τὸ δὲ τέτρατον ἵκετο τέκμωρ	- u u-u u- u u -uu -uu --	dactylic hexameter	masculine penthemimeral
Αἰγάς, ἔνθα δέ οἱ κλυτὰ δώματα βένθεσι λίμνης	-- -u u - uu -uu -uu --	dactylic hexameter	masculine penthemimeral
χρύσεα μαρμαίροντα τετεύχαται ἄφθιτα αἰεί.	-uu ---u u-uu -uu --	dactylic hexameter	feminine penthemimeral
ἔνθ’ ἐλθὼν ὑπ’ ὄχεσφι τιτύσκετο χαλκόποδ’ ἵππω	- -- u u-u u-uu -uu --	dactylic hexameter	feminine penthemimeral, trithemimeral
ὠκυπέτα χρυσέῃσιν ἐθείρῃσιν κομόωντε,	-uu- uu-u u--- uu--	dactylic hexameter	feminine penthemimeral, trithemimeral
χρυσὸν δ’αὐτὸς ἔδυνε περὶ χροΐ, γέντο δ’ἱμάσθλην	-- -u u-u u- uu -u u--	dactylic hexameter	feminine penthemimeral, hepthemimeral
χρυσείην εὔτυκτον, ἑοῦ δ’ἐπεβήσετο δίφρου,	--- --u u- uu-uu --	dactylic hexameter	feminine penthemimeral, hepthemimeral, trithemimeral
βῆ δ’ἐλάαν ἐπὶ κύματ’· ἄταλλε δὲ κήτε’ ὑπ’ αὐτοῦ	- uu- uu -u u-u u -u u --	dactylic hexameter	feminine penthemimeral, trithemimeral
πάντοθεν ἐκ κευθμῶν, οὐδ’ ἠγνοίησεν ἄνακτα·	-uu - -- - ---u u--	dactylic hexameter	masculine penthemimeral, trithemimeral
γηθοσύνῃ δὲ θάλασσα διίστατο· τοὶ δὲ πέτοντο	-uu- u u-u u-uu - u u--	dactylic hexameter	feminine penthemimeral, trithemimeral
ῥίμφα μάλ’, οὐδ’ ὑπένερθε διαίνετο χάλκεος ἄξων·	-u u - uu-u u-uu -uu --	dactylic hexameter	feminine penthemimeral, trithemimeral
τὸν δ’ἐς Ἀχαιῶν νῆας ἐΰσκαρθμοι φέρον ἵπποι.	- u u-- -u u--- uu --	dactylic hexameter	feminine penthemimeral
ἔστι δέ τι σπέος εὐρὺ βαθείης βένθεσι λίμνης	-u u - uu -u u-- -uu --	dactylic hexameter	feminine penthemimeral, trithemimeral
μεσσηγὺς Τενέδοιο καὶ Ἴμβρου παιπαλοέσσης·	--- uu-u u -- -uu--	dactylic hexameter	feminine penthemimeral, trithemimeral
ἔνθ’ ἵππους ἔστησε Ποσειδάων ἐνοσίχθων	- -- --u u--- uu--	dactylic hexameter	feminine penthemimeral, trithemimeral
λύσας ἐξ ὀχέων, παρὰ δ’ἀμβρόσιον βάλεν εἶδαρ	-- - uu- uu -uu- uu --	dactylic hexameter	masculine penthemimeral, trithemimeral
ἔδμεναι· ἀμφὶ δὲ ποσσὶ πέδας ἔβαλε χρυσείας	-uu -u u -u u- uu- ---	dactylic hexameter	feminine penthemimeral, hepthemimeral
ἀρρήκτους ἀλύτους, ὄφρ’ ἔμπεδον αὖθι μένοιεν	--- uu- - -uu -u u--	dactylic hexameter	masculine penthemimeral, trithemimeral
νοστήσαντα ἄνακτα· ὃ δ’ἐς στρατὸν ᾤχετ’ Ἀχαιῶν.	---u u-u u - uu -u u--	dactylic hexameter	feminine penthemimeral, hepthemimeral
Τρῶες δὲ φλογὶ ἶσοι ἀολλέες ἠὲ θυέλλῃ	-- - uu -u u-uu -u u--	dactylic hexameter	feminine penthemimeral, trithemimeral
Ἕκτορι Πριαμίδῃ ἄμοτον μεμαῶτες ἕποντο	-uu -uu- uu- uu-u u--	dactylic hexameter	masculine penthemimeral, hepthemimeral
ἄβρομοι αὐΐαχοι· ἔλποντο δὲ νῆας Ἀχαιῶν	-uu -uu- --u u -u u--	dactylic hexameter	masculine penthemimeral
αἱρήσειν, κτενέειν δὲ παρ’ αὐτόθι πάντας ἀρίστους.	--- uu- u u -uu -u u--	dactylic hexameter	masculine penthemimeral, trithemimeral
ἀλλὰ Ποσειδάων γαιήοχος ἐννοσίγαιος	-u u--- --uu -uu--	dactylic hexameter	masculine penthemimeral
Ἀργείους ὄτρυνε βαθείης ἐξ ἁλὸς ἐλθὼν	--- --u u-- - uu --	dactylic hexameter	feminine penthemimeral, trithemimeral
εἰσάμενος Κάλχαντι δέμας καὶ ἀτειρέα φωνήν·	-uu- --u u- u u-uu --	dactylic hexameter	feminine penthemimeral, hepthemimeral, trithemimeral
Αἴαντε πρώτω προσέφη μεμαῶτε καὶ αὐτώ·	--- -- uu- uu-u u --	dactylic hexameter	masculine penthemimeral, hepthemimeral, trithemimeral
Αἴαντε σφὼ μέν τε σαώσετε λαὸν Ἀχαιῶν	--- - - u u-uu -u u--	dactylic hexameter	masculine penthemimeral, trithemimeral
ἀλκῆς μνησαμένω, μὴ δὲ κρυεροῖο φόβοιο.	-- -uu- - - uu-u u--	dactylic hexameter	masculine penthemimeral, hepthemimeral
ἄλλῃ μὲν γὰρ ἔγωγ’ οὐ δείδια χεῖρας ἀάπτους	-- - u u- - -uu -u u--	dactylic hexameter	masculine penthemimeral, trithemimeral
Τρώων, οἳ μέγα τεῖχος ὑπερκατέβησαν ὁμίλῳ·	-- - uu -u u-uu-u u--	dactylic hexameter	feminine penthemimeral, trithemimeral
ἕξουσιν γὰρ πάντας ἐϋκνήμιδες Ἀχαιοί·	--- - -u u---u u--	dactylic hexameter	feminine penthemimeral, trithemimeral
τῇ δὲ δὴ αἰνότατον περιδείδια μή τι πάθωμεν,	- u u -uu- uu-uu - u u--	dactylic hexameter	masculine penthemimeral
ᾗ ῥ’ὅ γ’ὁ λυσσώδης φλογὶ εἴκελος ἡγεμονεύει	- u u --- uu -uu -uu--	dactylic hexameter	masculine penthemimeral
Ἕκτωρ, ὃς Διὸς εὔχετ’ ἐρισθενέος πάϊς εἶναι.	-- - uu -u u-uu- uu --	dactylic hexameter	feminine penthemimeral, trithemimeral
σφῶϊν δ’ὧδε θεῶν τις ἐνὶ φρεσὶ ποιήσειεν	-- -u u- u u- uu ----	dactylic hexameter	masculine penthemimeral, hepthemimeral
αὐτώ θ’ἑστάμεναι κρατερῶς καὶ ἀνωγέμεν ἄλλους·	-- -uu- uu- u u-uu --	dactylic hexameter	masculine penthemimeral, hepthemimeral
τώ κε καὶ ἐσσύμενόν περ ἐρωήσαιτ’ ἀπὸ νηῶν	- u u -uu- u u--- uu --	dactylic hexameter	masculine penthemimeral
ὠκυπόρων, εἰ καί μιν Ὀλύμπιος αὐτὸς ἐγείρει.	-uu- - - u u-uu -u u--	dactylic hexameter	masculine penthemimeral, trithemimeral
ἦ καὶ σκηπανίῳ γαιήοχος ἐννοσίγαιος	- - -uu- --uu -uu--	dactylic hexameter	masculine penthemimeral
ἀμφοτέρω κεκόπων πλῆσεν μένεος κρατεροῖο,	-uu- uu- -- uu- uu--	dactylic hexameter	masculine penthemimeral, hepthemimeral, trithemimeral
γυῖα δ’ἔθηκεν ἐλαφρὰ πόδας καὶ χεῖρας ὕπερθεν.	-u u-u u-u u- - -u u--	dactylic hexameter	feminine penthemimeral, hepthemimeral
αὐτὸς δ’ὥς τ’ἴρηξ ὠκύπτερος ὦρτο πέτεσθαι,	-- - -- --uu -u u--	dactylic hexameter	masculine penthemimeral, trithemimeral
ὅς ῥά τ’ἀπ’ αἰγίλιπος πέτρης περιμήκεος ἀρθεὶς	- u u -uu- -- uu-uu --	dactylic hexameter	masculine penthemimeral, hepthemimeral
ὁρμήσῃ πεδίοιο διώκειν ὄρνεον ἄλλο,	--- uu-u u-- -uu --	dactylic hexameter	feminine penthemimeral, trithemimeral
ὣς ἀπὸ τῶν ἤϊξε Ποσειδάων ἐνοσίχθων.	- uu - --u u--- uu--	dactylic hexameter	feminine penthemimeral, trithemimeral
τοῖιν δ’ἔγνω πρόσθεν Ὀϊλῆος ταχὺς Αἴας,	-- -- -u u--- uu --	dactylic hexameter	feminine penthemimeral
αἶψα δ’ἄρ’ Αἴαντα προσέφη Τελαμώνιον υἱόν·	-u u --- uu- uu-uu --	dactylic hexameter	masculine penthemimeral, hepthemimeral
Αἶαν ἐπεί τις νῶϊ θεῶν οἳ Ὄλυμπον ἔχουσι	-u u- - -u u- u u-u u--	dactylic hexameter	feminine penthemimeral, hepthemimeral, trithemimeral
μάντεϊ εἰδόμενος κέλεται παρὰ νηυσὶ μάχεσθαι,	-uu -uu- uu- uu -u u--	dactylic hexameter	masculine penthemimeral, hepthemimeral
οὐδ’ ὅ γε Κάλχας ἐστὶ θεοπρόπος οἰωνιστής·	- u u -- -u u-uu ----	dactylic hexameter	feminine penthemimeral
ἴχνια γὰρ μετόπισθε ποδῶν ἠδὲ κνημάων	-uu - uu-u u- -- ---	dactylic hexameter	feminine penthemimeral, hepthemimeral, trithemimeral
ῥεῖ’ ἔγνων ἀπιόντος· ἀρίγνωτοι δὲ θεοί περ·	- -- uu-u u--- u u- -	dactylic hexameter	feminine penthemimeral, trithemimeral
καὶ δ’ἐμοὶ αὐτῷ θυμὸς ἐνὶ στήθεσσι φίλοισι	- uu -- -u u- --u u--	dactylic hexameter	feminine penthemimeral, hepthemimeral
μᾶλλον ἐφορμᾶται πολεμίζειν ἠδὲ μάχεσθαι,	-u u--- uu-- -u u--	dactylic hexameter	masculine penthemimeral
μαιμώωσι δ’ἔνερθε πόδες καὶ χεῖρες ὕπερθε.	---u u-u u- - -u u--	dactylic hexameter	feminine penthemimeral, hepthemimeral
τὸν δ’ἀπαμειβόμενος προσέφη Τελαμώνιος Αἴας·	- uu-uu- uu- uu-uu --	dactylic hexameter	masculine penthemimeral, hepthemimeral
οὕτω νῦν καὶ ἐμοὶ περὶ δούρατι χεῖρες ἄαπτοι	-- - u u- uu -uu -u u--	dactylic hexameter	masculine penthemimeral, trithemimeral
μαιμῶσιν, καί μοι μένος ὤρορε, νέρθε δὲ ποσσὶν	--- - - uu -uu -u u --	dactylic hexameter	masculine penthemimeral, trithemimeral
ἔσσυμαι ἀμφοτέροισι· μενοινώω δὲ καὶ οἶος	-uu -uu-u u--- u u --	dactylic hexameter	feminine penthemimeral
Ἕκτορι Πριαμίδῃ ἄμοτον μεμαῶτι μάχεσθαι.	-uu -uu- uu- uu-u u--	dactylic hexameter	masculine penthemimeral, hepthemimeral
ὣς οἳ μὲν τοιαῦτα πρὸς ἀλλήλους ἀγόρευον	- - - --u u --- uu--	dactylic hexameter	feminine penthemimeral, trithemimeral
χάρμῃ γηθόσυνοι, τήν σφιν θεὸς ἔμβαλε θυμῷ·	-- -uu- - - uu -uu --	dactylic hexameter	masculine penthemimeral, hepthemimeral
τόφρα δὲ τοὺς ὄπιθεν γαιήοχος ὦρσεν Ἀχαιούς,	-u u - uu- --uu -u u--	dactylic hexameter	masculine penthemimeral, trithemimeral
οἳ παρὰ νηυσὶ θοῇσιν ἀνέψυχον φίλον ἦτορ.	- uu -u u-u u--- uu --	dactylic hexameter	feminine penthemimeral
τῶν ῥ’ἅμα τ’ἀργαλέῳ καμάτῳ φίλα γυῖα λέλυντο,	- uu -uu- uu- uu -u u--	dactylic hexameter	masculine penthemimeral, hepthemimeral
καί σφιν ἄχος κατὰ θυμὸν ἐγίγνετο δερκομένοισι	- u u- uu -u u-uu -uu--	dactylic hexameter	feminine penthemimeral, trithemimeral
Τρῶας, τοὶ μέγα τεῖχος ὑπερκατέβησαν ὁμίλῳ.	-- - uu -u u-uu-u u--	dactylic hexameter	feminine penthemimeral, trithemimeral
τοὺς οἵ γ’εἰσορόωντες ὑπ’ ὀφρύσι δάκρυα λεῖβον·	- - -uu-u u -uu -uu --	dactylic hexameter	feminine penthemimeral
οὐ γὰρ ἔφαν φεύξεσθαι ὑπ’ ἐκ κακοῦ· ἀλλ’ ἐνοσίχθων	- u u- --u u - uu - uu--	dactylic hexameter	feminine penthemimeral, hepthemimeral, trithemimeral
ῥεῖα μετεισάμενος κρατερὰς ὄτρυνε φάλαγγας.	-u u-uu- uu- --u u--	dactylic hexameter	masculine penthemimeral, hepthemimeral
Τεῦκρον ἔπι πρῶτον καὶ Λήϊτον ἦλθε κελεύων	-u u- -- - -uu -u u--	dactylic hexameter	masculine penthemimeral, trithemimeral
Πηνέλεών θ’ἥρωα Θόαντά τε Δηΐπυρόν τε	-uu- --u u-u u -uu- -	dactylic hexameter	feminine penthemimeral, trithemimeral
Μηριόνην τε καὶ Ἀντίλοχον μήστωρας ἀϋτῆς·	-uu- u u -uu- --u u--	dactylic hexameter	hepthemimeral, trithemimeral
τοὺς ὅ γ’ἐποτρύνων ἔπεα πτερόεντα προσηύδα·	- u u--- uu- uu-u u--	dactylic hexameter	masculine penthemimeral, hepthemimeral
αἰδὼς Ἀργεῖοι, κοῦροι νέοι· ὔμμιν ἔγωγε	-- --- -- uu -u u--	dactylic hexameter	masculine penthemimeral, hepthemimeral
μαρναμένοισι πέποιθα σαωσέμεναι νέας ἁμάς·	-uu-u u-u u-uu- uu --	dactylic hexameter	feminine penthemimeral
εἰ δ’ὑμεῖς πολέμοιο μεθήσετε λευγαλέοιο,	- -- uu-u u-uu -uu--	dactylic hexameter	feminine penthemimeral, trithemimeral
νῦν δὴ εἴδεται ἦμαρ ὑπὸ Τρώεσσι δαμῆναι.	- - -uu -u u- --u u--	dactylic hexameter	feminine penthemimeral, hepthemimeral
ὢ πόποι ἦ μέγα θαῦμα τόδ’ ὀφθαλμοῖσιν ὁρῶμαι	- uu - uu -u u ---u u--	dactylic hexameter	feminine penthemimeral, trithemimeral
δεινόν, ὃ οὔ ποτ’ ἔγωγε τελευτήσεσθαι ἔφασκον,	-u u - u u-u u---u u--	dactylic hexameter	feminine penthemimeral, trithemimeral
Τρῶας ἐφ’ ἡμετέρας ἰέναι νέας, οἳ τὸ πάρος περ	-u u -uu- uu- uu - u u- -	dactylic hexameter	masculine penthemimeral, hepthemimeral
φυζακινῇς ἐλάφοισιν ἐοίκεσαν, αἵ τε καθ’ ὕλην	-uu- uu-u u-uu - u u --	dactylic hexameter	feminine penthemimeral, trithemimeral
θώων παρδαλίων τε λύκων τ’ἤϊα πέλονται	-- -uu- u u- --u u--	dactylic hexameter	masculine penthemimeral, hepthemimeral
αὔτως ἠλάσκουσαι ἀνάλκιδες, οὐδ’ ἔπι χάρμη·	-- ---u u-uu - uu --	dactylic hexameter	feminine penthemimeral
ὣς Τρῶες τὸ πρίν γε μένος καὶ χεῖρας Ἀχαιῶν	- -- - - u u- - -u u--	dactylic hexameter	masculine penthemimeral, hepthemimeral, trithemimeral
μίμνειν οὐκ ἐθέλεσκον ἐναντίον, οὐδ’ ἠβαιόν·	-- - uu-u u-uu - ---	dactylic hexameter	feminine penthemimeral, trithemimeral
νῦν δὲ ἑκὰς πόλιος κοίλῃς ἐπὶ νηυσὶ μάχονται	- u u- uu- -- uu -u u--	dactylic hexameter	masculine penthemimeral, hepthemimeral, trithemimeral
ἡγεμόνος κακότητι μεθημοσύνῃσί τε λαῶν,	-uu- uu-u u-uu-u u --	dactylic hexameter	feminine penthemimeral, trithemimeral
οἳ κείνῳ ἐρίσαντες ἀμυνέμεν οὐκ ἐθέλουσι	- -- uu-u u-uu - uu--	dactylic hexameter	feminine penthemimeral, trithemimeral
νηῶν ὠκυπόρων, ἀλλὰ κτείνονται ἀν’ αὐτάς.	-- -uu- -- --u u --	dactylic hexameter	masculine penthemimeral, hepthemimeral
ἀλλ’ εἰ δὴ καὶ πάμπαν ἐτήτυμον αἴτιός ἐστιν	- - - - -u u-uu -uu --	dactylic hexameter	feminine penthemimeral, trithemimeral
ἥρως Ἀτρεΐδης εὐρὺ κρείων Ἀγαμέμνων	-- -uu- -- -- uu--	dactylic hexameter	masculine penthemimeral, hepthemimeral
οὕνεκ’ ἀπητίμησε ποδώκεα Πηλεΐωνα,	-u u---u u-uu -uu--	dactylic hexameter	feminine penthemimeral
ἡμέας γ’οὔ πως ἔστι μεθιέμεναι πολέμοιο.	-- - - -u u-uu- uu--	dactylic hexameter	feminine penthemimeral, trithemimeral
ἀλλ’ ἀκεώμεθα θᾶσσον· ἀκεσταί τοι φρένες ἐσθλῶν.	- uu-uu -u u-- - uu --	dactylic hexameter	feminine penthemimeral
ὑμεῖς δ’οὐκ ἔτι καλὰ μεθίετε θούριδος ἀλκῆς	-- - uu -u u-uu -uu --	dactylic hexameter	feminine penthemimeral, trithemimeral
πάντες ἄριστοι ἐόντες ἀνὰ στρατόν. οὐδ’ ἂν ἔγωγε	-u u-u u-u u- uu - u u--	dactylic hexameter	feminine penthemimeral, hepthemimeral
ἀνδρὶ μαχεσσαίμην ὅς τις πολέμοιο μεθείη	-u u--- - - uu-u u--	dactylic hexameter	masculine penthemimeral, hepthemimeral
λυγρὸς ἐών· ὑμῖν δὲ νεμεσσῶμαι περὶ κῆρι.	-u u- -- u u--- uu --	dactylic hexameter	masculine penthemimeral, trithemimeral
ὦ πέπονες τάχα δή τι κακὸν ποιήσετε μεῖζον	- uu- uu - u u- --uu --	dactylic hexameter	masculine penthemimeral, hepthemimeral, trithemimeral
τῇδε μεθημοσύνῃ· ἀλλ’ ἐν φρεσὶ θέσθε ἕκαστος	-u u-uu- - - uu -u u--	dactylic hexameter	masculine penthemimeral, hepthemimeral
αἰδῶ καὶ νέμεσιν· δὴ γὰρ μέγα νεῖκος ὄρωρεν.	-- - uu- - - uu -u u--	dactylic hexameter	masculine penthemimeral, hepthemimeral, trithemimeral
Ἕκτωρ δὴ παρὰ νηυσὶ βοὴν ἀγαθὸς πολεμίζει	-- - uu -u u- uu- uu--	dactylic hexameter	feminine penthemimeral, hepthemimeral, trithemimeral
καρτερός, ἔρρηξεν δὲ πύλας καὶ μακρὸν ὀχῆα.	-uu --- u u- - -u u--	dactylic hexameter	masculine penthemimeral, hepthemimeral
ὥς ῥα κελευτιόων γαιήοχος ὦρσεν Ἀχαιούς.	- u u-uu- --uu -u u--	dactylic hexameter	masculine penthemimeral
ἀμφὶ δ’ἄρ’ Αἴαντας δοιοὺς ἵσταντο φάλαγγες	-u u --- -- --u u--	dactylic hexameter	masculine penthemimeral, hepthemimeral
καρτεραί, ἃς οὔτ’ ἄν κεν Ἄρης ὀνόσαιτο μετελθὼν	-uu - - - u u- uu-u u--	dactylic hexameter	masculine penthemimeral, hepthemimeral, trithemimeral
οὔτε κ’Ἀθηναίη λαοσσόος· οἳ γὰρ ἄριστοι	-u u--- --uu - u u--	dactylic hexameter	masculine penthemimeral
κρινθέντες Τρῶάς τε καὶ Ἕκτορα δῖον ἔμιμνον,	--- -- u u -uu -u u--	dactylic hexameter	masculine penthemimeral, trithemimeral
φράξαντες δόρυ δουρί, σάκος σάκεϊ προθελύμνῳ·	--- uu -u u- uu- uu--	dactylic hexameter	feminine penthemimeral, hepthemimeral, trithemimeral
ἀσπὶς ἄρ’ ἀσπίδ’ ἔρειδε, κόρυς κόρυν, ἀνέρα δ’ἀνήρ·	-u u -u u-u u- uu -uu --	dactylic hexameter	feminine penthemimeral, hepthemimeral
ψαῦον δ’ἱππόκομοι κόρυθες λαμπροῖσι φάλοισι	-- -uu- uu- --u u--	dactylic hexameter	masculine penthemimeral, hepthemimeral
νευόντων, ὡς πυκνοὶ ἐφέστασαν ἀλλήλοισιν·	--- - -u u-uu ----	dactylic hexameter	feminine penthemimeral, trithemimeral
ἔγχεα δ’ἐπτύσσοντο θρασειάων ἀπὸ χειρῶν	-uu ---u u--- uu --	dactylic hexameter	feminine penthemimeral
σειόμεν’· οἳ δ’ἰθὺς φρόνεον, μέμασαν δὲ μάχεσθαι.	-uu - -- uu- uu- u u--	dactylic hexameter	masculine penthemimeral, hepthemimeral, trithemimeral
Τρῶες δὲ προὔτυψαν ἀολλέες, ἦρχε δ’ἄρ’ Ἕκτωρ	-- - --u u-uu -u u --	dactylic hexameter	feminine penthemimeral, trithemimeral
ἀντικρὺ μεμαώς, ὀλοοίτροχος ὣς ἀπὸ πέτρης,	--- uu- uu-uu - uu --	dactylic hexameter	masculine penthemimeral, trithemimeral
ὅν τε κατὰ στεφάνης ποταμὸς χειμάρροος ὤσῃ	- u u- uu- uu- --uu --	dactylic hexameter	masculine penthemimeral, hepthemimeral, trithemimeral
ῥήξας ἀσπέτῳ ὄμβρῳ ἀναιδέος ἔχματα πέτρης·	-- -uu -u u-uu -uu --	dactylic hexameter	feminine penthemimeral
ὕψι δ’ἀναθρῴσκων πέτεται, κτυπέει δέ θ’ὑπ’ αὐτοῦ	-u u--- uu- uu- u u --	dactylic hexameter	masculine penthemimeral, hepthemimeral
ὕλη· ὃ δ’ἀσφαλέως θέει ἔμπεδον, εἷος ἵκηται	-u u -uu- uu -uu -u u--	dactylic hexameter	masculine penthemimeral
ἰσόπεδον, τότε δ’οὔ τι κυλίνδεται ἐσσύμενός περ·	-uu- uu - u u-uu -uu- -	dactylic hexameter	masculine penthemimeral, trithemimeral
ὣς Ἕκτωρ εἷος μὲν ἀπείλει μέχρι θαλάσσης	- -- -- u u-- -u u--	dactylic hexameter	masculine penthemimeral, trithemimeral
ῥέα διελεύσεσθαι κλισίας καὶ νῆας Ἀχαιῶν	- uu--- uu- - -u u--	dactylic hexameter	masculine penthemimeral, hepthemimeral
κτείνων· ἀλλ’ ὅτε δὴ πυκινῇς ἐνέκυρσε φάλαγξι	-- - uu - uu- uu-u u--	dactylic hexameter	masculine penthemimeral, hepthemimeral, trithemimeral
στῆ ῥα μάλ’ ἐγχριμφθείς· οἳ δ’ἀντίοι υἷες Ἀχαιῶν	- u u --- - -uu -u u--	dactylic hexameter	masculine penthemimeral
νύσσοντες ξίφεσίν τε καὶ ἔγχεσιν ἀμφιγύοισιν	--- uu- u u -uu -uu--	dactylic hexameter	masculine penthemimeral, trithemimeral
ὦσαν ἀπὸ σφείων· ὃ δὲ χασσάμενος πελεμίχθη.	-u u- -- u u -uu- uu--	dactylic hexameter	masculine penthemimeral, trithemimeral
ἤϋσεν δὲ διαπρύσιον Τρώεσσι γεγωνώς·	--- u u-uu- --u u--	dactylic hexameter	hepthemimeral, trithemimeral
Τρῶες καὶ Λύκιοι καὶ Δάρδανοι ἀγχιμαχηταὶ	-- - uu- - -uu -uu--	dactylic hexameter	masculine penthemimeral, trithemimeral
παρμένετ’· οὔ τοι δηρὸν ἐμὲ σχήσουσιν Ἀχαιοὶ	-uu - - -u u- --u u--	dactylic hexameter	feminine penthemimeral, hepthemimeral, trithemimeral
καὶ μάλα πυργηδὸν σφέας αὐτοὺς ἀρτύναντες,	- uu --- uu -- ----	dactylic hexameter	masculine penthemimeral
ἀλλ’ ὀΐω χάσσονται ὑπ’ ἔγχεος, εἰ ἐτεόν με	- uu- --u u -uu - uu- -	dactylic hexameter	feminine penthemimeral, trithemimeral
ὦρσε θεῶν ὤριστος, ἐρίγδουπος πόσις Ἥρης.	-u u- --u u--- uu --	dactylic hexameter	feminine penthemimeral, trithemimeral
ὣς εἰπὼν ὄτρυνε μένος καὶ θυμὸν ἑκάστου.	- -- --u u- - -u u--	dactylic hexameter	feminine penthemimeral, hepthemimeral, trithemimeral
Δηΐφοβος δ’ἐν τοῖσι μέγα φρονέων ἐβεβήκει	-uu- - -u u- uu- uu--	dactylic hexameter	feminine penthemimeral, hepthemimeral, trithemimeral
Πριαμίδης, πρόσθεν δ’ἔχεν ἀσπίδα πάντοσ’ ἐΐσην	-uu- -- uu -uu -u u--	dactylic hexameter	masculine penthemimeral, trithemimeral
κοῦφα ποσὶ προβιβὰς καὶ ὑπασπίδια προποδίζων.	-u u- uu- u u-uu- uu--	dactylic hexameter	masculine penthemimeral, trithemimeral
Μηριόνης δ’αὐτοῖο τιτύσκετο δουρὶ φαεινῷ	-uu- --u u-uu -u u--	dactylic hexameter	feminine penthemimeral, trithemimeral
καὶ βάλεν, οὐδ’ ἀφάμαρτε, κατ’ ἀσπίδα πάντοσ’ ἐΐσην	- uu - uu-u u -uu -u u--	dactylic hexameter	feminine penthemimeral, trithemimeral
ταυρείην· τῆς δ’οὔ τι διήλασεν, ἀλλὰ πολὺ πρὶν	--- - - u u-uu -u u- -	dactylic hexameter	masculine penthemimeral, trithemimeral
ἐν καυλῷ ἐάγη δολιχὸν δόρυ· Δηΐφοβος δὲ	- -- uu- uu- uu -uu- -	dactylic hexameter	masculine penthemimeral, hepthemimeral, trithemimeral
ἀσπίδα ταυρείην σχέθ’ ἀπὸ ἕο, δεῖσε δὲ θυμῷ	-uu --- u u- uu -u u --	dactylic hexameter	masculine penthemimeral, hepthemimeral
ἔγχος Μηριόναο δαΐφρονος· αὐτὰρ ὅ γ’ἥρως	-- -uu-u u-uu -u u --	dactylic hexameter	feminine penthemimeral
ἂψ ἑτάρων εἰς ἔθνος ἐχάζετο, χώσατο δ’αἰνῶς	- uu- - -u u-uu -uu --	dactylic hexameter	feminine penthemimeral, trithemimeral
ἀμφότερον, νίκης τε καὶ ἔγχεος ὃ ξυνέαξε.	-uu- -- u u -uu - uu--	dactylic hexameter	masculine penthemimeral, trithemimeral
βῆ δ’ἰέναι παρά τε κλισίας καὶ νῆας Ἀχαιῶν	- uu- uu - uu- - -u u--	dactylic hexameter	masculine penthemimeral, hepthemimeral, trithemimeral
οἰσόμενος δόρυ μακρόν, ὅ οἱ κλισίηφι λέλειπτο.	-uu- uu -u u - uu-u u--	dactylic hexameter	feminine penthemimeral, hepthemimeral, trithemimeral
οἳ δ’ἄλλοι μάρναντο, βοὴ δ’ἄσβεστος ὀρώρει.	- -- --u u- --u u--	dactylic hexameter	feminine penthemimeral, hepthemimeral, trithemimeral
Τεῦκρος δὲ πρῶτος Τελαμώνιος ἄνδρα κατέκτα	-- - -- uu-uu -u u--	dactylic hexameter	masculine penthemimeral, trithemimeral
Ἴμβριον αἰχμητὴν πολυΐππου Μέντορος υἱόν·	-uu --- uu-- -uu --	dactylic hexameter	masculine penthemimeral
ναῖε δὲ Πήδαιον πρὶν ἐλθεῖν υἷας Ἀχαιῶν,	-u u --- - -- -u u--	dactylic hexameter	masculine penthemimeral
κούρην δὲ Πριάμοιο νόθην ἔχε, Μηδεσικάστην·	-- - uu-u u- uu -uu--	dactylic hexameter	feminine penthemimeral, hepthemimeral, trithemimeral
αὐτὰρ ἐπεὶ Δαναῶν νέες ἤλυθον ἀμφιέλισσαι,	-u u- uu- uu -uu -uu--	dactylic hexameter	masculine penthemimeral, trithemimeral
ἂψ ἐς Ἴλιον ἦλθε, μετέπρεπε δὲ Τρώεσσι,	- - -uu -u u-uu - ---	dactylic hexameter	feminine penthemimeral
ναῖε δὲ πὰρ Πριάμῳ· ὃ δέ μιν τίεν ἶσα τέκεσσι.	-u u - uu- u u - uu -u u--	dactylic hexameter	masculine penthemimeral, hepthemimeral, trithemimeral
τόν ῥ’υἱὸς Τελαμῶνος ὑπ’ οὔατος ἔγχεϊ μακρῷ	- -- uu-u u -uu -uu --	dactylic hexameter	feminine penthemimeral, trithemimeral
νύξ’, ἐκ δ’ἔσπασεν ἔγχος· ὃ δ’αὖτ’ ἔπεσεν μελίη ὣς	- - -uu -u u - uu- uu- -	dactylic hexameter	feminine penthemimeral, hepthemimeral
ἥ τ’ὄρεος κορυφῇ ἕκαθεν περιφαινομένοιο	- uu- uu- uu- uu-uu--	dactylic hexameter	masculine penthemimeral, hepthemimeral, trithemimeral
χαλκῷ ταμνομένη τέρενα χθονὶ φύλλα πελάσσῃ·	-- -uu- uu- uu -u u--	dactylic hexameter	masculine penthemimeral, hepthemimeral
ὣς πέσεν, ἀμφὶ δέ οἱ βράχε τεύχεα ποικίλα χαλκῷ.	- uu -u u - uu -uu -uu --	dactylic hexameter	masculine penthemimeral
Τεῦκρος δ’ὁρμήθη μεμαὼς ἀπὸ τεύχεα δῦσαι·	-- --- uu- uu -uu --	dactylic hexameter	masculine penthemimeral, hepthemimeral
Ἕκτωρ δ’ὁρμηθέντος ἀκόντισε δουρὶ φαεινῷ.	-- ---u u-uu -u u--	dactylic hexameter	feminine penthemimeral
ἀλλ’ ὃ μὲν ἄντα ἰδὼν ἠλεύατο χάλκεον ἔγχος	- u u -u u- --uu -uu --	dactylic hexameter	masculine penthemimeral
τυτθόν· ὃ δ’Ἀμφίμαχον Κτεάτου υἷ’ Ἀκτορίωνος	-u u -uu- uu- - -uu--	dactylic hexameter	masculine penthemimeral, hepthemimeral
νισόμενον πόλεμον δὲ κατὰ στῆθος βάλε δουρί·	-uu- uu- u u- -- uu --	dactylic hexameter	masculine penthemimeral, hepthemimeral, trithemimeral
δούπησεν δὲ πεσών, ἀράβησε δὲ τεύχε’ ἐπ’ αὐτῷ.	--- u u- uu-u u -u u --	dactylic hexameter	masculine penthemimeral, trithemimeral
Ἕκτωρ δ’ὁρμήθη κόρυθα κροτάφοις ἀραρυῖαν	-- --- uu- uu- uu--	dactylic hexameter	masculine penthemimeral, hepthemimeral
κρατὸς ἀφαρπάξαι μεγαλήτορος Ἀμφιμάχοιο·	-u u--- uu-uu -uu--	dactylic hexameter	masculine penthemimeral
Αἴας δ’ὁρμηθέντος ὀρέξατο δουρὶ φαεινῷ	-- ---u u-uu -u u--	dactylic hexameter	feminine penthemimeral
Ἕκτορος· ἀλλ’ οὔ πῃ χροὸς εἴσατο, πᾶς δ’ἄρα χαλκῷ	-uu - - - uu -uu - uu --	dactylic hexameter	masculine penthemimeral, trithemimeral
σμερδαλέῳ κεκάλυφθ’· ὃ δ’ἄρ’ ἀσπίδος ὀμφαλὸν οὖτα,	-uu- uu- u u -uu -uu --	dactylic hexameter	masculine penthemimeral, trithemimeral
ὦσε δέ μιν σθένεϊ μεγάλῳ· ὃ δὲ χάσσατ’ ὀπίσσω	-u u - uu- uu- u u -u u--	dactylic hexameter	masculine penthemimeral, hepthemimeral, trithemimeral
νεκρῶν ἀμφοτέρων, τοὺς δ’ἐξείρυσσαν Ἀχαιοί.	-- -uu- - ---u u--	dactylic hexameter	masculine penthemimeral
Ἀμφίμαχον μὲν ἄρα Στιχίος δῖός τε Μενεσθεὺς	-uu- u u- uu- -- u u--	dactylic hexameter	masculine penthemimeral, hepthemimeral, trithemimeral
ἀρχοὶ Ἀθηναίων κόμισαν μετὰ λαὸν Ἀχαιῶν·	-u u--- uu- uu -u u--	dactylic hexameter	masculine penthemimeral, hepthemimeral
Ἴμβριον αὖτ’ Αἴαντε μεμαότε θούριδος ἀλκῆς	-uu - --u u-uu -uu --	dactylic hexameter	feminine penthemimeral, trithemimeral
ὥς τε δύ’ αἶγα λέοντε κυνῶν ὕπο καρχαροδόντων	- u u -u u-u u- uu -uu--	dactylic hexameter	feminine penthemimeral, hepthemimeral
ἁρπάξαντε φέρητον ἀνὰ ῥωπήϊα πυκνὰ	---u u-u u- --uu --	dactylic hexameter	feminine penthemimeral, hepthemimeral
ὑψοῦ ὑπὲρ γαίης μετὰ γαμφηλῇσιν ἔχοντε,	-u u- -- uu ---u u--	dactylic hexameter	masculine penthemimeral, trithemimeral
ὥς ῥα τὸν ὑψοῦ ἔχοντε δύω Αἴαντε κορυστὰ	- u u -u u-u u- --u u--	dactylic hexameter	feminine penthemimeral, hepthemimeral
τεύχεα συλήτην· κεφαλὴν δ’ἁπαλῆς ἀπὸ δειρῆς	-uu --- uu- uu- uu --	dactylic hexameter	masculine penthemimeral, hepthemimeral
κόψεν Ὀϊλιάδης κεχολωμένος Ἀμφιμάχοιο,	-u u-uu- uu-uu -uu--	dactylic hexameter	masculine penthemimeral
ἧκε δέ μιν σφαιρηδὸν ἑλιξάμενος δι’ ὁμίλου·	-u u - --u u-uu- u u--	dactylic hexameter	feminine penthemimeral, trithemimeral
Ἕκτορι δὲ προπάροιθε ποδῶν πέσεν ἐν κονίῃσι.	-uu - uu-u u- uu - uu--	dactylic hexameter	feminine penthemimeral, hepthemimeral, trithemimeral
καὶ τότε δὴ περὶ κῆρι Ποσειδάων ἐχολώθη	- uu - uu -u u--- uu--	dactylic hexameter	feminine penthemimeral, trithemimeral
υἱωνοῖο πεσόντος ἐν αἰνῇ δηϊοτῆτι,	---u u-u u -- -uu--	dactylic hexameter	feminine penthemimeral
βῆ δ’ἰέναι παρά τε κλισίας καὶ νῆας Ἀχαιῶν	- uu- uu - uu- - -u u--	dactylic hexameter	masculine penthemimeral, hepthemimeral, trithemimeral
ὀτρυνέων Δαναούς, Τρώεσσι δὲ κήδεα τεῦχεν.	--- uu- --u u -uu --	dactylic hexameter	masculine penthemimeral, trithemimeral
Ἰδομενεὺς δ’ἄρα οἱ δουρικλυτὸς ἀντεβόλησεν	-uu- uu - --uu -uu--	dactylic hexameter	masculine penthemimeral, trithemimeral
ἐρχόμενος παρ’ ἑταίρου, ὅ οἱ νέον ἐκ πολέμοιο	-uu- u u-u u - uu - uu--	dactylic hexameter	feminine penthemimeral, hepthemimeral, trithemimeral
ἦλθε κατ’ ἰγνύην βεβλημένος ὀξέϊ χαλκῷ.	-u u --- --uu -uu --	dactylic hexameter	masculine penthemimeral
τὸν μὲν ἑταῖροι ἔνεικαν, ὃ δ’ἰητροῖς ἐπιτείλας	- u u-u u-u u --- uu--	dactylic hexameter	feminine penthemimeral
ἤϊεν ἐς κλισίην· ἔτι γὰρ πολέμοιο μενοίνα	-uu - uu- uu - uu-u u--	dactylic hexameter	masculine penthemimeral, hepthemimeral, trithemimeral
ἀντιάαν· τὸν δὲ προσέφη κρείων ἐνοσίχθων	-uu- - - uu- -- uu--	dactylic hexameter	masculine penthemimeral, hepthemimeral, trithemimeral
εἰσάμενος φθογγὴν Ἀνδραίμονος υἷϊ Θόαντι	-uu- -- --uu -u u--	dactylic hexameter	masculine penthemimeral, trithemimeral
ὃς πάσῃ Πλευρῶνι καὶ αἰπεινῇ Καλυδῶνι	- -- --u u --- uu--	dactylic hexameter	feminine penthemimeral, trithemimeral
Αἰτωλοῖσιν ἄνασσε, θεὸς δ’ὣς τίετο δήμῳ·	---u u-u u- - -uu --	dactylic hexameter	feminine penthemimeral, hepthemimeral
Ἰδομενεῦ Κρητῶν βουληφόρε ποῦ τοι ἀπειλαὶ	-uu- -- --uu - u u--	dactylic hexameter	masculine penthemimeral, trithemimeral
οἴχονται, τὰς Τρωσὶν ἀπείλεον υἷες Ἀχαιῶν;	--- - -u u-uu -u u--	dactylic hexameter	feminine penthemimeral, trithemimeral
τὸν δ’αὖτ’ Ἰδομενεὺς Κρητῶν ἀγὸς ἀντίον ηὔδα·	- - -uu- -- uu -uu --	dactylic hexameter	masculine penthemimeral, hepthemimeral
ὦ Θόαν οὔ τις ἀνὴρ νῦν γ’αἴτιος, ὅσσον ἔγωγε	- uu - u u- - -uu -u u--	dactylic hexameter	masculine penthemimeral, trithemimeral
γιγνώσκω· πάντες γὰρ ἐπιστάμεθα πτολεμίζειν.	--- -- u u-uu- uu--	dactylic hexameter	masculine penthemimeral, trithemimeral
οὔτέ τινα δέος ἴσχει ἀκήριον οὔτέ τις ὄκνῳ	-u u- uu -u u-uu -u u --	dactylic hexameter	feminine penthemimeral, trithemimeral
εἴκων ἀνδύεται πόλεμον κακόν· ἀλλά που οὕτω	-- -uu- uu- uu -u u --	dactylic hexameter	masculine penthemimeral, hepthemimeral
μέλλει δὴ φίλον εἶναι ὑπερμενέϊ Κρονίωνι	-- - uu -u u-uu- uu--	dactylic hexameter	feminine penthemimeral, trithemimeral
νωνύμνους ἀπολέσθαι ἀπ’ Ἄργεος ἐνθάδ’ Ἀχαιούς.	--- uu-u u -uu -u u--	dactylic hexameter	feminine penthemimeral, trithemimeral
ἀλλὰ Θόαν, καὶ γὰρ τὸ πάρος μενεδήϊος ἦσθα,	-u u- - - u u- uu-uu --	dactylic hexameter	masculine penthemimeral, hepthemimeral, trithemimeral
ὀτρύνεις δὲ καὶ ἄλλον ὅθι μεθιέντα ἴδηαι·	--- u u -u u- uu-u u--	dactylic hexameter	feminine penthemimeral, hepthemimeral, trithemimeral
τὼ νῦν μήτ’ ἀπόληγε κέλευέ τε φωτὶ ἑκάστῳ.	- - - uu-u u-u u -u u--	dactylic hexameter	feminine penthemimeral, trithemimeral
τὸν δ’ἠμείβετ’ ἔπειτα Ποσειδάων ἐνοσίχθων·	- --u u-u u--- uu--	dactylic hexameter	feminine penthemimeral
Ἰδομενεῦ μὴ κεῖνος ἀνὴρ ἔτι νοστήσειεν	-uu- - -u u- uu ----	dactylic hexameter	feminine penthemimeral, hepthemimeral, trithemimeral
ἐκ Τροίης, ἀλλ’ αὖθι κυνῶν μέλπηθρα γένοιτο,	- -- - -u u- --u u--	dactylic hexameter	feminine penthemimeral, hepthemimeral, trithemimeral
ὅς τις ἐπ’ ἤματι τῷδε ἑκὼν μεθίῃσι μάχεσθαι.	- u u -uu -u u- uu-u u--	dactylic hexameter	feminine penthemimeral, hepthemimeral
ἀλλ’ ἄγε τεύχεα δεῦρο λαβὼν ἴθι· ταῦτα δ’ἅμα χρὴ	- uu -uu -u u- uu -u u- -	dactylic hexameter	feminine penthemimeral, hepthemimeral
σπεύδειν, αἴ κ’ὄφελός τι γενώμεθα καὶ δύ’ ἐόντε.	-- - uu- u u-uu - u u--	dactylic hexameter	masculine penthemimeral, trithemimeral
συμφερτὴ δ’ἀρετὴ πέλει ἀνδρῶν καὶ μάλα λυγρῶν,	--- uu- uu -- - uu --	dactylic hexameter	masculine penthemimeral, trithemimeral
νῶϊ δὲ καί κ’ἀγαθοῖσιν ἐπισταίμεσθα μάχεσθαι.	-u u - uu-u u---u u--	dactylic hexameter	feminine penthemimeral, trithemimeral
ὣς εἰπὼν ὃ μὲν αὖτις ἔβη θεὸς ἂμ πόνον ἀνδρῶν·	- -- u u -u u- uu - uu --	dactylic hexameter	feminine penthemimeral, hepthemimeral, trithemimeral
Ἰδομενεὺς δ’ὅτε δὴ κλισίην εὔτυκτον ἵκανε	-uu- uu - uu- --u u--	dactylic hexameter	masculine penthemimeral, hepthemimeral, trithemimeral
δύσετο τεύχεα καλὰ περὶ χροΐ, γέντο δὲ δοῦρε,	-uu -uu -u u- uu -u u --	dactylic hexameter	feminine penthemimeral, hepthemimeral
βῆ δ’ἴμεν ἀστεροπῇ ἐναλίγκιος, ἥν τε Κρονίων	- uu -uu- uu-uu - u u--	dactylic hexameter	masculine penthemimeral
χειρὶ λαβὼν ἐτίναξεν ἀπ’ αἰγλήεντος Ὀλύμπου	-u u- uu-u u ---u u--	dactylic hexameter	feminine penthemimeral, trithemimeral
δεικνὺς σῆμα βροτοῖσιν· ἀρίζηλοι δέ οἱ αὐγαί·	-- -u u-u u--- u u --	dactylic hexameter	feminine penthemimeral
ὣς τοῦ χαλκὸς ἔλαμπε περὶ στήθεσσι θέοντος.	- - -u u-u u- --u u--	dactylic hexameter	feminine penthemimeral, hepthemimeral
Μηριόνης δ’ἄρα οἱ θεράπων ἐῢς ἀντεβόλησεν	-uu- uu - uu- uu -uu--	dactylic hexameter	masculine penthemimeral, hepthemimeral, trithemimeral
ἐγγὺς ἔτι κλισίης· μετὰ γὰρ δόρυ χάλκεον ᾔει	-u u- uu- uu - uu -uu --	dactylic hexameter	masculine penthemimeral, hepthemimeral, trithemimeral
οἰσόμενος· τὸν δὲ προσέφη σθένος Ἰδομενῆος·	-uu- - - uu- uu -uu--	dactylic hexameter	masculine penthemimeral, hepthemimeral, trithemimeral
Μηριόνη Μόλου υἱὲ πόδας ταχὺ φίλταθ’ ἑταίρων	-uu- uu -u u- uu -u u--	dactylic hexameter	feminine penthemimeral, hepthemimeral, trithemimeral
τίπτ’ ἦλθες πόλεμόν τε λιπὼν καὶ δηϊοτῆτα;	- -- uu- u u- - -uu--	dactylic hexameter	masculine penthemimeral, hepthemimeral, trithemimeral
ἠέ τι βέβληαι, βέλεος δέ σε τείρει ἀκωκή,	-u u --- uu- u u -u u--	dactylic hexameter	masculine penthemimeral, hepthemimeral
ἦέ τευ ἀγγελίης μετ’ ἔμ’ ἤλυθες; οὐδέ τοι αὐτὸς	-u u -uu- u u -uu -u u --	dactylic hexameter	masculine penthemimeral
ἧσθαι ἐνὶ κλισίῃσι λιλαίομαι, ἀλλὰ μάχεσθαι.	-u u- uu-u u-uu -u u--	dactylic hexameter	feminine penthemimeral, trithemimeral
τὸν δ’αὖ Μηριόνης πεπνυμένος ἀντίον ηὔδα·	- - -uu- --uu -uu --	dactylic hexameter	masculine penthemimeral
Ἰδομενεῦ, Κρητῶν βουληφόρε χαλκοχιτώνων,	-uu- -- --uu -uu--	dactylic hexameter	masculine penthemimeral, trithemimeral
ἔρχομαι εἴ τί τοι ἔγχος ἐνὶ κλισίῃσι λέλειπται	-uu - u u -u u- uu-u u--	dactylic hexameter	feminine penthemimeral, hepthemimeral, trithemimeral
οἰσόμενος· τό νυ γὰρ κατεάξαμεν ὃ πρὶν ἔχεσκον	-uu- u u - uu-uu - u u--	dactylic hexameter	masculine penthemimeral, trithemimeral
ἀσπίδα Δηϊφόβοιο βαλὼν ὑπερηνορέοντος.	-uu -uu-u u- uu-uu--	dactylic hexameter	feminine penthemimeral, hepthemimeral
τὸν δ’αὖτ’ Ἰδομενεὺς Κρητῶν ἀγὸς ἀντίον ηὔδα·	- - -uu- -- uu -uu --	dactylic hexameter	masculine penthemimeral, hepthemimeral
δούρατα δ’αἴ κ’ἐθέλῃσθα καὶ ἓν καὶ εἴκοσι δήεις	-uu - uu-u u - - -uu --	dactylic hexameter	feminine penthemimeral, hepthemimeral, trithemimeral
ἑσταότ’ ἐν κλισίῃ πρὸς ἐνώπια παμφανόωντα	-uu - uu- u u-uu -uu--	dactylic hexameter	masculine penthemimeral, trithemimeral
Τρώϊα, τὰ κταμένων ἀποαίνυμαι· οὐ γὰρ ὀΐω	-uu - uu- uu-uu - u u--	dactylic hexameter	masculine penthemimeral, trithemimeral
ἀνδρῶν δυσμενέων ἑκὰς ἱστάμενος πολεμίζειν.	-- -uu- uu -uu- uu--	dactylic hexameter	masculine penthemimeral
τώ μοι δούρατά τ’ἔστι καὶ ἀσπίδες ὀμφαλόεσσαι	- - -uu -u u -uu -uu--	dactylic hexameter	feminine penthemimeral
καὶ κόρυθες καὶ θώρηκες λαμπρὸν γανόωντες.	- uu- - --- -- uu--	dactylic hexameter	hepthemimeral, trithemimeral
τὸν δ’αὖ Μηριόνης πεπνυμένος ἀντίον ηὔδα·	- - -uu- --uu -uu --	dactylic hexameter	masculine penthemimeral
καί τοι ἐμοὶ παρά τε κλισίῃ καὶ νηῒ μελαίνῃ	- u u- uu - uu- - -u u--	dactylic hexameter	masculine penthemimeral, hepthemimeral, trithemimeral
πόλλ’ ἔναρα Τρώων· ἀλλ’ οὐ σχεδόν ἐστιν ἑλέσθαι.	- uu- -- - - uu -u u--	dactylic hexameter	masculine penthemimeral, hepthemimeral, trithemimeral
οὐδὲ γὰρ οὐδ’ ἐμέ φημι λελασμένον ἔμμεναι ἀλκῆς,	-u u - uu -u u-uu -uu --	dactylic hexameter	feminine penthemimeral, trithemimeral
ἀλλὰ μετὰ πρώτοισι μάχην ἀνὰ κυδιάνειραν	-u u- --u u- uu -uu--	dactylic hexameter	feminine penthemimeral, hepthemimeral, trithemimeral
ἵσταμαι, ὁππότε νεῖκος ὀρώρηται πολέμοιο.	-uu -uu -u u--- uu--	dactylic hexameter	feminine penthemimeral
ἄλλόν πού τινα μᾶλλον Ἀχαιῶν χαλκοχιτώνων	-- - uu -u u-- -uu--	dactylic hexameter	feminine penthemimeral, trithemimeral
λήθω μαρνάμενος, σὲ δὲ ἴδμεναι αὐτὸν ὀΐω.	-- -uu- u u -uu -u u--	dactylic hexameter	masculine penthemimeral
τὸν δ’αὖτ’ Ἰδομενεὺς Κρητῶν ἀγὸς ἀντίον ηὔδα·	- - -uu- -- uu -uu --	dactylic hexameter	masculine penthemimeral, hepthemimeral
οἶδ’ ἀρετὴν οἷ ός ἐσσι· τί σε χρὴ ταῦτα λέγεσθαι;	- uu- u u -u u - - -u u--	dactylic hexameter	feminine penthemimeral, hepthemimeral, trithemimeral
εἰ γὰρ νῦν παρὰ νηυσὶ λεγοίμεθα πάντες ἄριστοι	- - - uu -u u-uu -u u--	dactylic hexameter	feminine penthemimeral, trithemimeral
ἐς λόχον, ἔνθα μάλιστ’ ἀρετὴ διαείδεται ἀνδρῶν,	- uu -u u- uu- uu-uu --	dactylic hexameter	masculine penthemimeral, hepthemimeral
ἔνθ’ ὅ τε δειλὸς ἀνὴρ ὅς τ’ἄλκιμος ἐξεφαάνθη·	- u u -u u- - -uu -uu--	dactylic hexameter	masculine penthemimeral
τοῦ μὲν γάρ τε κακοῦ τρέπεται χρὼς ἄλλυδις ἄλλῃ,	- - - u u- uu- - -uu --	dactylic hexameter	masculine penthemimeral, hepthemimeral, trithemimeral
οὐδέ οἱ ἀτρέμας ἧσθαι ἐρητύετ’ ἐν φρεσὶ θυμός,	-u u -uu -u u-uu - uu --	dactylic hexameter	feminine penthemimeral
ἀλλὰ μετοκλάζει καὶ ἐπ’ ἀμφοτέρους πόδας ἵζει,	-u u--- u u -uu- uu --	dactylic hexameter	masculine penthemimeral
ἐν δέ τέ οἱ κραδίη μεγάλα στέρνοισι πατάσσει	- u u - uu- uu- --u u--	dactylic hexameter	masculine penthemimeral, hepthemimeral, trithemimeral
κῆρας ὀϊομένῳ, πάταγος δέ τε γίγνετ’ ὀδόντων·	-u u-uu- uu- u u -u u--	dactylic hexameter	masculine penthemimeral, hepthemimeral
τοῦ δ’ἀγαθοῦ οὔτ’ ἂρ τρέπεται χρὼς οὔτέ τι λίην	- uu- - - uu- - -u u --	dactylic hexameter	masculine penthemimeral, hepthemimeral, trithemimeral
ταρβεῖ, ἐπειδὰν πρῶτον ἐσίζηται λόχον ἀνδρῶν,	-u u-- -u u--- uu --	dactylic hexameter	feminine penthemimeral
ἀρᾶται δὲ τάχιστα μιγήμεναι ἐν δαῒ λυγρῇ·	--- u u-u u-uu - uu --	dactylic hexameter	feminine penthemimeral, trithemimeral
οὐδέ κεν ἔνθα τεόν γε μένος καὶ χεῖρας ὄνοιτο.	-u u -u u- u u- - -u u--	dactylic hexameter	masculine penthemimeral, hepthemimeral
εἴ περ γάρ κε βλεῖο πονεύμενος ἠὲ τυπείης	- - - - -u u-uu -u u--	dactylic hexameter	feminine penthemimeral, trithemimeral
οὐκ ἂν ἐν αὐχέν’ ὄπισθε πέσοι βέλος οὐδ’ ἐνὶ νώτῳ,	- u u -u u-u u- uu - uu --	dactylic hexameter	feminine penthemimeral, hepthemimeral
ἀλλά κεν ἢ στέρνων ἢ νηδύος ἀντιάσειε	-u u - -- - -uu -uu--	dactylic hexameter	masculine penthemimeral, trithemimeral
πρόσσω ἱεμένοιο μετὰ προμάχων ὀαριστύν.	-- -uu-u u- uu- uu--	dactylic hexameter	feminine penthemimeral, hepthemimeral
ἀλλ’ ἄγε μηκέτι ταῦτα λεγώμεθα νηπύτιοι ὣς	- uu -uu -u u-uu -uu- -	dactylic hexameter	feminine penthemimeral
ἑσταότες, μή πού τις ὑπερφιάλως νεμεσήσῃ·	-uu- - - u u-uu- uu--	dactylic hexameter	masculine penthemimeral, trithemimeral
ἀλλὰ σύ γε κλισίην δὲ κιὼν ἕλευ ὄβριμον ἔγχος.	-u u - uu- u u- uu -uu --	dactylic hexameter	masculine penthemimeral, hepthemimeral, trithemimeral
ὣς φάτο, Μηριόνης δὲ θοῷ ἀτάλαντος Ἄρηϊ	- uu -uu- u u- uu-u u--	dactylic hexameter	masculine penthemimeral, hepthemimeral
καρπαλίμως κλισίηθεν ἀνείλετο χάλκεον ἔγχος,	-uu- uu-u u-uu -uu --	dactylic hexameter	feminine penthemimeral, trithemimeral
βῆ δὲ μετ’ Ἰδομενῆα μέγα πτολέμοιο μεμηλώς.	- u u -uu-u u- uu-u u--	dactylic hexameter	feminine penthemimeral, hepthemimeral
οἷος δὲ βροτολοιγὸς Ἄρης πόλεμον δὲ μέτεισι,	-- - uu-u u- uu- u u--	dactylic hexameter	feminine penthemimeral, hepthemimeral, trithemimeral
τῷ δὲ Φόβος φίλος υἱὸς ἅμα κρατερὸς καὶ ἀταρβὴς	- u u- uu -u u- uu- u u--	dactylic hexameter	feminine penthemimeral, hepthemimeral, trithemimeral
ἕσπετο, ὅς τ’ἐφόβησε ταλάφρονά περ πολεμιστήν·	-uu - uu-u u-uu - uu--	dactylic hexameter	feminine penthemimeral, trithemimeral
τὼ μὲν ἄρ’ ἐκ Θρῄκης Ἐφύρους μέτα θωρήσσεσθον,	- u u - -- uu- uu ----	dactylic hexameter	masculine penthemimeral, hepthemimeral, trithemimeral
ἠὲ μετὰ Φλεγύας μεγαλήτορας· οὐδ’ ἄρα τώ γε	-u u- uu- uu-uu - uu - -	dactylic hexameter	masculine penthemimeral, trithemimeral
ἔκλυον ἀμφοτέρων, ἑτέροισι δὲ κῦδος ἔδωκαν·	-uu -uu- uu-u u -u u--	dactylic hexameter	masculine penthemimeral
τοῖοι Μηριόνης τε καὶ Ἰδομενεὺς ἀγοὶ ἀνδρῶν	-- -uu- u u -uu- uu --	dactylic hexameter	masculine penthemimeral
ἤϊσαν ἐς πόλεμον κεκορυθμένοι αἴθοπι χαλκῷ.	-uu - uu- uu-uu -uu --	dactylic hexameter	masculine penthemimeral, trithemimeral
τὸν καὶ Μηριόνης πρότερος πρὸς μῦθον ἔειπε·	- - -uu- uu- - -u u--	dactylic hexameter	masculine penthemimeral, hepthemimeral
Δευκαλίδη πῇ τὰρ μέμονας καταδῦναι ὅμιλον;	-uu- - - uu- uu-u u--	dactylic hexameter	masculine penthemimeral, hepthemimeral, trithemimeral
ἢ ἐπὶ δεξιόφιν παντὸς στρατοῦ, ἦ ἀνὰ μέσσους,	- uu -uu- -- uu - uu --	dactylic hexameter	masculine penthemimeral, hepthemimeral
ἦ ἐπ’ ἀριστερόφιν; ἐπεὶ οὔ ποθι ἔλπομαι οὕτω	- u u-uu- uu - uu -uu --	dactylic hexameter	masculine penthemimeral, hepthemimeral
δεύεσθαι πολέμοιο κάρη κομόωντας Ἀχαιούς.	--- uu-u u- uu-u u--	dactylic hexameter	feminine penthemimeral, hepthemimeral, trithemimeral
τὸν δ’αὖτ’ Ἰδομενεὺς Κρητῶν ἀγὸς ἀντίον ηὔδα·	- - -uu- -- uu -uu --	dactylic hexameter	masculine penthemimeral, hepthemimeral
νηυσὶ μὲν ἐν μέσσῃσιν ἀμύνειν εἰσὶ καὶ ἄλλοι	-u u - --u u-- -u u --	dactylic hexameter	feminine penthemimeral, trithemimeral
Αἴαντές τε δύω Τεῦκρός θ’,ὃς ἄριστος Ἀχαιῶν	--- u u- -- u u-u u--	dactylic hexameter	masculine penthemimeral, hepthemimeral, trithemimeral
τοξοσύνῃ, ἀγαθὸς δὲ καὶ ἐν σταδίῃ ὑσμίνῃ·	-uu- uu- u u - uu- ---	dactylic hexameter	masculine penthemimeral, hepthemimeral, trithemimeral
οἵ μιν ἅδην ἐλόωσι καὶ ἐσσύμενον πολέμοιο	- u u- uu-u u -uu- uu--	dactylic hexameter	feminine penthemimeral, trithemimeral
Ἕκτορα Πριαμίδην, καὶ εἰ μάλα καρτερός ἐστιν.	-uu -uu- - - uu -uu --	dactylic hexameter	masculine penthemimeral, hepthemimeral
αἰπύ οἱ ἐσσεῖται μάλα περ μεμαῶτι μάχεσθαι	-u u --- uu - uu-u u--	dactylic hexameter	masculine penthemimeral, hepthemimeral
κείνων νικήσαντι μένος καὶ χεῖρας ἀάπτους	-- ---u u- - -u u--	dactylic hexameter	feminine penthemimeral, hepthemimeral
νῆας ἐνιπρῆσαι, ὅτε μὴ αὐτός γε Κρονίων	-u u--- uu - -- u u--	dactylic hexameter	masculine penthemimeral, hepthemimeral
ἐμβάλοι αἰθόμενον δαλὸν νήεσσι θοῇσιν.	-uu -uu- -- --u u--	dactylic hexameter	masculine penthemimeral, hepthemimeral
ἀνδρὶ δέ κ’οὐκ εἴξειε μέγας Τελαμώνιος Αἴας,	-u u - --u u- uu-uu --	dactylic hexameter	feminine penthemimeral, hepthemimeral, trithemimeral
ὃς θνητός τ’εἴη καὶ ἔδοι Δημήτερος ἀκτὴν	- -- -- u u- --uu --	dactylic hexameter	masculine penthemimeral, hepthemimeral, trithemimeral
χαλκῷ τε ῥηκτὸς μεγάλοισί τε χερμαδίοισιν.	-- - -- uu-u u -uu--	dactylic hexameter	masculine penthemimeral, trithemimeral
οὐδ’ ἂν Ἀχιλλῆϊ ῥηξήνορι χωρήσειεν	- u u--- --uu ----	dactylic hexameter	masculine penthemimeral
ἔν γ’αὐτοσταδίῃ· ποσὶ δ’οὔ πως ἔστιν ἐρίζειν.	- --uu- uu - - -u u--	dactylic hexameter	masculine penthemimeral, hepthemimeral
νῶϊν δ’ὧδ’ ἐπ’ ἀριστέρ’ ἔχε στρατοῦ, ὄφρα τάχιστα	-- - u u-u u- uu -u u--	dactylic hexameter	feminine penthemimeral, hepthemimeral, trithemimeral
εἴδομεν ἠέ τῳ εὖχος ὀρέξομεν, ἦέ τις ἡμῖν.	-uu -u u -u u-uu -u u --	dactylic hexameter	feminine penthemimeral
ὣς φάτο, Μηριόνης δὲ θοῷ ἀτάλαντος Ἄρηϊ	- uu -uu- u u- uu-u u--	dactylic hexameter	masculine penthemimeral, hepthemimeral
ἦρχ’ ἴμεν, ὄφρ’ ἀφίκοντο κατὰ στρατὸν ᾗ μιν ἀνώγει,	- uu - uu-u u- uu - u u--	dactylic hexameter	feminine penthemimeral, hepthemimeral, trithemimeral
οἳ δ’ὡς Ἰδομενῆα ἴδον φλογὶ εἴκελον ἀλκὴν	- - -uu-u u- uu -uu --	dactylic hexameter	feminine penthemimeral, hepthemimeral
αὐτὸν καὶ θεράποντα σὺν ἔντεσι δαιδαλέοισι,	-- - uu-u u -uu -uu--	dactylic hexameter	feminine penthemimeral, trithemimeral
κεκλόμενοι καθ’ ὅμιλον ἐπ’ αὐτῷ πάντες ἔβησαν·	-uu- u u-u u -- -u u--	dactylic hexameter	feminine penthemimeral, trithemimeral
τῶν δ’ὁμὸν ἵστατο νεῖκος ἐπὶ πρυμνῇσι νέεσσιν.	- uu -uu -u u- --u u--	dactylic hexameter	feminine penthemimeral, hepthemimeral
ὡς δ’ὅθ’ ὑπὸ λιγέων ἀνέμων σπέρχωσιν ἄελλαι	- u u- uu- uu- --u u--	dactylic hexameter	masculine penthemimeral, hepthemimeral, trithemimeral
ἤματι τῷ ὅτε τε πλείστη κόνις ἀμφὶ κελεύθους,	-uu - uu - -- uu -u u--	dactylic hexameter	masculine penthemimeral, hepthemimeral, trithemimeral
οἵ τ’ἄμυδις κονίης μεγάλην ἱστᾶσιν ὀμίχλην,	- uu- uu- uu- --u u--	dactylic hexameter	masculine penthemimeral, hepthemimeral, trithemimeral
ὣς ἄρα τῶν ὁμόσ’ ἦλθε μάχη, μέμασαν δ’ἐνὶ θυμῷ	- uu - uu -u u- uu- uu --	dactylic hexameter	feminine penthemimeral, hepthemimeral, trithemimeral
ἀλλήλους καθ’ ὅμιλον ἐναιρέμεν ὀξέϊ χαλκῷ.	--- u u-u u-uu -uu --	dactylic hexameter	feminine penthemimeral, trithemimeral
ἔφριξεν δὲ μάχη φθισίμβροτος ἐγχείῃσι	--- u u- --uu ----	dactylic hexameter	masculine penthemimeral, trithemimeral
μακρῇς, ἃς εἶχον ταμεσίχροας· ὄσσε δ’ἄμερδεν	-- - -- uu-uu -u u--	dactylic hexameter	masculine penthemimeral, trithemimeral
αὐγὴ χαλκείη κορύθων ἄπο λαμπομενάων	-- --- uu- uu -uu--	dactylic hexameter	masculine penthemimeral, hepthemimeral
θωρήκων τε νεοσμήκτων σακέων τε φαεινῶν	--- u u--- uu- u u--	dactylic hexameter	hepthemimeral, trithemimeral
ἐρχομένων ἄμυδις· μάλα κεν θρασυκάρδιος εἴη	-uu- uu- uu - uu-uu --	dactylic hexameter	masculine penthemimeral, hepthemimeral, trithemimeral
ὃς τότε γηθήσειεν ἰδὼν πόνον οὐδ’ ἀκάχοιτο.	- uu ---u u- uu - uu--	dactylic hexameter	feminine penthemimeral, hepthemimeral
τὼ δ’ἀμφὶς φρονέοντε δύω Κρόνου υἷε κραταιὼ	- -- uu-u u- uu -u u--	dactylic hexameter	feminine penthemimeral, hepthemimeral, trithemimeral
ἀνδράσιν ἡρώεσσιν ἐτεύχετον ἄλγεα λυγρά.	-uu ---u u-uu -uu --	dactylic hexameter	feminine penthemimeral
Ζεὺς μέν ῥα Τρώεσσι καὶ Ἕκτορι βούλετο νίκην	- - - --u u -uu -uu --	dactylic hexameter	feminine penthemimeral, trithemimeral
κυδαίνων Ἀχιλῆα πόδας ταχύν· οὐδέ τι πάμπαν	--- uu-u u- uu -u u --	dactylic hexameter	feminine penthemimeral, hepthemimeral, trithemimeral
ἤθελε λαὸν ὀλέσθαι Ἀχαιϊκὸν Ἰλιόθι πρό,	-uu -u u-u u-uu -uu- -	dactylic hexameter	feminine penthemimeral
ἀλλὰ Θέτιν κύδαινε καὶ υἱέα καρτερόθυμον.	-u u- --u u -uu -uu--	dactylic hexameter	feminine penthemimeral, trithemimeral
Ἀργείους δὲ Ποσειδάων ὀρόθυνε μετελθὼν	--- u u--- uu-u u--	dactylic hexameter	hepthemimeral, trithemimeral
λάθρῃ ὑπεξαναδὺς πολιῆς ἁλός· ἤχθετο γάρ ῥα	-u u-uu- uu- uu -uu - -	dactylic hexameter	masculine penthemimeral, hepthemimeral
Τρωσὶν δαμναμένους, Διὶ δὲ κρατερῶς ἐνεμέσσα.	-- -uu- uu - uu- uu--	dactylic hexameter	masculine penthemimeral, hepthemimeral
ἦ μὰν ἀμφοτέροισιν ὁμὸν γένος ἠδ’ ἴα πάτρη,	- - -uu-u u- uu - uu --	dactylic hexameter	feminine penthemimeral, hepthemimeral
ἀλλὰ Ζεὺς πρότερος γεγόνει καὶ πλείονα ᾔδη.	-- - uu- uu- - -uu --	dactylic hexameter	masculine penthemimeral, hepthemimeral, trithemimeral
τώ ῥα καὶ ἀμφαδίην μὲν ἀλεξέμεναι ἀλέεινε,	- u u -uu- u u-uu- uu--	dactylic hexameter	masculine penthemimeral
λάθρῃ δ’αἰὲν ἔγειρε κατὰ στρατὸν ἀνδρὶ ἐοικώς.	-- -u u-u u- uu -u u--	dactylic hexameter	feminine penthemimeral, hepthemimeral
τοὶ δ’ἔριδος κρατερῆς καὶ ὁμοιΐου πτολέμοιο	- uu- uu- u u--- uu--	dactylic hexameter	masculine penthemimeral, trithemimeral
πεῖραρ ἐπαλλάξαντες ἐπ’ ἀμφοτέροισι τάνυσσαν	-u u---u u -uu-u u--	dactylic hexameter	feminine penthemimeral
ἄρρηκτόν τ’ἄλυτόν τε, τὸ πολλῶν γούνατ’ ἔλυσεν.	--- uu- u u -- -u u--	dactylic hexameter	masculine penthemimeral, trithemimeral
ἔνθα μεσαιπόλιός περ ἐὼν Δαναοῖσι κελεύσας	-u u-uu- u u- uu-u u--	dactylic hexameter	masculine penthemimeral, hepthemimeral
Ἰδομενεὺς Τρώεσσι μετάλμενος ἐν φόβον ὦρσε.	-uu- --u u-uu - uu --	dactylic hexameter	feminine penthemimeral, trithemimeral
πέφνε γὰρ Ὀθρυονῆα Καβησόθεν ἔνδον ἐόντα,	-u u -uu-u u-uu -u u--	dactylic hexameter	feminine penthemimeral
ὅς ῥα νέον πολέμοιο μετὰ κλέος εἰληλούθει,	- u u- uu-u u- uu ----	dactylic hexameter	feminine penthemimeral, hepthemimeral, trithemimeral
ᾔτεε δὲ Πριάμοιο θυγατρῶν εἶδος ἀρίστην	-uu - uu-u u-- -u u--	dactylic hexameter	feminine penthemimeral, trithemimeral
Κασσάνδρην ἀνάεδνον, ὑπέσχετο δὲ μέγα ἔργον,	--- uu-u u-uu - uu --	dactylic hexameter	feminine penthemimeral, trithemimeral
ἐκ Τροίης ἀέκοντας ἀπωσέμεν υἷας Ἀχαιῶν.	- -- uu-u u-uu -u u--	dactylic hexameter	feminine penthemimeral, trithemimeral
τῷ δ’ὁ γέρων Πρίαμος ὑπό τ’ἔσχετο καὶ κατένευσε	- u u- uu- uu -uu - uu--	dactylic hexameter	masculine penthemimeral, trithemimeral
δωσέμεναι· ὃ δὲ μάρναθ’ ὑποσχεσίῃσι πιθήσας.	-uu- u u -u u-uu-u u--	dactylic hexameter	feminine penthemimeral, trithemimeral
Ἰδομενεὺς δ’αὐτοῖο τιτύσκετο δουρὶ φαεινῷ,	-uu- --u u-uu -u u--	dactylic hexameter	feminine penthemimeral, trithemimeral
καὶ βάλεν ὕψι βιβάντα τυχών· οὐδ’ ἤρκεσε θώρηξ	- uu -u u-u u- - -uu --	dactylic hexameter	feminine penthemimeral, hepthemimeral
χάλκεος, ὃν φορέεσκε, μέσῃ δ’ἐν γαστέρι πῆξε.	-uu - uu-u u- - -uu --	dactylic hexameter	feminine penthemimeral, hepthemimeral, trithemimeral
δούπησεν δὲ πεσών· ὃ δ’ἐπεύξατο φώνησέν τε·	--- u u- u u-uu --- -	dactylic hexameter	masculine penthemimeral, trithemimeral
Ὀθρυονεῦ περὶ δή σε βροτῶν αἰνίζομ’ ἁπάντων	-uu- uu - u u- --u u--	dactylic hexameter	masculine penthemimeral, hepthemimeral, trithemimeral
εἰ ἐτεὸν δὴ πάντα τελευτήσεις ὅσ’ ὑπέστης	- uu- - -u u--- u u--	dactylic hexameter	feminine penthemimeral, trithemimeral
Δαρδανίδῃ Πριάμῳ· ὃ δ’ὑπέσχετο θυγατέρα ἥν.	-uu- uu- u u-uu -uu- -	dactylic hexameter	masculine penthemimeral, trithemimeral
καί κέ τοι ἡμεῖς ταῦτά γ’ ὑποσχόμενοι τελέσαιμεν,	- u u -- -u u-uu- uu--	dactylic hexameter	feminine penthemimeral
δοῖμεν δ’Ἀτρεΐδαο θυγατρῶν εἶδος ἀρίστην	-- -uu-u u-- -u u--	dactylic hexameter	feminine penthemimeral
Ἄργεος ἐξαγαγόντες ὀπυιέμεν, εἴ κε σὺν ἄμμιν	-uu -uu-u u-uu - u u --	dactylic hexameter	feminine penthemimeral
Ἰλίου ἐκπέρσῃς εὖ ναιόμενον πτολίεθρον.	-uu --- - -uu- uu--	dactylic hexameter	masculine penthemimeral
ἀλλ’ ἕπε’, ὄφρ’ ἐπὶ νηυσὶ συνώμεθα ποντοπόροισιν	- uu - uu -u u-uu -uu--	dactylic hexameter	feminine penthemimeral, trithemimeral
ἀμφὶ γάμῳ, ἐπεὶ οὔ τοι ἐεδνωταὶ κακοί εἰμεν.	-u u- uu - u u--- uu --	dactylic hexameter	masculine penthemimeral, trithemimeral
ὣς εἰπὼν ποδὸς ἕλκε κατὰ κρατερὴν ὑσμίνην	- -- uu -u u- uu- ---	dactylic hexameter	feminine penthemimeral, hepthemimeral, trithemimeral
ἥρως Ἰδομενεύς· τῷ δ’Ἄσιος ἦλθ’ ἐπαμύντωρ	-- -uu- - -uu - uu--	dactylic hexameter	masculine penthemimeral
πεζὸς πρόσθ’ ἵππων· τὼ δὲ πνείοντε κατ’ ὤμων	-- - -- - - --u u --	dactylic hexameter	masculine penthemimeral, hepthemimeral, trithemimeral
αἰὲν ἔχ’ ἡνίοχος θεράπων· ὃ δὲ ἵετο θυμῷ	-u u -uu- uu- u u -uu --	dactylic hexameter	masculine penthemimeral, hepthemimeral
Ἰδομενῆα βαλεῖν· ὃ δέ μιν φθάμενος βάλε δουρὶ	-uu-u u- u u - uu- uu --	dactylic hexameter	masculine penthemimeral, hepthemimeral
λαιμὸν ὑπ’ ἀνθερεῶνα, διὰ πρὸ δὲ χαλκὸν ἔλασσεν.	-u u -uu-u u- u u -u u--	dactylic hexameter	feminine penthemimeral, hepthemimeral
ἤριπε δ’ὡς ὅτε τις δρῦς ἤριπεν ἢ ἀχερωῒς	-uu - uu - - -uu - uu--	dactylic hexameter	masculine penthemimeral, trithemimeral
ἠὲ πίτυς βλωθρή, τήν τ’οὔρεσι τέκτονες ἄνδρες	-u u- -- - -uu -uu --	dactylic hexameter	masculine penthemimeral, trithemimeral
ἐξέταμον πελέκεσσι νεήκεσι νήϊον εἶναι·	-uu- uu-u u-uu -uu --	dactylic hexameter	feminine penthemimeral, trithemimeral
ὣς ὃ πρόσθ’ ἵππων καὶ δίφρου κεῖτο τανυσθεὶς	- - - -- - -- -u u--	dactylic hexameter	masculine penthemimeral, trithemimeral
βεβρυχὼς κόνιος δεδραγμένος αἱματοέσσης.	--- uu- --uu -uu--	dactylic hexameter	masculine penthemimeral, trithemimeral
ἐκ δέ οἱ ἡνίοχος πλήγη φρένας ἃς πάρος εἶχεν,	- u u -uu- -- uu - uu --	dactylic hexameter	masculine penthemimeral, hepthemimeral
οὐδ’ ὅ γ’ἐτόλμησεν δηίων ὑπὸ χεῖρας ἀλύξας	- u u--- -- uu -u u--	dactylic hexameter	masculine penthemimeral, hepthemimeral
ἂψ ἵππους στρέψαι, τὸν δ’Ἀντίλοχος μενεχάρμης	- -- -- - -uu- uu--	dactylic hexameter	masculine penthemimeral, trithemimeral
δουρὶ μέσον περόνησε τυχών· οὐδ’ ἤρκεσε θώρηξ	-u u- uu-u u- - -uu --	dactylic hexameter	feminine penthemimeral, hepthemimeral, trithemimeral
χάλκεος ὃν φορέεσκε, μέσῃ δ’ἐν γαστέρι πῆξεν.	-uu - uu-u u- - -uu --	dactylic hexameter	feminine penthemimeral, hepthemimeral, trithemimeral
αὐτὰρ ὃ ἀσθμαίνων εὐεργέος ἔκπεσε δίφρου,	-u u --- --uu -uu --	dactylic hexameter	masculine penthemimeral
ἵππους δ’Ἀντίλοχος μεγαθύμου Νέστορος υἱὸς	-- -uu- uu-- -uu --	dactylic hexameter	masculine penthemimeral
ἐξέλασε Τρώων μετ’ ἐϋκνήμιδας Ἀχαιούς.	-uu- -- u u---u u--	dactylic hexameter	masculine penthemimeral, trithemimeral
Δηΐφοβος δὲ μάλα σχεδὸν ἤλυθεν Ἰδομενῆος	-uu- u u- uu -uu -uu--	dactylic hexameter	masculine penthemimeral, trithemimeral
Ἀσίου ἀχνύμενος, καὶ ἀκόντισε δουρὶ φαεινῷ.	-uu -uu- u u-uu -u u--	dactylic hexameter	masculine penthemimeral
ἀλλ’ ὃ μὲν ἄντα ἰδὼν ἠλεύατο χάλκεον ἔγχος	- u u -u u- --uu -uu --	dactylic hexameter	masculine penthemimeral
Ἰδομενεύς· κρύφθη γὰρ ὑπ’ ἀσπίδι πάντοσ’ ἐΐσῃ,	-uu- -- u u -uu -u u--	dactylic hexameter	masculine penthemimeral, trithemimeral
τὴν ἄρ’ ὅ γε ῥινοῖσι βοῶν καὶ νώροπι χαλκῷ	- u u - --u u- - -uu --	dactylic hexameter	feminine penthemimeral, hepthemimeral, trithemimeral
δινωτὴν φορέεσκε, δύω κανόνεσσ’ ἀραρυῖαν·	--- uu-u u- uu- uu--	dactylic hexameter	feminine penthemimeral, hepthemimeral, trithemimeral
τῇ ὕπο πᾶς ἐάλη, τὸ δ’ὑπέρπτατο χάλκεον ἔγχος,	- uu - uu- u u-uu -uu --	dactylic hexameter	masculine penthemimeral, trithemimeral
καρφαλέον δέ οἱ ἀσπὶς ἐπιθρέξαντος ἄϋσεν	-uu- u u -u u---u u--	dactylic hexameter	feminine penthemimeral, trithemimeral
ἔγχεος· οὐδ’ ἅλιόν ῥα βαρείης χειρὸς ἀφῆκεν,	-uu - uu- u u-- -u u--	dactylic hexameter	masculine penthemimeral, trithemimeral
ἀλλ’ ἔβαλ’ Ἱππασίδην Ὑψήνορα ποιμένα λαῶν	- uu -uu- --uu -uu --	dactylic hexameter	masculine penthemimeral
ἧπαρ ὑπὸ πραπίδων, εἶθαρ δ’ὑπὸ γούνατ’ ἔλυσε.	-u u- uu- -- uu -u u--	dactylic hexameter	masculine penthemimeral, hepthemimeral, trithemimeral
Δηΐφοβος δ’ἔκπαγλον ἐπεύξατο μακρὸν ἀΰσας·	-uu- --u u-uu -u u--	dactylic hexameter	feminine penthemimeral, trithemimeral
οὐ μὰν αὖτ’ ἄτιτος κεῖτ’ Ἄσιος, ἀλλά ἕ φημι	- - - uu- - -uu -u u --	dactylic hexameter	masculine penthemimeral, trithemimeral
εἰς Ἄϊδός περ ἰόντα πυλάρταο κρατεροῖο	- uu- u u-u u--- uu--	dactylic hexameter	feminine penthemimeral, trithemimeral
γηθήσειν κατὰ θυμόν, ἐπεί ῥά οἱ ὤπασα πομπόν.	--- uu -u u- u u -uu --	dactylic hexameter	feminine penthemimeral, hepthemimeral, trithemimeral
ὣς ἔφατ’, Ἀργείοισι δ’ ἄχος γένετ’ εὐξαμένοιο,	- uu ---u u- uu -uu--	dactylic hexameter	feminine penthemimeral, hepthemimeral
Ἀντιλόχῳ δὲ μάλιστα δαΐφρονι θυμὸν ὄρινεν·	-uu- u u-u u-uu -u u--	dactylic hexameter	feminine penthemimeral, trithemimeral
ἀλλ’ οὐδ’ ἀχνύμενός περ ἑοῦ ἀμέλησεν ἑταίρου,	- - -uu- u u- uu-u u--	dactylic hexameter	masculine penthemimeral, hepthemimeral
ἀλλὰ θέων περίβη καί οἱ σάκος ἀμφεκάλυψε.	-u u- uu- - - uu -uu--	dactylic hexameter	masculine penthemimeral, hepthemimeral, trithemimeral
τὸν μὲν ἔπειθ’ ὑποδύντε δύω ἐρίηρες ἑταῖροι	- u u- uu-u u- uu-u u--	dactylic hexameter	feminine penthemimeral, hepthemimeral, trithemimeral
Μηκιστεὺς Ἐχίοιο πάϊς καὶ δῖος Ἀλάστωρ,	--- uu-u u- - -u u--	dactylic hexameter	feminine penthemimeral, hepthemimeral, trithemimeral
νῆας ἔπι γλαφυρὰς φερέτην βαρέα στενάχοντα.	-u u- uu- uu- uu- uu--	dactylic hexameter	masculine penthemimeral, hepthemimeral, trithemimeral
Ἰδομενεὺς δ’οὐ λῆγε μένος μέγα, ἵετο δ’αἰεὶ	-uu- - -u u- uu -uu --	dactylic hexameter	feminine penthemimeral, hepthemimeral, trithemimeral
ἠέ τινα Τρώων ἐρεβεννῇ νυκτὶ καλύψαι	-u u- -- uu-- -u u--	dactylic hexameter	masculine penthemimeral, trithemimeral
ἢ αὐτὸς δουπῆσαι ἀμύνων λοιγὸν Ἀχαιοῖς.	- -- --u u-- -u u--	dactylic hexameter	feminine penthemimeral, trithemimeral
ἔνθ’ Αἰσυήταο διοτρεφέος φίλον υἱὸν	- ----u u-uu- uu --	dactylic hexameter	feminine penthemimeral
ἥρω’ Ἀλκάθοον, γαμβρὸς δ’ἦν Ἀγχίσαο,	-- -uu- -- - ----	dactylic hexameter	masculine penthemimeral, hepthemimeral
πρεσβυτάτην δ’ὤπυιε θυγατρῶν Ἱπποδάμειαν	-uu- --u u-- -uu--	dactylic hexameter	feminine penthemimeral, trithemimeral
τὴν περὶ κῆρι φίλησε πατὴρ καὶ πότνια μήτηρ	- uu -u u-u u- - -uu --	dactylic hexameter	feminine penthemimeral, hepthemimeral
ἐν μεγάρῳ· πᾶσαν γὰρ ὁμηλικίην ἐκέκαστο	- uu- -- u u-uu- uu--	dactylic hexameter	masculine penthemimeral, trithemimeral
κάλλεϊ καὶ ἔργοισιν ἰδὲ φρεσί· τοὔνεκα καί μιν	-uu - --u u- uu -uu - -	dactylic hexameter	feminine penthemimeral, hepthemimeral, trithemimeral
γῆμεν ἀνὴρ ὤριστος ἐνὶ Τροίῃ εὐρείῃ·	-u u- --u u- -- ---	dactylic hexameter	feminine penthemimeral, hepthemimeral, trithemimeral
τὸν τόθ’ ὑπ’ Ἰδομενῆϊ Ποσειδάων ἐδάμασσε	- u u -uu-u u--- uu--	dactylic hexameter	feminine penthemimeral
θέλξας ὄσσε φαεινά, πέδησε δὲ φαίδιμα γυῖα·	-- -u u-u u-u u -uu --	dactylic hexameter	feminine penthemimeral
οὔτε γὰρ ἐξοπίσω φυγέειν δύνατ’ οὔτ’ ἀλέασθαι,	-u u -uu- uu- uu - uu--	dactylic hexameter	masculine penthemimeral, hepthemimeral
ἀλλ’ ὥς τε στήλην ἢ δένδρεον ὑψιπέτηλον	- - - -- - -uu -uu--	dactylic hexameter	masculine penthemimeral, trithemimeral
ἀτρέμας ἑσταότα στῆθος μέσον οὔτασε δουρὶ	-uu -uu- -- uu -uu --	dactylic hexameter	masculine penthemimeral, hepthemimeral
ἥρως Ἰδομενεύς, ῥῆξεν δέ οἱ ἀμφὶ χιτῶνα	-- -uu- -- u u -u u--	dactylic hexameter	masculine penthemimeral, hepthemimeral
χάλκεον, ὅς οἱ πρόσθεν ἀπὸ χροὸς ἤρκει ὄλεθρον·	-uu - - -u u- uu -u u--	dactylic hexameter	feminine penthemimeral, hepthemimeral, trithemimeral
δὴ τότε γ’αὖον ἄϋσεν ἐρεικόμενος περὶ δουρί.	- uu -u u-u u-uu- uu --	dactylic hexameter	feminine penthemimeral
δούπησεν δὲ πεσών, δόρυ δ’ἐν κραδίῃ ἐπεπήγει,	--- u u- uu - uu- uu--	dactylic hexameter	masculine penthemimeral, hepthemimeral, trithemimeral
ἥ ῥά οἱ ἀσπαίρουσα καὶ οὐρίαχον πελέμιζεν	- u u ---u u -uu- uu--	dactylic hexameter	feminine penthemimeral
ἔγχεος· ἔνθα δ’ἔπειτ’ ἀφίει μένος ὄβριμος Ἄρης·	-uu -u u- uu- uu -uu --	dactylic hexameter	masculine penthemimeral, hepthemimeral
Ἰδομενεὺς δ’ἔκπαγλον ἐπεύξατο μακρὸν ἀΰσας	-uu- --u u-uu -u u--	dactylic hexameter	feminine penthemimeral, trithemimeral
Δηΐφοβ’ ἦ ἄρα δή τι ἐΐσκομεν ἄξιον εἶναι	-uu - uu - u u-uu -uu --	dactylic hexameter	masculine penthemimeral, trithemimeral
τρεῖς ἑνὸς ἀντὶ πεφάσθαι; ἐπεὶ σύ περ εὔχεαι οὕτω.	- uu -u u-u u- u u -uu --	dactylic hexameter	feminine penthemimeral, hepthemimeral
δαιμόνι’ ἀλλὰ καὶ αὐτὸς ἐναντίον ἵστασ’ ἐμεῖο,	-uu -u u -u u-uu -u u--	dactylic hexameter	feminine penthemimeral
ὄφρα ἴδῃ οἷος Ζηνὸς γόνος ἐνθάδ’ ἱκάνω,	-u u- -- -- uu -u u--	dactylic hexameter	masculine penthemimeral, hepthemimeral, trithemimeral
ὃς πρῶτον Μίνωα τέκε Κρήτῃ ἐπίουρον·	- -- --u u- -- uu--	dactylic hexameter	feminine penthemimeral, hepthemimeral, trithemimeral
Μίνως δ’αὖ τέκεθ’ υἱὸν ἀμύμονα Δευκαλίωνα,	-- - uu -u u-uu -uu--	dactylic hexameter	feminine penthemimeral, trithemimeral
Δευκαλίων δ’ἐμὲ τίκτε πολέσσ’ ἄνδρεσσιν ἄνακτα	-uu- uu -u u- --u u--	dactylic hexameter	feminine penthemimeral, hepthemimeral, trithemimeral
Κρήτῃ ἐν εὐρείῃ· νῦν δ’ἐνθάδε νῆες ἔνεικαν	-u u --- - -uu -u u--	dactylic hexameter	masculine penthemimeral
σοί τε κακὸν καὶ πατρὶ καὶ ἄλλοισι Τρώεσσιν.	- u u- - -u u --- ---	dactylic hexameter	feminine penthemimeral, trithemimeral
ὣς φάτο, Δηΐφοβος δὲ διάνδιχα μερμήριξεν	- uu -uu- u u-uu ----	dactylic hexameter	masculine penthemimeral
ἤ τινά που Τρώων ἑταρίσσαιτο μεγαθύμων	- uu - -- uu--- uu--	dactylic hexameter	masculine penthemimeral, trithemimeral
ἂψ ἀναχωρήσας, ἦ πειρήσαιτο καὶ οἶος.	- uu--- - ---u u --	dactylic hexameter	masculine penthemimeral
ὧδε δέ οἱ φρονέοντι δοάσσατο κέρδιον εἶναι	-u u - uu-u u-uu -uu --	dactylic hexameter	feminine penthemimeral, trithemimeral
βῆναι ἐπ’ Αἰνείαν· τὸν δ’ὕστατον εὗρεν ὁμίλου	-u u --- - -uu -u u--	dactylic hexameter	masculine penthemimeral
ἑσταότ’· αἰεὶ γὰρ Πριάμῳ ἐπεμήνιε δίῳ	-uu -- - uu- uu-uu --	dactylic hexameter	masculine penthemimeral, hepthemimeral
οὕνεκ’ ἄρ’ ἐσθλὸν ἐόντα μετ’ ἀνδράσιν οὔ τι τίεσκεν.	-u u -u u-u u -uu - u u--	dactylic hexameter	feminine penthemimeral
ἀγχοῦ δ’ἱστάμενος ἔπεα πτερόεντα προσηύδα·	-- -uu- uu- uu-u u--	dactylic hexameter	masculine penthemimeral, hepthemimeral
Αἰνεία Τρώων βουληφόρε νῦν σε μάλα χρὴ	--- -- --uu - u u- -	dactylic hexameter	masculine penthemimeral, trithemimeral
γαμβρῷ ἀμυνέμεναι, εἴ πέρ τί σε κῆδος ἱκάνει.	-u u-uu- - - u u -u u--	dactylic hexameter	masculine penthemimeral, hepthemimeral
ἀλλ’ ἕπευ Ἀλκαθόῳ ἐπαμύνομεν, ὅς σε πάρος γε	- uu -uu- uu-uu - u u- -	dactylic hexameter	masculine penthemimeral
γαμβρὸς ἐὼν ἔθρεψε δόμοις ἔνι τυτθὸν ἐόντα·	-u u- --u u- uu -u u--	dactylic hexameter	feminine penthemimeral, hepthemimeral, trithemimeral
τὸν δέ τοι Ἰδομενεὺς δουρικλυτὸς ἐξενάριξεν.	- u u -uu- --uu -uu--	dactylic hexameter	masculine penthemimeral
ὣς φάτο, τῷ δ’ἄρα θυμὸν ἐνὶ στήθεσσιν ὄρινε,	- uu - uu -u u- --u u--	dactylic hexameter	feminine penthemimeral, hepthemimeral, trithemimeral
βῆ δὲ μετ’ Ἰδομενῆα μέγα πτολέμοιο μεμηλώς.	- u u -uu-u u- uu-u u--	dactylic hexameter	feminine penthemimeral, hepthemimeral
ἀλλ’ οὐκ Ἰδομενῆα φόβος λάβε τηλύγετον ὥς,	- - -uu-u u- uu -uu- -	dactylic hexameter	feminine penthemimeral, hepthemimeral
ἀλλ’ ἔμεν’ ὡς ὅτε τις σῦς οὔρεσιν ἀλκὶ πεποιθώς,	- uu - uu - - -uu -u u--	dactylic hexameter	masculine penthemimeral, trithemimeral
ὅς τε μένει κολοσυρτὸν ἐπερχόμενον πολὺν ἀνδρῶν	- u u- uu-u u-uu- uu --	dactylic hexameter	feminine penthemimeral, trithemimeral
χώρῳ ἐν οἰοπόλῳ, φρίσσει δέ τε νῶτον ὕπερθεν·	-u u -uu- -- u u -u u--	dactylic hexameter	masculine penthemimeral, hepthemimeral
ὀφθαλμὼ δ’ἄρα οἱ πυρὶ λάμπετον· αὐτὰρ ὀδόντας	--- uu - uu -uu -u u--	dactylic hexameter	masculine penthemimeral, trithemimeral
θήγει, ἀλέξασθαι μεμαὼς κύνας ἠδὲ καὶ ἄνδρας·	-u u--- uu- uu -u u --	dactylic hexameter	masculine penthemimeral, hepthemimeral
ὣς μένεν Ἰδομενεὺς δουρικλυτός, οὐδ’ ὑπεχώρει,	- uu -uu- --uu - uu--	dactylic hexameter	masculine penthemimeral
Αἰνείαν ἐπιόντα βοηθόον· αὖε δ’ἑταίρους	--- uu-u u-uu -u u--	dactylic hexameter	feminine penthemimeral, trithemimeral
Ἀσκάλαφόν τ’ἐσορῶν Ἀφαρῆά τε Δηΐπυρόν τε	-uu- uu- uu-u u -uu- -	dactylic hexameter	masculine penthemimeral, trithemimeral
Μηριόνην τε καὶ Ἀντίλοχον μήστωρας ἀϋτῆς·	-uu- u u -uu- --u u--	dactylic hexameter	hepthemimeral, trithemimeral
τοὺς ὅ γ’ἐποτρύνων ἔπεα πτερόεντα προσηύδα·	- u u--- uu- uu-u u--	dactylic hexameter	masculine penthemimeral, hepthemimeral
δεῦτε φίλοι, καί μ’οἴῳ ἀμύνετε· δείδια δ’αἰνῶς	-u u- - -u u-uu -uu --	dactylic hexameter	feminine penthemimeral, trithemimeral
Αἰνείαν ἐπιόντα πόδας ταχύν, ὅς μοι ἔπεισιν,	--- uu-u u- uu - u u--	dactylic hexameter	feminine penthemimeral, hepthemimeral, trithemimeral
ὃς μάλα καρτερός ἐστι μάχῃ ἔνι φῶτας ἐναίρειν·	- uu -uu -u u- uu -u u--	dactylic hexameter	feminine penthemimeral, hepthemimeral
καὶ δ’ἔχει ἥβης ἄνθος, ὅ τε κράτος ἐστὶ μέγιστον.	- uu -- -u u - uu -u u--	dactylic hexameter	feminine penthemimeral, hepthemimeral
εἰ γὰρ ὁμηλικίη γε γενοίμεθα τῷδ’ ἐπὶ θυμῷ	- u u-uu- u u-uu - uu --	dactylic hexameter	masculine penthemimeral
αἶψά κεν ἠὲ φέροιτο μέγα κράτος, ἠὲ φεροίμην.	-u u -u u-u u- uu -u u--	dactylic hexameter	feminine penthemimeral, hepthemimeral
ὣς ἔφαθ’, οἳ δ’ἄρα πάντες ἕνα φρεσὶ θυμὸν ἔχοντες	- uu - uu -u u- uu -u u--	dactylic hexameter	feminine penthemimeral, hepthemimeral, trithemimeral
πλησίοι ἔστησαν, σάκε’ ὤμοισι κλίναντες.	-uu --- uu --- ---	dactylic hexameter	masculine penthemimeral
Αἰνείας δ’ἑτέρωθεν ἐκέκλετο οἷς ἑτάροισι	--- uu-u u-uu - uu--	dactylic hexameter	feminine penthemimeral, trithemimeral
Δηΐφοβόν τε Πάριν τ’ἐσορῶν καὶ Ἀγήνορα δῖον,	-uu- u u- uu- u u-uu --	dactylic hexameter	masculine penthemimeral, hepthemimeral, trithemimeral
οἵ οἱ ἅμ’ ἡγεμόνες Τρώων ἔσαν· αὐτὰρ ἔπειτα	- u u -uu- -- uu -u u--	dactylic hexameter	masculine penthemimeral, hepthemimeral
λαοὶ ἕπονθ’, ὡς εἴ τε μετὰ κτίλον ἕσπετο μῆλα	-u u- - - u u- uu -uu --	dactylic hexameter	masculine penthemimeral, hepthemimeral, trithemimeral
πιόμεν’ ἐκ βοτάνης· γάνυται δ’ἄρα τε φρένα ποιμήν·	-uu - uu- uu- uu - uu --	dactylic hexameter	masculine penthemimeral, hepthemimeral, trithemimeral
ὣς Αἰνείᾳ θυμὸς ἐνὶ στήθεσσι γεγήθει	- --- -u u- --u u--	dactylic hexameter	feminine penthemimeral, hepthemimeral
ὡς ἴδε λαῶν ἔθνος ἐπισπόμενον ἑοῖ αὐτῷ.	- uu -- -u u-uu- uu --	dactylic hexameter	feminine penthemimeral
οἳ δ’ἀμφ’ Ἀλκαθόῳ αὐτοσχεδὸν ὁρμήθησαν	- - -uu- --uu ----	dactylic hexameter	masculine penthemimeral
μακροῖσι ξυστοῖσι· περὶ στήθεσσι δὲ χαλκὸς	--- --u u- --u u --	dactylic hexameter	feminine penthemimeral, hepthemimeral, trithemimeral
σμερδαλέον κονάβιζε τιτυσκομένων καθ’ ὅμιλον	-uu- uu-u u-uu- u u--	dactylic hexameter	feminine penthemimeral, trithemimeral
ἀλλήλων· δύο δ’ἄνδρες ἀρήϊοι ἔξοχον ἄλλων	--- uu -u u-uu -uu --	dactylic hexameter	feminine penthemimeral, trithemimeral
Αἰνείας τε καὶ Ἰδομενεὺς ἀτάλαντοι Ἄρηϊ	--- u u -uu- uu-u u--	dactylic hexameter	hepthemimeral, trithemimeral
ἵεντ’ ἀλλήλων ταμέειν χρόα νηλέϊ χαλκῷ.	-- --- uu- uu -uu --	dactylic hexameter	masculine penthemimeral, hepthemimeral
Αἰνείας δὲ πρῶτος ἀκόντισεν Ἰδομενῆος·	--- - -u u-uu -uu--	dactylic hexameter	feminine penthemimeral, trithemimeral
ἀλλ’ ὃ μὲν ἄντα ἰδὼν ἠλεύατο χάλκεον ἔγχος,	- u u -u u- --uu -uu --	dactylic hexameter	masculine penthemimeral
αἰχμὴ δ’Αἰνείαο κραδαινομένη κατὰ γαίης	-- ---u u-uu- uu --	dactylic hexameter	feminine penthemimeral
ᾤχετ’, ἐπεί ῥ’ἅλιον στιβαρῆς ἀπὸ χειρὸς ὄρουσεν.	-u u- uu- uu- uu -u u--	dactylic hexameter	masculine penthemimeral, hepthemimeral, trithemimeral
Ἰδομενεὺς δ’ἄρα Οἰνόμαον βάλε γαστέρα μέσσην,	-uu- uu -uu- uu -uu --	dactylic hexameter	hepthemimeral, trithemimeral
ῥῆξε δὲ θώρηκος γύαλον, διὰ δ’ἔντερα χαλκὸς	-u u --- uu- uu -uu --	dactylic hexameter	masculine penthemimeral, hepthemimeral
ἤφυσ’· ὃ δ’ἐν κονίῃσι πεσὼν ἕλε γαῖαν ἀγοστῷ.	-u u - uu-u u- uu -u u--	dactylic hexameter	feminine penthemimeral, hepthemimeral, trithemimeral
Ἰδομενεὺς δ’ἐκ μὲν νέκυος δολιχόσκιον ἔγχος	-uu- - - uu- uu-uu --	dactylic hexameter	masculine penthemimeral, hepthemimeral, trithemimeral
ἐσπάσατ’, οὐδ’ ἄρ’ ἔτ’ ἄλλα δυνήσατο τεύχεα καλὰ	-uu - u u -u u-uu -uu --	dactylic hexameter	feminine penthemimeral, trithemimeral
ὤμοιιν ἀφελέσθαι· ἐπείγετο γὰρ βελέεσσιν.	--- uu-u u-uu - uu--	dactylic hexameter	feminine penthemimeral, trithemimeral
οὐ γὰρ ἔτ’ ἔμπεδα γυῖα ποδῶν ἦν ὁρμηθέντι,	- u u -uu -u u- - ----	dactylic hexameter	feminine penthemimeral, hepthemimeral
οὔτ’ ἄρ’ ἐπαΐξαι μεθ’ ἑὸν· βέλος οὔτ’ ἀλέασθαι.	- u u--- u u- uu - uu--	dactylic hexameter	masculine penthemimeral, hepthemimeral
τώ ῥα καὶ ἐν σταδίῃ μὲν ἀμύνετο νηλεὲς ἦμαρ,	- u u - uu- u u-uu -uu --	dactylic hexameter	masculine penthemimeral, trithemimeral
τρέσσαι δ’οὐκ ἔτι ῥίμφα πόδες φέρον ἐκ πολέμοιο.	-- - uu -u u- uu - uu--	dactylic hexameter	feminine penthemimeral, hepthemimeral, trithemimeral
τοῦ δὲ βάδην ἀπιόντος ἀκόντισε δουρὶ φαεινῷ	- u u- uu-u u-uu -u u--	dactylic hexameter	feminine penthemimeral, trithemimeral
Δηΐφοβος· δὴ γάρ οἱ ἔχεν κότον ἐμμενὲς αἰεί.	-uu- - - u u- uu -uu --	dactylic hexameter	masculine penthemimeral, hepthemimeral, trithemimeral
ἀλλ’ ὅ γε καὶ τόθ’ ἅμαρτεν, ὃ δ’Ἀσκάλαφον βάλε δουρὶ	- u u - u u-u u -uu- uu --	dactylic hexameter	feminine penthemimeral, trithemimeral
υἱὸν Ἐνυαλίοιο· δι’ ὤμου δ’ὄβριμον ἔγχος	-u u-uu-u u -- -uu --	dactylic hexameter	feminine penthemimeral
ἔσχεν· ὃ δ’ἐν κονίῃσι πεσὼν ἕλε γαῖαν ἀγοστῷ.	-u u - uu-u u- uu -u u--	dactylic hexameter	feminine penthemimeral, hepthemimeral, trithemimeral
οὐδ’ ἄρα πώ τι πέπυστο βριήπυος ὄβριμος Ἄρης	- uu - u u-u u-uu -uu --	dactylic hexameter	feminine penthemimeral, trithemimeral
υἷος ἑοῖο πεσόντος ἐνὶ κρατερῇ ὑσμίνῃ,	-u u-u u-u u- uu- ---	dactylic hexameter	feminine penthemimeral, hepthemimeral
ἀλλ’ ὅ γ’ἄρ’ ἄκρῳ Ὀλύμπῳ ὑπὸ χρυσέοισι νέφεσσιν	- u u -u u-u u- uu-u u--	dactylic hexameter	feminine penthemimeral, hepthemimeral
ἧστο Διὸς βουλῇσιν ἐελμένος, ἔνθά περ ἄλλοι	-u u- --u u-uu -u u --	dactylic hexameter	feminine penthemimeral, trithemimeral
ἀθάνατοι θεοὶ ἦσαν ἐεργόμενοι πολέμοιο.	-uu- uu -u u-uu- uu--	dactylic hexameter	feminine penthemimeral, trithemimeral
οἳ δ’ἀμφ’ Ἀσκαλάφῳ αὐτοσχεδὸν ὁρμήθησαν·	- - -uu- --uu ----	dactylic hexameter	masculine penthemimeral
Δηΐφοβος μὲν ἀπ’ Ἀσκαλάφου πήληκα φαεινὴν	-uu- u u -uu- --u u--	dactylic hexameter	hepthemimeral, trithemimeral
ἥρπασε, Μηριόνης δὲ θοῷ ἀτάλαντος Ἄρηϊ	-uu -uu- u u- uu-u u--	dactylic hexameter	masculine penthemimeral, hepthemimeral
δουρὶ βραχίονα τύψεν ἐπάλμενος, ἐκ δ’ἄρα χειρὸς	-u u-uu -u u-uu - uu --	dactylic hexameter	feminine penthemimeral
αὐλῶπις τρυφάλεια χαμαὶ βόμβησε πεσοῦσα.	--- uu-u u- --u u--	dactylic hexameter	feminine penthemimeral, hepthemimeral, trithemimeral
Μηριόνης δ’ἐξ αὖτις ἐπάλμενος αἰγυπιὸς ὣς	-uu- - -u u-uu -uu- -	dactylic hexameter	feminine penthemimeral, trithemimeral
ἐξέρυσε πρυμνοῖο βραχίονος ὄβριμον ἔγχος,	-uu- --u u-uu -uu --	dactylic hexameter	feminine penthemimeral, trithemimeral
ἂψ δ’ἑτάρων εἰς ἔθνος ἐχάζετο. τὸν δὲ Πολίτης	- uu- - -u u-uu - u u--	dactylic hexameter	feminine penthemimeral, trithemimeral
αὐτοκασίγνητος περὶ μέσσῳ χεῖρε τιτήνας	-uu--- uu -- -u u--	dactylic hexameter	masculine penthemimeral
ἐξῆγεν πολέμοιο δυσηχέος, ὄφρ’ ἵκεθ’ ἵππους	--- uu-u u-uu - uu --	dactylic hexameter	feminine penthemimeral, trithemimeral
ὠκέας, οἵ οἱ ὄπισθε μάχης ἠδὲ πτολέμοιο	-uu - u u-u u- -- uu--	dactylic hexameter	feminine penthemimeral, hepthemimeral, trithemimeral
ἕστασαν ἡνίοχόν τε καὶ ἅρματα ποικίλ’ ἔχοντες·	-uu -uu- u u -uu -u u--	dactylic hexameter	masculine penthemimeral
οἳ τόν γε προτὶ ἄστυ φέρον βαρέα στενάχοντα	- - - uu -u u- uu- uu--	dactylic hexameter	feminine penthemimeral, hepthemimeral, trithemimeral
τειρόμενον· κατὰ δ’αἷμα νεουτάτου ἔρρεε χειρός.	-uu- uu -u u-uu -uu --	dactylic hexameter	feminine penthemimeral, trithemimeral
οἳ δ’ἄλλοι μάρναντο, βοὴ δ’ἄσβεστος ὀρώρει.	- -- --u u- --u u--	dactylic hexameter	feminine penthemimeral, hepthemimeral, trithemimeral
ἔνθ’ Αἰνέας Ἀφαρῆα Καλητορίδην ἐπορούσας	- -- uu-u u-uu- uu--	dactylic hexameter	feminine penthemimeral, trithemimeral
λαιμὸν τύψ’ ἐπὶ οἷ τετραμμένον ὀξέϊ δουρί·	-- - uu - --uu -uu --	dactylic hexameter	masculine penthemimeral, trithemimeral
ἐκλίνθη δ’ἑτέρωσε κάρη, ἐπὶ δ’ἀσπὶς ἑάφθη	--- uu-u u- uu -u u--	dactylic hexameter	feminine penthemimeral, hepthemimeral, trithemimeral
καὶ κόρυς, ἀμφὶ δέ οἱ θάνατος χύτο θυμοραϊστής.	- uu -u u - uu- uu -uu--	dactylic hexameter	masculine penthemimeral, hepthemimeral
Ἀντίλοχος δὲ Θόωνα μεταστρεφθέντα δοκεύσας	-uu- u u-u u---u u--	dactylic hexameter	feminine penthemimeral, trithemimeral
οὔτασ’ ἐπαΐξας, ἀπὸ δὲ φλέβα πᾶσαν ἔκερσεν,	-u u--- uu - uu -u u--	dactylic hexameter	masculine penthemimeral, hepthemimeral
ἥ τ’ἀνὰ νῶτα θέουσα διαμπερὲς αὐχέν’ ἱκάνει·	- uu -u u-u u-uu -u u--	dactylic hexameter	feminine penthemimeral
τὴν ἀπὸ πᾶσαν ἔκερσεν· ὃ δ’ὕπτιος ἐν κονίῃσι	- uu -u u-u u -uu - uu--	dactylic hexameter	feminine penthemimeral
κάππεσεν, ἄμφω χεῖρε φίλοις ἑτάροισι πετάσσας.	-uu -- -u u- uu-u u--	dactylic hexameter	feminine penthemimeral, hepthemimeral
Ἀντίλοχος δ’ἐπόρουσε, καὶ αἴνυτο τεύχε’ ἀπ’ ὤμων	-uu- uu-u u -uu -u u --	dactylic hexameter	feminine penthemimeral, trithemimeral
παπταίνων· Τρῶες δὲ περισταδὸν ἄλλοθεν ἄλλος	--- -- u u-uu -uu --	dactylic hexameter	masculine penthemimeral, trithemimeral
οὔταζον σάκος εὐρὺ παναίολον, οὐδὲ δύναντο	--- uu -u u-uu -u u--	dactylic hexameter	feminine penthemimeral, trithemimeral
εἴσω ἐπιγράψαι τέρενα χρόα νηλέϊ χαλκῷ	-u u--- uu- uu -uu --	dactylic hexameter	masculine penthemimeral, hepthemimeral
Ἀντιλόχου· πέρι γάρ ῥα Ποσειδάων ἐνοσίχθων	-uu- uu - u u--- uu--	dactylic hexameter	masculine penthemimeral, trithemimeral
Νέστορος υἱὸν ἔρυτο καὶ ἐν πολλοῖσι βέλεσσιν.	-uu -u u-u u - --u u--	dactylic hexameter	feminine penthemimeral, hepthemimeral
οὐ μὲν γάρ ποτ’ ἄνευ δηίων ἦν, ἀλλὰ κατ’ αὐτοὺς	- - - u u- -- - -u u --	dactylic hexameter	masculine penthemimeral, hepthemimeral, trithemimeral
στρωφᾶτ’· οὐδέ οἱ ἔγχος ἔχ’ ἀτρέμας, ἀλλὰ μάλ’ αἰεὶ	-- -u u -u u -uu -u u --	dactylic hexameter	feminine penthemimeral
σειόμενον ἐλέλικτο· τιτύσκετο δὲ φρεσὶν ᾗσιν	-uu- uu-u u-uu - uu --	dactylic hexameter	feminine penthemimeral, trithemimeral
ἤ τευ ἀκοντίσσαι, ἠὲ σχεδὸν ὁρμηθῆναι.	- u u--- -- uu ----	dactylic hexameter	masculine penthemimeral, hepthemimeral
ἀλλ’ οὐ λῆθ’ Ἀδάμαντα τιτυσκόμενος καθ’ ὅμιλον	- - - uu-u u-uu- u u--	dactylic hexameter	feminine penthemimeral, trithemimeral
Ἀσιάδην, ὅ οἱ οὖτα μέσον σάκος ὀξέϊ χαλκῷ	-uu- u u -u u- uu -uu --	dactylic hexameter	feminine penthemimeral, hepthemimeral, trithemimeral
ἐγγύθεν ὁρμηθείς· ἀμενήνωσεν δέ οἱ αἰχμὴν	-uu --- uu--- u u --	dactylic hexameter	masculine penthemimeral
κυανοχαῖτα Ποσειδάων βιότοιο μεγήρας.	-uu-u u--- uu-u u--	dactylic hexameter	hepthemimeral
καὶ τὸ μὲν αὐτοῦ μεῖν’ ὥς τε σκῶλος πυρίκαυστος	- u u -- - - - -- uu--	dactylic hexameter	masculine penthemimeral, hepthemimeral
ἐν σάκει Ἀντιλόχοιο, τὸ δ’ἥμισυ κεῖτ’ ἐπὶ γαίης·	- uu -uu-u u -uu - uu --	dactylic hexameter	feminine penthemimeral
ἂψ δ’ἑτάρων εἰς ἔθνος ἐχάζετο κῆρ’ ἀλεείνων·	- uu- - -u u-uu - uu--	dactylic hexameter	feminine penthemimeral, trithemimeral
Μηριόνης δ’ἀπιόντα μετασπόμενος βάλε δουρὶ	-uu- uu-u u-uu- uu --	dactylic hexameter	feminine penthemimeral, trithemimeral
αἰδοίων τε μεσηγὺ καὶ ὀμφαλοῦ, ἔνθα μάλιστα	--- u u-u u -uu -u u--	dactylic hexameter	feminine penthemimeral, trithemimeral
γίγνετ’ Ἄρης ἀλεγεινὸς ὀϊζυροῖσι βροτοῖσιν.	-u u- uu-u u---u u--	dactylic hexameter	feminine penthemimeral, trithemimeral
ἔνθά οἱ ἔγχος ἔπηξεν· ὃ δ’ἑσπόμενος περὶ δουρὶ	-u u -u u-u u -uu- uu --	dactylic hexameter	feminine penthemimeral
ἤσπαιρ’ ὡς ὅτε βοῦς τόν τ’οὔρεσι βουκόλοι ἄνδρες	-- - uu - - -uu -uu --	dactylic hexameter	masculine penthemimeral, trithemimeral
ἰλλάσιν οὐκ ἐθέλοντα βίῃ δήσαντες ἄγουσιν·	-uu - uu-u u- --u u--	dactylic hexameter	feminine penthemimeral, hepthemimeral, trithemimeral
ὣς ὃ τυπεὶς ἤσπαιρε μίνυνθά περ, οὔ τι μάλα δήν,	- u u- --u u-u u - u u- -	dactylic hexameter	feminine penthemimeral, trithemimeral
ὄφρά οἱ ἐκ χροὸς ἔγχος ἀνεσπάσατ’ ἐγγύθεν ἐλθὼν	-u u - uu -u u-uu -uu --	dactylic hexameter	feminine penthemimeral, trithemimeral
ἥρως Μηριόνης· τὸν δὲ σκότος ὄσσε κάλυψε.	-- -uu- - - uu -u u--	dactylic hexameter	masculine penthemimeral, hepthemimeral
Δηΐπυρον δ’Ἕλενος ξίφεϊ σχεδὸν ἤλασε κόρσην	-uu- uu- uu- uu -uu --	dactylic hexameter	masculine penthemimeral, hepthemimeral, trithemimeral
Θρηϊκίῳ μεγάλῳ, ἀπὸ δὲ τρυφάλειαν ἄραξεν.	-uu- uu- uu - uu-u u--	dactylic hexameter	masculine penthemimeral, hepthemimeral, trithemimeral
ἣ μὲν ἀποπλαγχθεῖσα χαμαὶ πέσε, καί τις Ἀχαιῶν	- u u---u u- uu - u u--	dactylic hexameter	feminine penthemimeral, hepthemimeral
μαρναμένων μετὰ ποσσὶ κυλινδομένην ἐκόμισσε·	-uu- uu -u u-uu- uu--	dactylic hexameter	feminine penthemimeral, trithemimeral
τὸν δὲ κατ’ ὀφθαλμῶν ἐρεβεννὴ νὺξ ἐκάλυψεν.	- u u --- uu-- - uu--	dactylic hexameter	masculine penthemimeral
Ἀτρεΐδην δ’ἄχος εἷλε βοὴν ἀγαθὸν Μενέλαον·	-uu- uu -u u- uu- uu--	dactylic hexameter	feminine penthemimeral, hepthemimeral, trithemimeral
βῆ δ’ἐπαπειλήσας Ἑλένῳ ἥρωϊ ἄνακτι	- uu--- uu- --u u--	dactylic hexameter	masculine penthemimeral, hepthemimeral
ὀξὺ δόρυ κραδάων· ὃ δὲ τόξου πῆχυν ἄνελκε.	-u u- uu- u u -- -u u--	dactylic hexameter	masculine penthemimeral, trithemimeral
τὼ δ’ἄρ’ ὁμαρτήδην ὃ μὲν ἔγχεϊ ὀξυόεντι	- u u--- u u -uu -uu--	dactylic hexameter	masculine penthemimeral
ἵετ’ ἀκοντίσσαι, ὃ δ’ἀπὸ νευρῆφιν ὀϊστῷ.	-u u--- u u- --u u--	dactylic hexameter	masculine penthemimeral, hepthemimeral
Πριαμίδης μὲν ἔπειτα κατὰ στῆθος βάλεν ἰῷ	-uu- u u-u u- -- uu --	dactylic hexameter	feminine penthemimeral, hepthemimeral, trithemimeral
θώρηκος γύαλον, ἀπὸ δ’ἔπτατο πικρὸς ὀϊστός.	--- uu- uu -uu -u u--	dactylic hexameter	masculine penthemimeral, trithemimeral
ὡς δ’ὅτ’ ἀπὸ πλατέος πτυόφιν μεγάλην κατ’ ἀλωὴν	- u u- uu- uu- uu- u u--	dactylic hexameter	masculine penthemimeral, hepthemimeral, trithemimeral
θρῴσκωσιν κύαμοι μελανόχροες ἢ ἐρέβινθοι	--- uu- uu-uu - uu--	dactylic hexameter	masculine penthemimeral, trithemimeral
πνοιῇ ὕπο λιγυρῇ καὶ λικμητῆρος ἐρωῇ,	-u u- uu- - ---u u--	dactylic hexameter	masculine penthemimeral, trithemimeral
ὣς ἀπὸ θώρηκος Μενελάου κυδαλίμοιο	- uu --- uu-- -uu--	dactylic hexameter	masculine penthemimeral
πολλὸν ἀποπλαγχθεὶς ἑκὰς ἔπτατο πικρὸς ὀϊστός.	-u u--- uu -uu -u u--	dactylic hexameter	masculine penthemimeral
Ἀτρεΐδης δ’ἄρα χεῖρα βοὴν ἀγαθὸς Μενέλαος	-uu- uu -u u- uu- uu--	dactylic hexameter	feminine penthemimeral, hepthemimeral, trithemimeral
τὴν βάλεν ᾗ ῥ’ἔχε τόξον ἐΰξοον· ἐν δ’ἄρα τόξῳ	- uu - uu -u u-uu - uu --	dactylic hexameter	feminine penthemimeral, trithemimeral
ἀντικρὺ διὰ χειρὸς ἐλήλατο χάλκεον ἔγχος.	--- uu -u u-uu -uu --	dactylic hexameter	feminine penthemimeral, trithemimeral
ἂψ δ’ἑτάρων εἰς ἔθνος ἐχάζετο κῆρ’ ἀλεείνων	- uu- - -u u-uu - uu--	dactylic hexameter	feminine penthemimeral, trithemimeral
χεῖρα παρακρεμάσας· τὸ δ’ἐφέλκετο μείλινον ἔγχος.	-u u-uu- u u-uu -uu --	dactylic hexameter	masculine penthemimeral
καὶ τὸ μὲν ἐκ χειρὸς ἔρυσεν μεγάθυμος Ἀγήνωρ,	- u u - -- uu- uu-u u--	dactylic hexameter	masculine penthemimeral, hepthemimeral, trithemimeral
αὐτὴν δὲ ξυνέδησεν ἐϋστρεφεῖ οἰὸς ἀώτῳ	-- - uu-u u-uu -u u--	dactylic hexameter	feminine penthemimeral, trithemimeral
σφενδόνῃ, ἣν ἄρα οἱ θεράπων ἔχε ποιμένι λαῶν.	-uu - uu - uu- uu -uu --	dactylic hexameter	masculine penthemimeral, hepthemimeral, trithemimeral
Πείσανδρος δ’ἰθὺς Μενελάου κυδαλίμοιο	--- -- uu-- -uu--	dactylic hexameter	masculine penthemimeral, trithemimeral
ἤϊε· τὸν δ’ἄγε μοῖρα κακὴ θανάτοιο τέλος δὲ	-uu - uu -u u- uu-u u- -	dactylic hexameter	feminine penthemimeral, hepthemimeral, trithemimeral
σοὶ Μενέλαε δαμῆναι ἐν αἰνῇ δηϊοτῆτι.	- uu-u u-u u -- -uu--	dactylic hexameter	feminine penthemimeral
οἳ δ’ὅτε δὴ σχεδὸν ἦσαν ἐπ’ ἀλλήλοισιν ἰόντες	- uu - uu -u u ---u u--	dactylic hexameter	feminine penthemimeral, trithemimeral
Ἀτρεΐδης μὲν ἅμαρτε, παραὶ δέ οἱ ἐτράπετ’ ἔγχος,	-uu- u u-u u- u u -uu --	dactylic hexameter	feminine penthemimeral, hepthemimeral, trithemimeral
Πείσανδρος δὲ σάκος Μενελάου κυδαλίμοιο	--- u u- uu-- -uu--	dactylic hexameter	masculine penthemimeral, trithemimeral
οὔτασεν, οὐδὲ διὰ πρὸ δυνήσατο χαλκὸν ἐλάσσαι·	-uu -u u- u u-uu -u u--	dactylic hexameter	masculine penthemimeral
ἔσχεθε γὰρ σάκος εὐρύ, κατεκλάσθη δ’ἐνὶ καυλῷ	-uu - uu -u u--- uu --	dactylic hexameter	feminine penthemimeral, trithemimeral
ἔγχος· ὃ δὲ φρεσὶν ᾗσι χάρη καὶ ἐέλπετο νίκην.	-u u - uu -u u- u u-uu --	dactylic hexameter	feminine penthemimeral, hepthemimeral, trithemimeral
Ἀτρεΐδης δὲ ἐρυσσάμενος ξίφος ἀργυρόηλον	-uu- u u-uu- uu -uu--	dactylic hexameter	hepthemimeral, trithemimeral
ἆλτ’ ἐπὶ Πεισάνδρῳ· ὃ δ’ὑπ’ ἀσπίδος εἵλετο καλὴν	- uu --- u u -uu -uu --	dactylic hexameter	masculine penthemimeral
ἀξίνην εὔχαλκον ἐλαΐνῳ ἀμφὶ πελέκκῳ	--- --u u-uu -u u--	dactylic hexameter	feminine penthemimeral, trithemimeral
μακρῷ ἐϋξέστῳ· ἅμα δ’ἀλλήλων ἐφίκοντο.	-u u--- uu --- uu--	dactylic hexameter	masculine penthemimeral
ἤτοι ὃ μὲν κόρυθος φάλον ἤλασεν ἱπποδασείης	-u u - uu- uu -uu -uu--	dactylic hexameter	masculine penthemimeral, trithemimeral
ἄκρον ὑπὸ λόφον αὐτόν, ὃ δὲ προσιόντα μέτωπον	-u u- uu -u u - uu-u u--	dactylic hexameter	feminine penthemimeral, hepthemimeral, trithemimeral
ῥινὸς ὕπερ πυμάτης· λάκε δ’ὀστέα, τὼ δέ οἱ ὄσσε	-u u- uu- uu -uu - u u --	dactylic hexameter	masculine penthemimeral, trithemimeral
πὰρ ποσὶν αἱματόεντα χαμαὶ πέσον ἐν κονίῃσιν,	- uu -uu-u u- uu - uu--	dactylic hexameter	feminine penthemimeral, hepthemimeral
ἰδνώθη δὲ πεσών· ὃ δὲ λὰξ ἐν στήθεσι βαίνων	--- u u- u u - - -uu --	dactylic hexameter	masculine penthemimeral, hepthemimeral, trithemimeral
τεύχεά τ’ἐξενάριξε καὶ εὐχόμενος ἔπος ηὔδα·	-uu -uu-u u -uu- uu --	dactylic hexameter	feminine penthemimeral
λείψετέ θην οὕτω γε νέας Δαναῶν ταχυπώλων	-uu - -- u u- uu- uu--	dactylic hexameter	masculine penthemimeral, hepthemimeral, trithemimeral
Τρῶες ὑπερφίαλοι δεινῆς ἀκόρητοι ἀϋτῆς,	-u u-uu- -- uu-u u--	dactylic hexameter	masculine penthemimeral, hepthemimeral
ἄλλης μὲν λώβης τε καὶ αἴσχεος οὐκ ἐπιδευεῖς	-- - -- u u -uu - uu--	dactylic hexameter	masculine penthemimeral, trithemimeral
ἣν ἐμὲ λωβήσασθε κακαὶ κύνες, οὐδέ τι θυμῷ	- uu ---u u- uu -u u --	dactylic hexameter	feminine penthemimeral, hepthemimeral
Ζηνὸς ἐριβρεμέτεω χαλεπὴν ἐδείσατε μῆνιν	-u u-uu- uu- --uu --	dactylic hexameter	masculine penthemimeral, hepthemimeral
ξεινίου, ὅς τέ ποτ’ ὔμμι διαφθέρσει πόλιν αἰπήν·	-uu - u u -u u--- uu --	dactylic hexameter	feminine penthemimeral, trithemimeral
οἵ μευ κουριδίην ἄλοχον καὶ κτήματα πολλὰ	- - -uu- uu- - -uu --	dactylic hexameter	masculine penthemimeral, hepthemimeral
μὰψ οἴχεσθ’ ἀνάγοντες, ἐπεὶ φιλέεσθε παρ’ αὐτῇ·	- -- uu-u u- uu-u u --	dactylic hexameter	feminine penthemimeral, hepthemimeral, trithemimeral
νῦν αὖτ’ ἐν νηυσὶν μενεαίνετε ποντοπόροισι	- - - -- uu-uu -uu--	dactylic hexameter	masculine penthemimeral, trithemimeral
πῦρ ὀλοὸν βαλέειν, κτεῖναι δ’ἥρωας Ἀχαιούς.	- uu- uu- -- --u u--	dactylic hexameter	masculine penthemimeral, hepthemimeral, trithemimeral
ἀλλά ποθι σχήσεσθε καὶ ἐσσύμενοί περ Ἄρηος.	-u u- --u u -uu- u u--	dactylic hexameter	feminine penthemimeral, trithemimeral
Ζεῦ πάτερ ἦ τέ σέ φασι περὶ φρένας ἔμμεναι ἄλλων	- uu - u u -u u- uu -uu --	dactylic hexameter	feminine penthemimeral, hepthemimeral, trithemimeral
ἀνδρῶν ἠδὲ θεῶν· σέο δ’ἐκ τάδε πάντα πέλονται·	-- -u u- uu - uu -u u--	dactylic hexameter	masculine penthemimeral, hepthemimeral
οἷον δὴ ἄνδρεσσι χαρίζεαι ὑβριστῇσι	-- - --u u-uu ----	dactylic hexameter	feminine penthemimeral, trithemimeral
Τρωσίν, τῶν μένος αἰὲν ἀτάσθαλον, οὐδὲ δύνανται	-- - uu -u u-uu -u u--	dactylic hexameter	feminine penthemimeral, trithemimeral
φυλόπιδος κορέσασθαι ὁμοιΐου πτολέμοιο.	-uu- uu-u u--- uu--	dactylic hexameter	feminine penthemimeral, trithemimeral
πάντων μὲν κόρος ἐστὶ καὶ ὕπνου καὶ φιλότητος	-- - uu -u u -- - uu--	dactylic hexameter	feminine penthemimeral, trithemimeral
μολπῆς τε γλυκερῆς καὶ ἀμύμονος ὀρχηθμοῖο,	-- - uu- u u-uu ----	dactylic hexameter	masculine penthemimeral, trithemimeral
τῶν πέρ τις καὶ μᾶλλον ἐέλδεται ἐξ ἔρον εἷναι	- - - - -u u-uu - uu --	dactylic hexameter	feminine penthemimeral, trithemimeral
ἢ πολέμου· Τρῶες δὲ μάχης ἀκόρητοι ἔασιν.	- uu- -- u u- uu-u u--	dactylic hexameter	masculine penthemimeral, hepthemimeral, trithemimeral
ὣς εἰπὼν τὰ μὲν ἔντε’ ἀπὸ χροὸς αἱματόεντα	- -- u u -u u- uu -uu--	dactylic hexameter	feminine penthemimeral, hepthemimeral, trithemimeral
συλήσας ἑτάροισι δίδου Μενέλαος ἀμύμων,	--- uu-u u- uu-u u--	dactylic hexameter	feminine penthemimeral, hepthemimeral, trithemimeral
αὐτὸς δ’αὖτ’ ἐξ αὖτις ἰὼν προμάχοισιν ἐμίχθη.	-- - - -u u- uu-u u--	dactylic hexameter	feminine penthemimeral, hepthemimeral, trithemimeral
ἔνθά οἱ υἱὸς ἐπᾶλτο Πυλαιμένεος βασιλῆος	-u u -u u-u u-uu- uu--	dactylic hexameter	feminine penthemimeral
Ἁρπαλίων, ὅ ῥα πατρὶ φίλῳ ἕπετο πτολεμίξων	-uu- u u -u u- uu- uu--	dactylic hexameter	feminine penthemimeral, hepthemimeral, trithemimeral
ἐς τροίην, οὐδ’ αὖτις ἀφίκετο πατρίδα γαῖαν·	- -- - -u u-uu -uu --	dactylic hexameter	feminine penthemimeral, trithemimeral
ὅς ῥα τότ’ Ἀτρεΐδαο μέσον σάκος οὔτασε δουρὶ	- u u -uu-u u- uu -uu --	dactylic hexameter	feminine penthemimeral, hepthemimeral
ἐγγύθεν, οὐδὲ διὰ πρὸ δυνήσατο χαλκὸν ἐλάσσαι	-uu -u u- u u-uu -u u--	dactylic hexameter	masculine penthemimeral
ἂψ δ’ἑτάρων εἰς ἔθνος ἐχάζετο κῆρ’ ἀλεείνων	- uu- - -u u-uu - uu--	dactylic hexameter	feminine penthemimeral, trithemimeral
πάντοσε παπταίνων μή τις χρόα χαλκῷ ἐπαύρῃ.	-uu --- - - uu -u u--	dactylic hexameter	masculine penthemimeral, hepthemimeral
Μηριόνης δ’ἀπιόντος ἵει χαλκήρε’ ὀϊστόν,	-uu- uu-u u- --u u--	dactylic hexameter	feminine penthemimeral, hepthemimeral, trithemimeral
καί ῥ’ἔβαλε γλουτὸν κάτα δεξιόν· αὐτὰρ ὀϊστὸς	- uu- -- uu -uu -u u--	dactylic hexameter	masculine penthemimeral, trithemimeral
ἀντικρὺ κατὰ κύστιν ὑπ’ ὀστέον ἐξεπέρησεν.	--- uu -u u -uu -uu--	dactylic hexameter	feminine penthemimeral, trithemimeral
ἑζόμενος δὲ κατ’ αὖθι φίλων ἐν χερσὶν ἑταίρων	-uu- u u -u u- - -u u--	dactylic hexameter	feminine penthemimeral, hepthemimeral, trithemimeral
θυμὸν ἀποπνείων, ὥς τε σκώληξ ἐπὶ γαίῃ	-u u--- - - -- uu --	dactylic hexameter	masculine penthemimeral, hepthemimeral
κεῖτο ταθείς· ἐκ δ’αἷμα μέλαν ῥέε, δεῦε δὲ γαῖαν.	-u u- - -u u- uu -u u --	dactylic hexameter	feminine penthemimeral, hepthemimeral, trithemimeral
τὸν μὲν Παφλαγόνες μεγαλήτορες ἀμφεπένοντο,	- - -uu- uu-uu -uu--	dactylic hexameter	masculine penthemimeral
ἐς δίφρον δ’ἀνέσαντες ἄγον προτὶ Ἴλιον ἱρὴν	- -- uu-u u- uu -uu --	dactylic hexameter	feminine penthemimeral, hepthemimeral, trithemimeral
ἀχνύμενοι· μετὰ δέ σφι πατὴρ κίε δάκρυα λείβων,	-uu- uu - u u- uu -uu --	dactylic hexameter	masculine penthemimeral, hepthemimeral, trithemimeral
ποινὴ δ’οὔ τις παιδὸς ἐγίγνετο τεθνηῶτος.	-- - - -u u-uu ----	dactylic hexameter	feminine penthemimeral, trithemimeral
τοῦ δὲ Πάρις μάλα θυμὸν ἀποκταμένοιο χολώθη·	- u u- uu -u u-uu-u u--	dactylic hexameter	feminine penthemimeral, trithemimeral
ξεῖνος γάρ οἱ ἔην πολέσιν μετὰ Παφλαγόνεσσι·	-- - u u- uu- uu -uu--	dactylic hexameter	masculine penthemimeral, hepthemimeral, trithemimeral
τοῦ ὅ γε χωόμενος προΐει χαλκήρε’ ὀϊστόν.	- u u -uu- uu- --u u--	dactylic hexameter	masculine penthemimeral, hepthemimeral
ἦν δέ τις Εὐχήνωρ Πολυΐδου μάντιος υἱὸς	- u u --- uu-- -uu --	dactylic hexameter	masculine penthemimeral
ἀφνειός τ’ἀγαθός τε Κορινθόθι οἰκία ναίων,	--- uu- u u-uu -uu --	dactylic hexameter	masculine penthemimeral, trithemimeral
ὅς ῥ’εὖ εἰδὼς κῆρ’ ὀλοὴν ἐπὶ νηὸς ἔβαινε·	- - -- - uu- uu -u u--	dactylic hexameter	masculine penthemimeral, hepthemimeral
πολλάκι γάρ οἱ ἔειπε γέρων ἀγαθὸς Πολύϊδος	-uu - u u-u u- uu- uu--	dactylic hexameter	feminine penthemimeral, hepthemimeral, trithemimeral
νούσῳ ὑπ’ ἀργαλέῃ φθίσθαι οἷς ἐν μεγάροισιν,	-u u -uu- -- - - uu--	dactylic hexameter	masculine penthemimeral, hepthemimeral
ἢ μετ’ Ἀχαιῶν νηυσὶν ὑπὸ Τρώεσσι δαμῆναι·	- u u-- -u u- --u u--	dactylic hexameter	feminine penthemimeral, hepthemimeral
τώ ῥ’ἅμα τ’ἀργαλέην θωὴν ἀλέεινεν Ἀχαιῶν	- uu -uu- -- uu-u u--	dactylic hexameter	masculine penthemimeral, hepthemimeral
νοῦσόν τε στυγερήν, ἵνα μὴ πάθοι ἄλγεα θυμῷ.	-- - uu- uu - uu -uu --	dactylic hexameter	masculine penthemimeral, hepthemimeral, trithemimeral
τὸν βάλ’ ὑπὸ γναθμοῖο καὶ οὔατος· ὦκα δὲ θυμὸς	- u u- --u u -uu -u u --	dactylic hexameter	feminine penthemimeral, trithemimeral
ᾤχετ’ ἀπὸ μελέων, στυγερὸς δ’ἄρα μιν σκότος εἷλεν.	-u u- uu- uu- uu - uu --	dactylic hexameter	masculine penthemimeral, hepthemimeral, trithemimeral
ὣς οἳ μὲν μάρναντο δέμας πυρὸς αἰθομένοιο·	- - - --u u- uu -uu--	dactylic hexameter	feminine penthemimeral, hepthemimeral, trithemimeral
Ἕκτωρ δ’οὐκ ἐπέπυστο Διῒ φίλος, οὐδέ τι ᾔδη	-- - uu-u u- uu -u u --	dactylic hexameter	feminine penthemimeral, hepthemimeral, trithemimeral
ὅττί ῥά οἱ νηῶν ἐπ’ ἀριστερὰ δηϊόωντο	-u u - -- u u-uu -uu--	dactylic hexameter	masculine penthemimeral, trithemimeral
λαοὶ ὑπ’ Ἀργείων. τάχα δ’ἂν καὶ κῦδος Ἀχαιῶν	-u u --- uu - - -u u--	dactylic hexameter	masculine penthemimeral, hepthemimeral
ἔπλετο· τοῖος γὰρ γαιήοχος ἐννοσίγαιος	-uu -- - --uu -uu--	dactylic hexameter	masculine penthemimeral
ὄτρυν’ Ἀργείους, πρὸς δὲ σθένει αὐτὸς ἄμυνεν·	-- --- - - uu -u u--	dactylic hexameter	masculine penthemimeral, hepthemimeral
ἀλλ’ ἔχεν ᾗ τὰ πρῶτα πύλας καὶ τεῖχος ἐσᾶλτο	- uu - - -u u- - -u u--	dactylic hexameter	feminine penthemimeral, hepthemimeral, trithemimeral
ῥηξάμενος Δαναῶν πυκινὰς στίχας ἀσπιστάων,	-uu- uu- uu- uu ----	dactylic hexameter	masculine penthemimeral, hepthemimeral, trithemimeral
ἔνθ’ ἔσαν Αἴαντός τε νέες καὶ Πρωτεσιλάου	- uu --- u u- - -uu--	dactylic hexameter	masculine penthemimeral, hepthemimeral
θῖν’ ἔφ’ ἁλὸς πολιῆς εἰρυμέναι· αὐτὰρ ὕπερθε	- u u- uu- --uu -u u--	dactylic hexameter	masculine penthemimeral, trithemimeral
τεῖχος ἐδέδμητο χθαμαλώτατον, ἔνθα μάλιστα	-u u--- uu-uu -u u--	dactylic hexameter	masculine penthemimeral
ζαχρηεῖς γίγνοντο μάχῃ αὐτοί τε καὶ ἵπποι.	--- --u u- -- u u --	dactylic hexameter	feminine penthemimeral, hepthemimeral, trithemimeral
ἔνθα δὲ Βοιωτοὶ καὶ Ἰάονες ἑλκεχίτωνες	-u u --- u u-uu -uu--	dactylic hexameter	masculine penthemimeral
Λοκροὶ καὶ Φθῖοι καὶ φαιδιμόεντες Ἐπειοὶ	-- - -- - -uu-u u--	dactylic hexameter	masculine penthemimeral, trithemimeral
σπουδῇ ἐπαΐσσοντα νεῶν ἔχον, οὐδὲ δύναντο	-u u---u u- uu -u u--	dactylic hexameter	feminine penthemimeral, hepthemimeral
ὦσαι ἀπὸ σφείων φλογὶ εἴκελον Ἕκτορα δῖον	-u u- -- uu -uu -uu --	dactylic hexameter	masculine penthemimeral, trithemimeral
οἳ μὲν Ἀθηναίων προλελεγμένοι· ἐν δ’ἄρα τοῖσιν	- u u--- uu-uu - uu --	dactylic hexameter	masculine penthemimeral
ἦρχ’ υἱὸς Πετεῶο Μενεσθεύς, οἳ δ’ἅμ’ ἕποντο	- -- uu-u u-- - u u--	dactylic hexameter	feminine penthemimeral, trithemimeral
Φείδας τε Στιχίος τε Βίας τ’ἐΰς· αὐτὰρ Ἐπειῶν	-- - uu- u u- uu -u u--	dactylic hexameter	masculine penthemimeral, hepthemimeral, trithemimeral
Φυλεΐδης τε Μέγης Ἀμφίων τε Δρακίος τε,	-uu- u u- --- - uu- -	dactylic hexameter	masculine penthemimeral, trithemimeral
πρὸ Φθίων δὲ Μέδων τε μενεπτόλεμός τε Ποδάρκης.	- -- u u- u u-uu- u u--	dactylic hexameter	masculine penthemimeral, trithemimeral
ἤτοι ὃ μὲν νόθος υἱὸς Ὀϊλῆος θείοιο	-u u - uu -u u--- ---	dactylic hexameter	feminine penthemimeral, trithemimeral
ἔσκε Μέδων Αἴαντος ἀδελφεός· αὐτὰρ ἔναιεν	-u u- --u u-uu -u u--	dactylic hexameter	feminine penthemimeral, trithemimeral
ἐν Φυλάκῃ γαίης ἄπο πατρίδος ἄνδρα κατακτὰς	- uu- -- uu -uu -u u--	dactylic hexameter	masculine penthemimeral, trithemimeral
γνωτὸν μητρυιῆς Ἐριώπιδος, ἣν ἔχ’ Ὀϊλεύς·	-- --- uu-uu - u u--	dactylic hexameter	masculine penthemimeral
αὐτὰρ ὃ Ἰφίκλοιο πάϊς τοῦ Φυλακίδαο.	-u u ---u u- - -uu--	dactylic hexameter	feminine penthemimeral, hepthemimeral
οἳ μὲν πρὸ Φθίων μεγαθύμων θωρηχθέντες	- - - -- uu-- ----	dactylic hexameter	masculine penthemimeral, trithemimeral
ναῦφιν ἀμυνόμενοι μετὰ Βοιωτῶν ἐμάχοντο·	-u u-uu- uu --- uu--	dactylic hexameter	masculine penthemimeral
Αἴας δ’οὐκέτι πάμπαν Ὀϊλῆος ταχὺς υἱὸς	-- -uu -u u--- uu --	dactylic hexameter	feminine penthemimeral
ἵστατ’ ἀπ’ Αἴαντος Τελαμωνίου οὐδ’ ἠβαιόν,	-u u --- uu-uu - ---	dactylic hexameter	masculine penthemimeral
ἀλλ’ ὥς τ’ἐν νειῷ βόε οἴνοπε πηκτὸν ἄροτρον	- - - -- uu -uu -u u--	dactylic hexameter	masculine penthemimeral, trithemimeral
ἶσον θυμὸν ἔχοντε τιταίνετον· ἀμφὶ δ’ἄρά σφι	-- -u u-u u-uu -u u- -	dactylic hexameter	feminine penthemimeral
πρυμνοῖσιν κεράεσσι πολὺς ἀνακηκίει ἱδρώς·	--- uu-u u- uu-uu --	dactylic hexameter	feminine penthemimeral, hepthemimeral, trithemimeral
τὼ μέν τε ζυγὸν οἶον ἐΰξοον ἀμφὶς ἐέργει	- - - uu -u u-uu -u u--	dactylic hexameter	feminine penthemimeral, trithemimeral
ἱεμένω κατὰ ὦλκα· τέμει δέ τε τέλσον ἀρούρης·	-uu- uu -u u- u u -u u--	dactylic hexameter	feminine penthemimeral, hepthemimeral, trithemimeral
ὣς τὼ παρβεβαῶτε μάλ’ ἕστασαν ἀλλήλοιιν.	- - -uu-u u -uu ----	dactylic hexameter	feminine penthemimeral
ἀλλ’ ἤτοι Τελαμωνιάδῃ πολλοί τε καὶ ἐσθλοὶ	- -- uu-uu- -- u u --	dactylic hexameter	hepthemimeral, trithemimeral
λαοὶ ἕπονθ’ ἕταροι, οἵ οἱ σάκος ἐξεδέχοντο	-u u- uu- - - uu -uu--	dactylic hexameter	masculine penthemimeral, hepthemimeral, trithemimeral
ὁππότε μιν κάματός τε καὶ ἱδρὼς γούναθ’ ἵκοιτο.	-uu - uu- u u -- -u u--	dactylic hexameter	masculine penthemimeral, trithemimeral
οὐδ’ ἄρ’ Ὀϊλιάδῃ μεγαλήτορι Λοκροὶ ἕποντο·	- u u-uu- uu-uu -u u--	dactylic hexameter	masculine penthemimeral
οὐ γάρ σφι σταδίῃ ὑσμίνῃ μίμνε φίλον κῆρ·	- - - uu- --- -u u- -	dactylic hexameter	masculine penthemimeral, trithemimeral
οὐ γὰρ ἔχον κόρυθας χαλκήρεας ἱπποδασείας,	- u u- uu- --uu -uu--	dactylic hexameter	masculine penthemimeral, trithemimeral
οὐδ’ ἔχον ἀσπίδας εὐκύκλους καὶ μείλινα δοῦρα,	- uu -uu --- - -uu --	dactylic hexameter	hepthemimeral
ἀλλ’ ἄρα τόξοισιν καὶ ἐϋστρεφεῖ οἶος ἀώτῳ	- uu --- u u-uu -u u--	dactylic hexameter	masculine penthemimeral
Ἴλιον εἰς ἅμ’ ἕποντο πεποιθότες, οἷσιν ἔπειτα	-uu - u u-u u-uu -u u--	dactylic hexameter	feminine penthemimeral, trithemimeral
ταρφέα βάλλοντες Τρώων ῥήγνυντο φάλαγγας·	-uu --- -- --u u--	dactylic hexameter	masculine penthemimeral, hepthemimeral
δή ῥα τόθ’ οἳ μὲν πρόσθε σὺν ἔντεσι δαιδαλέοισι	- u u - - -u u -uu -uu--	dactylic hexameter	feminine penthemimeral, trithemimeral
μάρναντο Τρωσίν τε καὶ Ἕκτορι χαλκοκορυστῇ,	--- -- u u -uu -uu--	dactylic hexameter	masculine penthemimeral, trithemimeral
οἳ δ’ὄπιθεν βάλλοντες ἐλάνθανον· οὐδέ τι χάρμης	- uu- --u u-uu -u u --	dactylic hexameter	feminine penthemimeral, trithemimeral
Τρῶες μιμνήσκοντο· συνεκλόνεον γὰρ ὀϊστοί.	-- ---u u-uu- u u--	dactylic hexameter	feminine penthemimeral
ἔνθά κε λευγαλέως νηῶν ἄπο καὶ κλισιάων	-u u -uu- -- uu - uu--	dactylic hexameter	masculine penthemimeral, hepthemimeral
Τρῶες ἐχώρησαν προτὶ Ἴλιον ἠνεμόεσσαν,	-u u--- uu -uu -uu--	dactylic hexameter	masculine penthemimeral
εἰ μὴ Πουλυδάμας θρασὺν Ἕκτορα εἶπε παραστάς·	- - -uu- uu -uu -u u--	dactylic hexameter	masculine penthemimeral
Ἕκτορ ἀμήχανός ἐσσι παραρρητοῖσι πιθέσθαι.	-u u-uu -u u---u u--	dactylic hexameter	feminine penthemimeral
οὕνεκά τοι περὶ δῶκε θεὸς πολεμήϊα ἔργα	-uu - uu -u u- uu-uu --	dactylic hexameter	feminine penthemimeral, hepthemimeral, trithemimeral
τοὔνεκα καὶ βουλῇ ἐθέλεις περιίδμεναι ἄλλων·	-uu - -- uu- uu-uu --	dactylic hexameter	masculine penthemimeral, hepthemimeral, trithemimeral
ἀλλ’ οὔ πως ἅμα πάντα δυνήσεαι αὐτὸς ἑλέσθαι.	- - - uu -u u-uu -u u--	dactylic hexameter	feminine penthemimeral, trithemimeral
ἄλλῳ μὲν γὰρ ἔδωκε θεὸς πολεμήϊα ἔργα,	-- - u u-u u- uu-uu --	dactylic hexameter	feminine penthemimeral, hepthemimeral, trithemimeral
ἄλλῳ δ’ὀρχηστύν, ἑτέρῳ κίθαριν καὶ ἀοιδήν,	-- --- uu- uu- u u--	dactylic hexameter	masculine penthemimeral, hepthemimeral
ἄλλῳ δ’ἐν στήθεσσι τιθεῖ νόον εὐρύοπα Ζεὺς	-- - --u u- uu -uu- -	dactylic hexameter	feminine penthemimeral, hepthemimeral, trithemimeral
ἐσθλόν, τοῦ δέ τε πολλοὶ ἐπαυρίσκοντ’ ἄνθρωποι,	-- - u u -u u--- ---	dactylic hexameter	feminine penthemimeral, trithemimeral
καί τε πολέας ἐσάωσε, μάλιστα δὲ καὐτὸς ἀνέγνω.	- u u- uu-u u-u u -u u--	dactylic hexameter	feminine penthemimeral, trithemimeral
αὐτὰρ ἐγὼν ἐρέω ὥς μοι δοκεῖ εἶναι ἄριστα·	-u u- uu- - - uu -u u--	dactylic hexameter	masculine penthemimeral, hepthemimeral, trithemimeral
πάντῃ γάρ σε περὶ στέφανος πολέμοιο δέδηε·	-- - u u- uu- uu-u u--	dactylic hexameter	masculine penthemimeral, hepthemimeral, trithemimeral
Τρῶες δὲ μεγάθυμοι ἐπεὶ κατὰ τεῖχος ἔβησαν	-- - uu-u u- uu -u u--	dactylic hexameter	feminine penthemimeral, hepthemimeral, trithemimeral
οἳ μὲν ἀφεστᾶσιν σὺν τεύχεσιν, οἳ δὲ μάχονται	- u u--- - -uu - u u--	dactylic hexameter	masculine penthemimeral
παυρότεροι πλεόνεσσι κεδασθέντες κατὰ νῆας.	-uu- uu-u u--- uu --	dactylic hexameter	feminine penthemimeral, trithemimeral
ἀλλ’ ἀναχασσάμενος κάλει ἐνθάδε πάντας ἀρίστους·	- uu-uu- uu -uu -u u--	dactylic hexameter	masculine penthemimeral
ἔνθεν δ’ἂν μάλα πᾶσαν ἐπιφρασσαίμεθα βουλὴν	-- - uu -u u---uu --	dactylic hexameter	feminine penthemimeral, trithemimeral
ἤ κεν ἐνὶ νήεσσι πολυκλήϊσι πέσωμεν	- u u- --u u---u u--	dactylic hexameter	feminine penthemimeral, trithemimeral
αἴ κ’ἐθέλῃσι θεὸς δόμεναι κράτος, ἦ κεν ἔπειτα	- uu-u u- uu- uu - u u--	dactylic hexameter	masculine penthemimeral, hepthemimeral
πὰρ νηῶν ἔλθωμεν ἀπήμονες. ἦ γὰρ ἔγωγε	- -- --u u-uu - u u--	dactylic hexameter	feminine penthemimeral, trithemimeral
δείδω μὴ τὸ χθιζὸν ἀποστήσωνται Ἀχαιοὶ	-- - - -u u---u u--	dactylic hexameter	feminine penthemimeral, trithemimeral
χρεῖος, ἐπεὶ παρὰ νηυσὶν ἀνὴρ ἆτος πολέμοιο	-u u- uu -u u- -- uu--	dactylic hexameter	feminine penthemimeral, hepthemimeral, trithemimeral
μίμνει, ὃν οὐκέτι πάγχυ μάχης σχήσεσθαι ὀΐω.	-u u -uu -u u- --u u--	dactylic hexameter	feminine penthemimeral, hepthemimeral
ὣς φάτο Πουλυδάμας, ἅδε δ’Ἕκτορι μῦθος ἀπήμων,	- uu -uu- uu -uu -u u--	dactylic hexameter	masculine penthemimeral
αὐτίκα δ’ἐξ ὀχέων σὺν τεύχεσιν ἆλτο χαμᾶζε	-uu - uu- - -uu -u u--	dactylic hexameter	masculine penthemimeral, trithemimeral
καί μιν φωνήσας ἔπεα πτερόεντα προσηύδα·	- - --- uu- uu-u u--	dactylic hexameter	masculine penthemimeral, hepthemimeral
Πουλυδάμα σὺ μὲν αὐτοῦ ἐρύκακε πάντας ἀρίστους,	-uu- u u -u u-uu -u u--	dactylic hexameter	feminine penthemimeral, trithemimeral
αὐτὰρ ἐγὼ κεῖσ’ εἶμι καὶ ἀντιόω πολέμοιο·	-u u- - -u u -uu- uu--	dactylic hexameter	feminine penthemimeral, trithemimeral
αἶψα δ’ἐλεύσομαι αὖτις ἐπὴν εὖ τοῖς ἐπιτείλω.	-u u-uu -u u- - - uu--	dactylic hexameter	feminine penthemimeral, hepthemimeral
ἦ ῥα, καὶ ὁρμήθη ὄρεϊ νιφόεντι ἐοικὼς	- u u --- uu- uu-u u--	dactylic hexameter	masculine penthemimeral, hepthemimeral
κεκλήγων, διὰ δὲ Τρώων πέτετ’ ἠδ’ ἐπικούρων.	--- uu - -- uu - uu--	dactylic hexameter	masculine penthemimeral, hepthemimeral, trithemimeral
οἳ δ’ἐς Πανθοΐδην ἀγαπήνορα Πουλυδάμαντα	- - -uu- uu-uu -uu--	dactylic hexameter	masculine penthemimeral
πάντες ἐπεσσεύοντ’, ἐπεὶ Ἕκτορος ἔκλυον αὐδήν.	-u u--- uu -uu -uu --	dactylic hexameter	masculine penthemimeral
αὐτὰρ ὃ Δηΐφοβόν τε βίην θ’Ἑλένοιο ἄνακτος	-u u -uu- u u- uu-u u--	dactylic hexameter	masculine penthemimeral, hepthemimeral
Ἀσιάδην τ’Ἀδάμαντα καὶ Ἄσιον Ὑρτάκου υἱὸν	-uu- uu-u u -uu -uu --	dactylic hexameter	feminine penthemimeral, trithemimeral
φοίτα ἀνὰ προμάχους διζήμενος, εἴ που ἐφεύροι.	-u u- uu- --uu - u u--	dactylic hexameter	masculine penthemimeral, trithemimeral
τοὺς δ’εὗρ’ οὐκέτι πάμπαν ἀπήμονας οὐδ’ ἀνολέθρους·	- - -uu -u u-uu - uu--	dactylic hexameter	feminine penthemimeral
ἀλλ’ οἳ μὲν δὴ νηυσὶν ἔπι πρυμνῇσιν Ἀχαιῶν	- - - - -u u- --u u--	dactylic hexameter	feminine penthemimeral, hepthemimeral, trithemimeral
χερσὶν ὑπ’ Ἀργείων κέατο ψυχὰς ὀλέσαντες,	-u u --- uu- -- uu--	dactylic hexameter	masculine penthemimeral, hepthemimeral
οἳ δ’ἐν τείχει ἔσαν βεβλημένοι οὐτάμενοί τε.	- - -u u- --uu -uu- -	dactylic hexameter	masculine penthemimeral
τὸν δὲ τάχ’ εὗρε μάχης ἐπ’ ἀριστερὰ δακρυοέσσης	- u u -u u- u u-uu -uu--	dactylic hexameter	masculine penthemimeral
δῖον Ἀλέξανδρον Ἑλένης πόσιν ἠϋκόμοιο	-u u--- uu- uu -uu--	dactylic hexameter	masculine penthemimeral, hepthemimeral
θαρσύνονθ’ ἑτάρους καὶ ἐποτρύνοντα μάχεσθαι,	--- uu- u u---u u--	dactylic hexameter	masculine penthemimeral, trithemimeral
ἀγχοῦ δ’ἱστάμενος προσέφη αἰσχροῖς ἐπέεσσι·	-- -uu- uu- -- uu--	dactylic hexameter	masculine penthemimeral, hepthemimeral
Δύσπαρι εἶδος ἄριστε γυναιμανὲς ἠπεροπευτὰ	-uu -u u-u u-uu -uu--	dactylic hexameter	feminine penthemimeral
ποῦ τοι Δηΐφοβός τε βίη θ’Ἑλένοιο ἄνακτος	- - -uu- u u- uu-u u--	dactylic hexameter	masculine penthemimeral, hepthemimeral
Ἀσιάδης τ’Ἀδάμας ἠδ’ Ἄσιος Ὑρτάκου υἱός;	-uu- uu- - -uu -uu --	dactylic hexameter	masculine penthemimeral, trithemimeral
ποῦ δέ τοι Ὀθρυονεύς; νῦν ὤλετο πᾶσα κατ’ ἄκρης	- u u -uu- - -uu -u u --	dactylic hexameter	masculine penthemimeral
Ἴλιος αἰπεινή· νῦν τοι σῶς αἰπὺς ὄλεθρος.	-uu --- - - - -u u--	dactylic hexameter	masculine penthemimeral, hepthemimeral
τὸν δ’αὖτε προσέειπεν Ἀλέξανδρος θεοειδής·	- -- uu-u u--- uu--	dactylic hexameter	feminine penthemimeral, trithemimeral
Ἕκτορ ἐπεί τοι θυμὸς ἀναίτιον αἰτιάασθαι,	-u u- - -u u-uu -uu--	dactylic hexameter	feminine penthemimeral, trithemimeral
ἄλλοτε δή ποτε μᾶλλον ἐρωῆσαι πολέμοιο	-uu - uu -u u--- uu--	dactylic hexameter	feminine penthemimeral, trithemimeral
μέλλω, ἐπεὶ οὐδ’ ἐμὲ πάμπαν ἀνάλκιδα γείνατο μήτηρ·	-u u- uu -u u-uu -uu --	dactylic hexameter	feminine penthemimeral, trithemimeral
ἐξ οὗ γὰρ παρὰ νηυσὶ μάχην ἤγειρας ἑταίρων,	- - - uu -u u- --u u--	dactylic hexameter	feminine penthemimeral, hepthemimeral, trithemimeral
ἐκ τοῦ δ’ἐνθάδ’ ἐόντες ὁμιλέομεν Δαναοῖσι	- - -u u-u u-uu- uu--	dactylic hexameter	feminine penthemimeral
νωλεμέως· ἕταροι δὲ κατέκταθεν οὓς σὺ μεταλλᾷς.	-uu- uu- u u-uu - u u--	dactylic hexameter	masculine penthemimeral, trithemimeral
οἴω Δηΐφοβός τε βίη θ’Ἑλένοιο ἄνακτος	-- -uu- u u- uu-u u--	dactylic hexameter	masculine penthemimeral, hepthemimeral
οἴχεσθον, μακρῇσι τετυμμένω ἐγχείῃσιν	--- --u u-uu ----	dactylic hexameter	feminine penthemimeral, trithemimeral
ἀμφοτέρω κατὰ χεῖρα· φόνον δ’ἤμυνε Κρονίων.	-uu- uu -u u- --u u--	dactylic hexameter	feminine penthemimeral, hepthemimeral, trithemimeral
νῦν δ’ἄρχ’ ὅππῃ σε κραδίη θυμός τε κελεύει·	- - -- - uu- -- u u--	dactylic hexameter	masculine penthemimeral, hepthemimeral
ἡμεῖς δ’ἐμμεμαῶτες ἅμ’ ἑψόμεθ’, οὐδέ τί φημι	-- -uu-u u -uu -u u --	dactylic hexameter	feminine penthemimeral
ἀλκῆς δευήσεσθαι, ὅση δύναμίς γε πάρεστι.	-- ---u u- uu- u u--	dactylic hexameter	feminine penthemimeral, hepthemimeral
πὰρ δύναμιν δ’οὐκ ἔστι καὶ ἐσσύμενον πολεμίζειν.	- uu- - -u u -uu- uu--	dactylic hexameter	feminine penthemimeral, trithemimeral
ὣς εἰπὼν παρέπεισεν ἀδελφειοῦ φρένας ἥρως·	- -- uu-u u--- uu --	dactylic hexameter	feminine penthemimeral, trithemimeral
βὰν δ’ἴμεν ἔνθα μάλιστα μάχη καὶ φύλοπις ἦεν	- uu -u u-u u- - -uu --	dactylic hexameter	feminine penthemimeral, hepthemimeral
ἀμφί τε Κεβριόνην καὶ ἀμύμονα Πουλυδάμαντα	-u u -uu- u u-uu -uu--	dactylic hexameter	masculine penthemimeral
Φάλκην Ὀρθαῖόν τε καὶ ἀντίθεον Πολυφήτην	-- --- u u -uu- uu--	dactylic hexameter	masculine penthemimeral
Πάλμύν τ’Ἀσκάνιόν τε Μόρυν θ’υἷ’ Ἱπποτίωνος,	-- -uu- u u- - -uu--	dactylic hexameter	masculine penthemimeral, hepthemimeral
οἵ ῥ’ἐξ Ἀσκανίης ἐριβώλακος ἦλθον ἀμοιβοὶ	- - -uu- uu-uu -u u--	dactylic hexameter	masculine penthemimeral
ἠοῖ τῇ προτέρῃ· τότε δὲ Ζεὺς ὦρσε μάχεσθαι.	-- - uu- uu - - -u u--	dactylic hexameter	masculine penthemimeral, hepthemimeral, trithemimeral
οἳ δ’ἴσαν ἀργαλέων ἀνέμων ἀτάλαντοι ἀέλλῃ,	- uu -uu- uu- uu-u u--	dactylic hexameter	masculine penthemimeral, hepthemimeral
ἥ ῥά θ’ὑπὸ βροντῆς πατρὸς Διὸς εἶσι πέδον δέ,	- u u- -- -- uu -u u- -	dactylic hexameter	masculine penthemimeral, hepthemimeral, trithemimeral
θεσπεσίῳ δ’ὁμάδῳ ἁλὶ μίσγεται, ἐν δέ τε πολλὰ	-uu- uu- uu -uu - u u --	dactylic hexameter	masculine penthemimeral, trithemimeral
κύματα παφλάζοντα πολυφλοίσβοιο θαλάσσης	-uu ---u u---u u--	dactylic hexameter	feminine penthemimeral
κυρτὰ φαληριόωντα, πρὸ μέν τ’ἄλλ’, αὐτὰρ ἐπ’ ἄλλα·	-u u-uu-u u - - -u u --	dactylic hexameter	feminine penthemimeral, hepthemimeral
ὣς Τρῶες πρὸ μὲν ἄλλοι ἀρηρότες, αὐτὰρ ἐπ’ ἄλλοι,	- -- u u -u u-uu -u u --	dactylic hexameter	feminine penthemimeral, trithemimeral
χαλκῷ μαρμαίροντες ἅμ’ ἡγεμόνεσσιν ἕποντο.	-- ---u u -uu-u u--	dactylic hexameter	feminine penthemimeral
Ἕκτωρ δ’ἡγεῖτο βροτολοιγῷ ἶσος Ἄρηϊ	-- --- uu-- -u u--	dactylic hexameter	masculine penthemimeral
Πριαμίδης· πρόσθεν δ’ἔχεν ἀσπίδα πάντοσ’ ἐΐσην	-uu- -- uu -uu -u u--	dactylic hexameter	masculine penthemimeral, trithemimeral
ῥινοῖσιν πυκινήν, πολλὸς δ’ἐπελήλατο χαλκός·	--- uu- -- uu-uu --	dactylic hexameter	masculine penthemimeral, hepthemimeral, trithemimeral
ἀμφὶ δέ οἱ κροτάφοισι φαεινὴ σείετο πήληξ.	-u u - uu-u u-- -uu --	dactylic hexameter	feminine penthemimeral, trithemimeral
πάντῃ δ’ἀμφὶ φάλαγγας ἐπειρᾶτο προποδίζων,	-- -u u-u u--- uu--	dactylic hexameter	feminine penthemimeral
εἴ πώς οἱ εἴξειαν ὑπασπίδια προβιβῶντι·	- - - --u u-uu- uu--	dactylic hexameter	feminine penthemimeral, trithemimeral
ἀλλ’ οὐ σύγχει θυμὸν ἐνὶ στήθεσσιν Ἀχαιῶν.	- - -- -u u- --u u--	dactylic hexameter	feminine penthemimeral, hepthemimeral
Αἴας δὲ πρῶτος προκαλέσσατο μακρὰ βιβάσθων·	-- - -- uu-uu -u u--	dactylic hexameter	masculine penthemimeral, trithemimeral
δαιμόνιε σχεδὸν ἐλθέ· τί ἢ δειδίσσεαι αὔτως	-uu- uu -u u - --uu --	dactylic hexameter	feminine penthemimeral, hepthemimeral, trithemimeral
Ἀργείους; οὔ τοί τι μάχης ἀδαήμονές εἰμεν,	--- - - u u- uu-uu --	dactylic hexameter	masculine penthemimeral, hepthemimeral, trithemimeral
ἀλλὰ Διὸς μάστιγι κακῇ ἐδάμημεν Ἀχαιοί.	-u u- --u u- uu-u u--	dactylic hexameter	feminine penthemimeral, hepthemimeral, trithemimeral
ἦ θήν πού τοι θυμὸς ἐέλπεται ἐξαλαπάξειν	- - - - -u u-uu -uu--	dactylic hexameter	feminine penthemimeral, trithemimeral
νῆας· ἄφαρ δέ τε χεῖρες ἀμύνειν εἰσὶ καὶ ἡμῖν.	-u u- u u -u u-- -u u --	dactylic hexameter	feminine penthemimeral, trithemimeral
ἦ κε πολὺ φθαίη εὖ ναιομένη πόλις ὑμὴ	- u u- -- - -uu- uu --	dactylic hexameter	masculine penthemimeral, trithemimeral
χερσὶν ὑφ’ ἡμετέρῃσιν ἁλοῦσά τε περθομένη τε.	-u u -uu-u u-u u -uu- -	dactylic hexameter	feminine penthemimeral
σοὶ δ’αὐτῷ φημὶ σχεδὸν ἔμμεναι ὁππότε φεύγων	- -- -- uu -uu -uu --	dactylic hexameter	masculine penthemimeral, trithemimeral
ἀρήσῃ Διὶ πατρὶ καὶ ἄλλοις ἀθανάτοισι	--- uu -u u -- -uu--	dactylic hexameter	feminine penthemimeral, trithemimeral
θάσσονας ἰρήκων ἔμεναι καλλίτριχας ἵππους,	-uu --- uu- --uu --	dactylic hexameter	masculine penthemimeral, hepthemimeral
οἵ σε πόλιν δ’οἴσουσι κονίοντες πεδίοιο.	- u u- --u u--- uu--	dactylic hexameter	feminine penthemimeral, trithemimeral
ὣς ἄρα οἱ εἰπόντι ἐπέπτατο δεξιὸς ὄρνις	- uu - --u u-uu -uu --	dactylic hexameter	feminine penthemimeral, trithemimeral
αἰετὸς ὑψιπέτης· ἐπὶ δ’ἴαχε λαὸς Ἀχαιῶν	-uu -uu- uu -uu -u u--	dactylic hexameter	masculine penthemimeral
θάρσυνος οἰωνῷ· ὃ δ’ἀμείβετο φαίδιμος Ἕκτωρ·	-uu --- u u-uu -uu --	dactylic hexameter	masculine penthemimeral
Αἶαν ἁμαρτοεπὲς βουγάϊε ποῖον ἔειπες·	-u u-uu- --uu -u u--	dactylic hexameter	masculine penthemimeral
εἰ γὰρ ἐγὼν οὕτω γε Διὸς πάϊς αἰγιόχοιο	- u u- -- u u- uu -uu--	dactylic hexameter	masculine penthemimeral, hepthemimeral, trithemimeral
εἴην ἤματα πάντα, τέκοι δέ με πότνια Ἥρη,	-- -uu -u u- u u -uu --	dactylic hexameter	feminine penthemimeral, hepthemimeral
τιοίμην δ’ὡς τίετ’ Ἀθηναίη καὶ Ἀπόλλων,	--- - -u u--- u u--	dactylic hexameter	feminine penthemimeral, trithemimeral
ὡς νῦν ἡμέρη ἥδε κακὸν φέρει Ἀργείοισι	- - -uu -u u- uu ----	dactylic hexameter	feminine penthemimeral, hepthemimeral
πᾶσι μάλ’, ἐν δὲ σὺ τοῖσι πεφήσεαι, αἴ κε ταλάσσῃς	-u u - u u -u u-uu - u u--	dactylic hexameter	feminine penthemimeral, trithemimeral
μεῖναι ἐμὸν δόρυ μακρόν, ὅ τοι χρόα λειριόεντα	-u u- uu -u u - uu -uu--	dactylic hexameter	feminine penthemimeral, hepthemimeral, trithemimeral
δάψει· ἀτὰρ Τρώων κορέεις κύνας ἠδ’ οἰωνοὺς	-u u- -- uu- uu - ---	dactylic hexameter	masculine penthemimeral, hepthemimeral, trithemimeral
δημῷ καὶ σάρκεσσι πεσὼν ἐπὶ νηυσὶν Ἀχαιῶν.	-- - --u u- uu -u u--	dactylic hexameter	feminine penthemimeral, hepthemimeral, trithemimeral
ὣς ἄρα φωνήσας ἡγήσατο· τοὶ δ’ἅμ’ ἕποντο	- uu --- --uu - u u--	dactylic hexameter	masculine penthemimeral
ἠχῇ θεσπεσίῃ, ἐπὶ δ’ἴαχε λαὸς ὄπισθεν.	-- -uu- uu -uu -u u--	dactylic hexameter	masculine penthemimeral
Ἀργεῖοι δ’ἑτέρωθεν ἐπίαχον, οὐδὲ λάθοντο	--- uu-u u-uu -u u--	dactylic hexameter	feminine penthemimeral, trithemimeral
ἀλκῆς, ἀλλ’ ἔμενον Τρώων ἐπιόντας ἀρίστους.	-- - uu- -- uu-u u--	dactylic hexameter	masculine penthemimeral, hepthemimeral, trithemimeral
ἠχὴ δ’ἀμφοτέρων ἵκετ’ αἰθέρα καὶ Διὸς αὐγάς.	-- -uu- uu -uu - uu --	dactylic hexameter	masculine penthemimeral
