Ἔνθ’ αὖ Τυδεΐδῃ Διομήδεϊ Παλλὰς Ἀθήνη	- - -uu- uu-uu -u u--	dactylic hexameter	masculine penthemimeral
δῶκε μένος καὶ θάρσος, ἵν’ ἔκδηλος μετὰ πᾶσιν	-u u- - -u u --- uu --	dactylic hexameter	feminine penthemimeral, trithemimeral
Ἀργείοισι γένοιτο ἰδὲ κλέος ἐσθλὸν ἄροιτο·	---u u-u u- uu -u u--	dactylic hexameter	feminine penthemimeral, hepthemimeral
δαῖέ οἱ ἐκ κόρυθός τε καὶ ἀσπίδος ἀκάματον πῦρ	-u u - uu- u u -uu -uu- -	dactylic hexameter	masculine penthemimeral, trithemimeral
ἀστέρ’ ὀπωρινῷ ἐναλίγκιον, ὅς τε μάλιστα	-u u--- uu-uu - u u--	dactylic hexameter	masculine penthemimeral
λαμπρὸν παμφαίνῃσι λελουμένος ὠκεανοῖο·	-- ---u u-uu -uu--	dactylic hexameter	feminine penthemimeral
τοῖόν οἱ πῦρ δαῖεν ἀπὸ κρατός τε καὶ ὤμων,	-- - - -u u- -- u u --	dactylic hexameter	feminine penthemimeral, hepthemimeral, trithemimeral
ὦρσε δέ μιν κατὰ μέσσον ὅθι πλεῖστοι κλονέοντο.	-u u - uu -u u- -- uu--	dactylic hexameter	feminine penthemimeral, hepthemimeral, trithemimeral
Ἦν δέ τις ἐν Τρώεσσι Δάρης ἀφνειὸς ἀμύμων	- u u - --u u- --u u--	dactylic hexameter	feminine penthemimeral, hepthemimeral, trithemimeral
ἱρεὺς Ἡφαίστοιο· δύω δέ οἱ υἱέες ἤστην	-- ---u u- u u -uu --	dactylic hexameter	feminine penthemimeral, hepthemimeral
Φηγεὺς Ἰδαῖός τε μάχης εὖ εἰδότε πάσης.	-- --- u u- - -uu --	dactylic hexameter	masculine penthemimeral, hepthemimeral
Τώ οἱ ἀποκρινθέντε ἐναντίω ὁρμηθήτην·	- u u---u u-uu ----	dactylic hexameter	feminine penthemimeral
τὼ μὲν ἀφ’ ἵπποιιν, ὃ δ’ἀπὸ χθονὸς ὄρνυτο πεζός.	- u u --- u u- uu -uu --	dactylic hexameter	masculine penthemimeral, hepthemimeral
Οἳ δ’ὅτε δὴ σχεδὸν ἦσαν ἐπ’ ἀλλήλοισιν ἰόντες	- uu - uu -u u ---u u--	dactylic hexameter	feminine penthemimeral, trithemimeral
Φηγεύς ῥα πρότερος προΐει δολιχόσκιον ἔγχος·	-- - uu- uu- uu-uu --	dactylic hexameter	masculine penthemimeral, hepthemimeral, trithemimeral
Τυδεΐδεω δ’ὑπὲρ ὦμον ἀριστερὸν ἤλυθ’ ἀκωκὴ	-uu- uu -u u-uu -u u--	dactylic hexameter	feminine penthemimeral, trithemimeral
ἔγχεος, οὐδ’ ἔβαλ’ αὐτόν· ὃ δ’ὕστερος ὄρνυτο χαλκῷ	-uu - uu -u u -uu -uu --	dactylic hexameter	feminine penthemimeral, trithemimeral
Τυδεΐδης· τοῦ δ’οὐχ ἅλιον βέλος ἔκφυγε χειρός,	-uu- - - uu- uu -uu --	dactylic hexameter	masculine penthemimeral, hepthemimeral, trithemimeral
ἀλλ’ ἔβαλε στῆθος μεταμάζιον, ὦσε δ’ἀφ’ ἵππων.	- uu- -- uu-uu -u u --	dactylic hexameter	masculine penthemimeral, trithemimeral
Ἰδαῖος δ’ἀπόρουσε λιπὼν περικαλλέα δίφρον,	--- uu-u u- uu-uu --	dactylic hexameter	feminine penthemimeral, hepthemimeral, trithemimeral
οὐδ’ ἔτλη περιβῆναι ἀδελφειοῦ κταμένοιο·	- -- uu-u u--- uu--	dactylic hexameter	feminine penthemimeral, trithemimeral
οὐδὲ γὰρ οὐδέ κεν αὐτὸς ὑπέκφυγε κῆρα μέλαιναν,	-u u -u u -u u-uu -u u--	dactylic hexameter	feminine penthemimeral
ἀλλ’ Ἥφαιστος ἔρυτο, σάωσε δὲ νυκτὶ καλύψας,	- --u u-u u-u u -u u--	dactylic hexameter	feminine penthemimeral
ὡς δή οἱ μὴ πάγχυ γέρων ἀκαχήμενος εἴη.	- - - - -u u- uu-uu --	dactylic hexameter	feminine penthemimeral, hepthemimeral, trithemimeral
Ἵππους δ’ἐξελάσας μεγαθύμου Τυδέος υἱὸς	-- -uu- uu-- -uu --	dactylic hexameter	masculine penthemimeral
δῶκεν ἑταίροισιν κατάγειν κοίλας ἐπὶ νῆας.	-u u--- uu- -- uu --	dactylic hexameter	masculine penthemimeral, hepthemimeral
Τρῶες δὲ μεγάθυμοι ἐπεὶ ἴδον υἷε Δάρητος	-- - uu-u u- uu -u u--	dactylic hexameter	feminine penthemimeral, hepthemimeral, trithemimeral
τὸν μὲν ἀλευάμενον, τὸν δὲ κτάμενον παρ’ ὄχεσφι,	- u u-uu- - - uu- u u--	dactylic hexameter	masculine penthemimeral, hepthemimeral
πᾶσιν ὀρίνθη θυμός· ἀτὰρ γλαυκῶπις Ἀθήνη	-u u-- -u u- --u u--	dactylic hexameter	feminine penthemimeral, hepthemimeral
χειρὸς ἑλοῦσ’ ἐπέεσσι προσηύδα θοῦρον Ἄρηα·	-u u- uu-u u-- -u u--	dactylic hexameter	feminine penthemimeral, trithemimeral
Ἆρες Ἄρες βροτολοιγὲ μιαιφόνε τειχεσιπλῆτα	-u u- uu-u u-uu -uu--	dactylic hexameter	feminine penthemimeral, trithemimeral
οὐκ ἂν δὴ Τρῶας μὲν ἐάσαιμεν καὶ Ἀχαιοὺς	- - - -- u u--- u u--	dactylic hexameter	masculine penthemimeral, trithemimeral
μάρνασθ’, ὁπποτέροισι πατὴρ Ζεὺς κῦδος ὀρέξῃ,	-- -uu-u u- - -u u--	dactylic hexameter	feminine penthemimeral, hepthemimeral
νῶϊ δὲ χαζώμεσθα, Διὸς δ’ἀλεώμεθα μῆνιν;	-u u ---u u- uu-uu --	dactylic hexameter	feminine penthemimeral, hepthemimeral
ὣς εἰποῦσα μάχης ἐξήγαγε θοῦρον Ἄρηα·	- --u u- --uu -u u--	dactylic hexameter	masculine penthemimeral
τὸν μὲν ἔπειτα καθεῖσεν ἐπ’ ἠϊόεντι Σκαμάνδρῳ,	- u u-u u-u u -uu-u u--	dactylic hexameter	feminine penthemimeral
Τρῶας δ’ἔκλιναν Δαναοί· ἕλε δ’ἄνδρα ἕκαστος	-- --- uu- uu -u u--	dactylic hexameter	masculine penthemimeral, hepthemimeral
ἡγεμόνων· πρῶτος δὲ ἄναξ ἀνδρῶν Ἀγαμέμνων	-uu- -- u u- -- uu--	dactylic hexameter	masculine penthemimeral, hepthemimeral, trithemimeral
ἀρχὸν Ἁλιζώνων Ὀδίον μέγαν ἔκβαλε δίφρου·	-u u--- uu- uu -uu --	dactylic hexameter	masculine penthemimeral, hepthemimeral
πρώτῳ γὰρ στρεφθέντι μεταφρένῳ ἐν δόρυ πῆξεν	-- - --u u-uu - uu --	dactylic hexameter	feminine penthemimeral, trithemimeral
ὤμων μεσσηγύς, διὰ δὲ στήθεσφιν ἔλασσε,	-- --- uu - --u u--	dactylic hexameter	masculine penthemimeral, hepthemimeral
δούπησεν δὲ πεσών, ἀράβησε δὲ τεύχε’ ἐπ’ αὐτῷ.	--- u u- uu-u u -u u --	dactylic hexameter	masculine penthemimeral, trithemimeral
Ἰδομενεὺς δ’ἄρα Φαῖστον ἐνήρατο Μῄονος υἱὸν	-uu- uu -u u-uu -uu --	dactylic hexameter	feminine penthemimeral, trithemimeral
Βώρου, ὃς ἐκ Τάρνης ἐριβώλακος εἰληλούθει.	-u u - -- uu-uu ----	dactylic hexameter	masculine penthemimeral, trithemimeral
Τὸν μὲν ἄρ’ Ἰδομενεὺς δουρικλυτὸς ἔγχεϊ μακρῷ	- u u -uu- --uu -uu --	dactylic hexameter	masculine penthemimeral
νύξ’ ἵππων ἐπιβησόμενον κατὰ δεξιὸν ὦμον·	- -- uu-uu- uu -uu --	dactylic hexameter	hepthemimeral, trithemimeral
ἤριπε δ’ἐξ ὀχέων, στυγερὸς δ’ἄρα μιν σκότος εἷλε.	-uu - uu- uu- uu - uu --	dactylic hexameter	masculine penthemimeral, hepthemimeral, trithemimeral
Τὸν μὲν ἄρ’ Ἰδομενῆος ἐσύλευον θεράποντες·	- u u -uu-u u--- uu--	dactylic hexameter	feminine penthemimeral
υἱὸν δὲ Στροφίοιο Σκαμάνδριον αἵμονα θήρης	-- - uu-u u-uu -uu --	dactylic hexameter	feminine penthemimeral, trithemimeral
Ἀτρεΐδης Μενέλαος ἕλ’ ἔγχεϊ ὀξυόεντι	-uu- uu-u u -uu -uu--	dactylic hexameter	feminine penthemimeral, trithemimeral
ἐσθλὸν θηρητῆρα· δίδαξε γὰρ Ἄρτεμις αὐτὴ	-- ---u u-u u -uu --	dactylic hexameter	feminine penthemimeral
βάλλειν ἄγρια πάντα, τά τε τρέφει οὔρεσιν ὕλη·	-- -uu -u u - uu -uu --	dactylic hexameter	feminine penthemimeral, hepthemimeral
ἀλλ’ οὔ οἱ τότε γε χραῖσμ’ Ἄρτεμις ἰοχέαιρα,	- - - uu - - -uu -uu--	dactylic hexameter	masculine penthemimeral, trithemimeral
οὐδὲ ἑκηβολίαι ᾗσιν τὸ πρίν γε κέκαστο·	-u u-uu- -- - - u u--	dactylic hexameter	masculine penthemimeral, hepthemimeral
ἀλλά μιν Ἀτρεΐδης δουρικλειτὸς Μενέλαος	-u u -uu- ---- uu--	dactylic hexameter	masculine penthemimeral
πρόσθεν ἕθεν φεύγοντα μετάφρενον οὔτασε δουρὶ	-u u- --u u-uu -uu --	dactylic hexameter	feminine penthemimeral, trithemimeral
ὤμων μεσσηγύς, διὰ δὲ στήθεσφιν ἔλασσεν,	-- --- uu - --u u--	dactylic hexameter	masculine penthemimeral, hepthemimeral
ἤριπε δὲ πρηνής, ἀράβησε δὲ τεύχε’ ἐπ’ αὐτῷ.	-uu - -- uu-u u -u u --	dactylic hexameter	masculine penthemimeral, trithemimeral
Μηριόνης δὲ Φέρεκλον ἐνήρατο, τέκτονος υἱὸν	-uu- u u-u u-uu -uu --	dactylic hexameter	feminine penthemimeral, trithemimeral
Ἁρμονίδεω, ὃς χερσὶν ἐπίστατο δαίδαλα πάντα	-uu- - -u u-uu -uu --	dactylic hexameter	feminine penthemimeral, trithemimeral
τεύχειν· ἔξοχα γάρ μιν ἐφίλατο Παλλὰς Ἀθήνη·	-- -uu - u u-uu -u u--	dactylic hexameter	masculine penthemimeral
ὃς καὶ Ἀλεξάνδρῳ τεκτήνατο νῆας ἐΐσας	- u u--- --uu -u u--	dactylic hexameter	masculine penthemimeral
ἀρχεκάκους, αἳ πᾶσι κακὸν Τρώεσσι γένοντο	-uu- - -u u- --u u--	dactylic hexameter	feminine penthemimeral, hepthemimeral, trithemimeral
οἷ τ’αὐτῷ, ἐπεὶ οὔ τι θεῶν ἐκ θέσφατα ᾔδη.	- -- uu - u u- - -uu --	dactylic hexameter	masculine penthemimeral, hepthemimeral, trithemimeral
Τὸν μὲν Μηριόνης ὅτε δὴ κατέμαρπτε διώκων	- - -uu- uu - uu-u u--	dactylic hexameter	masculine penthemimeral, hepthemimeral
βεβλήκει γλουτὸν κατὰ δεξιόν· ἣ δὲ διαπρὸ	--- -- uu -uu - u u--	dactylic hexameter	masculine penthemimeral, trithemimeral
ἀντικρὺ κατὰ κύστιν ὑπ’ ὀστέον ἤλυθ’ ἀκωκή·	--- uu -u u -uu -u u--	dactylic hexameter	feminine penthemimeral, trithemimeral
γνὺξ δ’ἔριπ’ οἰμώξας, θάνατος δέ μιν ἀμφεκάλυψε.	- uu --- uu- u u -uu--	dactylic hexameter	masculine penthemimeral, hepthemimeral
Πήδαιον δ’ἄρ’ ἔπεφνε Μέγης Ἀντήνορος υἱὸν	--- u u-u u- --uu --	dactylic hexameter	feminine penthemimeral, hepthemimeral, trithemimeral
ὅς ῥα νόθος μὲν ἔην, πύκα δ’ἔτρεφε δῖα Θεανὼ	- u u- u u- uu -uu -u u--	dactylic hexameter	masculine penthemimeral, trithemimeral
ἶσα φίλοισι τέκεσσι χαριζομένη πόσεϊ ᾧ.	-u u-u u-u u-uu- uu- -	dactylic hexameter	feminine penthemimeral
Τὸν μὲν Φυλεΐδης δουρὶ κλυτὸς ἐγγύθεν ἐλθὼν	- - -uu- -- uu -uu --	dactylic hexameter	masculine penthemimeral, hepthemimeral
βεβλήκει κεφαλῆς κατὰ ἰνίον ὀξέϊ δουρί·	--- uu- uu -uu -uu --	dactylic hexameter	masculine penthemimeral, trithemimeral
ἀντικρὺ δ’ἀν’ ὀδόντας ὑπὸ γλῶσσαν τάμε χαλκός·	--- u u-u u- -- uu --	dactylic hexameter	feminine penthemimeral, hepthemimeral, trithemimeral
ἤριπε δ’ἐν κονίῃ, ψυχρὸν δ’ἕλε χαλκὸν ὀδοῦσιν.	-uu - uu- -- uu -u u--	dactylic hexameter	masculine penthemimeral, hepthemimeral, trithemimeral
Εὐρύπυλος δ’Εὐαιμονίδης Ὑψήνορα δῖον	-uu- --uu- --uu --	dactylic hexameter	hepthemimeral, trithemimeral
υἱὸν ὑπερθύμου Δολοπίονος, ὅς ῥα Σκαμάνδρου	-u u--- uu-uu - u u--	dactylic hexameter	masculine penthemimeral
ἀρητὴρ ἐτέτυκτο, θεὸς δ’ὣς τίετο δήμῳ,	--- uu-u u- - -uu --	dactylic hexameter	feminine penthemimeral, hepthemimeral, trithemimeral
τὸν μὲν ἄρ’ Εὐρύπυλος, Εὐαίμονος ἀγλαὸς υἱός,	- u u -uu- --uu -uu --	dactylic hexameter	masculine penthemimeral
πρόσθεν ἕθεν φεύγοντα μεταδρομάδην ἔλασ’ ὦμον	-u u- --u u-uu- uu --	dactylic hexameter	feminine penthemimeral, trithemimeral
φασγάνῳ ἀΐξας, ἀπὸ δ’ἔξεσε χεῖρα βαρεῖαν·	-uu --- uu -uu -u u--	dactylic hexameter	masculine penthemimeral
αἱματόεσσα δὲ χεὶρ πεδίῳ πέσε· τὸν δὲ κατ’ ὄσσε	-uu-u u - uu- uu - u u --	dactylic hexameter	masculine penthemimeral, hepthemimeral
ἔλλαβε πορφύρεος θάνατος καὶ μοῖρα κραταιή.	-uu -uu- uu- - -u u--	dactylic hexameter	masculine penthemimeral, hepthemimeral
Ὣς οἳ μὲν πονέοντο κατὰ κρατερὴν ὑσμίνην·	- - - uu-u u- uu- ---	dactylic hexameter	feminine penthemimeral, hepthemimeral, trithemimeral
Τυδεΐδην δ’οὐκ ἂν γνοίης ποτέροισι μετείη	-uu- - - -- uu-u u--	dactylic hexameter	masculine penthemimeral, hepthemimeral, trithemimeral
ἠὲ μετὰ Τρώεσσιν ὁμιλέοι ἦ μετ’ Ἀχαιοῖς.	-u u- --u u-uu - u u--	dactylic hexameter	feminine penthemimeral, trithemimeral
Θῦνε γὰρ ἂμ πεδίον ποταμῷ πλήθοντι ἐοικὼς	-u u - uu- uu- --u u--	dactylic hexameter	masculine penthemimeral, hepthemimeral, trithemimeral
χειμάρρῳ, ὅς τ’ὦκα ῥέων ἐκέδασσε γεφύρας·	--- - -u u- uu-u u--	dactylic hexameter	feminine penthemimeral, hepthemimeral, trithemimeral
τὸν δ’οὔτ’ ἄρ τε γέφυραι ἐεργμέναι ἰσχανόωσιν,	- - - u u-u u-uu -uu--	dactylic hexameter	feminine penthemimeral, trithemimeral
οὔτ’ ἄρα ἕρκεα ἴσχει ἀλωάων ἐριθηλέων	- uu -uu -u u--- uu--	dactylic hexameter	feminine penthemimeral
ἐλθόντ’ ἐξαπίνης ὅτ’ ἐπιβρίσῃ Διὸς ὄμβρος·	-- -uu- u u--- uu --	dactylic hexameter	masculine penthemimeral
πολλὰ δ’ὑπ’ αὐτοῦ ἔργα κατήριπε κάλ’ αἰζηῶν·	-u u -- -u u-uu - ---	dactylic hexameter	feminine penthemimeral
ὣς ὑπὸ Τυδεΐδῃ πυκιναὶ κλονέοντο φάλαγγες	- uu -uu- uu- uu-u u--	dactylic hexameter	masculine penthemimeral, hepthemimeral
Τρώων, οὐδ’ ἄρα μιν μίμνον πολέες περ ἐόντες.	-- - uu - -- uu- u u--	dactylic hexameter	masculine penthemimeral, hepthemimeral, trithemimeral
Τὸν δ’ὡς οὖν ἐνόησε Λυκάονος ἀγλαὸς υἱὸς	- - - uu-u u-uu -uu --	dactylic hexameter	feminine penthemimeral, trithemimeral
θύνοντ’ ἂμ πεδίον πρὸ ἕθεν κλονέοντα φάλαγγας,	-- - uu- u u- uu-u u--	dactylic hexameter	masculine penthemimeral, hepthemimeral, trithemimeral
αἶψ’ ἐπὶ Τυδεΐδῃ ἐτιταίνετο καμπύλα τόξα,	- uu -uu- uu-uu -uu --	dactylic hexameter	masculine penthemimeral
καὶ βάλ’ ἐπαΐσσοντα τυχὼν κατὰ δεξιὸν ὦμον	- u u---u u- uu -uu --	dactylic hexameter	feminine penthemimeral, hepthemimeral
θώρηκος γύαλον· διὰ δ’ἔπτατο πικρὸς ὀϊστός,	--- uu- uu -uu -u u--	dactylic hexameter	masculine penthemimeral, trithemimeral
ἀντικρὺ δὲ διέσχε, παλάσσετο δ’αἵματι θώρηξ.	--- u u-u u-uu -uu --	dactylic hexameter	feminine penthemimeral, trithemimeral
Τῷ δ’ἐπὶ μακρὸν ἄϋσε Λυκάονος ἀγλαὸς υἱός·	- uu -u u-u u-uu -uu --	dactylic hexameter	feminine penthemimeral
ὄρνυσθε Τρῶες μεγάθυμοι κέντορες ἵππων·	--- -- uu-- -uu --	dactylic hexameter	masculine penthemimeral, trithemimeral
βέβληται γὰρ ἄριστος Ἀχαιῶν, οὐδέ ἕ φημι	--- u u-u u-- -u u --	dactylic hexameter	feminine penthemimeral, trithemimeral
δήθ’ ἀνσχήσεσθαι κρατερὸν βέλος, εἰ ἐτεόν με	- ---- uu- uu - uu- -	dactylic hexameter	masculine penthemimeral, hepthemimeral
ὦρσεν ἄναξ Διὸς υἱὸς ἀπορνύμενον Λυκίηθεν.	-u u- uu -u u-uu- uu--	dactylic hexameter	feminine penthemimeral, trithemimeral
Ὣς ἔφατ’ εὐχόμενος· τὸν δ’οὐ βέλος ὠκὺ δάμασσεν,	- uu -uu- - - uu -u u--	dactylic hexameter	masculine penthemimeral, hepthemimeral
ἀλλ’ ἀναχωρήσας πρόσθ’ ἵπποιιν καὶ ὄχεσφιν	- uu--- - --- u u--	dactylic hexameter	masculine penthemimeral
ἔστη, καὶ Σθένελον προσέφη Καπανήϊον υἱόν·	-- - uu- uu- uu-uu --	dactylic hexameter	masculine penthemimeral, hepthemimeral, trithemimeral
ὄρσο πέπον Καπανηϊάδη, καταβήσεο δίφρου,	-u u- uu-uu- uu-uu --	dactylic hexameter	hepthemimeral, trithemimeral
ὄφρά μοι ἐξ ὤμοιο ἐρύσσῃς πικρὸν ὀϊστόν.	-u u - --u u-- -u u--	dactylic hexameter	feminine penthemimeral, trithemimeral
Ὣς ἄρ’ ἔφη, Σθένελος δὲ καθ’ ἵππων ἆλτο χαμᾶζε,	- u u- uu- u u -- -u u--	dactylic hexameter	masculine penthemimeral, trithemimeral
πὰρ δὲ στὰς βέλος ὠκὺ διαμπερὲς ἐξέρυσ’ ὤμου·	- - - uu -u u-uu -uu --	dactylic hexameter	feminine penthemimeral, trithemimeral
αἷμα δ’ἀνηκόντιζε διὰ στρεπτοῖο χιτῶνος.	-u u---u u- --u u--	dactylic hexameter	feminine penthemimeral, hepthemimeral
Δὴ τότ’ ἔπειτ’ ἠρᾶτο βοὴν ἀγαθὸς Διομήδης·	- u u- --u u- uu- uu--	dactylic hexameter	feminine penthemimeral, hepthemimeral, trithemimeral
κλῦθί μευ αἰγιόχοιο Διὸς τέκος Ἀτρυτώνη,	-u u -uu-u u- uu ----	dactylic hexameter	feminine penthemimeral, hepthemimeral
εἴ ποτέ μοι καὶ πατρὶ φίλα φρονέουσα παρέστης	- uu - - -u u- uu-u u--	dactylic hexameter	feminine penthemimeral, hepthemimeral, trithemimeral
δηΐῳ ἐν πολέμῳ, νῦν αὖτ’ ἐμὲ φῖλαι Ἀθήνη·	-uu - uu- - - uu -u u--	dactylic hexameter	masculine penthemimeral, hepthemimeral, trithemimeral
δὸς δέ τέ μ’ἄνδρα ἑλεῖν καὶ ἐς ὁρμὴν ἔγχεος ἐλθεῖν	- u u -u u- u u -- -uu --	dactylic hexameter	masculine penthemimeral
ὅς μ’ἔβαλε φθάμενος καὶ ἐπεύχεται, οὐδέ μέ φησι	- uu- uu- u u-uu -u u --	dactylic hexameter	masculine penthemimeral, trithemimeral
δηρὸν ἔτ’ ὄψεσθαι λαμπρὸν φάος ἠελίοιο.	-u u --- -- uu -uu--	dactylic hexameter	masculine penthemimeral, hepthemimeral
ὣς ἔφατ’ εὐχόμενος· τοῦ δ’ἔκλυε Παλλὰς Ἀθήνη,	- uu -uu- - -uu -u u--	dactylic hexameter	masculine penthemimeral
γυῖα δ’ἔθηκεν ἐλαφρά, πόδας καὶ χεῖρας ὕπερθεν·	-u u-u u-u u- - -u u--	dactylic hexameter	feminine penthemimeral, hepthemimeral
ἀγχοῦ δ’ἱσταμένη ἔπεα πτερόεντα προσηύδα·	-- -uu- uu- uu-u u--	dactylic hexameter	masculine penthemimeral, hepthemimeral
θαρσῶν νῦν Διόμηδες ἐπὶ Τρώεσσι μάχεσθαι·	-- - uu-u u- --u u--	dactylic hexameter	feminine penthemimeral, hepthemimeral, trithemimeral
ἐν γάρ τοι στήθεσσι μένος πατρώϊον ἧκα	- - - --u u- --uu --	dactylic hexameter	feminine penthemimeral, hepthemimeral, trithemimeral
ἄτρομον, οἷον ἔχεσκε σακέσπαλος ἱππότα Τυδεύς·	-uu -u u-u u-uu -uu --	dactylic hexameter	feminine penthemimeral
ἀχλὺν δ’αὖ τοι ἀπ’ ὀφθαλμῶν ἕλον ἣ πρὶν ἐπῆεν,	-- - u u --- uu - u u--	dactylic hexameter	hepthemimeral, trithemimeral
ὄφρ’ εὖ γιγνώσκῃς ἠμὲν θεὸν ἠδὲ καὶ ἄνδρα.	- - --- -- uu -u u --	dactylic hexameter	masculine penthemimeral, hepthemimeral
τὼ νῦν αἴ κε θεὸς πειρώμενος ἐνθάδ’ ἵκηται	- - - u u- --uu -u u--	dactylic hexameter	masculine penthemimeral, trithemimeral
μή τι σύ γ’ἀθανάτοισι θεοῖς ἀντικρὺ μάχεσθαι	- u u -uu-u u- --u u--	dactylic hexameter	feminine penthemimeral, hepthemimeral
τοῖς ἄλλοις· ἀτὰρ εἴ κε Διὸς θυγάτηρ Ἀφροδίτη	- -- uu - u u- uu- uu--	dactylic hexameter	masculine penthemimeral, hepthemimeral, trithemimeral
ἔλθῃσ’ ἐς πόλεμον, τήν γ’οὐτάμεν ὀξέϊ χαλκῷ.	-- - uu- - -uu -uu --	dactylic hexameter	masculine penthemimeral, trithemimeral
ἣ μὲν ἄρ’ ὣς εἰποῦσ’ ἀπέβη γλαυκῶπις Ἀθήνη,	- u u - -- uu- --u u--	dactylic hexameter	masculine penthemimeral, hepthemimeral, trithemimeral
Τυδεΐδης δ’ἐξαῦτις ἰὼν προμάχοισιν ἐμίχθη	-uu- --u u- uu-u u--	dactylic hexameter	feminine penthemimeral, hepthemimeral, trithemimeral
καὶ πρίν περ θυμῷ μεμαὼς Τρώεσσι μάχεσθαι·	- - - -- uu- --u u--	dactylic hexameter	masculine penthemimeral, hepthemimeral, trithemimeral
δὴ τότε μιν τρὶς τόσσον ἕλεν μένος ὥς τε λέοντα	- uu - - -u u- uu - u u--	dactylic hexameter	feminine penthemimeral, hepthemimeral, trithemimeral
Ὅν ῥά τε ποιμὴν ἀγρῷ ἐπ’ εἰροπόκοις ὀΐεσσι	- u u -- -u u -uu- uu--	dactylic hexameter	feminine penthemimeral
χραύσῃ μέν τ’αὐλῆς ὑπεράλμενον οὐδὲ δαμάσσῃ·	-- - -- uu-uu -u u--	dactylic hexameter	masculine penthemimeral, trithemimeral
τοῦ μέν τε σθένος ὦρσεν, ἔπειτα δέ τ’οὐ προσαμύνει,	- - - uu -u u-u u - uu--	dactylic hexameter	feminine penthemimeral, trithemimeral
ἀλλὰ κατὰ σταθμοὺς δύεται, τὰ δ’ἐρῆμα φοβεῖται·	-u u- -- uu- u u-u u--	dactylic hexameter	masculine penthemimeral, hepthemimeral, trithemimeral
αἳ μέν τ’ἀγχιστῖναι ἐπ’ ἀλλήλῃσι κέχυνται,	- - ---u u ---u u--	dactylic hexameter	feminine penthemimeral
αὐτὰρ ὃ ἐμμεμαὼς βαθέης ἐξάλλεται αὐλῆς·	-u u -uu- uu- --uu --	dactylic hexameter	masculine penthemimeral, hepthemimeral
ὣς μεμαὼς Τρώεσσι μίγη κρατερὸς Διομήδης.	- uu- --u u- uu- uu--	dactylic hexameter	feminine penthemimeral, hepthemimeral, trithemimeral
Ἔνθ’ ἕλεν Ἀστύνοον καὶ Ὑπείρονα ποιμένα λαῶν,	- uu -uu- u u-uu -uu --	dactylic hexameter	masculine penthemimeral
τὸν μὲν ὑπὲρ μαζοῖο βαλὼν χαλκήρεϊ δουρί,	- u u- --u u- --uu --	dactylic hexameter	feminine penthemimeral, hepthemimeral, trithemimeral
τὸν δ’ἕτερον ξίφεϊ μεγάλῳ κληῖδα παρ’ ὦμον	- uu- uu- uu- --u u --	dactylic hexameter	masculine penthemimeral, hepthemimeral, trithemimeral
πλῆξ’, ἀπὸ δ’αὐχένος ὦμον ἐέργαθεν ἠδ’ ἀπὸ νώτου.	- uu -uu -u u-uu - uu --	dactylic hexameter	feminine penthemimeral
Τοὺς μὲν ἔασ’, ὃ δ’Ἄβαντα μετῴχετο καὶ Πολύειδον	- u u- u u-u u-uu - uu--	dactylic hexameter	feminine penthemimeral, trithemimeral
υἱέας Εὐρυδάμαντος ὀνειροπόλοιο γέροντος·	-uu -uu-u u-uu-u u--	dactylic hexameter	feminine penthemimeral
τοῖς οὐκ ἐρχομένοις ὃ γέρων ἐκρίνατ’ ὀνείρους,	- - -uu- u u- --u u--	dactylic hexameter	masculine penthemimeral, hepthemimeral
ἀλλά σφεας κρατερὸς Διομήδης ἐξενάριξε·	-- - uu- uu-- -uu--	dactylic hexameter	masculine penthemimeral, trithemimeral
βῆ δὲ μετὰ Ξάνθόν τε Θόωνά τε Φαίνοπος υἷε	- u u- -- u u-u u -uu --	dactylic hexameter	masculine penthemimeral, trithemimeral
ἄμφω τηλυγέτω· ὃ δὲ τείρετο γήραϊ λυγρῷ,	-- -uu- u u -uu -uu --	dactylic hexameter	masculine penthemimeral
υἱὸν δ’οὐ τέκετ’ ἄλλον ἐπὶ κτεάτεσσι λιπέσθαι.	-- - uu -u u- uu-u u--	dactylic hexameter	feminine penthemimeral, hepthemimeral, trithemimeral
Ἔνθ’ ὅ γε τοὺς ἐνάριζε, φίλον δ’ἐξαίνυτο θυμὸν	- u u - uu-u u- --uu --	dactylic hexameter	feminine penthemimeral, hepthemimeral, trithemimeral
ἀμφοτέρω, πατέρι δὲ γόον καὶ κήδεα λυγρὰ	-uu- uu- u u- - -uu --	dactylic hexameter	masculine penthemimeral, hepthemimeral, trithemimeral
λεῖπ’, ἐπεὶ οὐ ζώοντε μάχης ἐκνοστήσαντε	- uu - --u u- -----	dactylic hexameter	feminine penthemimeral, hepthemimeral, trithemimeral
δέξατο· χηρωσταὶ δὲ διὰ κτῆσιν δατέοντο.	-uu --- u u- -- uu--	dactylic hexameter	masculine penthemimeral, hepthemimeral
Ἔνθ’ υἷας Πριάμοιο δύω λάβε Δαρδανίδαο	- -- uu-u u- uu -uu--	dactylic hexameter	feminine penthemimeral, hepthemimeral, trithemimeral
εἰν ἑνὶ δίφρῳ ἐόντας Ἐχέμμονά τε Χρομίον τε.	- uu -u u-u u-uu - uu- -	dactylic hexameter	feminine penthemimeral
Ὡς δὲ λέων ἐν βουσὶ θορὼν ἐξ αὐχένα ἄξῃ	- u u- - -u u- - -uu --	dactylic hexameter	feminine penthemimeral, hepthemimeral, trithemimeral
πόρτιος ἠὲ βοὸς ξύλοχον κάτα βοσκομενάων,	-uu -u u- uu- uu -uu--	dactylic hexameter	masculine penthemimeral, hepthemimeral
ὣς τοὺς ἀμφοτέρους ἐξ ἵππων Τυδέος υἱὸς	- - -uu- - -- -uu --	dactylic hexameter	masculine penthemimeral
βῆσε κακῶς ἀέκοντας, ἔπειτα δὲ τεύχε’ ἐσύλα·	-u u- uu-u u-u u -u u--	dactylic hexameter	feminine penthemimeral, trithemimeral
ἵππους δ’οἷς ἑτάροισι δίδου μετὰ νῆας ἐλαύνειν.	-- - uu-u u- uu -u u--	dactylic hexameter	feminine penthemimeral, hepthemimeral, trithemimeral
Τὸν δ’ἴδεν Αἰνείας ἀλαπάζοντα στίχας ἀνδρῶν,	- uu --- uu--- uu --	dactylic hexameter	masculine penthemimeral
βῆ δ’ἴμεν ἄν τε μάχην καὶ ἀνὰ κλόνον ἐγχειάων	- uu - u u- u u- uu ----	dactylic hexameter	masculine penthemimeral, hepthemimeral, trithemimeral
Πάνδαρον ἀντίθεον διζήμενος εἴ που ἐφεύροι·	-uu -uu- --uu - u u--	dactylic hexameter	masculine penthemimeral
εὗρε Λυκάονος υἱὸν ἀμύμονά τε κρατερόν τε,	-u u-uu -u u-uu - uu- -	dactylic hexameter	feminine penthemimeral
στῆ δὲ πρόσθ’ αὐτοῖο ἔπος τέ μιν ἀντίον ηὔδα·	- - - --u u- u u -uu --	dactylic hexameter	feminine penthemimeral, hepthemimeral, trithemimeral
Πάνδαρε ποῦ τοι τόξον ἰδὲ πτερόεντες ὀϊστοὶ	-uu - - -u u- uu-u u--	dactylic hexameter	feminine penthemimeral, hepthemimeral, trithemimeral
καὶ κλέος; ᾧ οὔ τίς τοι ἐρίζεται ἐνθάδε γ’ἀνήρ,	- uu - - - u u-uu -uu --	dactylic hexameter	masculine penthemimeral, trithemimeral
οὐδέ τις ἐν Λυκίῃ σέο γ’εὔχεται εἶναι ἀμείνων.	-u u - uu- uu -uu -u u--	dactylic hexameter	masculine penthemimeral, trithemimeral
Ἀλλ’ ἄγε τῷδ’ ἔφες ἀνδρὶ βέλος Διὶ χεῖρας ἀνασχὼν	- uu - uu -u u- uu -u u--	dactylic hexameter	feminine penthemimeral, hepthemimeral, trithemimeral
ὅς τις ὅδε κρατέει καὶ δὴ κακὰ πολλὰ ἔοργε	- u u- uu- - - uu -- --	dactylic hexameter	masculine penthemimeral, hepthemimeral, trithemimeral
Τρῶας, ἐπεὶ πολλῶν τε καὶ ἐσθλῶν γούνατ’ ἔλυσεν·	-u u- -- u u -- -u u--	dactylic hexameter	masculine penthemimeral, trithemimeral
εἰ μή τις θεός ἐστι κοτεσσάμενος Τρώεσσιν	- - - uu -u u-uu- ---	dactylic hexameter	feminine penthemimeral, trithemimeral
ἱρῶν μηνίσας· χαλεπὴ δὲ θεοῦ ἔπι μῆνις.	-- --- uu- u u- uu --	dactylic hexameter	masculine penthemimeral, hepthemimeral
Τὸν δ’αὖτε προσέειπε Λυκάονος ἀγλαὸς υἱός·	- -- uu-u u-uu -uu --	dactylic hexameter	feminine penthemimeral, trithemimeral
Αἰνεία Τρώων βουληφόρε χαλκοχιτώνων	--- -- --uu -uu--	dactylic hexameter	masculine penthemimeral, trithemimeral
Τυδεΐδῃ μιν ἔγωγε δαΐφρονι πάντα ἐΐσκω,	-uu- u u-u u-uu -u u--	dactylic hexameter	feminine penthemimeral, trithemimeral
ἀσπίδι γιγνώσκων αὐλώπιδί τε τρυφαλείῃ,	-uu --- --uu - uu--	dactylic hexameter	masculine penthemimeral
ἵππους τ’εἰσορόων· σάφα δ’οὐκ οἶδ’ εἰ θεός ἐστιν.	-- -uu- uu - - - uu --	dactylic hexameter	masculine penthemimeral, hepthemimeral
Εἰ δ’ὅ γ’ἀνὴρ ὅν φημι δαΐφρων Τυδέος υἱὸς	- u u- - -u u-- -uu --	dactylic hexameter	feminine penthemimeral, trithemimeral
οὐχ ὅ γ’ἄνευθε θεοῦ τάδε μαίνεται, ἀλλά τις ἄγχι	- u u-u u- uu -uu -u u --	dactylic hexameter	masculine penthemimeral
ἕστηκ’ ἀθανάτων νεφέλῃ εἰλυμένος ὤμους,	-- -uu- uu- --uu --	dactylic hexameter	masculine penthemimeral, hepthemimeral
ὃς τούτου βέλος ὠκὺ κιχήμενον ἔτραπεν ἄλλῃ.	- -- uu -u u-uu -uu --	dactylic hexameter	feminine penthemimeral, trithemimeral
Ἤδη γάρ οἱ ἐφῆκα βέλος, καί μιν βάλον ὦμον	-- - u u-u u- - - uu --	dactylic hexameter	feminine penthemimeral, hepthemimeral, trithemimeral
δεξιὸν ἀντικρὺ διὰ θώρηκος γυάλοιο·	-uu --- uu --- uu--	dactylic hexameter	masculine penthemimeral
καί μιν ἔγωγ’ ἐφάμην Ἀϊδωνῆϊ προϊάψειν,	- u u- uu- uu--- uu--	dactylic hexameter	masculine penthemimeral, trithemimeral
ἔμπης δ’οὐκ ἐδάμασσα· θεός νύ τίς ἐστι κοτήεις.	-- - uu-u u- u u -u u--	dactylic hexameter	feminine penthemimeral, hepthemimeral, trithemimeral
Ἵπποι δ’οὐ παρέασι καὶ ἅρματα τῶν κ’ἐπιβαίην·	-- - uu-u u -uu - uu--	dactylic hexameter	feminine penthemimeral, trithemimeral
ἀλλά που ἐν μεγάροισι Λυκάονος ἕνδεκα δίφροι	-u u - uu-u u-uu -uu --	dactylic hexameter	feminine penthemimeral, trithemimeral
καλοὶ πρωτοπαγεῖς νεοτευχέες· ἀμφὶ δὲ πέπλοι	-- -uu- uu-uu -u u --	dactylic hexameter	masculine penthemimeral
πέπτανται· παρὰ δέ σφιν ἑκάστῳ δίζυγες ἵπποι	--- uu - u u-- -uu --	dactylic hexameter	masculine penthemimeral, trithemimeral
ἑστᾶσι κρῖ λευκὸν ἐρεπτόμενοι καὶ ὀλύρας.	--- - -u u-uu- u u--	dactylic hexameter	feminine penthemimeral, trithemimeral
Ἦ μέν μοι μάλα πολλὰ γέρων αἰχμητὰ Λυκάων	- - - uu -u u- --u u--	dactylic hexameter	feminine penthemimeral, hepthemimeral, trithemimeral
ἐρχομένῳ ἐπέτελλε δόμοις ἔνι ποιητοῖσιν·	-uu- uu-u u- uu ----	dactylic hexameter	feminine penthemimeral, hepthemimeral, trithemimeral
ἵπποισίν μ’ἐκέλευε καὶ ἅρμασιν ἐμβεβαῶτα	--- uu-u u -uu -uu--	dactylic hexameter	feminine penthemimeral, trithemimeral
ἀρχεύειν Τρώεσσι κατὰ κρατερὰς ὑσμίνας·	--- --u u- uu- ---	dactylic hexameter	feminine penthemimeral, hepthemimeral, trithemimeral
ἀλλ’ ἐγὼ οὐ πιθόμην· ἦ τ’ἂν πολὺ κέρδιον ἦεν·	- uu - uu- - - uu -uu --	dactylic hexameter	masculine penthemimeral, hepthemimeral, trithemimeral
ἵππων φειδόμενος, μή μοι δευοίατο φορβῆς	-- -uu- - - --uu --	dactylic hexameter	masculine penthemimeral, hepthemimeral
ἀνδρῶν εἰλομένων εἰωθότες ἔδμεναι ἄδην.	-- -uu- --uu -uu --	dactylic hexameter	masculine penthemimeral
Ὣς λίπον, αὐτὰρ πεζὸς ἐς Ἴλιον εἰλήλουθα	- uu -- -u u -uu ----	dactylic hexameter	feminine penthemimeral
τόξοισιν πίσυνος· τὰ δέ μ’οὐκ ἄρ’ ἔμελλον ὀνήσειν.	--- uu- u u - u u-u u--	dactylic hexameter	masculine penthemimeral, hepthemimeral, trithemimeral
Ἤδη γὰρ δοιοῖσιν ἀριστήεσσιν ἐφῆκα	-- - --u u---u u--	dactylic hexameter	feminine penthemimeral, trithemimeral
Τυδεΐδῃ τε καὶ Ἀτρεΐδῃ, ἐκ δ’ἀμφοτέροιιν	-uu- u u -uu- - -uu--	dactylic hexameter	hepthemimeral, trithemimeral
ἀτρεκὲς αἷμ’ ἔσσευα βαλών, ἤγειρα δὲ μᾶλλον.	-uu - --u u- --u u --	dactylic hexameter	feminine penthemimeral, hepthemimeral, trithemimeral
Τώ ῥα κακῇ αἴσῃ ἀπὸ πασσάλου ἀγκύλα τόξα	- u u- -- uu -uu -uu --	dactylic hexameter	masculine penthemimeral, trithemimeral
ἤματι τῷ ἑλόμην ὅτε Ἴλιον εἰς ἐρατεινὴν	-uu - uu- uu -uu - uu--	dactylic hexameter	masculine penthemimeral, trithemimeral
ἡγεόμην Τρώεσσι φέρων χάριν Ἕκτορι δίῳ.	-uu- --u u- uu -uu --	dactylic hexameter	feminine penthemimeral, hepthemimeral, trithemimeral
Εἰ δέ κε νοστήσω καὶ ἐσόψομαι ὀφθαλμοῖσι	- u u --- u u-uu ----	dactylic hexameter	masculine penthemimeral
πατρίδ’ ἐμὴν ἄλοχόν τε καὶ ὑψερεφὲς μέγα δῶμα,	-u u- uu- u u -uu- uu --	dactylic hexameter	masculine penthemimeral, trithemimeral
αὐτίκ’ ἔπειτ’ ἀπ’ ἐμεῖο κάρη τάμοι ἀλλότριος φὼς	-u u- u u-u u- uu -uu- -	dactylic hexameter	feminine penthemimeral, hepthemimeral, trithemimeral
εἰ μὴ ἐγὼ τάδε τόξα φαεινῷ ἐν πυρὶ θείην	- u u- uu -u u-- - uu --	dactylic hexameter	feminine penthemimeral, trithemimeral
χερσὶ διακλάσσας· ἀνεμώλια γάρ μοι ὀπηδεῖ.	-u u--- uu-uu - u u--	dactylic hexameter	masculine penthemimeral
Τὸν δ’αὖτ’ Αἰνείας Τρώων ἀγὸς ἀντίον ηὔδα·	- - --- -- uu -uu --	dactylic hexameter	masculine penthemimeral, hepthemimeral
μὴ δ’οὕτως ἀγόρευε· πάρος δ’οὐκ ἔσσεται ἄλλως,	- -- uu-u u- - -uu --	dactylic hexameter	feminine penthemimeral, hepthemimeral, trithemimeral
πρίν γ’ἐπὶ νὼ τῷδ’ ἀνδρὶ σὺν ἵπποισιν καὶ ὄχεσφιν	- uu - - -u u --- u u--	dactylic hexameter	feminine penthemimeral, trithemimeral
ἀντιβίην ἐλθόντε σὺν ἔντεσι πειρηθῆναι.	-uu- --u u -uu ----	dactylic hexameter	feminine penthemimeral, trithemimeral
Ἀλλ’ ἄγ’ ἐμῶν ὀχέων ἐπιβήσεο, ὄφρα ἴδηαι	- u u- uu- uu-uu -u u--	dactylic hexameter	masculine penthemimeral, trithemimeral
οἷοι Τρώϊοι ἵπποι ἐπιστάμενοι πεδίοιο	-- -uu -u u-uu- uu--	dactylic hexameter	feminine penthemimeral
κραιπνὰ μάλ’ ἔνθα καὶ ἔνθα διωκέμεν ἠδὲ φέβεσθαι·	-u u -u u -u u-uu -u u--	dactylic hexameter	feminine penthemimeral
τὼ καὶ νῶϊ πόλιν δὲ σαώσετον, εἴ περ ἂν αὖτε	- - -u u- u u-uu - u u --	dactylic hexameter	masculine penthemimeral
Ζεὺς ἐπὶ Τυδεΐδῃ Διομήδεϊ κῦδος ὀρέξῃ.	- uu -uu- uu-uu -u u--	dactylic hexameter	masculine penthemimeral
Ἀλλ’ ἄγε νῦν μάστιγα καὶ ἡνία σιγαλόεντα	- uu - --u u -uu -uu--	dactylic hexameter	feminine penthemimeral, trithemimeral
δέξαι, ἐγὼ δ’ἵππων ἀποβήσομαι ὄφρα μάχωμαι·	-u u- -- uu-uu -u u--	dactylic hexameter	masculine penthemimeral, trithemimeral
ἠὲ σὺ τόνδε δέδεξο, μελήσουσιν δ’ἐμοὶ ἵπποι.	-u u -u u-u u--- uu --	dactylic hexameter	feminine penthemimeral
Τὸν δ’αὖτε προσέειπε Λυκάονος ἀγλαὸς υἱός·	- -- uu-u u-uu -uu --	dactylic hexameter	feminine penthemimeral, trithemimeral
Αἰνεία σὺ μὲν αὐτὸς ἔχ’ ἡνία καὶ τεὼ ἵππω·	--- u u -u u -uu - - --	dactylic hexameter	feminine penthemimeral, trithemimeral
μᾶλλον ὑφ’ ἡνιόχῳ εἰωθότι καμπύλον ἅρμα	-u u -uu- --uu -uu --	dactylic hexameter	masculine penthemimeral
οἴσετον, εἴ περ ἂν αὖτε φεβώμεθα Τυδέος υἱόν·	-uu - u u -u u-uu -uu --	dactylic hexameter	feminine penthemimeral, trithemimeral
μὴ τὼ μὲν δείσαντε ματήσετον, οὐδ’ ἐθέλητον	- - - --u u-uu - uu--	dactylic hexameter	feminine penthemimeral, trithemimeral
ἐκφερέμεν πολέμοιο τεὸν φθόγγον ποθέοντε,	-uu- uu-u u- -- uu--	dactylic hexameter	feminine penthemimeral, hepthemimeral, trithemimeral
νῶϊ δ’ἐπαΐξας μεγαθύμου Τυδέος υἱὸς	-u u--- uu-- -uu --	dactylic hexameter	masculine penthemimeral
αὐτώ τε κτείνῃ καὶ ἐλάσσῃ μώνυχας ἵππους.	-- - -- u u-- -uu --	dactylic hexameter	masculine penthemimeral, trithemimeral
Ἀλλὰ σύ γ’αὐτὸς ἔλαυνε τέ’ ἅρματα καὶ τεὼ ἵππω,	-u u -u u-u u -uu - - --	dactylic hexameter	feminine penthemimeral
τὸν δὲ δ’ἐγὼν ἐπιόντα δεδέξομαι ὀξέϊ δουρί.	- u u- uu-u u-uu -uu --	dactylic hexameter	feminine penthemimeral, trithemimeral
Ὣς ἄρα φωνήσαντες ἐς ἅρματα ποικίλα βάντες	- uu ---u u -uu -uu --	dactylic hexameter	feminine penthemimeral
ἐμμεμαῶτ’ ἐπὶ Τυδεΐδῃ ἔχον ὠκέας ἵππους.	-uu- uu -uu- uu -uu --	dactylic hexameter	hepthemimeral, trithemimeral
Τοὺς δὲ ἴδε Σθένελος Καπανήϊος ἀγλαὸς υἱός,	- u u- uu- uu-uu -uu --	dactylic hexameter	masculine penthemimeral, trithemimeral
αἶψα δὲ Τυδεΐδην ἔπεα πτερόεντα προσηύδα·	-u u -uu- uu- uu-u u--	dactylic hexameter	masculine penthemimeral, hepthemimeral
Τυδεΐδη Διόμηδες ἐμῷ κεχαρισμένε θυμῷ,	-uu- uu-u u- uu-uu --	dactylic hexameter	feminine penthemimeral, hepthemimeral, trithemimeral
ἄνδρ’ ὁρόω κρατερὼ ἐπὶ σοὶ μεμαῶτε μάχεσθαι	- uu- uu- uu - uu-u u--	dactylic hexameter	masculine penthemimeral, hepthemimeral, trithemimeral
ἶν’ ἀπέλεθρον ἔχοντας· ὃ μὲν τόξων ἐῢ εἰδὼς	- uu-u u-u u - -- uu --	dactylic hexameter	feminine penthemimeral, hepthemimeral
Πάνδαρος, υἱὸς δ’αὖτε Λυκάονος εὔχεται εἶναι·	-uu -- -u u-uu -uu --	dactylic hexameter	feminine penthemimeral
Αἰνείας δ’υἱὸς μὲν ἀμύμονος Ἀγχίσαο	--- -- u u-uu ----	dactylic hexameter	masculine penthemimeral, trithemimeral
εὔχεται ἐκγεγάμεν, μήτηρ δέ οἵ ἐστ’ Ἀφροδίτη.	-uu -uu- -- u u - uu--	dactylic hexameter	masculine penthemimeral, hepthemimeral
Ἀλλ’ ἄγε δὴ χαζώμεθ’ ἐφ’ ἵππων, μηδέ μοι οὕτω	- uu - --u u -- -u u --	dactylic hexameter	feminine penthemimeral, trithemimeral
θῦνε διὰ προμάχων, μή πως φίλον ἦτορ ὀλέσσῃς.	-u u- uu- - - uu -u u--	dactylic hexameter	masculine penthemimeral, hepthemimeral, trithemimeral
Τὸν δ’ἄρ’ ὑπόδρα ἰδὼν προσέφη κρατερὸς Διομήδης·	- u u-u u- uu- uu- uu--	dactylic hexameter	masculine penthemimeral, hepthemimeral
μή τι φόβον δ’ἀγόρευ’, ἐπεὶ οὐδὲ σὲ πεισέμεν οἴω.	- u u- uu- uu -u u -uu --	dactylic hexameter	masculine penthemimeral, trithemimeral
Οὐ γάρ μοι γενναῖον ἀλυσκάζοντι μάχεσθαι	- - - --u u---u u--	dactylic hexameter	feminine penthemimeral, trithemimeral
οὐδὲ καταπτώσσειν· ἔτι μοι μένος ἔμπεδόν ἐστιν·	-u u--- uu - uu -uu --	dactylic hexameter	masculine penthemimeral, hepthemimeral
ὀκνείω δ’ἵππων ἐπιβαινέμεν, ἀλλὰ καὶ αὔτως	--- -- uu-uu -u u --	dactylic hexameter	masculine penthemimeral, trithemimeral
ἀντίον εἶμ’ αὐτῶν· τρεῖν μ’οὐκ ἐᾷ Παλλὰς Ἀθήνη.	-uu - -- - - - -u u--	dactylic hexameter	masculine penthemimeral, hepthemimeral, trithemimeral
Τούτω δ’οὐ πάλιν αὖτις ἀποίσετον ὠκέες ἵπποι	-- - uu -u u-uu -uu --	dactylic hexameter	feminine penthemimeral, trithemimeral
ἄμφω ἀφ’ ἡμείων, εἴ γ’οὖν ἕτερός γε φύγῃσιν.	-u u --- - - uu- u u--	dactylic hexameter	masculine penthemimeral, hepthemimeral
Ἄλλο δέ τοι ἐρέω, σὺ δ’ἐνὶ φρεσὶ βάλλεο σῇσιν·	-u u - uu- u u- uu -uu --	dactylic hexameter	masculine penthemimeral, hepthemimeral, trithemimeral
αἴ κέν μοι πολύβουλος Ἀθήνη κῦδος ὀρέξῃ	- - - uu-u u-- -u u--	dactylic hexameter	feminine penthemimeral, trithemimeral
ἀμφοτέρω κτεῖναι, σὺ δὲ τούσδε μὲν ὠκέας ἵππους	-uu- -- u u -u u -uu --	dactylic hexameter	masculine penthemimeral, trithemimeral
αὐτοῦ ἐρυκακέειν ἐξ ἄντυγος ἡνία τείνας,	-u u-uu- - -uu -uu --	dactylic hexameter	masculine penthemimeral
Αἰνείαο δ’ἐπαΐξαι μεμνημένος ἵππων,	---u u--- --uu --	dactylic hexameter	hepthemimeral
ἐκ δ’ἐλάσαι Τρώων μετ’ ἐϋκνήμιδας Ἀχαιούς.	- uu- -- u u---u u--	dactylic hexameter	masculine penthemimeral, trithemimeral
Τῆς γάρ τοι γενεῆς ἧς Τρωΐ περ εὐρύοπα Ζεὺς	- - - uu- - -u u -uu- -	dactylic hexameter	masculine penthemimeral, trithemimeral
δῶχ’ υἷος ποινὴν Γανυμήδεος, οὕνεκ’ ἄριστοι	- -- -- uu-uu -u u--	dactylic hexameter	masculine penthemimeral, trithemimeral
ἵππων ὅσσοι ἔασιν ὑπ’ ἠῶ τ’ἠέλιόν τε,	-- -- -u u -- -uu- -	dactylic hexameter	feminine penthemimeral
τῆς γενεῆς ἔκλεψεν ἄναξ ἀνδρῶν Ἀγχίσης	- uu- --u u- -- ---	dactylic hexameter	feminine penthemimeral, hepthemimeral, trithemimeral
λάθρῃ Λαομέδοντος ὑποσχὼν θήλεας ἵππους·	-- -uu-u u-- -uu --	dactylic hexameter	feminine penthemimeral
τῶν οἱ ἓξ ἐγένοντο ἐνὶ μεγάροισι γενέθλη.	- - - uu-u u- uu-u u--	dactylic hexameter	feminine penthemimeral, hepthemimeral, trithemimeral
Τοὺς μὲν τέσσαρας αὐτὸς ἔχων ἀτίταλλ’ ἐπὶ φάτνῃ,	- - -uu -u u- uu- uu --	dactylic hexameter	feminine penthemimeral, hepthemimeral
τὼ δὲ δύ’ Αἰνείᾳ δῶκεν μήστωρε φόβοιο.	- u u --- -- --u u--	dactylic hexameter	masculine penthemimeral, hepthemimeral
Εἰ τούτω κε λάβοιμεν, ἀροίμεθά κε κλέος ἐσθλόν.	- -- u u-u u-uu - uu --	dactylic hexameter	feminine penthemimeral, trithemimeral
Ὣς οἳ μὲν τοιαῦτα πρὸς ἀλλήλους ἀγόρευον,	- - - --u u --- uu--	dactylic hexameter	feminine penthemimeral, trithemimeral
τὼ δὲ τάχ’ ἐγγύθεν ἦλθον ἐλαύνοντ’ ὠκέας ἵππους.	- u u -uu -u u-- -uu --	dactylic hexameter	feminine penthemimeral
Τὸν πρότερος προσέειπε Λυκάονος ἀγλαὸς υἱός·	- uu- uu-u u-uu -uu --	dactylic hexameter	feminine penthemimeral, trithemimeral
καρτερόθυμε δαΐφρον ἀγαυοῦ Τυδέος υἱὲ	-uu-u u-u u-- -uu --	dactylic hexameter	feminine penthemimeral
ἦ μάλα σ’οὐ βέλος ὠκὺ δαμάσσατο πικρὸς ὀϊστός·	- uu - uu -u u-uu -u u--	dactylic hexameter	feminine penthemimeral, trithemimeral
νῦν αὖτ’ ἐγχείῃ πειρήσομαι αἴ κε τύχωμι.	- - --- --uu - u u--	dactylic hexameter	masculine penthemimeral
Ἦ ῥα καὶ ἀμπεπαλὼν προΐει δολιχόσκιον ἔγχος	- u u -uu- uu- uu-uu --	dactylic hexameter	masculine penthemimeral, hepthemimeral
καὶ βάλε Τυδεΐδαο κατ’ ἀσπίδα· τῆς δὲ διὰ πρὸ	- uu -uu-u u -uu - u u- -	dactylic hexameter	feminine penthemimeral
αἰχμὴ χαλκείη πταμένη θώρηκι πελάσθη·	-- --- uu- --u u--	dactylic hexameter	masculine penthemimeral, hepthemimeral
τῷ δ’ἐπὶ μακρὸν ἄϋσε Λυκάονος ἀγλαὸς υἱός·	- uu -u u-u u-uu -uu --	dactylic hexameter	feminine penthemimeral
βέβληαι κενεῶνα διαμπερές, οὐδέ σ’ὀΐω	--- uu-u u-uu -u u--	dactylic hexameter	feminine penthemimeral, trithemimeral
δηρὸν ἔτ’ ἀνσχήσεσθαι· ἐμοὶ δὲ μέγ’ εὖχος ἔδωκας.	-u u ---u u- u u -u u--	dactylic hexameter	feminine penthemimeral, hepthemimeral
Τὸν δ’οὐ ταρβήσας προσέφη κρατερὸς Διομήδης·	- - --- uu- uu- uu--	dactylic hexameter	masculine penthemimeral, hepthemimeral
ἤμβροτες οὐδ’ ἔτυχες· ἀτὰρ οὐ μὲν σφῶΐ γ’ὀΐω	-uu - uu- uu - - -u u--	dactylic hexameter	masculine penthemimeral, hepthemimeral, trithemimeral
πρίν γ’ἀποπαύσεσθαι πρίν γ’ἢ ἕτερόν γε πεσόντα	- uu--- - - uu- u u--	dactylic hexameter	masculine penthemimeral, hepthemimeral
αἵματος ἆσαι Ἄρηα, ταλαύρινον πολεμιστήν.	-uu -u u-u u--- uu--	dactylic hexameter	feminine penthemimeral
Ὣς φάμενος προέηκε· βέλος δ’ἴθυνεν Ἀθήνη	- uu- uu-u u- --u u--	dactylic hexameter	feminine penthemimeral, hepthemimeral, trithemimeral
ῥῖνα παρ’ ὀφθαλμόν, λευκοὺς δ’ἐπέρησεν ὀδόντας.	-u u --- -- uu-u u--	dactylic hexameter	masculine penthemimeral, hepthemimeral
Τοῦ δ’ἀπὸ μὲν γλῶσσαν πρυμνὴν τάμε χαλκὸς ἀτειρής,	- uu - -- -- uu -u u--	dactylic hexameter	masculine penthemimeral, hepthemimeral, trithemimeral
αἰχμὴ δ’ἐξελύθη παρὰ νείατον ἀνθερεῶνα·	-- -uu- uu -uu -uu--	dactylic hexameter	masculine penthemimeral
ἤριπε δ’ἐξ ὀχέων, ἀράβησε δὲ τεύχε’ ἐπ’ αὐτῷ	-uu - uu- uu-u u -u u --	dactylic hexameter	masculine penthemimeral, trithemimeral
αἰόλα παμφανόωντα, παρέτρεσσαν δέ οἱ ἵπποι	-uu -uu-u u--- u u --	dactylic hexameter	feminine penthemimeral
ὠκύποδες· τοῦ δ’αὖθι λύθη ψυχή τε μένος τε.	-uu- - -u u- -- u u- -	dactylic hexameter	feminine penthemimeral, hepthemimeral, trithemimeral
Αἰνείας δ’ἀπόρουσε σὺν ἀσπίδι δουρί τε μακρῷ	--- uu-u u -uu -u u --	dactylic hexameter	feminine penthemimeral, trithemimeral
δείσας μή πώς οἱ ἐρυσαίατο νεκρὸν Ἀχαιοί.	-- - - - uu-uu -u u--	dactylic hexameter	masculine penthemimeral, trithemimeral
Ἀμφὶ δ’ἄρ’ αὐτῷ βαῖνε λέων ὣς ἀλκὶ πεποιθώς,	-u u -- -u u- - -u u--	dactylic hexameter	feminine penthemimeral, hepthemimeral
πρόσθε δέ οἱ δόρυ τ’ἔσχε καὶ ἀσπίδα πάντοσ’ ἐΐσην,	-u u - uu -u u -uu -u u--	dactylic hexameter	feminine penthemimeral, trithemimeral
τὸν κτάμεναι μεμαὼς ὅς τις τοῦ γ’ἀντίος ἔλθοι	- uu- uu- - - - -uu --	dactylic hexameter	masculine penthemimeral, hepthemimeral, trithemimeral
σμερδαλέα ἰάχων· ὃ δὲ χερμάδιον λάβε χειρὶ	-uu- uu- u u -uu- uu --	dactylic hexameter	masculine penthemimeral, trithemimeral
Τυδεΐδης μέγα ἔργον ὃ οὐ δύο γ’ἄνδρε φέροιεν,	-uu- uu -u u - uu -u u--	dactylic hexameter	feminine penthemimeral, hepthemimeral, trithemimeral
οἷοι νῦν βροτοί εἰσ’· ὃ δέ μιν ῥέα πάλλε καὶ οἶος.	-- - uu - u u - uu -u u --	dactylic hexameter	masculine penthemimeral, hepthemimeral, trithemimeral
Τῷ βάλεν Αἰνείαο κατ’ ἰσχίον ἔνθά τε μηρὸς	- uu ---u u -uu -u u --	dactylic hexameter	feminine penthemimeral
ἰσχίῳ ἐνστρέφεται, κοτύλην δέ τέ μιν καλέουσι·	-uu -uu- uu- u u - uu--	dactylic hexameter	masculine penthemimeral, hepthemimeral
θλάσσε δέ οἱ κοτύλην, πρὸς δ’ἄμφω ῥῆξε τένοντε·	-u u - uu- - -- -u u--	dactylic hexameter	masculine penthemimeral, trithemimeral
ὦσε δ’ἀπὸ ῥινὸν τρηχὺς λίθος· αὐτὰρ ὅ γ’ἥρως	-u u- -- -- uu -u u --	dactylic hexameter	masculine penthemimeral, hepthemimeral, trithemimeral
ἔστη γνὺξ ἐριπὼν καὶ ἐρείσατο χειρὶ παχείῃ	-- - uu- u u-uu -u u--	dactylic hexameter	masculine penthemimeral, trithemimeral
γαίης· ἀμφὶ δὲ ὄσσε κελαινὴ νὺξ ἐκάλυψε.	-- -u u -u u-- - uu--	dactylic hexameter	feminine penthemimeral
Καί νύ κεν ἔνθ’ ἀπόλοιτο ἄναξ ἀνδρῶν Αἰνείας,	- u u - uu-u u- -- ---	dactylic hexameter	feminine penthemimeral, hepthemimeral, trithemimeral
εἰ μὴ ἄρ’ ὀξὺ νόησε Διὸς θυγάτηρ Ἀφροδίτη	- u u -u u-u u- uu- uu--	dactylic hexameter	feminine penthemimeral, hepthemimeral
μήτηρ, ἥ μιν ὑπ’ Ἀγχίσῃ τέκε βουκολέοντι·	-- - u u --- uu -uu--	dactylic hexameter	hepthemimeral, trithemimeral
ἀμφὶ δ’ἑὸν φίλον υἱὸν ἐχεύατο πήχεε λευκώ,	-- - uu -u u-uu -uu --	dactylic hexameter	feminine penthemimeral, trithemimeral
πρόσθε δέ οἱ πέπλοιο φαεινοῦ πτύγμα κάλυψεν	-u u - --u u-- -u u--	dactylic hexameter	feminine penthemimeral, trithemimeral
ἕρκος ἔμεν βελέων, μή τις Δαναῶν ταχυπώλων	-u u- uu- - - uu- uu--	dactylic hexameter	masculine penthemimeral, hepthemimeral, trithemimeral
χαλκὸν ἐνὶ στήθεσσι βαλὼν ἐκ θυμὸν ἕλοιτο.	-u u- --u u- - -u u--	dactylic hexameter	feminine penthemimeral, hepthemimeral, trithemimeral
Ἣ μὲν ἑὸν φίλον υἱὸν ὑπεξέφερεν πολέμοιο·	- u u- uu -u u-uu- uu--	dactylic hexameter	feminine penthemimeral, trithemimeral
οὐδ’ υἱὸς Καπανῆος ἐλήθετο συνθεσιάων	- -- uu-u u-uu -uu--	dactylic hexameter	feminine penthemimeral, trithemimeral
τάων ἃς ἐπέτελλε βοὴν ἀγαθὸς Διομήδης,	-- - uu-u u- uu- uu--	dactylic hexameter	feminine penthemimeral, hepthemimeral, trithemimeral
ἀλλ’ ὅ γε τοὺς μὲν ἑοὺς ἠρύκακε μώνυχας ἵππους	- u u - u u- --uu -uu --	dactylic hexameter	masculine penthemimeral, trithemimeral
νόσφιν ἀπὸ φλοίσβου ἐξ ἄντυγος ἡνία τείνας,	-u u- -- - -uu -uu --	dactylic hexameter	masculine penthemimeral, trithemimeral
Αἰνείαο δ’ἐπαΐξας καλλίτριχας ἵππους	---u u--- --uu --	dactylic hexameter	hepthemimeral
ἐξέλασε Τρώων μετ’ ἐϋκνήμιδας Ἀχαιούς.	-uu- -- u u---u u--	dactylic hexameter	masculine penthemimeral, trithemimeral
Δῶκε δὲ Δηϊπύλῳ ἑτάρῳ φίλῳ, ὃν περὶ πάσης	-u u -uu- uu- uu - uu --	dactylic hexameter	masculine penthemimeral, hepthemimeral
τῖεν ὁμηλικίης ὅτι οἱ φρεσὶν ἄρτια ᾔδη,	-u u-uu- uu - uu -uu --	dactylic hexameter	masculine penthemimeral, hepthemimeral
νηυσὶν ἔπι γλαφυρῇσιν ἐλαυνέμεν· αὐτὰρ ὅ γ’ἥρως	-u u- uu-u u-uu -u u --	dactylic hexameter	feminine penthemimeral, trithemimeral
ὧν ἵππων ἐπιβὰς ἔλαβ’ ἡνία σιγαλόεντα,	- -- uu- uu -uu -uu--	dactylic hexameter	masculine penthemimeral, trithemimeral
αἶψα δὲ Τυδεΐδην μέθεπε κρατερώνυχας ἵππους	-u u -uu- uu- uu-uu --	dactylic hexameter	masculine penthemimeral, hepthemimeral
ἐμμεμαώς· ὃ δὲ Κύπριν ἐπῴχετο νηλέϊ χαλκῷ	-uu- u u -u u-uu -uu --	dactylic hexameter	feminine penthemimeral, trithemimeral
γιγνώσκων ὅ τ’ἄναλκις ἔην θεός, οὐδὲ θεάων	--- u u-u u- uu -u u--	dactylic hexameter	feminine penthemimeral, hepthemimeral, trithemimeral
τάων αἵ τ’ἀνδρῶν πόλεμον κάτα κοιρανέουσιν,	-- - -- uu- uu -uu--	dactylic hexameter	masculine penthemimeral, hepthemimeral, trithemimeral
οὔτ’ ἄρ’ Ἀθηναίη οὔτε πτολίπορθος Ἐνυώ.	- u u--- -- uu-u u--	dactylic hexameter	masculine penthemimeral, hepthemimeral
Ἀλλ’ ὅτε δή ῥ’ἐκίχανε πολὺν καθ’ ὅμιλον ὀπάζων,	- uu - uu-u u- u u-u u--	dactylic hexameter	feminine penthemimeral, hepthemimeral, trithemimeral
ἔνθ’ ἐπορεξάμενος μεγαθύμου Τυδέος υἱὸς	- uu-uu- uu-- -uu --	dactylic hexameter	masculine penthemimeral
ἄκρην οὔτασε χεῖρα μετάλμενος ὀξέϊ δουρὶ	-- -uu -u u-uu -uu --	dactylic hexameter	feminine penthemimeral
ἀβληχρήν· εἶθαρ δὲ δόρυ χροὸς ἀντετόρησεν	--- -- u u- uu -uu--	dactylic hexameter	masculine penthemimeral, hepthemimeral, trithemimeral
ἀμβροσίου διὰ πέπλου, ὅν οἱ Χάριτες κάμον αὐταί,	-uu- uu -u u - uu- uu --	dactylic hexameter	feminine penthemimeral, hepthemimeral, trithemimeral
πρυμνὸν ὕπερ θέναρος· ῥέε δ’ἄμβροτον αἷμα θεοῖο	-u u- uu- uu -uu -u u--	dactylic hexameter	masculine penthemimeral, trithemimeral
ἰχώρ, οἷός πέρ τε ῥέει μακάρεσσι θεοῖσιν·	-- -- - u u- uu-u u--	dactylic hexameter	masculine penthemimeral, hepthemimeral
οὐ γὰρ σῖτον ἔδουσ’, οὐ πίνουσ’ αἴθοπα οἶνον,	- - -u u- - -- -uu --	dactylic hexameter	masculine penthemimeral
τοὔνεκ’ ἀναίμονές εἰσι καὶ ἀθάνατοι καλέονται.	-u u-uu -u u -uu- uu--	dactylic hexameter	feminine penthemimeral
Ἣ δὲ μέγα ἰάχουσα ἀπὸ ἕο κάββαλεν υἱόν·	- u u- uu-u u- uu -uu --	dactylic hexameter	feminine penthemimeral, hepthemimeral, trithemimeral
καὶ τὸν μὲν μετὰ χερσὶν ἐρύσατο Φοῖβος Ἀπόλλων	- - - uu -u u-uu -u u--	dactylic hexameter	feminine penthemimeral, trithemimeral
κυανέῃ νεφέλῃ, μή τις Δαναῶν ταχυπώλων	-uu- uu- - - uu- uu--	dactylic hexameter	masculine penthemimeral, hepthemimeral, trithemimeral
χαλκὸν ἐνὶ στήθεσσι βαλὼν ἐκ θυμὸν ἕλοιτο·	-u u- --u u- - -u u--	dactylic hexameter	feminine penthemimeral, hepthemimeral, trithemimeral
τῇ δ’ἐπὶ μακρὸν ἄϋσε βοὴν ἀγαθὸς Διομήδης·	- uu -u u-u u- uu- uu--	dactylic hexameter	feminine penthemimeral, hepthemimeral
εἶκε Διὸς θύγατερ πολέμου καὶ δηϊοτῆτος·	-u u- uu- uu- - -uu--	dactylic hexameter	masculine penthemimeral, hepthemimeral, trithemimeral
ἦ οὐχ ἅλις ὅττι γυναῖκας ἀνάλκιδας ἠπεροπεύεις;	- uu -u u-u u-uu -uu--	dactylic hexameter	feminine penthemimeral
εἰ δὲ σύ γ’ἐς πόλεμον πωλήσεαι, ἦ τέ σ’ὀΐω	- u u - uu- --uu - u u--	dactylic hexameter	masculine penthemimeral, trithemimeral
ῥιγήσειν πόλεμόν γε καὶ εἴ χ’ἑτέρωθι πύθηαι.	--- uu- u u - uu-u u--	dactylic hexameter	masculine penthemimeral, hepthemimeral, trithemimeral
Ὣς ἔφαθ’, ἣ δ’ἀλύουσ’ ἀπεβήσετο, τείρετο δ’αἰνῶς·	- uu - uu- uu-uu -uu --	dactylic hexameter	masculine penthemimeral, trithemimeral
τὴν μὲν ἄρ’ Ἶρις ἑλοῦσα ποδήνεμος ἔξαγ’ ὁμίλου	- u u -u u-u u-uu -u u--	dactylic hexameter	feminine penthemimeral
ἀχθομένην ὀδύνῃσι, μελαίνετο δὲ χρόα καλόν.	-uu- uu-u u-uu - uu --	dactylic hexameter	feminine penthemimeral, trithemimeral
Εὗρεν ἔπειτα μάχης ἐπ’ ἀριστερὰ θοῦρον Ἄρηα	-u u-u u- u u-uu -u u--	dactylic hexameter	masculine penthemimeral
ἥμενον· ἠέρι δ’ἔγχος ἐκέκλιτο καὶ ταχέ’ ἵππω·	-uu -uu -u u-uu - uu --	dactylic hexameter	feminine penthemimeral
ἣ δὲ γνὺξ ἐριποῦσα κασιγνήτοιο φίλοιο	- - - uu-u u---u u--	dactylic hexameter	feminine penthemimeral, trithemimeral
πολλὰ λισσομένη χρυσάμπυκας ᾔτεεν ἵππους·	-- -uu- --uu -uu --	dactylic hexameter	masculine penthemimeral
φίλε κασίγνητε κόμισαί τέ με δός τέ μοι ἵππους,	-u u--- uu- u u - u u --	dactylic hexameter	masculine penthemimeral, hepthemimeral
ὄφρ’ ἐς Ὄλυμπον ἵκωμαι ἵν’ ἀθανάτων ἕδος ἐστί.	- u u-u u-u u -uu- uu --	dactylic hexameter	feminine penthemimeral
Λίην ἄχθομαι ἕλκος ὅ με βροτὸς οὔτασεν ἀνὴρ	-- -uu -u u - uu -uu --	dactylic hexameter	feminine penthemimeral, hepthemimeral
Τυδεΐδης, ὃς νῦν γε καὶ ἂν Διὶ πατρὶ μάχοιτο.	-uu- - - u u - uu -u u--	dactylic hexameter	masculine penthemimeral, hepthemimeral, trithemimeral
Ὣς φάτο, τῇ δ’ἄρ’ Ἄρης δῶκε χρυσάμπυκας ἵππους·	- uu - u u- -- --uu --	dactylic hexameter	masculine penthemimeral, hepthemimeral, trithemimeral
ἣ δ’ἐς δίφρον ἔβαινεν ἀκηχεμένη φίλον ἦτορ,	- - -u u-u u-uu- uu --	dactylic hexameter	feminine penthemimeral
πὰρ δέ οἱ Ἶρις ἔβαινε καὶ ἡνία λάζετο χερσί,	- u u -u u-u u -uu -uu --	dactylic hexameter	feminine penthemimeral
μάστιξεν δ’ἐλάαν, τὼ δ’οὐκ ἀέκοντε πετέσθην.	--- uu- - - uu-u u--	dactylic hexameter	masculine penthemimeral, hepthemimeral, trithemimeral
Αἶψα δ’ἔπειθ’ ἵκοντο θεῶν ἕδος αἰπὺν Ὄλυμπον·	-u u- --u u- uu -u u--	dactylic hexameter	feminine penthemimeral, hepthemimeral, trithemimeral
ἔνθ’ ἵππους ἔστησε ποδήνεμος ὠκέα Ἶρις	- -- --u u-uu -uu --	dactylic hexameter	feminine penthemimeral, trithemimeral
λύσασ’ ἐξ ὀχέων, παρὰ δ’ἀμβρόσιον βάλεν εἶδαρ·	-- - uu- uu -uu- uu --	dactylic hexameter	masculine penthemimeral, trithemimeral
ἣ δ’ἐν γούνασι πῖπτε Διώνης δῖ’ Ἀφροδίτη	- - -uu -u u-- - uu--	dactylic hexameter	feminine penthemimeral
μητρὸς ἑῆς· ἣ δ’ἀγκὰς ἐλάζετο θυγατέρα ἥν,	-u u- - -u u-uu -uu- -	dactylic hexameter	feminine penthemimeral, trithemimeral
χειρί τέ μιν κατέρεξεν ἔπος τ’ἔφατ’ ἐκ τ’ὀνόμαζε·	-u u - uu-u u- uu - uu--	dactylic hexameter	feminine penthemimeral, hepthemimeral, trithemimeral
τίς νύ σε τοιάδ’ ἔρεξε φίλον τέκος Οὐρανιώνων	- u u -u u-u u- uu -uu--	dactylic hexameter	feminine penthemimeral, hepthemimeral
μαψιδίως, ὡς εἴ τι κακὸν ῥέζουσαν ἐνωπῇ;	-uu- - - u u- --u u--	dactylic hexameter	masculine penthemimeral, hepthemimeral, trithemimeral
τὴν δ’ἠμείβετ’ ἔπειτα φιλομμειδὴς Ἀφροδίτη·	- --u u-u u--- uu--	dactylic hexameter	feminine penthemimeral
οὖτά με Τυδέος υἱὸς ὑπέρθυμος Διομήδης,	-u u -uu -u u--- uu--	dactylic hexameter	feminine penthemimeral
οὕνεκ’ ἐγὼ φίλον υἱὸν ὑπεξέφερον πολέμοιο	-u u- uu -u u-uu- uu--	dactylic hexameter	feminine penthemimeral, trithemimeral
Αἰνείαν, ὃς ἐμοὶ πάντων πολὺ φίλτατός ἐστιν.	--- u u- -- uu -uu --	dactylic hexameter	masculine penthemimeral, hepthemimeral, trithemimeral
Οὐ γὰρ ἔτι Τρώων καὶ Ἀχαιῶν φύλοπις αἰνή,	- u u- -- u u-- -uu --	dactylic hexameter	masculine penthemimeral, trithemimeral
ἀλλ’ ἤδη Δαναοί γε καὶ ἀθανάτοισι μάχονται.	- -- uu- u u -uu-u u--	dactylic hexameter	masculine penthemimeral, trithemimeral
Τὴν δ’ἠμείβετ’ ἔπειτα Διώνη, δῖα θεάων·	- --u u-u u-- -u u--	dactylic hexameter	feminine penthemimeral
τέτλαθι τέκνον ἐμόν, καὶ ἀνάσχεο κηδομένη περ·	-uu -u u- u u-uu -uu- -	dactylic hexameter	masculine penthemimeral
πολλοὶ γὰρ δὴ τλῆμεν Ὀλύμπια δώματ’ ἔχοντες	-- - - -u u-uu -u u--	dactylic hexameter	feminine penthemimeral, trithemimeral
ἐξ ἀνδρῶν χαλέπ’ ἄλγε’ ἐπ’ ἀλλήλοισι τιθέντες.	- -- uu -u u ---u u--	dactylic hexameter	feminine penthemimeral, trithemimeral
Τλῆ μὲν Ἄρης ὅτε μιν Ὦτος κρατερός τ’Ἐφιάλτης	- u u- uu - -- uu- uu--	dactylic hexameter	masculine penthemimeral, hepthemimeral, trithemimeral
παῖδες Ἀλωῆος, δῆσαν κρατερῷ ἐνὶ δεσμῷ·	-u u--- -- uu- uu --	dactylic hexameter	masculine penthemimeral, hepthemimeral
χαλκέῳ δ’ἐν κεράμῳ δέδετο τρισκαίδεκα μῆνας·	-- - uu- uu- --uu --	dactylic hexameter	masculine penthemimeral, hepthemimeral, trithemimeral
καί νύ κεν ἔνθ’ ἀπόλοιτο Ἄρης ἆτος πολέμοιο,	- u u - uu-u u- -- uu--	dactylic hexameter	feminine penthemimeral, hepthemimeral, trithemimeral
εἰ μὴ μητρυιὴ περικαλλὴς Ἠερίβοια	- - --- uu-- -uu--	dactylic hexameter	masculine penthemimeral
Ἑρμέᾳ ἐξήγγειλεν· ὃ δ’ἐξέκλεψεν Ἄρηα	-- ---u u ---u u--	dactylic hexameter	feminine penthemimeral
ἤδη τειρόμενον, χαλεπὸς δέ ἑ δεσμὸς ἐδάμνα.	-- -uu- uu- u u -u u--	dactylic hexameter	masculine penthemimeral, hepthemimeral
Τλῆ δ’Ἥρη, ὅτε μιν κρατερὸς πάϊς Ἀμφιτρύωνος	- -- uu - uu- uu -uu--	dactylic hexameter	masculine penthemimeral, hepthemimeral, trithemimeral
δεξιτερὸν κατὰ μαζὸν ὀϊστῷ τριγλώχινι	-uu- uu -u u-- ----	dactylic hexameter	feminine penthemimeral, trithemimeral
βεβλήκει· τότε καί μιν ἀνήκεστον λάβεν ἄλγος.	--- uu - u u--- uu --	dactylic hexameter	masculine penthemimeral, trithemimeral
Τλῆ δ’Ἀΐδης ἐν τοῖσι πελώριος ὠκὺν ὀϊστόν,	- uu- - -u u-uu -u u--	dactylic hexameter	feminine penthemimeral, trithemimeral
εὖτέ μιν ωὐτὸς ἀνὴρ υἱὸς Διὸς αἰγιόχοιο	-u u -u u- -- uu -uu--	dactylic hexameter	masculine penthemimeral, hepthemimeral
ἐν Πύλῳ ἐν νεκύεσσι βαλὼν ὀδύνῃσιν ἔδωκεν·	- uu - uu-u u- uu-u u--	dactylic hexameter	feminine penthemimeral, hepthemimeral, trithemimeral
αὐτὰρ ὃ βῆ πρὸς δῶμα Διὸς καὶ μακρὸν Ὄλυμπον	-u u - - -u u- - -u u--	dactylic hexameter	feminine penthemimeral, hepthemimeral, trithemimeral
κῆρ ἀχέων ὀδύνῃσι πεπαρμένος· αὐτὰρ ὀϊστὸς	- uu- uu-u u-uu -u u--	dactylic hexameter	feminine penthemimeral, trithemimeral
ὤμῳ ἔνι στιβαρῷ ἠλήλατο, κῆδε δὲ θυμόν.	-u u- uu- --uu -u u --	dactylic hexameter	masculine penthemimeral, trithemimeral
Τῷ δ’ἐπὶ Παιήων ὀδυνήφατα φάρμακα πάσσων	- uu --- uu-uu -uu --	dactylic hexameter	masculine penthemimeral
ἠκέσατ’· οὐ μὲν γάρ τι καταθνητός γε τέτυκτο.	-uu - - - u u--- u u--	dactylic hexameter	masculine penthemimeral, trithemimeral
Σχέτλιος ὀβριμοεργὸς ὃς οὐκ ὄθετ’ αἴσυλα ῥέζων,	-uu -uu-u u - uu -uu --	dactylic hexameter	feminine penthemimeral, hepthemimeral
ὃς τόξοισιν ἔκηδε θεοὺς οἳ Ὄλυμπον ἔχουσι.	- --u u-u u- u u-u u--	dactylic hexameter	feminine penthemimeral, hepthemimeral
Σοὶ δ’ἐπὶ τοῦτον ἀνῆκε θεὰ γλαυκῶπις Ἀθήνη·	- uu -u u-u u- --u u--	dactylic hexameter	feminine penthemimeral, hepthemimeral
νήπιος, οὐδὲ τὸ οἶδε κατὰ φρένα Τυδέος υἱὸς	-uu -u u -u u- uu -uu --	dactylic hexameter	feminine penthemimeral, hepthemimeral
ὅττι μάλ’ οὐ δηναιὸς ὃς ἀθανάτοισι μάχηται,	-u u - --u u -uu-u u--	dactylic hexameter	feminine penthemimeral, trithemimeral
οὐδέ τί μιν παῖδες ποτὶ γούνασι παππάζουσιν	-u u - -- uu -uu ----	dactylic hexameter	masculine penthemimeral, trithemimeral
ἐλθόντ’ ἐκ πολέμοιο καὶ αἰνῆς δηϊοτῆτος.	-- - uu-u u -- -uu--	dactylic hexameter	feminine penthemimeral, trithemimeral
Τὼ νῦν Τυδεΐδης, εἰ καὶ μάλα καρτερός ἐστι,	- - -uu- - - uu -uu --	dactylic hexameter	masculine penthemimeral, hepthemimeral
φραζέσθω μή τίς οἱ ἀμείνων σεῖο μάχηται,	--- - - u u-- -u u--	dactylic hexameter	masculine penthemimeral, trithemimeral
μὴ δὴν Αἰγιάλεια περίφρων Ἀδρηστίνη	- - -uu-u u-- ----	dactylic hexameter	feminine penthemimeral
ἐξ ὕπνου γοόωσα φίλους οἰκῆας ἐγείρῃ	- -- uu-u u- --u u--	dactylic hexameter	feminine penthemimeral, hepthemimeral, trithemimeral
κουρίδιον ποθέουσα πόσιν τὸν ἄριστον Ἀχαιῶν	-uu- uu-u u- u u-u u--	dactylic hexameter	feminine penthemimeral, hepthemimeral, trithemimeral
ἰφθίμη ἄλοχος Διομήδεος ἱπποδάμοιο.	--- uu- uu-uu -uu--	dactylic hexameter	masculine penthemimeral, trithemimeral
Ἦ ῥα καὶ ἀμφοτέρῃσιν ἀπ’ ἰχῶ χειρὸς ὀμόργνυ·	- u u -uu-u u -- -u u--	dactylic hexameter	feminine penthemimeral
ἄλθετο χείρ, ὀδύναι δὲ κατηπιόωντο βαρεῖαι.	-uu - uu- u u-uu-u u--	dactylic hexameter	masculine penthemimeral, trithemimeral
Αἳ δ’αὖτ’ εἰσορόωσαι Ἀθηναίη τε καὶ Ἥρη	- - -uu-u u--- u u --	dactylic hexameter	feminine penthemimeral
κερτομίοις ἐπέεσσι Δία Κρονίδην ἐρέθιζον.	-uu- uu-u u- uu- uu--	dactylic hexameter	feminine penthemimeral, hepthemimeral, trithemimeral
Τοῖσι δὲ μύθων ἦρχε θεὰ γλαυκῶπις Ἀθήνη·	-u u -- -u u- --u u--	dactylic hexameter	feminine penthemimeral, hepthemimeral
Ζεῦ πάτερ ἦ ῥά τί μοι κεχολώσεαι ὅττι κεν εἴπω;	- uu - u u - uu-uu -u u --	dactylic hexameter	masculine penthemimeral, trithemimeral
ἦ μάλα δή τινα Κύπρις Ἀχαιϊάδων ἀνιεῖσα	- uu - uu -u u-uu- uu--	dactylic hexameter	feminine penthemimeral, trithemimeral
Τρωσὶν ἅμα σπέσθαι, τοὺς νῦν ἔκπαγλα φίλησε,	-u u- -- - - --u u--	dactylic hexameter	masculine penthemimeral, hepthemimeral, trithemimeral
τῶν τινα καρρέζουσα Ἀχαιϊάδων ἐϋπέπλων	- uu ---u u-uu- uu--	dactylic hexameter	feminine penthemimeral
πρὸς χρυσῇ περόνῃ καταμύξατο χεῖρα ἀραιήν.	- -- uu- uu-uu -u u--	dactylic hexameter	masculine penthemimeral, trithemimeral
Ὣς φάτο, μείδησεν δὲ πατὴρ ἀνδρῶν τε θεῶν τε,	- uu --- u u- -- u u- -	dactylic hexameter	masculine penthemimeral, hepthemimeral
καί ῥα καλεσσάμενος προσέφη χρυσῆν Ἀφροδίτην·	- u u-uu- uu- -- uu--	dactylic hexameter	masculine penthemimeral, hepthemimeral
οὔ τοι τέκνον ἐμὸν δέδοται πολεμήϊα ἔργα,	- - -u u- uu- uu-uu --	dactylic hexameter	masculine penthemimeral, hepthemimeral
ἀλλὰ σύ γ’ἱμερόεντα μετέρχεο ἔργα γάμοιο,	-u u -uu-u u-uu -u u--	dactylic hexameter	feminine penthemimeral
ταῦτα δ’Ἄρηϊ θοῷ καὶ Ἀθήνῃ πάντα μελήσει.	-u u-u u- u u-- -u u--	dactylic hexameter	masculine penthemimeral
Ὣς οἳ μὲν τοιαῦτα πρὸς ἀλλήλους ἀγόρευον,	- - - --u u --- uu--	dactylic hexameter	feminine penthemimeral, trithemimeral
Αἰνείᾳ δ’ἐπόρουσε βοὴν ἀγαθὸς Διομήδης,	--- uu-u u- uu- uu--	dactylic hexameter	feminine penthemimeral, hepthemimeral, trithemimeral
γιγνώσκων ὅ οἱ αὐτὸς ὑπείρεχε χεῖρας Ἀπόλλων·	--- u u -u u-uu -u u--	dactylic hexameter	feminine penthemimeral, trithemimeral
ἀλλ’ ὅ γ’ἄρ’ οὐδὲ θεὸν μέγαν ἅζετο, ἵετο δ’αἰεὶ	- u u -u u- uu -uu -uu --	dactylic hexameter	masculine penthemimeral
Αἰνείαν κτεῖναι καὶ ἀπὸ κλυτὰ τεύχεα δῦσαι.	--- -- u u- uu -uu --	dactylic hexameter	masculine penthemimeral, hepthemimeral, trithemimeral
Τρὶς μὲν ἔπειτ’ ἐπόρουσε κατακτάμεναι μενεαίνων,	- u u- uu-u u-uu- uu--	dactylic hexameter	feminine penthemimeral, trithemimeral
τρὶς δέ οἱ ἐστυφέλιξε φαεινὴν ἀσπίδ’ Ἀπόλλων·	- u u -uu-u u-- -u u--	dactylic hexameter	feminine penthemimeral
ἀλλ’ ὅτε δὴ τὸ τέταρτον ἐπέσσυτο δαίμονι ἶσος,	- uu - u u-u u-uu -uu --	dactylic hexameter	feminine penthemimeral, trithemimeral
δεινὰ δ’ὁμοκλήσας προσέφη ἑκάεργος Ἀπόλλων·	-u u--- uu- uu-u u--	dactylic hexameter	masculine penthemimeral, hepthemimeral
φράζεο Τυδεΐδη καὶ χάζεο, μηδὲ θεοῖσιν	-uu -uu- - -uu -u u--	dactylic hexameter	masculine penthemimeral
ἶσ’ ἔθελε φρονέειν, ἐπεὶ οὔ ποτε φῦλον ὁμοῖον	- uu- uu- uu - uu -u u--	dactylic hexameter	masculine penthemimeral, hepthemimeral, trithemimeral
ἀθανάτων τε θεῶν χαμαὶ ἐρχομένων τ’ἀνθρώπων.	-uu- u u- uu -uu- ---	dactylic hexameter	masculine penthemimeral, trithemimeral
Ὣς φάτο, Τυδεΐδης δ’ἀνεχάζετο τυτθὸν ὀπίσσω	- uu -uu- uu-uu -u u--	dactylic hexameter	masculine penthemimeral
μῆνιν ἀλευάμενος ἑκατηβόλου Ἀπόλλωνος.	-u u-uu- uu-uu ----	dactylic hexameter	masculine penthemimeral
Αἰνείαν δ’ἀπάτερθεν ὁμίλου θῆκεν Ἀπόλλων	--- uu-u u-- -u u--	dactylic hexameter	feminine penthemimeral, trithemimeral
Περγάμῳ εἰν ἱερῇ, ὅθι οἱ νηός γε τέτυκτο.	-uu - uu- uu - -- u u--	dactylic hexameter	masculine penthemimeral, hepthemimeral, trithemimeral
Ἤτοι τὸν Λητώ τε καὶ Ἄρτεμις ἰοχέαιρα	-- - -- u u -uu -uu--	dactylic hexameter	masculine penthemimeral, trithemimeral
ἐν μεγάλῳ ἀδύτῳ ἀκέοντό τε κύδαινόν τε·	- uu- uu- uu-u u --- -	dactylic hexameter	masculine penthemimeral, trithemimeral
αὐτὰρ ὃ εἴδωλον τεῦξ’ ἀργυρότοξος Ἀπόλλων	-u u --- - -uu-u u--	dactylic hexameter	masculine penthemimeral
αὐτῷ τ’Αἰνείᾳ ἴκελον καὶ τεύχεσι τοῖον,	-- --- uu- - -uu --	dactylic hexameter	masculine penthemimeral, hepthemimeral
ἀμφὶ δ’ἄρ’ εἰδώλῳ Τρῶες καὶ δῖοι Ἀχαιοὶ	-u u --- -- - -u u--	dactylic hexameter	masculine penthemimeral, hepthemimeral
δῄουν ἀλλήλων ἀμφὶ στήθεσσι βοείας	-- --- -- --u u--	dactylic hexameter	masculine penthemimeral, hepthemimeral
ἀσπίδας εὐκύκλους λαισήϊά τε πτερόεντα.	-uu --- --uu - uu--	dactylic hexameter	masculine penthemimeral
Δὴ τότε θοῦρον Ἄρηα προσηύδα Φοῖβος Ἀπόλλων·	- uu -u u-u u-- -u u--	dactylic hexameter	feminine penthemimeral
Ἆρες Ἄρες βροτολοιγὲ μιαιφόνε τειχεσιπλῆτα,	-u u- uu-u u-uu -uu--	dactylic hexameter	feminine penthemimeral, trithemimeral
οὐκ ἂν δὴ τόνδ’ ἄνδρα μάχης ἐρύσαιο μετελθὼν	- - - - -u u- uu-u u--	dactylic hexameter	feminine penthemimeral, hepthemimeral, trithemimeral
Τυδεΐδην, ὃς νῦν γε καὶ ἂν Διὶ πατρὶ μάχοιτο;	-uu- - - u u - uu -u u--	dactylic hexameter	masculine penthemimeral, hepthemimeral, trithemimeral
Κύπριδα μὲν πρῶτα σχεδὸν οὔτασε χεῖρ’ ἐπὶ καρπῷ,	-uu - -- uu -uu - uu --	dactylic hexameter	masculine penthemimeral, trithemimeral
αὐτὰρ ἔπειτ’ αὐτῷ μοι ἐπέσσυτο δαίμονι ἶσος.	-u u- -- u u-uu -uu --	dactylic hexameter	masculine penthemimeral, trithemimeral
Ὣς εἰπὼν αὐτὸς μὲν ἐφέζετο Περγάμῳ ἄκρῃ,	- -- -- u u-uu -uu --	dactylic hexameter	masculine penthemimeral, trithemimeral
Τρῳὰς δὲ στίχας οὖλος Ἄρης ὄτρυνε μετελθὼν	-- - uu -u u- --u u--	dactylic hexameter	feminine penthemimeral, hepthemimeral, trithemimeral
εἰδόμενος Ἀκάμαντι θοῷ ἡγήτορι Θρῃκῶν·	-uu- uu-u u- --uu --	dactylic hexameter	feminine penthemimeral, hepthemimeral, trithemimeral
υἱάσι δὲ Πριάμοιο διοτρεφέεσσι κέλευεν·	-uu - uu-u u-uu-u u--	dactylic hexameter	feminine penthemimeral, trithemimeral
ὦ υἱεῖς Πριάμοιο διοτρεφέος βασιλῆος	- -- uu-u u-uu- uu--	dactylic hexameter	feminine penthemimeral, trithemimeral
ἐς τί ἔτι κτείνεσθαι ἐάσετε λαὸν Ἀχαιοῖς;	- u u- --u u-uu -u u--	dactylic hexameter	feminine penthemimeral, trithemimeral
ἦ εἰς ὅ κεν ἀμφὶ πύλῃς εὖ ποιητῇσι μάχωνται;	- u u -u u- - ---u u--	dactylic hexameter	masculine penthemimeral
κεῖται ἀνὴρ ὃν ἶσον ἐτίομεν Ἕκτορι δίῳ	-u u- - -u u-uu -uu --	dactylic hexameter	feminine penthemimeral, trithemimeral
Αἰνείας υἱὸς μεγαλήτορος Ἀγχίσαο·	--- -- uu-uu ----	dactylic hexameter	masculine penthemimeral, trithemimeral
ἀλλ’ ἄγετ’ ἐκ φλοίσβοιο σαώσομεν ἐσθλὸν ἑταῖρον.	- uu - --u u-uu -u u--	dactylic hexameter	feminine penthemimeral, trithemimeral
Ὣς εἰπὼν ὄτρυνε μένος καὶ θυμὸν ἑκάστου.	- -- --u u- - -u u--	dactylic hexameter	feminine penthemimeral, hepthemimeral, trithemimeral
Ἔνθ’ αὖ Σαρπηδὼν μάλα νείκεσεν Ἕκτορα δῖον·	- - --- uu -uu -uu --	dactylic hexameter	masculine penthemimeral
Ἕκτορ πῇ δή τοι μένος οἴχεται ὃ πρὶν ἔχεσκες;	-- - - - uu -uu - u u--	dactylic hexameter	masculine penthemimeral, trithemimeral
φῆς που ἄτερ λαῶν πόλιν ἑξέμεν ἠδ’ ἐπικούρων	- u u- -- uu -uu - uu--	dactylic hexameter	masculine penthemimeral, trithemimeral
οἶος σὺν γαμβροῖσι κασιγνήτοισί τε σοῖσι.	-- - --u u---u u --	dactylic hexameter	feminine penthemimeral, trithemimeral
Τῶν νῦν οὔ τιν’ ἐγὼ ἰδέειν δύναμ’ οὐδὲ νοῆσαι,	- - - u u- uu- uu -u u--	dactylic hexameter	masculine penthemimeral, hepthemimeral, trithemimeral
ἀλλὰ καταπτώσσουσι κύνες ὣς ἀμφὶ λέοντα·	-u u---u u- - -u u--	dactylic hexameter	feminine penthemimeral, hepthemimeral
ἡμεῖς δὲ μαχόμεσθ’ οἵ πέρ τ’ἐπίκουροι ἔνειμεν.	-- - uu- - - uu-u u--	dactylic hexameter	masculine penthemimeral, hepthemimeral, trithemimeral
Καὶ γὰρ ἐγὼν ἐπίκουρος ἐὼν μάλα τηλόθεν ἥκω·	- u u- uu-u u- uu -uu --	dactylic hexameter	feminine penthemimeral, hepthemimeral, trithemimeral
τηλοῦ γὰρ Λυκίη Ξάνθῳ ἔπι δινήεντι,	-- - uu- -- uu ----	dactylic hexameter	masculine penthemimeral, hepthemimeral, trithemimeral
ἔνθ’ ἄλοχόν τε φίλην ἔλιπον καὶ νήπιον υἱόν,	- uu- u u- uu- - -uu --	dactylic hexameter	masculine penthemimeral, hepthemimeral, trithemimeral
κὰδ δὲ κτήματα πολλά, τὰ ἔλδεται ὅς κ’ἐπιδευής.	- - -uu -u u -uu - uu--	dactylic hexameter	feminine penthemimeral
Ἀλλὰ καὶ ὧς Λυκίους ὀτρύνω καὶ μέμον’ αὐτὸς	-u u - uu- --- - uu --	dactylic hexameter	masculine penthemimeral, trithemimeral
ἀνδρὶ μαχήσασθαι· ἀτὰρ οὔ τί μοι ἐνθάδε τοῖον	-u u--- uu - u u -uu --	dactylic hexameter	masculine penthemimeral, hepthemimeral
οἷόν κ’ἠὲ φέροιεν Ἀχαιοὶ ἤ κεν ἄγοιεν·	-- -u u-u u-- - u u--	dactylic hexameter	feminine penthemimeral
τύνη δ’ἕστηκας, ἀτὰρ οὐδ’ ἄλλοισι κελεύεις	-- --- uu - --u u--	dactylic hexameter	masculine penthemimeral, hepthemimeral
λαοῖσιν μενέμεν καὶ ἀμυνέμεναι ὤρεσσι.	--- uu- u u-uu- ---	dactylic hexameter	masculine penthemimeral, trithemimeral
Μή πως ὡς ἀψῖσι λίνου ἁλόντε πανάγρου	- - - --u u- --u u--	dactylic hexameter	feminine penthemimeral, hepthemimeral, trithemimeral
ἀνδράσι δυσμενέεσσιν ἕλωρ καὶ κύρμα γένησθε·	-uu -uu-u u- - -u u--	dactylic hexameter	feminine penthemimeral, hepthemimeral
οἳ δὲ τάχ’ ἐκπέρσουσ’ εὖ ναιομένην πόλιν ὑμήν.	- u u --- - -uu- uu --	dactylic hexameter	masculine penthemimeral
Σοὶ δὲ χρὴ τάδε πάντα μέλειν νύκτάς τε καὶ ἦμαρ	- - - uu -u u- -- u u --	dactylic hexameter	feminine penthemimeral, hepthemimeral, trithemimeral
ἀρχοὺς λισσομένῳ τηλεκλειτῶν ἐπικούρων	-- -uu- ---- uu--	dactylic hexameter	masculine penthemimeral
νωλεμέως ἐχέμεν, κρατερὴν δ’ἀποθέσθαι ἐνιπήν.	-uu- uu- uu- uu-u u--	dactylic hexameter	masculine penthemimeral, hepthemimeral, trithemimeral
Ὣς φάτο Σαρπηδών, δάκε δὲ φρένας Ἕκτορι μῦθος·	- uu --- uu - uu -uu --	dactylic hexameter	masculine penthemimeral, hepthemimeral
αὐτίκα δ’ἐξ ὀχέων σὺν τεύχεσιν ἆλτο χαμᾶζε,	-uu - uu- - -uu -u u--	dactylic hexameter	masculine penthemimeral, trithemimeral
πάλλων δ’ὀξέα δοῦρα κατὰ στρατὸν ᾤχετο πάντῃ	-- -uu -u u- uu -uu --	dactylic hexameter	feminine penthemimeral, hepthemimeral
ὀτρύνων μαχέσασθαι, ἔγειρε δὲ φύλοπιν αἰνήν.	--- uu-u u-u u -uu --	dactylic hexameter	feminine penthemimeral, trithemimeral
Οἳ δ’ἐλελίχθησαν καὶ ἐναντίοι ἔσταν Ἀχαιῶν·	- uu--- u u-uu -u u--	dactylic hexameter	masculine penthemimeral
Ἀργεῖοι δ’ὑπέμειναν ἀολλέες οὐδὲ φόβηθεν.	--- uu-u u-uu -u u--	dactylic hexameter	feminine penthemimeral, trithemimeral
Ὡς δ’ἄνεμος ἄχνας φορέει ἱερὰς κατ’ ἀλωὰς	- uu- -- uu- uu- u u--	dactylic hexameter	masculine penthemimeral, hepthemimeral, trithemimeral
ἀνδρῶν λικμώντων, ὅτε τε ξανθὴ Δημήτηρ	-- --- uu - -- ---	dactylic hexameter	masculine penthemimeral, hepthemimeral
κρίνῃ ἐπειγομένων ἀνέμων καρπόν τε καὶ ἄχνας,	-u u-uu- uu- -- u u --	dactylic hexameter	masculine penthemimeral, hepthemimeral
αἳ δ’ὑπολευκαίνονται ἀχυρμιαί· ὣς τότ’ Ἀχαιοὶ	- uu---u u-uu - u u--	dactylic hexameter	feminine penthemimeral
λευκοὶ ὕπερθε γένοντο κονισάλῳ, ὅν ῥα δι’ αὐτῶν	-u u-u u-u u-uu - u u --	dactylic hexameter	feminine penthemimeral
οὐρανὸν ἐς πολύχαλκον ἐπέπληγον πόδες ἵππων	-uu - uu-u u--- uu --	dactylic hexameter	feminine penthemimeral, trithemimeral
ἂψ ἐπιμισγομένων· ὑπὸ δ’ἔστρεφον ἡνιοχῆες.	- uu-uu- uu -uu -uu--	dactylic hexameter	masculine penthemimeral
Οἳ δὲ μένος χειρῶν ἰθὺς φέρον· ἀμφὶ δὲ νύκτα	- u u- -- -- uu -u u --	dactylic hexameter	masculine penthemimeral, hepthemimeral, trithemimeral
θοῦρος Ἄρης ἐκάλυψε μάχῃ Τρώεσσιν ἀρήγων	-u u- uu-u u- --u u--	dactylic hexameter	feminine penthemimeral, hepthemimeral, trithemimeral
πάντοσ’ ἐποιχόμενος· τοῦ δ’ἐκραίαινεν ἐφετμὰς	-u u-uu- - ---u u--	dactylic hexameter	masculine penthemimeral
Φοίβου Ἀπόλλωνος χρυσαόρου, ὅς μιν ἀνώγει	-u u--- --uu - u u--	dactylic hexameter	masculine penthemimeral
Τρωσὶν θυμὸν ἐγεῖραι, ἐπεὶ ἴδε Παλλάδ’ Ἀθήνην	-- -u u-u u- uu -u u--	dactylic hexameter	feminine penthemimeral, hepthemimeral
οἰχομένην· ἣ γάρ ῥα πέλεν Δαναοῖσιν ἀρηγών.	-uu- - - u u- uu-u u--	dactylic hexameter	masculine penthemimeral, hepthemimeral, trithemimeral
Αὐτὸς δ’Αἰνείαν μάλα πίονος ἐξ ἀδύτοιο	-- --- uu -uu - uu--	dactylic hexameter	masculine penthemimeral
ἧκε, καὶ ἐν στήθεσσι μένος βάλε ποιμένι λαῶν.	-u u - --u u- uu -uu --	dactylic hexameter	feminine penthemimeral, hepthemimeral, trithemimeral
Αἰνείας δ’ἑτάροισι μεθίστατο· τοὶ δὲ χάρησαν,	--- uu-u u-uu - u u--	dactylic hexameter	feminine penthemimeral, trithemimeral
ὡς εἶδον ζωόν τε καὶ ἀρτεμέα προσιόντα	- -- -- u u -uu- uu--	dactylic hexameter	masculine penthemimeral, trithemimeral
καὶ μένος ἐσθλὸν ἔχοντα· μετάλλησάν γε μὲν οὔ τι.	- uu -u u-u u--- u u - -	dactylic hexameter	feminine penthemimeral
Οὐ γὰρ ἔα πόνος ἄλλος, ὃν ἀργυρότοξος ἔγειρεν	- - - uu -u u -uu-u u--	dactylic hexameter	feminine penthemimeral, trithemimeral
Ἄρης τε βροτολοιγὸς Ἔρις τ’ἄμοτον μεμαυῖα.	-- - uu-u u- uu- uu--	dactylic hexameter	feminine penthemimeral, hepthemimeral, trithemimeral
Τοὺς δ’Αἴαντε δύω καὶ Ὀδυσσεὺς καὶ Διομήδης	- --u u- u u-- - uu--	dactylic hexameter	masculine penthemimeral
ὄτρυνον Δαναοὺς πολεμιζέμεν· οἳ δὲ καὶ αὐτοὶ	--- uu- uu-uu - u u --	dactylic hexameter	masculine penthemimeral, trithemimeral
οὔτε βίας Τρώων ὑπεδείδισαν οὔτε ἰωκάς,	-u u- -- uu-uu -u u--	dactylic hexameter	masculine penthemimeral, trithemimeral
ἀλλ’ ἔμενον νεφέλῃσιν ἐοικότες ἅς τε Κρονίων	- uu- uu-u u-uu - u u--	dactylic hexameter	feminine penthemimeral, trithemimeral
νηνεμίης ἔστησεν ἐπ’ ἀκροπόλοισιν ὄρεσσιν	-uu- --u u -uu-u u--	dactylic hexameter	feminine penthemimeral, trithemimeral
ἀτρέμας, ὄφρ’ εὕδῃσι μένος Βορέαο καὶ ἄλλων	-uu - --u u- uu-u u --	dactylic hexameter	feminine penthemimeral, hepthemimeral, trithemimeral
ζαχρειῶν ἀνέμων, οἵ τε νέφεα σκιόεντα	--- uu- - - uu- uu--	dactylic hexameter	masculine penthemimeral, hepthemimeral, trithemimeral
πνοιῇσιν λιγυρῇσι διασκιδνᾶσιν ἀέντες·	--- uu-u u---u u--	dactylic hexameter	feminine penthemimeral, trithemimeral
ὣς Δαναοὶ Τρῶας μένον ἔμπεδον οὐδὲ φέβοντο.	- uu- -- uu -uu -u u--	dactylic hexameter	masculine penthemimeral, trithemimeral
Ἀτρεΐδης δ’ἀν’ ὅμιλον ἐφοίτα πολλὰ κελεύων·	-uu- u u-u u-- -u u--	dactylic hexameter	feminine penthemimeral, trithemimeral
ὦ φίλοι ἀνέρες ἔστε καὶ ἄλκιμον ἦτορ ἕλεσθε,	- uu -uu -u u -uu -u u--	dactylic hexameter	feminine penthemimeral
ἀλλήλους τ’αἰδεῖσθε κατὰ κρατερὰς ὑσμίνας·	--- --u u- uu- ---	dactylic hexameter	feminine penthemimeral, hepthemimeral, trithemimeral
αἰδομένων ἀνδρῶν πλέονες σόοι ἠὲ πέφανται·	-uu- -- uu- uu -u u--	dactylic hexameter	masculine penthemimeral, hepthemimeral, trithemimeral
φευγόντων δ’οὔτ’ ἂρ κλέος ὄρνυται οὔτε τις ἀλκή.	--- - - uu -uu -u u --	dactylic hexameter	masculine penthemimeral, trithemimeral
Ἦ καὶ ἀκόντισε δουρὶ θοῶς, βάλε δὲ πρόμον ἄνδρα	- u u-uu -u u- uu - uu --	dactylic hexameter	feminine penthemimeral, hepthemimeral
Αἰνείω ἕταρον μεγαθύμου Δηϊκόωντα	--- uu- uu-- -uu--	dactylic hexameter	masculine penthemimeral, trithemimeral
Περγασίδην, ὃν Τρῶες ὁμῶς Πριάμοιο τέκεσσι	-uu- - -u u- uu-u u--	dactylic hexameter	feminine penthemimeral, hepthemimeral, trithemimeral
τῖον, ἐπεὶ θοὸς ἔσκε μετὰ πρώτοισι μάχεσθαι.	-u u- uu -u u- --u u--	dactylic hexameter	feminine penthemimeral, hepthemimeral, trithemimeral
Τόν ῥα κατ’ ἀσπίδα δουρὶ βάλε κρείων Ἀγαμέμνων·	- u u -uu -u u- -- uu--	dactylic hexameter	feminine penthemimeral, hepthemimeral
ἣ δ’οὐκ ἔγχος ἔρυτο, διὰ πρὸ δὲ εἴσατο χαλκός,	- - -u u-u u- u u -uu --	dactylic hexameter	feminine penthemimeral, hepthemimeral
νειαίρῃ δ’ἐν γαστρὶ διὰ ζωστῆρος ἔλασσε·	--- - -u u- --u u--	dactylic hexameter	feminine penthemimeral, hepthemimeral, trithemimeral
δούπησεν δὲ πεσών, ἀράβησε δὲ τεύχε’ ἐπ’ αὐτῷ.	--- u u- uu-u u -u u --	dactylic hexameter	masculine penthemimeral, trithemimeral
Ἔνθ’ αὖτ’ Αἰνείας Δαναῶν ἕλεν ἄνδρας ἀρίστους	- - --- uu- uu -u u--	dactylic hexameter	masculine penthemimeral, hepthemimeral
υἷε Διοκλῆος Κρήθωνά τε Ὀρσίλοχόν τε,	-u u--- --u u -uu- -	dactylic hexameter	masculine penthemimeral
τῶν ῥα πατὴρ μὲν ἔναιεν ἐϋκτιμένῃ ἐνὶ Φηρῇ	- u u- u u-u u-uu- uu --	dactylic hexameter	feminine penthemimeral, trithemimeral
ἀφνειὸς βιότοιο, γένος δ’ἦν ἐκ ποταμοῖο	--- uu-u u- - - uu--	dactylic hexameter	feminine penthemimeral, hepthemimeral, trithemimeral
Ἀλφειοῦ, ὅς τ’εὐρὺ ῥέει Πυλίων διὰ γαίης,	--- - -u u- uu- uu --	dactylic hexameter	feminine penthemimeral, hepthemimeral, trithemimeral
ὃς τέκετ’ Ὀρτίλοχον πολέεσσ’ ἄνδρεσσιν ἄνακτα·	- uu -uu- uu- --u u--	dactylic hexameter	masculine penthemimeral, hepthemimeral
Ὀρτίλοχος δ’ἄρ’ ἔτικτε Διοκλῆα μεγάθυμον,	-uu- u u-u u--- uu--	dactylic hexameter	feminine penthemimeral, trithemimeral
ἐκ δὲ Διοκλῆος διδυμάονε παῖδε γενέσθην,	- u u--- uu-uu -u u--	dactylic hexameter	masculine penthemimeral
Κρήθων Ὀρσίλοχός τε μάχης εὖ εἰδότε πάσης.	-- -uu- u u- - -uu --	dactylic hexameter	masculine penthemimeral, hepthemimeral
Τὼ μὲν ἄρ’ ἡβήσαντε μελαινάων ἐπὶ νηῶν	- u u ---u u--- uu --	dactylic hexameter	feminine penthemimeral
Ἴλιον εἰς εὔπωλον ἅμ’ Ἀργείοισιν ἑπέσθην,	-uu - --u u ---u u--	dactylic hexameter	feminine penthemimeral, trithemimeral
τιμὴν Ἀτρεΐδῃς Ἀγαμέμνονι καὶ Μενελάῳ	-- -uu- uu-uu - uu--	dactylic hexameter	masculine penthemimeral
ἀρνυμένω· τὼ δ’αὖθι τέλος θανάτοιο κάλυψεν.	-uu- - -u u- uu-u u--	dactylic hexameter	feminine penthemimeral, hepthemimeral, trithemimeral
Οἵω τώ γε λέοντε δύω ὄρεος κορυφῇσιν	-- - u u-u u- uu- uu--	dactylic hexameter	feminine penthemimeral, hepthemimeral, trithemimeral
ἐτραφέτην ὑπὸ μητρὶ βαθείης τάρφεσιν ὕλης·	-uu- uu -u u-- -uu --	dactylic hexameter	feminine penthemimeral, trithemimeral
τὼ μὲν ἄρ’ ἁρπάζοντε βόας καὶ ἴφια μῆλα	- u u ---u u- - -uu --	dactylic hexameter	feminine penthemimeral, hepthemimeral
σταθμοὺς ἀνθρώπων κεραΐζετον, ὄφρα καὶ αὐτὼ	-- --- uu-uu -u u --	dactylic hexameter	masculine penthemimeral
ἀνδρῶν ἐν παλάμῃσι κατέκταθεν ὀξέϊ χαλκῷ·	-- - uu-u u-uu -uu --	dactylic hexameter	feminine penthemimeral, trithemimeral
τοίω τὼ χείρεσσιν ὑπ’ Αἰνείαο δαμέντε	-- - --u u ---u u--	dactylic hexameter	feminine penthemimeral, trithemimeral
καππεσέτην, ἐλάτῃσιν ἐοικότες ὑψηλῇσι.	-uu- uu-u u-uu ----	dactylic hexameter	feminine penthemimeral, trithemimeral
Τὼ δὲ πεσόντ’ ἐλέησεν ἀρηΐφιλος Μενέλαος,	- u u- uu-u u-uu- uu--	dactylic hexameter	feminine penthemimeral, trithemimeral
βῆ δὲ διὰ προμάχων κεκορυθμένος αἴθοπι χαλκῷ	- u u- uu- uu-uu -uu --	dactylic hexameter	masculine penthemimeral, trithemimeral
σείων ἐγχείην· τοῦ δ’ὄτρυνεν μένος Ἄρης,	-- --- - --- uu --	dactylic hexameter	masculine penthemimeral
τὰ φρονέων ἵνα χερσὶν ὑπ’ Αἰνείαο δαμείη.	- uu- uu -u u ---u u--	dactylic hexameter	feminine penthemimeral, trithemimeral
Τὸν δ’ἴδεν Ἀντίλοχος μεγαθύμου Νέστορος υἱός,	- uu -uu- uu-- -uu --	dactylic hexameter	masculine penthemimeral
βῆ δὲ διὰ προμάχων· περὶ γὰρ δίε ποιμένι λαῶν	- u u- uu- uu - uu -uu --	dactylic hexameter	masculine penthemimeral, hepthemimeral, trithemimeral
μή τι πάθοι, μέγα δέ σφας ἀποσφήλειε πόνοιο.	- u u- uu - u u---u u--	dactylic hexameter	masculine penthemimeral, trithemimeral
Τὼ μὲν δὴ χεῖράς τε καὶ ἔγχεα ὀξυόεντα	- - - -- u u -uu -uu--	dactylic hexameter	masculine penthemimeral, trithemimeral
ἀντίον ἀλλήλων ἐχέτην μεμαῶτε μάχεσθαι·	-uu --- uu- uu-u u--	dactylic hexameter	masculine penthemimeral, hepthemimeral
Ἀντίλοχος δὲ μάλ’ ἄγχι παρίστατο ποιμένι λαῶν.	-uu- u u -u u-uu -uu --	dactylic hexameter	feminine penthemimeral, trithemimeral
Αἰνείας δ’οὐ μεῖνε θοός περ ἐὼν πολεμιστὴς	--- - -u u- u u- uu--	dactylic hexameter	feminine penthemimeral, hepthemimeral, trithemimeral
ὡς εἶδεν δύο φῶτε παρ’ ἀλλήλοισι μένοντε.	- -- uu -u u ---u u--	dactylic hexameter	feminine penthemimeral, trithemimeral
Οἳ δ’ἐπεὶ οὖν νεκροὺς ἔρυσαν μετὰ λαὸν Ἀχαιῶν,	- uu - -- uu- uu -u u--	dactylic hexameter	masculine penthemimeral, hepthemimeral, trithemimeral
τὼ μὲν ἄρα δειλὼ βαλέτην ἐν χερσὶν ἑταίρων,	- u u- -- uu- - -u u--	dactylic hexameter	masculine penthemimeral, hepthemimeral, trithemimeral
αὐτὼ δὲ στρεφθέντε μετὰ πρώτοισι μαχέσθην.	-- - --u u- --u u--	dactylic hexameter	feminine penthemimeral, hepthemimeral, trithemimeral
Ἔνθα Πυλαιμένεα ἑλέτην ἀτάλαντον Ἄρηϊ	-u u-uu- uu- uu-u u--	dactylic hexameter	masculine penthemimeral, hepthemimeral
ἀρχὸν Παφλαγόνων μεγαθύμων ἀσπιστάων.	-- -uu- uu-- ----	dactylic hexameter	masculine penthemimeral
Τὸν μὲν ἄρ’ Ἀτρεΐδης δουρικλειτὸς Μενέλαος	- u u -uu- ---- uu--	dactylic hexameter	masculine penthemimeral
ἑσταότ’ ἔγχεϊ νύξε κατὰ κληῖδα τυχήσας·	-uu -uu -u u- --u u--	dactylic hexameter	feminine penthemimeral, hepthemimeral
Ἀντίλοχος δὲ Μύδωνα βάλ’ ἡνίοχον θεράποντα	-uu- u u-u u -uu- uu--	dactylic hexameter	feminine penthemimeral, trithemimeral
ἐσθλὸν Ἀτυμνιάδην· ὃ δ’ὑπέστρεφε μώνυχας ἵππους·	-u u-uu- u u-uu -uu --	dactylic hexameter	masculine penthemimeral
χερμαδίῳ ἀγκῶνα τυχὼν μέσον· ἐκ δ’ἄρα χειρῶν	-uu- --u u- uu - uu --	dactylic hexameter	feminine penthemimeral, hepthemimeral, trithemimeral
ἡνία λεύκ’ ἐλέφαντι χαμαὶ πέσον ἐν κονίῃσιν.	-uu - uu-u u- uu - uu--	dactylic hexameter	feminine penthemimeral, hepthemimeral, trithemimeral
Ἀντίλοχος δ’ἄρ’ ἐπαΐξας ξίφει ἤλασε κόρσην·	-uu- u u--- uu -uu --	dactylic hexameter	hepthemimeral, trithemimeral
αὐτὰρ ὅ γ’ἀσθμαίνων εὐεργέος ἔκπεσε δίφρου	-u u --- --uu -uu --	dactylic hexameter	masculine penthemimeral
κύμβαχος ἐν κονίῃσιν ἐπὶ βρεχμόν τε καὶ ὤμους.	-uu - uu-u u- -- u u --	dactylic hexameter	feminine penthemimeral, hepthemimeral, trithemimeral
Δηθὰ μάλ’ ἑστήκει· τύχε γάρ ῥ’ἀμάθοιο βαθείης·	-u u --- uu - uu-u u--	dactylic hexameter	masculine penthemimeral, hepthemimeral
ὄφρ’ ἵππω πλήξαντε χαμαὶ βάλον ἐν κονίῃσι·	- -- --u u- uu - uu--	dactylic hexameter	feminine penthemimeral, hepthemimeral, trithemimeral
τοὺς ἵμασ’ Ἀντίλοχος, μετὰ δὲ στρατὸν ἤλασ’ Ἀχαιῶν.	- uu -uu- uu - uu -u u--	dactylic hexameter	masculine penthemimeral, hepthemimeral
Τοὺς δ’Ἕκτωρ ἐνόησε κατὰ στίχας, ὦρτο δ’ἐπ’ αὐτοὺς	- -- uu-u u- uu -u u --	dactylic hexameter	feminine penthemimeral, hepthemimeral, trithemimeral
κεκλήγων· ἅμα δὲ Τρώων εἵποντο φάλαγγες	--- uu - -- --u u--	dactylic hexameter	masculine penthemimeral, hepthemimeral, trithemimeral
καρτεραί· ἦρχε δ’ἄρα σφιν Ἄρης καὶ πότνι’ Ἐνυώ,	-uu -u u- u u- - -u u--	dactylic hexameter	masculine penthemimeral, hepthemimeral
ἣ μὲν ἔχουσα Κυδοιμὸν ἀναιδέα δηϊοτῆτος,	- u u-u u-u u-uu -uu--	dactylic hexameter	feminine penthemimeral
Ἄρης δ’ἐν παλάμῃσι πελώριον ἔγχος ἐνώμα,	-- - uu-u u-uu -u u--	dactylic hexameter	feminine penthemimeral, trithemimeral
φοίτα δ’ἄλλοτε μὲν πρόσθ’ Ἕκτορος, ἄλλοτ’ ὄπισθε.	-- -uu - - -uu -u u--	dactylic hexameter	masculine penthemimeral
Τὸν δὲ ἰδὼν ῥίγησε βοὴν ἀγαθὸς Διομήδης·	- u u- --u u- uu- uu--	dactylic hexameter	feminine penthemimeral, hepthemimeral, trithemimeral
ὡς δ’ὅτ’ ἀνὴρ ἀπάλαμνος ἰὼν πολέος πεδίοιο	- u u- uu-u u- uu- uu--	dactylic hexameter	feminine penthemimeral, hepthemimeral, trithemimeral
στήῃ ἐπ’ ὠκυρόῳ ποταμῷ ἅλα δὲ προρέοντι	-u u -uu- uu- uu - uu--	dactylic hexameter	masculine penthemimeral, hepthemimeral
ἀφρῷ μορμύροντα ἰδών, ἀνά τ’ἔδραμ’ ὀπίσσω,	-- ---u u- uu -u u--	dactylic hexameter	feminine penthemimeral, hepthemimeral
ὣς τότε Τυδεΐδης ἀνεχάζετο, εἶπέ τε λαῷ·	- uu -uu- uu-uu -u u --	dactylic hexameter	masculine penthemimeral
ὦ φίλοι οἷον δὴ θαυμάζομεν Ἕκτορα δῖον	- uu -- - --uu -uu --	dactylic hexameter	masculine penthemimeral
αἰχμητήν τ’ἔμεναι καὶ θαρσαλέον πολεμιστήν·	--- uu- - -uu- uu--	dactylic hexameter	masculine penthemimeral, trithemimeral
τῷ δ’αἰεὶ πάρα εἷς γε θεῶν, ὃς λοιγὸν ἀμύνει·	- -- uu - u u- - -u u--	dactylic hexameter	masculine penthemimeral, hepthemimeral, trithemimeral
καὶ νῦν οἱ πάρα κεῖνος Ἄρης βροτῷ ἀνδρὶ ἐοικώς.	- - - uu -u u- uu -u u--	dactylic hexameter	feminine penthemimeral, hepthemimeral, trithemimeral
Ἀλλὰ πρὸς Τρῶας τετραμμένοι αἰὲν ὀπίσσω	-- - -- --uu -u u--	dactylic hexameter	masculine penthemimeral, trithemimeral
εἴκετε, μηδὲ θεοῖς μενεαινέμεν ἶφι μάχεσθαι.	-uu -u u- uu-uu -u u--	dactylic hexameter	masculine penthemimeral
Ὣς ἄρ’ ἔφη, Τρῶες δὲ μάλα σχεδὸν ἤλυθον αὐτῶν.	- u u- -- u u- uu -uu --	dactylic hexameter	masculine penthemimeral, hepthemimeral, trithemimeral
Ἔνθ’ Ἕκτωρ δύο φῶτε κατέκτανεν εἰδότε χάρμης	- -- uu -u u-uu -uu --	dactylic hexameter	feminine penthemimeral, trithemimeral
εἰν ἑνὶ δίφρῳ ἐόντε, Μενέσθην Ἀγχίαλόν τε.	- uu -u u-u u-- -uu- -	dactylic hexameter	feminine penthemimeral
Τὼ δὲ πεσόντ’ ἐλέησε μέγας Τελαμώνιος Αἴας·	- u u- uu-u u- uu-uu --	dactylic hexameter	feminine penthemimeral, hepthemimeral, trithemimeral
στῆ δὲ μάλ’ ἐγγὺς ἰών, καὶ ἀκόντισε δουρὶ φαεινῷ,	- u u -u u- u u-uu -u u--	dactylic hexameter	masculine penthemimeral
καὶ βάλεν Ἄμφιον Σελάγου ἱόν, ὅς ῥ’ἐνὶ Παισῷ	- uu --- uu- uu - uu --	dactylic hexameter	masculine penthemimeral, hepthemimeral
ναῖε πολυκτήμων πολυλήϊος· ἀλλά ἑ μοῖρα	-u u--- uu-uu -u u --	dactylic hexameter	masculine penthemimeral
ἦγ’ ἐπικουρήσοντα μετὰ Πρίαμόν τε καὶ υἷας.	- uu---u u- uu- u u --	dactylic hexameter	feminine penthemimeral, hepthemimeral
Τόν ῥα κατὰ ζωστῆρα βάλεν Τελαμώνιος Αἴας,	- u u- --u u- uu-uu --	dactylic hexameter	feminine penthemimeral, hepthemimeral, trithemimeral
νειαίρῃ δ’ἐν γαστρὶ πάγη δολιχόσκιον ἔγχος,	--- - -u u- uu-uu --	dactylic hexameter	feminine penthemimeral, hepthemimeral, trithemimeral
δούπησεν δὲ πεσών· ὃ δ’ἐπέδραμε φαίδιμος Αἴας	--- u u- u u-uu -uu --	dactylic hexameter	masculine penthemimeral, trithemimeral
τεύχεα συλήσων· Τρῶες δ’ἐπὶ δούρατ’ ἔχευαν	-uu --- -- uu -u u--	dactylic hexameter	masculine penthemimeral, hepthemimeral
ὀξέα παμφανόωντα· σάκος δ’ἀνεδέξατο πολλά.	-uu -uu-u u- uu-uu --	dactylic hexameter	feminine penthemimeral, hepthemimeral
Αὐτὰρ ὃ λὰξ προσβὰς ἐκ νεκροῦ χάλκεον ἔγχος	-u u - -- - -- -uu --	dactylic hexameter	masculine penthemimeral, trithemimeral
ἐσπάσατ’· οὐδ’ ἄρ’ ἔτ’ ἄλλα δυνήσατο τεύχεα καλὰ	-uu - u u -u u-uu -uu --	dactylic hexameter	feminine penthemimeral, trithemimeral
ὤμοιιν ἀφελέσθαι· ἐπείγετο γὰρ βελέεσσι.	--- uu-u u-uu - uu--	dactylic hexameter	feminine penthemimeral, trithemimeral
Δεῖσε δ’ὅ γ’ἀμφίβασιν κρατερὴν Τρώων ἀγερώχων,	-u u -uu- uu- -- uu--	dactylic hexameter	masculine penthemimeral, hepthemimeral
οἳ πολλοί τε καὶ ἐσθλοὶ ἐφέστασαν ἔγχε’ ἔχοντες,	- -- u u -u u-uu -u u--	dactylic hexameter	feminine penthemimeral, trithemimeral
οἵ ἑ μέγαν περ ἐόντα καὶ ἴφθιμον καὶ ἀγαυὸν	- u u- u u-u u --- u u--	dactylic hexameter	feminine penthemimeral, trithemimeral
ὦσαν ἀπὸ σφείων· ὃ δὲ χασσάμενος πελεμίχθη.	-u u- -- u u -uu- uu--	dactylic hexameter	masculine penthemimeral, trithemimeral
Ὣς οἳ μὲν πονέοντο κατὰ κρατερὴν ὑσμίνην·	- - - uu-u u- uu- ---	dactylic hexameter	feminine penthemimeral, hepthemimeral, trithemimeral
Τληπόλεμον δ’Ἡρακλεΐδην ἠΰν τε μέγαν τε	-uu- --uu- -- u u- -	dactylic hexameter	hepthemimeral, trithemimeral
ὦρσεν ἐπ’ ἀντιθέῳ Σαρπηδόνι μοῖρα κραταιή.	-u u -uu- --uu -u u--	dactylic hexameter	masculine penthemimeral
Οἳ δ’ὅτε δὴ σχεδὸν ἦσαν ἐπ’ ἀλλήλοισιν ἰόντες	- uu - uu -u u ---u u--	dactylic hexameter	feminine penthemimeral, trithemimeral
υἱός θ’υἱωνός τε Διὸς νεφεληγερέταο,	-- --- u u- uu-uu--	dactylic hexameter	masculine penthemimeral, hepthemimeral
τὸν καὶ Τληπόλεμος πρότερος πρὸς μῦθον ἔειπε·	- - -uu- uu- - -u u--	dactylic hexameter	masculine penthemimeral, hepthemimeral
Σαρπῆδον Λυκίων βουληφόρε, τίς τοι ἀνάγκη	--- uu- --uu - u u--	dactylic hexameter	masculine penthemimeral, trithemimeral
πτώσσειν ἐνθάδ’ ἐόντι μάχης ἀδαήμονι φωτί;	-- -u u-u u- uu-uu --	dactylic hexameter	feminine penthemimeral, hepthemimeral
ψευδόμενοι δέ σέ φασι Διὸς γόνον αἰγιόχοιο	-uu- u u -u u- uu -uu--	dactylic hexameter	feminine penthemimeral, hepthemimeral, trithemimeral
εἶναι, ἐπεὶ πολλὸν κείνων ἐπιδεύεαι ἀνδρῶν	-u u- -- -- uu-uu --	dactylic hexameter	masculine penthemimeral, hepthemimeral, trithemimeral
οἳ Διὸς ἐξεγένοντο ἐπὶ προτέρων ἀνθρώπων·	- uu -uu-u u- uu- ---	dactylic hexameter	feminine penthemimeral, hepthemimeral
ἀλλ’ οἷόν τινά φασι βίην Ἡρακληείην	- -- uu -u u- -----	dactylic hexameter	feminine penthemimeral, hepthemimeral, trithemimeral
εἶναι, ἐμὸν πατέρα θρασυμέμνονα θυμολέοντα·	-u u- uu- uu-uu -uu--	dactylic hexameter	masculine penthemimeral, trithemimeral
ὅς ποτε δεῦρ’ ἐλθὼν ἕνεχ’ ἵππων Λαομέδοντος	- uu - -- uu -- -uu--	dactylic hexameter	masculine penthemimeral, trithemimeral
ἓξ οἴῃς σὺν νηυσὶ καὶ ἀνδράσι παυροτέροισιν	- -- - -u u -uu -uu--	dactylic hexameter	feminine penthemimeral, trithemimeral
Ἰλίου ἐξαλάπαξε πόλιν, χήρωσε δ’ἀγυιάς·	-uu -uu-u u- --u u--	dactylic hexameter	feminine penthemimeral, hepthemimeral
σοὶ δὲ κακὸς μὲν θυμός, ἀποφθινύθουσι δὲ λαοί.	- u u- - -u u-uu-u u --	dactylic hexameter	feminine penthemimeral, trithemimeral
Οὐδέ τί σε Τρώεσσιν ὀΐομαι ἄλκαρ ἔσεσθαι	-u u - --u u-uu -u u--	dactylic hexameter	feminine penthemimeral, trithemimeral
ἐλθόντ’ ἐκ Λυκίης, οὐδ’ εἰ μάλα καρτερός ἐσσι,	-- - uu- - - uu -uu --	dactylic hexameter	masculine penthemimeral, hepthemimeral, trithemimeral
ἀλλ’ ὑπ’ ἐμοὶ δμηθέντα πύλας Ἀΐδαο περήσειν.	- u u- --u u- uu-u u--	dactylic hexameter	feminine penthemimeral, hepthemimeral, trithemimeral
Τὸν δ’αὖ Σαρπηδὼν Λυκίων ἀγὸς ἀντίον ηὔδα·	- - --- uu- uu -uu --	dactylic hexameter	masculine penthemimeral, hepthemimeral
Τληπόλεμ’ ἤτοι κεῖνος ἀπώλεσεν Ἴλιον ἱρὴν	-uu -- -u u-uu -uu --	dactylic hexameter	feminine penthemimeral
ἀνέρος ἀφραδίῃσιν ἀγαυοῦ Λαομέδοντος,	-uu -uu-u u-- -uu--	dactylic hexameter	feminine penthemimeral
ὅς ῥά μιν εὖ ἕρξαντα κακῷ ἠνίπαπε μύθῳ,	- u u - --u u- --uu --	dactylic hexameter	feminine penthemimeral, hepthemimeral, trithemimeral
οὐδ’ ἀπέδωχ’ ἵππους, ὧν εἵνεκα τηλόθεν ἦλθε.	- uu- -- - -uu -uu --	dactylic hexameter	masculine penthemimeral, trithemimeral
Σοὶ δ’ἐγὼ ἐνθάδε φημὶ φόνον καὶ κῆρα μέλαιναν	- uu -uu -u u- - -u u--	dactylic hexameter	feminine penthemimeral, hepthemimeral
ἐξ ἐμέθεν τεύξεσθαι, ἐμῷ δ’ὑπὸ δουρὶ δαμέντα	- uu- --u u- uu -u u--	dactylic hexameter	feminine penthemimeral, hepthemimeral, trithemimeral
εὖχος ἐμοὶ δώσειν, ψυχὴν δ’Ἄϊδι κλυτοπώλῳ.	-u u- -- -- uu- uu--	dactylic hexameter	masculine penthemimeral, hepthemimeral, trithemimeral
Ὣς φάτο Σαρπηδών, ὃ δ’ἀνέσχετο μείλινον ἔγχος	- uu --- u u-uu -uu --	dactylic hexameter	masculine penthemimeral
Τληπόλεμος· καὶ τῶν μὲν ἁμαρτῇ δούρατα μακρὰ	-uu- - - u u-- -uu --	dactylic hexameter	masculine penthemimeral, trithemimeral
ἐκ χειρῶν ἤϊξαν· ὃ μὲν βάλεν αὐχένα μέσσον	- -- --u u - uu -uu --	dactylic hexameter	feminine penthemimeral, hepthemimeral, trithemimeral
Σαρπηδών, αἰχμὴ δὲ διαμπερὲς ἦλθ’ ἀλεγεινή·	--- -- u u-uu - uu--	dactylic hexameter	masculine penthemimeral, trithemimeral
τὸν δὲ κατ’ ὀφθαλμῶν ἐρεβεννὴ νὺξ ἐκάλυψε.	- u u --- uu-- - uu--	dactylic hexameter	masculine penthemimeral
Τληπόλεμος δ’ἄρα μηρὸν ἀριστερὸν ἔγχεϊ μακρῷ	-uu- uu -u u-uu -uu --	dactylic hexameter	feminine penthemimeral, trithemimeral
βεβλήκειν, αἰχμὴ δὲ διέσσυτο μαιμώωσα	--- -- u u-uu ----	dactylic hexameter	masculine penthemimeral, trithemimeral
ὀστέω ἐγχριμφθεῖσα, πατὴρ δ’ἔτι λοιγὸν ἄμυνεν.	-uu ---u u- uu -u u--	dactylic hexameter	feminine penthemimeral, hepthemimeral
Οἳ μὲν ἄρ’ ἀντίθεον Σαρπηδόνα δῖοι ἑταῖροι	- u u -uu- --uu -u u--	dactylic hexameter	masculine penthemimeral
ἐξέφερον πολέμοιο· βάρυνε δέ μιν δόρυ μακρὸν	-uu- uu-u u-u u - uu --	dactylic hexameter	feminine penthemimeral, trithemimeral
ἑλκόμενον· τὸ μὲν οὔ τις ἐπεφράσατ’ οὐδὲ νόησε	-uu- u u - u u-uu -u u--	dactylic hexameter	masculine penthemimeral, trithemimeral
μηροῦ ἐξερύσαι δόρυ μείλινον ὄφρ’ ἐπιβαίη	-- -uu- uu -uu - uu--	dactylic hexameter	masculine penthemimeral
σπευδόντων· τοῖον γὰρ ἔχον πόνον ἀμφιέποντες.	--- -- u u- uu -uu--	dactylic hexameter	masculine penthemimeral, hepthemimeral, trithemimeral
Τληπόλεμον δ’ἑτέρωθεν ἐϋκνήμιδες Ἀχαιοὶ	-uu- uu-u u---u u--	dactylic hexameter	feminine penthemimeral, trithemimeral
ἐξέφερον πολέμοιο· νόησε δὲ δῖος Ὀδυσσεὺς	-uu- uu-u u-u u -u u--	dactylic hexameter	feminine penthemimeral, trithemimeral
τλήμονα θυμὸν ἔχων, μαίμησε δέ οἱ φίλον ἦτορ·	-uu -u u- --u u - uu --	dactylic hexameter	masculine penthemimeral
μερμήριξε δ’ἔπειτα κατὰ φρένα καὶ κατὰ θυμὸν	---u u-u u- uu - uu --	dactylic hexameter	feminine penthemimeral, hepthemimeral
ἢ προτέρω Διὸς υἱὸν ἐριγδούποιο διώκοι,	- uu- uu -u u---u u--	dactylic hexameter	feminine penthemimeral, trithemimeral
ἦ ὅ γε τῶν πλεόνων Λυκίων ἀπὸ θυμὸν ἕλοιτο.	- u u - uu- uu- uu -u u--	dactylic hexameter	masculine penthemimeral, hepthemimeral, trithemimeral
Οὐδ’ ἄρ’ Ὀδυσσῆϊ μεγαλήτορι μόρσιμον ἦεν	- u u--- uu-uu -uu --	dactylic hexameter	masculine penthemimeral
ἴφθιμον Διὸς υἱὸν ἀποκτάμεν ὀξέϊ χαλκῷ·	--- uu -u u-uu -uu --	dactylic hexameter	feminine penthemimeral, trithemimeral
τώ ῥα κατὰ πληθὺν Λυκίων τράπε θυμὸν Ἀθήνη.	- u u- -- uu- uu -u u--	dactylic hexameter	masculine penthemimeral, hepthemimeral, trithemimeral
Ἔνθ’ ὅ γε Κοίρανον εἷλεν Ἀλάστορά τε Χρομίον τε	- u u -uu -u u-uu - uu- -	dactylic hexameter	feminine penthemimeral
Ἄλκανδρόν θ’Ἅλιόν τε Νοήμονά τε Πρύτανίν τε.	--- uu- u u-uu - uu- -	dactylic hexameter	masculine penthemimeral, trithemimeral
Καί νύ κ’ἔτι πλέονας Λυκίων κτάνε δῖος Ὀδυσσεὺς	- u u- uu- uu- uu -u u--	dactylic hexameter	masculine penthemimeral, hepthemimeral, trithemimeral
εἰ μὴ ἄρ’ ὀξὺ νόησε μέγας κορυθαίολος Ἕκτωρ·	- u u -u u-u u- uu-uu --	dactylic hexameter	feminine penthemimeral, hepthemimeral
βῆ δὲ διὰ προμάχων κεκορυθμένος αἴθοπι χαλκῷ	- u u- uu- uu-uu -uu --	dactylic hexameter	masculine penthemimeral, trithemimeral
δεῖμα φέρων Δαναοῖσι· χάρη δ’ἄρα οἱ προσιόντι	-u u- uu-u u- uu - uu--	dactylic hexameter	feminine penthemimeral, hepthemimeral, trithemimeral
Σαρπηδὼν Διὸς υἱός, ἔπος δ’ὀλοφυδνὸν ἔειπε·	--- uu -u u- uu-u u--	dactylic hexameter	feminine penthemimeral, hepthemimeral, trithemimeral
Πριαμίδη, μὴ δή με ἕλωρ Δαναοῖσιν ἐάσῃς	-uu- - - u u- uu-u u--	dactylic hexameter	masculine penthemimeral, hepthemimeral, trithemimeral
κεῖσθαι, ἀλλ’ ἐπάμυνον· ἔπειτά με καὶ λίποι αἰὼν	-- - uu-u u-u u - uu --	dactylic hexameter	feminine penthemimeral, trithemimeral
ἐν πόλει ὑμετέρῃ, ἐπεὶ οὐκ ἄρ’ ἔμελλον ἔγωγε	- uu -uu- uu - u u-u u--	dactylic hexameter	masculine penthemimeral, hepthemimeral
νοστήσας οἶκον δὲ φίλην ἐς πατρίδα γαῖαν	--- -- u u- - -uu --	dactylic hexameter	masculine penthemimeral, hepthemimeral, trithemimeral
εὐφρανέειν ἄλοχόν τε φίλην καὶ νήπιον υἱόν.	-uu- uu- u u- - -uu --	dactylic hexameter	masculine penthemimeral, hepthemimeral, trithemimeral
Ὣς φάτο, τὸν δ’οὔ τι προσέφη κορυθαίολος Ἕκτωρ,	- uu - - - uu- uu-uu --	dactylic hexameter	masculine penthemimeral, hepthemimeral, trithemimeral
ἀλλὰ παρήϊξεν λελιημένος ὄφρα τάχιστα	-u u--- uu-uu -u u--	dactylic hexameter	masculine penthemimeral
ὤσαιτ’ Ἀργείους, πολέων δ’ἀπὸ θυμὸν ἕλοιτο.	-- --- uu- uu -u u--	dactylic hexameter	masculine penthemimeral, hepthemimeral
Οἳ μὲν ἄρ’ ἀντίθεον Σαρπηδόνα δῖοι ἑταῖροι	- u u -uu- --uu -u u--	dactylic hexameter	masculine penthemimeral
εἷσαν ὑπ’ αἰγιόχοιο Διὸς περικαλλέϊ φηγῷ·	-u u -uu-u u- uu-uu --	dactylic hexameter	feminine penthemimeral, hepthemimeral
ἐκ δ’ἄρα οἱ μηροῦ δόρυ μείλινον ὦσε θύραζε	- uu - -- uu -uu -u u--	dactylic hexameter	masculine penthemimeral, trithemimeral
ἴφθιμος Πελάγων, ὅς οἱ φίλος ἦεν ἑταῖρος.	--- uu- - - uu -u u--	dactylic hexameter	masculine penthemimeral, hepthemimeral, trithemimeral
Τὸν δ’ἔλιπε ψυχή, κατὰ δ’ὀφθαλμῶν κέχυτ’ ἀχλύς·	- uu- -- uu --- uu --	dactylic hexameter	masculine penthemimeral, trithemimeral
αὖτις δ’ἐμπνύνθη, περὶ δὲ πνοιὴ Βορέαο	-- --- uu - -- uu--	dactylic hexameter	masculine penthemimeral, hepthemimeral
ζώγρει ἐπιπνείουσα κακῶς κεκαφηότα θυμόν.	-u u---u u- uu-uu --	dactylic hexameter	feminine penthemimeral, hepthemimeral
Ἀργεῖοι δ’ὑπ’ Ἄρηϊ καὶ Ἕκτορι χαλκοκορυστῇ	--- u u-u u -uu -uu--	dactylic hexameter	feminine penthemimeral, trithemimeral
οὔτε ποτὲ προτρέποντο μελαινάων ἐπὶ νηῶν	-u u- uu-u u--- uu --	dactylic hexameter	feminine penthemimeral, trithemimeral
οὔτε ποτ’ ἀντεφέροντο μάχῃ, ἀλλ’ αἰὲν ὀπίσσω	-u u -uu-u u- - -u u--	dactylic hexameter	feminine penthemimeral, hepthemimeral
χάζονθ’, ὡς ἐπύθοντο μετὰ Τρώεσσιν Ἄρηα.	-- - uu-u u- --u u--	dactylic hexameter	feminine penthemimeral, hepthemimeral, trithemimeral
Ἔνθα τίνα πρῶτον τίνα δ’ὕστατον ἐξενάριξαν	-u u- -- uu -uu -uu--	dactylic hexameter	masculine penthemimeral, trithemimeral
Ἕκτωρ τε Πριάμοιο πάϊς καὶ χάλκεος Ἄρης;	-- - uu-u u- - -uu --	dactylic hexameter	feminine penthemimeral, hepthemimeral, trithemimeral
ἀντίθεον Τεύθραντ’, ἐπὶ δὲ πλήξιππον Ὀρέστην,	-uu- -- uu - --u u--	dactylic hexameter	masculine penthemimeral, hepthemimeral, trithemimeral
Τρῆχόν τ’αἰχμητὴν Αἰτώλιον Οἰνόμαόν τε,	-- --- --uu -uu- -	dactylic hexameter	masculine penthemimeral
Οἰνοπίδην θ’Ἕλενον καὶ Ὀρέσβιον αἰολομίτρην,	-uu- uu- u u-uu -uu--	dactylic hexameter	masculine penthemimeral, trithemimeral
ὅς ῥ’ἐν Ὕλῃ ναίεσκε μέγα πλούτοιο μεμηλώς,	- u u- --u u- --u u--	dactylic hexameter	feminine penthemimeral, hepthemimeral, trithemimeral
λίμνῃ κεκλιμένος Κηφισίδι· πὰρ δέ οἱ ἄλλοι	-- -uu- --uu - u u --	dactylic hexameter	masculine penthemimeral
ναῖον Βοιωτοὶ μάλα πίονα δῆμον ἔχοντες.	-- --- uu -uu -u u--	dactylic hexameter	masculine penthemimeral
Τοὺς δ’ὡς οὖν ἐνόησε θεὰ λευκώλενος Ἥρη	- - - uu-u u- --uu --	dactylic hexameter	feminine penthemimeral, hepthemimeral, trithemimeral
Ἀργείους ὀλέκοντας ἐνὶ κρατερῇ ὑσμίνῃ,	--- uu-u u- uu- ---	dactylic hexameter	feminine penthemimeral, hepthemimeral, trithemimeral
αὐτίκ’ Ἀθηναίην ἔπεα πτερόεντα προσηύδα·	-u u--- uu- uu-u u--	dactylic hexameter	masculine penthemimeral, hepthemimeral
ὢ πόποι αἰγιόχοιο Διὸς τέκος Ἀτρυτώνη,	- uu -uu-u u- uu ----	dactylic hexameter	feminine penthemimeral, hepthemimeral
ἦ ῥ’ἅλιον τὸν μῦθον ὑπέστημεν Μενελάῳ	- uu- - -u u--- uu--	dactylic hexameter	feminine penthemimeral, trithemimeral
Ἴλιον ἐκπέρσαντ’ εὐτείχεον ἀπονέεσθαι,	-uu --- --uu -uu--	dactylic hexameter	masculine penthemimeral
εἰ οὕτω μαίνεσθαι ἐάσομεν οὖλον Ἄρηα.	- -- --u u-uu -u u--	dactylic hexameter	feminine penthemimeral, trithemimeral
Ἀλλ’ ἄγε δὴ καὶ νῶϊ μεδώμεθα θούριδος ἀλκῆς.	- uu - - -u u-uu -uu --	dactylic hexameter	feminine penthemimeral, trithemimeral
ὣς ἔφατ’, οὐδ’ ἀπίθησε θεὰ γλαυκῶπις Ἀθήνη.	- uu - uu-u u- --u u--	dactylic hexameter	feminine penthemimeral, hepthemimeral, trithemimeral
Ἣ μὲν ἐποιχομένη χρυσάμπυκας ἔντυεν ἵππους	- u u-uu- --uu -uu --	dactylic hexameter	masculine penthemimeral
Ἥρη πρέσβα θεὰ θυγάτηρ μεγάλοιο Κρόνοιο·	-- -u u- uu- uu-u u--	dactylic hexameter	masculine penthemimeral, hepthemimeral
Ἥβη δ’ἀμφ’ ὀχέεσσι θοῶς βάλε καμπύλα κύκλα	-- - uu-u u- uu -uu --	dactylic hexameter	feminine penthemimeral, hepthemimeral, trithemimeral
χάλκεα ὀκτάκνημα σιδηρέῳ ἄξονι ἀμφίς.	-uu ---u u-uu -uu --	dactylic hexameter	feminine penthemimeral
Τῶν ἤτοι χρυσέη ἴτυς ἄφθιτος, αὐτὰρ ὕπερθε	- -- uu- uu -uu -u u--	dactylic hexameter	masculine penthemimeral, trithemimeral
χάλκε’ ἐπίσσωτρα προσαρηρότα, θαῦμα ἰδέσθαι·	-u u--- uu-uu -u u--	dactylic hexameter	masculine penthemimeral
πλῆμναι δ’ἀργύρου εἰσὶ περίδρομοι ἀμφοτέρωθεν·	-- -uu -u u-uu -uu--	dactylic hexameter	feminine penthemimeral
δίφρος δὲ χρυσέοισι καὶ ἀργυρέοισιν ἱμᾶσιν	-- - uu-u u -uu-u u--	dactylic hexameter	feminine penthemimeral, trithemimeral
ἐντέταται, δοιαὶ δὲ περίδρομοι ἄντυγές εἰσι.	-uu- -- u u-uu -uu --	dactylic hexameter	masculine penthemimeral, trithemimeral
Τοῦ δ’ἐξ ἀργύρεος ῥυμὸς πέλεν· αὐτὰρ ἐπ’ ἄκρῳ	- - -uu- -- uu -u u --	dactylic hexameter	masculine penthemimeral, hepthemimeral
δῆσε χρύσειον καλὸν ζυγόν, ἐν δὲ λέπαδνα	-- --- -- uu - u u--	dactylic hexameter	masculine penthemimeral, hepthemimeral
κάλ’ ἔβαλε χρύσει’· ὑπὸ δὲ ζυγὸν ἤγαγεν Ἥρη	- uu- -- uu - uu -uu --	dactylic hexameter	masculine penthemimeral, hepthemimeral, trithemimeral
ἵππους ὠκύποδας, μεμαυῖ’ ἔριδος καὶ ἀϋτῆς.	-- -uu- uu- uu- u u--	dactylic hexameter	masculine penthemimeral, hepthemimeral
Αὐτὰρ Ἀθηναίη κούρη Διὸς αἰγιόχοιο	-u u--- -- uu -uu--	dactylic hexameter	masculine penthemimeral, hepthemimeral
πέπλον μὲν κατέχευεν ἑανὸν πατρὸς ἐπ’ οὔδει	-- - uu-u u-- -u u --	dactylic hexameter	feminine penthemimeral, trithemimeral
ποικίλον, ὅν ῥ’αὐτὴ ποιήσατο καὶ κάμε χερσίν·	-uu - -- --uu - uu --	dactylic hexameter	masculine penthemimeral, trithemimeral
ἣ δὲ χιτῶν’ ἐνδῦσα Διὸς νεφεληγερέταο	- u u- --u u- uu-uu--	dactylic hexameter	feminine penthemimeral, hepthemimeral, trithemimeral
τεύχεσιν ἐς πόλεμον θωρήσσετο δακρυόεντα.	-uu - uu- --uu -uu--	dactylic hexameter	masculine penthemimeral, trithemimeral
Ἀμφὶ δ’ἄρ’ ὤμοισιν βάλετ’ αἰγίδα θυσσανόεσσαν	-u u --- uu -uu -uu--	dactylic hexameter	masculine penthemimeral
δεινήν, ἣν περὶ μὲν πάντῃ Φόβος ἐστεφάνωται,	-- - uu - -- uu -uu--	dactylic hexameter	masculine penthemimeral, hepthemimeral, trithemimeral
ἐν δ’Ἔρις, ἐν δ’Ἀλκή, ἐν δὲ κρυόεσσα Ἰωκή,	- uu - -- - - uu-u u--	dactylic hexameter	masculine penthemimeral, hepthemimeral, trithemimeral
ἐν δέ τε Γοργείη κεφαλὴ δεινοῖο πελώρου	- u u --- uu- --u u--	dactylic hexameter	masculine penthemimeral, hepthemimeral
δεινή τε σμερδνή τε, Διὸς τέρας αἰγιόχοιο.	-- - -- u u- uu -uu--	dactylic hexameter	masculine penthemimeral, hepthemimeral, trithemimeral
Κρατὶ δ’ἐπ’ ἀμφίφαλον κυνέην θέτο τετραφάληρον	-u u -uu- uu- uu -uu--	dactylic hexameter	masculine penthemimeral, hepthemimeral
χρυσείην, ἑκατὸν πολίων πρυλέεσσ’ ἀραρυῖαν·	--- uu- uu- uu- uu--	dactylic hexameter	masculine penthemimeral, hepthemimeral, trithemimeral
ἐς δ’ὄχεα φλόγεα ποσὶ βήσετο, λάζετο δ’ἔγχος	- uu- uu- uu -uu -uu --	dactylic hexameter	masculine penthemimeral, trithemimeral
βριθὺ μέγα στιβαρόν, τῷ δάμνησι στίχας ἀνδρῶν	-u u- uu- - --- uu --	dactylic hexameter	masculine penthemimeral, trithemimeral
ἡρώων, οἷσίν τε κοτέσσεται ὀβριμοπάτρη.	--- -- u u-uu -uu--	dactylic hexameter	masculine penthemimeral, trithemimeral
Ἥρη δὲ μάστιγι θοῶς ἐπεμαίετ’ ἄρ’ ἵππους·	-- - --u u- uu-u u --	dactylic hexameter	feminine penthemimeral, hepthemimeral, trithemimeral
αὐτόμαται δὲ πύλαι μύκον οὐρανοῦ ἃς ἔχον Ὧραι,	-uu- u u- uu -uu - uu --	dactylic hexameter	masculine penthemimeral, trithemimeral
τῇς ἐπιτέτραπται μέγας οὐρανὸς Οὔλυμπός τε	- uu--- uu -uu --- -	dactylic hexameter	masculine penthemimeral
ἠμὲν ἀνακλῖναι πυκινὸν νέφος ἠδ’ ἐπιθεῖναι.	-u u--- uu- uu - uu--	dactylic hexameter	masculine penthemimeral, hepthemimeral
Τῇ ῥα δι’ αὐτάων κεντρηνεκέας ἔχον ἵππους·	- u u --- --uu- uu --	dactylic hexameter	masculine penthemimeral
εὗρον δὲ Κρονίωνα θεῶν ἄτερ ἥμενον ἄλλων	-- - uu-u u- uu -uu --	dactylic hexameter	feminine penthemimeral, hepthemimeral, trithemimeral
ἀκροτάτῃ κορυφῇ πολυδειράδος Οὐλύμποιο.	-uu- uu- uu-uu ----	dactylic hexameter	masculine penthemimeral, trithemimeral
Ἔνθ’ ἵππους στήσασα θεὰ λευκώλενος Ἥρη	- -- --u u- --uu --	dactylic hexameter	feminine penthemimeral, hepthemimeral, trithemimeral
Ζῆν’ ὕπατον Κρονίδην ἐξείρετο καὶ προσέειπε·	- uu- uu- --uu - uu--	dactylic hexameter	masculine penthemimeral, trithemimeral
Ζεῦ πάτερ οὐ νεμεσίζῃ Ἄρῃ τάδε καρτερὰ ἔργα	- uu - uu-u u- uu -uu --	dactylic hexameter	feminine penthemimeral, hepthemimeral, trithemimeral
ὁσσάτιόν τε καὶ οἷον ἀπώλεσε λαὸν Ἀχαιῶν	-uu- u u -u u-uu -u u--	dactylic hexameter	feminine penthemimeral, trithemimeral
μὰψ ἀτὰρ οὐ κατὰ κόσμον ἐμοὶ δ’ἄχος, οἳ δὲ ἕκηλοι	- uu - uu -u u- uu - u u--	dactylic hexameter	feminine penthemimeral, hepthemimeral, trithemimeral
τέρπονται Κύπρίς τε καὶ ἀργυρότοξος Ἀπόλλων	--- -- u u -uu-u u--	dactylic hexameter	masculine penthemimeral, trithemimeral
ἄφρονα τοῦτον ἀνέντες, ὃς οὔ τινα οἶδε θέμιστα;	-uu -u u-u u - uu -u u--	dactylic hexameter	feminine penthemimeral, hepthemimeral
Ζεῦ πάτερ ἦ ῥά τί μοι κεχολώσεαι, αἴ κεν Ἄρηα	- uu - u u - uu-uu - u u--	dactylic hexameter	masculine penthemimeral, trithemimeral
λυγρῶς πεπληγυῖα μάχης ἐξαποδίωμαι;	-- ---u u- --uu--	dactylic hexameter	feminine penthemimeral, hepthemimeral
τὴν δ’ἀπαμειβόμενος προσέφη νεφεληγερέτα Ζεύς·	- uu-uu- uu- uu-uu- -	dactylic hexameter	masculine penthemimeral, hepthemimeral
ἄγρει μάν οἱ ἔπορσον Ἀθηναίην ἀγελείην,	-- - u u-u u--- uu--	dactylic hexameter	feminine penthemimeral, trithemimeral
ἥ ἑ μάλιστ’ εἴωθε κακῇς ὀδύνῃσι πελάζειν.	- u u- --u u- uu-u u--	dactylic hexameter	feminine penthemimeral, hepthemimeral, trithemimeral
Ὣς ἔφατ’, οὐδ’ ἀπίθησε θεὰ λευκώλενος Ἥρη,	- uu - uu-u u- --uu --	dactylic hexameter	feminine penthemimeral, hepthemimeral, trithemimeral
μάστιξεν δ’ἵππους· τὼ δ’οὐκ ἀέκοντε πετέσθην	--- -- - - uu-u u--	dactylic hexameter	masculine penthemimeral, hepthemimeral, trithemimeral
μεσσηγὺς γαίης τε καὶ οὐρανοῦ ἀστερόεντος.	--- -- u u -uu -uu--	dactylic hexameter	masculine penthemimeral, trithemimeral
Ὅσσον δ’ἠεροειδὲς ἀνὴρ ἴδεν ὀφθαλμοῖσιν	-- -uu-u u- uu ----	dactylic hexameter	feminine penthemimeral, hepthemimeral
ἥμενος ἐν σκοπιῇ, λεύσσων ἐπὶ οἴνοπα πόντον,	-uu - uu- -- uu -uu --	dactylic hexameter	masculine penthemimeral, hepthemimeral, trithemimeral
τόσσον ἐπιθρῴσκουσι θεῶν ὑψηχέες ἵπποι.	-u u---u u- --uu --	dactylic hexameter	feminine penthemimeral, hepthemimeral
Ἀλλ’ ὅτε δὴ Τροίην ἷξον ποταμώ τε ῥέοντε,	- uu - -- -- uu- u u--	dactylic hexameter	masculine penthemimeral, hepthemimeral, trithemimeral
ἧχι ῥοὰς Σιμόεις συμβάλλετον ἠδὲ Σκάμανδρος,	-u u- uu- --uu -u u--	dactylic hexameter	masculine penthemimeral, trithemimeral
ἔνθ’ ἵππους ἔστησε θεὰ λευκώλενος Ἥρη	- -- --u u- --uu --	dactylic hexameter	feminine penthemimeral, hepthemimeral, trithemimeral
λύσασ’ ἐξ ὀχέων, περὶ δ’ἠέρα πουλὺν ἔχευε·	-- - uu- uu -uu -u u--	dactylic hexameter	masculine penthemimeral, trithemimeral
τοῖσιν δ’ἀμβροσίην Σιμόεις ἀνέτειλε νέμεσθαι.	-- -uu- uu- uu-u u--	dactylic hexameter	masculine penthemimeral, hepthemimeral
Αἳ δὲ βάτην τρήρωσι πελειάσιν ἴθμαθ’ ὁμοῖαι	- u u- --u u-uu -u u--	dactylic hexameter	feminine penthemimeral, trithemimeral
ἀνδράσιν Ἀργείοισιν ἀλεξέμεναι μεμαυῖαι·	-uu ---u u-uu- uu--	dactylic hexameter	feminine penthemimeral
ἀλλ’ ὅτε δή ῥ’ἵκανον ὅθι πλεῖστοι καὶ ἄριστοι	- uu - --u u- -- u u--	dactylic hexameter	feminine penthemimeral, hepthemimeral, trithemimeral
ἕστασαν ἀμφὶ βίην Διομήδεος ἱπποδάμοιο	-uu -u u- uu-uu -uu--	dactylic hexameter	masculine penthemimeral
εἰλόμενοι λείουσιν ἐοικότες ὠμοφάγοισιν	-uu- --u u-uu -uu--	dactylic hexameter	feminine penthemimeral, trithemimeral
ἢ συσὶ κάπροισιν, τῶν τε σθένος οὐκ ἀλαπαδνόν,	- uu --- - - uu - uu--	dactylic hexameter	masculine penthemimeral, hepthemimeral
ἔνθα στᾶσ’ ἤϋσε θεὰ λευκώλενος Ἥρη	-- - --u u- --uu --	dactylic hexameter	feminine penthemimeral, hepthemimeral, trithemimeral
Στέντορι εἰσαμένη μεγαλήτορι χαλκεοφώνῳ,	-uu -uu- uu-uu -uu--	dactylic hexameter	masculine penthemimeral
ὃς τόσον αὐδήσασχ’ ὅσον ἄλλοι πεντήκοντα·	- uu --- uu -- ----	dactylic hexameter	masculine penthemimeral
αἰδὼς Ἀργεῖοι κάκ’ ἐλέγχεα εἶδος ἀγητοί·	-- --- u u-uu -u u--	dactylic hexameter	masculine penthemimeral
ὄφρα μὲν ἐς πόλεμον πωλέσκετο δῖος Ἀχιλλεύς,	-u u - uu- --uu -u u--	dactylic hexameter	masculine penthemimeral, trithemimeral
οὐδέ ποτε Τρῶες πρὸ πυλάων Δαρδανιάων	-u u- -- u u-- -uu--	dactylic hexameter	masculine penthemimeral, trithemimeral
οἴχνεσκον· κείνου γὰρ ἐδείδισαν ὄβριμον ἔγχος·	--- -- u u-uu -uu --	dactylic hexameter	masculine penthemimeral, trithemimeral
νῦν δὲ ἑκὰς πόλιος κοίλῃς ἐπὶ νηυσὶ μάχονται.	- u u- uu- -- uu -u u--	dactylic hexameter	masculine penthemimeral, hepthemimeral, trithemimeral
Ὣς εἰποῦσ’ ὄτρυνε μένος καὶ θυμὸν ἑκάστου.	- -- --u u- - -u u--	dactylic hexameter	feminine penthemimeral, hepthemimeral, trithemimeral
Τυδεΐδῃ δ’ἐπόρουσε θεὰ γλαυκῶπις Ἀθήνη·	-uu- uu-u u- --u u--	dactylic hexameter	feminine penthemimeral, hepthemimeral, trithemimeral
εὗρε δὲ τόν γε ἄνακτα παρ’ ἵπποισιν καὶ ὄχεσφιν	-u u - u u-u u --- u u--	dactylic hexameter	feminine penthemimeral, trithemimeral
ἕλκος ἀναψύχοντα τό μιν βάλε Πάνδαρος ἰῷ.	-u u---u u - uu -uu --	dactylic hexameter	feminine penthemimeral, hepthemimeral
Ἱδρὼς γάρ μιν ἔτειρεν ὑπὸ πλατέος τελαμῶνος	-- - u u-u u- uu- uu--	dactylic hexameter	feminine penthemimeral, hepthemimeral, trithemimeral
ἀσπίδος εὐκύκλου· τῷ τείρετο, κάμνε δὲ χεῖρα,	-uu --- - -uu -u u --	dactylic hexameter	masculine penthemimeral
ἂν δ’ἴσχων τελαμῶνα κελαινεφὲς αἷμ’ ἀπομόργνυ.	- -- uu-u u-uu - uu--	dactylic hexameter	feminine penthemimeral, trithemimeral
Ἱππείου δὲ θεὰ ζυγοῦ ἥψατο φώνησέν τε·	--- u u- uu -uu --- -	dactylic hexameter	masculine penthemimeral, trithemimeral
ἦ ὀλίγον οἷ παῖδα ἐοικότα γείνατο Τυδεύς.	- uu- - -u u-uu -uu --	dactylic hexameter	feminine penthemimeral, trithemimeral
Τυδεύς τοι μικρὸς μὲν ἔην δέμας, ἀλλὰ μαχητής·	-- - -- u u- uu -u u--	dactylic hexameter	masculine penthemimeral, hepthemimeral, trithemimeral
καί ῥ’ὅτε πέρ μιν ἐγὼ πολεμίζειν οὐκ εἴασκον	- uu - u u- uu-- - ---	dactylic hexameter	masculine penthemimeral, trithemimeral
οὐδ’ ἐκπαιφάσσειν, ὅτε τ’ἤλυθε νόσφιν Ἀχαιῶν	- ---- uu -uu -u u--	dactylic hexameter	masculine penthemimeral
ἄγγελος ἐς Θήβας πολέας μετὰ Καδμείωνας·	-uu - -- uu- uu ----	dactylic hexameter	masculine penthemimeral, hepthemimeral, trithemimeral
δαίνυσθαί μιν ἄνωγον ἐνὶ μεγάροισιν ἕκηλον·	--- u u-u u- uu-u u--	dactylic hexameter	feminine penthemimeral, hepthemimeral, trithemimeral
αὐτὰρ ὃ θυμὸν ἔχων ὃν καρτερὸν ὡς τὸ πάρος περ	-u u -u u- - -uu - u u- -	dactylic hexameter	masculine penthemimeral
κούρους Καδμείων προκαλίζετο, πάντα δ’ἐνίκα	-- --- uu-uu -u u--	dactylic hexameter	masculine penthemimeral
ῥηϊδίως· τοίη οἱ ἐγὼν ἐπιτάρροθος ἦα.	-uu- -- u u- uu-uu --	dactylic hexameter	masculine penthemimeral, hepthemimeral, trithemimeral
Σοὶ δ’ἤτοι μὲν ἐγὼ παρά θ’ἵσταμαι ἠδὲ φυλάσσω,	- -- u u- uu -uu -u u--	dactylic hexameter	masculine penthemimeral, trithemimeral
καί σε προφρονέως κέλομαι Τρώεσσι μάχεσθαι·	- - -uu- uu- --u u--	dactylic hexameter	masculine penthemimeral, hepthemimeral
ἀλλά σευ ἢ κάματος πολυᾶϊξ γυῖα δέδυκεν	-u u - uu- uu-- -u u--	dactylic hexameter	masculine penthemimeral, trithemimeral
ἤ νύ σέ που δέος ἴσχει ἀκήριον· οὐ σύ γ’ἔπειτα	- u u - uu -u u-uu - u u--	dactylic hexameter	feminine penthemimeral, trithemimeral
Τυδέος ἔκγονός ἐσσι δαΐφρονος Οἰνεΐδαο.	-uu -uu -u u-uu -uu--	dactylic hexameter	feminine penthemimeral
Τὴν δ’ἀπαμειβόμενος προσέφη κρατερὸς Διομήδης·	- uu-uu- uu- uu- uu--	dactylic hexameter	masculine penthemimeral, hepthemimeral
γιγνώσκω σε θεὰ θύγατερ Διὸς αἰγιόχοιο·	--- u u- uu- uu -uu--	dactylic hexameter	masculine penthemimeral, hepthemimeral, trithemimeral
τώ τοι προφρονέως ἐρέω ἔπος οὐδ’ ἐπικεύσω.	- - -uu- uu- uu - uu--	dactylic hexameter	masculine penthemimeral, hepthemimeral
Οὔτέ τί με δέος ἴσχει ἀκήριον οὔτέ τις ὄκνος,	-u u - uu -u u-uu -u u --	dactylic hexameter	feminine penthemimeral, trithemimeral
ἀλλ’ ἔτι σέων μέμνημαι ἐφετμέων ἃς ἐπέτειλας	- uu - --u u-- - uu--	dactylic hexameter	feminine penthemimeral, trithemimeral
οὔ μ’εἴας μακάρεσσι θεοῖς ἀντικρὺ μάχεσθαι	- -- uu-u u- --u u--	dactylic hexameter	feminine penthemimeral, hepthemimeral, trithemimeral
τοῖς ἄλλοις· ἀτὰρ εἴ κε Διὸς θυγάτηρ Ἀφροδίτη	- -- uu - u u- uu- uu--	dactylic hexameter	masculine penthemimeral, hepthemimeral, trithemimeral
ἔλθῃσ’ ἐς πόλεμον, τήν γ’οὐτάμεν ὀξέϊ χαλκῷ.	-- - uu- - -uu -uu --	dactylic hexameter	masculine penthemimeral, trithemimeral
Τοὔνεκα νῦν αὐτός τ’ἀναχάζομαι ἠδὲ καὶ ἄλλους	-uu - -- uu-uu -u u --	dactylic hexameter	masculine penthemimeral, trithemimeral
Ἀργείους ἐκέλευσα ἀλήμεναι ἐνθάδε πάντας·	--- uu-u u-uu -uu --	dactylic hexameter	feminine penthemimeral, trithemimeral
γιγνώσκω γὰρ Ἄρηα μάχην ἀνὰ κοιρανέοντα.	--- u u-u u- uu -uu--	dactylic hexameter	feminine penthemimeral, hepthemimeral, trithemimeral
Τὸν δ’ἠμείβετ’ ἔπειτα θεὰ γλαυκῶπις Ἀθήνη·	- --u u-u u- --u u--	dactylic hexameter	feminine penthemimeral, hepthemimeral
Τυδεΐδη Διόμηδες ἐμῷ κεχαρισμένε θυμῷ	-uu- uu-u u- uu-uu --	dactylic hexameter	feminine penthemimeral, hepthemimeral, trithemimeral
μήτε σύ γ’Ἄρηα τό γε δείδιθι μήτε τιν’ ἄλλον	-u u --- u u -uu -u u --	dactylic hexameter	masculine penthemimeral
ἀθανάτων, τοίη τοι ἐγὼν ἐπιτάρροθός εἰμι·	-uu- -- u u- uu-uu --	dactylic hexameter	masculine penthemimeral, hepthemimeral, trithemimeral
ἀλλ’ ἄγ’ ἐπ’ Ἄρηϊ πρώτῳ ἔχε μώνυχας ἵππους,	- u u --- -- uu -uu --	dactylic hexameter	masculine penthemimeral, hepthemimeral
τύψον δὲ σχεδίην μηδ’ ἅζεο θοῦρον Ἄρηα	-- - uu- - -uu -u u--	dactylic hexameter	masculine penthemimeral, trithemimeral
τοῦτον μαινόμενον, τυκτὸν κακόν, ἀλλοπρόσαλλον,	-- -uu- -- uu -uu--	dactylic hexameter	masculine penthemimeral, hepthemimeral
ὃς πρῴην μὲν ἐμοί τε καὶ Ἥρῃ στεῦτ’ ἀγορεύων	- -- u u- u u -- - uu--	dactylic hexameter	masculine penthemimeral, trithemimeral
Τρωσὶ μαχήσεσθαι, ἀτὰρ Ἀργείοισιν ἀρήξειν,	-u u--- uu ---u u--	dactylic hexameter	masculine penthemimeral
νῦν δὲ μετὰ Τρώεσσιν ὁμιλεῖ, τῶν δὲ λέλασται.	- u u- --u u-- - u u--	dactylic hexameter	feminine penthemimeral, trithemimeral
Ὣς φαμένη Σθένελον μὲν ἀφ’ ἵππων ὦσε χαμᾶζε,	- uu- uu- u u -- -u u--	dactylic hexameter	masculine penthemimeral, trithemimeral
χειρὶ πάλιν ἐρύσασ’, ὃ δ’ἄρ’ ἐμμαπέως ἀπόρουσεν·	-u u- uu- u u -uu- uu--	dactylic hexameter	masculine penthemimeral, trithemimeral
ἣ δ’ἐς δίφρον ἔβαινε παραὶ Διομήδεα δῖον	- - -u u-u u- uu-uu --	dactylic hexameter	feminine penthemimeral, hepthemimeral
ἐμμεμαυῖα θεά· μέγα δ’ἔβραχε φήγινος ἄξων	-uu-u u- uu -uu -uu --	dactylic hexameter	masculine penthemimeral
βριθοσύνῃ· δεινὴν γὰρ ἄγεν θεὸν ἄνδρά τ’ἄριστον.	-uu- -- u u- uu -u u--	dactylic hexameter	masculine penthemimeral, hepthemimeral, trithemimeral
Λάζετο δὲ μάστιγα καὶ ἡνία Παλλὰς Ἀθήνη·	-uu - --u u -uu -u u--	dactylic hexameter	feminine penthemimeral, trithemimeral
αὐτίκ’ ἐπ’ Ἄρηϊ πρώτῳ ἔχε μώνυχας ἵππους.	-u u --- -- uu -uu --	dactylic hexameter	masculine penthemimeral, hepthemimeral
Ἤτοι ὃ μὲν Περίφαντα πελώριον ἐξενάριζεν	-u u - uu-u u-uu -uu--	dactylic hexameter	feminine penthemimeral, trithemimeral
Αἰτωλῶν ὄχ’ ἄριστον Ὀχησίου ἀγλαὸν υἱόν·	--- u u-u u-uu -uu --	dactylic hexameter	feminine penthemimeral, trithemimeral
τὸν μὲν Ἄρης ἐνάριζε μιαιφόνος· αὐτὰρ Ἀθήνη	- u u- uu-u u-uu -u u--	dactylic hexameter	feminine penthemimeral, trithemimeral
δῦν’ Ἄϊδος κυνέην, μή μιν ἴδοι ὄβριμος Ἄρης.	- uu- uu- - - uu -uu --	dactylic hexameter	masculine penthemimeral, hepthemimeral, trithemimeral
Ὡς δὲ ἴδε βροτολοιγὸς Ἄρης Διομήδεα δῖον,	- u u- uu-u u- uu-uu --	dactylic hexameter	feminine penthemimeral, hepthemimeral, trithemimeral
ἤτοι ὃ μὲν Περίφαντα πελώριον αὐτόθ’ ἔασε	-u u - uu-u u-uu -u u--	dactylic hexameter	feminine penthemimeral, trithemimeral
κεῖσθαι ὅθι πρῶτον κτείνων ἐξαίνυτο θυμόν,	-u u- -- -- --uu --	dactylic hexameter	masculine penthemimeral, hepthemimeral, trithemimeral
αὐτὰρ ὃ βῆ ῥ’ἰθὺς Διομήδεος ἱπποδάμοιο.	-u u - -- uu-uu -uu--	dactylic hexameter	masculine penthemimeral, trithemimeral
Οἳ δ’ὅτε δὴ σχεδὸν ἦσαν ἐπ’ ἀλλήλοισιν ἰόντες,	- uu - uu -u u ---u u--	dactylic hexameter	feminine penthemimeral, trithemimeral
πρόσθεν Ἄρης ὠρέξαθ’ ὑπὲρ ζυγὸν ἡνία θ’ἵππων	-u u- --u u- uu -uu --	dactylic hexameter	feminine penthemimeral, hepthemimeral, trithemimeral
ἔγχεϊ χαλκείῳ μεμαὼς ἀπὸ θυμὸν ἑλέσθαι·	-uu --- uu- uu -u u--	dactylic hexameter	masculine penthemimeral, hepthemimeral
καὶ τό γε χειρὶ λαβοῦσα θεὰ γλαυκῶπις Ἀθήνη	- u u -u u-u u- --u u--	dactylic hexameter	feminine penthemimeral, hepthemimeral
ὦσεν ὑπὲκ δίφροιο ἐτώσιον ἀϊχθῆναι.	-u u- --u u-uu ----	dactylic hexameter	feminine penthemimeral, trithemimeral
Δεύτερος αὖθ’ ὡρμᾶτο βοὴν ἀγαθὸς Διομήδης	-uu - --u u- uu- uu--	dactylic hexameter	feminine penthemimeral, hepthemimeral, trithemimeral
ἔγχεϊ χαλκείῳ· ἐπέρεισε δὲ Παλλὰς Ἀθήνη	-uu --- uu-u u -u u--	dactylic hexameter	masculine penthemimeral
νείατον ἐς κενεῶνα ὅθι ζωννύσκετο μίτρῃ·	-uu - uu-u u- --uu --	dactylic hexameter	feminine penthemimeral, hepthemimeral, trithemimeral
τῇ ῥά μιν οὖτα τυχών, διὰ δὲ χρόα καλὸν ἔδαψεν,	- u u -u u- uu - uu -u u--	dactylic hexameter	masculine penthemimeral, hepthemimeral
ἐκ δὲ δόρυ σπάσεν αὖτις· ὃ δ’ἔβραχε χάλκεος Ἄρης	- u u- uu -u u -uu -uu --	dactylic hexameter	feminine penthemimeral, trithemimeral
ὅσσόν τ’ἐννεάχιλοι ἐπίαχον ἢ δεκάχιλοι	-- -uu-u u-uu - uu--	dactylic hexameter	feminine penthemimeral
ἀνέρες ἐν πολέμῳ ἔριδα ξυνάγοντες Ἄρηος.	-uu - uu- uu- uu-u u--	dactylic hexameter	masculine penthemimeral, hepthemimeral, trithemimeral
Τοὺς δ’ἄρ’ ὑπὸ τρόμος εἷλεν Ἀχαιούς τε Τρῶάς τε	- u u- uu -u u-- - -- -	dactylic hexameter	feminine penthemimeral, trithemimeral
δείσαντας· τόσον ἔβραχ’ Ἄρης ἆτος πολέμοιο.	--- uu -u u- -- uu--	dactylic hexameter	feminine penthemimeral, hepthemimeral, trithemimeral
Οἵη δ’ἐκ νεφέων ἐρεβεννὴ φαίνεται ἀὴρ	-- - uu- uu-- -uu --	dactylic hexameter	masculine penthemimeral, trithemimeral
καύματος ἐξ ἀνέμοιο δυσαέος ὀρνυμένοιο,	-uu - uu-u u-- -uu--	dactylic hexameter	feminine penthemimeral, trithemimeral
τοῖος Τυδεΐδῃ Διομήδεϊ χάλκεος Ἄρης	-- -uu- uu-uu -uu --	dactylic hexameter	masculine penthemimeral
φαίνεθ’ ὁμοῦ νεφέεσσιν ἰὼν εἰς οὐρανὸν εὐρύν.	-u u- uu-u u- - -uu --	dactylic hexameter	feminine penthemimeral, hepthemimeral, trithemimeral
Καρπαλίμως δ’ἵκανε θεῶν ἕδος αἰπὺν Ὄλυμπον,	-uu- --u u- uu -u u--	dactylic hexameter	feminine penthemimeral, hepthemimeral, trithemimeral
πὰρ δὲ Διὶ Κρονίωνι καθέζετο θυμὸν ἀχεύων,	- u u- uu-u u-uu -u u--	dactylic hexameter	feminine penthemimeral, trithemimeral
δεῖξεν δ’ἄμβροτον αἷμα καταρρέον ἐξ ὠτειλῆς,	-- -uu -u u-uu - ---	dactylic hexameter	feminine penthemimeral
καί ῥ’ὀλοφυρόμενος ἔπεα πτερόεντα προσηύδα·	- uu-uu- uu- uu-u u--	dactylic hexameter	masculine penthemimeral, hepthemimeral
Ζεῦ πάτερ οὐ νεμεσίζῃ ὁρῶν τάδε καρτερὰ ἔργα;	- uu - uu-u u- uu -uu --	dactylic hexameter	feminine penthemimeral, hepthemimeral, trithemimeral
αἰεί τοι ῥίγιστα θεοὶ τετληότες εἰμὲν	-- - --u u- --uu --	dactylic hexameter	feminine penthemimeral, hepthemimeral, trithemimeral
ἀλλήλων ἰότητι, χάριν ἄνδρεσσι φέροντες.	--- uu-u u- --u u--	dactylic hexameter	feminine penthemimeral, hepthemimeral, trithemimeral
Σοὶ πάντες μαχόμεσθα· σὺ γὰρ τέκες ἄφρονα κούρην	- -- uu-u u - uu -uu --	dactylic hexameter	feminine penthemimeral, hepthemimeral, trithemimeral
οὐλομένην, ᾗ τ’αἰὲν ἀήσυλα ἔργα μέμηλεν.	-uu- - -u u-uu -u u--	dactylic hexameter	feminine penthemimeral, trithemimeral
Ἄλλοι μὲν γὰρ πάντες ὅσοι θεοί εἰσ’ ἐν Ὀλύμπῳ	-- - - -u u- uu - u u--	dactylic hexameter	feminine penthemimeral, hepthemimeral, trithemimeral
σοί τ’ἐπιπείθονται καὶ δεδμήμεσθα ἕκαστος·	- uu--- - ---u u--	dactylic hexameter	masculine penthemimeral
ταύτην δ’οὔτ’ ἔπεϊ προτιβάλλεαι οὔτέ τι ἔργῳ,	-- - uu- uu-uu -u u --	dactylic hexameter	masculine penthemimeral, trithemimeral
ἀλλ’ ἀνιεῖς, ἐπεὶ αὐτὸς ἐγείναο παῖδ’ ἀΐδηλον·	- uu- uu -u u-uu - uu--	dactylic hexameter	feminine penthemimeral, trithemimeral
ἣ νῦν Τυδέος υἱὸν ὑπερφίαλον Διομήδεα	- - -uu -u u-uu- uu--	dactylic hexameter	feminine penthemimeral
μαργαίνειν ἀνέηκεν ἐπ’ ἀθανάτοισι θεοῖσι.	--- uu-u u -uu-u u--	dactylic hexameter	feminine penthemimeral, trithemimeral
Κύπριδα μὲν πρῶτον σχεδὸν οὔτασε χεῖρ’ ἐπὶ καρπῷ,	-uu - -- uu -uu - uu --	dactylic hexameter	masculine penthemimeral, trithemimeral
αὐτὰρ ἔπειτ’ αὐτῷ μοι ἐπέσσυτο δαίμονι ἶσος·	-u u- -- u u-uu -uu --	dactylic hexameter	masculine penthemimeral, trithemimeral
ἀλλά μ’ὑπήνεικαν ταχέες πόδες· ἦ τέ κε δηρὸν	-u u--- uu- uu - u u --	dactylic hexameter	masculine penthemimeral, hepthemimeral
αὐτοῦ πήματ’ ἔπασχον ἐν αἰνῇσιν νεκάδεσσιν,	-- -u u-u u --- uu--	dactylic hexameter	feminine penthemimeral
ἤ κε ζὼς ἀμενηνὸς ἔα χαλκοῖο τυπῇσι.	- - - uu-u u- --u u--	dactylic hexameter	feminine penthemimeral, hepthemimeral, trithemimeral
Τὸν δ’ἄρ’ ὑπόδρα ἰδὼν προσέφη νεφεληγερέτα Ζεύς.	- u u-u u- uu- uu-uu- -	dactylic hexameter	masculine penthemimeral, hepthemimeral
Μή τί μοι ἀλλοπρόσαλλε παρεζόμενος μινύριζε.	- u u -uu-u u-uu- uu--	dactylic hexameter	feminine penthemimeral
Ἔχθιστος δέ μοί ἐσσι θεῶν οἳ Ὄλυμπον ἔχουσιν·	--- u u -u u- u u-u u--	dactylic hexameter	feminine penthemimeral, hepthemimeral, trithemimeral
αἰεὶ γάρ τοι ἔρις τε φίλη πόλεμοί τε μάχαι τε.	-- - u u- u u- uu- u u- -	dactylic hexameter	masculine penthemimeral, hepthemimeral, trithemimeral
Μητρός τοι μένος ἐστὶν ἀάσχετον οὐκ ἐπιεικτὸν	-- - uu -u u-uu - uu--	dactylic hexameter	feminine penthemimeral, trithemimeral
Ἥρης· τὴν μὲν ἐγὼ σπουδῇ δάμνημ’ ἐπέεσσι·	-- - u u- -- -- uu--	dactylic hexameter	masculine penthemimeral, hepthemimeral, trithemimeral
τώ σ’ὀΐω κείνης τάδε πάσχειν ἐννεσίῃσιν.	- uu- -- uu -- -uu--	dactylic hexameter	masculine penthemimeral, trithemimeral
Ἀλλ’ οὐ μάν σ’ἔτι δηρὸν ἀνέξομαι ἄλγε’ ἔχοντα·	- - - uu -u u-uu -u u--	dactylic hexameter	feminine penthemimeral, trithemimeral
ἐκ γὰρ ἐμεῦ γένος ἐσσί, ἐμοὶ δέ σε γείνατο μήτηρ·	- u u- uu -u u- u u -uu --	dactylic hexameter	feminine penthemimeral, hepthemimeral, trithemimeral
εἰ δέ τευ ἐξ ἄλλου γε θεῶν γένευ ὧδ’ ἀΐδηλος	- u u - -- u u- uu - uu--	dactylic hexameter	masculine penthemimeral, hepthemimeral, trithemimeral
καί κεν δὴ πάλαι ἦσθα ἐνέρτερος Οὐρανιώνων.	- - - uu -u u-uu -uu--	dactylic hexameter	feminine penthemimeral, trithemimeral
Ὣς φάτο, καὶ Παιήον’ ἀνώγειν ἰήσασθαι.	- uu - --u u-- ----	dactylic hexameter	feminine penthemimeral, trithemimeral
Τῷ δ’ἐπὶ Παιήων ὀδυνήφατα φάρμακα πάσσων	- uu --- uu-uu -uu --	dactylic hexameter	masculine penthemimeral
ἠκέσατ’· οὐ μὲν γάρ τι καταθνητός γ’ἐτέτυκτο.	-uu - - - u u--- uu--	dactylic hexameter	masculine penthemimeral, trithemimeral
Ὡς δ’ὅτ’ ὀπὸς γάλα λευκὸν ἐπειγόμενος συνέπηξεν	- u u- uu -u u-uu- uu--	dactylic hexameter	feminine penthemimeral, trithemimeral
ὑγρὸν ἐόν, μάλα δ’ὦκα περιτρέφεται κυκόωντι,	-u u- uu -u u-uu- uu--	dactylic hexameter	feminine penthemimeral, trithemimeral
ὣς ἄρα καρπαλίμως ἰήσατο θοῦρον Ἄρηα.	- uu -uu- --uu -u u--	dactylic hexameter	masculine penthemimeral
Τὸν δ’Ἥβη λοῦσεν, χαρίεντα δὲ εἵματα ἕσσε·	- -- -- uu-u u -uu --	dactylic hexameter	masculine penthemimeral, trithemimeral
πὰρ δὲ Διὶ Κρονίωνι καθέζετο κύδεϊ γαίων.	- u u- uu-u u-uu -uu --	dactylic hexameter	feminine penthemimeral, trithemimeral
Αἳ δ’αὖτις πρὸς δῶμα Διὸς μεγάλοιο νέοντο	- -- - -u u- uu-u u--	dactylic hexameter	feminine penthemimeral, hepthemimeral, trithemimeral
Ἥρη τ’Ἀργείη καὶ Ἀλαλκομενηῒς Ἀθήνη	-- --- u u-uu-u u--	dactylic hexameter	masculine penthemimeral
παύσασαι βροτολοιγὸν Ἄρη’ ἀνδροκτασιάων.	--- uu-u u- --uu--	dactylic hexameter	feminine penthemimeral, hepthemimeral, trithemimeral
