Ἄλλοι μέν ῥα θεοί τε καὶ ἀνέρες ἱπποκορυσταὶ	-- - u u- u u -uu -uu--	dactylic hexameter	masculine penthemimeral, trithemimeral
εὗδον παννύχιοι, Δία δ’οὐκ ἔχε νήδυμος ὕπνος,	-- -uu- uu - uu -uu --	dactylic hexameter	masculine penthemimeral, hepthemimeral
ἀλλ’ ὅ γε μερμήριζε κατὰ φρένα ὡς Ἀχιλῆα	- u u ---u u- uu - uu--	dactylic hexameter	feminine penthemimeral, hepthemimeral
τιμήσῃ, ὀλέσῃ δὲ πολέας ἐπὶ νηυσὶν Ἀχαιῶν.	--- uu- u u- uu -u u--	dactylic hexameter	masculine penthemimeral, hepthemimeral, trithemimeral
Ἥδε δέ οἱ κατὰ θυμὸν ἀρίστη φαίνετο βουλή,	-u u - uu -u u-- -uu --	dactylic hexameter	feminine penthemimeral, trithemimeral
πέμψαι ἐπ’ Ἀτρεΐδῃ Ἀγαμέμνονι οὖλον ὄνειρον·	-u u -uu- uu-uu -u u--	dactylic hexameter	masculine penthemimeral
καί μιν φωνήσας ἔπεα πτερόεντα προσηύδα·	- - --- uu- uu-u u--	dactylic hexameter	masculine penthemimeral, hepthemimeral
βάσκ’ ἴθι οὖλε ὄνειρε θοὰς ἐπὶ νῆας Ἀχαιῶν·	- uu -u u-u u- uu -u u--	dactylic hexameter	feminine penthemimeral, hepthemimeral
ἐλθὼν ἐς κλισίην Ἀγαμέμνονος Ἀτρεΐδαο	-- - uu- uu-uu -uu--	dactylic hexameter	masculine penthemimeral, trithemimeral
πάντα μάλ’ ἀτρεκέως ἀγορευέμεν ὡς ἐπιτέλλω·	-u u -uu- uu-uu - uu--	dactylic hexameter	masculine penthemimeral
θωρῆξαί ἑ κέλευε κάρη κομόωντας Ἀχαιοὺς	--- u u-u u- uu-u u--	dactylic hexameter	feminine penthemimeral, hepthemimeral, trithemimeral
πανσυδίῃ· νῦν γάρ κεν ἕλοι πόλιν εὐρυάγυιαν	-uu- - - u u- uu -uu--	dactylic hexameter	masculine penthemimeral, hepthemimeral, trithemimeral
Τρώων· οὐ γὰρ ἔτ’ ἀμφὶς Ὀλύμπια δώματ’ ἔχοντες	-- - u u -u u-uu -u u--	dactylic hexameter	feminine penthemimeral, trithemimeral
ἀθάνατοι φράζονται· ἐπέγναμψεν γὰρ ἅπαντας	-uu- --u u--- u u--	dactylic hexameter	feminine penthemimeral, trithemimeral
Ἥρη λισσομένη, Τρώεσσι δὲ κήδε’ ἐφῆπται.	-- -uu- --u u -u u--	dactylic hexameter	masculine penthemimeral
Ὣς φάτο, βῆ δ’ἄρ’ ὄνειρος ἐπεὶ τὸν μῦθον ἄκουσε·	- uu - u u-u u- - -u u--	dactylic hexameter	feminine penthemimeral, hepthemimeral, trithemimeral
καρπαλίμως δ’ἵκανε θοὰς ἐπὶ νῆας Ἀχαιῶν,	-uu- --u u- uu -u u--	dactylic hexameter	feminine penthemimeral, hepthemimeral, trithemimeral
βῆ δ’ἄρ’ ἐπ’ Ἀτρεΐδην Ἀγαμέμνονα· τὸν δὲ κίχανεν	- u u -uu- uu-uu - u u--	dactylic hexameter	masculine penthemimeral
εὕδοντ’ ἐν κλισίῃ, περὶ δ’ἀμβρόσιος κέχυθ’ ὕπνος.	-- - uu- uu -uu- uu --	dactylic hexameter	masculine penthemimeral, trithemimeral
Στῆ δ’ἄρ’ ὑπὲρ κεφαλῆς Νηληΐῳ υἷι ἐοικώς	- u u- uu- --uu -u u--	dactylic hexameter	masculine penthemimeral, trithemimeral
Νέστορι, τόν ῥα μάλιστα γερόντων τῖ’ Ἀγαμέμνων·	-uu - u u-u u-- - uu--	dactylic hexameter	feminine penthemimeral, trithemimeral
τῷ μιν ἐεισάμενος προσεφώνεε θεῖος ὄνειρος·	- u u-uu- uu-uu -u u--	dactylic hexameter	masculine penthemimeral
εὕδεις Ἀτρέος υἱὲ δαΐφρονος ἱπποδάμοιο·	-- -uu -u u-uu -uu--	dactylic hexameter	feminine penthemimeral
οὐ χρὴ παννύχιον εὕδειν βουληφόρον ἄνδρα	- - -uu- -- --uu --	dactylic hexameter	masculine penthemimeral, hepthemimeral
ᾧ λαοί τ’ἐπιτετράφαται καὶ τόσσα μέμηλε·	- -- uu-uu- - -u u--	dactylic hexameter	hepthemimeral, trithemimeral
νῦν δ’ἐμέθεν ξύνες ὦκα· Διὸς δέ τοι ἄγγελός εἰμι,	- uu- uu -u u- u u -uu --	dactylic hexameter	feminine penthemimeral, hepthemimeral, trithemimeral
ὃς σεῦ ἄνευθεν ἐὼν μέγα κήδεται ἠδ’ ἐλεαίρει.	- u u-u u- uu -uu - uu--	dactylic hexameter	masculine penthemimeral
Θωρῆξαί σε κέλευσε κάρη κομόωντας Ἀχαιοὺς	--- u u-u u- uu-u u--	dactylic hexameter	feminine penthemimeral, hepthemimeral, trithemimeral
πανσυδίῃ· νῦν γάρ κεν ἕλοις πόλιν εὐρυάγυιαν	-uu- - - u u- uu -uu--	dactylic hexameter	masculine penthemimeral, hepthemimeral, trithemimeral
Τρώων· οὐ γὰρ ἔτ’ ἀμφὶς Ὀλύμπια δώματ’ ἔχοντες	-- - u u -u u-uu -u u--	dactylic hexameter	feminine penthemimeral, trithemimeral
ἀθάνατοι φράζονται· ἐπέγναμψεν γὰρ ἅπαντας	-uu- --u u--- u u--	dactylic hexameter	feminine penthemimeral, trithemimeral
Ἥρη λισσομένη, Τρώεσσι δὲ κήδε’ ἐφῆπται	-- -uu- --u u -u u--	dactylic hexameter	masculine penthemimeral
ἐκ Διός· ἀλλὰ σὺ σῇσιν ἔχε φρεσί, μηδέ σε λήθη	- uu -u u -u u- uu -u u --	dactylic hexameter	feminine penthemimeral, hepthemimeral
αἱρείτω εὖτ’ ἄν σε μελίφρων ὕπνος ἀνήῃ.	--- - - u u-- -u u--	dactylic hexameter	masculine penthemimeral, trithemimeral
Ὣς ἄρα φωνήσας ἀπεβήσετο, τὸν δὲ λίπ’ αὐτοῦ	- uu --- uu-uu - u u --	dactylic hexameter	masculine penthemimeral
τὰ φρονέοντ’ ἀνὰ θυμὸν ἅ ῥ’οὐ τελέεσθαι ἔμελλον·	- uu- uu -u u - uu-u u--	dactylic hexameter	feminine penthemimeral, hepthemimeral, trithemimeral
φῆ γὰρ ὅ γ’αἱρήσειν Πριάμου πόλιν ἤματι κείνῳ	- u u --- uu- uu -uu --	dactylic hexameter	masculine penthemimeral, hepthemimeral
νήπιος, οὐδὲ τὰ ᾔδη ἅ ῥα Ζεὺς μήδετο ἔργα·	-uu -u u -u u - - -uu --	dactylic hexameter	feminine penthemimeral, hepthemimeral
θήσειν γὰρ ἔτ’ ἔμελλεν ἐπ’ ἄλγεά τε στοναχάς τε	-- - u u-u u -uu - uu- -	dactylic hexameter	feminine penthemimeral, trithemimeral
Τρωσί τε καὶ Δαναοῖσι διὰ κρατερὰς ὑσμίνας.	-u u - uu-u u- uu- ---	dactylic hexameter	feminine penthemimeral, hepthemimeral, trithemimeral
Ἔγρετο δ’ἐξ ὕπνου, θείη δέ μιν ἀμφέχυτ’ ὀμφή·	-uu - -- -- u u -uu --	dactylic hexameter	masculine penthemimeral, hepthemimeral, trithemimeral
ἕζετο δ’ὀρθωθείς, μαλακὸν δ’ἔνδυνε χιτῶνα	-uu --- uu- --u u--	dactylic hexameter	masculine penthemimeral, hepthemimeral
καλὸν νηγάτεον, περὶ δὲ μέγα βάλλετο φᾶρος·	-- -uu- uu - uu -uu --	dactylic hexameter	masculine penthemimeral, hepthemimeral
ποσσὶ δ’ὑπὸ λιπαροῖσιν ἐδήσατο καλὰ πέδιλα,	-u u- uu-u u-uu -u u--	dactylic hexameter	feminine penthemimeral, trithemimeral
ἀμφὶ δ’ἄρ’ ὤμοισιν βάλετο ξίφος ἀργυρόηλον·	-u u --- uu- uu -uu--	dactylic hexameter	masculine penthemimeral, hepthemimeral
εἵλετο δὲ σκῆπτρον πατρώϊον ἄφθιτον αἰεὶ	-uu - -- --uu -uu --	dactylic hexameter	masculine penthemimeral, trithemimeral
σὺν τῷ ἔβη κατὰ νῆας Ἀχαιῶν χαλκοχιτώνων·	- u u- uu -u u-- -uu--	dactylic hexameter	feminine penthemimeral, trithemimeral
ἠὼς μέν ῥα θεὰ προσεβήσετο μακρὸν Ὄλυμπον	-- - u u- uu-uu -u u--	dactylic hexameter	masculine penthemimeral, trithemimeral
Ζηνὶ φόως ἐρέουσα καὶ ἄλλοις ἀθανάτοισιν·	-u u- uu-u u -- -uu--	dactylic hexameter	feminine penthemimeral, trithemimeral
αὐτὰρ ὃ κηρύκεσσι λιγυφθόγγοισι κέλευσε	-u u ---u u---u u--	dactylic hexameter	feminine penthemimeral
κηρύσσειν ἀγορὴν δὲ κάρη κομόωντας Ἀχαιούς·	--- uu- u u- uu-u u--	dactylic hexameter	masculine penthemimeral, hepthemimeral, trithemimeral
οἳ μὲν ἐκήρυσσον, τοὶ δ’ἠγείροντο μάλ’ ὦκα·	- u u--- - ---u u --	dactylic hexameter	masculine penthemimeral
βουλὴν δὲ πρῶτον μεγαθύμων ἷζε γερόντων	-- - -- uu-- -u u--	dactylic hexameter	masculine penthemimeral, trithemimeral
Νεστορέῃ παρὰ νηῒ Πυλοιγενέος βασιλῆος·	-uu- uu -u u-uu- uu--	dactylic hexameter	feminine penthemimeral, trithemimeral
τοὺς ὅ γε συγκαλέσας πυκινὴν ἀρτύνετο βουλήν·	- u u -uu- uu- --uu --	dactylic hexameter	masculine penthemimeral, hepthemimeral
κλῦτε φίλοι· θεῖός μοι ἐνύπνιον ἦλθεν ὄνειρος	-u u- -- u u-uu -u u--	dactylic hexameter	masculine penthemimeral, trithemimeral
ἀμβροσίην διὰ νύκτα· μάλιστα δὲ Νέστορι δίῳ	-uu- uu -u u-u u -uu --	dactylic hexameter	feminine penthemimeral, trithemimeral
εἶδός τε μέγεθός τε φυήν τ’ἄγχιστα ἐῴκει·	-- - uu- u u- --u u--	dactylic hexameter	masculine penthemimeral, hepthemimeral, trithemimeral
στῆ δ’ἄρ’ ὑπὲρ κεφαλῆς καί με πρὸς μῦθον ἔειπεν·	- u u- uu- - - - -u u--	dactylic hexameter	masculine penthemimeral, hepthemimeral, trithemimeral
εὕδεις Ἀτρέος υἱὲ δαΐφρονος ἱπποδάμοιο·	-- -uu -u u-uu -uu--	dactylic hexameter	feminine penthemimeral
οὐ χρὴ παννύχιον εὕδειν βουληφόρον ἄνδρα,	- - -uu- -- --uu --	dactylic hexameter	masculine penthemimeral, hepthemimeral
ᾧ λαοί τ’ἐπιτετράφαται καὶ τόσσα μέμηλε·	- -- uu-uu- - -u u--	dactylic hexameter	hepthemimeral, trithemimeral
νῦν δ’ἐμέθεν ξύνες ὦκα· Διὸς δέ τοι ἄγγελός εἰμι,	- uu- uu -u u- u u -uu --	dactylic hexameter	feminine penthemimeral, hepthemimeral, trithemimeral
ὃς σεῦ ἄνευθεν ἐὼν μέγα κήδεται ἠδ’ ἐλεαίρει·	- u u-u u- uu -uu - uu--	dactylic hexameter	masculine penthemimeral
θωρῆξαί σε κέλευσε κάρη κομόωντας Ἀχαιοὺς	--- u u-u u- uu-u u--	dactylic hexameter	feminine penthemimeral, hepthemimeral, trithemimeral
πανσυδίῃ· νῦν γάρ κεν ἕλοις πόλιν εὐρυάγυιαν	-uu- - - u u- uu -uu--	dactylic hexameter	masculine penthemimeral, hepthemimeral, trithemimeral
Τρώων· οὐ γὰρ ἔτ’ ἀμφὶς Ὀλύμπια δώματ’ ἔχοντες	-- - u u -u u-uu -u u--	dactylic hexameter	feminine penthemimeral, trithemimeral
ἀθάνατοι φράζονται· ἐπέγναμψεν γὰρ ἅπαντας	-uu- --u u--- u u--	dactylic hexameter	feminine penthemimeral, trithemimeral
Ἥρη λισσομένη, Τρώεσσι δὲ κήδε’ ἐφῆπται	-- -uu- --u u -u u--	dactylic hexameter	masculine penthemimeral
ἐκ Διός· ἀλλὰ σὺ σῇσιν ἔχε φρεσίν· ὣς ὃ μὲν εἰπὼν	- uu -u u -u u- uu - u u --	dactylic hexameter	feminine penthemimeral, hepthemimeral
ᾤχετ’ ἀποπτάμενος, ἐμὲ δὲ γλυκὺς ὕπνος ἀνῆκεν.	-u u-uu- uu - uu -u u--	dactylic hexameter	masculine penthemimeral, hepthemimeral
Ἀλλ’ ἄγετ’ αἴ κέν πως θωρήξομεν υἷας Ἀχαιῶν·	- uu - - - --uu -u u--	dactylic hexameter	masculine penthemimeral, trithemimeral
πρῶτα δ’ἐγὼν ἔπεσιν πειρήσομαι, ἣ θέμις ἐστί,	-u u- uu- --uu - uu --	dactylic hexameter	masculine penthemimeral, trithemimeral
καὶ φεύγειν σὺν νηυσὶ πολυκλήϊσι κελεύσω·	- -- - -u u---u u--	dactylic hexameter	feminine penthemimeral, trithemimeral
ὑμεῖς δ’ἄλλοθεν ἄλλος ἐρητύειν ἐπέεσσιν.	-- -uu -u u--- uu--	dactylic hexameter	feminine penthemimeral
Ἤτοι ὅ γ’ὣς εἰπὼν κατ’ ἄρ’ ἕζετο, τοῖσι δ’ἀνέστη	-u u - -- u u -uu -u u--	dactylic hexameter	masculine penthemimeral, trithemimeral
Νέστωρ, ὅς ῥα Πύλοιο ἄναξ ἦν ἠμαθόεντος,	-- - u u-u u- - -uu--	dactylic hexameter	feminine penthemimeral, hepthemimeral, trithemimeral
ὅ σφιν ἐὺ φρονέων ἀγορήσατο καὶ μετέειπεν·	- u u- uu- uu-uu - uu--	dactylic hexameter	masculine penthemimeral, trithemimeral
ὦ φίλοι Ἀργείων ἡγήτορες ἠδὲ μέδοντες	- uu --- --uu -u u--	dactylic hexameter	masculine penthemimeral
εἰ μέν τις τὸν ὄνειρον Ἀχαιῶν ἄλλος ἔνισπε	- - - u u-u u-- -u u--	dactylic hexameter	feminine penthemimeral, trithemimeral
ψεῦδός κεν φαῖμεν καὶ νοσφιζοίμεθα μᾶλλον·	-- - -- - ---uu --	dactylic hexameter	masculine penthemimeral, trithemimeral
νῦν δ’ἴδεν ὃς μέγ’ ἄριστος Ἀχαιῶν εὔχεται εἶναι·	- uu - u u-u u-- -uu --	dactylic hexameter	feminine penthemimeral, trithemimeral
ἀλλ’ ἄγετ’ αἴ κέν πως θωρήξομεν υἷας Ἀχαιῶν.	- uu - - - --uu -u u--	dactylic hexameter	masculine penthemimeral, trithemimeral
Ὣς ἄρα φωνήσας βουλῆς ἐξῆρχε νέεσθαι,	- uu --- -- --u u--	dactylic hexameter	masculine penthemimeral, hepthemimeral
οἳ δ’ἐπανέστησαν πείθοντό τε ποιμένι λαῶν	- uu--- --u u -uu --	dactylic hexameter	masculine penthemimeral
σκηπτοῦχοι βασιλῆες· ἐπεσσεύοντο δὲ λαοί.	--- uu-u u---u u --	dactylic hexameter	feminine penthemimeral, trithemimeral
Ἠΰτε ἔθνεα εἶσι μελισσάων ἁδινάων	-uu -uu -u u--- uu--	dactylic hexameter	feminine penthemimeral
πέτρης ἐκ γλαφυρῆς αἰεὶ νέον ἐρχομενάων,	-- - uu- -- uu -uu--	dactylic hexameter	masculine penthemimeral, hepthemimeral, trithemimeral
βοτρυδὸν δὲ πέτονται ἐπ’ ἄνθεσιν εἰαρινοῖσιν·	--- u u-u u -uu -uu--	dactylic hexameter	feminine penthemimeral, trithemimeral
αἳ μέν τ’ἔνθα ἅλις πεποτήαται, αἳ δέ τε ἔνθα·	- - -u u- uu-uu - u u --	dactylic hexameter	masculine penthemimeral
ὣς τῶν ἔθνεα πολλὰ νεῶν ἄπο καὶ κλισιάων	- - -uu -u u- uu - uu--	dactylic hexameter	feminine penthemimeral, hepthemimeral
ἠϊόνος προπάροιθε βαθείης ἐστιχόωντο	-uu- uu-u u-- -uu--	dactylic hexameter	feminine penthemimeral, trithemimeral
ἰλαδὸν εἰς ἀγορήν· μετὰ δέ σφισιν ὄσσα δεδήει	-uu - uu- uu - uu -u u--	dactylic hexameter	masculine penthemimeral, hepthemimeral, trithemimeral
ὀτρύνουσ’ ἰέναι Διὸς ἄγγελος· οἳ δ’ἀγέροντο.	--- uu- uu -uu - uu--	dactylic hexameter	masculine penthemimeral, trithemimeral
Τετρήχει δ’ἀγορή, ὑπὸ δὲ στεναχίζετο γαῖα	--- uu- uu - uu-uu --	dactylic hexameter	masculine penthemimeral, hepthemimeral, trithemimeral
λαῶν ἱζόντων, ὅμαδος δ’ἦν· ἐννέα δέ σφεας	-- --- uu- - -uu - -	dactylic hexameter	masculine penthemimeral, hepthemimeral
κήρυκες βοόωντες ἐρήτυον, εἴ ποτ’ ἀϋτῆς	--- uu-u u-uu - u u--	dactylic hexameter	feminine penthemimeral, trithemimeral
σχοίατ’, ἀκούσειαν δὲ διοτρεφέων βασιλήων.	-u u--- u u-uu- uu--	dactylic hexameter	masculine penthemimeral
Σπουδῇ δ’ἕζετο λαός, ἐρήτυθεν δὲ καθ’ ἕδρας	-- -uu -u u--- u u --	dactylic hexameter	feminine penthemimeral
παυσάμενοι κλαγγῆς· ἀνὰ δὲ κρείων Ἀγαμέμνων	-uu- -- uu - -- uu--	dactylic hexameter	masculine penthemimeral, hepthemimeral, trithemimeral
ἔστη σκῆπτρον ἔχων τὸ μὲν Ἥφαιστος κάμε τεύχων.	-- -u u- u u --- uu --	dactylic hexameter	masculine penthemimeral
Ἥφαιστος μὲν δῶκε Διὶ Κρονίωνι ἄνακτι,	--- - -u u- uu-u u--	dactylic hexameter	feminine penthemimeral, hepthemimeral, trithemimeral
αὐτὰρ ἄρα Ζεὺς δῶκε διακτόρῳ ἀργεϊφόντῃ·	-u u- - -u u-uu -uu--	dactylic hexameter	feminine penthemimeral, trithemimeral
Ἑρμείας δὲ ἄναξ δῶκεν Πέλοπι πληξίππῳ,	--- u u- -- uu- ---	dactylic hexameter	masculine penthemimeral, hepthemimeral, trithemimeral
αὐτὰρ ὃ αὖτε Πέλοψ δῶκ’ Ἀτρέϊ ποιμένι λαῶν,	-u u -u u- - -uu -uu --	dactylic hexameter	masculine penthemimeral
Ἀτρεὺς δὲ θνῄσκων ἔλιπεν πολύαρνι Θυέστῃ,	-- - -- uu- uu-u u--	dactylic hexameter	masculine penthemimeral, hepthemimeral, trithemimeral
αὐτὰρ ὃ αὖτε Θυέστ’ Ἀγαμέμνονι λεῖπε φορῆναι,	-u u -u u- uu-uu -u u--	dactylic hexameter	masculine penthemimeral
πολλῇσιν νήσοισι καὶ Ἄργεϊ παντὶ ἀνάσσειν.	--- --u u -uu -u u--	dactylic hexameter	feminine penthemimeral, trithemimeral
Τῷ ὅ γ’ἐρεισάμενος ἔπε’ Ἀργείοισι μετηύδα·	- u u-uu- uu ---u u--	dactylic hexameter	masculine penthemimeral
ὦ φίλοι ἥρωες Δαναοὶ θεράποντες Ἄρηος	- uu --- uu- uu-u u--	dactylic hexameter	masculine penthemimeral, hepthemimeral
Ζεύς με μέγα Κρονίδης ἄτῃ ἐνέδησε βαρείῃ,	- u u- uu- -- uu-u u--	dactylic hexameter	masculine penthemimeral, hepthemimeral, trithemimeral
σχέτλιος, ὃς πρὶν μέν μοι ὑπέσχετο καὶ κατένευσεν	-uu - - - u u-uu - uu--	dactylic hexameter	masculine penthemimeral, trithemimeral
Ἴλιον ἐκπέρσαντ’ εὐτείχεον ἀπονέεσθαι,	-uu --- --uu -uu--	dactylic hexameter	masculine penthemimeral
νῦν δὲ κακὴν ἀπάτην βουλεύσατο, καί με κελεύει	- u u- uu- --uu - u u--	dactylic hexameter	masculine penthemimeral, trithemimeral
δυσκλέα Ἄργος ἱκέσθαι, ἐπεὶ πολὺν ὤλεσα λαόν.	-uu -u u-u u- uu -uu --	dactylic hexameter	feminine penthemimeral, hepthemimeral
Οὕτω που Διὶ μέλλει ὑπερμενέϊ φίλον εἶναι,	-- - uu -u u-uu- uu --	dactylic hexameter	feminine penthemimeral, trithemimeral
ὃς δὴ πολλάων πολίων κατέλυσε κάρηνα	- - --- uu- uu-u u--	dactylic hexameter	masculine penthemimeral, hepthemimeral
ἠδ’ ἔτι καὶ λύσει· τοῦ γὰρ κράτος ἐστὶ μέγιστον.	- uu - -- - - uu -u u--	dactylic hexameter	masculine penthemimeral, hepthemimeral, trithemimeral
Αἰσχρὸν γὰρ τόδε γ’ἐστὶ καὶ ἐσσομένοισι πυθέσθαι	-- - uu -u u -uu-u u--	dactylic hexameter	feminine penthemimeral, trithemimeral
μὰψ οὕτω τοιόνδε τοσόνδε τε λαὸν Ἀχαιῶν	- -- --u u-u u -u u--	dactylic hexameter	feminine penthemimeral, trithemimeral
ἄπρηκτον πόλεμον πολεμίζειν ἠδὲ μάχεσθαι	--- uu- uu-- -u u--	dactylic hexameter	masculine penthemimeral, trithemimeral
ἀνδράσι παυροτέροισι, τέλος δ’οὔ πώ τι πέφανται·	-uu -uu-u u- - - u u--	dactylic hexameter	feminine penthemimeral, hepthemimeral
εἴ περ γάρ κ’ἐθέλοιμεν Ἀχαιοί τε Τρῶές τε	- - - uu-u u-- - -- -	dactylic hexameter	feminine penthemimeral, trithemimeral
ὅρκια πιστὰ ταμόντες ἀριθμηθήμεναι ἄμφω,	-uu -u u-u u---uu --	dactylic hexameter	feminine penthemimeral
Τρῶας μὲν λέξασθαι ἐφέστιοι ὅσσοι ἔασιν,	-- - --u u-uu -u u--	dactylic hexameter	feminine penthemimeral, trithemimeral
ἡμεῖς δ’ἐς δεκάδας διακοσμηθεῖμεν Ἀχαιοί,	-- - uu- uu---u u--	dactylic hexameter	masculine penthemimeral, trithemimeral
Τρώων δ’ἄνδρα ἕκαστοι ἑλοίμεθα οἰνοχοεύειν,	-- -u u-u u-uu -uu--	dactylic hexameter	feminine penthemimeral
πολλαί κεν δεκάδες δευοίατο οἰνοχόοιο.	-- - uu- --uu -uu--	dactylic hexameter	masculine penthemimeral, trithemimeral
Τόσσον ἐγώ φημι πλέας ἔμμεναι υἷας Ἀχαιῶν	-u u- -- uu -uu -u u--	dactylic hexameter	masculine penthemimeral, trithemimeral
Τρώων, οἳ ναίουσι κατὰ πτόλιν· ἀλλ’ ἐπίκουροι	-- - --u u- uu - uu--	dactylic hexameter	feminine penthemimeral, hepthemimeral, trithemimeral
πολλέων ἐκ πολίων ἐγχέσπαλοι ἄνδρες ἔασιν,	-- - uu- --uu -u u--	dactylic hexameter	masculine penthemimeral, trithemimeral
οἵ με μέγα πλάζουσι καὶ οὐκ εἰῶσ’ ἐθέλοντα	- u u- --u u - -- uu--	dactylic hexameter	feminine penthemimeral, hepthemimeral, trithemimeral
Ἰλίου ἐκπέρσαι εὖ ναιόμενον πτολίεθρον.	-uu --- - -uu- uu--	dactylic hexameter	masculine penthemimeral
Ἐννέα δὴ βεβάασι Διὸς μεγάλου ἐνιαυτοί,	-uu - uu-u u- uu- uu--	dactylic hexameter	feminine penthemimeral, hepthemimeral, trithemimeral
καὶ δὴ δοῦρα σέσηπε νεῶν καὶ σπάρτα λέλυνται·	- - -u u-u u- - -u u--	dactylic hexameter	feminine penthemimeral, hepthemimeral
αἳ δέ που ἡμέτεραί τ’ἄλοχοι καὶ νήπια τέκνα	- u u -uu- uu- - -uu --	dactylic hexameter	masculine penthemimeral, hepthemimeral
εἵατ’ ἐνὶ μεγάροις ποτιδέγμεναι· ἄμμι δὲ ἔργον	-u u- uu- uu-uu -u u --	dactylic hexameter	masculine penthemimeral, trithemimeral
αὔτως ἀκράαντον οὗ εἵνεκα δεῦρ’ ἱκόμεσθα.	-- ---u u -uu - uu--	dactylic hexameter	feminine penthemimeral
Ἀλλ’ ἄγεθ’ ὡς ἂν ἐγὼ εἴπω πειθώμεθα πάντες·	- uu - u u- -- --uu --	dactylic hexameter	masculine penthemimeral, hepthemimeral, trithemimeral
φεύγωμεν σὺν νηυσὶ φίλην ἐς πατρίδα γαῖαν·	--- - -u u- - -uu --	dactylic hexameter	feminine penthemimeral, hepthemimeral, trithemimeral
οὐ γὰρ ἔτι Τροίην αἱρήσομεν εὐρυάγυιαν.	- u u- -- --uu -uu--	dactylic hexameter	masculine penthemimeral, trithemimeral
Ὣς φάτο, τοῖσι δὲ θυμὸν ἐνὶ στήθεσσιν ὄρινε	- uu -u u -u u- --u u--	dactylic hexameter	feminine penthemimeral, hepthemimeral
πᾶσι μετὰ πληθὺν ὅσοι οὐ βουλῆς ἐπάκουσαν·	-u u- -- uu - -- uu--	dactylic hexameter	masculine penthemimeral, hepthemimeral, trithemimeral
κινήθη δ’ἀγορὴ φὴ κύματα μακρὰ θαλάσσης	--- uu- - -uu -u u--	dactylic hexameter	masculine penthemimeral, trithemimeral
πόντου Ἰκαρίοιο, τὰ μέν τ’Εὖρός τε Νότος τε	-- -uu-u u - -- u u- -	dactylic hexameter	feminine penthemimeral, hepthemimeral
ὤρορ’ ἐπαΐξας πατρὸς Διὸς ἐκ νεφελάων.	-u u--- -- uu - uu--	dactylic hexameter	masculine penthemimeral, hepthemimeral
Ὡς δ’ὅτε κινήσῃ Ζέφυρος βαθὺ λήϊον ἐλθὼν	- uu --- uu- uu -uu --	dactylic hexameter	masculine penthemimeral, hepthemimeral
λάβρος ἐπαιγίζων, ἐπί τ’ἠμύει ἀσταχύεσσιν,	-u u--- uu -uu -uu--	dactylic hexameter	masculine penthemimeral
ὣς τῶν πᾶσ’ ἀγορὴ κινήθη· τοὶ δ’ἀλαλητῷ	- - - uu- --- - uu--	dactylic hexameter	masculine penthemimeral, trithemimeral
νῆας ἔπ’ ἐσσεύοντο, ποδῶν δ’ὑπένερθε κονίη	-u u ---u u- uu-u u--	dactylic hexameter	feminine penthemimeral, hepthemimeral
ἵστατ’ ἀειρομένη· τοὶ δ’ἀλλήλοισι κέλευον	-u u-uu- - ---u u--	dactylic hexameter	masculine penthemimeral
ἅπτεσθαι νηῶν ἠδ’ ἑλκέμεν εἰς ἅλα δῖαν,	--- -- - -uu - uu --	dactylic hexameter	masculine penthemimeral, trithemimeral
οὐρούς τ’ἐξεκάθαιρον· ἀϋτὴ δ’οὐρανὸν ἷκεν	-- -uu-u u-- -uu --	dactylic hexameter	feminine penthemimeral
οἴκαδε ἱεμένων· ὑπὸ δ’ᾕρεον ἕρματα νηῶν.	-uu -uu- uu -uu -uu --	dactylic hexameter	masculine penthemimeral
Ἔνθά κεν Ἀργείοισιν ὑπέρμορα νόστος ἐτύχθη	-u u ---u u-uu -u u--	dactylic hexameter	feminine penthemimeral
εἰ μὴ Ἀθηναίην Ἥρη πρὸς μῦθον ἔειπεν·	- u u--- -- - -u u--	dactylic hexameter	masculine penthemimeral, hepthemimeral
ὢ πόποι αἰγιόχοιο Διὸς τέκος Ἀτρυτώνη,	- uu -uu-u u- uu ----	dactylic hexameter	feminine penthemimeral, hepthemimeral
οὕτω δὴ οἶκον δὲ φίλην ἐς πατρίδα γαῖαν	-- - -- u u- - -uu --	dactylic hexameter	masculine penthemimeral, hepthemimeral, trithemimeral
Ἀργεῖοι φεύξονται ἐπ’ εὐρέα νῶτα θαλάσσης,	--- --u u -uu -u u--	dactylic hexameter	feminine penthemimeral, trithemimeral
κὰδ δέ κεν εὐχωλὴν Πριάμῳ καὶ Τρωσὶ λίποιεν	- u u --- uu- - -u u--	dactylic hexameter	masculine penthemimeral, hepthemimeral
Ἀργείην Ἑλένην, ἧς εἵνεκα πολλοὶ Ἀχαιῶν	--- uu- - -uu -u u--	dactylic hexameter	masculine penthemimeral, trithemimeral
ἐν Τροίῃ ἀπόλοντο φίλης ἀπὸ πατρίδος αἴης·	- -- uu-u u- uu -uu --	dactylic hexameter	feminine penthemimeral, hepthemimeral, trithemimeral
ἀλλ’ ἴθι νῦν κατὰ λαὸν Ἀχαιῶν χαλκοχιτώνων·	- uu - uu -u u-- -uu--	dactylic hexameter	feminine penthemimeral, trithemimeral
σοῖς ἀγανοῖς ἐπέεσσιν ἐρήτυε φῶτα ἕκαστον,	- uu- uu-u u-uu -u u--	dactylic hexameter	feminine penthemimeral, trithemimeral
μηδὲ ἔα νῆας ἅλα δ’ἑλκέμεν ἀμφιελίσσας.	-u u- -- uu -uu -uu--	dactylic hexameter	masculine penthemimeral, trithemimeral
Ὣς ἔφατ’, οὐδ’ ἀπίθησε θεὰ γλαυκῶπις Ἀθήνη,	- uu - uu-u u- --u u--	dactylic hexameter	feminine penthemimeral, hepthemimeral, trithemimeral
βῆ δὲ κατ’ Οὐλύμποιο καρήνων ἀΐξασα·	- u u ---u u-- ----	dactylic hexameter	feminine penthemimeral
καρπαλίμως δ’ἵκανε θοὰς ἐπὶ νῆας Ἀχαιῶν.	-uu- --u u- uu -u u--	dactylic hexameter	feminine penthemimeral, hepthemimeral, trithemimeral
Εὗρεν ἔπειτ’ Ὀδυσῆα Διὶ μῆτιν ἀτάλαντον	-u u- uu-u u- -- uu--	dactylic hexameter	feminine penthemimeral, hepthemimeral, trithemimeral
ἑσταότ’· οὐδ’ ὅ γε νηὸς ἐϋσσέλμοιο μελαίνης	-uu - u u -u u---u u--	dactylic hexameter	feminine penthemimeral, trithemimeral
ἅπτετ’, ἐπεί μιν ἄχος κραδίην καὶ θυμὸν ἵκανεν·	-u u- u u- uu- - -u u--	dactylic hexameter	masculine penthemimeral, hepthemimeral, trithemimeral
ἀγχοῦ δ’ἱσταμένη προσέφη γλαυκῶπις Ἀθήνη·	-- -uu- uu- --u u--	dactylic hexameter	masculine penthemimeral, hepthemimeral
διογενὲς Λαερτιάδη πολυμήχαν’ Ὀδυσσεῦ,	-uu- --uu- uu-u u--	dactylic hexameter	hepthemimeral, trithemimeral
οὕτω δὴ οἶκον δὲ φίλην ἐς πατρίδα γαῖαν	-- - -- u u- - -uu --	dactylic hexameter	masculine penthemimeral, hepthemimeral, trithemimeral
φεύξεσθ’ ἐν νήεσσι πολυκλήϊσι πεσόντες,	-- - --u u---u u--	dactylic hexameter	feminine penthemimeral, trithemimeral
κὰδ δέ κεν εὐχωλὴν Πριάμῳ καὶ Τρωσὶ λίποιτε	- u u --- uu- - -u u--	dactylic hexameter	masculine penthemimeral, hepthemimeral
Ἀργείην Ἑλένην, ἧς εἵνεκα πολλοὶ Ἀχαιῶν	--- uu- - -uu -u u--	dactylic hexameter	masculine penthemimeral, trithemimeral
ἐν Τροίῃ ἀπόλοντο φίλης ἀπὸ πατρίδος αἴης;	- -- uu-u u- uu -uu --	dactylic hexameter	feminine penthemimeral, hepthemimeral, trithemimeral
ἀλλ’ ἴθι νῦν κατὰ λαὸν Ἀχαιῶν, μηδ’ ἔτ’ ἐρώει,	- uu - uu -u u-- - u u--	dactylic hexameter	feminine penthemimeral, trithemimeral
σοῖς δ’ἀγανοῖς ἐπέεσσιν ἐρήτυε φῶτα ἕκαστον,	- uu- uu-u u-uu -u u--	dactylic hexameter	feminine penthemimeral, trithemimeral
μηδὲ ἔα νῆας ἅλα δ’ἑλκέμεν ἀμφιελίσσας.	-u u- -- uu -uu -uu--	dactylic hexameter	masculine penthemimeral, trithemimeral
Ὣς φάθ’, ὃ δὲ ξυνέηκε θεᾶς ὄπα φωνησάσης,	- u u - uu-u u- uu ----	dactylic hexameter	feminine penthemimeral, hepthemimeral, trithemimeral
βῆ δὲ θέειν, ἀπὸ δὲ χλαῖναν βάλε· τὴν δὲ κόμισσε	- u u- uu - -- uu - u u--	dactylic hexameter	masculine penthemimeral, hepthemimeral, trithemimeral
κῆρυξ Εὐρυβάτης Ἰθακήσιος ὅς οἱ ὀπήδει·	-- -uu- uu-uu - u u--	dactylic hexameter	masculine penthemimeral
αὐτὸς δ’Ἀτρεΐδεω Ἀγαμέμνονος ἀντίος ἐλθὼν	-- -uu- uu-uu -uu --	dactylic hexameter	masculine penthemimeral
δέξατό οἱ σκῆπτρον πατρώϊον ἄφθιτον αἰεί·	-uu - -- --uu -uu --	dactylic hexameter	masculine penthemimeral, trithemimeral
σὺν τῷ ἔβη κατὰ νῆας Ἀχαιῶν χαλκοχιτώνων.	- u u- uu -u u-- -uu--	dactylic hexameter	feminine penthemimeral, trithemimeral
Ὅν τινα μὲν βασιλῆα καὶ ἔξοχον ἄνδρα κιχείη	- uu - uu-u u -uu -u u--	dactylic hexameter	feminine penthemimeral, trithemimeral
τὸν δ’ἀγανοῖς ἐπέεσσιν ἐρητύσασκε παραστάς·	- uu- uu-u u---u u--	dactylic hexameter	feminine penthemimeral, trithemimeral
δαιμόνι’ οὔ σε ἔοικε κακὸν ὣς δειδίσσεσθαι,	-uu - u u-u u- - ----	dactylic hexameter	feminine penthemimeral, hepthemimeral, trithemimeral
ἀλλ’ αὐτός τε κάθησο καὶ ἄλλους ἵδρυε λαούς·	- -- u u-u u -- -uu --	dactylic hexameter	feminine penthemimeral, trithemimeral
οὐ γάρ πω σάφα οἶσθ’ οἷος νόος Ἀτρεΐωνος·	- - - uu - -- uu -uu--	dactylic hexameter	masculine penthemimeral, hepthemimeral, trithemimeral
νῦν μὲν πειρᾶται, τάχα δ’ἴψεται υἷας Ἀχαιῶν.	- - --- uu -uu -u u--	dactylic hexameter	masculine penthemimeral
Ἐν βουλῇ δ’οὐ πάντες ἀκούσαμεν οἷον ἔειπε.	- -- - -u u-uu -u u--	dactylic hexameter	feminine penthemimeral, trithemimeral
μή τι χολωσάμενος ῥέξῃ κακὸν υἷας Ἀχαιῶν·	- u u-uu- -- uu -u u--	dactylic hexameter	masculine penthemimeral, hepthemimeral
θυμὸς δὲ μέγας ἐστὶ διοτρεφέων βασιλήων,	-- - uu -u u-uu- uu--	dactylic hexameter	feminine penthemimeral, trithemimeral
τιμὴ δ’ἐκ Διός ἐστι, φιλεῖ δέ ἑ μητίετα Ζεύς.	-- - uu -u u- u u -uu- -	dactylic hexameter	feminine penthemimeral, hepthemimeral, trithemimeral
Ὃν δ’αὖ δήμου τ’ἄνδρα ἴδοι βοόωντά τ’ἐφεύροι,	- - -- -u u- uu-u u--	dactylic hexameter	feminine penthemimeral, hepthemimeral
τὸν σκήπτρῳ ἐλάσασκεν ὁμοκλήσασκέ τε μύθῳ·	- -- uu-u u---u u --	dactylic hexameter	feminine penthemimeral, trithemimeral
δαιμόνι’ ἀτρέμας ἧσο καὶ ἄλλων μῦθον ἄκουε,	-uu -uu -u u -- -u u--	dactylic hexameter	feminine penthemimeral
οἳ σέο φέρτεροί εἰσι, σὺ δ’ἀπτόλεμος καὶ ἄναλκις	- uu -uu -u u -uu- u u--	dactylic hexameter	feminine penthemimeral
οὔτέ ποτ’ ἐν πολέμῳ ἐναρίθμιος οὔτ’ ἐνὶ βουλῇ·	-u u - uu- uu-uu - uu --	dactylic hexameter	masculine penthemimeral, trithemimeral
οὐ μέν πως πάντες βασιλεύσομεν ἐνθάδ’ Ἀχαιοί·	- - - -- uu-uu -u u--	dactylic hexameter	masculine penthemimeral, trithemimeral
οὐκ ἀγαθὸν πολυκοιρανίη· εἷς κοίρανος ἔστω,	- uu- uu-uu- - -uu --	dactylic hexameter	hepthemimeral, trithemimeral
εἷς βασιλεύς, ᾧ δῶκε Κρόνου πάϊς ἀγκυλομήτεω	- uu- - -u u- uu -uu--	dactylic hexameter	feminine penthemimeral, hepthemimeral, trithemimeral
σκῆπτρόν τ’ἠδὲ θέμιστας, ἵνά σφισι βουλεύῃσι.	-- -u u-u u- uu ----	dactylic hexameter	feminine penthemimeral, hepthemimeral
Ὣς ὅ γε κοιρανέων δίεπε στρατόν· οἳ δ’ἀγορὴν δὲ	- u u -uu- uu- uu - uu- -	dactylic hexameter	masculine penthemimeral, hepthemimeral
αὖτις ἐπεσσεύοντο νεῶν ἄπο καὶ κλισιάων	-u u---u u- uu - uu--	dactylic hexameter	feminine penthemimeral, hepthemimeral
ἠχῇ, ὡς ὅτε κῦμα πολυφλοίσβοιο θαλάσσης	-- - uu -u u---u u--	dactylic hexameter	feminine penthemimeral, trithemimeral
αἰγιαλῷ μεγάλῳ βρέμεται, σμαραγεῖ δέ τε πόντος.	-uu- uu- uu- uu- u u --	dactylic hexameter	masculine penthemimeral, hepthemimeral, trithemimeral
Ἄλλοι μέν ῥ’ἕζοντο, ἐρήτυθεν δὲ καθ’ ἕδρας·	-- - --u u--- u u --	dactylic hexameter	feminine penthemimeral, trithemimeral
Θερσίτης δ’ἔτι μοῦνος ἀμετροεπὴς ἐκολῴα,	--- uu -u u-uu- uu--	dactylic hexameter	feminine penthemimeral, trithemimeral
ὃς ἔπεα φρεσὶν ᾗσιν ἄκοσμά τε πολλά τε ᾔδη	- uu- uu -u u-u u -u u --	dactylic hexameter	feminine penthemimeral, trithemimeral
μάψ, ἀτὰρ οὐ κατὰ κόσμον, ἐριζέμεναι βασιλεῦσιν,	- uu - uu -u u-uu- uu--	dactylic hexameter	feminine penthemimeral, trithemimeral
ἀλλ’ ὅ τι οἱ εἴσαιτο γελοίϊον Ἀργείοισιν	- u u - --u u-uu ----	dactylic hexameter	feminine penthemimeral, trithemimeral
ἔμμεναι· αἴσχιστος δὲ ἀνὴρ ὑπὸ Ἴλιον ἦλθε·	-uu --- u u- uu -uu --	dactylic hexameter	masculine penthemimeral, hepthemimeral
φολκὸς ἔην, χωλὸς δ’ἕτερον πόδα· τὼ δέ οἱ ὤμω	-u u- -- uu- uu - u u --	dactylic hexameter	masculine penthemimeral, hepthemimeral, trithemimeral
κυρτὼ ἐπὶ στῆθος συνοχωκότε· αὐτὰρ ὕπερθε	-u u- -- uu-uu -u u--	dactylic hexameter	masculine penthemimeral, trithemimeral
φοξὸς ἔην κεφαλήν, ψεδνὴ δ’ἐπενήνοθε λάχνη.	-u u- uu- -- uu-uu --	dactylic hexameter	masculine penthemimeral, hepthemimeral, trithemimeral
Ἔχθιστος δ’Ἀχιλῆϊ μάλιστ’ ἦν ἠδ’ Ὀδυσῆϊ·	--- uu-u u- - - uu--	dactylic hexameter	feminine penthemimeral, hepthemimeral, trithemimeral
τὼ γὰρ νεικείεσκε· τότ’ αὖτ’ Ἀγαμέμνονι δίῳ	- - ---u u - uu-uu --	dactylic hexameter	feminine penthemimeral, hepthemimeral
ὀξέα κεκλήγων λέγ’ ὀνείδεα· τῷ δ’ἄρ’ Ἀχαιοὶ	-uu --- u u-uu - u u--	dactylic hexameter	masculine penthemimeral
ἐκπάγλως κοτέοντο νεμέσσηθέν τ’ἐνὶ θυμῷ.	--- uu-u u--- uu --	dactylic hexameter	feminine penthemimeral, trithemimeral
Αὐτὰρ ὃ μακρὰ βοῶν Ἀγαμέμνονα νείκεε μύθῳ·	-u u -u u- uu-uu -uu --	dactylic hexameter	masculine penthemimeral
Ἀτρεΐδη τέο δ’αὖτ’ ἐπιμέμφεαι ἠδὲ χατίζεις;	-uu- uu - uu-uu -u u--	dactylic hexameter	masculine penthemimeral, trithemimeral
πλεῖαί τοι χαλκοῦ κλισίαι, πολλαὶ δὲ γυναῖκες	-- - -- uu- -- u u--	dactylic hexameter	masculine penthemimeral, hepthemimeral, trithemimeral
εἰσὶν ἐνὶ κλισίῃς ἐξαίρετοι, ἅς τοι Ἀχαιοὶ	-u u- uu- --uu - u u--	dactylic hexameter	masculine penthemimeral, trithemimeral
πρωτίστῳ δίδομεν εὖτ’ ἂν πτολίεθρον ἕλωμεν.	--- uu- - - uu-u u--	dactylic hexameter	masculine penthemimeral, hepthemimeral, trithemimeral
Ἦ ἔτι καὶ χρυσοῦ ἐπιδεύεαι, ὅν κέ τις οἴσει	- uu - -- uu-uu - u u --	dactylic hexameter	masculine penthemimeral, trithemimeral
Τρώων ἱπποδάμων ἐξ Ἰλίου υἷος ἄποινα,	-- -uu- - -uu -u u--	dactylic hexameter	masculine penthemimeral
ὅν κεν ἐγὼ δήσας ἀγάγω ἢ ἄλλος Ἀχαιῶν,	- u u- -- uu- - -u u--	dactylic hexameter	masculine penthemimeral, hepthemimeral, trithemimeral
ἠὲ γυναῖκα νέην, ἵνα μίσγεαι ἐν φιλότητι,	-u u-u u- uu -uu - uu--	dactylic hexameter	masculine penthemimeral
ἥν τ’αὐτὸς ἀπονόσφι κατίσχεαι; οὐ μὲν ἔοικεν	- -- uu-u u-uu - u u--	dactylic hexameter	feminine penthemimeral, trithemimeral
ἀρχὸν ἐόντα κακῶν ἐπιβασκέμεν υἷας Ἀχαιῶν.	-u u-u u- uu-uu -u u--	dactylic hexameter	masculine penthemimeral
Ὦ πέπονες κάκ’ ἐλέγχε’ Ἀχαιΐδες οὐκέτ’ Ἀχαιοὶ	- uu- u u-u u-uu -u u--	dactylic hexameter	feminine penthemimeral, trithemimeral
οἴκαδέ περ σὺν νηυσὶ νεώμεθα, τόνδε δ’ἐῶμεν	-uu - - -u u-uu -u u--	dactylic hexameter	feminine penthemimeral, trithemimeral
αὐτοῦ ἐνὶ Τροίῃ γέρα πεσσέμεν, ὄφρα ἴδηται	-u u- -- uu -uu -u u--	dactylic hexameter	masculine penthemimeral, trithemimeral
ἤ ῥά τί οἱ χἠμεῖς προσαμύνομεν ἦε καὶ οὐκί·	- u u - -- uu-uu -u u --	dactylic hexameter	masculine penthemimeral, trithemimeral
ὃς καὶ νῦν Ἀχιλῆα ἕο μέγ’ ἀμείνονα φῶτα	- - - uu-u u- u u-uu --	dactylic hexameter	feminine penthemimeral, hepthemimeral, trithemimeral
ἠτίμησεν· ἑλὼν γὰρ ἔχει γέρας αὐτὸς ἀπούρας.	---u u- u u- uu -u u--	dactylic hexameter	masculine penthemimeral, hepthemimeral
Ἀλλὰ μάλ’ οὐκ Ἀχιλῆϊ χόλος φρεσίν, ἀλλὰ μεθήμων·	-u u - uu-u u- uu -u u--	dactylic hexameter	feminine penthemimeral, hepthemimeral, trithemimeral
ἦ γὰρ ἂν Ἀτρεΐδη νῦν ὕστατα λωβήσαιο·	- u u -uu- - -uu ----	dactylic hexameter	masculine penthemimeral
ὣς φάτο νεικείων Ἀγαμέμνονα ποιμένα λαῶν,	- uu --- uu-uu -uu --	dactylic hexameter	masculine penthemimeral
Θερσίτης· τῷ δ’ὦκα παρίστατο δῖος Ὀδυσσεύς,	--- - -u u-uu -u u--	dactylic hexameter	feminine penthemimeral, trithemimeral
καί μιν ὑπόδρα ἰδὼν χαλεπῷ ἠνίπαπε μύθῳ·	- u u-u u- uu- --uu --	dactylic hexameter	masculine penthemimeral, hepthemimeral
Θερσῖτ’ ἀκριτόμυθε, λιγύς περ ἐὼν ἀγορητής,	-- -uu-u u- u u- uu--	dactylic hexameter	feminine penthemimeral, hepthemimeral
ἴσχεο, μηδ’ ἔθελ’ οἶος ἐριζέμεναι βασιλεῦσιν·	-uu - uu -u u-uu- uu--	dactylic hexameter	feminine penthemimeral, trithemimeral
οὐ γὰρ ἐγὼ σέο φημὶ χερειότερον βροτὸν ἄλλον	- u u- uu -u u-uu- uu --	dactylic hexameter	feminine penthemimeral, trithemimeral
ἔμμεναι, ὅσσοι ἅμ’ Ἀτρεΐδῃς ὑπὸ Ἴλιον ἦλθον.	-uu -u u -uu- uu -uu --	dactylic hexameter	hepthemimeral
Τὼ οὐκ ἂν βασιλῆας ἀνὰ στόμ’ ἔχων ἀγορεύοις,	- - - uu-u u- u u- uu--	dactylic hexameter	feminine penthemimeral, hepthemimeral, trithemimeral
καί σφιν ὀνείδεά τε προφέροις, νόστόν τε φυλάσσοις.	- u u-uu - uu- -- u u--	dactylic hexameter	masculine penthemimeral, hepthemimeral
Οὐδέ τί πω σάφα ἴδμεν ὅπως ἔσται τάδε ἔργα,	-u u - uu -u u- -- uu --	dactylic hexameter	feminine penthemimeral, hepthemimeral, trithemimeral
ἢ εὖ ἦε κακῶς νοστήσομεν υἷες Ἀχαιῶν.	- - -u u- --uu -u u--	dactylic hexameter	masculine penthemimeral
Τὼ νῦν Ἀτρεΐδῃ Ἀγαμέμνονι ποιμένι λαῶν	- - -uu- uu-uu -uu --	dactylic hexameter	masculine penthemimeral
ἧσαι ὀνειδίζων, ὅτι οἱ μάλα πολλὰ διδοῦσιν	-u u--- uu - uu -u u--	dactylic hexameter	masculine penthemimeral, hepthemimeral
ἥρωες Δαναοί· σὺ δὲ κερτομέων ἀγορεύεις.	--- uu- u u -uu- uu--	dactylic hexameter	masculine penthemimeral, trithemimeral
Ἀλλ’ ἔκ τοι ἐρέω, τὸ δὲ καὶ τετελεσμένον ἔσται·	- - - uu- u u - uu-uu --	dactylic hexameter	masculine penthemimeral, hepthemimeral, trithemimeral
εἴ κ’ἔτι σ’ἀφραίνοντα κιχήσομαι ὥς νύ περ ὧδε,	- uu ---u u-uu - u u --	dactylic hexameter	feminine penthemimeral
μηκέτ’ ἔπειτ’ Ὀδυσῆϊ κάρη ὤμοισιν ἐπείη,	-u u- uu-u u- --u u--	dactylic hexameter	feminine penthemimeral, hepthemimeral, trithemimeral
μηδ’ ἔτι Τηλεμάχοιο πατὴρ κεκλημένος εἴην,	- uu -uu-u u- --uu --	dactylic hexameter	feminine penthemimeral, hepthemimeral
εἰ μὴ ἐγώ σε λαβὼν ἀπὸ μὲν φίλα εἵματα δύσω,	- u u- u u- uu - uu -uu --	dactylic hexameter	masculine penthemimeral, hepthemimeral, trithemimeral
χλαῖνάν τ’ἠδὲ χιτῶνα, τά τ’αἰδῶ ἀμφικαλύπτει,	-- -u u-u u -- -uu--	dactylic hexameter	feminine penthemimeral
αὐτὸν δὲ κλαίοντα θοὰς ἐπὶ νῆας ἀφήσω	-- - --u u- uu -u u--	dactylic hexameter	feminine penthemimeral, hepthemimeral, trithemimeral
πεπλήγων ἀγορῆθεν ἀεικέσσι πληγῇσιν.	--- uu-u u--- ---	dactylic hexameter	feminine penthemimeral, trithemimeral
Ὣς ἄρ’ ἔφη, σκήπτρῳ δὲ μετάφρενον ἠδὲ καὶ ὤμω	- u u- -- u u-uu -u u --	dactylic hexameter	masculine penthemimeral, trithemimeral
πλῆξεν· ὃ δ’ἰδνώθη, θαλερὸν δέ οἱ ἔκπεσε δάκρυ·	-u u --- uu- u u -uu --	dactylic hexameter	masculine penthemimeral, hepthemimeral
σμῶδιξ δ’αἱματόεσσα μεταφρένου ἐξυπανέστη	-- -uu-u u-uu -uu--	dactylic hexameter	feminine penthemimeral
σκήπτρου ὕπο χρυσέου· ὃ δ’ἄρ’ ἕζετο τάρβησέν τε,	-u u- uu- u u -uu --- -	dactylic hexameter	masculine penthemimeral, trithemimeral
ἀλγήσας δ’ἀχρεῖον ἰδὼν ἀπομόρξατο δάκρυ.	--- --u u- uu-uu --	dactylic hexameter	feminine penthemimeral, hepthemimeral, trithemimeral
Οἳ δὲ καὶ ἀχνύμενοί περ ἐπ’ αὐτῷ ἡδὺ γέλασσαν·	- u u -uu- u u -- -u u--	dactylic hexameter	masculine penthemimeral
ὧδε δέ τις εἴπεσκεν ἰδὼν ἐς πλησίον ἄλλον·	-u u - --u u- - -uu --	dactylic hexameter	feminine penthemimeral, hepthemimeral, trithemimeral
ὢ πόποι ἦ δὴ μυρί’ Ὀδυσσεὺς ἐσθλὰ ἔοργε	- uu - - -u u-- -u u--	dactylic hexameter	feminine penthemimeral, trithemimeral
βουλάς τ’ἐξάρχων ἀγαθὰς πόλεμόν τε κορύσσων·	-- --- uu- uu- u u--	dactylic hexameter	masculine penthemimeral, hepthemimeral
νῦν δὲ τόδε μέγ’ ἄριστον ἐν Ἀργείοισιν ἔρεξεν,	- u u- u u-u u ---u u--	dactylic hexameter	feminine penthemimeral, trithemimeral
ὃς τὸν λωβητῆρα ἐπεσβόλον ἔσχ’ ἀγοράων.	- - ---u u-uu - uu--	dactylic hexameter	feminine penthemimeral
Οὔ θήν μιν πάλιν αὖτις ἀνήσει θυμὸς ἀγήνωρ	- - - uu -u u-- -u u--	dactylic hexameter	feminine penthemimeral, trithemimeral
νεικείειν βασιλῆας ὀνειδείοις ἐπέεσσιν.	--- uu-u u--- uu--	dactylic hexameter	feminine penthemimeral, trithemimeral
Ὣς φάσαν ἣ πληθύς· ἀνὰ δ’ὃ πτολίπορθος Ὀδυσσεὺς	- uu - -- uu - uu-u u--	dactylic hexameter	masculine penthemimeral, hepthemimeral, trithemimeral
ἔστη σκῆπτρον ἔχων· παρὰ δὲ γλαυκῶπις Ἀθήνη	-- -u u- uu - --u u--	dactylic hexameter	masculine penthemimeral, hepthemimeral
εἰδομένη κήρυκι σιωπᾶν λαὸν ἀνώγει,	-uu- --u u-- -u u--	dactylic hexameter	feminine penthemimeral, trithemimeral
ὡς ἅμα θ’οἳ πρῶτοί τε καὶ ὕστατοι υἷες Ἀχαιῶν	- uu - -- u u -uu -u u--	dactylic hexameter	masculine penthemimeral, trithemimeral
μῦθον ἀκούσειαν καὶ ἐπιφρασσαίατο βουλήν·	-u u--- u u---uu --	dactylic hexameter	masculine penthemimeral
ὅ σφιν ἐὺ φρονέων ἀγορήσατο καὶ μετέειπεν·	- u u- uu- uu-uu - uu--	dactylic hexameter	masculine penthemimeral, trithemimeral
Ἀτρεΐδη νῦν δή σε ἄναξ ἐθέλουσιν Ἀχαιοὶ	-uu- - - u u- uu-u u--	dactylic hexameter	masculine penthemimeral, hepthemimeral, trithemimeral
πᾶσιν ἐλέγχιστον θέμεναι μερόπεσσι βροτοῖσιν,	-u u--- uu- uu-u u--	dactylic hexameter	masculine penthemimeral, hepthemimeral
οὐδέ τοι ἐκτελέουσιν ὑπόσχεσιν ἥν περ ὑπέσταν	-u u -uu-u u-uu - u u--	dactylic hexameter	feminine penthemimeral
ἐνθάδ’ ἔτι στείχοντες ἀπ’ Ἄργεος ἱπποβότοιο	-u u- --u u -uu -uu--	dactylic hexameter	feminine penthemimeral, trithemimeral
Ἴλιον ἐκπέρσαντ’ εὐτείχεον ἀπονέεσθαι.	-uu --- --uu -uu--	dactylic hexameter	masculine penthemimeral
Ὥς τε γὰρ ἢ παῖδες νεαροὶ χῆραί τε γυναῖκες	- u u - -- uu- -- u u--	dactylic hexameter	masculine penthemimeral, hepthemimeral, trithemimeral
ἀλλήλοισιν ὀδύρονται οἶκον δὲ νέεσθαι.	---u u--- -- u u--	dactylic hexameter	hepthemimeral
Ἦ μὴν καὶ πόνος ἐστὶν ἀνιηθέντα νέεσθαι·	- - - uu -u u---u u--	dactylic hexameter	feminine penthemimeral, trithemimeral
καὶ γάρ τίς θ’ἕνα μῆνα μένων ἀπὸ ἧς ἀλόχοιο	- - - uu -u u- uu - uu--	dactylic hexameter	feminine penthemimeral, hepthemimeral, trithemimeral
ἀσχαλάᾳ σὺν νηῒ πολυζύγῳ, ὅν περ ἄελλαι	-uu- - -u u-uu - u u--	dactylic hexameter	feminine penthemimeral, trithemimeral
χειμέριαι εἰλέωσιν ὀρινομένη τε θάλασσα·	-uu- --u u-uu- u u--	dactylic hexameter	feminine penthemimeral, trithemimeral
ἡμῖν δ’εἴνατός ἐστι περιτροπέων ἐνιαυτὸς	-- -uu -u u-uu- uu--	dactylic hexameter	feminine penthemimeral
ἐνθάδε μιμνόντεσσι· τὼ οὐ νεμεσίζομ’ Ἀχαιοὺς	-uu ---u u - uu-u u--	dactylic hexameter	feminine penthemimeral, hepthemimeral
ἀσχαλάαν παρὰ νηυσὶ κορωνίσιν· ἀλλὰ καὶ ἔμπης	-uu- uu -u u-uu -u u --	dactylic hexameter	feminine penthemimeral, trithemimeral
αἰσχρόν τοι δηρόν τε μένειν κενεόν τε νέεσθαι.	-- - -- u u- uu- u u--	dactylic hexameter	masculine penthemimeral, hepthemimeral, trithemimeral
Τλῆτε φίλοι, καὶ μείνατ’ ἐπὶ χρόνον ὄφρα δαῶμεν	-u u- - -u u- uu -u u--	dactylic hexameter	feminine penthemimeral, hepthemimeral, trithemimeral
ἢ ἐτεὸν Κάλχας μαντεύεται ἦε καὶ οὐκί.	- uu- -- --uu -u u --	dactylic hexameter	masculine penthemimeral, trithemimeral
Εὖ γὰρ δὴ τόδε ἴδμεν ἐνὶ φρεσίν, ἐστὲ δὲ πάντες	- - - uu -u u- uu -u u --	dactylic hexameter	feminine penthemimeral, hepthemimeral, trithemimeral
μάρτυροι, οὓς μὴ κῆρες ἔβαν θανάτοιο φέρουσαι·	-uu - - -u u- uu-u u--	dactylic hexameter	feminine penthemimeral, hepthemimeral, trithemimeral
χθιζά τε καὶ πρωΐζ’ ὅτ’ ἐς Αὐλίδα νῆες Ἀχαιῶν	-u u - -- u u -uu -u u--	dactylic hexameter	masculine penthemimeral, trithemimeral
ἠγερέθοντο κακὰ Πριάμῳ καὶ Τρωσὶ φέρουσαι,	-uu-u u- uu- - -u u--	dactylic hexameter	masculine penthemimeral, hepthemimeral
ἡμεῖς δ’ἀμφὶ περὶ κρήνην ἱεροὺς κατὰ βωμοὺς	-- -u u- -- uu- uu --	dactylic hexameter	masculine penthemimeral, hepthemimeral
ἕρδομεν ἀθανάτοισι τεληέσσας ἑκατόμβας	-uu -uu-u u--- uu--	dactylic hexameter	feminine penthemimeral
καλῇ ὑπὸ πλατανίστῳ ὅθεν ῥέεν ἀγλαὸν ὕδωρ·	-u u- uu-u u- uu -uu --	dactylic hexameter	feminine penthemimeral, hepthemimeral, trithemimeral
ἔνθ’ ἐφάνη μέγα σῆμα· δράκων ἐπὶ νῶτα δαφοινὸς	- uu- uu -u u- uu -u u--	dactylic hexameter	feminine penthemimeral, hepthemimeral, trithemimeral
σμερδαλέος, τόν ῥ’αὐτὸς Ὀλύμπιος ἧκε φόως δέ,	-uu- - -u u-uu -u u- -	dactylic hexameter	feminine penthemimeral, trithemimeral
βωμοῦ ὑπαΐξας πρός ῥα πλατάνιστον ὄρουσεν.	-u u--- - - uu-u u--	dactylic hexameter	masculine penthemimeral, hepthemimeral
Ἔνθα δ’ἔσαν στρουθοῖο νεοσσοί, νήπια τέκνα,	-u u- --u u-- -uu --	dactylic hexameter	feminine penthemimeral, trithemimeral
ὄζῳ ἐπ’ ἀκροτάτῳ πετάλοις ὑποπεπτηῶτες	-u u -uu- uu- uu----	dactylic hexameter	masculine penthemimeral, hepthemimeral
ὀκτώ, ἀτὰρ μήτηρ ἐνάτη ἦν ἣ τέκε τέκνα·	-u u- -- uu- - - uu --	dactylic hexameter	masculine penthemimeral, hepthemimeral, trithemimeral
ἔνθ’ ὅ γε τοὺς ἐλεεινὰ κατήσθιε τετριγῶτας·	- u u - uu-u u-uu ----	dactylic hexameter	feminine penthemimeral, trithemimeral
μήτηρ δ’ἀμφεποτᾶτο ὀδυρομένη φίλα τέκνα·	-- -uu-u u-uu- uu --	dactylic hexameter	feminine penthemimeral
τὴν δ’ἐλελιξάμενος πτέρυγος λάβεν ἀμφιαχυῖαν.	- uu-uu- uu- uu -uu--	dactylic hexameter	masculine penthemimeral, hepthemimeral
Αὐτὰρ ἐπεὶ κατὰ τέκνα φάγε στρουθοῖο καὶ αὐτήν,	-u u- uu -u u- --u u --	dactylic hexameter	feminine penthemimeral, hepthemimeral, trithemimeral
τὸν μὲν ἀρίζηλον θῆκεν θεὸς ὅς περ ἔφηνε·	- u u--- -- uu - u u--	dactylic hexameter	masculine penthemimeral, hepthemimeral
λᾶαν γάρ μιν ἔθηκε Κρόνου πάϊς ἀγκυλομήτεω·	-- - u u-u u- uu -uu--	dactylic hexameter	feminine penthemimeral, hepthemimeral, trithemimeral
ἡμεῖς δ’ἑσταότες θαυμάζομεν οἷον ἐτύχθη.	-- -uu- --uu -u u--	dactylic hexameter	masculine penthemimeral
Ὡς οὖν δεινὰ πέλωρα θεῶν εἰσῆλθ’ ἑκατόμβας,	- - -u u-u u- -- uu--	dactylic hexameter	feminine penthemimeral, hepthemimeral
Κάλχας δ’αὐτίκ’ ἔπειτα θεοπροπέων ἀγόρευε·	-- -u u-u u-uu- uu--	dactylic hexameter	feminine penthemimeral
τίπτ’ ἄνεῳ ἐγένεσθε κάρη κομόωντες Ἀχαιοί;	- uu- uu-u u- uu-u u--	dactylic hexameter	feminine penthemimeral, hepthemimeral, trithemimeral
ἡμῖν μὲν τόδ’ ἔφηνε τέρας μέγα μητίετα Ζεὺς	-- - u u-u u- uu -uu- -	dactylic hexameter	feminine penthemimeral, hepthemimeral, trithemimeral
ὄψιμον ὀψιτέλεστον, ὅου κλέος οὔ ποτ’ ὀλεῖται.	-uu -uu-u u- uu - u u--	dactylic hexameter	feminine penthemimeral, hepthemimeral
Ὡς οὗτος κατὰ τέκνα φάγε στρουθοῖο καὶ αὐτὴν	- -- uu -u u- --u u --	dactylic hexameter	feminine penthemimeral, hepthemimeral, trithemimeral
ὀκτώ, ἀτὰρ μήτηρ ἐνάτη ἦν ἣ τέκε τέκνα,	-u u- -- uu- - - uu --	dactylic hexameter	masculine penthemimeral, hepthemimeral, trithemimeral
ὣς ἡμεῖς τοσσαῦτ’ ἔτεα πτολεμίξομεν αὖθι,	- -- -- uu- uu-uu --	dactylic hexameter	masculine penthemimeral, hepthemimeral, trithemimeral
τῷ δεκάτῳ δὲ πόλιν αἱρήσομεν εὐρυάγυιαν.	- uu- u u- --uu -uu--	dactylic hexameter	masculine penthemimeral, trithemimeral
Κεῖνος τὼς ἀγόρευε· τὰ δὴ νῦν πάντα τελεῖται.	-- - uu-u u - - -u u--	dactylic hexameter	feminine penthemimeral, hepthemimeral, trithemimeral
Ἀλλ’ ἄγε μίμνετε πάντες ἐϋκνήμιδες Ἀχαιοὶ	- uu -uu -u u---u u--	dactylic hexameter	feminine penthemimeral
αὐτοῦ εἰς ὅ κεν ἄστυ μέγα Πριάμοιο ἕλωμεν.	-- - u u -u u- uu-u u--	dactylic hexameter	feminine penthemimeral, hepthemimeral, trithemimeral
Ὣς ἔφατ’, Ἀργεῖοι δὲ μέγ’ ἴαχον, ἀμφὶ δὲ νῆες	- uu --- u u -uu -u u --	dactylic hexameter	masculine penthemimeral
σμερδαλέον κονάβησαν ἀϋσάντων ὑπ’ Ἀχαιῶν,	-uu- uu-u u--- u u--	dactylic hexameter	feminine penthemimeral, trithemimeral
μῦθον ἐπαινήσαντες Ὀδυσσῆος θείοιο·	-u u---u u--- ---	dactylic hexameter	feminine penthemimeral
τοῖσι δὲ καὶ μετέειπε Γερήνιος ἱππότα Νέστωρ·	-u u - uu-u u-uu -uu --	dactylic hexameter	feminine penthemimeral, trithemimeral
ὦ πόποι ἦ δὴ παισὶν ἐοικότες ἀγοράασθε	- uu - - -u u-uu -uu--	dactylic hexameter	feminine penthemimeral, trithemimeral
νηπιάχοις οἷς οὔ τι μέλει πολεμήϊα ἔργα.	-uu- - - u u- uu-uu --	dactylic hexameter	masculine penthemimeral, hepthemimeral, trithemimeral
Πῇ δὴ συνθεσίαι τε καὶ ὅρκια βήσεται ἥμιν;	- - -uu- u u -uu -uu --	dactylic hexameter	masculine penthemimeral
ἐν πυρὶ δὴ βουλαί τε γενοίατο μήδεά τ’ἀνδρῶν	- uu - -- u u-uu -uu --	dactylic hexameter	masculine penthemimeral, trithemimeral
σπονδαί τ’ἄκρητοι καὶ δεξιαί, ᾗς ἐπέπιθμεν·	-- --- - -uu - uu--	dactylic hexameter	masculine penthemimeral
αὔτως γὰρ ἐπέεσσ’ ἐριδαίνομεν, οὐδέ τι μῆχος	-- - uu- uu-uu -u u --	dactylic hexameter	masculine penthemimeral, trithemimeral
εὑρέμεναι δυνάμεσθα, πολὺν χρόνον ἐνθάδ’ ἐόντες.	-uu- uu-u u- uu -u u--	dactylic hexameter	feminine penthemimeral, hepthemimeral, trithemimeral
Ἀτρεΐδη σὺ δ’ἔθ’ ὡς πρὶν ἔχων ἀστεμφέα βουλὴν	-uu- u u - u u- --uu --	dactylic hexameter	masculine penthemimeral, hepthemimeral, trithemimeral
ἄρχευ’ Ἀργείοισι κατὰ κρατερὰς ὑσμίνας,	-- ---u u- uu- ---	dactylic hexameter	feminine penthemimeral, hepthemimeral
τούσδε δ’ἔα φθινύθειν ἕνα καὶ δύο, τοί κεν Ἀχαιῶν	-u u- uu- uu - uu - u u--	dactylic hexameter	masculine penthemimeral, hepthemimeral, trithemimeral
νόσφιν βουλεύωσ’· ἄνυσις δ’οὐκ ἔσσεται αὐτῶν·	-- --- uu- - -uu --	dactylic hexameter	masculine penthemimeral, hepthemimeral
πρὶν Ἄργος δ’ἰέναι πρὶν καὶ Διὸς αἰγιόχοιο	- -- uu- - - uu -uu--	dactylic hexameter	masculine penthemimeral, hepthemimeral, trithemimeral
γνώμεναι εἴ τε ψεῦδος ὑπόσχεσις εἴ τε καὶ οὐκί.	-uu - - -u u-uu - u u --	dactylic hexameter	feminine penthemimeral, trithemimeral
Φημὶ γὰρ οὖν κατανεῦσαι ὑπερμενέα Κρονίωνα	-u u - uu-u u-uu- uu--	dactylic hexameter	feminine penthemimeral, trithemimeral
ἤματι τῷ ὅτε νηυσὶν ἐν ὠκυπόροισιν ἔβαινον	-uu - uu -u u -uu-u u--	dactylic hexameter	feminine penthemimeral, trithemimeral
Ἀργεῖοι Τρώεσσι φόνον καὶ κῆρα φέροντες	--- --u u- - -u u--	dactylic hexameter	feminine penthemimeral, hepthemimeral, trithemimeral
ἀστράπτων ἐπιδέξι’ ἐναίσιμα σήματα φαίνων.	--- uu-u u-uu -uu --	dactylic hexameter	feminine penthemimeral, trithemimeral
Τὼ μή τις πρὶν ἐπειγέσθω οἶκον δὲ νέεσθαι	- - - u u--- -- u u--	dactylic hexameter	hepthemimeral, trithemimeral
πρίν τινα πὰρ Τρώων ἀλόχῳ κατακοιμηθῆναι,	- uu - -- uu- uu----	dactylic hexameter	masculine penthemimeral, hepthemimeral, trithemimeral
τίσασθαι δ’Ἑλένης ὁρμήματά τε στοναχάς τε.	--- uu- --uu - uu- -	dactylic hexameter	masculine penthemimeral, trithemimeral
Εἰ δέ τις ἐκπάγλως ἐθέλει οἶκον δὲ νέεσθαι	- u u --- uu- -- u u--	dactylic hexameter	masculine penthemimeral, hepthemimeral
ἁπτέσθω ἧς νηὸς ἐϋσσέλμοιο μελαίνης,	--- - -u u---u u--	dactylic hexameter	feminine penthemimeral, trithemimeral
ὄφρα πρόσθ’ ἄλλων θάνατον καὶ πότμον ἐπίσπῃ.	-- - -- uu- - -u u--	dactylic hexameter	masculine penthemimeral, hepthemimeral, trithemimeral
Ἀλλὰ ἄναξ αὐτός τ’εὖ μήδεο πείθεό τ’ἄλλῳ·	-u u- -- - -uu -uu --	dactylic hexameter	masculine penthemimeral, trithemimeral
οὔ τοι ἀπόβλητον ἔπος ἔσσεται ὅττί κεν εἴπω·	- u u--- uu -uu -u u --	dactylic hexameter	masculine penthemimeral
κρῖν’ ἄνδρας κατὰ φῦλα κατὰ φρήτρας Ἀγάμεμνον,	- -- uu -u u- -- uu--	dactylic hexameter	feminine penthemimeral, hepthemimeral, trithemimeral
ὡς φρήτρη φρήτρηφιν ἀρήγῃ, φῦλα δὲ φύλοις.	- -- --u u-- -u u --	dactylic hexameter	feminine penthemimeral, trithemimeral
Εἰ δέ κεν ὣς ἕρξῃς καί τοι πείθωνται Ἀχαιοί,	- u u - -- - - --u u--	dactylic hexameter	masculine penthemimeral, hepthemimeral, trithemimeral
γνώσῃ ἔπειθ’ ὅς θ’ἡγεμόνων κακὸς ὅς τέ νυ λαῶν	-u u- - -uu- uu - u u --	dactylic hexameter	hepthemimeral, trithemimeral
ἠδ’ ὅς κ’ἐσθλὸς ἔῃσι· κατὰ σφέας γὰρ μαχέονται.	- - -u u-u u- - - uu--	dactylic hexameter	feminine penthemimeral, hepthemimeral
Γνώσεαι δ’εἰ καὶ θεσπεσίῃ πόλιν οὐκ ἀλαπάξεις,	-- - - -uu- uu - uu--	dactylic hexameter	hepthemimeral, trithemimeral
ἦ ἀνδρῶν κακότητι καὶ ἀφραδίῃ πολέμοιο.	- -- uu-u u -uu- uu--	dactylic hexameter	feminine penthemimeral, trithemimeral
Τὸν δ’ἀπαμειβόμενος προσέφη κρείων Ἀγαμέμνων·	- uu-uu- uu- -- uu--	dactylic hexameter	masculine penthemimeral, hepthemimeral
ἦ μὰν αὖτ’ ἀγορῇ νικᾷς γέρον υἷας Ἀχαιῶν.	- - - uu- -- uu -u u--	dactylic hexameter	masculine penthemimeral, hepthemimeral, trithemimeral
Αἲ γὰρ Ζεῦ τε πάτερ καὶ Ἀθηναίη καὶ Ἄπολλον	- - - u u- u u--- u u--	dactylic hexameter	masculine penthemimeral, trithemimeral
τοιοῦτοι δέκα μοι συμφράδμονες εἶεν Ἀχαιῶν·	--- uu - --uu -u u--	dactylic hexameter	masculine penthemimeral, trithemimeral
τώ κε τάχ’ ἠμύσειε πόλις Πριάμοιο ἄνακτος	- u u ---u u- uu-u u--	dactylic hexameter	feminine penthemimeral, hepthemimeral
χερσὶν ὑφ’ ἡμετέρῃσιν ἁλοῦσά τε περθομένη τε.	-u u -uu-u u-u u -uu- -	dactylic hexameter	feminine penthemimeral
Ἀλλά μοι αἰγίοχος Κρονίδης Ζεὺς ἄλγε’ ἔδωκεν,	-u u -uu- uu- - -u u--	dactylic hexameter	masculine penthemimeral, hepthemimeral
ὅς με μετ’ ἀπρήκτους ἔριδας καὶ νείκεα βάλλει.	- u u --- uu- - -uu --	dactylic hexameter	masculine penthemimeral, hepthemimeral
Καὶ γὰρ ἐγὼν Ἀχιλεύς τε μαχεσσάμεθ’ εἵνεκα κούρης	- u u- uu- u u-uu -uu --	dactylic hexameter	masculine penthemimeral, trithemimeral
ἀντιβίοις ἐπέεσσιν, ἐγὼ δ’ἦρχον χαλεπαίνων·	-uu- uu-u u- -- uu--	dactylic hexameter	feminine penthemimeral, hepthemimeral, trithemimeral
εἰ δέ ποτ’ ἔς γε μίαν βουλεύσομεν, οὐκέτ’ ἔπειτα	- u u - u u- --uu -u u--	dactylic hexameter	masculine penthemimeral, trithemimeral
Τρωσὶν ἀνάβλησις κακοῦ ἔσσεται οὐδ’ ἠβαιόν.	-u u--- uu -uu - ---	dactylic hexameter	masculine penthemimeral
Νῦν δ’ἔρχεσθ’ ἐπὶ δεῖπνον ἵνα ξυνάγωμεν Ἄρηα.	- -- uu -u u- uu-u u--	dactylic hexameter	feminine penthemimeral, hepthemimeral, trithemimeral
Εὖ μέν τις δόρυ θηξάσθω, εὖ δ’ἀσπίδα θέσθω,	- - - uu --- - -uu --	dactylic hexameter	hepthemimeral, trithemimeral
εὖ δέ τις ἵπποισιν δεῖπνον δότω ὠκυπόδεσσιν,	- u u --- -- uu -uu--	dactylic hexameter	masculine penthemimeral, hepthemimeral
εὖ δέ τις ἅρματος ἀμφὶς ἰδὼν πολέμοιο μεδέσθω,	- u u -uu -u u- uu-u u--	dactylic hexameter	feminine penthemimeral, hepthemimeral
ὥς κε πανημέριοι στυγερῷ κρινώμεθ’ Ἄρηϊ.	- u u-uu- uu- --u u--	dactylic hexameter	masculine penthemimeral, hepthemimeral
Οὐ γὰρ παυσωλή γε μετέσσεται οὐδ’ ἠβαιὸν	- - --- u u-uu - ---	dactylic hexameter	masculine penthemimeral
εἰ μὴ νὺξ ἐλθοῦσα διακρινέει μένος ἀνδρῶν.	- - - --u u-uu- uu --	dactylic hexameter	feminine penthemimeral, trithemimeral
Ἱδρώσει μέν τευ τελαμὼν ἀμφὶ στήθεσφιν	--- - - uu- -- ---	dactylic hexameter	masculine penthemimeral, hepthemimeral, trithemimeral
ἀσπίδος ἀμφιβρότης, περὶ δ’ἔγχεϊ χεῖρα καμεῖται·	-uu -uu- uu -uu -u u--	dactylic hexameter	masculine penthemimeral
ἱδρώσει δέ τευ ἵππος ἐΰξοον ἅρμα τιταίνων.	--- u u -u u-uu -u u--	dactylic hexameter	feminine penthemimeral, trithemimeral
Ὃν δέ κ’ἐγὼν ἀπάνευθε μάχης ἐθέλοντα νοήσω	- u u- uu-u u- uu-u u--	dactylic hexameter	feminine penthemimeral, hepthemimeral, trithemimeral
μιμνάζειν παρὰ νηυσὶ κορωνίσιν, οὔ οἱ ἔπειτα	--- uu -u u-uu - u u--	dactylic hexameter	feminine penthemimeral, trithemimeral
ἄρκιον ἐσσεῖται φυγέειν κύνας ἠδ’ οἰωνούς.	-uu --- uu- uu - ---	dactylic hexameter	masculine penthemimeral, hepthemimeral
Ὣς ἔφατ’, Ἀργεῖοι δὲ μέγ’ ἴαχον ὡς ὅτε κῦμα	- uu --- u u -uu - uu --	dactylic hexameter	masculine penthemimeral
ἀκτῇ ἐφ’ ὑψηλῇ, ὅτε κινήσῃ Νότος ἐλθών,	-u u --- uu --- uu --	dactylic hexameter	masculine penthemimeral
προβλῆτι σκοπέλῳ· τὸν δ’οὔ ποτε κύματα λείπει	--- uu- - - uu -uu --	dactylic hexameter	masculine penthemimeral, hepthemimeral, trithemimeral
παντοίων ἀνέμων, ὅτ’ ἂν ἔνθ’ ἢ ἔνθα γένωνται.	--- uu- u u - - -u u--	dactylic hexameter	masculine penthemimeral, hepthemimeral, trithemimeral
Ἀνστάντες δ’ὀρέοντο κεδασθέντες κατὰ νῆας,	--- uu-u u--- uu --	dactylic hexameter	feminine penthemimeral, trithemimeral
κάπνισσάν τε κατὰ κλισίας, καὶ δεῖπνον ἕλοντο.	--- u u- uu- - -u u--	dactylic hexameter	masculine penthemimeral, hepthemimeral, trithemimeral
Ἄλλος δ’ἄλλῳ ἔρεζε θεῶν αἰειγενετάων	-- -u u-u u- --uu--	dactylic hexameter	feminine penthemimeral, hepthemimeral
εὐχόμενος θάνατόν τε φυγεῖν καὶ μῶλον Ἄρηος.	-uu- uu- u u- - -u u--	dactylic hexameter	masculine penthemimeral, hepthemimeral, trithemimeral
Αὐτὰρ ὃ βοῦν ἱέρευσε ἄναξ ἀνδρῶν Ἀγαμέμνων	-u u - uu-u u- -- uu--	dactylic hexameter	feminine penthemimeral, hepthemimeral, trithemimeral
πίονα πενταέτηρον ὑπερμενέϊ Κρονίωνι,	-uu -uu-u u-uu- uu--	dactylic hexameter	feminine penthemimeral
κίκλησκεν δὲ γέροντας ἀριστῆας Παναχαιῶν,	--- u u-u u--- uu--	dactylic hexameter	feminine penthemimeral, trithemimeral
Νέστορα μὲν πρώτιστα καὶ Ἰδομενῆα ἄνακτα,	-uu - --u u -uu-u u--	dactylic hexameter	feminine penthemimeral, trithemimeral
αὐτὰρ ἔπειτ’ Αἴαντε δύω καὶ Τυδέος υἱόν,	-u u- --u u- - -uu --	dactylic hexameter	feminine penthemimeral, hepthemimeral, trithemimeral
ἕκτον δ’αὖτ’ Ὀδυσῆα Διὶ μῆτιν ἀτάλαντον.	-- - uu-u u- -- uu--	dactylic hexameter	feminine penthemimeral, hepthemimeral, trithemimeral
Αὐτόματος δέ οἱ ἦλθε βοὴν ἀγαθὸς Μενέλαος·	-uu- u u -u u- uu- uu--	dactylic hexameter	feminine penthemimeral, hepthemimeral, trithemimeral
ᾔδεε γὰρ κατὰ θυμὸν ἀδελφεὸν ὡς ἐπονεῖτο.	-uu - uu -u u-uu - uu--	dactylic hexameter	feminine penthemimeral, trithemimeral
Βοῦν δὲ περιστήσαντο καὶ οὐλοχύτας ἀνέλοντο·	- u u---u u -uu- uu--	dactylic hexameter	feminine penthemimeral
τοῖσιν δ’εὐχόμενος μετέφη κρείων Ἀγαμέμνων·	-- -uu- uu- -- uu--	dactylic hexameter	masculine penthemimeral, hepthemimeral
Ζεῦ κύδιστε μέγιστε κελαινεφὲς αἰθέρι ναίων	- --u u-u u-uu -uu --	dactylic hexameter	feminine penthemimeral
μὴ πρὶν ἐπ’ ἠέλιον δῦναι καὶ ἐπὶ κνέφας ἐλθεῖν	- u u -uu- -- u u- uu --	dactylic hexameter	masculine penthemimeral, hepthemimeral
πρίν με κατὰ πρηνὲς βαλέειν Πριάμοιο μέλαθρον	- u u- -- uu- uu-u u--	dactylic hexameter	masculine penthemimeral, hepthemimeral, trithemimeral
αἰθαλόεν, πρῆσαι δὲ πυρὸς δηίοιο θύρετρα,	-uu- -- u u- --u u--	dactylic hexameter	masculine penthemimeral, hepthemimeral, trithemimeral
Ἑκτόρεον δὲ χιτῶνα περὶ στήθεσσι δαΐξαι	-uu- u u-u u- --u u--	dactylic hexameter	feminine penthemimeral, hepthemimeral, trithemimeral
χαλκῷ ῥωγαλέον· πολέες δ’ἀμφ’ αὐτὸν ἑταῖροι	-- -uu- uu- - -u u--	dactylic hexameter	masculine penthemimeral, hepthemimeral
πρηνέες ἐν κονίῃσιν ὀδὰξ λαζοίατο γαῖαν.	-uu - uu-u u- --uu --	dactylic hexameter	feminine penthemimeral, hepthemimeral, trithemimeral
Ὣς ἔφατ’, οὐδ’ ἄρα πώ οἱ ἐπεκραίαινε Κρονίων,	- uu - uu - u u---u u--	dactylic hexameter	masculine penthemimeral, trithemimeral
ἀλλ’ ὅ γε δέκτο μὲν ἱρά, πόνον δ’ἀμέγαρτον ὄφελλεν.	- u u -u u -u u- uu-u u--	dactylic hexameter	feminine penthemimeral, hepthemimeral
Αὐτὰρ ἐπεί ῥ’εὔξαντο καὶ οὐλοχύτας προβάλοντο,	-u u- --u u -uu- uu--	dactylic hexameter	feminine penthemimeral, trithemimeral
αὐέρυσαν μὲν πρῶτα καὶ ἔσφαξαν καὶ ἔδειραν,	-uu- - -u u --- u u--	dactylic hexameter	feminine penthemimeral, trithemimeral
μηρούς τ’ἐξέταμον κατά τε κνίσῃ ἐκάλυψαν	-- -uu- uu - -- uu--	dactylic hexameter	masculine penthemimeral, hepthemimeral
δίπτυχα ποιήσαντες, ἐπ’ αὐτῶν δ’ὠμοθέτησαν.	-uu ---u u -- -uu--	dactylic hexameter	feminine penthemimeral
Καὶ τὰ μὲν ἂρ σχίζῃσιν ἀφύλλοισιν κατέκαιον,	- u u - --u u--- uu--	dactylic hexameter	feminine penthemimeral, trithemimeral
σπλάγχνα δ’ἄρ’ ἀμπείραντες ὑπείρεχον Ἡφαίστοιο.	-u u ---u u-uu ----	dactylic hexameter	feminine penthemimeral
Αὐτὰρ ἐπεὶ κατὰ μῆρε κάη καὶ σπλάγχνα πάσαντο,	-u u- uu -u u- - -u u--	dactylic hexameter	feminine penthemimeral, hepthemimeral, trithemimeral
μίστυλλόν τ’ἄρα τἆλλα καὶ ἀμφ’ ὀβελοῖσιν ἔπειραν,	--- uu -u u - uu-u u--	dactylic hexameter	feminine penthemimeral, hepthemimeral, trithemimeral
ὤπτησάν τε περιφραδέως, ἐρύσαντό τε πάντα.	--- u u-uu- uu-u u --	dactylic hexameter	hepthemimeral, trithemimeral
Αὐτὰρ ἐπεὶ παύσαντο πόνου τετύκοντό τε δαῖτα	-u u- --u u- uu-u u --	dactylic hexameter	feminine penthemimeral, hepthemimeral, trithemimeral
δαίνυντ’, οὐδέ τι θυμὸς ἐδεύετο δαιτὸς ἐΐσης.	-- -u u -u u-uu -u u--	dactylic hexameter	feminine penthemimeral
Αὐτὰρ ἐπεὶ πόσιος καὶ ἐδητύος ἐξ ἔρον ἕντο,	-u u- uu- u u-uu - uu --	dactylic hexameter	masculine penthemimeral, trithemimeral
τοῖς ἄρα μύθων ἦρχε Γερήνιος ἱππότα Νέστωρ·	- uu -- -u u-uu -uu --	dactylic hexameter	feminine penthemimeral
Ἀτρεΐδη κύδιστε ἄναξ ἀνδρῶν Ἀγάμεμνον,	-uu- --u u- -- uu--	dactylic hexameter	feminine penthemimeral, hepthemimeral, trithemimeral
μηκέτι νῦν δήθ’ αὖθι λεγώμεθα, μηδ’ ἔτι δηρὸν	-uu - - -u u-uu - uu --	dactylic hexameter	feminine penthemimeral, trithemimeral
ἀμβαλλώμεθα ἔργον ὃ δὴ θεὸς ἐγγυαλίζει.	---uu -u u - uu -uu--	dactylic hexameter	feminine penthemimeral, hepthemimeral
Ἀλλ’ ἄγε κήρυκες μὲν Ἀχαιῶν χαλκοχιτώνων	- uu --- u u-- -uu--	dactylic hexameter	masculine penthemimeral
λαὸν κηρύσσοντες ἀγειρόντων κατὰ νῆας,	-- ---u u--- uu --	dactylic hexameter	feminine penthemimeral
ἡμεῖς δ’ἀθρόοι ὧδε κατὰ στρατὸν εὐρὺν Ἀχαιῶν	-- -uu -u u- uu -u u--	dactylic hexameter	feminine penthemimeral, hepthemimeral
ἴομεν ὄφρα κε θᾶσσον ἐγείρομεν ὀξὺν Ἄρηα.	-uu -u u -u u-uu -u u--	dactylic hexameter	feminine penthemimeral
Ὣς ἔφατ’, οὐδ’ ἀπίθησεν ἄναξ ἀνδρῶν Ἀγαμέμνων.	- uu - uu-u u- -- uu--	dactylic hexameter	feminine penthemimeral, hepthemimeral, trithemimeral
Αὐτίκα κηρύκεσσι λιγυφθόγγοισι κέλευσε	-uu ---u u---u u--	dactylic hexameter	feminine penthemimeral
κηρύσσειν πόλεμον δὲ κάρη κομόωντας Ἀχαιούς·	--- uu- u u- uu-u u--	dactylic hexameter	masculine penthemimeral, hepthemimeral, trithemimeral
οἳ μὲν ἐκήρυσσον, τοὶ δ’ἠγείροντο μάλ’ ὦκα.	- u u--- - ---u u --	dactylic hexameter	masculine penthemimeral
Οἳ δ’ἀμφ’ Ἀτρεΐωνα διοτρεφέες βασιλῆες	- - -uu-u u-uu- uu--	dactylic hexameter	feminine penthemimeral
θῦνον κρίνοντες, μετὰ δὲ γλαυκῶπις Ἀθήνη	-- --- uu - --u u--	dactylic hexameter	masculine penthemimeral, hepthemimeral
αἰγίδ’ ἔχουσ’ ἐρίτιμον ἀγήρων ἀθανάτην τε,	-u u- uu-u u-- -uu- -	dactylic hexameter	feminine penthemimeral, trithemimeral
τῆς ἑκατὸν θύσανοι παγχρύσεοι ἠερέθονται,	- uu- uu- --uu -uu--	dactylic hexameter	masculine penthemimeral, trithemimeral
πάντες ἐϋπλεκέες, ἑκατόμβοιος δὲ ἕκαστος·	-u u-uu- uu--- u u--	dactylic hexameter	masculine penthemimeral
σὺν τῇ παιφάσσουσα διέσσυτο λαὸν Ἀχαιῶν	- - ---u u-uu -u u--	dactylic hexameter	feminine penthemimeral
ὀτρύνουσ’ ἰέναι· ἐν δὲ σθένος ὦρσεν ἑκάστῳ	--- uu- - - uu -u u--	dactylic hexameter	masculine penthemimeral, hepthemimeral, trithemimeral
καρδίῃ ἄλληκτον πολεμίζειν ἠδὲ μάχεσθαι.	-uu --- uu-- -u u--	dactylic hexameter	masculine penthemimeral
Τοῖσι δ’ἄφαρ πόλεμος γλυκίων γένετ’ ἠὲ νέεσθαι	-u u- uu- uu- uu -u u--	dactylic hexameter	masculine penthemimeral, hepthemimeral, trithemimeral
ἐν νηυσὶ γλαφυρῇσι φίλην ἐς πατρίδα γαῖαν.	- -- uu-u u- - -uu --	dactylic hexameter	feminine penthemimeral, hepthemimeral, trithemimeral
Ἠΰτε πῦρ ἀΐδηλον ἐπιφλέγει ἄσπετον ὕλην	-uu - uu-u u-uu -uu --	dactylic hexameter	feminine penthemimeral, trithemimeral
οὔρεος ἐν κορυφῇς, ἕκαθεν δέ τε φαίνεται αὐγή,	-uu - uu- uu- u u -uu --	dactylic hexameter	masculine penthemimeral, hepthemimeral, trithemimeral
ὣς τῶν ἐρχομένων ἀπὸ χαλκοῦ θεσπεσίοιο	- - -uu- uu -- -uu--	dactylic hexameter	masculine penthemimeral
αἴγλη παμφανόωσα δι’ αἰθέρος οὐρανὸν ἷκε.	-- -uu-u u -uu -uu --	dactylic hexameter	feminine penthemimeral
Τῶν δ’ὥς τ’ὀρνίθων πετεηνῶν ἔθνεα πολλὰ	- - --- uu-- -uu --	dactylic hexameter	masculine penthemimeral
χηνῶν ἢ γεράνων ἢ κύκνων δουλιχοδείρων	-- - uu- - -- -uu--	dactylic hexameter	masculine penthemimeral, trithemimeral
Ἀσίω ἐν λειμῶνι Καϋστρίου ἀμφὶ ῥέεθρα	-uu - --u u-uu -u u--	dactylic hexameter	feminine penthemimeral, trithemimeral
ἔνθα καὶ ἔνθα ποτῶνται ἀγαλλόμενα πτερύγεσσι	-u u -u u-u u-uu- uu--	dactylic hexameter	feminine penthemimeral
κλαγγηδὸν προκαθιζόντων, σμαραγεῖ δέ τε λειμών,	--- uu--- uu- u u --	dactylic hexameter	hepthemimeral, trithemimeral
ὣς τῶν ἔθνεα πολλὰ νεῶν ἄπο καὶ κλισιάων	- - -uu -u u- uu - uu--	dactylic hexameter	feminine penthemimeral, hepthemimeral
ἐς πεδίον προχέοντο Σκαμάνδριον· αὐτὰρ ὑπὸ χθὼν	- uu- uu-u u-uu -u u- -	dactylic hexameter	feminine penthemimeral, trithemimeral
σμερδαλέον κονάβιζε ποδῶν αὐτῶν τε καὶ ἵππων.	-uu- uu-u u- -- u u --	dactylic hexameter	feminine penthemimeral, hepthemimeral, trithemimeral
Ἔσταν δ’ἐν λειμῶνι Σκαμανδρίῳ ἀνθεμόεντι	-- - --u u-uu -uu--	dactylic hexameter	feminine penthemimeral, trithemimeral
μυρίοι, ὅσσά τε φύλλα καὶ ἄνθεα γίγνεται ὥρῃ.	-uu -u u -u u -uu -uu --	dactylic hexameter	feminine penthemimeral
Ἠΰτε μυιάων ἁδινάων ἔθνεα πολλὰ	-uu --- uu-- -uu --	dactylic hexameter	masculine penthemimeral
αἵ τε κατὰ σταθμὸν ποιμνήϊον ἠλάσκουσιν	- u u- -- --uu ----	dactylic hexameter	masculine penthemimeral, trithemimeral
ὥρῃ ἐν εἰαρινῇ ὅτε τε γλάγος ἄγγεα δεύει,	-u u -uu- uu - uu -uu --	dactylic hexameter	masculine penthemimeral, hepthemimeral
τόσσοι ἐπὶ Τρώεσσι κάρη κομόωντες Ἀχαιοὶ	-u u- --u u- uu-u u--	dactylic hexameter	feminine penthemimeral, hepthemimeral, trithemimeral
ἐν πεδίῳ ἵσταντο διαρραῖσαι μεμαῶτες.	- uu- --u u--- uu--	dactylic hexameter	feminine penthemimeral, trithemimeral
Τοὺς δ’ὥς τ’αἰπόλια πλατέ’ αἰγῶν αἰπόλοι ἄνδρες	- - -uu- uu -- -uu --	dactylic hexameter	masculine penthemimeral
ῥεῖα διακρίνωσιν ἐπεί κε νομῷ μιγέωσιν,	-u u---u u- u u- uu--	dactylic hexameter	feminine penthemimeral, hepthemimeral
ὣς τοὺς ἡγεμόνες διεκόσμεον ἔνθα καὶ ἔνθα	- - -uu- uu-uu -u u --	dactylic hexameter	masculine penthemimeral
ὑσμίνην δ’ἰέναι, μετὰ δὲ κρείων Ἀγαμέμνων	--- uu- uu - -- uu--	dactylic hexameter	masculine penthemimeral, hepthemimeral, trithemimeral
ὄμματα καὶ κεφαλὴν ἴκελος Διὶ τερπικεραύνῳ,	-uu - uu- uu- uu -uu--	dactylic hexameter	masculine penthemimeral, hepthemimeral, trithemimeral
Ἄρεϊ δὲ ζώνην, στέρνον δὲ Ποσειδάωνι.	-uu - -- -- u u----	dactylic hexameter	masculine penthemimeral, hepthemimeral, trithemimeral
Ἠΰτε βοῦς ἀγέληφι μέγ’ ἔξοχος ἔπλετο πάντων	-uu - uu-u u -uu -uu --	dactylic hexameter	feminine penthemimeral, trithemimeral
ταῦρος· ὃ γάρ τε βόεσσι μεταπρέπει ἀγρομένῃσι·	-u u - u u-u u-uu -uu--	dactylic hexameter	feminine penthemimeral, trithemimeral
τοῖον ἄρ’ Ἀτρεΐδην θῆκε Ζεὺς ἤματι κείνῳ	-u u -uu- -- - -uu --	dactylic hexameter	masculine penthemimeral, hepthemimeral
ἐκπρεπέ’ ἐν πολλοῖσι καὶ ἔξοχον ἡρώεσσιν.	-uu - --u u -uu ----	dactylic hexameter	feminine penthemimeral, trithemimeral
Ἔσπετε νῦν μοι Μοῦσαι Ὀλύμπια δώματ’ ἔχουσαι·	-uu - - -u u-uu -u u--	dactylic hexameter	feminine penthemimeral, trithemimeral
ὑμεῖς γὰρ θεαί ἐστε πάρεστέ τε ἴστέ τε πάντα,	-- - uu -u u-u u -u u --	dactylic hexameter	feminine penthemimeral, trithemimeral
ἡμεῖς δὲ κλέος οἶον ἀκούομεν οὐδέ τι ἴδμεν·	-- - uu -u u-uu -u u --	dactylic hexameter	feminine penthemimeral, trithemimeral
οἵ τινες ἡγεμόνες Δαναῶν καὶ κοίρανοι ἦσαν·	- uu -uu- uu- - -uu --	dactylic hexameter	masculine penthemimeral, hepthemimeral
πληθὺν δ’οὐκ ἂν ἐγὼ μυθήσομαι οὐδ’ ὀνομήνω,	-- - u u- --uu - uu--	dactylic hexameter	masculine penthemimeral, trithemimeral
οὐδ’ εἴ μοι δέκα μὲν γλῶσσαι, δέκα δὲ στόματ’ εἶεν,	- - - uu - -- uu - uu --	dactylic hexameter	masculine penthemimeral, hepthemimeral, trithemimeral
φωνὴ δ’ἄρρηκτος, χάλκεον δέ μοι ἦτορ ἐνείη,	-- --- -- u u -u u--	dactylic hexameter	masculine penthemimeral, hepthemimeral
εἰ μὴ Ὀλυμπιάδες Μοῦσαι Διὸς αἰγιόχοιο	- u u-uu- -- uu -uu--	dactylic hexameter	masculine penthemimeral, hepthemimeral
θυγατέρες μνησαίαθ’ ὅσοι ὑπὸ Ἴλιον ἦλθον·	-uu- --u u- uu -uu --	dactylic hexameter	feminine penthemimeral, hepthemimeral, trithemimeral
ἀρχοὺς αὖ νηῶν ἐρέω νῆάς τε προπάσας.	-- - -- uu- -- u u--	dactylic hexameter	masculine penthemimeral, hepthemimeral, trithemimeral
Βοιωτῶν μὲν Πηνέλεως καὶ Λήϊτος ἦρχον	--- - -uu- - -uu --	dactylic hexameter	hepthemimeral, trithemimeral
Ἀρκεσίλαός τε Προθοήνωρ τε Κλονίος τε,	-uu-- - uu-- - uu- -	dactylic hexameter	masculine penthemimeral
οἵ θ’Ὑρίην ἐνέμοντο καὶ Αὐλίδα πετρήεσσαν	- uu- uu-u u -uu ----	dactylic hexameter	feminine penthemimeral, trithemimeral
Σχοῖνόν τε Σκῶλόν τε πολύκνημόν τ’Ἐτεωνόν,	-- - -- u u--- uu--	dactylic hexameter	masculine penthemimeral, trithemimeral
Θέσπειαν Γραῖάν τε καὶ εὐρύχορον Μυκαλησσόν,	--- -- u u -uu- uu--	dactylic hexameter	masculine penthemimeral, trithemimeral
οἵ τ’ἀμφ’ Ἅρμ’ ἐνέμοντο καὶ Εἰλέσιον καὶ Ἐρυθράς,	- - - uu-u u -uu- u u--	dactylic hexameter	feminine penthemimeral, trithemimeral
οἵ τ’Ἐλεῶν’ εἶχον ἠδ’ Ὕλην καὶ Πετεῶνα,	- uu- -- - -- - uu--	dactylic hexameter	masculine penthemimeral, trithemimeral
Ὠκαλέην Μεδεῶνά τ’ ἐϋκτίμενον πτολίεθρον,	-uu- uu-u u-uu- uu--	dactylic hexameter	feminine penthemimeral, trithemimeral
Κώπας Εὔτρησίν τε πολυτρήρωνά τε Θίσβην,	-- --- u u---u u --	dactylic hexameter	masculine penthemimeral
οἵ τε Κορώνειαν καὶ ποιήενθ’ Ἁλίαρτον,	- u u--- - --- uu--	dactylic hexameter	masculine penthemimeral
οἵ τε Πλάταιαν ἔχον ἠδ’ οἳ Γλισᾶντ’ ἐνέμοντο,	- u u-u u- - - -- uu--	dactylic hexameter	masculine penthemimeral, hepthemimeral
οἵ θ’Ὑποθήβας εἶχον ἐϋκτίμενον πτολίεθρον,	- uu-- -u u-uu- uu--	dactylic hexameter	feminine penthemimeral
Ὀγχηστόν θ’ἱερὸν Ποσιδήϊον ἀγλαὸν ἄλσος,	--- uu- uu-uu -uu --	dactylic hexameter	masculine penthemimeral, trithemimeral
οἵ τε πολυστάφυλον Ἄρνην ἔχον, οἵ τε Μίδειαν	- u u-uu- -- uu - u u--	dactylic hexameter	masculine penthemimeral, hepthemimeral
Νῖσάν τε ζαθέην Ἀνθηδόνα τ’ἐσχατόωσαν·	-- - uu- --uu -uu--	dactylic hexameter	masculine penthemimeral, trithemimeral
τῶν μὲν πεντήκοντα νέες κίον, ἐν δὲ ἑκάστῃ	- - ---u u- uu - u u--	dactylic hexameter	feminine penthemimeral, hepthemimeral
κοῦροι Βοιωτῶν ἑκατὸν καὶ εἴκοσι βαῖνον.	-- --- uu- - -uu --	dactylic hexameter	masculine penthemimeral, hepthemimeral
Οἳ δ’Ἀσπληδόνα ναῖον ἰδ’ Ὀρχομενὸν Μινύειον,	- --uu -u u -uu- uu--	dactylic hexameter	feminine penthemimeral
τῶν ἦρχ’ Ἀσκάλαφος καὶ Ἰάλμενος υἷες Ἄρηος	- - -uu- u u-uu -u u--	dactylic hexameter	masculine penthemimeral
οὓς τέκεν Ἀστυόχη δόμῳ Ἄκτορος Ἀζεΐδαο,	- uu -uu- uu -uu -uu--	dactylic hexameter	masculine penthemimeral
παρθένος αἰδοίη ὑπερώϊον εἰσαναβᾶσα	-uu --- uu-uu -uu--	dactylic hexameter	masculine penthemimeral
Ἄρηϊ κρατερῷ· ὃ δέ οἱ παρελέξατο λάθρῃ·	--- uu- u u - uu-uu --	dactylic hexameter	masculine penthemimeral, hepthemimeral, trithemimeral
τοῖς δὲ τριήκοντα γλαφυραὶ νέες ἐστιχόωντο.	- u u--- uu- uu -uu--	dactylic hexameter	masculine penthemimeral, hepthemimeral
Αὐτὰρ Φωκήων Σχεδίος καὶ Ἐπίστροφος ἦρχον	-- --- uu- u u-uu --	dactylic hexameter	masculine penthemimeral, hepthemimeral
υἷες Ἰφίτου μεγαθύμου Ναυβολίδαο,	-- --- uu-- -uu--	dactylic hexameter	masculine penthemimeral
οἳ Κυπάρισσον ἔχον Πυθῶνά τε πετρήεσσαν	- uu-u u- --u u ----	dactylic hexameter	masculine penthemimeral
Κρῖσάν τε ζαθέην καὶ Δαυλίδα καὶ Πανοπῆα,	-- - uu- - -uu - uu--	dactylic hexameter	masculine penthemimeral, trithemimeral
οἵ τ’Ἀνεμώρειαν καὶ Ὑάμπολιν ἀμφενέμοντο,	- uu--- u u-uu -uu--	dactylic hexameter	masculine penthemimeral
οἵ τ’ἄρα πὰρ ποταμὸν Κηφισὸν δῖον ἔναιον,	- uu - uu- --- -u u--	dactylic hexameter	masculine penthemimeral, trithemimeral
οἵ τε Λίλαιαν ἔχον πηγῇς ἔπι Κηφισοῖο·	- u u-u u- -- uu ----	dactylic hexameter	masculine penthemimeral, hepthemimeral
τοῖς δ’ἅμα τεσσαράκοντα μέλαιναι νῆες ἕποντο.	- uu -uu-u u-- -u u--	dactylic hexameter	feminine penthemimeral
Οἳ μὲν Φωκήων στίχας ἵστασαν ἀμφιέποντες,	- - --- uu -uu -uu--	dactylic hexameter	masculine penthemimeral
Βοιωτῶν δ’ἔμπλην ἐπ’ ἀριστερὰ θωρήσσοντο.	--- -- u u-uu ----	dactylic hexameter	masculine penthemimeral, trithemimeral
Λοκρῶν δ’ἡγεμόνευεν Ὀϊλῆος ταχὺς Αἴας	-- -uu-u u--- uu --	dactylic hexameter	feminine penthemimeral
μείων, οὔ τι τόσος γε ὅσος Τελαμώνιος Αἴας	-- - u u- u u- uu-uu --	dactylic hexameter	masculine penthemimeral, hepthemimeral, trithemimeral
ἀλλὰ πολὺ μείων· ὀλίγος μὲν ἔην λινοθώρηξ,	-u u- -- uu- u u- uu--	dactylic hexameter	masculine penthemimeral, hepthemimeral, trithemimeral
ἐγχείῃ δ’ἐκέκαστο Πανέλληνας καὶ Ἀχαιούς·	--- uu-u u--- u u--	dactylic hexameter	feminine penthemimeral, trithemimeral
οἳ Κῦνόν τ’ἐνέμοντ’ Ὀπόεντά τε Καλλίαρόν τε	- -- uu- uu-u u -uu- -	dactylic hexameter	masculine penthemimeral, trithemimeral
Βῆσσάν τε Σκάρφην τε καὶ Αὐγειὰς ἐρατεινὰς	-- - -- u u --- uu--	dactylic hexameter	masculine penthemimeral, trithemimeral
Τάρφην τε Θρόνιον τε Βοαγρίου ἀμφὶ ῥέεθρα·	-- - uu- u u-uu -u u--	dactylic hexameter	masculine penthemimeral, trithemimeral
τῷ δ’ἅμα τεσσαράκοντα μέλαιναι νῆες ἕποντο	- uu -uu-u u-- -u u--	dactylic hexameter	feminine penthemimeral
Λοκρῶν, οἳ ναίουσι πέρην ἱερῆς Εὐβοίης.	-- - --u u- uu- ---	dactylic hexameter	feminine penthemimeral, hepthemimeral, trithemimeral
Οἳ δ’Εὔβοιαν ἔχον μένεα πνείοντες Ἄβαντες	- --u u- uu- --u u--	dactylic hexameter	masculine penthemimeral, hepthemimeral
Χαλκίδα τ’Εἰρέτριάν τε πολυστάφυλόν θ’Ἱστίαιαν	-uu -uu- u u-uu- ---	dactylic hexameter	masculine penthemimeral
Κήρινθόν τ’ἔφαλον Δίου τ’αἰπὺ πτολίεθρον,	--- uu- -- -- uu--	dactylic hexameter	masculine penthemimeral, hepthemimeral, trithemimeral
οἵ τε Κάρυστον ἔχον ἠδ’ οἳ Στύρα ναιετάασκον,	- u u-u u- - - uu -uu--	dactylic hexameter	masculine penthemimeral, hepthemimeral
τῶν αὖθ’ ἡγεμόνευ’ Ἐλεφήνωρ ὄζος Ἄρηος	- - -uu- uu-- -u u--	dactylic hexameter	masculine penthemimeral
Χαλκωδοντιάδης μεγαθύμων ἀρχὸς Ἀβάντων.	---uu- uu-- -u u--	dactylic hexameter	masculine penthemimeral
Τῷ δ’ἅμ’ Ἄβαντες ἕποντο θοοὶ ὄπιθεν κομόωντες	- u u-u u-u u- uu- uu--	dactylic hexameter	feminine penthemimeral, hepthemimeral
αἰχμηταὶ μεμαῶτες ὀρεκτῇσιν μελίῃσι	--- uu-u u--- uu--	dactylic hexameter	feminine penthemimeral, trithemimeral
θώρηκας ῥήξειν δηίων ἀμφὶ στήθεσσι·	--- -- -- -- ---	dactylic hexameter	masculine penthemimeral, hepthemimeral, trithemimeral
τῷ δ’ἅμα τεσσαράκοντα μέλαιναι νῆες ἕποντο.	- uu -uu-u u-- -u u--	dactylic hexameter	feminine penthemimeral
Οἳ δ’ἄρ’ Ἀθήνας εἶχον ἐϋκτίμενον πτολίεθρον	- u u-- -u u-uu- uu--	dactylic hexameter	feminine penthemimeral
δῆμον Ἐρεχθῆος μεγαλήτορος, ὅν ποτ’ Ἀθήνη	-u u--- uu-uu - u u--	dactylic hexameter	masculine penthemimeral
θρέψε Διὸς θυγάτηρ, τέκε δὲ ζείδωρος ἄρουρα,	-u u- uu- uu - --u u--	dactylic hexameter	masculine penthemimeral, hepthemimeral, trithemimeral
κὰδ δ’ἐν Ἀθήνῃς εἷσεν ἑῷ ἐν πίονι νηῷ·	- u u-- -u u- - -uu --	dactylic hexameter	feminine penthemimeral, hepthemimeral
ἔνθα δέ μιν ταύροισι καὶ ἀρνειοῖς ἱλάονται	-u u - --u u --- uu--	dactylic hexameter	feminine penthemimeral, trithemimeral
κοῦροι Ἀθηναίων περιτελλομένων ἐνιαυτῶν·	-u u--- uu-uu- uu--	dactylic hexameter	masculine penthemimeral
τῶν αὖθ’ ἡγεμόνευ’ υἱὸς Πετεῶο Μενεσθεύς.	- - -uu- -- uu-u u--	dactylic hexameter	masculine penthemimeral, hepthemimeral
Τῷ δ’οὔ πώ τις ὁμοῖος ἐπιχθόνιος γένετ’ ἀνὴρ	- - - u u-u u-uu- uu --	dactylic hexameter	feminine penthemimeral, trithemimeral
κοσμῆσαι ἵππους τε καὶ ἀνέρας ἀσπιδιώτας·	--- -- u u -uu -uu--	dactylic hexameter	masculine penthemimeral, trithemimeral
Νέστωρ οἶος ἔριζεν· ὃ γὰρ προγενέστερος ἦεν·	-- -u u-u u - uu-uu --	dactylic hexameter	feminine penthemimeral, hepthemimeral
τῷ δ’ἅμα πεντήκοντα μέλαιναι νῆες ἕποντο.	- uu ---u u-- -u u--	dactylic hexameter	feminine penthemimeral
Αἴας δ’ἐκ Σαλαμῖνος ἄγεν δυοκαίδεκα νῆας,	-- - uu-u u- uu-uu --	dactylic hexameter	feminine penthemimeral, hepthemimeral, trithemimeral
στῆσε δ’ἄγων ἵν’ Ἀθηναίων ἵσταντο φάλαγγες.	-u u- u u--- --u u--	dactylic hexameter	hepthemimeral, trithemimeral
Οἳ δ’Ἄργός τ’εἶχον Τίρυνθά τε τειχιόεσσαν	- -- -- --u u -uu--	dactylic hexameter	masculine penthemimeral, trithemimeral
Ἑρμιόνην Ἀσίνην τε, βαθὺν κατὰ κόλπον ἐχούσας,	-uu- uu- u u- uu -u u--	dactylic hexameter	masculine penthemimeral, hepthemimeral, trithemimeral
Τροιζῆν’ Ἠϊόνας τε καὶ ἀμπελόεντ’ Ἐπίδαυρον,	-- -uu- u u -uu- uu--	dactylic hexameter	masculine penthemimeral
οἵ τ’ἔχον Αἴγιναν Μάσητά τε κοῦροι Ἀχαιῶν,	- uu --- --u u -u u--	dactylic hexameter	masculine penthemimeral
τῶν αὖθ’ ἡγεμόνευε βοὴν ἀγαθὸς Διομήδης	- - -uu-u u- uu- uu--	dactylic hexameter	feminine penthemimeral, hepthemimeral
καὶ Σθένελος, Καπανῆος ἀγακλειτοῦ φίλος υἱός·	- uu- uu-u u--- uu --	dactylic hexameter	feminine penthemimeral, trithemimeral
τοῖσι δ’ἅμ’ Εὐρύαλος τρίτατος κίεν ἰσόθεος φὼς	-u u -uu- uu- uu -uu- -	dactylic hexameter	masculine penthemimeral, hepthemimeral
Μηκιστέος υἱὸς Ταλαϊονίδαο ἄνακτος·	--- -- uu-uu-u u--	dactylic hexameter	masculine penthemimeral, trithemimeral
συμπάντων δ’ἡγεῖτο βοὴν ἀγαθὸς Διομήδης·	--- --u u- uu- uu--	dactylic hexameter	feminine penthemimeral, hepthemimeral, trithemimeral
τοῖσι δ’ἅμ’ ὀγδώκοντα μέλαιναι νῆες ἕποντο.	-u u ---u u-- -u u--	dactylic hexameter	feminine penthemimeral
Οἳ δὲ Μυκήνας εἶχον ἐϋκτίμενον πτολίεθρον	- u u-- -u u-uu- uu--	dactylic hexameter	feminine penthemimeral
ἀφνειόν τε Κόρινθον ἐϋκτιμένας τε Κλεωνάς,	--- u u-u u-uu- u u--	dactylic hexameter	feminine penthemimeral, trithemimeral
Ὀρνειάς τ’ἐνέμοντο Ἀραιθυρέην τ’ἐρατεινὴν	--- uu-u u-uu- uu--	dactylic hexameter	feminine penthemimeral, trithemimeral
καὶ Σικυῶν’, ὅθ’ ἄρ’ Ἄδρηστος πρῶτ’ ἐμβασίλευεν,	- uu- u u --- - -uu--	dactylic hexameter	hepthemimeral, trithemimeral
οἵ θ’Ὑπερησίην τε καὶ αἰπεινὴν Γονόεσσαν	- uu--- u u --- uu--	dactylic hexameter	masculine penthemimeral
Πελλήνην τ’εἶχον ἠδ’ Αἴγιον ἀμφενέμοντο	--- -- - -uu -uu--	dactylic hexameter	masculine penthemimeral, trithemimeral
Αἰγιαλόν τ’ἀνὰ πάντα καὶ ἀμφ’ Ἑλίκην εὐρεῖαν,	-uu- uu -u u - uu- ---	dactylic hexameter	feminine penthemimeral, hepthemimeral, trithemimeral
τῶν ἑκατὸν νηῶν ἦρχε κρείων Ἀγαμέμνων	- uu- -- -- -- uu--	dactylic hexameter	masculine penthemimeral, hepthemimeral, trithemimeral
Ἀτρεΐδης· ἅμα τῷ γε πολὺ πλεῖστοι καὶ ἄριστοι	-uu- uu - u u- -- u u--	dactylic hexameter	masculine penthemimeral, hepthemimeral, trithemimeral
λαοὶ ἕποντ’· ἐν δ’αὐτὸς ἐδύσετο νώροπα χαλκὸν	-u u- - -u u-uu -uu --	dactylic hexameter	feminine penthemimeral, trithemimeral
κυδιόων, πᾶσιν δὲ μετέπρεπεν ἡρώεσσιν	-uu- -- u u-uu ----	dactylic hexameter	masculine penthemimeral, trithemimeral
οὕνεκ’ ἄριστος ἔην πολὺ δὲ πλείστους ἄγε λαούς.	-u u-u u- uu - -- uu --	dactylic hexameter	masculine penthemimeral, hepthemimeral
Οἳ δ’εἶχον κοίλην Λακεδαίμονα κητώεσσαν,	- -- -- uu-uu ----	dactylic hexameter	masculine penthemimeral, trithemimeral
Φᾶρίν τε Σπάρτην τε πολυτρήρωνά τε Μέσσην,	-- - -- u u---u u --	dactylic hexameter	masculine penthemimeral, trithemimeral
Βρυσειάς τ’ἐνέμοντο καὶ Αὐγειὰς ἐρατεινάς,	--- uu-u u --- uu--	dactylic hexameter	feminine penthemimeral, trithemimeral
οἵ τ’ἄρ’ Ἀμύκλας εἶχον Ἕλος τ’ἔφαλον πτολίεθρον,	- u u-- -u u- uu- uu--	dactylic hexameter	feminine penthemimeral, hepthemimeral
οἵ τε Λάαν εἶχον ἠδ’ Οἴτυλον ἀμφενέμοντο,	- u u- -- - -uu -uu--	dactylic hexameter	masculine penthemimeral, trithemimeral
τῶν οἱ ἀδελφεὸς ἦρχε βοὴν ἀγαθὸς Μενέλαος	- u u-uu -u u- uu- uu--	dactylic hexameter	feminine penthemimeral, hepthemimeral
ἑξήκοντα νεῶν· ἀπάτερθε δὲ θωρήσσοντο·	---u u- uu-u u ----	dactylic hexameter	masculine penthemimeral
ἐν δ’αὐτὸς κίεν ᾗσι προθυμίῃσι πεποιθὼς	- -- uu -u u---u u--	dactylic hexameter	feminine penthemimeral, trithemimeral
ὀτρύνων πόλεμον δέ· μάλιστα δὲ ἵετο θυμῷ	--- uu- u u-u u -uu --	dactylic hexameter	masculine penthemimeral, trithemimeral
τίσασθαι Ἑλένης ὁρμήματά τε στοναχάς τε.	--- uu- --uu - uu- -	dactylic hexameter	masculine penthemimeral, trithemimeral
Οἳ δὲ Πύλον τ’ἐνέμοντο καὶ Ἀρήνην ἐρατεινὴν	- u u- uu-u u --- uu--	dactylic hexameter	feminine penthemimeral, trithemimeral
καὶ Θρύον Ἀλφειοῖο πόρον καὶ ἐΰκτιτον Αἰπὺ	- uu ---u u- u u-uu --	dactylic hexameter	feminine penthemimeral, hepthemimeral
καὶ Κυπαρισσήεντα καὶ Ἀμφιγένειαν ἔναιον	- uu---u u -uu-u u--	dactylic hexameter	feminine penthemimeral
καὶ Πτελεὸν καὶ Ἕλος καὶ Δώριον, ἔνθά τε Μοῦσαι	- uu- u u- - -uu -u u --	dactylic hexameter	masculine penthemimeral, trithemimeral
ἀντόμεναι Θάμυριν τὸν Θρήϊκα παῦσαν ἀοιδῆς	-uu- uu- - -uu -u u--	dactylic hexameter	masculine penthemimeral, trithemimeral
Οἰχαλίηθεν ἰόντα παρ’ Εὐρύτου Οἰχαλιῆος·	-uu-u u-u u -uu -uu--	dactylic hexameter	feminine penthemimeral
στεῦτο γὰρ εὐχόμενος νικησέμεν εἴ περ ἂν αὐταὶ	-u u -uu- --uu - u u --	dactylic hexameter	masculine penthemimeral
Μοῦσαι ἀείδοιεν κοῦραι Διὸς αἰγιόχοιο·	-u u--- -- uu -uu--	dactylic hexameter	masculine penthemimeral, hepthemimeral
αἳ δὲ χολωσάμεναι πηρὸν θέσαν, αὐτὰρ ἀοιδὴν	- u u-uu- -- uu -u u--	dactylic hexameter	masculine penthemimeral, hepthemimeral
θεσπεσίην ἀφέλοντο καὶ ἐκλέλαθον κιθαριστύν·	-uu- uu-u u -uu- uu--	dactylic hexameter	feminine penthemimeral, trithemimeral
τῶν αὖθ’ ἡγεμόνευε Γερήνιος ἱππότα Νέστωρ·	- - -uu-u u-uu -uu --	dactylic hexameter	feminine penthemimeral
τῷ δ’ἐνενήκοντα γλαφυραὶ νέες ἐστιχόωντο.	- uu--- uu- uu -uu--	dactylic hexameter	masculine penthemimeral, hepthemimeral
Οἳ δ’ἔχον Ἀρκαδίην ὑπὸ Κυλλήνης ὄρος αἰπὺ	- uu -uu- uu --- uu --	dactylic hexameter	masculine penthemimeral
Αἰπύτιον παρὰ τύμβον ἵν’ ἀνέρες ἀγχιμαχηταί,	-uu- uu -u u -uu -uu--	dactylic hexameter	feminine penthemimeral, trithemimeral
οἳ Φενεόν τ’ἐνέμοντο καὶ Ὀρχομενὸν πολύμηλον	- uu- uu-u u -uu- uu--	dactylic hexameter	feminine penthemimeral, trithemimeral
’Ρίπην τε Στρατίην τε καὶ ἠνεμόεσσαν Ἐνίσπην	-- - uu- u u -uu-u u--	dactylic hexameter	masculine penthemimeral, trithemimeral
καὶ Τεγέην εἶχον καὶ Μαντινέην ἐρατεινὴν	- uu- -- - -uu- uu--	dactylic hexameter	masculine penthemimeral, trithemimeral
Στύμφηλόν τ’εἶχον καὶ Παρρασίην ἐνέμοντο,	--- -- - -uu- uu--	dactylic hexameter	masculine penthemimeral, trithemimeral
τῶν ἦρχ’ Ἀγκαίοιο πάϊς κρείων Ἀγαπήνωρ	- - ---u u- -- uu--	dactylic hexameter	feminine penthemimeral, hepthemimeral
ἑξήκοντα νεῶν· πολέες δ’ἐν νηῒ ἑκάστῃ	---u u- uu- - -u u--	dactylic hexameter	masculine penthemimeral, hepthemimeral
Ἀρκάδες ἄνδρες ἔβαινον ἐπιστάμενοι πολεμίζειν.	-uu -u u-u u-uu- uu--	dactylic hexameter	feminine penthemimeral
Αὐτὸς γάρ σφιν δῶκεν ἄναξ ἀνδρῶν Ἀγαμέμνων	-- - - -u u- -- uu--	dactylic hexameter	feminine penthemimeral, hepthemimeral, trithemimeral
νῆας ἐϋσσέλμους περάαν ἐπὶ οἴνοπα πόντον	-u u--- uu- uu -uu --	dactylic hexameter	masculine penthemimeral, hepthemimeral
Ἀτρεΐδης, ἐπεὶ οὔ σφι θαλάσσια ἔργα μεμήλει.	-uu- uu - u u-uu -u u--	dactylic hexameter	masculine penthemimeral, trithemimeral
Οἳ δ’ἄρα Βουπράσιόν τε καὶ Ἤλιδα δῖαν ἔναιον	- uu -uu- u u -uu -u u--	dactylic hexameter	masculine penthemimeral
ὅσσον ἐφ’ Ὑρμίνη καὶ Μύρσινος ἐσχατόωσα	-u u --- - -uu -uu--	dactylic hexameter	masculine penthemimeral
πέτρη τ’Ὠλενίη καὶ Ἀλήσιον ἐντὸς ἐέργει,	-- -uu- u u-uu -u u--	dactylic hexameter	masculine penthemimeral
τῶν αὖ τέσσαρες ἀρχοὶ ἔσαν, δέκα δ’ἀνδρὶ ἑκάστῳ	- - -uu -u u- uu -u u--	dactylic hexameter	feminine penthemimeral, hepthemimeral
νῆες ἕποντο θοαί, πολέες δ’ἔμβαινον Ἐπειοί.	-u u-u u- uu- --u u--	dactylic hexameter	masculine penthemimeral, hepthemimeral
Τῶν μὲν ἄρ’ Ἀμφίμαχος καὶ Θάλπιος ἡγησάσθην	- u u -uu- - -uu ----	dactylic hexameter	masculine penthemimeral
υἷες ὃ μὲν Κτεάτου, ὃ δ’ἄρ’ Εὐρύτου, Ἀκτορίωνε·	-u u - uu- u u -uu -uu--	dactylic hexameter	masculine penthemimeral, trithemimeral
τῶν δ’Ἀμαρυγκεΐδης ἦρχε κρατερὸς Διώρης·	- uu-uu- -- uu- ---	dactylic hexameter	masculine penthemimeral, hepthemimeral
τῶν δὲ τετάρτων ἦρχε Πολύξεινος θεοειδὴς	- u u-- -u u--- uu--	dactylic hexameter	feminine penthemimeral
υἱὸς Ἀγασθένεος Αὐγηϊάδαο ἄνακτος.	-u u-uu- --uu-u u--	dactylic hexameter	masculine penthemimeral
Οἳ δ’ἐκ Δουλιχίοιο Ἐχινάων θ’ἱεράων	- - -uu-u u--- uu--	dactylic hexameter	feminine penthemimeral
νήσων, αἳ ναίουσι πέρην ἁλὸς Ἤλιδος ἄντα,	-- - --u u- uu -uu --	dactylic hexameter	feminine penthemimeral, hepthemimeral, trithemimeral
τῶν αὖθ’ ἡγεμόνευε Μέγης ἀτάλαντος Ἄρηϊ	- - -uu-u u- uu-u u--	dactylic hexameter	feminine penthemimeral, hepthemimeral
Φυλεΐδης, ὃν τίκτε Διῒ φίλος ἱππότα Φυλεύς,	-uu- - -u u- uu -uu --	dactylic hexameter	feminine penthemimeral, hepthemimeral, trithemimeral
ὅς ποτε Δουλίχιον δ’ἀπενάσσατο πατρὶ χολωθείς·	- uu -uu- uu-uu -u u--	dactylic hexameter	masculine penthemimeral
τῷ δ’ἅμα τεσσαράκοντα μέλαιναι νῆες ἕποντο.	- uu -uu-u u-- -u u--	dactylic hexameter	feminine penthemimeral
Αὐτὰρ Ὀδυσσεὺς ἦγε Κεφαλλῆνας μεγαθύμους,	-u u-- -u u--- uu--	dactylic hexameter	feminine penthemimeral
οἵ ῥ’Ἰθάκην εἶχον καὶ Νήριτον εἰνοσίφυλλον	- uu- -- - -uu -uu--	dactylic hexameter	masculine penthemimeral, trithemimeral
καὶ Κροκύλει’ ἐνέμοντο καὶ Αἰγίλιπα τρηχεῖαν,	- uu- uu-u u -uu- ---	dactylic hexameter	feminine penthemimeral, trithemimeral
οἵ τε Ζάκυνθον ἔχον ἠδ’ οἳ Σάμον ἀμφενέμοντο,	- u u-u u- - - uu -uu--	dactylic hexameter	masculine penthemimeral, hepthemimeral
οἵ τ’ἤπειρον ἔχον ἠδ’ ἀντιπέραι’ ἐνέμοντο·	- --u u- - -uu- uu--	dactylic hexameter	masculine penthemimeral
τῶν μὲν Ὀδυσσεὺς ἦρχε Διὶ μῆτιν ἀτάλαντος·	- u u-- -u u- -- uu--	dactylic hexameter	feminine penthemimeral, hepthemimeral
τῷ δ’ἅμα νῆες ἕποντο δυώδεκα μιλτοπάρῃοι.	- uu -u u-u u-uu -uu--	dactylic hexameter	feminine penthemimeral
Αἰτωλῶν δ’ἡγεῖτο Θόας Ἀνδραίμονος υἱός,	--- --u u- --uu --	dactylic hexameter	feminine penthemimeral, hepthemimeral, trithemimeral
οἳ Πλευρῶν’ ἐνέμοντο καὶ Ὤλενον ἠδὲ Πυλήνην	- -- uu-u u -uu -u u--	dactylic hexameter	feminine penthemimeral, trithemimeral
Χαλκίδα τ’ἀγχίαλον Καλυδῶνά τε πετρήεσσαν·	-uu -uu- uu-u u ----	dactylic hexameter	masculine penthemimeral
οὐ γὰρ ἔτ’ Οἰνῆος μεγαλήτορος υἱέες ἦσαν,	- u u --- uu-uu -uu --	dactylic hexameter	masculine penthemimeral
οὐδ’ ἄρ’ ἔτ’ αὐτὸς ἔην, θάνε δὲ ξανθὸς Μελέαγρος·	- u u -u u- uu - -- uu--	dactylic hexameter	masculine penthemimeral, hepthemimeral
τῷ δ’ἐπὶ πάντ’ ἐτέταλτο ἀνασσέμεν Αἰτωλοῖσι·	- uu - uu-u u-uu ----	dactylic hexameter	feminine penthemimeral, trithemimeral
τῷ δ’ἅμα τεσσαράκοντα μέλαιναι νῆες ἕποντο.	- uu -uu-u u-- -u u--	dactylic hexameter	feminine penthemimeral
Κρητῶν δ’Ἰδομενεὺς δουρὶ κλυτὸς ἡγεμόνευεν,	-- -uu- -- uu -uu--	dactylic hexameter	masculine penthemimeral, hepthemimeral
οἳ Κνωσόν τ’εἶχον Γόρτυνά τε τειχιόεσσαν,	- -- -- --u u -uu--	dactylic hexameter	masculine penthemimeral, trithemimeral
Λύκτον Μίλητόν τε καὶ ἀργινόεντα Λύκαστον	-- --- u u -uu-u u--	dactylic hexameter	masculine penthemimeral
Φαιστόν τε ’Ρύτιόν τε, πόλεις εὖ ναιετοώσας,	-- - uu- u u- - -uu--	dactylic hexameter	masculine penthemimeral, hepthemimeral, trithemimeral
ἄλλοι θ’οἳ Κρήτην ἑκατόμπολιν ἀμφενέμοντο.	-- - -- uu-uu -uu--	dactylic hexameter	masculine penthemimeral, trithemimeral
Τῶν μὲν ἄρ’ Ἰδομενεὺς δουρὶ κλυτὸς ἡγεμόνευε	- u u -uu- -- uu -uu--	dactylic hexameter	masculine penthemimeral, hepthemimeral
Μηριόνης τ’ἀτάλαντος Ἐνυαλίῳ ἀνδρειφόντῃ·	-uu- uu-u u-uu ----	dactylic hexameter	feminine penthemimeral, trithemimeral
τοῖσι δ’ἅμ’ ὀγδώκοντα μέλαιναι νῆες ἕποντο.	-u u ---u u-- -u u--	dactylic hexameter	feminine penthemimeral
Τληπόλεμος δ’Ἡρακλεΐδης ἠΰς τε μέγας τε	-uu- --uu- -- u u- -	dactylic hexameter	hepthemimeral, trithemimeral
ἐκ ’Ρόδου ἐννέα νῆας ἄγεν ’Ροδίων ἀγερώχων,	- uu -uu -u u- uu- uu--	dactylic hexameter	feminine penthemimeral, hepthemimeral
οἳ ’Ρόδον ἀμφενέμοντο διὰ τρίχα κοσμηθέντες	- uu -uu-u u- uu ----	dactylic hexameter	feminine penthemimeral, hepthemimeral
Λίνδον Ἰηλυσόν τε καὶ ἀργινόεντα Κάμειρον.	-u u--- u u -uu-u u--	dactylic hexameter	masculine penthemimeral
Τῶν μὲν Τληπόλεμος δουρὶ κλυτὸς ἡγεμόνευεν,	- - -uu- -- uu -uu--	dactylic hexameter	masculine penthemimeral, hepthemimeral
ὃν τέκεν Ἀστυόχεια βίῃ Ἡρακληείῃ,	- uu -uu-u u- -----	dactylic hexameter	feminine penthemimeral, hepthemimeral
τὴν ἄγετ’ ἐξ Ἐφύρης ποταμοῦ ἄπο Σελλήεντος	- uu - uu- uu- uu ----	dactylic hexameter	masculine penthemimeral, hepthemimeral, trithemimeral
πέρσας ἄστεα πολλὰ διοτρεφέων αἰζηῶν.	-- -uu -u u-uu- ---	dactylic hexameter	feminine penthemimeral
Τληπόλεμος δ’ἐπεὶ οὖν τράφ’ ἐνὶ μεγάρῳ εὐπήκτῳ,	-uu- uu - u u- uu- ---	dactylic hexameter	masculine penthemimeral, hepthemimeral, trithemimeral
αὐτίκα πατρὸς ἑοῖο φίλον μήτρωα κατέκτα	--- uu -u u- --u u--	dactylic hexameter	feminine penthemimeral, hepthemimeral, trithemimeral
ἤδη γηράσκοντα Λικύμνιον ὄζον Ἄρηος·	-- ---u u-uu -u u--	dactylic hexameter	feminine penthemimeral
αἶψα δὲ νῆας ἔπηξε, πολὺν δ’ὅ γε λαὸν ἀγείρας	-u u -u u-u u- u u -u u--	dactylic hexameter	feminine penthemimeral, hepthemimeral
βῆ φεύγων ἐπὶ πόντον· ἀπείλησαν γάρ οἱ ἄλλοι	- -- uu -u u--- u u --	dactylic hexameter	feminine penthemimeral, trithemimeral
υἱέες υἱωνοί τε βίης Ἡρακληείης.	-uu --- u u- -----	dactylic hexameter	masculine penthemimeral, hepthemimeral
Αὐτὰρ ὅ γ’ἐς ’Ρόδον ἷξεν ἀλώμενος ἄλγεα πάσχων·	-u u - uu -u u-uu -uu --	dactylic hexameter	feminine penthemimeral, trithemimeral
τριχθὰ δὲ ᾤκηθεν καταφυλαδόν, ἠδὲ φίληθεν	-u u --- uu-uu -u u--	dactylic hexameter	masculine penthemimeral
ἐκ Διός, ὅς τε θεοῖσι καὶ ἀνθρώποισιν ἀνάσσει,	- uu - u u-u u ---u u--	dactylic hexameter	feminine penthemimeral, trithemimeral
καί σφιν θεσπέσιον πλοῦτον κατέχευε Κρονίων.	- - -uu- -- uu-u u--	dactylic hexameter	masculine penthemimeral, hepthemimeral
Νιρεὺς αὖ Σύμηθεν ἄγε τρεῖς νῆας ἐΐσας	-- - --u u- - -u u--	dactylic hexameter	feminine penthemimeral, hepthemimeral, trithemimeral
Νιρεὺς Ἀγλαΐης υἱὸς Χαρόποιό τ’ἄνακτος	-- -uu- -- uu-u u--	dactylic hexameter	masculine penthemimeral, hepthemimeral
Νιρεύς, ὃς κάλλιστος ἀνὴρ ὑπὸ Ἴλιον ἦλθε	-- - --u u- uu -uu --	dactylic hexameter	feminine penthemimeral, hepthemimeral, trithemimeral
τῶν ἄλλων Δαναῶν μετ’ ἀμύμονα Πηλεΐωνα·	- -- uu- u u-uu -uu--	dactylic hexameter	masculine penthemimeral, trithemimeral
ἀλλ’ ἀλαπαδνὸς ἔην, παῦρος δέ οἱ εἵπετο λαός.	- uu-u u- -- u u -uu --	dactylic hexameter	masculine penthemimeral, hepthemimeral
Οἳ δ’ἄρα Νίσυρόν τ’εἶχον Κράπαθόν τε Κάσον τε	- uu --- -- uu- u u- -	dactylic hexameter	masculine penthemimeral, hepthemimeral
καὶ Κῶν Εὐρυπύλοιο πόλιν νήσους τε Καλύδνας,	- - -uu-u u- -- u u--	dactylic hexameter	feminine penthemimeral, hepthemimeral
τῶν αὖ Φείδιππός τε καὶ Ἄντιφος ἡγησάσθην	- - --- u u -uu ----	dactylic hexameter	masculine penthemimeral
Θεσσαλοῦ υἷε δύω Ἡρακλεΐδαο ἄνακτος·	-uu -u u- --uu-u u--	dactylic hexameter	masculine penthemimeral
τοῖς δὲ τριήκοντα γλαφυραὶ νέες ἐστιχόωντο.	- u u--- uu- uu -uu--	dactylic hexameter	masculine penthemimeral, hepthemimeral
Νῦν αὖ τοὺς ὅσσοι τὸ Πελασγικὸν Ἄργος ἔναιον,	- - - -- u u-uu -u u--	dactylic hexameter	masculine penthemimeral, trithemimeral
οἵ τ’Ἄλον οἵ τ’Ἀλόπην οἵ τε Τρηχῖνα νέμοντο,	- uu - uu- - - --u u--	dactylic hexameter	masculine penthemimeral, hepthemimeral, trithemimeral
οἵ τ’εἶχον Φθίην ἠδ’ Ἑλλάδα καλλιγύναικα,	- -- -- - -uu -uu--	dactylic hexameter	masculine penthemimeral, trithemimeral
Μυρμιδόνες δὲ καλεῦντο καὶ Ἕλληνες καὶ Ἀχαιοί,	-uu- u u-u u --- u u--	dactylic hexameter	feminine penthemimeral, trithemimeral
τῶν αὖ πεντήκοντα νεῶν ἦν ἀρχὸς Ἀχιλλεύς.	- - ---u u- - -u u--	dactylic hexameter	feminine penthemimeral, hepthemimeral
Ἀλλ’ οἵ γ’οὐ πολέμοιο δυσηχέος ἐμνώοντο·	- - - uu-u u-uu ----	dactylic hexameter	feminine penthemimeral, trithemimeral
οὐ γὰρ ἔην ὅς τίς σφιν ἐπὶ στίχας ἡγήσαιτο·	- u u- - - u u- uu ----	dactylic hexameter	masculine penthemimeral, hepthemimeral, trithemimeral
κεῖτο γὰρ ἐν νήεσσι ποδάρκης δῖος Ἀχιλλεὺς	-u u - --u u-- -u u--	dactylic hexameter	feminine penthemimeral, trithemimeral
κούρης χωόμενος Βρισηΐδος ἠϋκόμοιο,	-- -uu- --uu -uu--	dactylic hexameter	masculine penthemimeral
τὴν ἐκ Λυρνησσοῦ ἐξείλετο πολλὰ μογήσας	- - --- --uu -u u--	dactylic hexameter	masculine penthemimeral
Λυρνησσὸν διαπορθήσας καὶ τείχεα Θήβης,	--- uu--- - -uu --	dactylic hexameter	hepthemimeral, trithemimeral
κὰδ δὲ Μύνητ’ ἔβαλεν καὶ Ἐπίστροφον ἐγχεσιμώρους,	- u u- uu- u u-uu -uu--	dactylic hexameter	masculine penthemimeral, trithemimeral
υἱέας Εὐηνοῖο Σεληπιάδαο ἄνακτος·	-uu ---u u-uu-u u--	dactylic hexameter	feminine penthemimeral
τῆς ὅ γε κεῖτ’ ἀχέων, τάχα δ’ἀνστήσεσθαι ἔμελλεν.	- u u - uu- uu ---u u--	dactylic hexameter	masculine penthemimeral, trithemimeral
Οἳ δ’εἶχον Φυλάκην καὶ Πύρασον ἀνθεμόεντα	- -- uu- - -uu -uu--	dactylic hexameter	masculine penthemimeral, trithemimeral
Δήμητρος τέμενος, Ἴτωνά τε μητέρα μήλων,	--- uu- --u u -uu --	dactylic hexameter	masculine penthemimeral, trithemimeral
ἀγχίαλόν τ’Ἀντρῶνα ἰδὲ Πτελεὸν λεχεποίην,	-uu- --u u- uu- uu--	dactylic hexameter	feminine penthemimeral, hepthemimeral, trithemimeral
τῶν αὖ Πρωτεσίλαος ἀρήϊος ἡγεμόνευε	- - -uu-u u-uu -uu--	dactylic hexameter	feminine penthemimeral
ζωὸς ἐών· τότε δ’ἤδη ἔχεν κάτα γαῖα μέλαινα.	-u u- uu -u u- uu -u u--	dactylic hexameter	feminine penthemimeral, hepthemimeral, trithemimeral
Τοῦ δὲ καὶ ἀμφιδρυφὴς ἄλοχος Φυλάκῃ ἐλέλειπτο	- u u -uu- uu- uu- uu--	dactylic hexameter	masculine penthemimeral, hepthemimeral
καὶ δόμος ἡμιτελής· τὸν δ’ἔκτανε Δάρδανος ἀνὴρ	- uu -uu- - -uu -uu --	dactylic hexameter	masculine penthemimeral
νηὸς ἀποθρῴσκοντα πολὺ πρώτιστον Ἀχαιῶν.	-u u---u u- --u u--	dactylic hexameter	feminine penthemimeral, hepthemimeral
Οὐδὲ μὲν οὐδ’ οἳ ἄναρχοι ἔσαν, πόθεόν γε μὲν ἀρχόν·	-u u - u u-u u- uu- u u --	dactylic hexameter	feminine penthemimeral, hepthemimeral, trithemimeral
ἀλλά σφεας κόσμησε Ποδάρκης ὄζος Ἄρηος	-- - --u u-- -u u--	dactylic hexameter	feminine penthemimeral, trithemimeral
Ἰφίκλου υἱὸς πολυμήλου Φυλακίδαο	--- -- uu-- -uu--	dactylic hexameter	masculine penthemimeral, trithemimeral
αὐτοκασίγνητος μεγαθύμου Πρωτεσιλάου	-uu--- uu-- -uu--	dactylic hexameter	masculine penthemimeral
ὁπλότερος γενεῇ· ὁ δ’ἅμα πρότερος καὶ ἀρείων	-uu- uu- u u- uu- u u--	dactylic hexameter	masculine penthemimeral, hepthemimeral, trithemimeral
ἥρως Πρωτεσίλαος ἀρήϊος· οὐδέ τι λαοὶ	-- -uu-u u-uu -u u --	dactylic hexameter	feminine penthemimeral
δεύονθ’ ἡγεμόνος, πόθεόν γε μὲν ἐσθλὸν ἐόντα·	-- -uu- uu- u u -u u--	dactylic hexameter	masculine penthemimeral, hepthemimeral
τῷ δ’ἅμα τεσσαράκοντα μέλαιναι νῆες ἕποντο.	- uu -uu-u u-- -u u--	dactylic hexameter	feminine penthemimeral
Οἳ δὲ Φερὰς ἐνέμοντο παραὶ Βοιβηΐδα λίμνην	- u u- uu-u u- --uu --	dactylic hexameter	feminine penthemimeral, hepthemimeral, trithemimeral
Βοίβην καὶ Γλαφύρας καὶ ἐϋκτιμένην Ἰαωλκόν,	-- - uu- u u-uu- uu--	dactylic hexameter	masculine penthemimeral, trithemimeral
τῶν ἦρχ’ Ἀδμήτοιο φίλος πάϊς ἕνδεκα νηῶν	- - ---u u- uu -uu --	dactylic hexameter	feminine penthemimeral, hepthemimeral
Εὔμηλος, τὸν ὑπ’ Ἀδμήτῳ τέκε δῖα γυναικῶν	--- u u --- uu -u u--	dactylic hexameter	hepthemimeral, trithemimeral
Ἄλκηστις Πελίαο θυγατρῶν εἶδος ἀρίστη.	--- uu-u u-- -u u--	dactylic hexameter	feminine penthemimeral, trithemimeral
Οἳ δ’ἄρα Μηθώνην καὶ Θαυμακίην ἐνέμοντο	- uu --- - -uu- uu--	dactylic hexameter	masculine penthemimeral
καὶ Μελίβοιαν ἔχον καὶ Ὀλιζῶνα τρηχεῖαν,	- uu-u u- u u--- ---	dactylic hexameter	masculine penthemimeral
τῶν δὲ Φιλοκτήτης ἦρχεν τόξων ἐῢ εἰδὼς	- u u--- -- -- uu --	dactylic hexameter	masculine penthemimeral, hepthemimeral
ἑπτὰ νεῶν· ἐρέται δ’ἐν ἑκάστῃ πεντήκοντα	-u u- uu- u u-- ----	dactylic hexameter	masculine penthemimeral, trithemimeral
ἐμβέβασαν τόξων εὖ εἰδότες ἶφι μάχεσθαι.	-uu- -- - -uu -u u--	dactylic hexameter	masculine penthemimeral, trithemimeral
Ἀλλ’ ὃ μὲν ἐν νήσῳ κεῖτο κρατέρ’ ἄλγεα πάσχων	- u u - -- -- uu -uu --	dactylic hexameter	masculine penthemimeral, hepthemimeral, trithemimeral
Λήμνῳ ἐν ἠγαθέῃ, ὅθι μιν λίπον υἷες Ἀχαιῶν	-u u -uu- uu - uu -u u--	dactylic hexameter	masculine penthemimeral, hepthemimeral
ἕλκεϊ μοχθίζοντα κακῷ ὀλοόφρονος ὕδρου·	-uu ---u u- uu-uu --	dactylic hexameter	feminine penthemimeral, hepthemimeral
ἔνθ’ ὅ γε κεῖτ’ ἀχέων· τάχα δὲ μνήσεσθαι ἔμελλον	- u u - uu- uu - --u u--	dactylic hexameter	masculine penthemimeral, hepthemimeral, trithemimeral
Ἀργεῖοι παρὰ νηυσὶ Φιλοκτήταο ἄνακτος.	--- uu -u u---u u--	dactylic hexameter	feminine penthemimeral, trithemimeral
Οὐδὲ μὲν οὐδ’ οἳ ἄναρχοι ἔσαν, πόθεόν γε μὲν ἀρχόν·	-u u - u u-u u- uu- u u --	dactylic hexameter	feminine penthemimeral, hepthemimeral, trithemimeral
ἀλλὰ Μέδων κόσμησεν Ὀϊλῆος νόθος υἱός,	-u u- --u u--- uu --	dactylic hexameter	feminine penthemimeral, trithemimeral
τόν ῥ’ἔτεκεν ’Ρήνη ὑπ’ Ὀϊλῆϊ πτολιπόρθῳ.	- uu- -- u u--- uu--	dactylic hexameter	masculine penthemimeral, trithemimeral
Οἳ δ’εἶχον Τρίκκην καὶ Ἰθώμην κλωμακόεσσαν,	- -- -- u u-- -uu--	dactylic hexameter	masculine penthemimeral, trithemimeral
οἵ τ’ἔχον Οἰχαλίην πόλιν Εὐρύτου Οἰχαλιῆος,	- uu -uu- uu -uu -uu--	dactylic hexameter	masculine penthemimeral
τῶν αὖθ’ ἡγείσθην Ἀσκληπιοῦ δύο παῖδε	- - --- ---- uu --	dactylic hexameter	masculine penthemimeral
ἰητῆρ’ ἀγαθὼ Ποδαλείριος ἠδὲ Μαχάων·	--- uu- uu-uu -u u--	dactylic hexameter	masculine penthemimeral, trithemimeral
τοῖς δὲ τριήκοντα γλαφυραὶ νέες ἐστιχόωντο.	- u u--- uu- uu -uu--	dactylic hexameter	masculine penthemimeral, hepthemimeral
Οἳ δ’ἔχον Ὀρμένιον, οἵ τε κρήνην Ὑπέρειαν,	- uu -uu- - - -- uu--	dactylic hexameter	masculine penthemimeral, hepthemimeral
οἵ τ’ἔχον Ἀστέριον Τιτάνοιό τε λευκὰ κάρηνα,	- uu -uu- uu-u u -u u--	dactylic hexameter	masculine penthemimeral
τῶν ἦρχ’ Εὐρύπυλος Εὐαίμονος ἀγλαὸς υἱός·	- - -uu- --uu -uu --	dactylic hexameter	masculine penthemimeral
τῷ δ’ἅμα τεσσαράκοντα μέλαιναι νῆες ἕποντο.	- uu -uu-u u-- -u u--	dactylic hexameter	feminine penthemimeral
Οἳ δ’Ἄργισσαν ἔχον καὶ Γυρτώνην ἐνέμοντο,	- --u u- - --- uu--	dactylic hexameter	masculine penthemimeral
Ὄρθην Ἠλώνην τε πόλιν τ’Ὀλοοσσόνα λευκήν,	-- --- u u- uu-uu --	dactylic hexameter	masculine penthemimeral, hepthemimeral
τῶν αὖθ’ ἡγεμόνευε μενεπτόλεμος Πολυποίτης	- - -uu-u u-uu- uu--	dactylic hexameter	feminine penthemimeral
υἱὸς Πειριθόοιο τὸν ἀθάνατος τέκετο Ζεύς·	-- -uu-u u -uu- uu- -	dactylic hexameter	feminine penthemimeral
τόν ῥ’ὑπὸ Πειριθόῳ τέκετο κλυτὸς Ἱπποδάμεια	- uu -uu- uu- uu -uu--	dactylic hexameter	masculine penthemimeral, hepthemimeral
ἤματι τῷ ὅτε Φῆρας ἐτίσατο λαχνήεντας,	-uu - uu -u u-uu ----	dactylic hexameter	feminine penthemimeral, trithemimeral
τοὺς δ’ἐκ Πηλίου ὦσε καὶ Αἰθίκεσσι πέλασσεν·	- - -uu -u u ---u u--	dactylic hexameter	feminine penthemimeral
οὐκ οἶος, ἅμα τῷ γε Λεοντεὺς ὄζος Ἄρηος	- -- uu - u u-- -u u--	dactylic hexameter	masculine penthemimeral, trithemimeral
υἱὸς ὑπερθύμοιο Κορώνου Καινεΐδαο·	-u u---u u-- -uu--	dactylic hexameter	feminine penthemimeral
τοῖς δ’ἅμα τεσσαράκοντα μέλαιναι νῆες ἕποντο.	- uu -uu-u u-- -u u--	dactylic hexameter	feminine penthemimeral
Γουνεὺς δ’ἐκ Κύφου ἦγε δύω καὶ εἴκοσι νῆας·	-- - uu -u u- - -uu --	dactylic hexameter	feminine penthemimeral, hepthemimeral, trithemimeral
τῷ δ’Ἀινιῆνες ἕποντο μενεπτόλεμοί τε Περαιβοὶ	- --u u-u u-uu- u u--	dactylic hexameter	feminine penthemimeral
οἳ περὶ Δωδώνην δυσχείμερον οἰκί’ ἔθεντο,	- uu --- --uu -u u--	dactylic hexameter	masculine penthemimeral
οἵ τ’ἀμφ’ ἱμερτὸν Τιταρησσὸν ἔργα νέμοντο	- - --- uu-- -u u--	dactylic hexameter	masculine penthemimeral
ὅς ῥ’ἐς Πηνειὸν προΐει καλλίρροον ὕδωρ,	- - --- uu- --uu --	dactylic hexameter	masculine penthemimeral, hepthemimeral
οὐδ’ ὅ γε Πηνειῷ συμμίσγεται ἀργυροδίνῃ,	- u u --- --uu -uu--	dactylic hexameter	masculine penthemimeral
ἀλλά τέ μιν καθύπερθεν ἐπιρρέει ἠΰτ’ ἔλαιον·	-u u - uu-u u-uu -u u--	dactylic hexameter	feminine penthemimeral, trithemimeral
ὅρκου γὰρ δεινοῦ Στυγὸς ὕδατός ἐστιν ἀπορρώξ.	-- - -- uu -uu -u u--	dactylic hexameter	masculine penthemimeral, trithemimeral
Μαγνήτων δ’ἦρχε Πρόθοος Τενθρηδόνος υἱός,	--- -- uu- --uu --	dactylic hexameter	masculine penthemimeral, hepthemimeral, trithemimeral
οἳ περὶ Πηνειὸν καὶ Πήλιον εἰνοσίφυλλον	- uu --- - -uu -uu--	dactylic hexameter	masculine penthemimeral
ναίεσκον· τῶν μὲν Πρόθοος θοὸς ἡγεμόνευε,	--- - - uu- uu -uu--	dactylic hexameter	masculine penthemimeral, hepthemimeral, trithemimeral
τῷ δ’ἅμα τεσσαράκοντα μέλαιναι νῆες ἕποντο.	- uu -uu-u u-- -u u--	dactylic hexameter	feminine penthemimeral
Οὗτοι ἄρ’ ἡγεμόνες Δαναῶν καὶ κοίρανοι ἦσαν·	-u u -uu- uu- - -uu --	dactylic hexameter	masculine penthemimeral, hepthemimeral
τίς τὰρ τῶν ὄχ’ ἄριστος ἔην σύ μοι ἔννεπε Μοῦσα	- - - u u-u u- u u -uu --	dactylic hexameter	feminine penthemimeral, hepthemimeral, trithemimeral
αὐτῶν ἠδ’ ἵππων, οἳ ἅμ’ Ἀτρεΐδῃσιν ἕποντο.	-- - -- u u -uu-u u--	dactylic hexameter	masculine penthemimeral, trithemimeral
Ἵπποι μὲν μέγ’ ἄρισται ἔσαν Φηρητιάδαο,	-- - u u-u u- --uu--	dactylic hexameter	feminine penthemimeral, hepthemimeral, trithemimeral
τὰς Εὔμηλος ἔλαυνε ποδώκεας ὄρνιθας ὣς	- --u u-u u-uu --- -	dactylic hexameter	feminine penthemimeral
ὄτριχας οἰέτεας σταφύληῥἐπὶ νῶτον ἐΐσας·	-uu -uu- uu-uu -u u--	dactylic hexameter	masculine penthemimeral
τὰς ἐν Πηρείῃ θρέψ’ ἀργυρότοξος Ἀπόλλων	- - --- - -uu-u u--	dactylic hexameter	masculine penthemimeral
ἄμφω θηλείας, φόβον Ἄρηος φορεούσας.	-- --- uu --- uu--	dactylic hexameter	masculine penthemimeral
Ἀνδρῶν αὖ μέγ’ ἄριστος ἔην Τελαμώνιος Αἴας	-- - u u-u u- uu-uu --	dactylic hexameter	feminine penthemimeral, hepthemimeral, trithemimeral
ὄφρ’ Ἀχιλεὺς μήνιεν· ὃ γὰρ πολὺ φέρτατος ἦεν,	- uu- --u u - uu -uu --	dactylic hexameter	feminine penthemimeral, hepthemimeral, trithemimeral
ἵπποι θ’οἳ φορέεσκον ἀμύμονα Πηλεΐωνα.	-- - uu-u u-uu -uu--	dactylic hexameter	feminine penthemimeral, trithemimeral
Ἀλλ’ ὃ μὲν ἐν νήεσσι κορωνίσι ποντοπόροισι	- u u - --u u-uu -uu--	dactylic hexameter	feminine penthemimeral, trithemimeral
κεῖτ’ ἀπομηνίσας Ἀγαμέμνονι ποιμένι λαῶν	- uu--- uu-uu -uu --	dactylic hexameter	masculine penthemimeral
Ἀτρεΐδῃ· λαοὶ δὲ παρὰ ῥηγμῖνι θαλάσσης	-uu- -- u u- --u u--	dactylic hexameter	masculine penthemimeral, hepthemimeral, trithemimeral
δίσκοισιν τέρποντο καὶ αἰγανέῃσιν ἱέντες	--- --u u -uu-u u--	dactylic hexameter	feminine penthemimeral, trithemimeral
τόξοισίν θ’·ἵπποι δὲ παρ’ ἅρμασιν οἷσιν ἕκαστος	--- -- u u -uu -u u--	dactylic hexameter	masculine penthemimeral, trithemimeral
λωτὸν ἐρεπτόμενοι ἐλεόθρεπτόν τε σέλινον	-u u-uu- uu--- u u--	dactylic hexameter	masculine penthemimeral
ἕστασαν· ἅρματα δ’εὖ πεπυκασμένα κεῖτο ἀνάκτων	-uu -uu - uu-uu -u u--	dactylic hexameter	masculine penthemimeral
ἐν κλισίῃς· οἳ δ’ἀρχὸν ἀρηΐφιλον ποθέοντες	- uu- - -u u-uu- uu--	dactylic hexameter	feminine penthemimeral, trithemimeral
φοίτων ἔνθα καὶ ἔνθα κατὰ στρατὸν οὐδὲ μάχοντο.	-- -u u -u u- uu -u u--	dactylic hexameter	feminine penthemimeral, hepthemimeral
Οἳ δ’ἄρ’ ἴσαν ὡς εἴ τε πυρὶ χθὼν πᾶσα νέμοιτο·	- u u- - - u u- - -u u--	dactylic hexameter	masculine penthemimeral, hepthemimeral, trithemimeral
γαῖα δ’ὑπεστενάχιζε Διὶ ὣς τερπικεραύνῳ	-u u-uu-u u- - -uu--	dactylic hexameter	feminine penthemimeral, hepthemimeral
χωομένῳ ὅτε τ’ἀμφὶ Τυφωέϊ γαῖαν ἱμάσσῃ	-uu- uu -u u-uu -u u--	dactylic hexameter	feminine penthemimeral, trithemimeral
εἰν Ἀρίμοις, ὅθι φασὶ Τυφωέος ἔμμεναι εὐνάς·	- uu- uu -u u-uu -uu --	dactylic hexameter	feminine penthemimeral, trithemimeral
ὣς ἄρα τῶν ὑπὸ ποσσὶ μέγα στεναχίζετο γαῖα	- uu - uu -u u- uu-uu --	dactylic hexameter	feminine penthemimeral, hepthemimeral, trithemimeral
ἐρχομένων· μάλα δ’ὦκα διέπρησσον πεδίοιο.	-uu- uu -u u--- uu--	dactylic hexameter	feminine penthemimeral, trithemimeral
Τρωσὶν δ’ἄγγελος ἦλθε ποδήνεμος ὠκέα Ἶρις	-- -uu -u u-uu -uu --	dactylic hexameter	feminine penthemimeral
πὰρ Διὸς αἰγιόχοιο σὺν ἀγγελίῃ ἀλεγεινῇ·	- uu -uu-u u -uu- uu--	dactylic hexameter	feminine penthemimeral
οἳ δ’ἀγορὰς ἀγόρευον ἐπὶ Πριάμοιο θύρῃσι	- uu- uu-u u- uu-u u--	dactylic hexameter	feminine penthemimeral, hepthemimeral, trithemimeral
πάντες ὁμηγερέες ἠμὲν νέοι ἠδὲ γέροντες·	-u u-uu- -- uu -u u--	dactylic hexameter	masculine penthemimeral, hepthemimeral
ἀγχοῦ δ’ἱσταμένη προσέφη πόδας ὠκέα Ἶρις·	-- -uu- uu- uu -uu --	dactylic hexameter	masculine penthemimeral, hepthemimeral
εἴσατο δὲ φθογγὴν υἷϊ Πριάμοιο Πολίτῃ,	-uu - -- -- uu-u u--	dactylic hexameter	masculine penthemimeral, hepthemimeral, trithemimeral
ὃς Τρώων σκοπὸς ἷζε ποδωκείῃσι πεποιθὼς	- -- uu -u u---u u--	dactylic hexameter	feminine penthemimeral, trithemimeral
τύμβῳ ἐπ’ ἀκροτάτῳ Αἰσυήταο γέροντος,	-u u -uu- ----u u--	dactylic hexameter	masculine penthemimeral
δέγμενος ὁππότε ναῦφιν ἀφορμηθεῖεν Ἀχαιοί·	-uu -uu -u u---u u--	dactylic hexameter	feminine penthemimeral
τῷ μιν ἐεισαμένη προσέφη πόδας ὠκέα Ἶρις·	- u u-uu- uu- uu -uu --	dactylic hexameter	masculine penthemimeral, hepthemimeral
ὦ γέρον αἰεί τοι μῦθοι φίλοι ἄκριτοί εἰσιν,	- uu -- - -- uu -uu --	dactylic hexameter	masculine penthemimeral, hepthemimeral
ὥς ποτ’ ἐπ’ εἰρήνης· πόλεμος δ’ἀλίαστος ὄρωρεν.	- u u --- uu- uu-u u--	dactylic hexameter	masculine penthemimeral, hepthemimeral
Ἤδη μὲν μάλα πολλὰ μάχας εἰσήλυθον ἀνδρῶν,	-- - uu -u u- --uu --	dactylic hexameter	feminine penthemimeral, hepthemimeral, trithemimeral
ἀλλ’ οὔ πω τοιόνδε τοσόνδέ τε λαὸν ὄπωπα·	- - - --u u-u u -u u--	dactylic hexameter	feminine penthemimeral, trithemimeral
λίην γὰρ φύλλοισιν ἐοικότες ἢ ψαμάθοισιν	-- - --u u-uu - uu--	dactylic hexameter	feminine penthemimeral, trithemimeral
ἔρχονται πεδίοιο μαχησόμενοι προτὶ ἄστυ.	--- uu-u u-uu- uu --	dactylic hexameter	feminine penthemimeral, trithemimeral
Ἕκτορ σοὶ δὲ μάλιστ’ ἐπιτέλλομαι, ὧδε δὲ ῥέξαι·	-- - u u- uu-uu -u u --	dactylic hexameter	masculine penthemimeral, trithemimeral
πολλοὶ γὰρ κατὰ ἄστυ μέγα Πριάμου ἐπίκουροι,	-- - uu -u u- uu- uu--	dactylic hexameter	feminine penthemimeral, hepthemimeral, trithemimeral
ἄλλη δ’ἄλλων γλῶσσα πολυσπερέων ἀνθρώπων·	-- -- -u u-uu- ---	dactylic hexameter	feminine penthemimeral
τοῖσιν ἕκαστος ἀνὴρ σημαινέτω οἷσί περ ἄρχει,	-u u-u u- --uu -u u --	dactylic hexameter	masculine penthemimeral
τῶν δ’ἐξηγείσθω κοσμησάμενος πολιήτας.	- ---- --uu- uu--	dactylic hexameter	masculine penthemimeral
Ὣς ἔφαθ’, Ἕκτωρ δ’οὔ τι θεᾶς ἔπος ἠγνοίησεν,	- uu -- - u u- uu ----	dactylic hexameter	masculine penthemimeral, hepthemimeral
αἶψα δ’ἔλυσ’ ἀγορήν· ἐπὶ τεύχεα δ’ἐσσεύοντο·	-u u- uu- uu -uu ----	dactylic hexameter	masculine penthemimeral, trithemimeral
πᾶσαι δ’ὠΐγνυντο πύλαι, ἐκ δ’ἔσσυτο λαὸς	-- ---u u- - -uu --	dactylic hexameter	feminine penthemimeral, hepthemimeral
πεζοί θ’ἱππῆές τε· πολὺς δ’ὀρυμαγδὸς ὀρώρει.	-- --- u u- uu-u u--	dactylic hexameter	masculine penthemimeral, hepthemimeral
Ἔστι δέ τις προπάροιθε πόληος αἰπεῖα κολώνη	-u u - uu-u u- --u u--	dactylic hexameter	feminine penthemimeral, hepthemimeral, trithemimeral
ἐν πεδίῳ ἀπάνευθε περίδρομος ἔνθα καὶ ἔνθα,	- uu- uu-u u-uu -u u --	dactylic hexameter	feminine penthemimeral, trithemimeral
τὴν ἤτοι ἄνδρες Βατίειαν κικλήσκουσιν,	- -- -- uu-- ----	dactylic hexameter	masculine penthemimeral, trithemimeral
ἀθάνατοι δέ τε σῆμα πολυσκάρθμοιο Μυρίνης·	-uu- u u -u u---u u--	dactylic hexameter	feminine penthemimeral, trithemimeral
ἔνθα τότε Τρῶές τε διέκριθεν ἠδ’ ἐπίκουροι.	-u u- -- u u-uu - uu--	dactylic hexameter	masculine penthemimeral, trithemimeral
Τρωσὶ μὲν ἡγεμόνευε μέγας κορυθαίολος Ἕκτωρ	-u u -uu-u u- uu-uu --	dactylic hexameter	feminine penthemimeral, hepthemimeral
Πριαμίδης· ἅμα τῷ γε πολὺ πλεῖστοι καὶ ἄριστοι	-uu- uu - u u- -- u u--	dactylic hexameter	masculine penthemimeral, hepthemimeral, trithemimeral
λαοὶ θωρήσσοντο μεμαότες ἐγχείῃσι.	-- ---u u-uu ----	dactylic hexameter	feminine penthemimeral
Δαρδανίων αὖτ’ ἦρχεν ἐῢς πάϊς Ἀγχίσαο	-uu- - -u u- uu ----	dactylic hexameter	feminine penthemimeral, hepthemimeral, trithemimeral
Αἰνείας, τὸν ὑπ’ Ἀγχίσῃ τέκε δῖ’ Ἀφροδίτη	--- u u --- uu - uu--	dactylic hexameter	hepthemimeral, trithemimeral
Ἴδης ἐν κνημοῖσι θεὰ βροτῷ εὐνηθεῖσα,	-- - --u u- uu ----	dactylic hexameter	feminine penthemimeral, hepthemimeral, trithemimeral
οὐκ οἶος, ἅμα τῷ γε δύω Ἀντήνορος υἷε	- -- uu - u u- --uu --	dactylic hexameter	masculine penthemimeral, hepthemimeral, trithemimeral
Ἀρχέλοχός τ’Ἀκάμας τε μάχης εὖ εἰδότε πάσης.	-uu- uu- u u- - -uu --	dactylic hexameter	masculine penthemimeral, hepthemimeral, trithemimeral
Οἳ δὲ Ζέλειαν ἔναιον ὑπαὶ πόδα νείατον Ἴδης	- u u-u u-u u- uu -uu --	dactylic hexameter	feminine penthemimeral, hepthemimeral
ἀφνειοὶ πίνοντες ὕδωρ μέλαν Αἰσήποιο	--- --u u- uu ----	dactylic hexameter	feminine penthemimeral, hepthemimeral, trithemimeral
Τρῶες, τῶν αὖτ’ ἦρχε Λυκάονος ἀγλαὸς υἱὸς	-- - - -u u-uu -uu --	dactylic hexameter	feminine penthemimeral, trithemimeral
Πάνδαρος, ᾧ καὶ τόξον Ἀπόλλων αὐτὸς ἔδωκεν.	-uu - - -u u-- -u u--	dactylic hexameter	feminine penthemimeral, trithemimeral
Οἳ δ’Ἀδρήστειάν τ’εἶχον καὶ δῆμον Ἀπαισοῦ	- ---- -- - -u u--	dactylic hexameter	masculine penthemimeral, hepthemimeral
καὶ Πιτύειαν ἔχον καὶ Τηρείης ὄρος αἰπύ,	- uu-u u- - --- uu --	dactylic hexameter	masculine penthemimeral
τῶν ἦρχ’ Ἄδρηστός τε καὶ Ἄμφιος λινοθώρηξ	- - --- u u --- uu--	dactylic hexameter	masculine penthemimeral
υἷε δύω Μέροπος Περκωσίου, ὃς περὶ πάντων	-u u- uu- --uu - uu --	dactylic hexameter	masculine penthemimeral, trithemimeral
ᾔδεε μαντοσύνας, οὐδὲ οὓς παῖδας ἔασκε	-uu -uu- -- - -u u--	dactylic hexameter	masculine penthemimeral, hepthemimeral
στείχειν ἐς πόλεμον φθισήνορα· τὼ δέ οἱ οὔ τι	-- - uu- --uu - u u - -	dactylic hexameter	masculine penthemimeral, trithemimeral
πειθέσθην· κῆρες γὰρ ἄγον μέλανος θανάτοιο.	--- -- u u- uu- uu--	dactylic hexameter	masculine penthemimeral, hepthemimeral, trithemimeral
Οἳ δ’ἄρα Περκώτην καὶ Πράκτιον ἀμφενέμοντο	- uu --- - -uu -uu--	dactylic hexameter	masculine penthemimeral
καὶ Σηστὸν καὶ Ἄβυδον ἔχον καὶ δῖαν Ἀρίσβην,	- -- u u-u u- - -u u--	dactylic hexameter	feminine penthemimeral, hepthemimeral, trithemimeral
τῶν αὖθ’ Ὑρτακίδης ἦρχ’ Ἄσιος ὄρχαμος ἀνδρῶν,	- - -uu- - -uu -uu --	dactylic hexameter	masculine penthemimeral
Ἄσιος Ὑρτακίδης ὃν Ἀρίσβηθεν φέρον ἵπποι	-uu -uu- u u--- uu --	dactylic hexameter	masculine penthemimeral
αἴθωνες μεγάλοι ποταμοῦ ἄπο Σελλήεντος.	--- uu- uu- uu ----	dactylic hexameter	masculine penthemimeral, hepthemimeral, trithemimeral
Ἱππόθοος δ’ἄγε φῦλα Πελασγῶν ἐγχεσιμώρων	-uu- uu -u u-- -uu--	dactylic hexameter	feminine penthemimeral, trithemimeral
τῶν οἳ Λάρισαν ἐριβώλακα ναιετάασκον·	- - --- uu-uu -uu--	dactylic hexameter	masculine penthemimeral
τῶν ἦρχ’ Ἱππόθοός τε Πύλαιός τ’ὄζος Ἄρηος,	- - -uu- u u-- -u u--	dactylic hexameter	masculine penthemimeral
υἷε δύω Λήθοιο Πελασγοῦ Τευταμίδαο.	-u u- --u u-- -uu--	dactylic hexameter	feminine penthemimeral, trithemimeral
Αὐτὰρ Θρήϊκας ἦγ’ Ἀκάμας καὶ Πείροος ἥρως	-- -uu - uu- - -uu --	dactylic hexameter	masculine penthemimeral, hepthemimeral
ὅσσους Ἑλλήσποντος ἀγάρροος ἐντὸς ἐέργει	-- ---u u-uu -u u--	dactylic hexameter	feminine penthemimeral
Εὔφημος δ’ἀρχὸς Κικόνων ἦν αἰχμητάων	--- -- uu- - ----	dactylic hexameter	masculine penthemimeral, hepthemimeral, trithemimeral
υἱὸς Τροιζήνοιο διοτρεφέος Κεάδαο.	-- ---u u-uu- uu--	dactylic hexameter	feminine penthemimeral
Αὐτὰρ Πυραίχμης ἄγε Παίονας ἀγκυλοτόξους	-- --- uu -uu -uu--	dactylic hexameter	masculine penthemimeral
τηλόθεν ἐξ Ἀμυδῶνος ἀπ’ Ἀξιοῦ εὐρὺ ῥέοντος,	-uu - uu-u u -uu -u u--	dactylic hexameter	feminine penthemimeral, trithemimeral
Ἀξιοῦ οὗ κάλλιστον ὕδωρ ἐπικίδναται αἶαν.	-uu - --u u- uu-uu --	dactylic hexameter	feminine penthemimeral, hepthemimeral, trithemimeral
Παφλαγόνων δ’ἡγεῖτο Πυλαιμένεος λάσιον κῆρ	-uu- --u u-uu- uu- -	dactylic hexameter	feminine penthemimeral, trithemimeral
ἐξ Ἐνετῶν, ὅθεν ἡμιόνων γένος ἀγροτεράων,	- uu- uu -uu- uu -uu--	dactylic hexameter	hepthemimeral, trithemimeral
οἵ ῥα Κύτωρον ἔχον καὶ Σήσαμον ἀμφενέμοντο	- u u-u u- - -uu -uu--	dactylic hexameter	masculine penthemimeral
ἀμφί τε Παρθένιον ποταμὸν κλυτὰ δώματ’ ἔναιον	-u u -uu- uu- uu -u u--	dactylic hexameter	masculine penthemimeral, hepthemimeral
Κρῶμνάν τ’Αἰγιαλόν τε καὶ ὑψηλοὺς Ἐρυθίνους.	-- -uu- u u --- uu--	dactylic hexameter	masculine penthemimeral
Αὐτὰρ Ἁλιζώνων Ὀδίος καὶ Ἐπίστροφος ἦρχον	-u u--- uu- u u-uu --	dactylic hexameter	masculine penthemimeral, hepthemimeral
τηλόθεν ἐξ Ἀλύβης, ὅθεν ἀργύρου ἐστὶ γενέθλη.	-uu - uu- uu -uu -u u--	dactylic hexameter	masculine penthemimeral, trithemimeral
Μυσῶν δὲ Χρόμις ἦρχε καὶ Ἔννομος οἰωνιστής·	-- - uu -u u -uu ----	dactylic hexameter	feminine penthemimeral, trithemimeral
ἀλλ’ οὐκ οἰωνοῖσιν ἐρύσατο κῆρα μέλαιναν,	- - ---u u-uu -u u--	dactylic hexameter	feminine penthemimeral
ἀλλ’ ἐδάμη ὑπὸ χερσὶ ποδώκεος Αἰακίδαο	- uu- uu -u u-uu -uu--	dactylic hexameter	feminine penthemimeral, trithemimeral
ἐν ποταμῷ, ὅθι περ Τρῶας κεράϊζε καὶ ἄλλους.	- uu- uu - -- uu-u u --	dactylic hexameter	masculine penthemimeral, hepthemimeral, trithemimeral
Φόρκυς αὖ Φρύγας ἦγε καὶ Ἀσκάνιος θεοειδὴς	-- - uu -u u -uu- uu--	dactylic hexameter	feminine penthemimeral, trithemimeral
τῆλ’ ἐξ Ἀσκανίης· μέμασαν δ’ὑσμῖνι μάχεσθαι.	- - -uu- uu- --u u--	dactylic hexameter	masculine penthemimeral, hepthemimeral
Μῄοσιν αὖ Μέσθλης τε καὶ Ἄντιφος ἡγησάσθην	-uu - -- u u -uu ----	dactylic hexameter	masculine penthemimeral, trithemimeral
υἷε Ταλαιμένεος τὼ Γυγαίη τέκε λίμνη,	-u u-uu- - --- uu --	dactylic hexameter	masculine penthemimeral
οἳ καὶ Μῄονας ἦγον ὑπὸ Τμώλῳ γεγαῶτας.	- - -uu -u u- -- uu--	dactylic hexameter	feminine penthemimeral, hepthemimeral
Νάστης αὖ Καρῶν ἡγήσατο βαρβαροφώνων,	-- - -- --uu -uu--	dactylic hexameter	masculine penthemimeral, trithemimeral
οἳ Μίλητον ἔχον Φθιρῶν τ’ὄρος ἀκριτόφυλλον	- --u u- -- uu -uu--	dactylic hexameter	masculine penthemimeral, hepthemimeral
Μαιάνδρου τε ῥοὰς Μυκάλης τ’αἰπεινὰ κάρηνα·	--- u u- uu- --u u--	dactylic hexameter	masculine penthemimeral, hepthemimeral, trithemimeral
τῶν μὲν ἄρ’ Ἀμφίμαχος καὶ Νάστης ἡγησάσθην,	- u u -uu- - -- ----	dactylic hexameter	masculine penthemimeral
Νάστης Ἀμφίμαχός τε Νομίονος ἀγλαὰ τέκνα,	-- -uu- u u-uu -uu --	dactylic hexameter	masculine penthemimeral
ὃς καὶ χρυσὸν ἔχων πόλεμον δ’ἴεν ἠΰτε κούρη	- - -u u- uu- uu -uu --	dactylic hexameter	masculine penthemimeral, hepthemimeral
νήπιος, οὐδέ τί οἱ τό γ’ἐπήρκεσε λυγρὸν ὄλεθρον,	-uu -u u - u u-uu -u u--	dactylic hexameter	masculine penthemimeral
ἀλλ’ ἐδάμη ὑπὸ χερσὶ ποδώκεος Αἰακίδαο	- uu- uu -u u-uu -uu--	dactylic hexameter	feminine penthemimeral, trithemimeral
ἐν ποταμῷ, χρυσὸν δ’Ἀχιλεὺς ἐκόμισσε δαΐφρων.	- uu- -- uu- uu-u u--	dactylic hexameter	masculine penthemimeral, hepthemimeral, trithemimeral
Σαρπηδὼν δ’ἦρχεν Λυκίων καὶ Γλαῦκος ἀμύμων	--- -- uu- - -u u--	dactylic hexameter	masculine penthemimeral, hepthemimeral, trithemimeral
τηλόθεν ἐκ Λυκίης, Ξάνθου ἄπο δινήεντος.	-uu - uu- -- uu ----	dactylic hexameter	masculine penthemimeral, hepthemimeral, trithemimeral
