ὣς οἳ μὲν κατὰ ἄστυ πεφυζότες ἠΰτε νεβροὶ	- - - uu -u u-uu -uu --	dactylic hexameter	feminine penthemimeral, trithemimeral
ἱδρῶ ἀπεψύχοντο πίον τ’ἀκέοντό τε δίψαν	-u u---u u- uu-u u --	dactylic hexameter	feminine penthemimeral, hepthemimeral
κεκλιμένοι καλῇσιν ἐπάλξεσιν· αὐτὰρ Ἀχαιοὶ	-uu- --u u-uu -u u--	dactylic hexameter	feminine penthemimeral, trithemimeral
τείχεος ἆσσον ἴσαν σάκε’ ὤμοισι κλίναντες.	-uu -u u- uu --- ---	dactylic hexameter	masculine penthemimeral
Ἕκτορα δ’αὐτοῦ μεῖναι ὀλοιὴ μοῖρα πέδησεν	-uu -- -u u-- -u u--	dactylic hexameter	feminine penthemimeral
Ἰλίου προπάροιθε πυλάων τε Σκαιάων.	--- uu-u u-- - ---	dactylic hexameter	feminine penthemimeral, trithemimeral
αὐτὰρ Πηλείωνα προσηύδα Φοῖβος Ἀπόλλων·	-- ---u u-- -u u--	dactylic hexameter	feminine penthemimeral
τίπτέ με Πηλέος υἱὲ ποσὶν ταχέεσσι διώκεις	-u u -uu -u u- uu-u u--	dactylic hexameter	feminine penthemimeral, hepthemimeral
αὐτὸς θνητὸς ἐὼν θεὸν ἄμβροτον; οὐδέ νύ πώ με	-- -u u- uu -uu -u u - -	dactylic hexameter	masculine penthemimeral
ἔγνως ὡς θεός εἰμι, σὺ δ’ἀσπερχὲς μενεαίνεις.	-- - uu -u u --- uu--	dactylic hexameter	feminine penthemimeral, trithemimeral
ἦ νύ τοι οὔ τι μέλει Τρώων πόνος, οὓς ἐφόβησας,	- u u - u u- -- uu - uu--	dactylic hexameter	masculine penthemimeral, hepthemimeral, trithemimeral
οἳ δή τοι εἰς ἄστυ ἄλεν, σὺ δὲ δεῦρο λιάσθης.	- - - - -u u- u u -u u--	dactylic hexameter	feminine penthemimeral, hepthemimeral, trithemimeral
οὐ μέν με κτενέεις, ἐπεὶ οὔ τοι μόρσιμός εἰμι.	- - - uu- uu - - -uu --	dactylic hexameter	masculine penthemimeral, hepthemimeral, trithemimeral
τὸν δὲ μέγ’ ὀχθήσας προσέφη πόδας ὠκὺς Ἀχιλλεύς·	- u u --- uu- uu -u u--	dactylic hexameter	masculine penthemimeral, hepthemimeral
ἔβλαψάς μ’ἑκάεργε θεῶν ὀλοώτατε πάντων	--- uu-u u- uu-uu --	dactylic hexameter	feminine penthemimeral, hepthemimeral, trithemimeral
ἐνθάδε νῦν τρέψας ἀπὸ τείχεος· ἦ κ’ἔτι πολλοὶ	-uu - -- uu -uu - uu --	dactylic hexameter	masculine penthemimeral, trithemimeral
γαῖαν ὀδὰξ εἷλον πρὶν Ἴλιον εἰσαφικέσθαι.	-u u- -- - -uu -uu--	dactylic hexameter	masculine penthemimeral, trithemimeral
νῦν δ’ἐμὲ μὲν μέγα κῦδος ἀφείλεο, τοὺς δὲ σάωσας	- uu - uu -u u-uu - u u--	dactylic hexameter	feminine penthemimeral, trithemimeral
ῥηϊδίως, ἐπεὶ οὔ τι τίσιν γ’ἔδεισας ὀπίσσω.	-uu- uu - u u- --u u--	dactylic hexameter	masculine penthemimeral, hepthemimeral, trithemimeral
ἦ σ’ἂν τισαίμην, εἴ μοι δύναμίς γε παρείη.	- - --- - - uu- u u--	dactylic hexameter	masculine penthemimeral, hepthemimeral
ὣς εἰπὼν προτὶ ἄστυ μέγα φρονέων ἐβεβήκει,	- -- uu -u u- uu- uu--	dactylic hexameter	feminine penthemimeral, hepthemimeral, trithemimeral
σευάμενος ὥς θ’ἵππος ἀεθλοφόρος σὺν ὄχεσφιν,	-uu- - -u u-uu- u u--	dactylic hexameter	feminine penthemimeral, trithemimeral
ὅς ῥά τε ῥεῖα θέῃσι τιταινόμενος πεδίοιο·	- u u -u u-u u-uu- uu--	dactylic hexameter	feminine penthemimeral
ὣς Ἀχιλεὺς λαιψηρὰ πόδας καὶ γούνατ’ ἐνώμα.	- uu- --u u- - -u u--	dactylic hexameter	feminine penthemimeral, hepthemimeral, trithemimeral
τὸν δ’ὃ γέρων Πρίαμος πρῶτος ἴδεν ὀφθαλμοῖσι	- u u- uu- -- uu ----	dactylic hexameter	masculine penthemimeral, hepthemimeral, trithemimeral
παμφαίνονθ’ ὥς τ’ἀστέρ’ ἐπεσσύμενον πεδίοιο,	--- - -u u-uu- uu--	dactylic hexameter	feminine penthemimeral, trithemimeral
ὅς ῥά τ’ὀπώρης εἶσιν, ἀρίζηλοι δέ οἱ αὐγαὶ	- u u-- -u u--- u u --	dactylic hexameter	feminine penthemimeral
φαίνονται πολλοῖσι μετ’ ἀστράσι νυκτὸς ἀμολγῷ,	--- --u u -uu -u u--	dactylic hexameter	feminine penthemimeral, trithemimeral
ὅν τε κύν’ Ὠρίωνος ἐπίκλησιν καλέουσι.	- u u ---u u--- uu--	dactylic hexameter	feminine penthemimeral
λαμπρότατος μὲν ὅ γ’ἐστί, κακὸν δέ τε σῆμα τέτυκται,	-uu- u u -u u- u u -u u--	dactylic hexameter	feminine penthemimeral, hepthemimeral, trithemimeral
καί τε φέρει πολλὸν πυρετὸν δειλοῖσι βροτοῖσιν·	- u u- -- uu- --u u--	dactylic hexameter	masculine penthemimeral, hepthemimeral, trithemimeral
ὣς τοῦ χαλκὸς ἔλαμπε περὶ στήθεσσι θέοντος.	- - -u u-u u- --u u--	dactylic hexameter	feminine penthemimeral, hepthemimeral
ᾤμωξεν δ’ὃ γέρων, κεφαλὴν δ’ὅ γε κόψατο χερσὶν	--- u u- uu- u u -uu --	dactylic hexameter	masculine penthemimeral, hepthemimeral, trithemimeral
ὑψόσ’ ἀνασχόμενος, μέγα δ’οἰμώξας ἐγεγώνει	-u u-uu- uu --- uu--	dactylic hexameter	masculine penthemimeral
λισσόμενος φίλον υἱόν· ὃ δὲ προπάροιθε πυλάων	-uu- uu -u u - uu-u u--	dactylic hexameter	feminine penthemimeral, hepthemimeral, trithemimeral
ἑστήκει ἄμοτον μεμαὼς Ἀχιλῆϊ μάχεσθαι·	--- uu- uu- uu-u u--	dactylic hexameter	masculine penthemimeral, hepthemimeral, trithemimeral
τὸν δ’ὃ γέρων ἐλεεινὰ προσηύδα χεῖρας ὀρεγνύς·	- u u- uu-u u-- -u u--	dactylic hexameter	feminine penthemimeral, trithemimeral
Ἕκτορ μή μοι μίμνε φίλον τέκος ἀνέρα τοῦτον	-- - - -u u- uu -uu --	dactylic hexameter	feminine penthemimeral, hepthemimeral, trithemimeral
οἶος ἄνευθ’ ἄλλων, ἵνα μὴ τάχα πότμον ἐπίσπῃς	-u u- -- uu - uu -u u--	dactylic hexameter	masculine penthemimeral, hepthemimeral, trithemimeral
Πηλεΐωνι δαμείς, ἐπεὶ ἦ πολὺ φέρτερός ἐστι	-uu-u u- uu - uu -uu --	dactylic hexameter	masculine penthemimeral, hepthemimeral
σχέτλιος· αἴθε θεοῖσι φίλος τοσσόνδε γένοιτο	-uu -u u-u u- --u u--	dactylic hexameter	feminine penthemimeral, hepthemimeral
ὅσσον ἐμοί· τάχα κέν ἑ κύνες καὶ γῦπες ἔδοιεν	-u u- uu - u u- - -u u--	dactylic hexameter	masculine penthemimeral, hepthemimeral, trithemimeral
κείμενον· ἦ κέ μοι αἰνὸν ἀπὸ πραπίδων ἄχος ἔλθοι·	-uu - u u -u u- uu- uu --	dactylic hexameter	feminine penthemimeral, hepthemimeral, trithemimeral
ὅς μ’υἱῶν πολλῶν τε καὶ ἐσθλῶν εὖνιν ἔθηκε	- -- -- u u -- -u u--	dactylic hexameter	masculine penthemimeral, trithemimeral
κτείνων καὶ περνὰς νήσων ἔπι τηλεδαπάων.	-- - -- -- uu -uu--	dactylic hexameter	masculine penthemimeral, hepthemimeral, trithemimeral
καὶ γὰρ νῦν δύο παῖδε Λυκάονα καὶ Πολύδωρον	- - - uu -u u-uu - uu--	dactylic hexameter	feminine penthemimeral, trithemimeral
οὐ δύναμαι ἰδέειν Τρώων εἰς ἄστυ ἀλέντων,	- uu- uu- -- - -u u--	dactylic hexameter	masculine penthemimeral, hepthemimeral, trithemimeral
τούς μοι Λαοθόη τέκετο κρείουσα γυναικῶν.	- - -uu- uu- --u u--	dactylic hexameter	masculine penthemimeral, hepthemimeral
ἀλλ’ εἰ μὲν ζώουσι μετὰ στρατῷ, ἦ τ’ἂν ἔπειτα	- - - --u u- uu - u u--	dactylic hexameter	feminine penthemimeral, hepthemimeral, trithemimeral
χαλκοῦ τε χρυσοῦ τ’ἀπολυσόμεθ’, ἔστι γὰρ ἔνδον·	-- - -- uu-uu -u u --	dactylic hexameter	masculine penthemimeral, trithemimeral
πολλὰ γὰρ ὤπασε παιδὶ γέρων ὀνομάκλυτος Ἄλτης.	-u u -uu -u u- uu-uu --	dactylic hexameter	feminine penthemimeral, hepthemimeral
εἰ δ’ἤδη τεθνᾶσι καὶ εἰν Ἀΐδαο δόμοισιν,	- -- --u u - uu-u u--	dactylic hexameter	feminine penthemimeral, hepthemimeral, trithemimeral
ἄλγος ἐμῷ θυμῷ καὶ μητέρι τοὶ τεκόμεσθα·	-u u- -- - -uu - uu--	dactylic hexameter	masculine penthemimeral, trithemimeral
λαοῖσιν δ’ἄλλοισι μινυνθαδιώτερον ἄλγος	--- --u u-uu-uu --	dactylic hexameter	feminine penthemimeral, trithemimeral
ἔσσεται, ἢν μὴ καὶ σὺ θάνῃς Ἀχιλῆϊ δαμασθείς.	-uu - - - u u- uu-u u--	dactylic hexameter	masculine penthemimeral, hepthemimeral, trithemimeral
ἀλλ’ εἰσέρχεο τεῖχος ἐμὸν τέκος, ὄφρα σαώσῃς	- --uu -u u- uu -u u--	dactylic hexameter	feminine penthemimeral, hepthemimeral
Τρῶας καὶ Τρῳάς, μὴ δὲ μέγα κῦδος ὀρέξῃς	-- - -- - - uu -u u--	dactylic hexameter	masculine penthemimeral, hepthemimeral, trithemimeral
Πηλεΐδῃ, αὐτὸς δὲ φίλης αἰῶνος ἀμερθῇς.	-uu- -- u u- --u u--	dactylic hexameter	masculine penthemimeral, hepthemimeral, trithemimeral
πρὸς δ’ἐμὲ τὸν δύστηνον ἔτι φρονέοντ’ ἐλέησον	- uu - --u u- uu- uu--	dactylic hexameter	feminine penthemimeral, hepthemimeral, trithemimeral
δύσμορον, ὅν ῥα πατὴρ Κρονίδης ἐπὶ γήραος οὐδῷ	-uu - u u- uu- uu -uu --	dactylic hexameter	masculine penthemimeral, hepthemimeral, trithemimeral
αἴσῃ ἐν ἀργαλέῃ φθίσει κακὰ πόλλ’ ἐπιδόντα	-u u -uu- -- uu - uu--	dactylic hexameter	masculine penthemimeral, hepthemimeral
υἷάς τ’ὀλλυμένους ἑλκηθείσας τε θύγατρας,	-- -uu- ---- u u--	dactylic hexameter	masculine penthemimeral
καὶ θαλάμους κεραϊζομένους, καὶ νήπια τέκνα	- uu- uu-uu- - -uu --	dactylic hexameter	hepthemimeral, trithemimeral
βαλλόμενα προτὶ γαίῃ ἐν αἰνῇ δηϊοτῆτι,	-uu- uu -u u -- -uu--	dactylic hexameter	feminine penthemimeral, trithemimeral
ἑλκομένας τε νυοὺς ὀλοῇς ὑπὸ χερσὶν Ἀχαιῶν.	-uu- u u- uu- uu -u u--	dactylic hexameter	masculine penthemimeral, hepthemimeral, trithemimeral
αὐτὸν δ’ἂν πύματόν με κύνες πρώτῃσι θύρῃσιν	-- - uu- u u- --u u--	dactylic hexameter	masculine penthemimeral, hepthemimeral, trithemimeral
ὠμησταὶ ἐρύουσιν, ἐπεί κέ τις ὀξέϊ χαλκῷ	--- uu-u u- u u -uu --	dactylic hexameter	feminine penthemimeral, hepthemimeral, trithemimeral
τύψας ἠὲ βαλὼν ῥεθέων ἐκ θυμὸν ἕληται,	-- -u u- uu- - -u u--	dactylic hexameter	masculine penthemimeral, hepthemimeral
οὓς τρέφον ἐν μεγάροισι τραπεζῆας θυραωρούς,	- uu - uu-u u--- uu--	dactylic hexameter	feminine penthemimeral, trithemimeral
οἵ κ’ἐμὸν αἷμα πιόντες ἀλύσσοντες περὶ θυμῷ	- uu -u u-u u--- uu --	dactylic hexameter	feminine penthemimeral
κείσοντ’ ἐν προθύροισι. νέῳ δέ τε πάντ’ ἐπέοικεν	-- - uu-u u- u u - uu--	dactylic hexameter	feminine penthemimeral, hepthemimeral, trithemimeral
ἄρηϊ κταμένῳ δεδαϊγμένῳ ὀξέϊ χαλκῷ	--- uu- uu-uu -uu --	dactylic hexameter	masculine penthemimeral, trithemimeral
κεῖσθαι· πάντα δὲ καλὰ θανόντι περ ὅττι φανήῃ·	-- -u u -u u-u u -u u--	dactylic hexameter	feminine penthemimeral
ἀλλ’ ὅτε δὴ πολιόν τε κάρη πολιόν τε γένειον	- uu - uu- u u- uu- u u--	dactylic hexameter	masculine penthemimeral, hepthemimeral, trithemimeral
αἰδῶ τ’αἰσχύνωσι κύνες κταμένοιο γέροντος,	-- ---u u- uu-u u--	dactylic hexameter	feminine penthemimeral, hepthemimeral
τοῦτο δὴ οἴκτιστον πέλεται δειλοῖσι βροτοῖσιν.	-u u --- uu- --u u--	dactylic hexameter	masculine penthemimeral, hepthemimeral
ἦ ῥ’ὃ γέρων, πολιὰς δ’ἄρ’ ἀνὰ τρίχας ἕλκετο χερσὶ	- u u- uu- u u- uu -uu --	dactylic hexameter	masculine penthemimeral, hepthemimeral, trithemimeral
τίλλων ἐκ κεφαλῆς· οὐδ’ Ἕκτορι θυμὸν ἔπειθε.	-- - uu- - -uu -u u--	dactylic hexameter	masculine penthemimeral, trithemimeral
μήτηρ δ’αὖθ’ ἑτέρωθεν ὀδύρετο δάκρυ χέουσα	-- - uu-u u-uu -u u--	dactylic hexameter	feminine penthemimeral, trithemimeral
κόλπον ἀνιεμένη, ἑτέρηφι δὲ μαζὸν ἀνέσχε·	-u u-uu- uu-u u -u u--	dactylic hexameter	masculine penthemimeral
καί μιν δάκρυ χέουσ’ ἔπεα πτερόεντα προσηύδα·	- - -u u- uu- uu-u u--	dactylic hexameter	masculine penthemimeral, hepthemimeral
Ἕκτορ τέκνον ἐμὸν τάδε τ’αἴδεο καί μ’ἐλέησον	-- -u u- uu -uu - uu--	dactylic hexameter	masculine penthemimeral
αὐτήν, εἴ ποτέ τοι λαθικηδέα μαζὸν ἐπέσχον·	-- - uu - uu-uu -u u--	dactylic hexameter	masculine penthemimeral, trithemimeral
τῶν μνῆσαι φίλε τέκνον ἄμυνε δὲ δήϊον ἄνδρα	- -- uu -u u-u u -uu --	dactylic hexameter	feminine penthemimeral, trithemimeral
τείχεος ἐντὸς ἐών, μὴ δὲ πρόμος ἵστασο τούτῳ	-uu -u u- - - uu -uu --	dactylic hexameter	masculine penthemimeral, hepthemimeral
σχέτλιος· εἴ περ γάρ σε κατακτάνῃ, οὔ σ’ἔτ’ ἔγωγε	-uu - - - u u-uu - u u--	dactylic hexameter	masculine penthemimeral, trithemimeral
κλαύσομαι ἐν λεχέεσσι φίλον θάλος, ὃν τέκον αὐτή,	-uu - uu-u u- uu - uu --	dactylic hexameter	feminine penthemimeral, hepthemimeral, trithemimeral
οὐδ’ ἄλοχος πολύδωρος· ἄνευθε δέ σε μέγα νῶϊν	- uu- uu-u u-u u - uu --	dactylic hexameter	feminine penthemimeral, trithemimeral
Ἀργείων παρὰ νηυσὶ κύνες ταχέες κατέδονται.	--- uu -u u- uu- uu--	dactylic hexameter	feminine penthemimeral, hepthemimeral, trithemimeral
ὣς τώ γε κλαίοντε προσαυδήτην φίλον υἱὸν	- - - --u u--- uu --	dactylic hexameter	feminine penthemimeral, trithemimeral
πολλὰ λισσομένω· οὐδ’ Ἕκτορι θυμὸν ἔπειθον,	-- -uu- - -uu -u u--	dactylic hexameter	masculine penthemimeral
ἀλλ’ ὅ γε μίμν’ Ἀχιλῆα πελώριον ἆσσον ἰόντα.	- u u - uu-u u-uu -u u--	dactylic hexameter	feminine penthemimeral, trithemimeral
ὡς δὲ δράκων ἐπὶ χειῇ ὀρέστερος ἄνδρα μένῃσι	- u u- uu -u u-uu -u u--	dactylic hexameter	feminine penthemimeral, trithemimeral
βεβρωκὼς κακὰ φάρμακ’, ἔδυ δέ τέ μιν χόλος αἰνός,	--- uu -u u- u u - uu --	dactylic hexameter	feminine penthemimeral, hepthemimeral, trithemimeral
σμερδαλέον δὲ δέδορκεν ἑλισσόμενος περὶ χειῇ·	-uu- u u-u u-uu- uu --	dactylic hexameter	feminine penthemimeral, trithemimeral
ὣς Ἕκτωρ ἄσβεστον ἔχων μένος οὐχ ὑπεχώρει	- -- --u u- uu - uu--	dactylic hexameter	feminine penthemimeral, hepthemimeral, trithemimeral
πύργῳ ἔπι προὔχοντι φαεινὴν ἀσπίδ’ ἐρείσας·	-u u- --u u-- -u u--	dactylic hexameter	feminine penthemimeral, trithemimeral
ὀχθήσας δ’ἄρα εἶπε πρὸς ὃν μεγαλήτορα θυμόν·	--- uu -u u - uu-uu --	dactylic hexameter	feminine penthemimeral, hepthemimeral, trithemimeral
ὤ μοι ἐγών, εἰ μέν κε πύλας καὶ τείχεα δύω,	- u u- - - u u- - -uu --	dactylic hexameter	masculine penthemimeral, hepthemimeral, trithemimeral
Πουλυδάμας μοι πρῶτος ἐλεγχείην ἀναθήσει,	-uu- - -u u--- uu--	dactylic hexameter	feminine penthemimeral, trithemimeral
ὅς μ’ἐκέλευε Τρωσὶ ποτὶ πτόλιν ἡγήσασθαι	- uu-- -u u- uu ----	dactylic hexameter	feminine penthemimeral, hepthemimeral
νύχθ’ ὕπο τήνδ’ ὀλοὴν ὅτε τ’ὤρετο δῖος Ἀχιλλεύς.	- uu - uu- uu -uu -u u--	dactylic hexameter	masculine penthemimeral, trithemimeral
ἀλλ’ ἐγὼ οὐ πιθόμην· ἦ τ’ἂν πολὺ κέρδιον ἦεν.	- uu - uu- - - uu -uu --	dactylic hexameter	masculine penthemimeral, hepthemimeral, trithemimeral
νῦν δ’ἐπεὶ ὤλεσα λαὸν ἀτασθαλίῃσιν ἐμῇσιν,	- uu -uu -u u-uu-u u--	dactylic hexameter	feminine penthemimeral
αἰδέομαι Τρῶας καὶ Τρῳάδας ἑλκεσιπέπλους,	-uu- -- - -uu -uu--	dactylic hexameter	masculine penthemimeral, trithemimeral
μή ποτέ τις εἴπῃσι κακώτερος ἄλλος ἐμεῖο·	- uu - --u u-uu -u u--	dactylic hexameter	feminine penthemimeral, trithemimeral
Ἕκτωρ ἧφι βίηφι πιθήσας ὤλεσε λαόν.	-- -u u-u u-- -uu --	dactylic hexameter	feminine penthemimeral
ὣς ἐρέουσιν· ἐμοὶ δὲ τότ’ ἂν πολὺ κέρδιον εἴη	- uu-u u- u u - uu -uu --	dactylic hexameter	masculine penthemimeral, hepthemimeral
ἄντην ἢ Ἀχιλῆα κατακτείναντα νέεσθαι,	-- - uu-u u---u u--	dactylic hexameter	feminine penthemimeral, trithemimeral
ἠέ κεν αὐτῷ ὀλέσθαι ἐϋκλειῶς πρὸ πόληος.	-u u -u u-u u--- u u--	dactylic hexameter	feminine penthemimeral
εἰ δέ κεν ἀσπίδα μὲν καταθείομαι ὀμφαλόεσσαν	- u u -uu - uu-uu -uu--	dactylic hexameter	masculine penthemimeral
καὶ κόρυθα βριαρήν, δόρυ δὲ πρὸς τεῖχος ἐρείσας	- uu- uu- uu - - -u u--	dactylic hexameter	masculine penthemimeral, hepthemimeral, trithemimeral
αὐτὸς ἰὼν Ἀχιλῆος ἀμύμονος ἀντίος ἔλθω	-u u- uu-u u-uu -uu --	dactylic hexameter	feminine penthemimeral, trithemimeral
καί οἱ ὑπόσχωμαι Ἑλένην καὶ κτήμαθ’ ἅμ’ αὐτῇ,	- u u--- uu- - -u u --	dactylic hexameter	masculine penthemimeral, hepthemimeral
πάντα μάλ’ ὅσσά τ’Ἀλέξανδρος κοίλῃς ἐνὶ νηυσὶν	-u u -u u--- -- uu --	dactylic hexameter	hepthemimeral
ἠγάγετο Τροίηνδ’, ἥ τ’ἔπλετο νείκεος ἀρχή,	-uu- -- - -uu -uu --	dactylic hexameter	masculine penthemimeral, trithemimeral
δωσέμεν Ἀτρεΐδῃσιν ἄγειν, ἅμα δ’ἀμφὶς Ἀχαιοῖς	-uu -uu-u u- uu -u u--	dactylic hexameter	feminine penthemimeral, hepthemimeral
ἄλλ’ ἀποδάσσεσθαι ὅσα τε πτόλις ἥδε κέκευθε·	- uu--- uu - uu -u u--	dactylic hexameter	masculine penthemimeral, hepthemimeral
Τρωσὶν δ’αὖ μετόπισθε γερούσιον ὅρκον ἕλωμαι	-- - uu-u u-uu -u u--	dactylic hexameter	feminine penthemimeral, trithemimeral
μή τι κατακρύψειν, ἀλλ’ ἄνδιχα πάντα δάσασθαι	- u u--- - -uu -u u--	dactylic hexameter	masculine penthemimeral
κτῆσιν ὅσην πτολίεθρον ἐπήρατον ἐντὸς ἐέργει·	-u u- uu-u u-uu -u u--	dactylic hexameter	feminine penthemimeral, trithemimeral
ἀλλὰ τί ἤ μοι ταῦτα φίλος διελέξατο θυμός;	-u u - - -u u- uu-uu --	dactylic hexameter	feminine penthemimeral, hepthemimeral, trithemimeral
μή μιν ἐγὼ μὲν ἵκωμαι ἰών, ὃ δέ μ’οὐκ ἐλεήσει	- u u- u u-u u- u u - uu--	dactylic hexameter	feminine penthemimeral, hepthemimeral, trithemimeral
οὐδέ τί μ’αἰδέσεται, κτενέει δέ με γυμνὸν ἐόντα	-u u -uu- uu- u u -u u--	dactylic hexameter	masculine penthemimeral, hepthemimeral
αὔτως ὥς τε γυναῖκα, ἐπεί κ’ἀπὸ τεύχεα δύω.	-- - u u-u u- uu -uu --	dactylic hexameter	feminine penthemimeral, hepthemimeral, trithemimeral
οὐ μέν πως νῦν ἔστιν ἀπὸ δρυὸς οὐδ’ ἀπὸ πέτρης	- - - - -u u- uu - uu --	dactylic hexameter	feminine penthemimeral, hepthemimeral, trithemimeral
τῷ ὀαριζέμεναι, ἅ τε παρθένος ἠΐθεός τε	- uu-uu- u u -uu -uu- -	dactylic hexameter	masculine penthemimeral
παρθένος ἠΐθεός τ’ὀαρίζετον ἀλλήλοιιν.	-uu -uu- uu-uu ----	dactylic hexameter	masculine penthemimeral
βέλτερον αὖτ’ ἔριδι ξυνελαυνέμεν ὅττι τάχιστα·	-uu - uu- uu-uu -u u--	dactylic hexameter	masculine penthemimeral, trithemimeral
εἴδομεν ὁπποτέρῳ κεν Ὀλύμπιος εὖχος ὀρέξῃ.	-uu -uu- u u-uu -u u--	dactylic hexameter	masculine penthemimeral
ὣς ὅρμαινε μένων, ὃ δέ οἱ σχεδὸν ἦλθεν Ἀχιλλεὺς	- --u u- u u - uu -u u--	dactylic hexameter	masculine penthemimeral, hepthemimeral
ἶσος Ἐνυαλίῳ κορυθάϊκι πτολεμιστῇ	-u u-uu- uu--- uu--	dactylic hexameter	masculine penthemimeral
σείων Πηλιάδα μελίην κατὰ δεξιὸν ὦμον	-- -uu- uu- uu -uu --	dactylic hexameter	masculine penthemimeral, hepthemimeral
δεινήν· ἀμφὶ δὲ χαλκὸς ἐλάμπετο εἴκελος αὐγῇ	-- -u u -u u-uu -uu --	dactylic hexameter	feminine penthemimeral
ἢ πυρὸς αἰθομένου ἢ ἠελίου ἀνιόντος.	- uu -uu- - -uu- uu--	dactylic hexameter	masculine penthemimeral
Ἕκτορα δ’,ὡς ἐνόησεν, ἕλε τρόμος· οὐδ’ ἄρ’ ἔτ’ ἔτλη	-uu - uu-u u- uu - u u --	dactylic hexameter	feminine penthemimeral, hepthemimeral, trithemimeral
αὖθι μένειν, ὀπίσω δὲ πύλας λίπε, βῆ δὲ φοβηθείς·	-u u- uu- u u- uu - u u--	dactylic hexameter	masculine penthemimeral, hepthemimeral, trithemimeral
Πηλεΐδης δ’ἐπόρουσε ποσὶ κραιπνοῖσι πεποιθώς.	-uu- uu-u u- --u u--	dactylic hexameter	feminine penthemimeral, hepthemimeral, trithemimeral
ἠΰτε κίρκος ὄρεσφιν ἐλαφρότατος πετεηνῶν	-uu -u u-u u-uu- uu--	dactylic hexameter	feminine penthemimeral
ῥηϊδίως οἴμησε μετὰ τρήρωνα πέλειαν,	-uu- --u u- --u u--	dactylic hexameter	feminine penthemimeral, hepthemimeral, trithemimeral
ἣ δέ θ’ὕπαιθα φοβεῖται, ὃ δ’ἐγγύθεν ὀξὺ λεληκὼς	- u u-u u-u u -uu -u u--	dactylic hexameter	feminine penthemimeral
ταρφέ’ ἐπαΐσσει, ἑλέειν τέ ἑ θυμὸς ἀνώγει·	-u u--- uu- u u -u u--	dactylic hexameter	masculine penthemimeral, hepthemimeral
ὣς ἄρ’ ὅ γ’ἐμμεμαὼς ἰθὺς πέτετο, τρέσε δ’Ἕκτωρ	- u u -uu- -- uu- uu --	dactylic hexameter	masculine penthemimeral, hepthemimeral
τεῖχος ὕπο Τρώων, λαιψηρὰ δὲ γούνατ’ ἐνώμα.	-u u- -- --u u -u u--	dactylic hexameter	masculine penthemimeral, trithemimeral
οἳ δὲ παρὰ σκοπιὴν καὶ ἐρινεὸν ἠνεμόεντα	- u u- uu- u u-uu -uu--	dactylic hexameter	masculine penthemimeral, trithemimeral
τείχεος αἰὲν ὑπ’ ἐκ κατ’ ἀμαξιτὸν ἐσσεύοντο,	-uu -u u - u u-uu ----	dactylic hexameter	masculine penthemimeral
κρουνὼ δ’ἵκανον καλλιρρόω· ἔνθα δὲ πηγαὶ	-- --- --uu -u u --	dactylic hexameter	masculine penthemimeral
δοιαὶ ἀναΐσσουσι Σκαμάνδρου δινήεντος.	-u u---u u-- ----	dactylic hexameter	feminine penthemimeral
ἣ μὲν γάρ θ’ὕδατι λιαρῷ ῥέει, ἀμφὶ δὲ καπνὸς	- - - uu- uu- uu -u u --	dactylic hexameter	masculine penthemimeral, hepthemimeral, trithemimeral
γίγνεται ἐξ αὐτῆς ὡς εἰ πυρὸς αἰθομένοιο·	-uu - -- - - uu -uu--	dactylic hexameter	masculine penthemimeral, hepthemimeral, trithemimeral
ἣ δ’ἑτέρη θέρεϊ προρέει ἐϊκυῖα χαλάζῃ,	- uu- uu- uu- uu-u u--	dactylic hexameter	masculine penthemimeral, hepthemimeral, trithemimeral
ἢ χιόνι ψυχρῇ ἢ ἐξ ὕδατος κρυστάλλῳ.	- uu- -- - - uu- ---	dactylic hexameter	masculine penthemimeral, hepthemimeral, trithemimeral
ἔνθα δ’ἐπ’ αὐτάων πλυνοὶ εὐρέες ἐγγὺς ἔασι	-u u --- uu -uu -u u--	dactylic hexameter	masculine penthemimeral
καλοὶ λαΐνεοι, ὅθι εἵματα σιγαλόεντα	-- -uu- uu -uu -uu--	dactylic hexameter	masculine penthemimeral
πλύνεσκον Τρώων ἄλοχοι καλαί τε θύγατρες	--- -- uu- -- u u--	dactylic hexameter	masculine penthemimeral, hepthemimeral, trithemimeral
τὸ πρὶν ἐπ’ εἰρήνης πρὶν ἐλθεῖν υἷας Ἀχαιῶν.	- u u --- - -- -u u--	dactylic hexameter	masculine penthemimeral
τῇ ῥα παραδραμέτην φεύγων ὃ δ’ὄπισθε διώκων·	- u u-uu- -- u u-u u--	dactylic hexameter	masculine penthemimeral, hepthemimeral
πρόσθε μὲν ἐσθλὸς ἔφευγε, δίωκε δέ μιν μέγ’ ἀμείνων	-u u -u u-u u-u u - u u--	dactylic hexameter	feminine penthemimeral
καρπαλίμως, ἐπεὶ οὐχ ἱερήϊον οὐδὲ βοείην	-uu- uu - uu-uu -u u--	dactylic hexameter	masculine penthemimeral, trithemimeral
ἀρνύσθην, ἅ τε ποσσὶν ἀέθλια γίγνεται ἀνδρῶν,	--- u u -u u-uu -uu --	dactylic hexameter	feminine penthemimeral, trithemimeral
ἀλλὰ περὶ ψυχῆς θέον Ἕκτορος ἱπποδάμοιο.	-u u- -- uu -uu -uu--	dactylic hexameter	masculine penthemimeral, trithemimeral
ὡς δ’ὅτ’ ἀεθλοφόροι περὶ τέρματα μώνυχες ἵπποι	- u u-uu- uu -uu -uu --	dactylic hexameter	masculine penthemimeral
ῥίμφα μάλα τρωχῶσι· τὸ δὲ μέγα κεῖται ἄεθλον	-u u- --u u - uu -u u--	dactylic hexameter	feminine penthemimeral, hepthemimeral, trithemimeral
ἢ τρίπος ἠὲ γυνὴ ἀνδρὸς κατατεθνηῶτος·	- uu -u u- -- uu----	dactylic hexameter	masculine penthemimeral, hepthemimeral
ὣς τὼ τρὶς Πριάμοιο πόλιν πέρι δινηθήτην	- - - uu-u u- uu ----	dactylic hexameter	feminine penthemimeral, hepthemimeral, trithemimeral
καρπαλίμοισι πόδεσσι· θεοὶ δ’ἐς πάντες ὁρῶντο·	-uu-u u-u u- - -u u--	dactylic hexameter	feminine penthemimeral, hepthemimeral
τοῖσι δὲ μύθων ἦρχε πατὴρ ἀνδρῶν τε θεῶν τε·	-u u -- -u u- -- u u- -	dactylic hexameter	feminine penthemimeral, hepthemimeral
ὢ πόποι ἦ φίλον ἄνδρα διωκόμενον περὶ τεῖχος	- uu - uu -u u-uu- uu --	dactylic hexameter	feminine penthemimeral, trithemimeral
ὀφθαλμοῖσιν ὁρῶμαι· ἐμὸν δ’ὀλοφύρεται ἦτορ	---u u-u u- uu-uu --	dactylic hexameter	feminine penthemimeral, hepthemimeral
Ἕκτορος, ὅς μοι πολλὰ βοῶν ἐπὶ μηρί’ ἔκηεν	-uu - - -u u- uu -u u--	dactylic hexameter	feminine penthemimeral, hepthemimeral, trithemimeral
Ἴδης ἐν κορυφῇσι πολυπτύχου, ἄλλοτε δ’αὖτε	-- - uu-u u-uu -uu --	dactylic hexameter	feminine penthemimeral, trithemimeral
ἐν πόλει ἀκροτάτῃ· νῦν αὖτέ ἑ δῖος Ἀχιλλεὺς	- uu -uu- - -u u -u u--	dactylic hexameter	masculine penthemimeral
ἄστυ πέρι Πριάμοιο ποσὶν ταχέεσσι διώκει.	-u u- uu-u u- uu-u u--	dactylic hexameter	feminine penthemimeral, hepthemimeral, trithemimeral
ἀλλ’ ἄγετε φράζεσθε θεοὶ καὶ μητιάασθε	- uu- --u u- - -uu--	dactylic hexameter	feminine penthemimeral, hepthemimeral, trithemimeral
ἠέ μιν ἐκ θανάτοιο σαώσομεν, ἦέ μιν ἤδη	-u u - uu-u u-uu -u u --	dactylic hexameter	feminine penthemimeral, trithemimeral
Πηλεΐδῃ Ἀχιλῆϊ δαμάσσομεν ἐσθλὸν ἐόντα.	-uu- uu-u u-uu -u u--	dactylic hexameter	feminine penthemimeral, trithemimeral
τὸν δ’αὖτε προσέειπε θεὰ γλαυκῶπις Ἀθήνη·	- -- uu-u u- --u u--	dactylic hexameter	feminine penthemimeral, hepthemimeral, trithemimeral
ὦ πάτερ ἀργικέραυνε κελαινεφὲς οἷον ἔειπες·	- uu -uu-u u-uu -u u--	dactylic hexameter	feminine penthemimeral
ἄνδρα θνητὸν ἐόντα πάλαι πεπρωμένον αἴσῃ	-- -u u-u u- --uu --	dactylic hexameter	feminine penthemimeral, hepthemimeral
ἂψ ἐθέλεις θανάτοιο δυσηχέος ἐξαναλῦσαι;	- uu- uu-u u-uu -uu--	dactylic hexameter	feminine penthemimeral, trithemimeral
ἔρδ’· ἀτὰρ οὔ τοι πάντες ἐπαινέομεν θεοὶ ἄλλοι.	- uu - - -u u-uu- uu --	dactylic hexameter	feminine penthemimeral, trithemimeral
τὴν δ’ἀπαμειβόμενος προσέφη νεφεληγερέτα Ζεύς·	- uu-uu- uu- uu-uu- -	dactylic hexameter	masculine penthemimeral, hepthemimeral
θάρσει Τριτογένεια φίλον τέκος· οὔ νύ τι θυμῷ	-- -uu-u u- uu - u u --	dactylic hexameter	feminine penthemimeral, hepthemimeral
πρόφρονι μυθέομαι, ἐθέλω δέ τοι ἤπιος εἶναι·	-uu -uu- uu- u u -uu --	dactylic hexameter	masculine penthemimeral, hepthemimeral
ἔρξον ὅπῃ δή τοι νόος ἔπλετο, μὴ δ’ἔτ’ ἐρώει.	-u u- - - uu -uu - u u--	dactylic hexameter	masculine penthemimeral, trithemimeral
ὣς εἰπὼν ὄτρυνε πάρος μεμαυῖαν Ἀθήνην·	- -- --u u- uu-u u--	dactylic hexameter	feminine penthemimeral, hepthemimeral, trithemimeral
βῆ δὲ κατ’ Οὐλύμποιο καρήνων ἀΐξασα.	- u u ---u u-- ----	dactylic hexameter	feminine penthemimeral
Ἕκτορα δ’ἀσπερχὲς κλονέων ἔφεπ’ ὠκὺς Ἀχιλλεύς.	-uu --- uu- uu -u u--	dactylic hexameter	masculine penthemimeral, hepthemimeral
ὡς δ’ὅτε νεβρὸν ὄρεσφι κύων ἐλάφοιο δίηται	- uu -u u-u u- uu-u u--	dactylic hexameter	feminine penthemimeral, hepthemimeral
ὄρσας ἐξ εὐνῆς διά τ’ἄγκεα καὶ διὰ βήσσας·	-- - -- uu -uu - uu --	dactylic hexameter	masculine penthemimeral, trithemimeral
τὸν δ’εἴ πέρ τε λάθῃσι καταπτήξας ὑπὸ θάμνῳ,	- - - u u-u u--- uu --	dactylic hexameter	feminine penthemimeral, trithemimeral
ἀλλά τ’ἀνιχνεύων θέει ἔμπεδον ὄφρά κεν εὕρῃ·	-u u--- uu -uu -u u --	dactylic hexameter	masculine penthemimeral
ὣς Ἕκτωρ οὐ λῆθε ποδώκεα Πηλεΐωνα.	- -- - -u u-uu -uu--	dactylic hexameter	feminine penthemimeral, trithemimeral
ὁσσάκι δ’ὁρμήσειε πυλάων Δαρδανιάων	-uu ---u u-- -uu--	dactylic hexameter	feminine penthemimeral
ἀντίον ἀΐξασθαι ἐϋδμήτους ὑπὸ πύργους,	-uu ---u u--- uu --	dactylic hexameter	feminine penthemimeral
εἴ πως οἷ καθύπερθεν ἀλάλκοιεν βελέεσσι,	- - - uu-u u--- uu--	dactylic hexameter	feminine penthemimeral, trithemimeral
τοσσάκι μιν προπάροιθεν ἀποστρέψασκε παραφθὰς	-uu - uu-u u---u u--	dactylic hexameter	feminine penthemimeral, trithemimeral
πρὸς πεδίον· αὐτὸς δὲ ποτὶ πτόλιος πέτετ’ αἰεί.	- uu- -- u u- uu- uu --	dactylic hexameter	masculine penthemimeral, hepthemimeral, trithemimeral
ὡς δ’ἐν ὀνείρῳ οὐ δύναται φεύγοντα διώκειν·	- u u-- - uu- --u u--	dactylic hexameter	masculine penthemimeral, hepthemimeral
οὔτ’ ἄρ’ ὃ τὸν δύναται ὑποφεύγειν οὔθ’ ὃ διώκειν·	- u u - uu- uu-- - u u--	dactylic hexameter	masculine penthemimeral, trithemimeral
ὣς ὃ τὸν οὐ δύνατο μάρψαι ποσίν, οὐδ’ ὃς ἀλύξαι.	- u u - uu- -- uu - u u--	dactylic hexameter	masculine penthemimeral, hepthemimeral, trithemimeral
πῶς δέ κεν Ἕκτωρ κῆρας ὑπεξέφυγεν θανάτοιο,	- u u -- -u u-uu- uu--	dactylic hexameter	feminine penthemimeral
εἰ μή οἱ πύματόν τε καὶ ὕστατον ἤντετ’ Ἀπόλλων	- - - uu- u u -uu -u u--	dactylic hexameter	masculine penthemimeral, trithemimeral
ἐγγύθεν, ὅς οἱ ἐπῶρσε μένος λαιψηρά τε γοῦνα;	-uu - u u-u u- --u u --	dactylic hexameter	feminine penthemimeral, hepthemimeral, trithemimeral
λαοῖσιν δ’ἀνένευε καρήατι δῖος Ἀχιλλεύς,	--- uu-u u-uu -u u--	dactylic hexameter	feminine penthemimeral, trithemimeral
οὐδ’ ἔα ἱέμεναι ἐπὶ Ἕκτορι πικρὰ βέλεμνα,	- uu -uu- uu -uu -u u--	dactylic hexameter	masculine penthemimeral
μή τις κῦδος ἄροιτο βαλών, ὃ δὲ δεύτερος ἔλθοι.	- - -u u-u u- u u -uu --	dactylic hexameter	feminine penthemimeral, hepthemimeral
ἀλλ’ ὅτε δὴ τὸ τέταρτον ἐπὶ κρουνοὺς ἀφίκοντο,	- uu - u u-u u- -- uu--	dactylic hexameter	feminine penthemimeral, hepthemimeral, trithemimeral
καὶ τότε δὴ χρύσεια πατὴρ ἐτίταινε τάλαντα,	- uu - --u u- uu-u u--	dactylic hexameter	feminine penthemimeral, hepthemimeral, trithemimeral
ἐν δ’ἐτίθει δύο κῆρε τανηλεγέος θανάτοιο,	- uu- uu -u u-uu- uu--	dactylic hexameter	feminine penthemimeral, trithemimeral
τὴν μὲν Ἀχιλλῆος, τὴν δ’Ἕκτορος ἱπποδάμοιο,	- u u--- - -uu -uu--	dactylic hexameter	masculine penthemimeral
ἕλκε δὲ μέσσα λαβών· ῥέπε δ’Ἕκτορος αἴσιμον ἦμαρ,	-u u -u u- uu -uu -uu --	dactylic hexameter	masculine penthemimeral
ᾤχετο δ’εἰς Ἀΐδαο, λίπεν δέ ἑ Φοῖβος Ἀπόλλων.	-uu - uu-u u- u u -u u--	dactylic hexameter	feminine penthemimeral, hepthemimeral, trithemimeral
Πηλεΐωνα δ’ἵκανε θεὰ γλαυκῶπις Ἀθήνη,	-uu-u u-u u- --u u--	dactylic hexameter	feminine penthemimeral, hepthemimeral
ἀγχοῦ δ’ἱσταμένη ἔπεα πτερόεντα προσηύδα·	-- -uu- uu- uu-u u--	dactylic hexameter	masculine penthemimeral, hepthemimeral
νῦν δὴ νῶι ἔολπα Διῒ φίλε φαίδιμ’ Ἀχιλλεῦ	- - -u u-u u- uu -u u--	dactylic hexameter	feminine penthemimeral, hepthemimeral
οἴσεσθαι μέγα κῦδος Ἀχαιοῖσι προτὶ νῆας	--- uu -u u--- uu --	dactylic hexameter	feminine penthemimeral, trithemimeral
Ἕκτορα δῃώσαντε μάχης ἄατόν περ ἐόντα.	-uu ---u u- uu- u u--	dactylic hexameter	feminine penthemimeral, hepthemimeral
οὔ οἱ νῦν ἔτι γ’ἔστι πεφυγμένον ἄμμε γενέσθαι,	- - - uu -u u-uu -u u--	dactylic hexameter	feminine penthemimeral, trithemimeral
οὐδ’ εἴ κεν μάλα πολλὰ πάθοι ἑκάεργος Ἀπόλλων	- - - uu -u u- uu-u u--	dactylic hexameter	feminine penthemimeral, hepthemimeral, trithemimeral
προπροκυλινδόμενος πατρὸς Διὸς αἰγιόχοιο.	-uu-uu- -- uu -uu--	dactylic hexameter	masculine penthemimeral, hepthemimeral
ἀλλὰ σὺ μὲν νῦν στῆθι καὶ ἄμπνυε, τόνδε δ’ἐγώ τοι	-u u - - -u u -uu -u u- -	dactylic hexameter	feminine penthemimeral, trithemimeral
οἰχομένη πεπιθήσω ἐναντίβιον μαχέσασθαι.	-uu- uu-u u-uu- uu--	dactylic hexameter	feminine penthemimeral, trithemimeral
ὣς φάτ’ Ἀθηναίη, ὃ δ’ἐπείθετο, χαῖρε δὲ θυμῷ,	- u u--- u u-uu -u u --	dactylic hexameter	masculine penthemimeral
στῆ δ’ἄρ’ ἐπὶ μελίης χαλκογλώχινος ἐρεισθείς.	- u u- uu- ----u u--	dactylic hexameter	masculine penthemimeral, trithemimeral
ἣ δ’ἄρα τὸν μὲν ἔλειπε, κιχήσατο δ’Ἕκτορα δῖον	- uu - u u-u u-uu -uu --	dactylic hexameter	feminine penthemimeral, trithemimeral
Δηϊφόβῳ ἐϊκυῖα δέμας καὶ ἀτειρέα φωνήν·	-uu- uu-u u- u u-uu --	dactylic hexameter	feminine penthemimeral, hepthemimeral, trithemimeral
ἀγχοῦ δ’ἱσταμένη ἔπεα πτερόεντα προσηύδα·	-- -uu- uu- uu-u u--	dactylic hexameter	masculine penthemimeral, hepthemimeral
ἠθεῖ’ ἦ μάλα δή σε βιάζεται ὠκὺς Ἀχιλλεὺς	-- - uu - u u-uu -u u--	dactylic hexameter	masculine penthemimeral, trithemimeral
ἄστυ πέρι Πριάμοιο ποσὶν ταχέεσσι διώκων·	-u u- uu-u u- uu-u u--	dactylic hexameter	feminine penthemimeral, hepthemimeral, trithemimeral
ἀλλ’ ἄγε δὴ στέωμεν καὶ ἀλεξώμεσθα μένοντες.	- uu - -- u u---u u--	dactylic hexameter	masculine penthemimeral, trithemimeral
τὴν δ’αὖτε προσέειπε μέγας κορυθαίολος Ἕκτωρ·	- -- uu-u u- uu-uu --	dactylic hexameter	feminine penthemimeral, hepthemimeral, trithemimeral
Δηΐφοβ’ ἦ μέν μοι τὸ πάρος πολὺ φίλτατος ἦσθα	-uu - - - u u- uu -uu --	dactylic hexameter	masculine penthemimeral, hepthemimeral, trithemimeral
γνωτῶν οὓς Ἑκάβη ἠδὲ Πρίαμος τέκε παῖδας·	-- - uu- -- uu- uu --	dactylic hexameter	masculine penthemimeral, hepthemimeral, trithemimeral
νῦν δ’ἔτι καὶ μᾶλλον νοέω φρεσὶ τιμήσασθαι,	- uu - -- uu- uu ----	dactylic hexameter	masculine penthemimeral, hepthemimeral, trithemimeral
ὃς ἔτλης ἐμεῦ εἵνεκ’, ἐπεὶ ἴδες ὀφθαλμοῖσι,	- -- uu -u u- uu ----	dactylic hexameter	feminine penthemimeral, hepthemimeral, trithemimeral
τείχεος ἐξελθεῖν, ἄλλοι δ’ἔντοσθε μένουσι.	-uu --- -- --u u--	dactylic hexameter	masculine penthemimeral, hepthemimeral
τὸν δ’αὖτε προσέειπε θεὰ γλαυκῶπις Ἀθήνη·	- -- uu-u u- --u u--	dactylic hexameter	feminine penthemimeral, hepthemimeral, trithemimeral
ἠθεῖ’ ἦ μὲν πολλὰ πατὴρ καὶ πότνια μήτηρ	-- - - -u u- - -uu --	dactylic hexameter	feminine penthemimeral, hepthemimeral, trithemimeral
λίσσονθ’ ἑξείης γουνούμενοι, ἀμφὶ δ’ἑταῖροι,	-- --- --uu -u u--	dactylic hexameter	masculine penthemimeral
αὖθι μένειν· τοῖον γὰρ ὑποτρομέουσιν ἅπαντες·	-u u- -- u u-uu-u u--	dactylic hexameter	masculine penthemimeral, trithemimeral
ἀλλ’ ἐμὸς ἔνδοθι θυμὸς ἐτείρετο πένθεϊ λυγρῷ.	- uu -uu -u u-uu -uu --	dactylic hexameter	feminine penthemimeral
νῦν δ’ἰθὺς μεμαῶτε μαχώμεθα, μὴ δέ τι δούρων	- -- uu-u u-uu - u u --	dactylic hexameter	feminine penthemimeral, trithemimeral
ἔστω φειδωλή, ἵνα εἴδομεν εἴ κεν Ἀχιλλεὺς	-- --- uu -uu - u u--	dactylic hexameter	masculine penthemimeral
νῶϊ κατακτείνας ἔναρα βροτόεντα φέρηται	-u u--- uu- uu-u u--	dactylic hexameter	masculine penthemimeral, hepthemimeral
νῆας ἔπι γλαφυράς, ἦ κεν σῷ δουρὶ δαμήῃ.	-u u- uu- - - - -u u--	dactylic hexameter	masculine penthemimeral, hepthemimeral, trithemimeral
ὣς φαμένη καὶ κερδοσύνῃ ἡγήσατ’ Ἀθήνη·	- uu- - -uu- --u u--	dactylic hexameter	hepthemimeral, trithemimeral
οἳ δ’ὅτε δὴ σχεδὸν ἦσαν ἐπ’ ἀλλήλοισιν ἰόντες,	- uu - uu -u u ---u u--	dactylic hexameter	feminine penthemimeral, trithemimeral
τὸν πρότερος προσέειπε μέγας κορυθαίολος Ἕκτωρ·	- uu- uu-u u- uu-uu --	dactylic hexameter	feminine penthemimeral, hepthemimeral, trithemimeral
οὔ σ’ἔτι Πηλέος υἱὲ φοβήσομαι, ὡς τὸ πάρος περ	- uu -uu -u u-uu - u u- -	dactylic hexameter	feminine penthemimeral
τρὶς περὶ ἄστυ μέγα Πριάμου δίον, οὐδέ ποτ’ ἔτλην	- uu -u u- uu- uu -u u --	dactylic hexameter	masculine penthemimeral, hepthemimeral
μεῖναι ἐπερχόμενον· νῦν αὖτέ με θυμὸς ἀνῆκε	-u u-uu- - -u u -u u--	dactylic hexameter	masculine penthemimeral
στήμεναι ἀντία σεῖο· ἕλοιμί κεν ἤ κεν ἁλοίην.	-uu -uu -u u-u u - u u--	dactylic hexameter	feminine penthemimeral
ἀλλ’ ἄγε δεῦρο θεοὺς ἐπιδώμεθα· τοὶ γὰρ ἄριστοι	- uu -u u- uu-uu - u u--	dactylic hexameter	masculine penthemimeral
μάρτυροι ἔσσονται καὶ ἐπίσκοποι ἁρμονιάων·	-uu --- u u-uu -uu--	dactylic hexameter	masculine penthemimeral
οὐ γὰρ ἐγώ σ’ἔκπαγλον ἀεικιῶ, αἴ κεν ἐμοὶ Ζεὺς	- u u- --u u-uu - u u- -	dactylic hexameter	feminine penthemimeral, trithemimeral
δώῃ καμμονίην, σὴν δὲ ψυχὴν ἀφέλωμαι·	-- -uu- - - -- uu--	dactylic hexameter	masculine penthemimeral, hepthemimeral
ἀλλ’ ἐπεὶ ἄρ κέ σε συλήσω κλυτὰ τεύχε’ Ἀχιλλεῦ	- uu - u u --- uu -u u--	dactylic hexameter	hepthemimeral, trithemimeral
νεκρὸν Ἀχαιοῖσιν δώσω πάλιν· ὣς δὲ σὺ ῥέζειν.	-u u--- -- uu - u u --	dactylic hexameter	masculine penthemimeral, hepthemimeral
τὸν δ’ἄρ’ ὑπόδρα ἰδὼν προσέφη πόδας ὠκὺς Ἀχιλλεύς·	- u u-u u- uu- uu -u u--	dactylic hexameter	masculine penthemimeral, hepthemimeral
Ἕκτορ μή μοι ἄλαστε συνημοσύνας ἀγόρευε·	-- - u u-u u-uu- uu--	dactylic hexameter	feminine penthemimeral, trithemimeral
ὡς οὐκ ἔστι λέουσι καὶ ἀνδράσιν ὅρκια πιστά,	- - -u u-u u -uu -uu --	dactylic hexameter	feminine penthemimeral
οὐδὲ λύκοι τε καὶ ἄρνες ὁμόφρονα θυμὸν ἔχουσιν,	-u u- u u -u u-uu -u u--	dactylic hexameter	feminine penthemimeral, trithemimeral
ἀλλὰ κακὰ φρονέουσι διαμπερὲς ἀλλήλοισιν,	-u u- uu-u u-uu ----	dactylic hexameter	feminine penthemimeral, trithemimeral
ὣς οὐκ ἔστ’ ἐμὲ καὶ σὲ φιλήμεναι, οὐδέ τι νῶϊν	- - - uu - u u-uu -u u --	dactylic hexameter	masculine penthemimeral, trithemimeral
ὅρκια ἔσσονται, πρίν γ’ἢ ἕτερόν γε πεσόντα	-uu --- - - uu- u u--	dactylic hexameter	masculine penthemimeral, hepthemimeral
αἵματος ἆσαι Ἄρηα ταλαύρινον πολεμιστήν.	-uu -u u-u u--- uu--	dactylic hexameter	feminine penthemimeral
παντοίης ἀρετῆς μιμνήσκεο· νῦν σε μάλα χρὴ	--- uu- --uu - u u- -	dactylic hexameter	masculine penthemimeral, trithemimeral
αἰχμητήν τ’ἔμεναι καὶ θαρσαλέον πολεμιστήν.	--- uu- - -uu- uu--	dactylic hexameter	masculine penthemimeral, trithemimeral
οὔ τοι ἔτ’ ἔσθ’ ὑπάλυξις, ἄφαρ δέ σε Παλλὰς Ἀθήνη	- u u - uu-u u- u u -u u--	dactylic hexameter	feminine penthemimeral, hepthemimeral, trithemimeral
ἔγχει ἐμῷ δαμάᾳ· νῦν δ’ἀθρόα πάντ’ ἀποτίσεις	-u u- uu- - -uu - uu--	dactylic hexameter	masculine penthemimeral, trithemimeral
κήδε’ ἐμῶν ἑτάρων οὓς ἔκτανες ἔγχεϊ θύων.	-u u- uu- - -uu -uu --	dactylic hexameter	masculine penthemimeral, trithemimeral
ἦ ῥα, καὶ ἀμπεπαλὼν προΐει δολιχόσκιον ἔγχος·	- u u -uu- uu- uu-uu --	dactylic hexameter	masculine penthemimeral, hepthemimeral
καὶ τὸ μὲν ἄντα ἰδὼν ἠλεύατο φαίδιμος Ἕκτωρ·	- u u -u u- --uu -uu --	dactylic hexameter	masculine penthemimeral
ἕζετο γὰρ προϊδών, τὸ δ’ὑπέρπτατο χάλκεον ἔγχος,	-uu - uu- u u-uu -uu --	dactylic hexameter	masculine penthemimeral, trithemimeral
ἐν γαίῃ δ’ἐπάγη· ἀνὰ δ’ἥρπασε Παλλὰς Ἀθήνη,	- -- uu- uu -uu -u u--	dactylic hexameter	masculine penthemimeral, trithemimeral
ἂψ δ’Ἀχιλῆϊ δίδου, λάθε δ’Ἕκτορα ποιμένα λαῶν.	- uu-u u- uu -uu -uu --	dactylic hexameter	masculine penthemimeral
Ἕκτωρ δὲ προσέειπεν ἀμύμονα Πηλεΐωνα·	-- - uu-u u-uu -uu--	dactylic hexameter	feminine penthemimeral, trithemimeral
ἤμβροτες, οὐδ’ ἄρα πώ τι θεοῖς ἐπιείκελ’ Ἀχιλλεῦ	-uu - uu - u u- uu-u u--	dactylic hexameter	masculine penthemimeral, hepthemimeral, trithemimeral
ἐκ Διὸς ἠείδης τὸν ἐμὸν μόρον, ἦ τοι ἔφης γε·	- uu --- u u- uu - u u- -	dactylic hexameter	masculine penthemimeral, hepthemimeral
ἀλλά τις ἀρτιεπὴς καὶ ἐπίκλοπος ἔπλεο μύθων,	-u u -uu- u u-uu -uu --	dactylic hexameter	masculine penthemimeral
ὄφρά σ’ὑποδείσας μένεος ἀλκῆς τε λάθωμαι.	-u u--- uu- -- u u--	dactylic hexameter	masculine penthemimeral, hepthemimeral
οὐ μέν μοι φεύγοντι μεταφρένῳ ἐν δόρυ πήξεις,	- - - --u u-uu - uu --	dactylic hexameter	feminine penthemimeral, trithemimeral
ἀλλ’ ἰθὺς μεμαῶτι διὰ στήθεσφιν ἔλασσον	- -- uu-u u- --u u--	dactylic hexameter	feminine penthemimeral, hepthemimeral, trithemimeral
εἴ τοι ἔδωκε θεός· νῦν αὖτ’ ἐμὸν ἔγχος ἄλευαι	- u u-u u- - - uu -u u--	dactylic hexameter	masculine penthemimeral, hepthemimeral
χάλκεον· ὡς δή μιν σῷ ἐν χροῒ πᾶν κομίσαιο.	-uu - - - - - uu - uu--	dactylic hexameter	masculine penthemimeral, hepthemimeral, trithemimeral
καί κεν ἐλαφρότερος πόλεμος Τρώεσσι γένοιτο	- u u-uu- uu- --u u--	dactylic hexameter	masculine penthemimeral, hepthemimeral
σεῖο καταφθιμένοιο· σὺ γάρ σφισι πῆμα μέγιστον.	-u u-uu-u u - uu -u u--	dactylic hexameter	feminine penthemimeral, hepthemimeral
ἦ ῥα, καὶ ἀμπεπαλὼν προΐει δολιχόσκιον ἔγχος,	- u u -uu- uu- uu-uu --	dactylic hexameter	masculine penthemimeral, hepthemimeral
καὶ βάλε Πηλεΐδαο μέσον σάκος οὐδ’ ἀφάμαρτε·	- uu -uu-u u- uu - uu--	dactylic hexameter	feminine penthemimeral, hepthemimeral
τῆλε δ’ἀπεπλάγχθη σάκεος δόρυ· χώσατο δ’Ἕκτωρ	-u u--- uu- uu -uu --	dactylic hexameter	masculine penthemimeral, hepthemimeral
ὅττί ῥά οἱ βέλος ὠκὺ ἐτώσιον ἔκφυγε χειρός,	-u u - uu -u u-uu -uu --	dactylic hexameter	feminine penthemimeral, trithemimeral
στῆ δὲ κατηφήσας, οὐδ’ ἄλλ’ ἔχε μείλινον ἔγχος.	- u u--- - - uu -uu --	dactylic hexameter	masculine penthemimeral, hepthemimeral
Δηΐφοβον δ’ἐκάλει λευκάσπιδα μακρὸν ἀΰσας·	-uu- uu- --uu -u u--	dactylic hexameter	masculine penthemimeral, trithemimeral
ᾔτεέ μιν δόρυ μακρόν· ὃ δ’οὔ τί οἱ ἐγγύθεν ἦεν.	-uu - uu -u u - u u -uu --	dactylic hexameter	feminine penthemimeral, hepthemimeral, trithemimeral
Ἕκτωρ δ’ἔγνω ᾗσιν ἐνὶ φρεσὶ φώνησέν τε·	-- -- -u u- uu --- -	dactylic hexameter	feminine penthemimeral, hepthemimeral
ὢ πόποι ἦ μάλα δή με θεοὶ θάνατον δὲ κάλεσσαν·	- uu - uu - u u- uu- u u--	dactylic hexameter	masculine penthemimeral, hepthemimeral, trithemimeral
Δηΐφοβον γὰρ ἔγωγ’ ἐφάμην ἥρωα παρεῖναι·	-uu- u u- uu- --u u--	dactylic hexameter	masculine penthemimeral, hepthemimeral, trithemimeral
ἀλλ’ ὃ μὲν ἐν τείχει, ἐμὲ δ’ἐξαπάτησεν Ἀθήνη.	- u u - -- uu -uu-u u--	dactylic hexameter	masculine penthemimeral, trithemimeral
νῦν δὲ δὴ ἐγγύθι μοι θάνατος κακός, οὐδ’ ἔτ’ ἄνευθεν,	- u u -uu - uu- uu - u u--	dactylic hexameter	masculine penthemimeral, hepthemimeral
οὐδ’ ἀλέη· ἦ γάρ ῥα πάλαι τό γε φίλτερον ἦεν	- uu- - - u u- u u -uu --	dactylic hexameter	masculine penthemimeral, hepthemimeral, trithemimeral
Ζηνί τε καὶ Διὸς υἷι ἑκηβόλῳ, οἵ με πάρος γε	-u u - uu -u u-uu - u u- -	dactylic hexameter	feminine penthemimeral, trithemimeral
πρόφρονες εἰρύατο· νῦν αὖτέ με μοῖρα κιχάνει.	-uu -uu- - -u u -u u--	dactylic hexameter	masculine penthemimeral
μὴ μὰν ἀσπουδί γε καὶ ἀκλειῶς ἀπολοίμην,	- - --- u u --- uu--	dactylic hexameter	masculine penthemimeral
ἀλλὰ μέγα ῥέξας τι καὶ ἐσσομένοισι πυθέσθαι.	-u u- -- u u -uu-u u--	dactylic hexameter	masculine penthemimeral, trithemimeral
ὣς ἄρα φωνήσας εἰρύσσατο φάσγανον ὀξύ,	- uu --- --uu -uu --	dactylic hexameter	masculine penthemimeral
τό οἱ ὑπὸ λαπάρην τέτατο μέγα τε στιβαρόν τε,	- u u- uu- uu- uu - uu- -	dactylic hexameter	masculine penthemimeral, hepthemimeral, trithemimeral
οἴμησεν δὲ ἀλεὶς ὥς τ’αἰετὸς ὑψιπετήεις,	--- u u- - -uu -uu--	dactylic hexameter	masculine penthemimeral, trithemimeral
ὅς τ’εἶσιν πεδίον δὲ διὰ νεφέων ἐρεβεννῶν	- -- uu- u u- uu- uu--	dactylic hexameter	masculine penthemimeral, hepthemimeral, trithemimeral
ἁρπάξων ἢ ἄρν’ ἀμαλὴν ἤ πτῶκα λαγωόν·	--- - - uu- - -u u--	dactylic hexameter	masculine penthemimeral, hepthemimeral, trithemimeral
ὣς Ἕκτωρ οἴμησε τινάσσων φάσγανον ὀξύ.	- -- --u u-- -uu --	dactylic hexameter	feminine penthemimeral, trithemimeral
ὁρμήθη δ’Ἀχιλεύς, μένεος δ’ἐμπλήσατο θυμὸν	--- uu- uu- --uu --	dactylic hexameter	masculine penthemimeral, hepthemimeral, trithemimeral
ἀγρίου, πρόσθεν δὲ σάκος στέρνοιο κάλυψε	--- -- u u- --u u--	dactylic hexameter	masculine penthemimeral, hepthemimeral, trithemimeral
καλὸν δαιδάλεον, κόρυθι δ’ἐπένευε φαεινῇ	-- -uu- uu- uu-u u--	dactylic hexameter	masculine penthemimeral, hepthemimeral
τετραφάλῳ· καλαὶ δὲ περισσείοντο ἔθειραι	-uu- -- u u---u u--	dactylic hexameter	masculine penthemimeral, trithemimeral
χρύσεαι, ἃς Ἥφαιστος ἵει λόφον ἀμφὶ θαμειάς.	-uu - --u u- uu -u u--	dactylic hexameter	feminine penthemimeral, hepthemimeral, trithemimeral
οἷος δ’ἀστὴρ εἶσι μετ’ ἀστράσι νυκτὸς ἀμολγῷ	-- -- -u u -uu -u u--	dactylic hexameter	feminine penthemimeral
ἕσπερος, ὃς κάλλιστος ἐν οὐρανῷ ἵσταται ἀστήρ,	-uu - --u u -uu -uu --	dactylic hexameter	feminine penthemimeral, trithemimeral
ὣς αἰχμῆς ἀπέλαμπ’ εὐήκεος, ἣν ἄρ’ Ἀχιλλεὺς	- -- uu- --uu - u u--	dactylic hexameter	masculine penthemimeral, trithemimeral
πάλλεν δεξιτερῇ φρονέων κακὸν Ἕκτορι δίῳ	-- -uu- uu- uu -uu --	dactylic hexameter	masculine penthemimeral, hepthemimeral
εἰσορόων χρόα καλόν, ὅπῃ εἴξειε μάλιστα.	-uu- uu -u u- --u u--	dactylic hexameter	feminine penthemimeral, hepthemimeral, trithemimeral
τοῦ δὲ καὶ ἄλλο τόσον μὲν ἔχε χρόα χάλκεα τεύχεα	- u u -u u- u u- uu -uu --	dactylic hexameter	masculine penthemimeral, hepthemimeral
καλά, τὰ Πατρόκλοιο βίην ἐνάριξε κατακτάς·	-u u ---u u- uu-u u--	dactylic hexameter	feminine penthemimeral, hepthemimeral
φαίνετο δ’ᾗ κληῖδες ἀπ’ ὤμων αὐχέν’ ἔχουσι	-uu - --u u -- -u u--	dactylic hexameter	feminine penthemimeral, trithemimeral
λαυκανίην, ἵνα τε ψυχῆς ὤκιστος ὄλεθρος·	-uu- uu - -- --u u--	dactylic hexameter	masculine penthemimeral, hepthemimeral, trithemimeral
τῇ ῥ’ἐπὶ οἷ μεμαῶτ’ ἔλασ’ ἔγχεϊ δῖος Ἀχιλλεύς,	- uu - uu- uu -uu -u u--	dactylic hexameter	masculine penthemimeral, trithemimeral
ἀντικρὺ δ’ἁπαλοῖο δι’ αὐχένος ἤλυθ’ ἀκωκή·	--- uu-u u -uu -u u--	dactylic hexameter	feminine penthemimeral, trithemimeral
οὐδ’ ἄρ’ ἀπ’ ἀσφάραγον μελίη τάμε χαλκοβάρεια,	- u u -uu- uu- uu -uu--	dactylic hexameter	masculine penthemimeral, hepthemimeral
ὄφρά τί μιν προτιείποι ἀμειβόμενος ἐπέεσσιν.	-u u - uu-u u-uu- uu--	dactylic hexameter	feminine penthemimeral, trithemimeral
ἤριπε δ’ἐν κονίῃς· ὃ δ’ἐπεύξατο δῖος Ἀχιλλεύς·	-uu - uu- u u-uu -u u--	dactylic hexameter	masculine penthemimeral, trithemimeral
Ἕκτορ ἀτάρ που ἔφης Πατροκλῆ’ ἐξεναρίζων	-u u- u u- --- -uu--	dactylic hexameter	masculine penthemimeral, trithemimeral
σῶς ἔσσεσθ’, ἐμὲ δ’οὐδὲν ὀπίζεο νόσφιν ἐόντα	- -- uu -u u-uu -u u--	dactylic hexameter	feminine penthemimeral, trithemimeral
νήπιε· τοῖο δ’ἄνευθεν ἀοσσητὴρ μέγ’ ἀμείνων	-uu -u u-u u--- u u--	dactylic hexameter	feminine penthemimeral
νηυσὶν ἔπι γλαφυρῇσιν ἐγὼ μετόπισθε λελείμμην,	-u u- uu-u u- uu-u u--	dactylic hexameter	feminine penthemimeral, hepthemimeral, trithemimeral
ὅς τοι γούνατ’ ἔλυσα· σὲ μὲν κύνες ἠδ’ οἰωνοὶ	- - -u u-u u - uu - ---	dactylic hexameter	feminine penthemimeral, hepthemimeral
ἑλκήσουσ’ ἀϊκῶς, τὸν δὲ κτεριοῦσιν Ἀχαιοί.	--- uu- - - uu-u u--	dactylic hexameter	masculine penthemimeral, hepthemimeral, trithemimeral
τὸν δ’ὀλιγοδρανέων προσέφη κορυθαίολος Ἕκτωρ·	- uu-uu- uu- uu-uu --	dactylic hexameter	masculine penthemimeral, hepthemimeral
λίσσομ’ ὑπὲρ ψυχῆς καὶ γούνων σῶν τε τοκήων	-u u- -- - -- - u u--	dactylic hexameter	masculine penthemimeral, trithemimeral
μή με ἔα παρὰ νηυσὶ κύνας καταδάψαι Ἀχαιῶν,	- u u- uu -u u- uu-u u--	dactylic hexameter	feminine penthemimeral, hepthemimeral, trithemimeral
ἀλλὰ σὺ μὲν χαλκόν τε ἅλις χρυσόν τε δέδεξο	-u u - -- u u- -- u u--	dactylic hexameter	masculine penthemimeral, hepthemimeral, trithemimeral
δῶρα τά τοι δώσουσι πατὴρ καὶ πότνια μήτηρ,	-u u - --u u- - -uu --	dactylic hexameter	feminine penthemimeral, hepthemimeral, trithemimeral
σῶμα δὲ οἴκαδ’ ἐμὸν δόμεναι πάλιν, ὄφρα πυρός με	-u u -u u- uu- uu -u u- -	dactylic hexameter	masculine penthemimeral, hepthemimeral
Τρῶες καὶ Τρώων ἄλοχοι λελάχωσι θανόντα.	-- - -- uu- uu-u u--	dactylic hexameter	masculine penthemimeral, hepthemimeral, trithemimeral
τὸν δ’ἄρ’ ὑπόδρα ἰδὼν προσέφη πόδας ὠκὺς Ἀχιλλεὺς·	- u u-u u- uu- uu -u u--	dactylic hexameter	masculine penthemimeral, hepthemimeral
μή με κύον γούνων γουνάζεο μὴ δὲ τοκήων·	- u u- -- --uu - u u--	dactylic hexameter	masculine penthemimeral, trithemimeral
αἲ γάρ πως αὐτόν με μένος καὶ θυμὸς ἀνήη	- - - -- u u- - -u u--	dactylic hexameter	masculine penthemimeral, hepthemimeral, trithemimeral
ὤμ’ ἀποταμνόμενον κρέα ἔδμεναι, οἷα ἔοργας,	- uu-uu- uu -uu -u u--	dactylic hexameter	masculine penthemimeral
ὡς οὐκ ἔσθ’ ὃς σῆς γε κύνας κεφαλῆς ἀπαλάλκοι,	- - - - - u u- uu- uu--	dactylic hexameter	masculine penthemimeral, hepthemimeral, trithemimeral
οὐδ’ εἴ κεν δεκάκις τε καὶ εἰκοσινήριτ’ ἄποινα	- - - uu- u u -uu-u u--	dactylic hexameter	masculine penthemimeral, trithemimeral
στήσωσ’ ἐνθάδ’ ἄγοντες, ὑπόσχωνται δὲ καὶ ἄλλα,	-- -u u-u u--- u u --	dactylic hexameter	feminine penthemimeral
οὐδ’ εἴ κέν σ’αὐτὸν χρυσῷ ἐρύσασθαι ἀνώγοι	- - - -- -- uu-u u--	dactylic hexameter	masculine penthemimeral, hepthemimeral, trithemimeral
Δαρδανίδης Πρίαμος· οὐδ’ ὧς σέ γε πότνια μήτηρ	-uu- uu- - - u u -uu --	dactylic hexameter	masculine penthemimeral, hepthemimeral, trithemimeral
ἐνθεμένη λεχέεσσι γοήσεται ὃν τέκεν αὐτή,	-uu- uu-u u-uu - uu --	dactylic hexameter	feminine penthemimeral, trithemimeral
ἀλλὰ κύνες τε καὶ οἰωνοὶ κατὰ πάντα δάσονται.	-u u- u u --- uu -u u--	dactylic hexameter	hepthemimeral, trithemimeral
τὸν δὲ καταθνῄσκων προσέφη κορυθαίολος Ἕκτωρ·	- u u--- uu- uu-uu --	dactylic hexameter	masculine penthemimeral, hepthemimeral
ἦ σ’εὖ γιγνώσκων προτιόσσομαι, οὐδ’ ἄρ’ ἔμελλον	- - --- uu-uu - u u--	dactylic hexameter	masculine penthemimeral
πείσειν· ἦ γὰρ σοί γε σιδήρεος ἐν φρεσὶ θυμός.	-- - - - u u-uu - uu --	dactylic hexameter	masculine penthemimeral, trithemimeral
φράζεο νῦν, μή τοί τι θεῶν μήνιμα γένωμαι	-uu - - - u u- --u u--	dactylic hexameter	masculine penthemimeral, hepthemimeral, trithemimeral
ἤματι τῷ ὅτε κέν σε Πάρις καὶ Φοῖβος Ἀπόλλων	-uu - uu - u u- - -u u--	dactylic hexameter	masculine penthemimeral, hepthemimeral, trithemimeral
ἐσθλὸν ἐόντ’ ὀλέσωσιν ἐνὶ Σκαιῇσι πύλῃσιν.	-u u- uu-u u- --u u--	dactylic hexameter	feminine penthemimeral, hepthemimeral, trithemimeral
ὣς ἄρα μιν εἰπόντα τέλος θανάτοιο κάλυψε,	- uu - --u u- uu-u u--	dactylic hexameter	feminine penthemimeral, hepthemimeral, trithemimeral
ψυχὴ δ’ἐκ ῥεθέων πταμένη Ἄϊδος δὲ βεβήκει	-- - uu- uu- uu- u u--	dactylic hexameter	masculine penthemimeral, hepthemimeral, trithemimeral
ὃν πότμον γοόωσα λιποῦσ’ ἀνδροτῆτα καὶ ἥβην.	- -- uu-u u- uu-u u --	dactylic hexameter	feminine penthemimeral, hepthemimeral, trithemimeral
τὸν καὶ τεθνηῶτα προσηύδα δῖος Ἀχιλλεύς·	- - ---u u-- -u u--	dactylic hexameter	feminine penthemimeral
τέθναθι· κῆρα δ’ἐγὼ τότε δέξομαι ὁππότε κεν δὴ	-uu -u u- uu -uu -uu - -	dactylic hexameter	masculine penthemimeral
Ζεὺς ἐθέλῃ τελέσαι ἠδ’ ἀθάνατοι θεοὶ ἄλλοι.	- uu- uu- - -uu- uu --	dactylic hexameter	masculine penthemimeral, trithemimeral
ἦ ῥα, καὶ ἐκ νεκροῖο ἐρύσσατο χάλκεον ἔγχος,	- u u - --u u-uu -uu --	dactylic hexameter	feminine penthemimeral, trithemimeral
καὶ τό γ’ἄνευθεν ἔθηχ’, ὃ δ’ἀπ’ ὤμων τεύχε’ ἐσύλα	- u u-u u- u u -- -u u--	dactylic hexameter	masculine penthemimeral
αἱματόεντ’· ἄλλοι δὲ περίδραμον υἷες Ἀχαιῶν,	-uu- -- u u-uu -u u--	dactylic hexameter	masculine penthemimeral, trithemimeral
οἳ καὶ θηήσαντο φυὴν καὶ εἶδος ἀγητὸν	- - ---u u- - -u u--	dactylic hexameter	feminine penthemimeral, hepthemimeral
Ἕκτορος· οὐδ’ ἄρα οἵ τις ἀνουτητί γε παρέστη.	-uu - uu - u u--- u u--	dactylic hexameter	masculine penthemimeral, trithemimeral
ὧδε δέ τις εἴπεσκεν ἰδὼν ἐς πλησίον ἄλλον·	-u u - --u u- - -uu --	dactylic hexameter	feminine penthemimeral, hepthemimeral, trithemimeral
ὢ πόποι, ἦ μάλα δὴ μαλακώτερος ἀμφαφάασθαι	- uu - uu - uu-uu -uu--	dactylic hexameter	masculine penthemimeral, trithemimeral
Ἕκτωρ ἢ ὅτε νῆας ἐνέπρησεν πυρὶ κηλέῳ.	-- - uu -u u--- uu --	dactylic hexameter	feminine penthemimeral, trithemimeral
ὣς ἄρα τις εἴπεσκε καὶ οὐτήσασκε παραστάς.	- uu - --u u ---u u--	dactylic hexameter	feminine penthemimeral, trithemimeral
τὸν δ’ἐπεὶ ἐξενάριξε ποδάρκης δῖος Ἀχιλλεύς,	- uu -uu-u u-- -u u--	dactylic hexameter	feminine penthemimeral
στὰς ἐν Ἀχαιοῖσιν ἔπεα πτερόεντ’ ἀγόρευεν·	- u u--- uu- uu- uu--	dactylic hexameter	masculine penthemimeral, hepthemimeral
ὦ φίλοι Ἀργείων ἡγήτορες ἠδὲ μέδοντες	- uu --- --uu -u u--	dactylic hexameter	masculine penthemimeral
ἢ πεὶ δὴ τόνδ’ ἄνδρα θεοὶ δαμάσασθαι ἔδωκαν,	- - - - -u u- uu-u u--	dactylic hexameter	feminine penthemimeral, hepthemimeral, trithemimeral
ὃς κακὰ πόλλ’ ἔρρεξεν ὅσ’ οὐ σύμπαντες οἱ ἄλλοι,	- uu - --u u - --u u --	dactylic hexameter	feminine penthemimeral, hepthemimeral, trithemimeral
εἰ δ’ἄγετ’ ἀμφὶ πόλιν σὺν τεύχεσι πειρηθῶμεν,	- uu -u u- - -uu ----	dactylic hexameter	masculine penthemimeral
ὄφρά κ’ἔτι γνῶμεν Τρώων νόον ὅν τιν’ ἔχουσιν,	-u u- -- -- uu - u u--	dactylic hexameter	masculine penthemimeral, hepthemimeral, trithemimeral
ἢ καταλείψουσιν πόλιν ἄκρην τοῦδε πεσόντος,	- uu--- uu -- -u u--	dactylic hexameter	masculine penthemimeral
ἦε μένειν μεμάασι καὶ Ἕκτορος οὐκέτ’ ἐόντος.	-u u- uu-u u -uu -u u--	dactylic hexameter	feminine penthemimeral, trithemimeral
ἀλλὰ τί ἤ μοι ταῦτα φίλος διελέξατο θυμός;	-u u - - -u u- uu-uu --	dactylic hexameter	feminine penthemimeral, hepthemimeral, trithemimeral
κεῖται πὰρ νήεσσι νέκυς ἄκλαυτος ἄθαπτος	-- - --u u- --u u--	dactylic hexameter	feminine penthemimeral, hepthemimeral, trithemimeral
Πάτροκλος· τοῦ δ’οὐκ ἐπιλήσομαι, ὄφρ’ ἂν ἔγωγε	--- - - uu-uu - u u--	dactylic hexameter	masculine penthemimeral, trithemimeral
ζωοῖσιν μετέω καί μοι φίλα γούνατ’ ὀρώρῃ·	--- uu- - - uu -u u--	dactylic hexameter	masculine penthemimeral, hepthemimeral, trithemimeral
εἰ δὲ θανόντων περ καταλήθοντ’ εἰν Ἀΐδαο	- u u-- - uu-- - uu--	dactylic hexameter	masculine penthemimeral
αὐτὰρ ἐγὼ καὶ κεῖθι φίλου μεμνήσομ’ ἑταίρου.	-u u- - -u u- --u u--	dactylic hexameter	feminine penthemimeral, hepthemimeral, trithemimeral
νῦν δ’ἄγ’ ἀείδοντες παιήονα κοῦροι Ἀχαιῶν	- u u--- --uu -u u--	dactylic hexameter	masculine penthemimeral
νηυσὶν ἔπι γλαφυρῇσι νεώμεθα, τόνδε δ’ἄγωμεν.	-u u- uu-u u-uu -u u--	dactylic hexameter	feminine penthemimeral, trithemimeral
ἠράμεθα μέγα κῦδος· ἐπέφνομεν Ἕκτορα δῖον,	-uu- uu -u u-uu -uu --	dactylic hexameter	feminine penthemimeral, trithemimeral
ᾧ Τρῶες κατὰ ἄστυ θεῷ ὣς εὐχετόωντο.	- -- uu -u u- - -uu--	dactylic hexameter	feminine penthemimeral, hepthemimeral, trithemimeral
ἦ ῥα, καὶ Ἕκτορα δῖον ἀεικέα μήδετο ἔργα.	- u u -uu -u u-uu -uu --	dactylic hexameter	feminine penthemimeral
ἀμφοτέρων μετόπισθε ποδῶν τέτρηνε τένοντε	-uu- uu-u u- --u u--	dactylic hexameter	feminine penthemimeral, hepthemimeral, trithemimeral
ἐς σφυρὸν ἐκ πτέρνης, βοέους δ’ἐξῆπτεν ἱμάντας,	- uu - -- uu- --u u--	dactylic hexameter	masculine penthemimeral, hepthemimeral, trithemimeral
ἐκ δίφροιο δ’ἔδησε, κάρη δ’ἕλκεσθαι ἔασεν·	- --u u-u u- --u u--	dactylic hexameter	feminine penthemimeral, hepthemimeral
ἐς δίφρον δ’ἀναβὰς ἀνά τε κλυτὰ τεύχε’ ἀείρας	- -- uu- uu - uu -u u--	dactylic hexameter	masculine penthemimeral, hepthemimeral, trithemimeral
μάστιξέν ῥ’ἐλάαν, τὼ δ’οὐκ ἀέκοντε πετέσθην.	--- uu- - - uu-u u--	dactylic hexameter	masculine penthemimeral, hepthemimeral, trithemimeral
τοῦ δ’ἦν ἑλκομένοιο κονίσαλος, ἀμφὶ δὲ χαῖται	- - -uu-u u-uu -u u --	dactylic hexameter	feminine penthemimeral
κυάνεαι πίτναντο, κάρη δ’ἅπαν ἐν κονίῃσι	-uu- --u u- uu - uu--	dactylic hexameter	feminine penthemimeral, hepthemimeral, trithemimeral
κεῖτο πάρος χαρίεν· τότε δὲ Ζεὺς δυσμενέεσσι	-u u- uu- uu - - -uu--	dactylic hexameter	masculine penthemimeral, hepthemimeral, trithemimeral
δῶκεν ἀεικίσσασθαι ἑῇ ἐν πατρίδι γαίῃ.	-u u---u u- - -uu --	dactylic hexameter	feminine penthemimeral, hepthemimeral
ὣς τοῦ μὲν κεκόνιτο κάρη ἅπαν· ἣ δέ νυ μήτηρ	- - - uu-u u- uu - u u --	dactylic hexameter	feminine penthemimeral, hepthemimeral, trithemimeral
τίλλε κόμην, ἀπὸ δὲ λιπαρὴν ἔρριψε καλύπτρην	-u u- uu - uu- --u u--	dactylic hexameter	masculine penthemimeral, hepthemimeral, trithemimeral
τηλόσε, κώκυσεν δὲ μάλα μέγα παῖδ’ ἐσιδοῦσα·	-uu --- u u- uu - uu--	dactylic hexameter	masculine penthemimeral, hepthemimeral
ᾤμωξεν δ’ἐλεεινὰ πατὴρ φίλος, ἀμφὶ δὲ λαοὶ	--- uu-u u- uu -u u --	dactylic hexameter	feminine penthemimeral, hepthemimeral, trithemimeral
κωκυτῷ τ’εἴχοντο καὶ οἰμωγῇ κατὰ ἄστυ.	--- --u u --- uu --	dactylic hexameter	feminine penthemimeral, trithemimeral
τῷ δὲ μάλιστ’ ἄρ’ ἔην ἐναλίγκιον ὡς εἰ ἅπασα	- u u- u u- uu-uu - u u--	dactylic hexameter	masculine penthemimeral, trithemimeral
Ἴλιος ὀφρυόεσσα πυρὶ σμύχοιτο κατ’ ἄκρης.	-uu -uu-u u- --u u --	dactylic hexameter	feminine penthemimeral, hepthemimeral
λαοὶ μέν ῥα γέροντα μόγις ἔχον ἀσχαλόωντα	-- - u u-u u- uu -uu--	dactylic hexameter	feminine penthemimeral, hepthemimeral, trithemimeral
ἐξελθεῖν μεμαῶτα πυλάων Δαρδανιάων.	--- uu-u u-- -uu--	dactylic hexameter	feminine penthemimeral, trithemimeral
πάντας δ’ἐλλιτάνευε κυλινδόμενος κατὰ κόπρον,	-- -uu-u u-uu- uu --	dactylic hexameter	feminine penthemimeral
ἐξονομακλήδην ὀνομάζων ἄνδρα ἕκαστον·	-uu--- uu-- -u u--	dactylic hexameter	masculine penthemimeral
σχέσθε φίλοι, καί μ’οἶον ἐάσατε κηδόμενοί περ	-u u- - -u u-uu -uu- -	dactylic hexameter	feminine penthemimeral, trithemimeral
ἐξελθόντα πόληος ἱκέσθ’ ἐπὶ νῆας Ἀχαιῶν.	---u u-u u- uu -u u--	dactylic hexameter	feminine penthemimeral, hepthemimeral
λίσσωμ’ ἀνέρα τοῦτον ἀτάσθαλον ὀβριμοεργόν,	-- -uu -u u-uu -uu--	dactylic hexameter	feminine penthemimeral
ἤν πως ἡλικίην αἰδέσσεται ἠδ’ ἐλεήσῃ	- - -uu- --uu - uu--	dactylic hexameter	masculine penthemimeral
γῆρας· καὶ δέ νυ τῷ γε πατὴρ τοιόσδε τέτυκται	-- - u u - u u- --u u--	dactylic hexameter	masculine penthemimeral, hepthemimeral, trithemimeral
Πηλεύς, ὅς μιν ἔτικτε καὶ ἔτρεφε πῆμα γενέσθαι	-- - u u-u u -uu -u u--	dactylic hexameter	feminine penthemimeral, trithemimeral
Τρωσί· μάλιστα δ’ἐμοὶ περὶ πάντων ἄλγε’ ἔθηκε.	-u u-u u- uu -- -u u--	dactylic hexameter	masculine penthemimeral
τόσσους γάρ μοι παῖδας ἀπέκτανε τηλεθάοντας·	-- - - -u u-uu -uu--	dactylic hexameter	feminine penthemimeral, trithemimeral
τῶν πάντων οὐ τόσσον ὀδύρομαι ἀχνύμενός περ	- -- - -u u-uu -uu- -	dactylic hexameter	feminine penthemimeral, trithemimeral
ὡς ἑνός, οὗ μ’ἄχος ὀξὺ κατοίσεται Ἄϊδος εἴσω,	- uu - uu -u u-uu -uu --	dactylic hexameter	feminine penthemimeral, trithemimeral
Ἕκτορος· ὡς ὄφελεν θανέειν ἐν χερσὶν ἐμῇσι·	-uu - uu- uu- - -u u--	dactylic hexameter	masculine penthemimeral, hepthemimeral, trithemimeral
τώ κε κορεσσάμεθα κλαίοντέ τε μυρομένω τε	- u u-uu- --u u -uu- -	dactylic hexameter	masculine penthemimeral
μήτηρ θ’,ἥ μιν ἔτικτε δυσάμμορος, ἠδ’ ἐγὼαὐτός.	-- - u u-u u-uu - uu--	dactylic hexameter	feminine penthemimeral, trithemimeral
ὣς ἔφατο κλαίων, ἐπὶ δὲ στενάχοντο πολῖται·	- uu- -- uu - uu-u u--	dactylic hexameter	masculine penthemimeral, hepthemimeral, trithemimeral
Τρῳῇσιν δ’Ἑκάβη ἁδινοῦ ἐξῆρχε γόοιο·	--- uu- uu- --u u--	dactylic hexameter	masculine penthemimeral, hepthemimeral, trithemimeral
τέκνον ἐγὼ δειλή· τί νυ βείομαι αἰνὰ παθοῦσα	-u u- -- u u -uu -u u--	dactylic hexameter	masculine penthemimeral, trithemimeral
σεῦ ἀποτεθνηῶτος; ὅ μοι νύκτάς τε καὶ ἦμαρ	- uu---u u - -- u u --	dactylic hexameter	feminine penthemimeral, hepthemimeral
εὐχωλὴ κατὰ ἄστυ πελέσκεο, πᾶσί τ’ὄνειαρ	--- uu -u u-uu -u u--	dactylic hexameter	feminine penthemimeral, trithemimeral
Τρωσί τε καὶ Τρῳῇσι κατὰ πτόλιν, οἵ σε θεὸν ὣς	-u u - --u u- uu - u u- -	dactylic hexameter	feminine penthemimeral, hepthemimeral, trithemimeral
δειδέχατ’· ἦ γὰρ καί σφι μάλα μέγα κῦδος ἔησθα	-uu - - - u u- uu -u u--	dactylic hexameter	masculine penthemimeral, hepthemimeral, trithemimeral
ζωὸς ἐών· νῦν αὖ θάνατος καὶ μοῖρα κιχάνει.	-u u- - - uu- - -u u--	dactylic hexameter	masculine penthemimeral, hepthemimeral, trithemimeral
ὣς ἔφατο κλαίουσ’, ἄλοχος δ’οὔ πώ τι πέπυστο	- uu- -- uu- - - u u--	dactylic hexameter	masculine penthemimeral, hepthemimeral, trithemimeral
Ἕκτορος· οὐ γάρ οἵ τις ἐτήτυμος ἄγγελος ἐλθὼν	-uu - - - u u-uu -uu --	dactylic hexameter	masculine penthemimeral, trithemimeral
ἤγγειλ’ ὅττί ῥά οἱ πόσις ἔκτοθι μίμνε πυλάων,	-- -u u - uu -uu -u u--	dactylic hexameter	masculine penthemimeral
ἀλλ’ ἥ γ’ἱστὸν ὕφαινε μυχῷ δόμου ὑψηλοῖο	- - -u u-u u- uu ----	dactylic hexameter	feminine penthemimeral, hepthemimeral
δίπλακα πορφυρέην, ἐν δὲ θρόνα ποικίλ’ ἔπασσε.	-uu -uu- - - uu -u u--	dactylic hexameter	masculine penthemimeral, hepthemimeral
κέκλετο δ’ἀμφιπόλοισιν ἐϋπλοκάμοις κατὰ δῶμα	-uu -uu-u u-uu- uu --	dactylic hexameter	feminine penthemimeral
ἀμφὶ πυρὶ στῆσαι τρίποδα μέγαν, ὄφρα πέλοιτο	-u u- -- uu- uu -u u--	dactylic hexameter	masculine penthemimeral, hepthemimeral, trithemimeral
Ἕκτορι θερμὰ λοετρὰ μάχης ἐκ νοστήσαντι	-uu -u u-u u- - ----	dactylic hexameter	feminine penthemimeral, hepthemimeral
νηπίη, οὐδ’ ἐνόησεν ὅ μιν μάλα τῆλε λοετρῶν	-uu - uu-u u - uu -u u--	dactylic hexameter	feminine penthemimeral, hepthemimeral, trithemimeral
χερσὶν Ἀχιλλῆος δάμασε γλαυκῶπις Ἀθήνη.	-u u--- uu- --u u--	dactylic hexameter	masculine penthemimeral, hepthemimeral
κωκυτοῦ δ’ἤκουσε καὶ οἰμωγῆς ἀπὸ πύργου·	--- --u u --- uu --	dactylic hexameter	feminine penthemimeral, trithemimeral
τῆς δ’ἐλελίχθη γυῖα, χαμαὶ δέ οἱ ἔκπεσε κερκίς·	- uu-- -u u- u u -uu --	dactylic hexameter	feminine penthemimeral, hepthemimeral
ἣ δ’αὖτις δμῳῇσιν ἐϋπλοκάμοισι μετηύδα·	- -- --u u-uu-u u--	dactylic hexameter	feminine penthemimeral, trithemimeral
δεῦτε δύω μοι ἕπεσθον, ἴδωμ’ ὅτιν’ ἔργα τέτυκται.	-u u- u u-u u- uu -u u--	dactylic hexameter	feminine penthemimeral, hepthemimeral, trithemimeral
αἰδοίης ἑκυρῆς ὀπὸς ἔκλυον, ἐν δ’ἐμοὶ αὐτῇ	--- uu- uu -uu - uu --	dactylic hexameter	masculine penthemimeral, trithemimeral
στήθεσι πάλλεται ἦτορ ἀνὰ στόμα, νέρθε δὲ γοῦνα	-uu -uu -u u- uu -u u --	dactylic hexameter	feminine penthemimeral, hepthemimeral
πήγνυται· ἐγγὺς δή τι κακὸν Πριάμοιο τέκεσσιν.	-uu -- - u u- uu-u u--	dactylic hexameter	masculine penthemimeral, hepthemimeral
αἲ γὰρ ἀπ’ οὔατος εἴη ἐμεῦ ἔπος· ἀλλὰ μάλ’ αἰνῶς	- u u -uu -u u- uu -u u --	dactylic hexameter	feminine penthemimeral, hepthemimeral
δείδω μὴ δή μοι θρασὺν Ἕκτορα δῖος Ἀχιλλεὺς	-- - - - uu -uu -u u--	dactylic hexameter	masculine penthemimeral, trithemimeral
μοῦνον ἀποτμήξας πόλιος πεδίον δὲ δίηται,	-u u--- uu- uu- u u--	dactylic hexameter	masculine penthemimeral, hepthemimeral
καὶ δή μιν καταπαύσῃ ἀγηνορίης ἀλεγεινῆς	- - - uu-u u-uu- uu--	dactylic hexameter	feminine penthemimeral, trithemimeral
ἥ μιν ἔχεσκ’, ἐπεὶ οὔ ποτ’ ἐνὶ πληθυῖ μένεν ἀνδρῶν,	- u u- uu - u u- -- uu --	dactylic hexameter	masculine penthemimeral, hepthemimeral, trithemimeral
ἀλλὰ πολὺ προθέεσκε, τὸ ὃν μένος οὐδενὶ εἴκων.	-u u- uu-u u - uu -uu --	dactylic hexameter	feminine penthemimeral, hepthemimeral, trithemimeral
ὣς φαμένη μεγάροιο διέσσυτο μαινάδι ἴση	- uu- uu-u u-uu -uu --	dactylic hexameter	feminine penthemimeral, trithemimeral
παλλομένη κραδίην· ἅμα δ’ἀμφίπολοι κίον αὐτῇ	-uu- uu- uu -uu- uu --	dactylic hexameter	masculine penthemimeral, trithemimeral
αὐτὰρ ἐπεὶ πύργόν τε καὶ ἀνδρῶν ἷξεν ὅμιλον	-u u- -- u u -- -u u--	dactylic hexameter	masculine penthemimeral, trithemimeral
ἔστη παπτήνασ’ ἐπὶ τείχεϊ, τὸν δὲ νόησεν	-- --- uu -uu - u u--	dactylic hexameter	masculine penthemimeral
ἑλκόμενον πρόσθεν πόλιος· ταχέες δέ μιν ἵπποι	-uu- -- uu- uu- u u --	dactylic hexameter	masculine penthemimeral, hepthemimeral, trithemimeral
ἕλκον ἀκηδέστως κοίλας ἐπὶ νῆας Ἀχαιῶν.	-u u--- -- uu -u u--	dactylic hexameter	masculine penthemimeral, hepthemimeral
τὴν δὲ κατ’ ὀφθαλμῶν ἐρεβεννὴ νὺξ ἐκάλυψεν,	- u u --- uu-- - uu--	dactylic hexameter	masculine penthemimeral
ἤριπε δ’ἐξοπίσω, ἀπὸ δὲ ψυχὴν ἐκάπυσσε.	-uu -uu- uu - -- uu--	dactylic hexameter	masculine penthemimeral, hepthemimeral
τῆλε δ’ἀπὸ κρατὸς βάλε δέσματα σιγαλόεντα,	-u u- -- uu -uu -uu--	dactylic hexameter	masculine penthemimeral, trithemimeral
ἄμπυκα κεκρύφαλόν τε ἰδὲ πλεκτὴν ἀναδέσμην	-uu -uu- u u- -- uu--	dactylic hexameter	masculine penthemimeral, hepthemimeral
κρήδεμνόν θ’,ὅ ῥά οἱ δῶκε χρυσῆ Ἀφροδίτη	--- u u - -- -- uu--	dactylic hexameter	masculine penthemimeral, hepthemimeral, trithemimeral
ἤματι τῷ ὅτε μιν κορυθαίολος ἠγάγεθ’ Ἕκτωρ	-uu - uu - uu-uu -uu --	dactylic hexameter	masculine penthemimeral, trithemimeral
ἐκ δόμου Ἠετίωνος, ἐπεὶ πόρε μυρία ἕδνα.	- uu -uu-u u- uu -uu --	dactylic hexameter	feminine penthemimeral, hepthemimeral
ἀμφὶ δέ μιν γαλόῳ τε καὶ εἰνατέρες ἅλις ἔσταν,	-u u - uu- u u -uu- uu --	dactylic hexameter	masculine penthemimeral, trithemimeral
αἵ ἑ μετὰ σφίσιν εἶχον ἀτυζομένην ἀπολέσθαι.	- u u- uu -u u-uu- uu--	dactylic hexameter	feminine penthemimeral, trithemimeral
ἣ δ’ἐπεὶ οὖν ἔμπνυτο καὶ ἐς φρένα θυμὸς ἀγέρθη	- uu - --u u - uu -u u--	dactylic hexameter	feminine penthemimeral, hepthemimeral, trithemimeral
ἀμβλήδην γοόωσα μετὰ Τρῳῇσιν ἔειπεν·	--- uu-u u- --u u--	dactylic hexameter	feminine penthemimeral, hepthemimeral, trithemimeral
Ἕκτορ ἐγὼ δύστηνος· ἰῇ ἄρα γεινόμεθ’ αἴσῃ	-u u- --u u- uu -uu --	dactylic hexameter	feminine penthemimeral, hepthemimeral, trithemimeral
ἀμφότεροι, σὺ μὲν ἐν Τροίῃ Πριάμου κατὰ δῶμα,	-uu- u u - -- uu- uu --	dactylic hexameter	masculine penthemimeral, hepthemimeral, trithemimeral
αὐτὰρ ἐγὼ Θήβῃσιν ὑπὸ Πλάκῳ ὑληέσσῃ	-u u- --u u- uu ----	dactylic hexameter	feminine penthemimeral, hepthemimeral, trithemimeral
ἐν δόμῳ Ἠετίωνος, ὅ μ’ἔτρεφε τυτθὸν ἐοῦσαν	- uu -uu-u u -uu -u u--	dactylic hexameter	feminine penthemimeral
δύσμορος αἰνόμορον· ὡς μὴ ὤφελλε τεκέσθαι.	-uu -uu- - - --u u--	dactylic hexameter	masculine penthemimeral, hepthemimeral
νῦν δὲ σὺ μὲν Ἀΐδαο δόμους ὑπὸ κεύθεσι γαίης	- u u - uu-u u- uu -uu --	dactylic hexameter	feminine penthemimeral, hepthemimeral, trithemimeral
ἔρχεαι, αὐτὰρ ἐμὲ στυγερῷ ἐνὶ πένθεϊ λείπεις	-uu -u u- uu- uu -uu --	dactylic hexameter	masculine penthemimeral, hepthemimeral
χήρην ἐν μεγάροισι· πάϊς δ’ἔτι νήπιος αὔτως,	-- - uu-u u- uu -uu --	dactylic hexameter	feminine penthemimeral, hepthemimeral, trithemimeral
ὃν τέκομεν σύ τ’ἐγώ τε δυσάμμοροι· οὔτε σὺ τούτῳ	- uu- u u- u u-uu -u u --	dactylic hexameter	masculine penthemimeral, trithemimeral
ἔσσεαι Ἕκτορ ὄνειαρ ἐπεὶ θάνες, οὔτε σοὶ οὗτος.	-uu -u u-u u- uu -u u --	dactylic hexameter	feminine penthemimeral, hepthemimeral
ἤν περ γὰρ πόλεμόν γε φύγῃ πολύδακρυν Ἀχαιῶν,	- - - uu- u u- uu-u u--	dactylic hexameter	masculine penthemimeral, hepthemimeral, trithemimeral
αἰεί τοι τούτῳ γε πόνος καὶ κήδε’ ὀπίσσω	-- - -- u u- - -u u--	dactylic hexameter	masculine penthemimeral, hepthemimeral, trithemimeral
ἔσσοντ’· ἄλλοι γάρ οἱ ἀπουρίσσουσιν ἀρούρας.	-- -- - u u---u u--	dactylic hexameter	masculine penthemimeral
ἦμαρ δ’ὀρφανικὸν παναφήλικα παῖδα τίθησι·	-- -uu- uu-uu -u u--	dactylic hexameter	masculine penthemimeral
πάντα δ’ὑπεμνήμυκε, δεδάκρυνται δὲ παρειαί,	-u u---u u--- u u--	dactylic hexameter	feminine penthemimeral
δευόμενος δέ τ’ἄνεισι πάϊς ἐς πατρὸς ἑταίρους,	-uu- u u-u u- - -u u--	dactylic hexameter	feminine penthemimeral, hepthemimeral, trithemimeral
ἄλλον μὲν χλαίνης ἐρύων, ἄλλον δὲ χιτῶνος·	-- - -- uu- -- u u--	dactylic hexameter	masculine penthemimeral, hepthemimeral, trithemimeral
τῶν δ’ἐλεησάντων κοτύλην τις τυτθὸν ἐπέσχε·	- uu--- uu- - -u u--	dactylic hexameter	masculine penthemimeral, hepthemimeral
χείλεα μέν τ’ἐδίην’, ὑπερῴην δ’οὐκ ἐδίηνε.	-uu - uu- uu-- - uu--	dactylic hexameter	masculine penthemimeral, trithemimeral
τὸν δὲ καὶ ἀμφιθαλὴς ἐκ δαιτύος ἐστυφέλιξε	- u u -uu- - -uu -uu--	dactylic hexameter	masculine penthemimeral
χερσὶν πεπλήγων καὶ ὀνειδείοισιν ἐνίσσων·	-- --- u u---u u--	dactylic hexameter	masculine penthemimeral
ἔρρ’ οὕτως· οὐ σός γε πατὴρ μεταδαίνυται ἡμῖν.	- -- - - u u- uu-uu --	dactylic hexameter	masculine penthemimeral, hepthemimeral, trithemimeral
δακρυόεις δέ τ’ἄνεισι πάϊς ἐς μητέρα χήρην	-uu- u u-u u- - -uu --	dactylic hexameter	feminine penthemimeral, hepthemimeral, trithemimeral
Ἀστυάναξ, ὃς πρὶν μὲν ἑοῦ ἐπὶ γούνασι πατρὸς	-uu- - - u u- uu -uu --	dactylic hexameter	masculine penthemimeral, hepthemimeral, trithemimeral
μυελὸν οἶον ἔδεσκε καὶ οἰῶν πίονα δημόν·	-uu -u u-u u -- -uu --	dactylic hexameter	feminine penthemimeral
αὐτὰρ ὅθ’ ὕπνος ἕλοι, παύσαιτό τε νηπιαχεύων,	-u u -u u- --u u -uu--	dactylic hexameter	masculine penthemimeral
εὕδεσκ’ ἐν λέκτροισιν ἐν ἀγκαλίδεσσι τιθήνης	-- - --u u -uu-u u--	dactylic hexameter	feminine penthemimeral, trithemimeral
εὐνῇ ἔνι μαλακῇ θαλέων ἐμπλησάμενος κῆρ·	-u u- uu- uu- --uu- -	dactylic hexameter	masculine penthemimeral, hepthemimeral, trithemimeral
νῦν δ’ἂν πολλὰ πάθῃσι φίλου ἀπὸ πατρὸς ἁμαρτὼν	- - -u u-u u- uu -u u--	dactylic hexameter	feminine penthemimeral, hepthemimeral
Ἀστυάναξ, ὃν Τρῶες ἐπίκλησιν καλέουσιν·	-uu- - -u u--- uu--	dactylic hexameter	feminine penthemimeral, trithemimeral
οἶος γάρ σφιν ἔρυσο πύλας καὶ τείχεα μακρά.	-- - u u-u u- - -uu --	dactylic hexameter	feminine penthemimeral, hepthemimeral, trithemimeral
νῦν δὲ σὲ μὲν παρὰ νηυσὶ κορωνίσι νόσφι τοκήων	- u u - uu -u u-uu -u u--	dactylic hexameter	feminine penthemimeral, trithemimeral
αἰόλαι εὐλαὶ ἔδονται, ἐπεί κε κύνες κορέσωνται	-uu -u u-u u- u u- uu--	dactylic hexameter	feminine penthemimeral, hepthemimeral
γυμνόν· ἀτάρ τοι εἵματ’ ἐνὶ μεγάροισι κέονται	-u u- - -u u- uu-u u--	dactylic hexameter	feminine penthemimeral, hepthemimeral, trithemimeral
λεπτά τε καὶ χαρίεντα τετυγμένα χερσὶ γυναικῶν.	-u u - uu-u u-uu -u u--	dactylic hexameter	feminine penthemimeral, trithemimeral
ἀλλ’ ἤτοι τάδε πάντα καταφλέξω πυρὶ κηλέῳ	- -- uu -u u--- uu --	dactylic hexameter	feminine penthemimeral, trithemimeral
οὐδὲν σοί γ’ὄφελος, ἐπεὶ οὐκ ἐγκείσεαι αὐτοῖς,	-- - uu- uu - --uu --	dactylic hexameter	masculine penthemimeral, hepthemimeral, trithemimeral
ἀλλὰ πρὸς Τρώων καὶ Τρωϊάδων κλέος εἶναι.	-- - -- - -uu- uu --	dactylic hexameter	masculine penthemimeral, trithemimeral
ὣς ἔφατο κλαίουσ’, ἐπὶ δὲ στενάχοντο γυναῖκες.	- uu- -- uu - uu-u u--	dactylic hexameter	masculine penthemimeral, hepthemimeral, trithemimeral
