ὣς οἱ μὲν Τρῶες φυλακὰς ἔχον· αὐτὰρ Ἀχαιοὺς	- - - -- uu- uu -u u--	dactylic hexameter	masculine penthemimeral, hepthemimeral, trithemimeral
θεσπεσίη ἔχε φύζα φόβου κρυόεντος ἑταίρη,	-uu- uu -u u- uu-u u--	dactylic hexameter	feminine penthemimeral, hepthemimeral, trithemimeral
πένθεϊ δ’ἀτλήτῳ βεβολήατο πάντες ἄριστοι.	-uu --- uu-uu -u u--	dactylic hexameter	masculine penthemimeral
ὡς δ’ἄνεμοι δύο πόντον ὀρίνετον ἰχθυόεντα	- uu- uu -u u-uu -uu--	dactylic hexameter	feminine penthemimeral, trithemimeral
Βορέης καὶ Ζέφυρος, τώ τε Θρῄκηθεν ἄητον	-- - uu- - - --u u--	dactylic hexameter	masculine penthemimeral, hepthemimeral, trithemimeral
ἐλθόντ’ ἐξαπίνης· ἄμυδις δέ τε κῦμα κελαινὸν	-- -uu- uu- u u -u u--	dactylic hexameter	masculine penthemimeral, hepthemimeral
κορθύεται, πολλὸν δὲ παρὲξ ἅλα φῦκος ἔχευεν·	-uu- -- u u- uu -u u--	dactylic hexameter	masculine penthemimeral, hepthemimeral, trithemimeral
ὣς ἐδαΐζετο θυμὸς ἐνὶ στήθεσσιν Ἀχαιῶν.	- uu-uu -u u- --u u--	dactylic hexameter	feminine penthemimeral, hepthemimeral
Ἀτρεΐδης δ’ἄχεϊ μεγάλῳ βεβολημένος ἦτορ	-uu- uu- uu- uu-uu --	dactylic hexameter	masculine penthemimeral, hepthemimeral, trithemimeral
φοίτα κηρύκεσσι λιγυφθόγγοισι κελεύων	-- ---u u---u u--	dactylic hexameter	feminine penthemimeral
κλήδην εἰς ἀγορὴν κικλήσκειν ἄνδρα ἕκαστον,	-- - uu- --- -u u--	dactylic hexameter	masculine penthemimeral, trithemimeral
μὴ δὲ βοᾶν· αὐτὸς δὲ μετὰ πρώτοισι πονεῖτο.	- u u- -- u u- --u u--	dactylic hexameter	masculine penthemimeral, hepthemimeral, trithemimeral
ἷζον δ’εἰν ἀγορῇ τετιηότες· ἂν δ’Ἀγαμέμνων	-- - uu- uu-uu - uu--	dactylic hexameter	masculine penthemimeral, trithemimeral
ἵστατο δάκρυ χέων ὥς τε κρήνη μελάνυδρος	-uu -u u- - - -- uu--	dactylic hexameter	masculine penthemimeral, hepthemimeral
ἥ τε κατ’ αἰγίλιπος πέτρης δνοφερὸν χέει ὕδωρ·	- u u -uu- -- uu- uu --	dactylic hexameter	masculine penthemimeral, hepthemimeral
ὣς ὃ βαρὺ στενάχων ἔπε’ Ἀργείοισι μετηύδα·	- u u- uu- uu ---u u--	dactylic hexameter	masculine penthemimeral, trithemimeral
ὦ φίλοι Ἀργείων ἡγήτορες ἠδὲ μέδοντες	- uu --- --uu -u u--	dactylic hexameter	masculine penthemimeral
Ζεύς με μέγα Κρονίδης ἄτῃ ἐνέδησε βαρείῃ	- u u- uu- -- uu-u u--	dactylic hexameter	masculine penthemimeral, hepthemimeral, trithemimeral
σχέτλιος, ὃς τότε μέν μοι ὑπέσχετο καὶ κατένευσεν	-uu - uu - u u-uu - uu--	dactylic hexameter	masculine penthemimeral, trithemimeral
Ἴλιον ἐκπέρσαντ’ εὐτείχεον ἀπονέεσθαι,	-uu --- --uu -uu--	dactylic hexameter	masculine penthemimeral
νῦν δὲ κακὴν ἀπάτην βουλεύσατο, καί με κελεύει	- u u- uu- --uu - u u--	dactylic hexameter	masculine penthemimeral, trithemimeral
δυσκλέα Ἄργος ἱκέσθαι, ἐπεὶ πολὺν ὤλεσα λαόν.	-uu -u u-u u- uu -uu --	dactylic hexameter	feminine penthemimeral, hepthemimeral
οὕτω που Διὶ μέλλει ὑπερμενέϊ φίλον εἶναι,	-- - uu -u u-uu- uu --	dactylic hexameter	feminine penthemimeral, trithemimeral
ὃς δὴ πολλάων πολίων κατέλυσε κάρηνα	- - --- uu- uu-u u--	dactylic hexameter	masculine penthemimeral, hepthemimeral
ἠδ’ ἔτι καὶ λύσει· τοῦ γὰρ κράτος ἐστὶ μέγιστον.	- uu - -- - - uu -u u--	dactylic hexameter	masculine penthemimeral, hepthemimeral, trithemimeral
ἀλλ’ ἄγεθ’ ὡς ἂν ἐγὼ εἴπω πειθώμεθα πάντες·	- uu - u u- -- --uu --	dactylic hexameter	masculine penthemimeral, hepthemimeral, trithemimeral
φεύγωμεν σὺν νηυσὶ φίλην ἐς πατρίδα γαῖαν·	--- - -u u- - -uu --	dactylic hexameter	feminine penthemimeral, hepthemimeral, trithemimeral
οὐ γὰρ ἔτι Τροίην αἱρήσομεν εὐρυάγυιαν.	- u u- -- --uu -uu--	dactylic hexameter	masculine penthemimeral, trithemimeral
ὣς ἔφαθ’, οἳ δ’ἄρα πάντες ἀκὴν ἐγένοντο σιωπῇ.	- uu - uu -u u- uu-u u--	dactylic hexameter	feminine penthemimeral, hepthemimeral, trithemimeral
δὴν δ’ἄνεῳ ἦσαν τετιηότες υἷες Ἀχαιῶν·	- uu- -- uu-uu -u u--	dactylic hexameter	masculine penthemimeral, trithemimeral
ὀψὲ δὲ δὴ μετέειπε βοὴν ἀγαθὸς Διομήδης·	-u u - uu-u u- uu- uu--	dactylic hexameter	feminine penthemimeral, hepthemimeral, trithemimeral
Ἀτρεΐδη σοὶ πρῶτα μαχήσομαι ἀφραδέοντι,	-uu- - -u u-uu -uu--	dactylic hexameter	feminine penthemimeral, trithemimeral
ἣ θέμις ἐστὶν ἄναξ ἀγορῇ· σὺ δὲ μή τι χολωθῇς.	- uu -u u- uu- u u - u u--	dactylic hexameter	masculine penthemimeral, hepthemimeral
ἀλκὴν μέν μοι πρῶτον ὀνείδισας ἐν Δαναοῖσι	-- - - -u u-uu - uu--	dactylic hexameter	feminine penthemimeral, trithemimeral
φὰς ἔμεν ἀπτόλεμον καὶ ἀνάλκιδα· ταῦτα δὲ πάντα	- uu -uu- u u-uu -u u --	dactylic hexameter	masculine penthemimeral
ἴσασ’ Ἀργείων ἠμὲν νέοι ἠδὲ γέροντες.	-- --- -- uu -u u--	dactylic hexameter	masculine penthemimeral, hepthemimeral
σοὶ δὲ διάνδιχα δῶκε Κρόνου πάϊς ἀγκυλομήτεω·	- u u-uu -u u- uu -uu--	dactylic hexameter	feminine penthemimeral, hepthemimeral
σκήπτρῳ μέν τοι δῶκε τετιμῆσθαι περὶ πάντων,	-- - - -u u--- uu --	dactylic hexameter	feminine penthemimeral, trithemimeral
ἀλκὴν δ’οὔ τοι δῶκεν, ὅ τε κράτος ἐστὶ μέγιστον.	-- - - -u u - uu -u u--	dactylic hexameter	feminine penthemimeral, hepthemimeral, trithemimeral
δαιμόνι’ οὕτω που μάλα ἔλπεαι υἷας Ἀχαιῶν	-uu -- - uu -uu -u u--	dactylic hexameter	masculine penthemimeral
ἀπτολέμους τ’ἔμεναι καὶ ἀνάλκιδας ὡς ἀγορεύεις;	-uu- uu- u u-uu - uu--	dactylic hexameter	masculine penthemimeral, trithemimeral
εἰ δέ τοι αὐτῷ θυμὸς ἐπέσσυται ὥς τε νέεσθαι	- u u -- -u u-uu - u u--	dactylic hexameter	feminine penthemimeral
ἔρχεο· πάρ τοι ὁδός, νῆες δέ τοι ἄγχι θαλάσσης	-uu - u u- -- u u -u u--	dactylic hexameter	masculine penthemimeral, hepthemimeral, trithemimeral
ἑστᾶσ’, αἵ τοι ἕποντο Μυκήνηθεν μάλα πολλαί.	-- - u u-u u--- uu --	dactylic hexameter	feminine penthemimeral, trithemimeral
ἀλλ’ ἄλλοι μενέουσι κάρη κομόωντες Ἀχαιοὶ	- -- uu-u u- uu-u u--	dactylic hexameter	feminine penthemimeral, hepthemimeral, trithemimeral
εἰς ὅ κέ περ Τροίην διαπέρσομεν. εἰ δὲ καὶ αὐτοὶ	- u u - -- uu-uu - u u --	dactylic hexameter	masculine penthemimeral, trithemimeral
φευγόντων σὺν νηυσὶ φίλην ἐς πατρίδα γαῖαν·	--- - -u u- - -uu --	dactylic hexameter	feminine penthemimeral, hepthemimeral, trithemimeral
νῶϊ δ’ἐγὼ Σθένελός τε μαχησόμεθ’ εἰς ὅ κε τέκμωρ	-u u- uu- u u-uu - u u --	dactylic hexameter	masculine penthemimeral, trithemimeral
Ἰλίου εὕρωμεν· σὺν γὰρ θεῷ εἰλήλουθμεν.	-uu --- - - uu ----	dactylic hexameter	masculine penthemimeral, hepthemimeral
ὣς ἔφαθ’, οἳ δ’ἄρα πάντες ἐπίαχον υἷες Ἀχαιῶν	- uu - uu -u u-uu -u u--	dactylic hexameter	feminine penthemimeral, trithemimeral
μῦθον ἀγασσάμενοι Διομήδεος ἱπποδάμοιο.	-u u-uu- uu-uu -uu--	dactylic hexameter	masculine penthemimeral
τοῖσι δ’ἀνιστάμενος μετεφώνεεν ἱππότα Νέστωρ·	-u u-uu- uu-uu -uu --	dactylic hexameter	masculine penthemimeral
Τυδεΐδη περὶ μὲν πολέμῳ ἔνι καρτερός ἐσσι,	-uu- uu - uu- uu -uu --	dactylic hexameter	masculine penthemimeral, hepthemimeral, trithemimeral
καὶ βουλῇ μετὰ πάντας ὁμήλικας ἔπλευ ἄριστος.	- -- uu -u u-uu -u u--	dactylic hexameter	feminine penthemimeral, trithemimeral
οὔ τίς τοι τὸν μῦθον ὀνόσσεται ὅσσοι Ἀχαιοί,	- - - - -u u-uu -u u--	dactylic hexameter	feminine penthemimeral, trithemimeral
οὐδὲ πάλιν ἐρέει· ἀτὰρ οὐ τέλος ἵκεο μύθων.	-u u- uu- uu - uu -uu --	dactylic hexameter	masculine penthemimeral, hepthemimeral, trithemimeral
ἦ μὲν καὶ νέος ἐσσί, ἐμὸς δέ κε καὶ πάϊς εἴης	- - - uu -u u- u u - uu --	dactylic hexameter	feminine penthemimeral, hepthemimeral, trithemimeral
ὁπλότατος γενεῆφιν· ἀτὰρ πεπνυμένα βάζεις	-uu- uu-u u- --uu --	dactylic hexameter	feminine penthemimeral, hepthemimeral, trithemimeral
Ἀργείων βασιλῆας, ἐπεὶ κατὰ μοῖραν ἔειπες.	--- uu-u u- uu -u u--	dactylic hexameter	feminine penthemimeral, hepthemimeral, trithemimeral
ἀλλ’ ἄγ’ ἐγών, ὃς σεῖο γεραίτερος εὔχομαι εἶναι,	- u u- - -u u-uu -uu --	dactylic hexameter	feminine penthemimeral, trithemimeral
ἐξείπω καὶ πάντα διίξομαι· οὐδέ κέ τίς μοι	--- - -u u-uu -u u - -	dactylic hexameter	feminine penthemimeral, trithemimeral
μῦθον ἀτιμήσει’, οὐδὲ κρείων Ἀγαμέμνων.	-u u--- -- -- uu--	dactylic hexameter	masculine penthemimeral, hepthemimeral
ἀφρήτωρ ἀθέμιστος ἀνέστιός ἐστιν ἐκεῖνος	--- uu-u u-uu -u u--	dactylic hexameter	feminine penthemimeral, trithemimeral
ὃς πολέμου ἔραται ἐπιδημίου ὀκρυόεντος.	- uu- uu- uu-uu -uu--	dactylic hexameter	masculine penthemimeral, trithemimeral
ἀλλ’ ἤτοι νῦν μὲν πειθώμεθα νυκτὶ μελαίνῃ	- -- - - --uu -u u--	dactylic hexameter	masculine penthemimeral, trithemimeral
δόρπά τ’ἐφοπλισόμεσθα· φυλακτῆρες δὲ ἕκαστοι	-u u-uu-u u--- u u--	dactylic hexameter	feminine penthemimeral
λεξάσθων παρὰ τάφρον ὀρυκτὴν τείχεος ἐκτός.	--- uu -u u-- -uu --	dactylic hexameter	feminine penthemimeral, trithemimeral
κούροισιν μὲν ταῦτ’ ἐπιτέλλομαι· αὐτὰρ ἔπειτα	--- - - uu-uu -u u--	dactylic hexameter	masculine penthemimeral, trithemimeral
Ἀτρεΐδη σὺ μὲν ἄρχε· σὺ γὰρ βασιλεύτατός ἐσσι.	-uu- u u -u u - uu-uu --	dactylic hexameter	feminine penthemimeral, hepthemimeral, trithemimeral
δαίνυ δαῖτα γέρουσιν· ἔοικέ τοι, οὔ τοι ἀεικές.	-- -u u-u u-u u - u u--	dactylic hexameter	feminine penthemimeral
πλεῖαί τοι οἴνου κλισίαι, τὸν νῆες Ἀχαιῶν	-- - -- uu- - -u u--	dactylic hexameter	masculine penthemimeral, hepthemimeral, trithemimeral
ἠμάτιαι Θρῄκηθεν ἐπ’ εὐρέα πόντον ἄγουσι·	-uu- --u u -uu -u u--	dactylic hexameter	feminine penthemimeral, trithemimeral
πᾶσά τοί ἐσθ’ ὑποδεξίη, πολέεσσι δ’ἀνάσσεις.	-u u - uu--- uu-u u--	dactylic hexameter	hepthemimeral, trithemimeral
πολλῶν δ’ἀγρομένων τῷ πείσεαι ὅς κεν ἀρίστην	-- -uu- - -uu - u u--	dactylic hexameter	masculine penthemimeral
βουλὴν βουλεύσῃ· μάλα δὲ χρεὼ πάντας Ἀχαιοὺς	-- --- uu - - -u u--	dactylic hexameter	masculine penthemimeral, hepthemimeral
ἐσθλῆς καὶ πυκινῆς, ὅτι δήϊοι ἐγγύθι νηῶν	-- - uu- uu -uu -uu --	dactylic hexameter	masculine penthemimeral, trithemimeral
καίουσιν πυρὰ πολλά· τίς ἂν τάδε γηθήσειε;	--- uu -u u - uu ----	dactylic hexameter	feminine penthemimeral, hepthemimeral, trithemimeral
νὺξ δ’ἧδ’ ἠὲ διαρραίσει στρατὸν ἠὲ σαώσει.	- - -u u--- uu -u u--	dactylic hexameter	hepthemimeral
ὣς ἔφαθ’, οἳ δ’ἄρα τοῦ μάλα μὲν κλύον ἠδὲ πίθοντο.	- uu - uu - uu - uu -u u--	dactylic hexameter	masculine penthemimeral, hepthemimeral, trithemimeral
ἐκ δὲ φυλακτῆρες σὺν τεύχεσιν ἐσσεύοντο	- u u--- - -uu ----	dactylic hexameter	masculine penthemimeral
ἀμφί τε Νεστορίδην Θρασυμήδεα ποιμένα λαῶν,	-u u -uu- uu-uu -uu --	dactylic hexameter	masculine penthemimeral
ἠδ’ ἀμφ’ Ἀσκάλαφον καὶ Ἰάλμενον υἷας Ἄρηος	- - -uu- u u-uu -u u--	dactylic hexameter	masculine penthemimeral
ἀμφί τε Μηριόνην Ἀφαρῆά τε Δηΐπυρόν τε,	-u u -uu- uu-u u -uu- -	dactylic hexameter	masculine penthemimeral
ἠδ’ ἀμφὶ Κρείοντος υἱὸν Λυκομήδεα δῖον.	- -- -- -- uu-uu --	dactylic hexameter	masculine penthemimeral, hepthemimeral, trithemimeral
ἕπτ’ ἔσαν ἡγεμόνες φυλάκων, ἑκατὸν δὲ ἑκάστῳ	- uu -uu- uu- uu- u u--	dactylic hexameter	masculine penthemimeral, hepthemimeral
κοῦροι ἅμα στεῖχον δολίχ’ ἔγχεα χερσὶν ἔχοντες·	-u u- -- uu -uu -u u--	dactylic hexameter	masculine penthemimeral, trithemimeral
κὰδ δὲ μέσον τάφρου καὶ τείχεος ἷζον ἰόντες·	- u u- -- - -uu -u u--	dactylic hexameter	masculine penthemimeral, trithemimeral
ἔνθα δὲ πῦρ κήαντο, τίθεντο δὲ δόρπα ἕκαστος.	-u u - --u u-u u -u u--	dactylic hexameter	feminine penthemimeral, trithemimeral
Ἀτρεΐδης δὲ γέροντας ἀολλέας ἦγεν Ἀχαιῶν	-uu- u u-u u-uu -u u--	dactylic hexameter	feminine penthemimeral, trithemimeral
ἐς κλισίην, παρὰ δέ σφι τίθει μενοεικέα δαῖτα.	- uu- uu - u u- uu-uu --	dactylic hexameter	masculine penthemimeral, hepthemimeral, trithemimeral
οἳ δ’ἐπ’ ὀνείαθ’ ἑτοῖμα προκείμενα χεῖρας ἴαλλον.	- u u-u u-u u-uu -u u--	dactylic hexameter	feminine penthemimeral
αὐτὰρ ἐπεὶ πόσιος καὶ ἐδητύος ἐξ ἔρον ἕντο,	-u u- uu- u u-uu - uu --	dactylic hexameter	masculine penthemimeral, trithemimeral
τοῖς ὁ γέρων πάμπρωτος ὑφαίνειν ἤρχετο μῆτιν	- u u- --u u-- -uu --	dactylic hexameter	feminine penthemimeral, trithemimeral
Νέστωρ, οὗ καὶ πρόσθεν ἀρίστη φαίνετο βουλή·	-- - - -u u-- -uu --	dactylic hexameter	feminine penthemimeral, trithemimeral
ὅ σφιν ἐϋφρονέων ἀγορήσατο καὶ μετέειπεν·	- u u-uu- uu-uu - uu--	dactylic hexameter	masculine penthemimeral
Ἀτρεΐδη κύδιστε ἄναξ ἀνδρῶν Ἀγάμεμνον	-uu- --u u- -- uu--	dactylic hexameter	feminine penthemimeral, hepthemimeral, trithemimeral
ἐν σοὶ μὲν λήξω, σέο δ’ἄρξομαι, οὕνεκα πολλῶν	- - - -- uu -uu -uu --	dactylic hexameter	masculine penthemimeral, trithemimeral
λαῶν ἐσσι ἄναξ καί τοι Ζεὺς ἐγγυάλιξε	-- -u u- - - - -uu--	dactylic hexameter	masculine penthemimeral, hepthemimeral
σκῆπτρόν τ’ἠδὲ θέμιστας, ἵνά σφισι βουλεύῃσθα.	-- -u u-u u- uu ----	dactylic hexameter	feminine penthemimeral, hepthemimeral
τώ σε χρὴ περὶ μὲν φάσθαι ἔπος ἠδ’ ἐπακοῦσαι,	- - - uu - -- uu - uu--	dactylic hexameter	masculine penthemimeral, hepthemimeral, trithemimeral
κρηῆναι δὲ καὶ ἄλλῳ, ὅτ’ ἄν τινα θυμὸς ἀνώγῃ	--- u u -u u - uu -u u--	dactylic hexameter	feminine penthemimeral, hepthemimeral, trithemimeral
εἰπεῖν εἰς ἀγαθόν· σέο δ’ἕξεται ὅττί κεν ἄρχῃ.	-- - uu- uu -uu -u u --	dactylic hexameter	masculine penthemimeral, trithemimeral
αὐτὰρ ἐγὼν ἐρέω ὥς μοι δοκεῖ εἶναι ἄριστα.	-u u- uu- - - uu -u u--	dactylic hexameter	masculine penthemimeral, hepthemimeral, trithemimeral
οὐ γάρ τις νόον ἄλλος ἀμείνονα τοῦδε νοήσει	- - - uu -u u-uu -u u--	dactylic hexameter	feminine penthemimeral, trithemimeral
οἷον ἐγὼ νοέω ἠμὲν πάλαι ἠδ’ ἔτι καὶ νῦν	-u u- uu -- -- - uu - -	dactylic hexameter	trithemimeral
ἐξ ἔτι τοῦ ὅτε διογενὲς Βρισηΐδα κούρην	- uu - uu -uu- --uu --	dactylic hexameter	hepthemimeral, trithemimeral
χωομένου Ἀχιλῆος ἔβης κλισίηθεν ἀπούρας	-uu- uu-u u- uu-u u--	dactylic hexameter	feminine penthemimeral, hepthemimeral, trithemimeral
οὔ τι καθ’ ἡμέτερόν γε νόον· μάλα γάρ τοι ἔγωγε	- u u -uu- u u- uu - u u--	dactylic hexameter	masculine penthemimeral, hepthemimeral
πόλλ’ ἀπεμυθεόμην· σὺ δὲ σῷ μεγαλήτορι θυμῷ	- uu-uu- u u - uu-uu --	dactylic hexameter	masculine penthemimeral, hepthemimeral
εἴξας ἄνδρα φέριστον, ὃν ἀθάνατοί περ ἔτισαν,	-- -u u-u u -uu- u u--	dactylic hexameter	feminine penthemimeral
ἠτίμησας, ἑλὼν γὰρ ἔχεις γέρας· ἀλλ’ ἔτι καὶ νῦν	---u u- u u- uu - uu - -	dactylic hexameter	masculine penthemimeral, hepthemimeral
φραζώμεσθ’ ὥς κέν μιν ἀρεσσάμενοι πεπίθωμεν	--- - - u u-uu- uu--	dactylic hexameter	masculine penthemimeral, trithemimeral
δώροισίν τ’ἀγανοῖσιν ἔπεσσί τε μειλιχίοισι.	--- uu-u u-u u -uu--	dactylic hexameter	feminine penthemimeral, trithemimeral
τὸν δ’αὖτε προσέειπεν ἄναξ ἀνδρῶν Ἀγαμέμνων·	- -- uu-u u- -- uu--	dactylic hexameter	feminine penthemimeral, hepthemimeral, trithemimeral
ὦ γέρον οὔ τι ψεῦδος ἐμὰς ἄτας κατέλεξας·	- uu - - -u u- -- uu--	dactylic hexameter	feminine penthemimeral, hepthemimeral, trithemimeral
ἀασάμην, οὐδ’ αὐτὸς ἀναίνομαι. ἀντί νυ πολλῶν	-uu- - -u u-uu -u u --	dactylic hexameter	feminine penthemimeral, trithemimeral
λαῶν ἐστὶν ἀνὴρ ὅν τε Ζεὺς κῆρι φιλήσῃ,	-- -u u- - - - -u u--	dactylic hexameter	masculine penthemimeral, hepthemimeral
ὡς νῦν τοῦτον ἔτισε, δάμασσε δὲ λαὸν Ἀχαιῶν.	- - -u u-u u-u u -u u--	dactylic hexameter	feminine penthemimeral
ἀλλ’ ἐπεὶ ἀασάμην φρεσὶ λευγαλέῃσι πιθήσας,	- uu -uu- uu -uu-u u--	dactylic hexameter	masculine penthemimeral
ἂψ ἐθέλω ἀρέσαι δόμεναί τ’ἀπερείσι’ ἄποινα.	- uu- uu- uu- uu-u u--	dactylic hexameter	masculine penthemimeral, hepthemimeral, trithemimeral
ὑμῖν δ’ἐν πάντεσσι περικλυτὰ δῶρ’ ὀνομήνω	-- - --u u-uu - uu--	dactylic hexameter	feminine penthemimeral, trithemimeral
ἕπτ’ ἀπύρους τρίποδας, δέκα δὲ χρυσοῖο τάλαντα,	- uu- uu- uu - --u u--	dactylic hexameter	masculine penthemimeral, hepthemimeral, trithemimeral
αἴθωνας δὲ λέβητας ἐείκοσι, δώδεκα δ’ἵππους	--- u u-u u-uu -uu --	dactylic hexameter	feminine penthemimeral, trithemimeral
πηγοὺς ἀθλοφόρους, οἳ ἀέθλια ποσσὶν ἄροντο.	-- -uu- u u-uu -u u--	dactylic hexameter	masculine penthemimeral
οὔ κεν ἀλήϊος εἴη ἀνὴρ ᾧ τόσσα γένοιτο,	- u u-uu -u u- - -u u--	dactylic hexameter	feminine penthemimeral, hepthemimeral
οὐδέ κεν ἀκτήμων ἐριτίμοιο χρυσοῖο,	-u u --- uu--- ---	dactylic hexameter	masculine penthemimeral
ὅσσά μοι ἠνείκαντο ἀέθλια μώνυχες ἵπποι.	-u u ---u u-uu -uu --	dactylic hexameter	feminine penthemimeral
δώσω δ’ἑπτὰ γυναῖκας ἀμύμονα ἔργα ἰδυίας	-- -u u-u u-uu -u u--	dactylic hexameter	feminine penthemimeral
Λεσβίδας, ἃς ὅτε Λέσβον ἐϋκτιμένην ἕλεν αὐτὸς	-uu - uu -u u-uu- uu --	dactylic hexameter	feminine penthemimeral, trithemimeral
ἐξελόμην, αἳ κάλλει ἐνίκων φῦλα γυναικῶν.	-uu- - -u u-- -u u--	dactylic hexameter	feminine penthemimeral, trithemimeral
τὰς μέν οἱ δώσω, μετὰ δ’ἔσσεται ἣν τότ’ ἀπηύρων	- - - -- uu -uu - u u--	dactylic hexameter	masculine penthemimeral, trithemimeral
κούρη Βρισῆος· ἐπὶ δὲ μέγαν ὅρκον ὀμοῦμαι	-- --- uu - uu -u u--	dactylic hexameter	masculine penthemimeral, hepthemimeral
μή ποτε τῆς εὐνῆς ἐπιβήμεναι ἠδὲ μιγῆναι,	- uu - -- uu-uu -u u--	dactylic hexameter	masculine penthemimeral, trithemimeral
ἣ θέμις ἀνθρώπων πέλει ἀνδρῶν ἠδὲ γυναικῶν.	- uu --- uu -- -u u--	dactylic hexameter	masculine penthemimeral
ταῦτα μὲν αὐτίκα πάντα παρέσσεται· εἰ δέ κεν αὖτε	-u u -uu -u u-uu - u u --	dactylic hexameter	feminine penthemimeral
ἄστυ μέγα Πριάμοιο θεοὶ δώωσ’ ἀλαπάξαι,	-u u- uu-u u- -- uu--	dactylic hexameter	feminine penthemimeral, hepthemimeral, trithemimeral
νῆα ἅλις χρυσοῦ καὶ χαλκοῦ νηησάσθω	-u u- -- - -- ----	dactylic hexameter	masculine penthemimeral, trithemimeral
εἰσελθών, ὅτε κεν δατεώμεθα ληΐδ’ Ἀχαιοί,	--- uu - --uu -u u--	dactylic hexameter	masculine penthemimeral, trithemimeral
Τρωϊάδας δὲ γυναῖκας ἐείκοσιν αὐτὸς ἑλέσθω,	-uu- u u-u u-uu -u u--	dactylic hexameter	feminine penthemimeral, trithemimeral
αἴ κε μετ’ Ἀργείην Ἑλένην κάλλισται ἔωσιν.	- u u --- uu- --u u--	dactylic hexameter	masculine penthemimeral, hepthemimeral
εἰ δέ κεν Ἄργος ἱκοίμεθ’ Ἀχαιϊκὸν οὖθαρ ἀρούρης	- u u -u u-u u-uu -u u--	dactylic hexameter	feminine penthemimeral
γαμβρός κέν μοι ἔοι· τίσω δέ μιν ἶσον Ὀρέστῃ,	-- - u u- -- u u -u u--	dactylic hexameter	masculine penthemimeral, hepthemimeral, trithemimeral
ὅς μοι τηλύγετος τρέφεται θαλίῃ ἔνι πολλῇ.	- - -uu- uu- uu- uu --	dactylic hexameter	masculine penthemimeral, hepthemimeral
τρεῖς δέ μοί εἰσι θύγατρες ἐνὶ μεγάρῳ εὐπήκτῳ	- u u -u u-u u- uu- ---	dactylic hexameter	feminine penthemimeral, hepthemimeral
Χρυσόθεμις καὶ Λαοδίκη καὶ Ἰφιάνασσα,	-uu- - -uu- - -uu--	dactylic hexameter	hepthemimeral, trithemimeral
τάων ἥν κ’ἐθέλῃσι φίλην ἀνάεδνον ἀγέσθω	-- - uu-u u- uu-u u--	dactylic hexameter	feminine penthemimeral, hepthemimeral, trithemimeral
πρὸς οἶκον Πηλῆος· ἐγὼ δ’ἐπὶ μείλια δώσω	- -- --u u- uu -uu --	dactylic hexameter	feminine penthemimeral, hepthemimeral, trithemimeral
πολλὰ μάλ’, ὅσσ’ οὔ πώ τις ἑῇ ἐπέδωκε θυγατρί·	-u u - - - u u- uu-u u--	dactylic hexameter	masculine penthemimeral, hepthemimeral, trithemimeral
ἑπτὰ δέ οἱ δώσω εὖ ναιόμενα πτολίεθρα	-u u - -- - -uu- uu--	dactylic hexameter	masculine penthemimeral, trithemimeral
Καρδαμύλην Ἐνόπην τε καὶ Ἱρὴν ποιήεσσαν	-uu- uu- u u -- ----	dactylic hexameter	masculine penthemimeral, trithemimeral
Φηράς τε ζαθέας ἠδ’Ἄνθειαν βαθύλειμον	-- - uu- ---- uu--	dactylic hexameter	masculine penthemimeral, trithemimeral
καλήν τ’Αἴπειαν καὶ Πήδασον ἀμπελόεσσαν.	-- --- - -uu -uu--	dactylic hexameter	masculine penthemimeral
πᾶσαι δ’ἐγγὺς ἁλός, νέαται Πύλου ἠμαθόεντος·	-- -u u- uu- uu -uu--	dactylic hexameter	masculine penthemimeral, hepthemimeral
ἐν δ’ἄνδρες ναίουσι πολύρρηνες πολυβοῦται,	- -- --u u--- uu--	dactylic hexameter	feminine penthemimeral, trithemimeral
οἵ κέ ἑ δωτίνῃσι θεὸν ὣς τιμήσουσι	- u u ---u u- - ----	dactylic hexameter	feminine penthemimeral, hepthemimeral
καί οἱ ὑπὸ σκήπτρῳ λιπαρὰς τελέουσι θέμιστας.	- u u- -- uu- uu-u u--	dactylic hexameter	masculine penthemimeral, hepthemimeral, trithemimeral
ταῦτά κέ οἱ τελέσαιμι μεταλήξαντι χόλοιο.	-u u - uu-u u---u u--	dactylic hexameter	feminine penthemimeral, trithemimeral
δμηθήτω· Ἀΐδης τοι ἀμείλιχος ἠδ’ ἀδάμαστος,	--- uu- u u-uu - uu--	dactylic hexameter	masculine penthemimeral, trithemimeral
τοὔνεκα καί τε βροτοῖσι θεῶν ἔχθιστος ἁπάντων·	-uu - u u-u u- --u u--	dactylic hexameter	feminine penthemimeral, hepthemimeral, trithemimeral
καί μοι ὑποστήτω ὅσσον βασιλεύτερός εἰμι	- u u--- -- uu-uu --	dactylic hexameter	masculine penthemimeral, hepthemimeral
ἠδ’ ὅσσον γενεῇ προγενέστερος εὔχομαι εἶναι.	- -- uu- uu-uu -uu --	dactylic hexameter	masculine penthemimeral, trithemimeral
τὸν δ’ἠμείβετ’ ἔπειτα Γερήνιος ἱππότα Νέστωρ·	- --u u-u u-uu -uu --	dactylic hexameter	feminine penthemimeral
Ἀτρεΐδη κύδιστε ἄναξ ἀνδρῶν Ἀγάμεμνον	-uu- --u u- -- uu--	dactylic hexameter	feminine penthemimeral, hepthemimeral, trithemimeral
δῶρα μὲν οὐκέτ’ ὀνοστὰ διδοῖς Ἀχιλῆϊ ἄνακτι·	-u u -u u-u u- uu-u u--	dactylic hexameter	feminine penthemimeral, hepthemimeral
ἀλλ’ ἄγετε κλητοὺς ὀτρύνομεν, οἵ κε τάχιστα	- uu- -- --uu - u u--	dactylic hexameter	masculine penthemimeral, trithemimeral
ἔλθωσ’ ἐς κλισίην Πηληϊάδεω Ἀχιλῆος.	-- - uu- --uu- uu--	dactylic hexameter	masculine penthemimeral, trithemimeral
εἰ δ’ἄγε τοὺς ἂν ἐγὼ ἐπιόψομαι οἳ δὲ πιθέσθων.	- uu - u u- uu-uu - u u--	dactylic hexameter	masculine penthemimeral, trithemimeral
Φοῖνιξ μὲν πρώτιστα Διῒ φίλος ἡγησάσθω,	-- - --u u- uu ----	dactylic hexameter	feminine penthemimeral, hepthemimeral, trithemimeral
αὐτὰρ ἔπειτ’ Αἴας τε μέγας καὶ δῖος Ὀδυσσεύς·	-u u- -- u u- - -u u--	dactylic hexameter	masculine penthemimeral, hepthemimeral, trithemimeral
κηρύκων δ’Ὀδίος τε καὶ Εὐρυβάτης ἅμ’ ἑπέσθων.	--- uu- u u -uu- u u--	dactylic hexameter	masculine penthemimeral, trithemimeral
φέρτε δὲ χερσὶν ὕδωρ, εὐφημῆσαί τε κέλεσθε,	-u u -u u- ---- u u--	dactylic hexameter	masculine penthemimeral
ὄφρα Διὶ Κρονίδῃ ἀρησόμεθ’, αἴ κ’ἐλεήσῃ.	-u u- uu- --uu - uu--	dactylic hexameter	masculine penthemimeral, trithemimeral
ὣς φάτο, τοῖσι δὲ πᾶσιν ἑαδότα μῦθον ἔειπεν.	- uu -u u -u u-uu -u u--	dactylic hexameter	feminine penthemimeral
αὐτίκα κήρυκες μὲν ὕδωρ ἐπὶ χεῖρας ἔχευαν,	-uu --- u u- uu -u u--	dactylic hexameter	masculine penthemimeral, hepthemimeral
κοῦροι δὲ κρητῆρας ἐπεστέψαντο ποτοῖο,	-- - --u u---u u--	dactylic hexameter	feminine penthemimeral, trithemimeral
νώμησαν δ’ἄρα πᾶσιν ἐπαρξάμενοι δεπάεσσιν.	--- uu -u u-uu- uu--	dactylic hexameter	feminine penthemimeral, trithemimeral
αὐτὰρ ἐπεὶ σπεῖσάν τ’ἔπιόν θ’ὅσον ἤθελε θυμός,	-u u- -- uu- uu -uu --	dactylic hexameter	masculine penthemimeral, hepthemimeral, trithemimeral
ὁρμῶντ’ ἐκ κλισίης Ἀγαμέμνονος Ἀτρεΐδαο.	-- - uu- uu-uu -uu--	dactylic hexameter	masculine penthemimeral, trithemimeral
τοῖσι δὲ πόλλ’ ἐπέτελλε Γερήνιος ἱππότα Νέστωρ	-u u - uu-u u-uu -uu --	dactylic hexameter	feminine penthemimeral, trithemimeral
δενδίλλων ἐς ἕκαστον, Ὀδυσσῆϊ δὲ μάλιστα,	--- u u-u u--- u u--	dactylic hexameter	feminine penthemimeral, trithemimeral
πειρᾶν ὡς πεπίθοιεν ἀμύμονα Πηλεΐωνα.	-- - uu-u u-uu -uu--	dactylic hexameter	feminine penthemimeral, trithemimeral
τὼ δὲ βάτην παρὰ θῖνα πολυφλοίσβοιο θαλάσσης	- u u- uu -u u---u u--	dactylic hexameter	feminine penthemimeral, trithemimeral
πολλὰ μάλ’ εὐχομένω γαιηόχῳ ἐννοσιγαίῳ	-u u -uu- --uu -uu--	dactylic hexameter	masculine penthemimeral
ῥηϊδίως πεπιθεῖν μεγάλας φρένας Αἰακίδαο.	-uu- uu- uu- uu -uu--	dactylic hexameter	masculine penthemimeral, hepthemimeral, trithemimeral
Μυρμιδόνων δ’ἐπί τε κλισίας καὶ νῆας ἱκέσθην,	-uu- uu - uu- - -u u--	dactylic hexameter	masculine penthemimeral, hepthemimeral, trithemimeral
τὸν δ’εὗρον φρένα τερπόμενον φόρμιγγι λιγείῃ	- -- uu -uu- --u u--	dactylic hexameter	hepthemimeral, trithemimeral
καλῇ δαιδαλέῃ, ἐπὶ δ’ἀργύρεον ζυγὸν ἦεν,	-- -uu- uu -uu- uu --	dactylic hexameter	masculine penthemimeral
τὴν ἄρετ’ ἐξ ἐνάρων πόλιν Ἠετίωνος ὀλέσσας·	- uu - uu- uu -uu-u u--	dactylic hexameter	masculine penthemimeral, trithemimeral
τῇ ὅ γε θυμὸν ἔτερπεν, ἄειδε δ’ἄρα κλέα ἀνδρῶν.	- u u -u u-u u-u u- uu --	dactylic hexameter	feminine penthemimeral
Πάτροκλος δέ οἱ οἶος ἐναντίος ἧστο σιωπῇ,	--- u u -u u-uu -u u--	dactylic hexameter	feminine penthemimeral, trithemimeral
δέγμενος Αἰακίδην ὁπότε λήξειεν ἀείδων,	-uu -uu- uu- --u u--	dactylic hexameter	masculine penthemimeral, hepthemimeral
τὼ δὲ βάτην προτέρω, ἡγεῖτο δὲ δῖος Ὀδυσσεύς,	- u u- uu- --u u -u u--	dactylic hexameter	masculine penthemimeral, trithemimeral
στὰν δὲ πρόσθ’ αὐτοῖο· ταφὼν δ’ἀνόρουσεν Ἀχιλλεὺς	- - - --u u- uu-u u--	dactylic hexameter	feminine penthemimeral, hepthemimeral, trithemimeral
αὐτῇ σὺν φόρμιγγι λιπὼν ἕδος ἔνθα θάασσεν.	-- - --u u- uu -u u--	dactylic hexameter	feminine penthemimeral, hepthemimeral, trithemimeral
ὣς δ’αὔτως Πάτροκλος, ἐπεὶ ἴδε φῶτας, ἀνέστη.	- -- --u u- uu -u u--	dactylic hexameter	feminine penthemimeral, hepthemimeral, trithemimeral
τὼ καὶ δεικνύμενος προσέφη πόδας ὠκὺς Ἀχιλλεύς·	- - -uu- uu- uu -u u--	dactylic hexameter	masculine penthemimeral, hepthemimeral
χαίρετον· ἦ φίλοι ἄνδρες ἱκάνετον ἦ τι μάλα χρεώ,	-uu - uu -u u-uu - u u- -	dactylic hexameter	feminine penthemimeral, trithemimeral
οἵ μοι σκυζομένῳ περ Ἀχαιῶν φίλτατοί ἐστον.	- - -uu- u u-- -uu --	dactylic hexameter	masculine penthemimeral
ὣς ἄρα φωνήσας προτέρω ἄγε δῖος Ἀχιλλεύς,	- uu --- uu- uu -u u--	dactylic hexameter	masculine penthemimeral, hepthemimeral
εἷσεν δ’ἐν κλισμοῖσι τάπησί τε πορφυρέοισιν.	-- - --u u-u u -uu--	dactylic hexameter	feminine penthemimeral, trithemimeral
αἶψα δὲ Πάτροκλον προσεφώνεεν ἐγγὺς ἐόντα·	-u u --- uu-uu -u u--	dactylic hexameter	masculine penthemimeral
μείζονα δὴ κρητῆρα Μενοιτίου υἱὲ καθίστα,	-uu - --u u-uu -u u--	dactylic hexameter	feminine penthemimeral, trithemimeral
ζωρότερον δὲ κέραιε, δέπας δ’ἔντυνον ἑκάστῳ·	-uu- u u-u u- --u u--	dactylic hexameter	feminine penthemimeral, hepthemimeral, trithemimeral
οἳ γὰρ φίλτατοι ἄνδρες ἐμῷ ὑπέασι μελάθρῳ.	- - -uu -u u- uu-u u--	dactylic hexameter	feminine penthemimeral, hepthemimeral
ὣς φάτο, Πάτροκλος δὲ φίλῳ ἐπεπείθεθ’ ἑταίρῳ.	- uu --- u u- uu-u u--	dactylic hexameter	masculine penthemimeral, hepthemimeral
αὐτὰρ ὅ γε κρεῖον μέγα κάββαλεν ἐν πυρὸς αὐγῇ,	-u u - -- uu -uu - uu --	dactylic hexameter	masculine penthemimeral, trithemimeral
ἐν δ’ἄρα νῶτον ἔθηκ’ ὄϊος καὶ πίονος αἰγός,	- uu -u u- uu- - -uu --	dactylic hexameter	masculine penthemimeral, hepthemimeral
ἐν δὲ συὸς σιάλοιο ῥάχιν τεθαλυῖαν ἀλοιφῇ.	- u u- uu-u u- uu-u u--	dactylic hexameter	feminine penthemimeral, hepthemimeral, trithemimeral
τῷ δ’ἔχεν Αὐτομέδων, τάμνεν δ’ἄρα δῖος Ἀχιλλεύς.	- uu -uu- -- uu -u u--	dactylic hexameter	masculine penthemimeral, hepthemimeral
καὶ τὰ μὲν εὖ μίστυλλε καὶ ἀμφ’ ὀβελοῖσιν ἔπειρε,	- u u - --u u - uu-u u--	dactylic hexameter	feminine penthemimeral, hepthemimeral, trithemimeral
πῦρ δὲ Μενοιτιάδης δαῖεν μέγα ἰσόθεος φώς.	- u u-uu- -- uu -uu- -	dactylic hexameter	masculine penthemimeral, hepthemimeral
αὐτὰρ ἐπεὶ κατὰ πῦρ ἐκάη καὶ φλὸξ ἐμαράνθη,	-u u- uu - uu- - - uu--	dactylic hexameter	masculine penthemimeral, hepthemimeral, trithemimeral
ἀνθρακιὴν στορέσας ὀβελοὺς ἐφύπερθε τάνυσσε,	-uu- uu- uu- uu-u u--	dactylic hexameter	masculine penthemimeral, hepthemimeral, trithemimeral
πάσσε δ’ἁλὸς θείοιο κρατευτάων ἐπαείρας.	-u u- --u u--- uu--	dactylic hexameter	feminine penthemimeral, trithemimeral
αὐτὰρ ἐπεί ῥ’ὤπτησε καὶ εἰν ἐλεοῖσιν ἔχευε,	-u u- --u u - uu-u u--	dactylic hexameter	feminine penthemimeral, hepthemimeral, trithemimeral
Πάτροκλος μὲν σῖτον ἑλὼν ἐπένειμε τραπέζῃ	--- - -u u- uu-u u--	dactylic hexameter	feminine penthemimeral, hepthemimeral, trithemimeral
καλοῖς ἐν κανέοισιν, ἀτὰρ κρέα νεῖμεν Ἀχιλλεύς.	-- - uu-u u- uu -u u--	dactylic hexameter	feminine penthemimeral, hepthemimeral, trithemimeral
αὐτὸς δ’ἀντίον ἷζεν Ὀδυσσῆος θείοιο	-- -uu -u u--- ---	dactylic hexameter	feminine penthemimeral
τοίχου τοῦ ἑτέροιο, θεοῖσι δὲ θῦσαι ἀνώγει	-- - uu-u u-u u -u u--	dactylic hexameter	feminine penthemimeral, trithemimeral
Πάτροκλον ὃν ἑταῖρον· ὃ δ’ἐν πυρὶ βάλλε θυηλάς.	--- u u-u u - uu -u u--	dactylic hexameter	feminine penthemimeral, hepthemimeral, trithemimeral
οἳ δ’ἐπ’ ὀνείαθ’ ἑτοῖμα προκείμενα χεῖρας ἴαλλον.	- u u-u u-u u-uu -u u--	dactylic hexameter	feminine penthemimeral
αὐτὰρ ἐπεὶ πόσιος καὶ ἐδητύος ἐξ ἔρον ἕντο,	-u u- uu- u u-uu - uu --	dactylic hexameter	masculine penthemimeral, trithemimeral
νεῦσ’ Αἴας Φοίνικι· νόησε δὲ δῖος Ὀδυσσεύς,	- -- --u u-u u -u u--	dactylic hexameter	feminine penthemimeral, trithemimeral
πλησάμενος δ’οἴνοιο δέπας δείδεκτ’ Ἀχιλῆα·	-uu- --u u- -- uu--	dactylic hexameter	feminine penthemimeral, hepthemimeral, trithemimeral
χαῖρ’ Ἀχιλεῦ· δαιτὸς μὲν ἐΐσης οὐκ ἐπιδευεῖς	- uu- -- u u-- - uu--	dactylic hexameter	masculine penthemimeral, trithemimeral
ἠμὲν ἐνὶ κλισίῃ Ἀγαμέμνονος Ἀτρεΐδαο	-u u- uu- uu-uu -uu--	dactylic hexameter	masculine penthemimeral, trithemimeral
ἠδὲ καὶ ἐνθάδε νῦν, πάρα γὰρ μενοεικέα πολλὰ	-u u -uu - uu - uu-uu --	dactylic hexameter	masculine penthemimeral, hepthemimeral
δαίνυσθ’· ἀλλ’ οὐ δαιτὸς ἐπηράτου ἔργα μέμηλεν,	-- - - -u u-uu -u u--	dactylic hexameter	feminine penthemimeral, trithemimeral
ἀλλὰ λίην μέγα πῆμα διοτρεφὲς εἰσορόωντες	-u u- uu -u u-uu -uu--	dactylic hexameter	feminine penthemimeral, trithemimeral
δείδιμεν· ἐν δοιῇ δὲ σαωσέμεν ἢ ἀπολέσθαι	-uu - -- u u-uu - uu--	dactylic hexameter	masculine penthemimeral, trithemimeral
νῆας ἐϋσσέλμους, εἰ μὴ σύ γε δύσεαι ἀλκήν.	-u u--- - - u u -uu --	dactylic hexameter	masculine penthemimeral, hepthemimeral
ἐγγὺς γὰρ νηῶν καὶ τείχεος αὖλιν ἔθεντο	-- - -- - -uu -u u--	dactylic hexameter	masculine penthemimeral, trithemimeral
Τρῶες ὑπέρθυμοι τηλεκλειτοί τ’ἐπίκουροι	-u u--- ---- uu--	dactylic hexameter	masculine penthemimeral
κηάμενοι πυρὰ πολλὰ κατὰ στρατόν, οὐδ’ ἔτι φασὶ	-uu- uu -u u- uu - uu --	dactylic hexameter	feminine penthemimeral, hepthemimeral, trithemimeral
σχήσεσθ’, ἀλλ’ ἐν νηυσὶ μελαίνῃσιν πεσέεσθαι.	-- - - -u u--- uu--	dactylic hexameter	feminine penthemimeral, trithemimeral
Ζεὺς δέ σφι Κρονίδης ἐνδέξια σήματα φαίνων	- - - uu- --uu -uu --	dactylic hexameter	masculine penthemimeral, trithemimeral
ἀστράπτει· Ἕκτωρ δὲ μέγα σθένεϊ βλεμεαίνων	--- -- u u- uu- uu--	dactylic hexameter	masculine penthemimeral, hepthemimeral, trithemimeral
μαίνεται ἐκπάγλως πίσυνος Διί, οὐδέ τι τίει	-uu --- uu- uu -u u --	dactylic hexameter	masculine penthemimeral, hepthemimeral
ἀνέρας οὐδὲ θεούς· κρατερὴ δέ ἑ λύσσα δέδυκεν.	-uu -u u- uu- u u -u u--	dactylic hexameter	masculine penthemimeral, hepthemimeral
ἀρᾶται δὲ τάχιστα φανήμεναι Ἠῶ δῖαν·	--- u u-u u-uu -- --	dactylic hexameter	feminine penthemimeral, trithemimeral
στεῦται γὰρ νηῶν ἀποκόψειν ἄκρα κόρυμβα	-- - -- uu-- -u u--	dactylic hexameter	masculine penthemimeral, trithemimeral
αὐτάς τ’ἐμπρήσειν μαλεροῦ πυρός, αὐτὰρ Ἀχαιοὺς	-- --- uu- uu -u u--	dactylic hexameter	masculine penthemimeral, hepthemimeral
δῃώσειν παρὰ τῇσιν ὀρινομένους ὑπὸ καπνοῦ.	-- -- -u u-uu- uu --	dactylic hexameter	feminine penthemimeral
ταῦτ’ αἰνῶς δείδοικα κατὰ φρένα, μή οἱ ἀπειλὰς	- -- --u u- uu - u u--	dactylic hexameter	feminine penthemimeral, hepthemimeral, trithemimeral
ἐκτελέσωσι θεοί, ἡμῖν δὲ δὴ αἴσιμον εἴη	-uu-u u- -- u u -uu --	dactylic hexameter	masculine penthemimeral, hepthemimeral
φθίσθαι ἐνὶ Τροίῃ ἑκὰς Ἄργεος ἱπποβότοιο.	-u u- -- uu -uu -uu--	dactylic hexameter	masculine penthemimeral, trithemimeral
ἀλλ’ ἄνα εἰ μέμονάς γε καὶ ὀψέ περ υἷας Ἀχαιῶν	- uu - uu- u u -u u -u u--	dactylic hexameter	masculine penthemimeral, trithemimeral
τειρομένους ἐρύεσθαι ὑπὸ Τρώων ὀρυμαγδοῦ.	-uu- uu-u u- -- uu--	dactylic hexameter	feminine penthemimeral, hepthemimeral, trithemimeral
αὐτῷ τοι μετόπισθ’ ἄχος ἔσσεται, οὐδέ τι μῆχος	-- - uu- uu -uu -u u --	dactylic hexameter	masculine penthemimeral, trithemimeral
ῥεχθέντος κακοῦ ἔστ’ ἄκος εὑρεῖν· ἀλλὰ πολὺ πρὶν	--- uu - uu -- -u u- -	dactylic hexameter	masculine penthemimeral, trithemimeral
φράζευ ὅπως Δαναοῖσιν ἀλεξήσεις κακὸν ἦμαρ.	-u u- uu-u u--- uu --	dactylic hexameter	feminine penthemimeral, trithemimeral
ὦ πέπον ἦ μὲν σοί γε πατὴρ ἐπετέλλετο Πηλεὺς	- uu - - - u u- uu-uu --	dactylic hexameter	masculine penthemimeral, hepthemimeral, trithemimeral
ἤματι τῷ ὅτε σ’ἐκ Φθίης Ἀγαμέμνονι πέμπε·	-uu - uu - -- uu-uu --	dactylic hexameter	masculine penthemimeral, hepthemimeral, trithemimeral
τέκνον ἐμὸν κάρτος μὲν Ἀθηναίη τε καὶ Ἥρη	-u u- -- u u--- u u --	dactylic hexameter	masculine penthemimeral, trithemimeral
δώσουσ’ αἴ κ’ἐθέλωσι, σὺ δὲ μεγαλήτορα θυμὸν	-- - uu-u u - uu-uu --	dactylic hexameter	feminine penthemimeral, hepthemimeral, trithemimeral
ἴσχειν ἐν στήθεσσι· φιλοφροσύνη γὰρ ἀμείνων·	-- - --u u-uu- u u--	dactylic hexameter	feminine penthemimeral, trithemimeral
ληγέμεναι δ’ἔριδος κακομηχάνου, ὄφρά σε μᾶλλον	-uu- uu- uu-uu -u u --	dactylic hexameter	masculine penthemimeral, trithemimeral
τίωσ’ Ἀργείων ἠμὲν νέοι ἠδὲ γέροντες.	-- --- -- uu -u u--	dactylic hexameter	masculine penthemimeral, hepthemimeral
ὣς ἐπέτελλ’ ὃ γέρων, σὺ δὲ λήθεαι· ἀλλ’ ἔτι καὶ νῦν	- uu- u u- u u -uu - uu - -	dactylic hexameter	masculine penthemimeral, trithemimeral
παύε’, ἔα δὲ χόλον θυμαλγέα· σοὶ δ’Ἀγαμέμνων	-u u- u u- --uu - uu--	dactylic hexameter	masculine penthemimeral, trithemimeral
ἄξια δῶρα δίδωσι μεταλήξαντι χόλοιο.	-uu -u u-u u---u u--	dactylic hexameter	feminine penthemimeral
εἰ δὲ σὺ μέν μευ ἄκουσον, ἐγὼ δέ κέ τοι καταλέξω	- u u - u u-u u- u u - uu--	dactylic hexameter	feminine penthemimeral, hepthemimeral, trithemimeral
ὅσσά τοι ἐν κλισίῃσιν ὑπέσχετο δῶρ’ Ἀγαμέμνων·	-u u - uu-u u-uu - uu--	dactylic hexameter	feminine penthemimeral, trithemimeral
ἕπτ’ ἀπύρους τρίποδας, δέκα δὲ χρυσοῖο τάλαντα,	- uu- uu- uu - --u u--	dactylic hexameter	masculine penthemimeral, hepthemimeral, trithemimeral
αἴθωνας δὲ λέβητας ἐείκοσι, δώδεκα δ’ἵππους	--- u u-u u-uu -uu --	dactylic hexameter	feminine penthemimeral, trithemimeral
πηγοὺς ἀθλοφόρους, οἳ ἀέθλια ποσσὶν ἄροντο.	-- -uu- u u-uu -u u--	dactylic hexameter	masculine penthemimeral
οὔ κεν ἀλήϊος εἴη ἀνὴρ ᾧ τόσσα γένοιτο	- u u-uu -u u- - -u u--	dactylic hexameter	feminine penthemimeral, hepthemimeral
οὐδέ κεν ἀκτήμων ἐριτίμοιο χρυσοῖο,	-u u --- uu--- ---	dactylic hexameter	masculine penthemimeral
ὅσσ’ Ἀγαμέμνονος ἵπποι ἀέθλια ποσσὶν ἄροντο.	- uu-uu -u u-uu -u u--	dactylic hexameter	feminine penthemimeral
δώσει δ’ἑπτὰ γυναῖκας ἀμύμονα ἔργα ἰδυίας	-- -u u-u u-uu -u u--	dactylic hexameter	feminine penthemimeral
Λεσβίδας, ἃς ὅτε Λέσβον ἐϋκτιμένην ἕλες αὐτὸς	-uu - uu -u u-uu- uu --	dactylic hexameter	feminine penthemimeral, trithemimeral
ἐξέλεθ’, αἳ τότε κάλλει ἐνίκων φῦλα γυναικῶν.	-uu - uu -u u-- -u u--	dactylic hexameter	feminine penthemimeral, trithemimeral
τὰς μέν τοι δώσει, μετὰ δ’ἔσσεται ἣν τότ’ ἀπηύρα	- - - -- uu -uu - u u--	dactylic hexameter	masculine penthemimeral, trithemimeral
κούρη Βρισῆος· ἐπὶ δὲ μέγαν ὅρκον ὀμεῖται	-- --- uu - uu -u u--	dactylic hexameter	masculine penthemimeral, hepthemimeral
μή ποτε τῆς εὐνῆς ἐπιβήμεναι ἠδὲ μιγῆναι	- uu - -- uu-uu -u u--	dactylic hexameter	masculine penthemimeral, trithemimeral
ἣ θέμις ἐστὶν ἄναξ ἤτ’ ἀνδρῶν ἤτε γυναικῶν.	- uu -u u- - -- -u u--	dactylic hexameter	masculine penthemimeral
ταῦτα μὲν αὐτίκα πάντα παρέσσεται· εἰ δέ κεν αὖτε	-u u -uu -u u-uu - u u --	dactylic hexameter	feminine penthemimeral
ἄστυ μέγα Πριάμοιο θεοὶ δώωσ’ ἀλαπάξαι,	-u u- uu-u u- -- uu--	dactylic hexameter	feminine penthemimeral, hepthemimeral, trithemimeral
νῆα ἅλις χρυσοῦ καὶ χαλκοῦ νηήσασθαι	-u u- -- - -- ----	dactylic hexameter	masculine penthemimeral, trithemimeral
εἰσελθών, ὅτε κεν δατεώμεθα ληΐδ’ Ἀχαιοί,	--- uu - --uu -u u--	dactylic hexameter	masculine penthemimeral, trithemimeral
Τρωϊάδας δὲ γυναῖκας ἐείκοσιν αὐτὸς ἑλέσθαι,	-uu- u u-u u-uu -u u--	dactylic hexameter	feminine penthemimeral, trithemimeral
αἵ κε μετ’ Ἀργείην Ἑλένην κάλλισται ἔωσιν.	- u u --- uu- --u u--	dactylic hexameter	masculine penthemimeral, hepthemimeral
εἰ δέ κεν Ἄργος ἱκοίμεθ’ Ἀχαιϊκὸν οὖθαρ ἀρούρης	- u u -u u-u u-uu -u u--	dactylic hexameter	feminine penthemimeral
γαμβρός κέν οἱ ἔοις· τίσει δέ σε ἶσον Ὀρέστῃ,	-- - u u- -- u u -u u--	dactylic hexameter	masculine penthemimeral, hepthemimeral, trithemimeral
ὅς οἱ τηλύγετος τρέφεται θαλίῃ ἔνι πολλῇ.	- - -uu- uu- uu- uu --	dactylic hexameter	masculine penthemimeral, hepthemimeral
τρεῖς δέ οἵ εἰσι θύγατρες ἐνὶ μεγάρῳ εὐπήκτῳ	- u u -u u-u u- uu- ---	dactylic hexameter	feminine penthemimeral, hepthemimeral
Χρυσόθεμις καὶ Λαοδίκη καὶ Ἰφιάνασσα,	-uu- - -uu- - -uu--	dactylic hexameter	hepthemimeral, trithemimeral
τάων ἥν κ’ἐθέλῃσθα φίλην ἀνάεδνον ἄγεσθαι	-- - uu-u u- uu-u u--	dactylic hexameter	feminine penthemimeral, hepthemimeral, trithemimeral
πρὸς οἶκον Πηλῆος· ὃ δ’αὖτ’ ἐπὶ μείλια δώσει	- -- --u u - uu -uu --	dactylic hexameter	feminine penthemimeral, hepthemimeral, trithemimeral
πολλὰ μάλ’, ὅσσ’ οὔ πώ τις ἑῇ ἐπέδωκε θυγατρί·	-u u - - - u u- uu-u u--	dactylic hexameter	masculine penthemimeral, hepthemimeral, trithemimeral
ἑπτὰ δέ τοι δώσει εὖ ναιόμενα πτολίεθρα	-u u - -- - -uu- uu--	dactylic hexameter	masculine penthemimeral, trithemimeral
Καρδαμύλην Ἐνόπην τε καὶ Ἱρὴν ποιήεσσαν	-uu- uu- u u -- ----	dactylic hexameter	masculine penthemimeral, trithemimeral
Φηράς τε ζαθέας ἠδ’ Ἄνθειαν βαθύλειμον	-- - uu- - --- uu--	dactylic hexameter	masculine penthemimeral, trithemimeral
καλήν τ’Αἴπειαν καὶ Πήδασον ἀμπελόεσσαν.	-- --- - -uu -uu--	dactylic hexameter	masculine penthemimeral
πᾶσαι δ’ἐγγὺς ἁλός, νέαται Πύλου ἠμαθόεντος·	-- -u u- uu- uu -uu--	dactylic hexameter	masculine penthemimeral, hepthemimeral
ἐν δ’ἄνδρες ναίουσι πολύρρηνες πολυβοῦται,	- -- --u u--- uu--	dactylic hexameter	feminine penthemimeral, trithemimeral
οἵ κέ σε δωτίνῃσι θεὸν ὣς τιμήσουσι	- u u ---u u- - ----	dactylic hexameter	feminine penthemimeral, hepthemimeral
καί τοι ὑπὸ σκήπτρῳ λιπαρὰς τελέουσι θέμιστας.	- u u- -- uu- uu-u u--	dactylic hexameter	masculine penthemimeral, hepthemimeral, trithemimeral
ταῦτά κέ τοι τελέσειε μεταλήξαντι χόλοιο.	-u u - uu-u u---u u--	dactylic hexameter	feminine penthemimeral, trithemimeral
εἰ δέ τοι Ἀτρεΐδης μὲν ἀπήχθετο κηρόθι μᾶλλον	- u u -uu- u u-uu -uu --	dactylic hexameter	masculine penthemimeral
αὐτὸς καὶ τοῦ δῶρα, σὺ δ’ἄλλους περ Παναχαιοὺς	-- - - -u u -- - uu--	dactylic hexameter	feminine penthemimeral, trithemimeral
τειρομένους ἐλέαιρε κατὰ στρατόν, οἵ σε θεὸν ὣς	-uu- uu-u u- uu - u u- -	dactylic hexameter	feminine penthemimeral, hepthemimeral, trithemimeral
τίσουσ’· ἦ γάρ κέ σφι μάλα μέγα κῦδος ἄροιο·	-- - - - u u- uu -u u--	dactylic hexameter	masculine penthemimeral, hepthemimeral, trithemimeral
νῦν γάρ χ’Ἕκτορ’ ἕλοις, ἐπεὶ ἂν μάλα τοι σχεδὸν ἔλθοι	- - -u u- uu - uu - uu --	dactylic hexameter	masculine penthemimeral, hepthemimeral
λύσσαν ἔχων ὀλοήν, ἐπεὶ οὔ τινά φησιν ὁμοῖον	-u u- uu- uu - uu -u u--	dactylic hexameter	masculine penthemimeral, hepthemimeral, trithemimeral
οἷ ἔμεναι Δαναῶν οὓς ἐνθάδε νῆες ἔνεικαν.	- uu- uu- - -uu -u u--	dactylic hexameter	masculine penthemimeral, trithemimeral
τὸν δ’ἀπαμειβόμενος προσέφη πόδας ὠκὺς Ἀχιλλεύς·	- uu-uu- uu- uu -u u--	dactylic hexameter	masculine penthemimeral, hepthemimeral
διογενὲς Λαερτιάδη πολυμήχαν’ Ὀδυσσεῦ	-uu- --uu- uu-u u--	dactylic hexameter	hepthemimeral, trithemimeral
χρὴ μὲν δὴ τὸν μῦθον ἀπηλεγέως ἀποειπεῖν,	- - - - -u u-uu- uu--	dactylic hexameter	feminine penthemimeral, trithemimeral
ᾗ περ δὴ φρονέω τε καὶ ὡς τετελεσμένον ἔσται,	- - - uu- u u - uu-uu --	dactylic hexameter	masculine penthemimeral, hepthemimeral, trithemimeral
ὡς μή μοι τρύζητε παρήμενοι ἄλλοθεν ἄλλος.	- - - --u u-uu -uu --	dactylic hexameter	feminine penthemimeral, trithemimeral
ἐχθρὸς γάρ μοι κεῖνος ὁμῶς Ἀΐδαο πύλῃσιν	-- - - -u u- uu-u u--	dactylic hexameter	feminine penthemimeral, hepthemimeral, trithemimeral
ὅς χ’ἕτερον μὲν κεύθῃ ἐνὶ φρεσίν, ἄλλο δὲ εἴπῃ.	- uu- - -u u- uu -u u --	dactylic hexameter	feminine penthemimeral, hepthemimeral, trithemimeral
αὐτὰρ ἐγὼν ἐρέω ὥς μοι δοκεῖ εἶναι ἄριστα·	-u u- uu- - - uu -u u--	dactylic hexameter	masculine penthemimeral, hepthemimeral, trithemimeral
οὔτ’ ἔμεγ’ Ἀτρεΐδην Ἀγαμέμνονα πεισέμεν οἴω	- uu -uu- uu-uu -uu --	dactylic hexameter	masculine penthemimeral
οὔτ’ ἄλλους Δαναούς, ἐπεὶ οὐκ ἄρα τις χάρις ἦεν	- -- uu- uu - uu - uu --	dactylic hexameter	masculine penthemimeral, hepthemimeral, trithemimeral
μάρνασθαι δηίοισιν ἐπ’ ἀνδράσι νωλεμὲς αἰεί.	--- --u u -uu -uu --	dactylic hexameter	feminine penthemimeral, trithemimeral
ἴση μοῖρα μένοντι καὶ εἰ μάλα τις πολεμίζοι·	-- -u u-u u - uu - uu--	dactylic hexameter	feminine penthemimeral, hepthemimeral
ἐν δὲ ἰῇ τιμῇ ἠμὲν κακὸς ἠδὲ καὶ ἐσθλός·	- u u- -- -- uu -u u --	dactylic hexameter	masculine penthemimeral, hepthemimeral, trithemimeral
κάτθαν’ ὁμῶς ὅ τ’ἀεργὸς ἀνὴρ ὅ τε πολλὰ ἐοργώς.	-u u- u u-u u- u u -u u--	dactylic hexameter	feminine penthemimeral, hepthemimeral, trithemimeral
οὐδέ τί μοι περίκειται, ἐπεὶ πάθον ἄλγεα θυμῷ	-u u - uu-u u- uu -uu --	dactylic hexameter	feminine penthemimeral, hepthemimeral, trithemimeral
αἰεὶ ἐμὴν ψυχὴν παραβαλλόμενος πολεμίζειν.	-u u- -- uu-uu- uu--	dactylic hexameter	masculine penthemimeral, trithemimeral
ὡς δ’ὄρνις ἀπτῆσι νεοσσοῖσι προφέρῃσι	- -- --u u--- uu--	dactylic hexameter	feminine penthemimeral, trithemimeral
μάστακ’ ἐπεί κε λάβῃσι, κακῶς δ’ἄρα οἱ πέλει αὐτῇ,	-u u- u u-u u- uu - uu --	dactylic hexameter	feminine penthemimeral, hepthemimeral, trithemimeral
ὣς καὶ ἐγὼ πολλὰς μὲν ἀΰπνους νύκτας ἴαυον,	- u u- -- u u-- -u u--	dactylic hexameter	masculine penthemimeral, trithemimeral
ἤματα δ’αἱματόεντα διέπρησσον πολεμίζων	-uu -uu-u u--- uu--	dactylic hexameter	feminine penthemimeral
ἀνδράσι μαρνάμενος ὀάρων ἕνεκα σφετεράων.	-uu -uu- uu- uu- uu--	dactylic hexameter	masculine penthemimeral, hepthemimeral
δώδεκα δὴ σὺν νηυσὶ πόλεις ἀλάπαξ’ ἀνθρώπων,	-uu - - -u u- uu- ---	dactylic hexameter	feminine penthemimeral, hepthemimeral, trithemimeral
πεζὸς δ’ἕνδεκά φημι κατὰ Τροίην ἐρίβωλον·	-- -uu -u u- -- uu--	dactylic hexameter	feminine penthemimeral, hepthemimeral
τάων ἐκ πασέων κειμήλια πολλὰ καὶ ἐσθλὰ	-- - uu- --uu -u u --	dactylic hexameter	masculine penthemimeral, trithemimeral
ἐξελόμην, καὶ πάντα φέρων Ἀγαμέμνονι δόσκον	-uu- - -u u- uu-uu --	dactylic hexameter	feminine penthemimeral, hepthemimeral, trithemimeral
Ἀτρεΐδῃ· ὃ δ’ὄπισθε μένων παρὰ νηυσὶ θοῇσι	-uu- u u-u u- uu -u u--	dactylic hexameter	feminine penthemimeral, hepthemimeral, trithemimeral
δεξάμενος διὰ παῦρα δασάσκετο, πολλὰ δ’ἔχεσκεν.	-uu- uu -u u-uu -u u--	dactylic hexameter	feminine penthemimeral, trithemimeral
ἄλλα δ’ἀριστήεσσι δίδου γέρα καὶ βασιλεῦσι·	-u u---u u- uu - uu--	dactylic hexameter	feminine penthemimeral, hepthemimeral
τοῖσι μὲν ἔμπεδα κεῖται, ἐμεῦ δ’ἀπὸ μούνου Ἀχαιῶν	-u u -uu -u u- uu -u u--	dactylic hexameter	feminine penthemimeral, hepthemimeral
εἵλετ’, ἔχει δ’ἄλοχον θυμαρέα· τῇ παριαύων	-u u- uu- --uu - uu--	dactylic hexameter	masculine penthemimeral, trithemimeral
τερπέσθω. τί δὲ δεῖ πολεμιζέμεναι Τρώεσσιν	--- u u - uu-uu- ---	dactylic hexameter	masculine penthemimeral, trithemimeral
Ἀργείους; τί δὲ λαὸν ἀνήγαγεν ἐνθάδ’ ἀγείρας	--- u u -u u-uu -u u--	dactylic hexameter	feminine penthemimeral, trithemimeral
Ἀτρεΐδης; ἦ οὐχ Ἑλένης ἕνεκ’ ἠϋκόμοιο;	-uu- - - uu- uu -uu--	dactylic hexameter	masculine penthemimeral, hepthemimeral, trithemimeral
ἦ μοῦνοι φιλέουσ’ ἀλόχους μερόπων ἀνθρώπων	- -- uu- uu- uu- ---	dactylic hexameter	masculine penthemimeral, hepthemimeral, trithemimeral
Ἀτρεΐδαι; ἐπεὶ ὅς τις ἀνὴρ ἀγαθὸς καὶ ἐχέφρων	-uu- uu - u u- uu- u u--	dactylic hexameter	masculine penthemimeral, hepthemimeral, trithemimeral
τὴν αὐτοῦ φιλέει καὶ κήδεται, ὡς καὶ ἐγὼ τὴν	- -- uu- - -uu - u u- -	dactylic hexameter	masculine penthemimeral, trithemimeral
ἐκ θυμοῦ φίλεον δουρικτητήν περ ἐοῦσαν.	- -- uu- ---- u u--	dactylic hexameter	masculine penthemimeral, trithemimeral
νῦν δ’ἐπεὶ ἐκ χειρῶν γέρας εἵλετο καί μ’ἀπάτησε	- uu - -- uu -uu - uu--	dactylic hexameter	masculine penthemimeral, trithemimeral
μή μευ πειράτω εὖ εἰδότος· οὐδέ με πείσει.	- - --- - -uu -u u --	dactylic hexameter	masculine penthemimeral
ἀλλ’ Ὀδυσεῦ σὺν σοί τε καὶ ἄλλοισιν βασιλεῦσι	- uu- - - u u --- uu--	dactylic hexameter	masculine penthemimeral, trithemimeral
φραζέσθω νήεσσιν ἀλεξέμεναι δήίον πῦρ.	--- --u u-uu- -- -	dactylic hexameter	feminine penthemimeral, trithemimeral
ἦ μὲν δὴ μάλα πολλὰ πονήσατο νόσφιν ἐμεῖο,	- - - uu -u u-uu -u u--	dactylic hexameter	feminine penthemimeral, trithemimeral
καὶ δὴ τεῖχος ἔδειμε, καὶ ἤλασε τάφρον ἐπ’ αὐτῷ	- - -u u-u u -uu -u u --	dactylic hexameter	feminine penthemimeral
εὐρεῖαν μεγάλην, ἐν δὲ σκόλοπας κατέπηξεν·	--- uu- - - uu- uu--	dactylic hexameter	masculine penthemimeral, hepthemimeral, trithemimeral
ἀλλ’ οὐδ’ ὧς δύναται σθένος Ἕκτορος ἀνδροφόνοιο	- - - uu- uu -uu -uu--	dactylic hexameter	masculine penthemimeral, trithemimeral
ἴσχειν· ὄφρα δ’ἐγὼ μετ’ Ἀχαιοῖσιν πολέμιζον	-- -u u- u u--- uu--	dactylic hexameter	masculine penthemimeral
οὐκ ἐθέλεσκε μάχην ἀπὸ τείχεος ὀρνύμεν Ἕκτωρ,	- uu-u u- uu -uu -uu --	dactylic hexameter	masculine penthemimeral
ἀλλ’ ὅσον ἐς Σκαιάς τε πύλας καὶ φηγὸν ἵκανεν·	- uu - -- u u- - -u u--	dactylic hexameter	masculine penthemimeral, hepthemimeral, trithemimeral
ἔνθά ποτ’ οἶον ἔμιμνε, μόγις δέ μευ ἔκφυγεν ὁρμήν.	-u u -u u-u u- u u -uu --	dactylic hexameter	feminine penthemimeral, hepthemimeral
νῦν δ’ἐπεὶ οὐκ ἐθέλω πολεμιζέμεν Ἕκτορι δίῳ	- uu - uu- uu-uu -uu --	dactylic hexameter	masculine penthemimeral, trithemimeral
αὔριον ἱρὰ Διὶ ῥέξας καὶ πᾶσι θεοῖσι	-uu -u u- -- - -u u--	dactylic hexameter	masculine penthemimeral, hepthemimeral
νηήσας εὖ νῆας, ἐπὴν ἅλα δὲ προερύσσω,	--- - -u u- uu - uu--	dactylic hexameter	feminine penthemimeral, hepthemimeral, trithemimeral
ὄψεαι, αἴ κ’ἐθέλῃσθα καὶ αἴ κέν τοι τὰ μεμήλῃ,	-uu - uu-u u - - - u u--	dactylic hexameter	feminine penthemimeral, hepthemimeral, trithemimeral
ἦρι μάλ’ Ἑλλήσποντον ἐπ’ ἰχθυόεντα πλεούσας	-u u ---u u -uu-u u--	dactylic hexameter	feminine penthemimeral
νῆας ἐμάς, ἐν δ’ἄνδρας ἐρεσσέμεναι μεμαῶτας·	-u u- - -u u-uu- uu--	dactylic hexameter	feminine penthemimeral, trithemimeral
εἰ δέ κεν εὐπλοίην δώῃ κλυτὸς ἐννοσίγαιος	- u u --- -- uu -uu--	dactylic hexameter	masculine penthemimeral, hepthemimeral
ἤματί κε τριτάτῳ Φθίην ἐρίβωλον ἱκοίμην.	-uu - uu- -- uu-u u--	dactylic hexameter	masculine penthemimeral, hepthemimeral, trithemimeral
ἔστι δέ μοι μάλα πολλά, τὰ κάλλιπον ἐνθάδε ἔρρων·	-u u - uu -u u -uu -uu --	dactylic hexameter	feminine penthemimeral, trithemimeral
ἄλλον δ’ἐνθένδε χρυσὸν καὶ χαλκὸν ἐρυθρὸν	-- --- -- - -u u--	dactylic hexameter	masculine penthemimeral, hepthemimeral
ἠδὲ γυναῖκας ἐϋζώνους πολιόν τε σίδηρον	-u u-u u--- uu- u u--	dactylic hexameter	hepthemimeral
ἄξομαι, ἅσσ’ ἔλαχόν γε· γέρας δέ μοι, ὅς περ ἔδωκεν,	-uu - uu- u u- u u - u u--	dactylic hexameter	masculine penthemimeral, hepthemimeral, trithemimeral
αὖτις ἐφυβρίζων ἕλετο κρείων Ἀγαμέμνων	-u u--- uu- -- uu--	dactylic hexameter	masculine penthemimeral, hepthemimeral
Ἀτρεΐδης· τῷ πάντ’ ἀγορευέμεν ὡς ἐπιτέλλω	-uu- - - uu-uu - uu--	dactylic hexameter	masculine penthemimeral, trithemimeral
ἀμφαδόν, ὄφρα καὶ ἄλλοι ἐπισκύζωνται Ἀχαιοὶ	-uu -u u -u u---u u--	dactylic hexameter	feminine penthemimeral
εἴ τινά που Δαναῶν ἔτι ἔλπεται ἐξαπατήσειν	- uu - uu- uu -uu -uu--	dactylic hexameter	masculine penthemimeral, trithemimeral
αἰὲν ἀναιδείην ἐπιειμένος· οὐδ’ ἂν ἔμοιγε	-u u--- uu-uu - u u--	dactylic hexameter	masculine penthemimeral
τετλαίη κύνεός περ ἐὼν εἰς ὦπα ἰδέσθαι·	--- uu- u u- - -u u--	dactylic hexameter	masculine penthemimeral, hepthemimeral, trithemimeral
οὐδέ τί οἱ βουλὰς συμφράσσομαι, οὐδὲ μὲν ἔργον·	-u u - -- --uu -u u --	dactylic hexameter	masculine penthemimeral, trithemimeral
ἐκ γὰρ δή μ’ἀπάτησε καὶ ἤλιτεν· οὐδ’ ἂν ἔτ’ αὖτις	- - - uu-u u -uu - u u --	dactylic hexameter	feminine penthemimeral, trithemimeral
ἐξαπάφοιτ’ ἐπέεσσιν· ἅλις δέ οἱ· ἀλλὰ ἕκηλος	-uu- uu-u u- u u -u u--	dactylic hexameter	feminine penthemimeral, hepthemimeral, trithemimeral
ἐρρέτω· ἐκ γάρ εὑ φρένας εἵλετο μητίετα Ζεύς.	-uu - - - uu -uu -uu- -	dactylic hexameter	masculine penthemimeral, trithemimeral
ἐχθρὰ δέ μοι τοῦ δῶρα, τίω δέ μιν ἐν καρὸς αἴσῃ.	-u u - - -u u- u u - uu --	dactylic hexameter	feminine penthemimeral, hepthemimeral, trithemimeral
οὐδ’ εἴ μοι δεκάκις τε καὶ εἰκοσάκις τόσα δοίη	- - - uu- u u -uu- uu --	dactylic hexameter	masculine penthemimeral, trithemimeral
ὅσσά τέ οἱ νῦν ἔστι, καὶ εἴ ποθεν ἄλλα γένοιτο,	-u u - - -u u - uu -u u--	dactylic hexameter	feminine penthemimeral, hepthemimeral, trithemimeral
οὐδ’ ὅσ’ ἐς Ὀρχομενὸν ποτινίσεται, οὐδ’ ὅσα Θήβας	- u u -uu- uu-uu - uu --	dactylic hexameter	masculine penthemimeral
Αἰγυπτίας, ὅθι πλεῖστα δόμοις ἐν κτήματα κεῖται,	--- uu -u u- - -uu --	dactylic hexameter	feminine penthemimeral, hepthemimeral, trithemimeral
αἵ θ’ἑκατόμπυλοί εἰσι, διηκόσιοι δ’ἀν’ ἑκάστας	- uu-uu -u u-uu- u u--	dactylic hexameter	feminine penthemimeral
ἀνέρες ἐξοιχνεῦσι σὺν ἵπποισιν καὶ ὄχεσφιν·	-uu ---u u --- u u--	dactylic hexameter	feminine penthemimeral
οὐδ’ εἴ μοι τόσα δοίη ὅσα ψάμαθός τε κόνις τε,	- - - uu -u u- uu- u u- -	dactylic hexameter	feminine penthemimeral, hepthemimeral, trithemimeral
οὐδέ κεν ὧς ἔτι θυμὸν ἐμὸν πείσει’ Ἀγαμέμνων	-u u - uu -u u- -- uu--	dactylic hexameter	feminine penthemimeral, hepthemimeral, trithemimeral
πρίν γ’ἀπὸ πᾶσαν ἐμοὶ δόμεναι θυμαλγέα λώβην.	- uu -u u- uu- --uu --	dactylic hexameter	masculine penthemimeral, hepthemimeral
κούρην δ’οὐ γαμέω Ἀγαμέμνονος Ἀτρεΐδαο,	-- - uu- uu-uu -uu--	dactylic hexameter	masculine penthemimeral, trithemimeral
οὐδ’ εἰ χρυσείῃ Ἀφροδίτῃ κάλλος ἐρίζοι,	- - --- uu-- -u u--	dactylic hexameter	masculine penthemimeral
ἔργα δ’Ἀθηναίῃ γλαυκώπιδι ἰσοφαρίζοι·	-u u--- --uu -uu--	dactylic hexameter	masculine penthemimeral
οὐδέ μιν ὧς γαμέω· ὃ δ’Ἀχαιῶν ἄλλον ἑλέσθω,	-u u - uu- u u-- -u u--	dactylic hexameter	masculine penthemimeral, trithemimeral
ὅς τις οἷ τ’ἐπέοικε καὶ ὃς βασιλεύτερός ἐστιν.	- - - uu-u u - uu-uu --	dactylic hexameter	feminine penthemimeral, hepthemimeral, trithemimeral
ἢν γὰρ δή με σαῶσι θεοὶ καὶ οἴκαδ’ ἵκωμαι,	- - - u u-u u- - -u u--	dactylic hexameter	feminine penthemimeral, hepthemimeral, trithemimeral
Πηλεύς θήν μοι ἔπειτα γυναῖκά γε μάσσεται αὐτός.	-- - u u-u u-u u -uu --	dactylic hexameter	feminine penthemimeral, trithemimeral
πολλαὶ Ἀχαιΐδες εἰσὶν ἀν’ Ἑλλάδα τε Φθίην τε	-u u-uu -u u -uu - -- -	dactylic hexameter	feminine penthemimeral
κοῦραι ἀριστήων, οἵ τε πτολίεθρα ῥύονται,	-u u--- - - uu-u u--	dactylic hexameter	masculine penthemimeral, hepthemimeral
τάων ἥν κ’ἐθέλωμι φίλην ποιήσομ’ ἄκοιτιν.	-- - uu-u u- --u u--	dactylic hexameter	feminine penthemimeral, hepthemimeral, trithemimeral
ἔνθα δέ μοι μάλα πολλὸν ἐπέσσυτο θυμὸς ἀγήνωρ	-u u - uu -u u-uu -u u--	dactylic hexameter	feminine penthemimeral, trithemimeral
γήμαντα μνηστὴν ἄλοχον ἐϊκυῖαν ἄκοιτιν	--- -- uu- uu-u u--	dactylic hexameter	masculine penthemimeral, hepthemimeral, trithemimeral
κτήμασι τέρπεσθαι τὰ γέρων ἐκτήσατο Πηλεύς·	-uu --- u u- --uu --	dactylic hexameter	masculine penthemimeral, hepthemimeral
οὐ γὰρ ἐμοὶ ψυχῆς ἀντάξιον οὐδ’ ὅσα φασὶν	- u u- -- --uu - uu --	dactylic hexameter	masculine penthemimeral, trithemimeral
Ἴλιον ἐκτῆσθαι εὖ ναιόμενον πτολίεθρον	-uu --- - -uu- uu--	dactylic hexameter	masculine penthemimeral
τὸ πρὶν ἐπ’ εἰρήνης, πρὶν ἐλθεῖν υἷας Ἀχαιῶν,	- u u --- - -- -u u--	dactylic hexameter	masculine penthemimeral
οὐδ’ ὅσα λάϊνος οὐδὸς ἀφήτορος ἐντὸς ἐέργει	- uu -uu -u u-uu -u u--	dactylic hexameter	feminine penthemimeral
Φοίβου Ἀπόλλωνος Πυθοῖ ἔνι πετρηέσσῃ.	-u u--- -- uu ----	dactylic hexameter	masculine penthemimeral, hepthemimeral
ληϊστοὶ μὲν γάρ τε βόες καὶ ἴφια μῆλα,	--- - - u u- - -uu --	dactylic hexameter	masculine penthemimeral, hepthemimeral, trithemimeral
κτητοὶ δὲ τρίποδές τε καὶ ἵππων ξανθὰ κάρηνα,	-- - uu- u u -- -u u--	dactylic hexameter	masculine penthemimeral, trithemimeral
ἀνδρὸς δὲ ψυχὴ πάλιν ἐλθεῖν οὔτε λεϊστὴ	-- - -- uu -- -u u--	dactylic hexameter	masculine penthemimeral, trithemimeral
οὔθ’ ἑλετή, ἐπεὶ ἄρ κεν ἀμείψεται ἕρκος ὀδόντων.	- uu- uu - u u-uu -u u--	dactylic hexameter	masculine penthemimeral, trithemimeral
μήτηρ γάρ τέ μέ φησι θεὰ Θέτις ἀργυρόπεζα	-- - u u -u u- uu -uu--	dactylic hexameter	feminine penthemimeral, hepthemimeral, trithemimeral
διχθαδίας κῆρας φερέμεν θανάτοιο τέλος δέ.	-uu- -- uu- uu-u u- -	dactylic hexameter	masculine penthemimeral, hepthemimeral, trithemimeral
εἰ μέν κ’αὖθι μένων Τρώων πόλιν ἀμφιμάχωμαι,	- - -u u- -- uu -uu--	dactylic hexameter	masculine penthemimeral, hepthemimeral
ὤλετο μέν μοι νόστος, ἀτὰρ κλέος ἄφθιτον ἔσται·	-uu - - -u u- uu -uu --	dactylic hexameter	feminine penthemimeral, hepthemimeral, trithemimeral
εἰ δέ κεν οἴκαδ’ ἵκωμι φίλην ἐς πατρίδα γαῖαν,	- u u -u u-u u- - -uu --	dactylic hexameter	feminine penthemimeral, hepthemimeral
ὤλετό μοι κλέος ἐσθλόν, ἐπὶ δηρὸν δέ μοι αἰὼν	-uu - uu -u u- -- u u --	dactylic hexameter	feminine penthemimeral, hepthemimeral, trithemimeral
ἔσσεται, οὐδέ κέ μ’ὦκα τέλος θανάτοιο κιχείη.	-uu -u u -u u- uu-u u--	dactylic hexameter	feminine penthemimeral, hepthemimeral
καὶ δ’ἂν τοῖς ἄλλοισιν ἐγὼ παραμυθησαίμην	- - - --u u- uu----	dactylic hexameter	feminine penthemimeral, hepthemimeral, trithemimeral
οἴκαδ’ ἀποπλείειν, ἐπεὶ οὐκέτι δήετε τέκμωρ	-u u--- uu -uu -uu --	dactylic hexameter	masculine penthemimeral
Ἰλίου αἰπεινῆς· μάλα γάρ ἑθεν εὐρύοπα Ζεὺς	-uu --- uu - uu -uu- -	dactylic hexameter	masculine penthemimeral, hepthemimeral
χεῖρα ἑὴν ὑπερέσχε, τεθαρσήκασι δὲ λαοί.	-u u- uu-u u---u u --	dactylic hexameter	feminine penthemimeral, trithemimeral
ἀλλ’ ὑμεῖς μὲν ἰόντες ἀριστήεσσιν Ἀχαιῶν	- -- u u-u u---u u--	dactylic hexameter	feminine penthemimeral, trithemimeral
ἀγγελίην ἀπόφασθε· τὸ γὰρ γέρας ἐστὶ γερόντων·	-uu- uu-u u - uu -u u--	dactylic hexameter	feminine penthemimeral, hepthemimeral, trithemimeral
ὄφρ’ ἄλλην φράζωνται ἐνὶ φρεσὶ μῆτιν ἀμείνω,	- -- --u u- uu -u u--	dactylic hexameter	feminine penthemimeral, hepthemimeral, trithemimeral
ἥ κέ σφιν νῆάς τε σαῷ καὶ λαὸν Ἀχαιῶν	- - - -- u u- - -u u--	dactylic hexameter	masculine penthemimeral, hepthemimeral, trithemimeral
νηυσὶν ἔπι γλαφυρῇς, ἐπεὶ οὔ σφισιν ἥδέ γ’ἑτοίμη	-u u- uu- uu - uu -u u--	dactylic hexameter	masculine penthemimeral, hepthemimeral, trithemimeral
ἣν νῦν ἐφράσσαντο ἐμεῦ ἀπομηνίσαντος·	- - ---u u- uu----	dactylic hexameter	feminine penthemimeral, hepthemimeral
Φοῖνιξ δ’αὖθι παρ’ ἄμμι μένων κατακοιμηθήτω,	-- -u u -u u- uu----	dactylic hexameter	feminine penthemimeral, hepthemimeral
ὄφρά μοι ἐν νήεσσι φίλην ἐς πατρίδ’ ἕπηται	-u u - --u u- - -u u--	dactylic hexameter	feminine penthemimeral, hepthemimeral, trithemimeral
αὔριον ἢν ἐθέλῃσιν· ἀνάγκῃ δ’οὔ τί μιν ἄξω.	-uu - uu-u u-- - u u --	dactylic hexameter	feminine penthemimeral, trithemimeral
ὣς ἔφαθ’, οἳ δ’ἄρα πάντες ἀκὴν ἐγένοντο σιωπῇ	- uu - uu -u u- uu-u u--	dactylic hexameter	feminine penthemimeral, hepthemimeral, trithemimeral
μῦθον ἀγασσάμενοι· μάλα γὰρ κρατερῶς ἀπέειπεν·	-u u-uu- uu - uu- uu--	dactylic hexameter	masculine penthemimeral, hepthemimeral
ὀψὲ δὲ δὴ μετέειπε γέρων ἱππηλάτα Φοῖνιξ	-u u - uu-u u- --uu --	dactylic hexameter	feminine penthemimeral, hepthemimeral, trithemimeral
δάκρυ’ ἀναπρήσας· περὶ γὰρ δίε νηυσὶν Ἀχαιῶν·	-u u--- uu - uu -u u--	dactylic hexameter	masculine penthemimeral, hepthemimeral
εἰ μὲν δὴ νόστόν γε μετὰ φρεσὶ φαίδιμ’ Ἀχιλλεῦ	- - - -- u u- uu -u u--	dactylic hexameter	masculine penthemimeral, hepthemimeral, trithemimeral
βάλλεαι, οὐδέ τι πάμπαν ἀμύνειν νηυσὶ θοῇσι	-uu -u u -u u-- -u u--	dactylic hexameter	feminine penthemimeral
πῦρ ἐθέλεις ἀΐδηλον, ἐπεὶ χόλος ἔμπεσε θυμῷ,	- uu- uu-u u- uu -uu --	dactylic hexameter	feminine penthemimeral, hepthemimeral, trithemimeral
πῶς ἂν ἔπειτ’ ἀπὸ σεῖο φίλον τέκος αὖθι λιποίμην	- u u- uu -u u- uu -u u--	dactylic hexameter	feminine penthemimeral, hepthemimeral, trithemimeral
οἶος; σοὶ δέ μ’ἔπεμπε γέρων ἱππηλάτα Πηλεὺς	-- - u u-u u- --uu --	dactylic hexameter	feminine penthemimeral, hepthemimeral, trithemimeral
ἤματι τῷ ὅτε σ’ἐκ Φθίης Ἀγαμέμνονι πέμπε	-uu - uu - -- uu-uu --	dactylic hexameter	masculine penthemimeral, hepthemimeral, trithemimeral
νήπιον οὔ πω εἰδόθ’ ὁμοιΐου πολέμοιο	-uu - - -u u--- uu--	dactylic hexameter	feminine penthemimeral, trithemimeral
οὐδ’ ἀγορέων, ἵνα τ’ἄνδρες ἀριπρεπέες τελέθουσι.	- uu- uu -u u-uu- uu--	dactylic hexameter	feminine penthemimeral, trithemimeral
τοὔνεκά με προέηκε διδασκέμεναι τάδε πάντα,	-uu - uu-u u-uu- uu --	dactylic hexameter	feminine penthemimeral, trithemimeral
μύθων τε ῥητῆρ’ ἔμεναι πρηκτῆρά τε ἔργων.	-- - -- uu- --u u --	dactylic hexameter	masculine penthemimeral, hepthemimeral, trithemimeral
ὡς ἂν ἔπειτ’ ἀπὸ σεῖο φίλον τέκος οὐκ ἐθέλοιμι	- u u- uu -u u- uu - uu--	dactylic hexameter	feminine penthemimeral, hepthemimeral, trithemimeral
λείπεσθ’, οὐδ’ εἴ κέν μοι ὑποσταίη θεὸς αὐτὸς	-- - - - u u--- uu --	dactylic hexameter	masculine penthemimeral, trithemimeral
γῆρας ἀποξύσας θήσειν νέον ἡβώοντα,	-u u--- -- uu ----	dactylic hexameter	masculine penthemimeral, hepthemimeral
οἷον ὅτε πρῶτον λίπον Ἑλλάδα καλλιγύναικα	-u u- -- uu -uu -uu--	dactylic hexameter	masculine penthemimeral, trithemimeral
φεύγων νείκεα πατρὸς Ἀμύντορος Ὀρμενίδαο,	-- -uu -u u-uu -uu--	dactylic hexameter	feminine penthemimeral
ὅς μοι παλλακίδος περιχώσατο καλλικόμοιο,	- - -uu- uu-uu -uu--	dactylic hexameter	masculine penthemimeral
τὴν αὐτὸς φιλέεσκεν, ἀτιμάζεσκε δ’ἄκοιτιν	- -- uu-u u---u u--	dactylic hexameter	feminine penthemimeral, trithemimeral
μητέρ’ ἐμήν· ἣ δ’αἰὲν ἐμὲ λισσέσκετο γούνων	-u u- - -u u- --uu --	dactylic hexameter	feminine penthemimeral, hepthemimeral, trithemimeral
παλλακίδι προμιγῆναι, ἵν’ ἐχθήρειε γέροντα.	-uu- uu-u u ---u u--	dactylic hexameter	feminine penthemimeral, trithemimeral
τῇ πιθόμην καὶ ἔρεξα· πατὴρ δ’ἐμὸς αὐτίκ’ ὀϊσθεὶς	- uu- u u-u u- uu -u u--	dactylic hexameter	feminine penthemimeral, hepthemimeral, trithemimeral
πολλὰ κατηρᾶτο, στυγερὰς δ’ἐπεκέκλετ’ Ἐρινῦς,	-u u--- uu- uu-u u--	dactylic hexameter	masculine penthemimeral, hepthemimeral
μή ποτε γούνασιν οἷσιν ἐφέσσεσθαι φίλον υἱὸν	- uu -uu -u u--- uu --	dactylic hexameter	feminine penthemimeral
ἐξ ἐμέθεν γεγαῶτα· θεοὶ δ’ἐτέλειον ἐπαρὰς	- uu- uu-u u- uu-u u--	dactylic hexameter	feminine penthemimeral, hepthemimeral, trithemimeral
Ζεύς τε καταχθόνιος καὶ ἐπαινὴ Περσεφόνεια.	- u u-uu- u u-- -uu--	dactylic hexameter	masculine penthemimeral
ἔνθ’ ἐμοὶ οὐκέτι πάμπαν ἐρητύετ’ ἐν φρεσὶ θυμὸς	- uu -uu -u u-uu - uu --	dactylic hexameter	feminine penthemimeral
πατρὸς χωομένοιο κατὰ μέγαρα στρωφᾶσθαι.	-- -uu-u u- uu- ---	dactylic hexameter	feminine penthemimeral, hepthemimeral
ἦ μὲν πολλὰ ἔται καὶ ἀνεψιοὶ ἀμφὶς ἐόντες	- - -u u- u u-uu -u u--	dactylic hexameter	masculine penthemimeral
αὐτοῦ λισσόμενοι κατερήτυον ἐν μεγάροισι,	-- -uu- uu-uu - uu--	dactylic hexameter	masculine penthemimeral
πολλὰ δὲ ἴφια μῆλα καὶ εἰλίποδας ἕλικας βοῦς	-u u -uu -u u -uu- uu- -	dactylic hexameter	feminine penthemimeral
ἔσφαζον, πολλοὶ δὲ σύες θαλέθοντες ἀλοιφῇ	--- -- u u- uu-u u--	dactylic hexameter	masculine penthemimeral, hepthemimeral, trithemimeral
εὑόμενοι τανύοντο διὰ φλογὸς Ἡφαίστοιο,	-uu- uu-u u- uu ----	dactylic hexameter	feminine penthemimeral, hepthemimeral, trithemimeral
πολλὸν δ’ἐκ κεράμων μέθυ πίνετο τοῖο γέροντος.	-- - uu- uu -uu -u u--	dactylic hexameter	masculine penthemimeral, trithemimeral
εἰνάνυχες δέ μοι ἀμφ’ αὐτῷ παρὰ νύκτας ἴαυον·	-uu- u u - -- uu -u u--	dactylic hexameter	masculine penthemimeral, hepthemimeral, trithemimeral
οἳ μὲν ἀμειβόμενοι φυλακὰς ἔχον, οὐδέ ποτ’ ἔσβη	- u u-uu- uu- uu -u u --	dactylic hexameter	masculine penthemimeral, hepthemimeral
πῦρ, ἕτερον μὲν ὑπ’ αἰθούσῃ εὐερκέος αὐλῆς,	- uu- u u --- --uu --	dactylic hexameter	hepthemimeral, trithemimeral
ἄλλο δ’ἐνὶ προδόμῳ, πρόσθεν θαλάμοιο θυράων.	-u u- uu- -- uu-u u--	dactylic hexameter	masculine penthemimeral, hepthemimeral, trithemimeral
ἀλλ’ ὅτε δὴ δεκάτη μοι ἐπήλυθε νὺξ ἐρεβεννή,	- uu - uu- u u-uu - uu--	dactylic hexameter	masculine penthemimeral, trithemimeral
καὶ τότ’ ἐγὼ θαλάμοιο θύρας πυκινῶς ἀραρυίας	- u u- uu-u u- uu- uu--	dactylic hexameter	feminine penthemimeral, hepthemimeral, trithemimeral
ῥήξας ἐξῆλθον, καὶ ὑπέρθορον ἑρκίον αὐλῆς	-- --- u u-uu -uu --	dactylic hexameter	masculine penthemimeral
ῥεῖα, λαθὼν φύλακάς τ’ἄνδρας δμῳάς τε γυναῖκας.	-u u- uu- -- -- u u--	dactylic hexameter	masculine penthemimeral, hepthemimeral, trithemimeral
φεῦγον ἔπειτ’ ἀπάνευθε δι’ Ἑλλάδος εὐρυχόροιο,	-u u- uu-u u -uu -uu--	dactylic hexameter	feminine penthemimeral, trithemimeral
Φθίην δ’ἐξικόμην ἐριβώλακα μητέρα μήλων	-- -uu- uu-uu -uu --	dactylic hexameter	masculine penthemimeral
ἐς Πηλῆα ἄναχθ’· ὃ δέ με πρόφρων ὑπέδεκτο,	- --u u- u u - -- uu--	dactylic hexameter	masculine penthemimeral, hepthemimeral
καί μ’ἐφίλησ’ ὡς εἴ τε πατὴρ ὃν παῖδα φιλήσῃ	- uu- - - u u- - -u u--	dactylic hexameter	masculine penthemimeral, hepthemimeral, trithemimeral
μοῦνον τηλύγετον πολλοῖσιν ἐπὶ κτεάτεσσι,	-- -uu- --u u- ---	dactylic hexameter	masculine penthemimeral
καί μ’ἀφνειὸν ἔθηκε, πολὺν δέ μοι ὤπασε λαόν·	- --u u-u u- u u -uu --	dactylic hexameter	feminine penthemimeral, hepthemimeral
ναῖον δ’ἐσχατιὴν Φθίης Δολόπεσσιν ἀνάσσων.	-- -uu- -- uu-u u--	dactylic hexameter	masculine penthemimeral, hepthemimeral
καί σε τοσοῦτον ἔθηκα θεοῖς ἐπιείκελ’ Ἀχιλλεῦ,	- u u-u u-u u- uu-u u--	dactylic hexameter	feminine penthemimeral, hepthemimeral
ἐκ θυμοῦ φιλέων, ἐπεὶ οὐκ ἐθέλεσκες ἅμ’ ἄλλῳ	- -- uu- uu - uu-u u --	dactylic hexameter	masculine penthemimeral, hepthemimeral, trithemimeral
οὔτ’ ἐς δαῖτ’ ἰέναι οὔτ’ ἐν μεγάροισι πάσασθαι,	- - - uu- - - uu-u u--	dactylic hexameter	masculine penthemimeral, hepthemimeral, trithemimeral
πρίν γ’ὅτε δή σ’ἐπ’ ἐμοῖσιν ἐγὼ γούνεσσι καθίσσας	- uu - u u-u u- --u u--	dactylic hexameter	feminine penthemimeral, hepthemimeral, trithemimeral
ὄψου τ’ἄσαιμι προταμὼν καὶ οἶνον ἐπισχών.	-- --- uu- - -u u--	dactylic hexameter	masculine penthemimeral, hepthemimeral
πολλάκι μοι κατέδευσας ἐπὶ στήθεσσι χιτῶνα	-uu - uu-u u- --u u--	dactylic hexameter	feminine penthemimeral, hepthemimeral, trithemimeral
οἴνου ἀποβλύζων ἐν νηπιέῃ ἀλεγεινῇ.	-u u--- - -uu- uu--	dactylic hexameter	masculine penthemimeral
ὣς ἐπὶ σοὶ μάλα πολλὰ πάθον καὶ πολλὰ μόγησα,	- uu - uu -u u- - -u u--	dactylic hexameter	feminine penthemimeral, hepthemimeral, trithemimeral
τὰ φρονέων ὅ μοι οὔ τι θεοὶ γόνον ἐξετέλειον	- uu- u u - u u- uu -uu--	dactylic hexameter	masculine penthemimeral, hepthemimeral, trithemimeral
ἐξ ἐμεῦ· ἀλλὰ σὲ παῖδα θεοῖς ἐπιείκελ’ Ἀχιλλεῦ	- uu -u u -u u- uu-u u--	dactylic hexameter	feminine penthemimeral, hepthemimeral
ποιεύμην, ἵνα μοί ποτ’ ἀεικέα λοιγὸν ἀμύνῃς.	--- uu - u u-uu -u u--	dactylic hexameter	masculine penthemimeral, trithemimeral
ἀλλ’ Ἀχιλεῦ δάμασον θυμὸν μέγαν· οὐδέ τί σε χρὴ	- uu- uu- -- uu -u u - -	dactylic hexameter	masculine penthemimeral, hepthemimeral, trithemimeral
νηλεὲς ἦτορ ἔχειν· στρεπτοὶ δέ τε καὶ θεοὶ αὐτοί,	-uu -u u- -- u u - uu --	dactylic hexameter	masculine penthemimeral, hepthemimeral
τῶν περ καὶ μείζων ἀρετὴ τιμή τε βίη τε.	- - - -- uu- -- u u- -	dactylic hexameter	masculine penthemimeral, hepthemimeral, trithemimeral
καὶ μὲν τοὺς θυέεσσι καὶ εὐχωλῇς ἀγανῇσι	- - - uu-u u --- uu--	dactylic hexameter	feminine penthemimeral, trithemimeral
λοιβῇ τε κνίσῃ τε παρατρωπῶσ’ ἄνθρωποι	-- - -- u u--- ---	dactylic hexameter	masculine penthemimeral, trithemimeral
λισσόμενοι, ὅτε κέν τις ὑπερβήῃ καὶ ἁμάρτῃ.	-uu- uu - u u--- u u--	dactylic hexameter	masculine penthemimeral, trithemimeral
καὶ γάρ τε λιταί εἰσι Διὸς κοῦραι μεγάλοιο	- - - uu -u u- -- uu--	dactylic hexameter	feminine penthemimeral, hepthemimeral, trithemimeral
χωλαί τε ῥυσαί τε παραβλῶπές τ’ὀφθαλμώ,	-- - -- u u--- ---	dactylic hexameter	masculine penthemimeral, trithemimeral
αἵ ῥά τε καὶ μετόπισθ’ ἄτης ἀλέγουσι κιοῦσαι.	- u u - uu- -- uu-u u--	dactylic hexameter	masculine penthemimeral, hepthemimeral, trithemimeral
ἣ δ’ἄτη σθεναρή τε καὶ ἀρτίπος, οὕνεκα πάσας	- -- uu- u u -uu -uu --	dactylic hexameter	masculine penthemimeral, trithemimeral
πολλὸν ὑπεκπροθέει, φθάνει δέ τε πᾶσαν ἐπ’ αἶαν	-u u-uu- -- u u -u u --	dactylic hexameter	masculine penthemimeral, hepthemimeral
βλάπτουσ’ ἀνθρώπους· αἳ δ’ἐξακέονται ὀπίσσω.	-- --- - -uu-u u--	dactylic hexameter	masculine penthemimeral
ὃς μέν τ’αἰδέσεται κούρας Διὸς ἆσσον ἰούσας,	- - -uu- -- uu -u u--	dactylic hexameter	masculine penthemimeral, hepthemimeral
τὸν δὲ μέγ’ ὤνησαν καί τ’ἔκλυον εὐχομένοιο·	- u u --- - -uu -uu--	dactylic hexameter	masculine penthemimeral
ὃς δέ κ’ἀνήνηται καί τε στερεῶς ἀποείπῃ,	- u u--- - - uu- uu--	dactylic hexameter	masculine penthemimeral, hepthemimeral
λίσσονται δ’ἄρα ταί γε Δία Κρονίωνα κιοῦσαι	--- uu - u u- uu-u u--	dactylic hexameter	masculine penthemimeral, hepthemimeral, trithemimeral
τῷ ἄτην ἅμ’ ἕπεσθαι, ἵνα βλαφθεὶς ἀποτίσῃ.	- -- u u-u u- -- uu--	dactylic hexameter	feminine penthemimeral, hepthemimeral, trithemimeral
ἀλλ’ Ἀχιλεῦ πόρε καὶ σὺ Διὸς κούρῃσιν ἕπεσθαι	- uu- uu - u u- --u u--	dactylic hexameter	masculine penthemimeral, hepthemimeral, trithemimeral
τιμήν, ἥ τ’ἄλλων περ ἐπιγνάμπτει νόον ἐσθλῶν.	-- - -- u u--- uu --	dactylic hexameter	masculine penthemimeral, trithemimeral
εἰ μὲν γὰρ μὴ δῶρα φέροι τὰ δ’ὄπισθ’ ὀνομάζοι	- - - - -u u- u u- uu--	dactylic hexameter	feminine penthemimeral, hepthemimeral, trithemimeral
Ἀτρεΐδης, ἀλλ’ αἰὲν ἐπιζαφελῶς χαλεπαίνοι,	-uu- - -u u-uu- uu--	dactylic hexameter	feminine penthemimeral, trithemimeral
οὐκ ἂν ἔγωγέ σε μῆνιν ἀπορρίψαντα κελοίμην	- u u-u u -u u---u u--	dactylic hexameter	feminine penthemimeral
Ἀργείοισιν ἀμυνέμεναι χατέουσί περ ἔμπης·	---u u-uu- uu-u u --	dactylic hexameter	hepthemimeral
νῦν δ’ἅμα τ’αὐτίκα πολλὰ διδοῖ τὰ δ’ὄπισθεν ὑπέστη,	- uu -uu -u u- u u-u u--	dactylic hexameter	feminine penthemimeral, hepthemimeral
ἄνδρας δὲ λίσσεσθαι ἐπιπροέηκεν ἀρίστους	-- - --u u-uu-u u--	dactylic hexameter	feminine penthemimeral, trithemimeral
κρινάμενος κατὰ λαὸν Ἀχαιϊκόν, οἵ τε σοὶ αὐτῷ	-uu- uu -u u-uu - u u --	dactylic hexameter	feminine penthemimeral, trithemimeral
φίλτατοι Ἀργείων· τῶν μὴ σύ γε μῦθον ἐλέγξῃς	-uu --- - - u u -u u--	dactylic hexameter	masculine penthemimeral, hepthemimeral
μηδὲ πόδας· πρὶν δ’οὔ τι νεμεσσητὸν κεχολῶσθαι.	-u u- - - u u--- uu--	dactylic hexameter	masculine penthemimeral, trithemimeral
οὕτω καὶ τῶν πρόσθεν ἐπευθόμεθα κλέα ἀνδρῶν	-- - - -u u-uu- uu --	dactylic hexameter	feminine penthemimeral, trithemimeral
ἡρώων, ὅτε κέν τιν’ ἐπιζάφελος χόλος ἵκοι·	--- uu - u u-uu- uu --	dactylic hexameter	masculine penthemimeral, trithemimeral
δωρητοί τε πέλοντο παράρρητοί τ’ἐπέεσσι.	--- u u-u u--- uu--	dactylic hexameter	feminine penthemimeral, trithemimeral
μέμνημαι τόδε ἔργον ἐγὼ πάλαι οὔ τι νέον γε	--- uu -u u- uu - u u- -	dactylic hexameter	feminine penthemimeral, hepthemimeral, trithemimeral
ὡς ἦν· ἐν δ’ὑμῖν ἐρέω πάντεσσι φίλοισι.	- - - -- uu- --u u--	dactylic hexameter	masculine penthemimeral, hepthemimeral, trithemimeral
Κουρῆτές τ’ἐμάχοντο καὶ Αἰτωλοὶ μενεχάρμαι	--- uu-u u --- uu--	dactylic hexameter	feminine penthemimeral, trithemimeral
ἀμφὶ πόλιν Καλυδῶνα καὶ ἀλλήλους ἐνάριζον,	-u u- uu-u u --- uu--	dactylic hexameter	feminine penthemimeral, trithemimeral
Αἰτωλοὶ μὲν ἀμυνόμενοι Καλυδῶνος ἐραννῆς,	--- u u-uu- uu-u u--	dactylic hexameter	hepthemimeral, trithemimeral
Κουρῆτες δὲ διαπραθέειν μεμαῶτες Ἄρηϊ.	--- u u-uu- uu-u u--	dactylic hexameter	hepthemimeral, trithemimeral
καὶ γὰρ τοῖσι κακὸν χρυσόθρονος Ἄρτεμις ὦρσε	- - -u u- --uu -uu --	dactylic hexameter	masculine penthemimeral
χωσαμένη ὅ οἱ οὔ τι θαλύσια γουνῷ ἀλωῆς	-uu- u u - u u-uu -u u--	dactylic hexameter	masculine penthemimeral, trithemimeral
Οἰνεὺς ῥέξ’· ἄλλοι δὲ θεοὶ δαίνυνθ’ ἑκατόμβας,	-- - -- u u- -- uu--	dactylic hexameter	masculine penthemimeral, hepthemimeral, trithemimeral
οἴῃ δ’οὐκ ἔρρεξε Διὸς κούρῃ μεγάλοιο.	-- - --u u- -- uu--	dactylic hexameter	feminine penthemimeral, hepthemimeral, trithemimeral
ἢ λάθετ’ ἢ οὐκ ἐνόησεν· ἀάσατο δὲ μέγα θυμῷ.	- uu - uu-u u-uu - uu --	dactylic hexameter	feminine penthemimeral, trithemimeral
ἣ δὲ χολωσαμένη δῖον γένος ἰοχέαιρα	- u u-uu- -- uu -uu--	dactylic hexameter	masculine penthemimeral, hepthemimeral
ὦρσεν ἔπι χλούνην σῦν ἄγριον ἀργιόδοντα,	-u u- -- - -uu -uu--	dactylic hexameter	masculine penthemimeral, trithemimeral
ὃς κακὰ πόλλ’ ἕρδεσκεν ἔθων Οἰνῆος ἀλωήν·	- uu - --u u- --u u--	dactylic hexameter	feminine penthemimeral, hepthemimeral, trithemimeral
πολλὰ δ’ὅ γε προθέλυμνα χαμαὶ βάλε δένδρεα μακρὰ	-u u - uu-u u- uu -uu --	dactylic hexameter	feminine penthemimeral, hepthemimeral, trithemimeral
αὐτῇσιν ῥίζῃσι καὶ αὐτοῖς ἄνθεσι μήλων.	--- --u u -- -uu --	dactylic hexameter	feminine penthemimeral, trithemimeral
τὸν δ’υἱὸς Οἰνῆος ἀπέκτεινεν Μελέαγρος	- -- --u u--- uu--	dactylic hexameter	feminine penthemimeral, trithemimeral
πολλέων ἐκ πολίων θηρήτορας ἄνδρας ἀγείρας	-- - uu- --uu -u u--	dactylic hexameter	masculine penthemimeral, trithemimeral
καὶ κύνας· οὐ μὲν γάρ κε δάμη παύροισι βροτοῖσι·	- uu - - - u u- --u u--	dactylic hexameter	masculine penthemimeral, hepthemimeral, trithemimeral
τόσσος ἔην, πολλοὺς δὲ πυρῆς ἐπέβησ’ ἀλεγεινῆς.	-u u- -- u u- uu- uu--	dactylic hexameter	masculine penthemimeral, hepthemimeral, trithemimeral
ἣ δ’ἀμφ’ αὐτῷ θῆκε πολὺν κέλαδον καὶ ἀϋτὴν	- - -- -u u- uu- u u--	dactylic hexameter	feminine penthemimeral, hepthemimeral
ἀμφὶ συὸς κεφαλῇ καὶ δέρματι λαχνήεντι,	-u u- uu- - -uu ----	dactylic hexameter	masculine penthemimeral, trithemimeral
Κουρήτων τε μεσηγὺ καὶ Αἰτωλῶν μεγαθύμων.	--- u u-u u --- uu--	dactylic hexameter	feminine penthemimeral, trithemimeral
ὄφρα μὲν οὖν Μελέαγρος ἄρηι φίλος πολέμιζε,	-u u - uu-u u-u u- uu--	dactylic hexameter	feminine penthemimeral, trithemimeral
τόφρα δὲ Κουρήτεσσι κακῶς ἦν, οὐδὲ δύναντο	-u u ---u u- - -u u--	dactylic hexameter	feminine penthemimeral, hepthemimeral
τείχεος ἔκτοσθεν μίμνειν πολέες περ ἐόντες·	-uu --- -- uu- u u--	dactylic hexameter	masculine penthemimeral, hepthemimeral
ἀλλ’ ὅτε δὴ Μελέαγρον ἔδυ χόλος, ὅς τε καὶ ἄλλων	- uu - uu-u u- uu - u u --	dactylic hexameter	feminine penthemimeral, hepthemimeral, trithemimeral
οἰδάνει ἐν στήθεσσι νόον πύκα περ φρονεόντων,	-uu - --u u- uu - uu--	dactylic hexameter	feminine penthemimeral, hepthemimeral, trithemimeral
ἤτοι ὃ μητρὶ φίλῃ Ἀλθαίῃ χωόμενος κῆρ	-u u -u u- --- -uu- -	dactylic hexameter	masculine penthemimeral
κεῖτο παρὰ μνηστῇ ἀλόχῳ καλῇ Κλεοπάτρῃ	-u u- -- uu- -- uu--	dactylic hexameter	masculine penthemimeral, hepthemimeral, trithemimeral
κούρῃ Μαρπήσσης καλλισφύρου Εὐηνίνης	-- --- --uu ----	dactylic hexameter	masculine penthemimeral
Ἴδεώ θ’,ὃς κάρτιστος ἐπιχθονίων γένετ’ ἀνδρῶν	-- - --u u-uu- uu --	dactylic hexameter	feminine penthemimeral, trithemimeral
τῶν τότε· καί ῥα ἄνακτος ἐναντίον εἵλετο τόξον	- uu - u u-u u-uu -uu --	dactylic hexameter	feminine penthemimeral, trithemimeral
Φοίβου Ἀπόλλωνος καλλισφύρου εἵνεκα νύμφης,	-u u--- --uu -uu --	dactylic hexameter	masculine penthemimeral
τὴν δὲ τότ’ ἐν μεγάροισι πατὴρ καὶ πότνια μήτηρ	- u u - uu-u u- - -uu --	dactylic hexameter	feminine penthemimeral, hepthemimeral, trithemimeral
Ἀλκυόνην καλέεσκον ἐπώνυμον, οὕνεκ’ ἄρ’ αὐτῆς	-uu- uu-u u-uu -u u --	dactylic hexameter	feminine penthemimeral, trithemimeral
μήτηρ ἀλκυόνος πολυπενθέος οἶτον ἔχουσα	-- -uu- uu-uu -u u--	dactylic hexameter	masculine penthemimeral
κλαῖεν ὅ μιν ἑκάεργος ἀνήρπασε Φοῖβος Ἀπόλλων·	-u u - uu-u u-uu -u u--	dactylic hexameter	feminine penthemimeral, trithemimeral
τῇ ὅ γε παρκατέλεκτο χόλον θυμαλγέα πέσσων	- u u -uu-u u- --uu --	dactylic hexameter	feminine penthemimeral, hepthemimeral
ἐξ ἀρέων μητρὸς κεχολωμένος, ἥ ῥα θεοῖσι	- uu- -- uu-uu - u u--	dactylic hexameter	masculine penthemimeral, trithemimeral
πόλλ’ ἀχέουσ’ ἠρᾶτο κασιγνήτοιο φόνοιο,	- uu- --u u---u u--	dactylic hexameter	feminine penthemimeral, trithemimeral
πολλὰ δὲ καὶ γαῖαν πολυφόρβην χερσὶν ἀλοία	-u u - -- uu-- -u u--	dactylic hexameter	masculine penthemimeral, trithemimeral
κικλήσκουσ’ Ἀΐδην καὶ ἐπαινὴν Περσεφόνειαν	--- uu- u u-- -uu--	dactylic hexameter	masculine penthemimeral, trithemimeral
πρόχνυ καθεζομένη, δεύοντο δὲ δάκρυσι κόλποι,	-u u-uu- --u u -uu --	dactylic hexameter	masculine penthemimeral
παιδὶ δόμεν θάνατον· τῆς δ’ἠεροφοῖτις Ἐρινὺς	-u u- uu- - -uu-u u--	dactylic hexameter	masculine penthemimeral, trithemimeral
ἔκλυεν ἐξ Ἐρέβεσφιν ἀμείλιχον ἦτορ ἔχουσα.	-uu - uu-u u-uu -u u--	dactylic hexameter	feminine penthemimeral, trithemimeral
τῶν δὲ τάχ’ ἀμφὶ πύλας ὅμαδος καὶ δοῦπος ὀρώρει	- u u -u u- uu- - -u u--	dactylic hexameter	masculine penthemimeral, hepthemimeral
πύργων βαλλομένων· τὸν δὲ λίσσοντο γέροντες	-- -uu- - - --u u--	dactylic hexameter	masculine penthemimeral, hepthemimeral
Αἰτωλῶν, πέμπον δὲ θεῶν ἱερῆας ἀρίστους,	--- -- u u- uu-u u--	dactylic hexameter	masculine penthemimeral, hepthemimeral, trithemimeral
ἐξελθεῖν καὶ ἀμῦναι ὑποσχόμενοι μέγα δῶρον·	--- u u-u u-uu- uu --	dactylic hexameter	feminine penthemimeral, trithemimeral
ὁππόθι πιότατον πεδίον Καλυδῶνος ἐραννῆς,	-uu -uu- uu- uu-u u--	dactylic hexameter	masculine penthemimeral, hepthemimeral
ἔνθά μιν ἤνωγον τέμενος περικαλλὲς ἑλέσθαι	-u u --- uu- uu-u u--	dactylic hexameter	masculine penthemimeral, hepthemimeral
πεντηκοντόγυον, τὸ μὲν ἥμισυ οἰνοπέδοιο,	---uu- u u -uu -uu--	dactylic hexameter	masculine penthemimeral
ἥμισυ δὲ ψιλὴν ἄροσιν πεδίοιο ταμέσθαι.	-uu - -- uu- uu-u u--	dactylic hexameter	masculine penthemimeral, hepthemimeral, trithemimeral
πολλὰ δέ μιν λιτάνευε γέρων ἱππηλάτα Οἰνεὺς	-u u - uu-u u- --uu --	dactylic hexameter	feminine penthemimeral, hepthemimeral, trithemimeral
οὐδοῦ ἐπεμβεβαὼς ὑψηρεφέος θαλάμοιο	-u u-uu- --uu- uu--	dactylic hexameter	masculine penthemimeral
σείων κολλητὰς σανίδας γουνούμενος υἱόν·	-- --- uu- --uu --	dactylic hexameter	masculine penthemimeral, hepthemimeral
πολλὰ δὲ τόν γε κασίγνηται καὶ πότνια μήτηρ	-u u - u u--- - -uu --	dactylic hexameter	hepthemimeral, trithemimeral
ἐλλίσσονθ’· ὃ δὲ μᾶλλον ἀναίνετο· πολλὰ δ’ἑταῖροι,	--- u u -u u-uu -u u--	dactylic hexameter	feminine penthemimeral, trithemimeral
οἵ οἱ κεδνότατοι καὶ φίλτατοι ἦσαν ἁπάντων·	- - -uu- - -uu -u u--	dactylic hexameter	masculine penthemimeral
ἀλλ’ οὐδ’ ὧς τοῦ θυμὸν ἐνὶ στήθεσσιν ἔπειθον,	- - - - -u u- --u u--	dactylic hexameter	feminine penthemimeral, hepthemimeral, trithemimeral
πρίν γ’ὅτε δὴ θάλαμος πύκ’ ἐβάλλετο, τοὶ δ’ἐπὶ πύργων	- uu - uu- u u-uu - uu --	dactylic hexameter	masculine penthemimeral, trithemimeral
βαῖνον Κουρῆτες καὶ ἐνέπρηθον μέγα ἄστυ.	-- --- u u--- uu --	dactylic hexameter	masculine penthemimeral
καὶ τότε δὴ Μελέαγρον ἐΰζωνος παράκοιτις	- uu - uu-u u--- uu--	dactylic hexameter	feminine penthemimeral, trithemimeral
λίσσετ’ ὀδυρομένη, καί οἱ κατέλεξεν ἅπαντα	-u u-uu- - - uu-u u--	dactylic hexameter	masculine penthemimeral, hepthemimeral
κήδε’, ὅσ’ ἀνθρώποισι πέλει τῶν ἄστυ ἁλώῃ·	-u u ---u u- - -u u--	dactylic hexameter	feminine penthemimeral, hepthemimeral
ἄνδρας μὲν κτείνουσι, πόλιν δέ τε πῦρ ἀμαθύνει,	-- - --u u- u u - uu--	dactylic hexameter	feminine penthemimeral, hepthemimeral, trithemimeral
τέκνα δέ τ’ἄλλοι ἄγουσι βαθυζώνους τε γυναῖκας.	-u u -u u-u u--- u u--	dactylic hexameter	feminine penthemimeral
τοῦ δ’ὠρίνετο θυμὸς ἀκούοντος κακὰ ἔργα,	- --uu -u u--- uu --	dactylic hexameter	feminine penthemimeral
βῆ δ’ἰέναι, χροῒ δ’ἔντε’ ἐδύσετο παμφανόωντα.	- uu- uu -u u-uu -uu--	dactylic hexameter	feminine penthemimeral, trithemimeral
ὣς ὃ μὲν Αἰτωλοῖσιν ἀπήμυνεν κακὸν ἦμαρ	- u u ---u u--- uu --	dactylic hexameter	feminine penthemimeral
εἴξας ᾧ θυμῷ· τῷ δ’οὐκέτι δῶρα τέλεσσαν	-- - -- - -uu -u u--	dactylic hexameter	masculine penthemimeral, trithemimeral
πολλά τε καὶ χαρίεντα, κακὸν δ’ἤμυνε καὶ αὔτως.	-u u - uu-u u- --u u --	dactylic hexameter	feminine penthemimeral, hepthemimeral, trithemimeral
ἀλλὰ σὺ μή μοι ταῦτα νόει φρεσί, μὴ δέ σε δαίμων	-u u - - -u u- uu - u u --	dactylic hexameter	feminine penthemimeral, hepthemimeral, trithemimeral
ἐνταῦθα τρέψειε φίλος· κάκιον δέ κεν εἴη	--- --u u- uu- u u --	dactylic hexameter	feminine penthemimeral, hepthemimeral, trithemimeral
νηυσὶν καιομένῃσιν ἀμυνέμεν· ἀλλ’ ἐπὶ δώρων	-- -uu-u u-uu - uu --	dactylic hexameter	feminine penthemimeral
ἔρχεο· ἶσον γάρ σε θεῷ τίσουσιν Ἀχαιοί.	-uu -- - u u- --u u--	dactylic hexameter	masculine penthemimeral, hepthemimeral
εἰ δέ κ’ἄτερ δώρων πόλεμον φθισήνορα δύῃς	- u u- -- uu- --uu --	dactylic hexameter	masculine penthemimeral, hepthemimeral, trithemimeral
οὐκέθ’ ὁμῶς τιμῆς ἔσεαι πόλεμόν περ ἀλαλκών,	-u u- -- uu- uu- u u--	dactylic hexameter	masculine penthemimeral, hepthemimeral, trithemimeral
τὸν δ’ἀπαμειβόμενος προσέφη πόδας ὠκὺς Ἀχιλλεύς·	- uu-uu- uu- uu -u u--	dactylic hexameter	masculine penthemimeral, hepthemimeral
Φοῖνιξ ἄττα γεραιὲ διοτρεφὲς οὔ τί με ταύτης	-- -u u-u u-uu - u u --	dactylic hexameter	feminine penthemimeral
χρεὼ τιμῆς· φρονέω δὲ τετιμῆσθαι Διὸς αἴσῃ,	- -- uu- u u--- uu --	dactylic hexameter	masculine penthemimeral, trithemimeral
ἥ μ’ἕξει παρὰ νηυσὶ κορωνίσιν εἰς ὅ κ’ἀϋτμὴ	- -- uu -u u-uu - u u--	dactylic hexameter	feminine penthemimeral, trithemimeral
ἐν στήθεσσι μένῃ καί μοι φίλα γούνατ’ ὀρώρῃ.	- --u u- - - uu -u u--	dactylic hexameter	masculine penthemimeral, hepthemimeral
ἄλλο δέ τοι ἐρέω, σὺ δ’ἐνὶ φρεσὶ βάλλεο σῇσι·	-u u - uu- u u- uu -uu --	dactylic hexameter	masculine penthemimeral, hepthemimeral, trithemimeral
μή μοι σύγχει θυμὸν ὀδυρόμενος καὶ ἀχεύων	- - -- -u u-uu- u u--	dactylic hexameter	feminine penthemimeral
Ἀτρεΐδῃ ἥρωϊ φέρων χάριν· οὐδέ τί σε χρὴ	-uu- --u u- uu -u u - -	dactylic hexameter	feminine penthemimeral, hepthemimeral, trithemimeral
τὸν φιλέειν, ἵνα μή μοι ἀπέχθηαι φιλέοντι.	- uu- uu - u u--- uu--	dactylic hexameter	masculine penthemimeral, trithemimeral
καλόν τοι σὺν ἐμοὶ τὸν κήδειν ὅς κ’ἐμὲ κήδῃ·	-- - u u- - -- - uu --	dactylic hexameter	masculine penthemimeral, trithemimeral
ἶσον ἐμοὶ βασίλευε καὶ ἥμισυ μείρεο τιμῆς.	-u u- uu-u u -uu -uu --	dactylic hexameter	feminine penthemimeral, trithemimeral
οὗτοι δ’ἀγγελέουσι, σὺ δ’αὐτόθι λέξεο μίμνων	-- -uu-u u -uu -uu --	dactylic hexameter	feminine penthemimeral
εὐνῇ ἔνι μαλακῇ· ἅμα δ’ἠοῖ φαινομένηφι	-u u- uu- uu -- -uu--	dactylic hexameter	masculine penthemimeral, trithemimeral
φρασσόμεθ’ ἤ κε νεώμεθ’ ἐφ’ ἡμέτερ’ ἦ κε μένωμεν.	-uu - u u-u u -uu - u u--	dactylic hexameter	feminine penthemimeral, trithemimeral
ἦ καὶ Πατρόκλῳ ὅ γ’ἐπ’ ὀφρύσι νεῦσε σιωπῇ	- - --- u u -uu -u u--	dactylic hexameter	masculine penthemimeral
Φοίνικι στορέσαι πυκινὸν λέχος, ὄφρα τάχιστα	--- uu- uu- uu -u u--	dactylic hexameter	masculine penthemimeral, hepthemimeral, trithemimeral
ἐκ κλισίης νόστοιο μεδοίατο· τοῖσι δ’ἄρ’ Αἴας	- uu- --u u-uu -u u --	dactylic hexameter	feminine penthemimeral, trithemimeral
ἀντίθεος Τελαμωνιάδης μετὰ μῦθον ἔειπε·	-uu- uu-uu- uu -u u--	dactylic hexameter	hepthemimeral, trithemimeral
διογενὲς Λαερτιάδη πολυμήχαν’ Ὀδυσσεῦ	-uu- --uu- uu-u u--	dactylic hexameter	hepthemimeral, trithemimeral
ἴομεν· οὐ γάρ μοι δοκέει μύθοιο τελευτὴ	-uu - - - uu- --u u--	dactylic hexameter	masculine penthemimeral, hepthemimeral, trithemimeral
τῇδέ γ’ὁδῷ κρανέεσθαι· ἀπαγγεῖλαι δὲ τάχιστα	-u u- uu-u u--- u u--	dactylic hexameter	feminine penthemimeral, trithemimeral
χρὴ μῦθον Δαναοῖσι καὶ οὐκ ἀγαθόν περ ἐόντα	- -- uu-u u - uu- u u--	dactylic hexameter	feminine penthemimeral, hepthemimeral, trithemimeral
οἵ που νῦν ἕαται ποτιδέγμενοι. αὐτάρ Ἀχιλλεὺς	- - - -- uu-uu -u u--	dactylic hexameter	masculine penthemimeral, trithemimeral
ἄγριον ἐν στήθεσσι θέτο μεγαλήτορα θυμὸν	-uu - --u u- uu-uu --	dactylic hexameter	feminine penthemimeral, hepthemimeral, trithemimeral
σχέτλιος, οὐδὲ μετατρέπεται φιλότητος ἑταίρων	-uu -u u-uu- uu-u u--	dactylic hexameter	hepthemimeral
τῆς ᾗ μιν παρὰ νηυσὶν ἐτίομεν ἔξοχον ἄλλων	- - - uu -u u-uu -uu --	dactylic hexameter	feminine penthemimeral, trithemimeral
νηλής· καὶ μέν τίς τε κασιγνήτοιο φονῆος	-- - - - u u---u u--	dactylic hexameter	masculine penthemimeral, trithemimeral
ποινὴν ἢ οὗ παιδὸς ἐδέξατο τεθνηῶτος·	-- - - -u u-uu ----	dactylic hexameter	feminine penthemimeral, trithemimeral
καί ῥ’ὃ μὲν ἐν δήμῳ μένει αὐτοῦ πόλλ’ ἀποτίσας,	- u u - -- uu -- - uu--	dactylic hexameter	masculine penthemimeral, trithemimeral
τοῦ δέ τ’ἐρητύεται κραδίη καὶ θυμὸς ἀγήνωρ	- u u-uu- uu- - -u u--	dactylic hexameter	masculine penthemimeral, hepthemimeral
ποινὴν δεξαμένῳ· σοὶ δ’ἄληκτόν τε κακόν τε	-- -uu- - --- u u- -	dactylic hexameter	masculine penthemimeral
θυμὸν ἐνὶ στήθεσσι θεοὶ θέσαν εἵνεκα κούρης	-u u- --u u- uu -uu --	dactylic hexameter	feminine penthemimeral, hepthemimeral, trithemimeral
οἴης· νῦν δέ τοι ἑπτὰ παρίσχομεν ἔξοχ’ ἀρίστας,	-- - u u -u u-uu -u u--	dactylic hexameter	feminine penthemimeral, trithemimeral
ἄλλά τε πόλλ’ ἐπὶ τῇσι· σὺ δ’ἵλαον ἔνθεο θυμόν,	-u u - uu -u u -uu -uu --	dactylic hexameter	feminine penthemimeral, trithemimeral
αἴδεσσαι δὲ μέλαθρον· ὑπωρόφιοι δέ τοί εἰμεν	--- u u-u u-uu- u u --	dactylic hexameter	feminine penthemimeral, trithemimeral
πληθύος ἐκ Δαναῶν, μέμαμεν δέ τοι ἔξοχον ἄλλων	-uu - uu- uu- u u -uu --	dactylic hexameter	masculine penthemimeral, hepthemimeral, trithemimeral
κήδιστοί τ’ἔμεναι καὶ φίλτατοι ὅσσοι Ἀχαιοί.	--- uu- - -uu -u u--	dactylic hexameter	masculine penthemimeral, trithemimeral
τὸν δ’ἀπαμειβόμενος προσέφη πόδας ὠκὺς Ἀχιλλεύς·	- uu-uu- uu- uu -u u--	dactylic hexameter	masculine penthemimeral, hepthemimeral
Αἶαν διογενὲς Τελαμώνιε κοίρανε λαῶν	-- -uu- uu-uu -uu --	dactylic hexameter	masculine penthemimeral
πάντά τί μοι κατὰ θυμὸν ἐείσαο μυθήσασθαι·	-u u - uu -u u-uu ----	dactylic hexameter	feminine penthemimeral, trithemimeral
ἀλλά μοι οἰδάνεται κραδίη χόλῳ ὁππότε κείνων	-u u -uu- uu- uu -uu --	dactylic hexameter	masculine penthemimeral, hepthemimeral
μνήσομαι ὥς μ’ἀσύφηλον ἐν Ἀργείοισιν ἔρεξεν	-uu - uu-u u ---u u--	dactylic hexameter	feminine penthemimeral, trithemimeral
Ἀτρεΐδης ὡς εἴ τιν’ ἀτίμητον μετανάστην.	-uu- - - u u--- uu--	dactylic hexameter	masculine penthemimeral, trithemimeral
ἀλλ’ ὑμεῖς ἔρχεσθε καὶ ἀγγελίην ἀπόφασθε·	- -- --u u -uu- uu--	dactylic hexameter	feminine penthemimeral, trithemimeral
οὐ γὰρ πρὶν πολέμοιο μεδήσομαι αἱματόεντος	- - - uu-u u-uu -uu--	dactylic hexameter	feminine penthemimeral, trithemimeral
πρίν γ’υἱὸν Πριάμοιο δαΐφρονος Ἕκτορα δῖον	- -- uu-u u-uu -uu --	dactylic hexameter	feminine penthemimeral, trithemimeral
Μυρμιδόνων ἐπί τε κλισίας καὶ νῆας ἱκέσθαι	-uu- uu - uu- - -u u--	dactylic hexameter	masculine penthemimeral, hepthemimeral, trithemimeral
κτείνοντ’ Ἀργείους, κατά τε σμῦξαι πυρὶ νῆας.	-- --- uu - -- uu --	dactylic hexameter	masculine penthemimeral, hepthemimeral
ἀμφὶ δέ τοι τῇ ἐμῇ κλισίῃ καὶ νηῒ μελαίνῃ	-u u - u u- uu- - -u u--	dactylic hexameter	masculine penthemimeral, hepthemimeral, trithemimeral
Ἕκτορα καὶ μεμαῶτα μάχης σχήσεσθαι ὀΐω.	-uu - uu-u u- --u u--	dactylic hexameter	feminine penthemimeral, hepthemimeral, trithemimeral
ὣς ἔφαθ’, οἳ δὲ ἕκαστος ἑλὼν δέπας ἀμφικύπελλον	- uu - u u-u u- uu -uu--	dactylic hexameter	feminine penthemimeral, hepthemimeral, trithemimeral
σπείσαντες παρὰ νῆας ἴσαν πάλιν· ἦρχε δ’Ὀδυσσεύς.	--- uu -u u- uu -u u--	dactylic hexameter	feminine penthemimeral, hepthemimeral, trithemimeral
Πάτροκλος δ’ἑτάροισιν ἰδὲ δμωῇσι κέλευσε	--- uu-u u- --u u--	dactylic hexameter	feminine penthemimeral, hepthemimeral, trithemimeral
Φοίνικι στορέσαι πυκινὸν λέχος ὅττι τάχιστα.	--- uu- uu- uu -u u--	dactylic hexameter	masculine penthemimeral, hepthemimeral, trithemimeral
αἳ δ’ἐπιπειθόμεναι στόρεσαν λέχος ὡς ἐκέλευσε	- uu-uu- uu- uu - uu--	dactylic hexameter	masculine penthemimeral, hepthemimeral
κώεά τε ῥῆγός τε λίνοιό τε λεπτὸν ἄωτον.	-uu - -- u u-u u -u u--	dactylic hexameter	masculine penthemimeral, trithemimeral
ἔνθ’ ὃ γέρων κατέλεκτο καὶ ἠῶ δῖαν ἔμιμνεν.	- u u- uu-u u -- -u u--	dactylic hexameter	feminine penthemimeral, trithemimeral
αὐτὰρ Ἀχιλλεὺς εὗδε μυχῷ κλισίης εὐπήκτου·	-u u-- -u u- uu- ---	dactylic hexameter	feminine penthemimeral, hepthemimeral
τῷ δ’ἄρα παρκατέλεκτο γυνή, τὴν Λεσβόθεν ἦγε,	- uu -uu-u u- - -uu --	dactylic hexameter	feminine penthemimeral, hepthemimeral
Φόρβαντος θυγάτηρ Διομήδη καλλιπάρῃος.	--- uu- uu-- -uu--	dactylic hexameter	masculine penthemimeral, trithemimeral
Πάτροκλος δ’ἑτέρωθεν ἐλέξατο· πὰρ δ’ἄρα καὶ τῷ	--- uu-u u-uu - uu - -	dactylic hexameter	feminine penthemimeral, trithemimeral
Ἶφις ἐΰζωνος, τήν οἱ πόρε δῖος Ἀχιλλεὺς	-u u--- - - uu -u u--	dactylic hexameter	masculine penthemimeral, hepthemimeral
Σκῦρον ἑλὼν αἰπεῖαν Ἐνυῆος πτολίεθρον.	-u u- --u u--- uu--	dactylic hexameter	feminine penthemimeral, trithemimeral
οἳ δ’ὅτε δὴ κλισίῃσιν ἐν Ἀτρεΐδαο γένοντο.	- uu - uu-u u -uu-u u--	dactylic hexameter	feminine penthemimeral, trithemimeral
τοὺς μὲν ἄρα χρυσέοισι κυπέλλοις υἷες Ἀχαιῶν	- u u- --u u-- -u u--	dactylic hexameter	feminine penthemimeral, trithemimeral
δειδέχατ’ ἄλλοθεν ἄλλος ἀνασταδόν, ἔκ τ’ἐρέοντο·	-uu -uu -u u-uu - uu--	dactylic hexameter	feminine penthemimeral
πρῶτος δ’ἐξερέεινεν ἄναξ ἀνδρῶν Ἀγαμέμνων·	-- -uu-u u- -- uu--	dactylic hexameter	feminine penthemimeral, hepthemimeral
εἴπ’ ἄγε μ’ὦ πολύαιν’ Ὀδυσεῦ μέγα κῦδος Ἀχαιῶν	- uu - uu- uu- uu -u u--	dactylic hexameter	masculine penthemimeral, hepthemimeral, trithemimeral
ἤ ῥ’ἐθέλει νήεσσιν ἀλεξέμεναι δήιον πῦρ,	- uu- --u u-uu- -- -	dactylic hexameter	feminine penthemimeral, trithemimeral
ἦ ἀπέειπε, χόλος δ’ἔτ’ ἔχει μεγαλήτορα θυμόν;	- uu-u u- u u- uu-uu --	dactylic hexameter	masculine penthemimeral, hepthemimeral
τὸν δ’αὖτε προσέειπε πολύτλας δῖος Ὀδυσσεύς·	- -- uu-u u-- -u u--	dactylic hexameter	feminine penthemimeral, trithemimeral
Ἀτρεΐδη κύδιστε ἄναξ ἀνδρῶν Ἀγάμεμνον	-uu- --u u- -- uu--	dactylic hexameter	feminine penthemimeral, hepthemimeral, trithemimeral
κεῖνός γ’οὐκ ἐθέλει σβέσσαι χόλον, ἀλλ’ ἔτι μᾶλλον	-- - uu- -- uu - uu --	dactylic hexameter	masculine penthemimeral, hepthemimeral, trithemimeral
πιμπλάνεται μένεος, σὲ δ’ἀναίνεται ἠδὲ σὰ δῶρα.	-uu- uu- u u-uu -u u --	dactylic hexameter	masculine penthemimeral, trithemimeral
αὐτόν σε φράζεσθαι ἐν Ἀργείοισιν ἄνωγεν	-- - --u u ---u u--	dactylic hexameter	feminine penthemimeral, trithemimeral
ὅππως κεν νῆάς τε σαῷς καὶ λαὸν Ἀχαιῶν·	-- - -- u u- - -u u--	dactylic hexameter	masculine penthemimeral, hepthemimeral, trithemimeral
αὐτὸς δ’ἠπείλησεν ἅμ’ ἠοῖ φαινομένηφι	-- ---u u -- -uu--	dactylic hexameter	feminine penthemimeral
νῆας ἐϋσσέλμους ἅλαδ’ ἑλκέμεν ἀμφιελίσσας.	-u u--- uu -uu -uu--	dactylic hexameter	masculine penthemimeral
καὶ δ’ἂν τοῖς ἄλλοισιν ἔφη παραμυθήσασθαι	- - - --u u- uu----	dactylic hexameter	feminine penthemimeral, hepthemimeral, trithemimeral
οἴκαδ’ ἀποπλείειν, ἐπεὶ οὐκέτι δήετε τέκμωρ	-u u--- uu -uu -uu --	dactylic hexameter	masculine penthemimeral
Ἰλίου αἰπεινῆς· μάλα γάρ ἑθεν εὐρύοπα Ζεὺς	-uu --- uu - uu -uu- -	dactylic hexameter	masculine penthemimeral, hepthemimeral
χεῖρα ἑὴν ὑπερέσχε, τεθαρσήκασι δὲ λαοί.	-u u- uu-u u---u u --	dactylic hexameter	feminine penthemimeral, trithemimeral
ὣς ἔφατ’· εἰσὶ καὶ οἵδε τάδ’ εἰπέμεν, οἵ μοι ἕποντο,	- uu -u u -u u -uu - u u--	dactylic hexameter	feminine penthemimeral
Αἴας καὶ κήρυκε δύω πεπνυμένω ἄμφω.	-- - --u u- --uu --	dactylic hexameter	feminine penthemimeral, hepthemimeral, trithemimeral
Φοῖνιξ δ’αὖθ’ ὃ γέρων κατελέξατο, ὡς γὰρ ἀνώγει,	-- - u u- uu-uu - u u--	dactylic hexameter	masculine penthemimeral, trithemimeral
ὄφρά οἱ ἐν νήεσσι φίλην ἐς πατρίδ’ ἕπηται	-u u - --u u- - -u u--	dactylic hexameter	feminine penthemimeral, hepthemimeral, trithemimeral
αὔριον, ἢν ἐθέλῃσιν· ἀνάγκῃ δ’οὔ τί μιν ἄξει.	-uu - uu-u u-- - u u --	dactylic hexameter	feminine penthemimeral, trithemimeral
ὣς ἔφαθ’, οἳ δ’ἄρα πάντες ἀκὴν ἐγένοντο σιωπῇ	- uu - uu -u u- uu-u u--	dactylic hexameter	feminine penthemimeral, hepthemimeral, trithemimeral
μῦθον ἀγασσάμενοι· μάλα γὰρ κρατερῶς ἀγόρευσε.	-u u-uu- uu - uu- uu--	dactylic hexameter	masculine penthemimeral, hepthemimeral
δὴν δ’ἄνεῳ ἦσαν τετιηότες υἷες Ἀχαιῶν·	- uu- -- uu-uu -u u--	dactylic hexameter	masculine penthemimeral, trithemimeral
ὀψὲ δὲ δὴ μετέειπε βοὴν ἀγαθὸς Διομήδης·	-u u - uu-u u- uu- uu--	dactylic hexameter	feminine penthemimeral, hepthemimeral, trithemimeral
Ἀτρεΐδη κύδιστε ἄναξ ἀνδρῶν Ἀγάμεμνον	-uu- --u u- -- uu--	dactylic hexameter	feminine penthemimeral, hepthemimeral, trithemimeral
μὴ ὄφελες λίσσεσθαι ἀμύμονα Πηλεΐωνα	- uu- --u u-uu -uu--	dactylic hexameter	feminine penthemimeral, trithemimeral
μυρία δῶρα διδούς· ὃ δ’ἀγήνωρ ἐστὶ καὶ ἄλλως·	-uu -u u- u u-- -u u --	dactylic hexameter	masculine penthemimeral
νῦν αὖ μιν πολὺ μᾶλλον ἀγηνορίῃσιν ἐνῆκας.	- - - uu -u u-uu-u u--	dactylic hexameter	feminine penthemimeral, trithemimeral
ἀλλ’ ἤτοι κεῖνον μὲν ἐάσομεν ἤ κεν ἴῃσιν	- -- -- u u-uu - u u--	dactylic hexameter	masculine penthemimeral, trithemimeral
ἦ κε μένῃ· τότε δ’αὖτε μαχήσεται ὁππότε κέν μιν	- u u- uu -u u-uu -uu - -	dactylic hexameter	feminine penthemimeral, trithemimeral
θυμὸς ἐνὶ στήθεσσιν ἀνώγῃ καὶ θεὸς ὄρσῃ.	-u u- --u u-- - uu --	dactylic hexameter	feminine penthemimeral, trithemimeral
ἀλλ’ ἄγεθ’ ὡς ἂν ἐγὼ εἴπω πειθώμεθα πάντες·	- uu - u u- -- --uu --	dactylic hexameter	masculine penthemimeral, hepthemimeral, trithemimeral
νῦν μὲν κοιμήσασθε τεταρπόμενοι φίλον ἦτορ	- - ---u u-uu- uu --	dactylic hexameter	feminine penthemimeral
σίτου καὶ οἴνοιο· τὸ γὰρ μένος ἐστὶ καὶ ἀλκή·	-- - --u u - uu -u u --	dactylic hexameter	feminine penthemimeral, hepthemimeral, trithemimeral
αὐτὰρ ἐπεί κε φανῇ καλὴ ῥοδοδάκτυλος Ἠώς,	-u u- u u- -- uu-uu --	dactylic hexameter	masculine penthemimeral, hepthemimeral, trithemimeral
καρπαλίμως πρὸ νεῶν ἐχέμεν λαόν τε καὶ ἵππους	-uu- u u- uu- -- u u --	dactylic hexameter	masculine penthemimeral, hepthemimeral, trithemimeral
ὀτρύνων, καὶ δ’αὐτὸς ἐνὶ πρώτοισι μάχεσθαι.	--- - -u u- --u u--	dactylic hexameter	feminine penthemimeral, hepthemimeral, trithemimeral
ὣς ἔφαθ’, οἳ δ’ἄρα πάντες ἐπῄνησαν βασιλῆες	- uu - uu -u u--- uu--	dactylic hexameter	feminine penthemimeral, trithemimeral
μῦθον ἀγασσάμενοι Διομήδεος ἱπποδάμοιο.	-u u-uu- uu-uu -uu--	dactylic hexameter	masculine penthemimeral
καὶ τότε δὴ σπείσαντες ἔβαν κλισίην δὲ ἕκαστος,	- uu - --u u- uu- u u--	dactylic hexameter	feminine penthemimeral, hepthemimeral, trithemimeral
ἔνθα δὲ κοιμήσαντο καὶ ὕπνου δῶρον ἕλοντο.	-u u ---u u -- -u u--	dactylic hexameter	feminine penthemimeral
