Αὐτὰρ ἐπεὶ κόσμηθεν ἅμ’ ἡγεμόνεσσιν ἕκαστοι,	-u u- --u u -uu-u u--	dactylic hexameter	feminine penthemimeral, trithemimeral
Τρῶες μὲν κλαγγῇ τ’ἐνοπῇ τ’ἴσαν ὄρνιθες ὣς	-- - -- uu- uu --- -	dactylic hexameter	masculine penthemimeral, hepthemimeral, trithemimeral
ἠΰτε περ κλαγγὴ γεράνων πέλει οὐρανόθι πρό·	-uu - -- uu- uu -uu- -	dactylic hexameter	masculine penthemimeral, hepthemimeral, trithemimeral
αἵ τ’ἐπεὶ οὖν χειμῶνα φύγον καὶ ἀθέσφατον ὄμβρον	- uu - --u u- u u-uu --	dactylic hexameter	feminine penthemimeral, hepthemimeral, trithemimeral
κλαγγῇ ταί γε πέτονται ἐπ’ ὠκεανοῖο ῥοάων	-- - u u-u u -uu-u u--	dactylic hexameter	feminine penthemimeral, trithemimeral
ἀνδράσι Πυγμαίοισι φόνον καὶ κῆρα φέρουσαι·	-uu ---u u- - -u u--	dactylic hexameter	feminine penthemimeral, hepthemimeral
ἠέριαι δ’ἄρα ταί γε κακὴν ἔριδα προφέρονται.	-uu- uu - u u- uu- uu--	dactylic hexameter	masculine penthemimeral, hepthemimeral, trithemimeral
Οἳ δ’ἄρ’ ἴσαν σιγῇ μένεα πνείοντες Ἀχαιοὶ	- u u- -- uu- --u u--	dactylic hexameter	masculine penthemimeral, hepthemimeral, trithemimeral
ἐν θυμῷ μεμαῶτες ἀλεξέμεν ἀλλήλοισιν.	- -- uu-u u-uu ----	dactylic hexameter	feminine penthemimeral, trithemimeral
Εὖτ’ ὄρεος κορυφῇσι Νότος κατέχευεν ὀμίχλην	- uu- uu-u u- uu-u u--	dactylic hexameter	feminine penthemimeral, hepthemimeral, trithemimeral
ποιμέσιν οὔ τι φίλην, κλέπτῃ δέ τε νυκτὸς ἀμείνω,	-uu - u u- -- u u -u u--	dactylic hexameter	masculine penthemimeral, hepthemimeral, trithemimeral
τόσσόν τίς τ’ἐπιλεύσσει ὅσον τ’ἐπὶ λᾶαν ἵησιν·	-- - uu-u u- uu -u u--	dactylic hexameter	feminine penthemimeral, hepthemimeral, trithemimeral
ὣς ἄρα τῶν ὑπὸ ποσσὶ κονίσαλος ὄρνυτ’ ἀελλὴς	- uu - uu -u u-uu -u u--	dactylic hexameter	feminine penthemimeral, trithemimeral
ἐρχομένων· μάλα δ’ὦκα διέπρησσον πεδίοιο.	-uu- uu -u u--- uu--	dactylic hexameter	feminine penthemimeral, trithemimeral
Οἳ δ’ὅτε δὴ σχεδὸν ἦσαν ἐπ’ ἀλλήλοισιν ἰόντες,	- uu - uu -u u ---u u--	dactylic hexameter	feminine penthemimeral, trithemimeral
Τρωσὶν μὲν προμάχιζεν Ἀλέξανδρος θεοειδὴς	-- - uu-u u--- uu--	dactylic hexameter	feminine penthemimeral, trithemimeral
παρδαλέην ὤμοισιν ἔχων καὶ καμπύλα τόξα	-uu- --u u- - -uu --	dactylic hexameter	feminine penthemimeral, hepthemimeral, trithemimeral
καὶ ξίφος· αὐτὰρ δοῦρε δύω κεκορυθμένα χαλκῷ	- uu -- -u u- uu-uu --	dactylic hexameter	feminine penthemimeral, hepthemimeral
πάλλων Ἀργείων προκαλίζετο πάντας ἀρίστους	-- --- uu-uu -u u--	dactylic hexameter	masculine penthemimeral
ἀντίβιον μαχέσασθαι ἐν αἰνῇ δηϊοτῆτι.	-uu- uu-u u -- -uu--	dactylic hexameter	feminine penthemimeral, trithemimeral
Τὸν δ’ὡς οὖν ἐνόησεν ἀρηΐφιλος Μενέλαος	- - - uu-u u-uu- uu--	dactylic hexameter	feminine penthemimeral, trithemimeral
ἐρχόμενον προπάροιθεν ὁμίλου μακρὰ βιβάντα,	-uu- uu-u u-- -u u--	dactylic hexameter	feminine penthemimeral, trithemimeral
ὥς τε λέων ἐχάρη μεγάλῳ ἐπὶ σώματι κύρσας	- u u- uu- uu- uu -uu --	dactylic hexameter	masculine penthemimeral, hepthemimeral, trithemimeral
εὑρὼν ἢ ἔλαφον κεραὸν ἢ ἄγριον αἶγα	-- - uu- uu- - -uu --	dactylic hexameter	masculine penthemimeral, hepthemimeral, trithemimeral
πεινάων· μάλα γάρ τε κατεσθίει, εἴ περ ἂν αὐτὸν	--- uu - u u-uu - u u --	dactylic hexameter	masculine penthemimeral, trithemimeral
σεύωνται ταχέες τε κύνες θαλεροί τ’αἰζηοί·	--- uu- u u- uu- ---	dactylic hexameter	masculine penthemimeral, hepthemimeral, trithemimeral
ὣς ἐχάρη Μενέλαος Ἀλέξανδρον θεοειδέα	- uu- uu-u u--- uu--	dactylic hexameter	feminine penthemimeral, trithemimeral
ὀφθαλμοῖσιν ἰδών· φάτο γὰρ τίσεσθαι ἀλείτην·	---u u- uu - --u u--	dactylic hexameter	masculine penthemimeral, hepthemimeral
αὐτίκα δ’ἐξ ὀχέων σὺν τεύχεσιν ἆλτο χαμᾶζε.	-uu - uu- - -uu -u u--	dactylic hexameter	masculine penthemimeral, trithemimeral
Τὸν δ’ὡς οὖν ἐνόησεν Ἀλέξανδρος θεοειδὴς	- - - uu-u u--- uu--	dactylic hexameter	feminine penthemimeral, trithemimeral
ἐν προμάχοισι φανέντα, κατεπλήγη φίλον ἦτορ,	- uu-u u-u u--- uu --	dactylic hexameter	feminine penthemimeral
ἂψ δ’ἑτάρων εἰς ἔθνος ἐχάζετο κῆρ’ ἀλεείνων.	- uu- - -u u-uu - uu--	dactylic hexameter	feminine penthemimeral, trithemimeral
Ὡς δ’ὅτε τίς τε δράκοντα ἰδὼν παλίνορσος ἀπέστη	- uu - u u-u u- uu-u u--	dactylic hexameter	feminine penthemimeral, hepthemimeral, trithemimeral
οὔρεος ἐν βήσσῃς, ὑπό τε τρόμος ἔλλαβε γυῖα,	-uu - -- uu - uu -uu --	dactylic hexameter	masculine penthemimeral, hepthemimeral, trithemimeral
ἂψ δ’ἀνεχώρησεν, ὦχρός τέ μιν εἷλε παρειάς,	- uu--- -- u u -u u--	dactylic hexameter	masculine penthemimeral, hepthemimeral
ὣς αὖτις καθ’ ὅμιλον ἔδυ Τρώων ἀγερώχων	- -- u u-u u- -- uu--	dactylic hexameter	feminine penthemimeral, hepthemimeral, trithemimeral
δείσας Ἀτρέος υἱὸν Ἀλέξανδρος θεοειδής.	-- -uu -u u--- uu--	dactylic hexameter	feminine penthemimeral
Τὸν δ’Ἕκτωρ νείκεσσεν ἰδὼν αἰσχροῖς ἐπέεσσιν·	- -- --u u- -- uu--	dactylic hexameter	feminine penthemimeral, hepthemimeral, trithemimeral
Δύσπαρι εἶδος ἄριστε γυναιμανὲς ἠπεροπευτὰ	-uu -u u-u u-uu -uu--	dactylic hexameter	feminine penthemimeral
αἴθ’ ὄφελες ἄγονός τ’ἔμεναι ἄγαμός τ’ἀπολέσθαι·	- uu- uu- uu- uu- uu--	dactylic hexameter	masculine penthemimeral, hepthemimeral, trithemimeral
καί κε τὸ βουλοίμην, καί κεν πολὺ κέρδιον ἦεν	- u u --- - - uu -uu --	dactylic hexameter	masculine penthemimeral, hepthemimeral
ἢ οὕτω λώβην τ’ἔμεναι καὶ ὑπόψιον ἄλλων.	- -- -- uu- u u-uu --	dactylic hexameter	masculine penthemimeral, hepthemimeral, trithemimeral
Ἦ που καγχαλόωσι κάρη κομόωντες Ἀχαιοὶ	- - -uu-u u- uu-u u--	dactylic hexameter	feminine penthemimeral, hepthemimeral
φάντες ἀριστῆα πρόμον ἔμμεναι, οὕνεκα καλὸν	-u u--- uu -uu -uu --	dactylic hexameter	masculine penthemimeral
εἶδος ἔπ’, ἀλλ’ οὐκ ἔστι βίη φρεσὶν οὐδέ τις ἀλκή.	-u u - - -u u- uu -u u --	dactylic hexameter	feminine penthemimeral, hepthemimeral, trithemimeral
Ἦ τοιόσδε ἐὼν ἐν ποντοπόροισι νέεσσι	- --u u- - -uu-u u--	dactylic hexameter	masculine penthemimeral
πόντον ἐπιπλώσας, ἑτάρους ἐρίηρας ἀγείρας,	-u u--- uu- uu-u u--	dactylic hexameter	masculine penthemimeral, hepthemimeral
μιχθεὶς ἀλλοδαποῖσι γυναῖκ’ εὐειδέ’ ἀνῆγες	-- -uu-u u- --u u--	dactylic hexameter	feminine penthemimeral, hepthemimeral
ἐξ ἀπίης γαίης νυὸν ἀνδρῶν αἰχμητάων	- uu- -- uu -- ----	dactylic hexameter	masculine penthemimeral, trithemimeral
πατρί τε σῷ μέγα πῆμα πόληΐ τε παντί τε δήμῳ,	-u u - uu -u u-u u -u u --	dactylic hexameter	feminine penthemimeral, trithemimeral
δυσμενέσιν μὲν χάρμα, κατηφείην δὲ σοὶ αὐτῷ;	-uu- - -u u--- u u --	dactylic hexameter	feminine penthemimeral, trithemimeral
οὐκ ἂν δὴ μείνειας ἀρηΐφιλον Μενέλαον;	- - - --u u-uu- uu--	dactylic hexameter	feminine penthemimeral, trithemimeral
γνοίης χ’οἵου φωτὸς ἔχεις θαλερὴν παράκοιτιν·	-- -- -u u- uu- uu--	dactylic hexameter	feminine penthemimeral, hepthemimeral
οὐκ ἄν τοι χραίσμῃ κίθαρις τά τε δῶρ’ Ἀφροδίτης	- - - -- uu- u u - uu--	dactylic hexameter	masculine penthemimeral, hepthemimeral, trithemimeral
ἥ τε κόμη τό τε εἶδος ὅτ’ ἐν κονίῃσι μιγείης.	- u u- u u -u u - uu-u u--	dactylic hexameter	feminine penthemimeral, hepthemimeral, trithemimeral
Ἀλλὰ μάλα Τρῶες δειδήμονες· ἦ τέ κεν ἤδη	-u u- -- --uu - u u --	dactylic hexameter	masculine penthemimeral, trithemimeral
λάϊνον ἕσσο χιτῶνα κακῶν ἕνεχ’ ὅσσα ἔοργας.	-uu -u u-u u- uu -u u--	dactylic hexameter	feminine penthemimeral, hepthemimeral
Τὸν δ’αὖτε προσέειπεν Ἀλέξανδρος θεοειδής·	- -- uu-u u--- uu--	dactylic hexameter	feminine penthemimeral, trithemimeral
Ἕκτορ ἐπεί με κατ’ αἶσαν ἐνείκεσας οὐδ’ ὑπὲρ αἶσαν·	-u u- u u -u u-uu - uu --	dactylic hexameter	feminine penthemimeral, trithemimeral
αἰεί τοι κραδίη πέλεκυς ὥς ἐστιν ἀτειρὴς	-- - uu- uu- - -u u--	dactylic hexameter	masculine penthemimeral, hepthemimeral, trithemimeral
ὅς τ’εἶσιν διὰ δουρὸς ὑπ’ ἀνέρος ὅς ῥά τε τέχνῃ	- -- uu -u u -uu - u u --	dactylic hexameter	feminine penthemimeral, trithemimeral
νήϊον ἐκτάμνῃσιν, ὀφέλλει δ’ἀνδρὸς ἐρωήν·	-uu ---u u-- -u u--	dactylic hexameter	feminine penthemimeral
ὣς σοὶ ἐνὶ στήθεσσιν ἀτάρβητος νόος ἐστί·	- u u- --u u--- uu --	dactylic hexameter	feminine penthemimeral, trithemimeral
μή μοι δῶρ’ ἐρατὰ πρόφερε χρυσέης Ἀφροδίτης·	- - - uu- uu- uu- uu--	dactylic hexameter	masculine penthemimeral, hepthemimeral, trithemimeral
οὔ τοι ἀπόβλητ’ ἐστὶ θεῶν ἐρικυδέα δῶρα	- u u-- -u u- uu-uu --	dactylic hexameter	feminine penthemimeral, hepthemimeral
ὅσσά κεν αὐτοὶ δῶσιν, ἑκὼν δ’οὐκ ἄν τις ἕλοιτο·	-u u -- -u u- - - u u--	dactylic hexameter	feminine penthemimeral, hepthemimeral
νῦν αὖτ’ εἴ μ’ἐθέλεις πολεμίζειν ἠδὲ μάχεσθαι,	- - - uu- uu-- -u u--	dactylic hexameter	masculine penthemimeral, trithemimeral
ἄλλους μὲν κάθισον Τρῶας καὶ πάντας Ἀχαιούς,	-- - uu- -- - -u u--	dactylic hexameter	masculine penthemimeral, hepthemimeral, trithemimeral
αὐτὰρ ἔμ’ ἐν μέσσῳ καὶ ἀρηΐφιλον Μενέλαον	-u u - -- u u-uu- uu--	dactylic hexameter	masculine penthemimeral, trithemimeral
συμβάλετ’ ἀμφ’ Ἑλένῃ καὶ κτήμασι πᾶσι μάχεσθαι·	-uu - uu- - -uu -u u--	dactylic hexameter	masculine penthemimeral, trithemimeral
ὁππότερος δέ κε νικήσῃ κρείσσων τε γένηται,	-uu- u u --- -- u u--	dactylic hexameter	hepthemimeral, trithemimeral
κτήμαθ’ ἑλὼν εὖ πάντα γυναῖκά τε οἴκαδ’ ἀγέσθω·	-u u- - -u u-u u -u u--	dactylic hexameter	feminine penthemimeral, trithemimeral
οἳ δ’ἄλλοι φιλότητα καὶ ὅρκια πιστὰ ταμόντες	- -- uu-u u -uu -u u--	dactylic hexameter	feminine penthemimeral, trithemimeral
ναίοιτε Τροίην ἐριβώλακα, τοὶ δὲ νεέσθων	--- -- uu-uu - u u--	dactylic hexameter	masculine penthemimeral, trithemimeral
Ἄργος ἐς ἱππόβοτον καὶ Ἀχαιΐδα καλλιγύναικα.	-u u -uu- u u-uu -uu--	dactylic hexameter	masculine penthemimeral
Ὣς ἔφαθ’, Ἕκτωρ δ’αὖτ’ ἐχάρη μέγα μῦθον ἀκούσας,	- uu -- - uu- uu -u u--	dactylic hexameter	masculine penthemimeral, hepthemimeral
καί ῥ’ἐς μέσσον ἰὼν Τρώων ἀνέεργε φάλαγγας	- - -u u- -- uu-u u--	dactylic hexameter	masculine penthemimeral, hepthemimeral
μέσσου δουρὸς ἑλών· τοὶ δ’ἱδρύνθησαν ἅπαντες.	-- -u u- - ---u u--	dactylic hexameter	masculine penthemimeral
Τῷ δ’ἐπετοξάζοντο κάρη κομόωντες Ἀχαιοὶ	- uu---u u- uu-u u--	dactylic hexameter	feminine penthemimeral, hepthemimeral
ἰοῖσίν τε τιτυσκόμενοι λάεσσί τ’ἔβαλλον·	--- u u-uu- --u u--	dactylic hexameter	hepthemimeral, trithemimeral
αὐτὰρ ὃ μακρὸν ἄϋσεν ἄναξ ἀνδρῶν Ἀγαμέμνων·	-u u -u u-u u- -- uu--	dactylic hexameter	feminine penthemimeral, hepthemimeral
ἴσχεσθ’ Ἀργεῖοι, μὴ βάλλετε κοῦροι Ἀχαιῶν·	-- --- - -uu -u u--	dactylic hexameter	masculine penthemimeral
στεῦται γάρ τι ἔπος ἐρέειν κορυθαίολος Ἕκτωρ.	-- - u u- uu- uu-uu --	dactylic hexameter	masculine penthemimeral, hepthemimeral, trithemimeral
Ὣς ἔφαθ’, οἳ δ’ἔσχοντο μάχης ἄνεῴ τ’ἐγένοντο	- uu - --u u- -- uu--	dactylic hexameter	feminine penthemimeral, hepthemimeral, trithemimeral
ἐσσυμένως· Ἕκτωρ δὲ μετ’ ἀμφοτέροισιν ἔειπε·	-uu- -- u u -uu-u u--	dactylic hexameter	masculine penthemimeral, trithemimeral
κέκλυτέ μευ Τρῶες καὶ ἐϋκνήμιδες Ἀχαιοὶ	-uu - -- u u---u u--	dactylic hexameter	masculine penthemimeral, trithemimeral
μῦθον Ἀλεξάνδροιο, τοῦ εἵνεκα νεῖκος ὄρωρεν.	-u u---u u -uu -u u--	dactylic hexameter	feminine penthemimeral
Ἄλλους μὲν κέλεται Τρῶας καὶ πάντας Ἀχαιοὺς	-- - uu- -- - -u u--	dactylic hexameter	masculine penthemimeral, hepthemimeral, trithemimeral
τεύχεα κάλ’ ἀποθέσθαι ἐπὶ χθονὶ πουλυβοτείρῃ,	-uu - uu-u u- uu -uu--	dactylic hexameter	feminine penthemimeral, hepthemimeral, trithemimeral
αὐτὸν δ’ἐν μέσσῳ καὶ ἀρηΐφιλον Μενέλαον	-- - -- u u-uu- uu--	dactylic hexameter	masculine penthemimeral, trithemimeral
οἴους ἀμφ’ Ἑλένῃ καὶ κτήμασι πᾶσι μάχεσθαι.	-- - uu- - -uu -u u--	dactylic hexameter	masculine penthemimeral, trithemimeral
Ὁππότερος δέ κε νικήσῃ κρείσσων τε γένηται	-uu- u u --- -- u u--	dactylic hexameter	hepthemimeral, trithemimeral
κτήμαθ’ ἑλὼν εὖ πάντα γυναῖκά τε οἴκαδ’ ἀγέσθω·	-u u- - -u u-u u -u u--	dactylic hexameter	feminine penthemimeral, trithemimeral
οἳ δ’ἄλλοι φιλότητα καὶ ὅρκια πιστὰ τάμωμεν.	- -- uu-u u -uu -u u--	dactylic hexameter	feminine penthemimeral, trithemimeral
Ὣς ἔφαθ’, οἳ δ’ἄρα πάντες ἀκὴν ἐγένοντο σιωπῇ·	- uu - uu -u u- uu-u u--	dactylic hexameter	feminine penthemimeral, hepthemimeral, trithemimeral
τοῖσι δὲ καὶ μετέειπε βοὴν ἀγαθὸς Μενέλαος·	-u u - uu-u u- uu- uu--	dactylic hexameter	feminine penthemimeral, hepthemimeral, trithemimeral
κέκλυτε νῦν καὶ ἐμεῖο· μάλιστα γὰρ ἄλγος ἱκάνει	-uu - u u-u u-u u -u u--	dactylic hexameter	feminine penthemimeral, trithemimeral
θυμὸν ἐμόν, φρονέω δὲ διακρινθήμεναι ἤδη	-u u- uu- u u---uu --	dactylic hexameter	masculine penthemimeral, trithemimeral
Ἀργείους καὶ Τρῶας, ἐπεὶ κακὰ πολλὰ πέπασθε	--- - -u u- uu -u u--	dactylic hexameter	feminine penthemimeral, hepthemimeral, trithemimeral
εἵνεκ’ ἐμῆς ἔριδος καὶ Ἀλεξάνδρου ἕνεκ’ ἀρχῆς·	-u u- uu- u u--- uu --	dactylic hexameter	masculine penthemimeral, trithemimeral
ἡμέων δ’ὁπποτέρῳ θάνατος καὶ μοῖρα τέτυκται	-- -uu- uu- - -u u--	dactylic hexameter	masculine penthemimeral, hepthemimeral
τεθναίη· ἄλλοι δὲ διακρινθεῖτε τάχιστα.	--- -- u u---u u--	dactylic hexameter	masculine penthemimeral, trithemimeral
Οἴσετε ἄρν’, ἕτερον λευκόν, ἑτέρην δὲ μέλαιναν,	-uu - uu- -- uu- u u--	dactylic hexameter	masculine penthemimeral, hepthemimeral, trithemimeral
Γῇ τε καὶ Ἠελίῳ· Διὶ δ’ἡμεῖς οἴσομεν ἄλλον·	- u u -uu- uu -- -uu --	dactylic hexameter	masculine penthemimeral
ἄξετε δὲ Πριάμοιο βίην, ὄφρ’ ὅρκια τάμνῃ	-uu - uu-u u- - -uu --	dactylic hexameter	feminine penthemimeral, hepthemimeral, trithemimeral
αὐτός, ἐπεί οἱ παῖδες ὑπερφίαλοι καὶ ἄπιστοι,	-u u- - -u u-uu- u u--	dactylic hexameter	feminine penthemimeral, trithemimeral
μή τις ὑπερβασίῃ Διὸς ὅρκια δηλήσηται.	- u u-uu- uu -uu ----	dactylic hexameter	masculine penthemimeral
Αἰεὶ δ’ὁπλοτέρων ἀνδρῶν φρένες ἠερέθονται·	-- -uu- -- uu -uu--	dactylic hexameter	masculine penthemimeral, hepthemimeral
οἷς δ’ὁ γέρων μετέῃσιν ἅμα πρόσσω καὶ ὀπίσσω	- u u- uu-u u- -- u u--	dactylic hexameter	feminine penthemimeral, hepthemimeral, trithemimeral
λεύσσει, ὅπως ὄχ’ ἄριστα μετ’ ἀμφοτέροισι γένηται.	-u u- u u-u u -uu-u u--	dactylic hexameter	feminine penthemimeral, trithemimeral
Ὣς ἔφαθ’, οἳ δ’ἐχάρησαν Ἀχαιοί τε Τρῶές τε	- uu - uu-u u-- - -- -	dactylic hexameter	feminine penthemimeral, trithemimeral
ἐλπόμενοι παύσασθαι ὀϊζυροῦ πολέμοιο.	-uu- --u u--- uu--	dactylic hexameter	feminine penthemimeral, trithemimeral
Καί ῥ’ἵππους μὲν ἔρυξαν ἐπὶ στίχας, ἐκ δ’ἔβαν αὐτοί,	- -- u u-u u- uu - uu --	dactylic hexameter	feminine penthemimeral, hepthemimeral, trithemimeral
τεύχεά τ’ἐξεδύοντο· τὰ μὲν κατέθεντ’ ἐπὶ γαίῃ	-uu -uu-u u - uu- uu --	dactylic hexameter	feminine penthemimeral, hepthemimeral
πλησίον ἀλλήλων, ὀλίγη δ’ἦν ἀμφὶς ἄρουρα·	-uu --- uu- - -u u--	dactylic hexameter	masculine penthemimeral, hepthemimeral
Ἕκτωρ δὲ προτὶ ἄστυ δύω κήρυκας ἔπεμπε	-- - uu -u u- --u u--	dactylic hexameter	feminine penthemimeral, hepthemimeral, trithemimeral
καρπαλίμως ἄρνάς τε φέρειν Πρίαμόν τε καλέσσαι·	-uu- -- u u- uu- u u--	dactylic hexameter	masculine penthemimeral, hepthemimeral, trithemimeral
αὐτὰρ ὃ Ταλθύβιον προΐει κρείων Ἀγαμέμνων	-u u -uu- uu- -- uu--	dactylic hexameter	masculine penthemimeral, hepthemimeral
νῆας ἔπι γλαφυρὰς ἰέναι, ἠδ’ ἄρν’ ἐκέλευεν	-u u- uu- uu- - - uu--	dactylic hexameter	masculine penthemimeral, hepthemimeral, trithemimeral
οἰσέμεναι· ὃ δ’ἄρ’ οὐκ ἀπίθησ’ Ἀγαμέμνονι δίῳ.	-uu- u u - uu- uu-uu --	dactylic hexameter	masculine penthemimeral, hepthemimeral, trithemimeral
Ἶρις δ’αὖθ’ Ἑλένῃ λευκωλένῳ ἄγγελος ἦλθεν	-- - uu- --uu -uu --	dactylic hexameter	masculine penthemimeral, trithemimeral
εἰδομένη γαλόῳ Ἀντηνορίδαο δάμαρτι,	-uu- uu- --uu-u u--	dactylic hexameter	masculine penthemimeral, trithemimeral
τὴν Ἀντηνορίδης εἶχε κρείων Ἑλικάων	- --uu- -- -- uu--	dactylic hexameter	masculine penthemimeral, hepthemimeral
Λαοδίκην Πριάμοιο θυγατρῶν εἶδος ἀρίστην.	-uu- uu-u u-- -u u--	dactylic hexameter	feminine penthemimeral, trithemimeral
Τὴν δ’εὗρ’ ἐν μεγάρῳ· ἣ δὲ μέγαν ἱστὸν ὕφαινε	- - - uu- - - uu -u u--	dactylic hexameter	masculine penthemimeral, hepthemimeral, trithemimeral
δίπλακα πορφυρέην, πολέας δ’ἐνέπασσεν ἀέθλους	-uu -uu- uu- uu-u u--	dactylic hexameter	masculine penthemimeral, hepthemimeral
Τρώων θ’ἱπποδάμων καὶ Ἀχαιῶν χαλκοχιτώνων,	-- -uu- u u-- -uu--	dactylic hexameter	masculine penthemimeral
οὕς ἑθεν εἵνεκ’ ἔπασχον ὑπ’ Ἄρηος παλαμάων·	- uu -u u-u u --- uu--	dactylic hexameter	feminine penthemimeral
ἀγχοῦ δ’ἱσταμένη προσέφη πόδας ὠκέα Ἶρις·	-- -uu- uu- uu -uu --	dactylic hexameter	masculine penthemimeral, hepthemimeral
δεῦρ’ ἴθι νύμφα φίλη, ἵνα θέσκελα ἔργα ἴδηαι	- uu -u u- uu -uu -u u--	dactylic hexameter	masculine penthemimeral
Τρώων θ’ἱπποδάμων καὶ Ἀχαιῶν χαλκοχιτώνων,	-- -uu- u u-- -uu--	dactylic hexameter	masculine penthemimeral
οἳ πρὶν ἐπ’ ἀλλήλοισι φέρον πολύδακρυν Ἄρηα	- u u ---u u- uu-u u--	dactylic hexameter	feminine penthemimeral, hepthemimeral
ἐν πεδίῳ ὀλοοῖο λιλαιόμενοι πολέμοιο·	- uu- uu-u u-uu- uu--	dactylic hexameter	feminine penthemimeral, trithemimeral
οἳ δὴ νῦν ἕαται σιγῇ, πόλεμος δὲ πέπαυται,	- - - -- -- uu- u u--	dactylic hexameter	masculine penthemimeral, hepthemimeral, trithemimeral
ἀσπίσι κεκλιμένοι, παρὰ δ’ἔγχεα μακρὰ πέπηγεν.	-uu -uu- uu -uu -u u--	dactylic hexameter	masculine penthemimeral
Αὐτὰρ Ἀλέξανδρος καὶ ἀρηΐφιλος Μενέλαος	-u u--- u u-uu- uu--	dactylic hexameter	masculine penthemimeral
μακρῇς ἐγχείῃσι μαχήσονται περὶ σεῖο·	-- ---u u--- uu --	dactylic hexameter	feminine penthemimeral
τῷ δέ κε νικήσαντι φίλη κεκλήσῃ ἄκοιτις.	- u u ---u u- --u u--	dactylic hexameter	feminine penthemimeral, hepthemimeral
Ὣς εἰποῦσα θεὰ γλυκὺν ἵμερον ἔμβαλε θυμῷ	- --u u- uu -uu -uu --	dactylic hexameter	masculine penthemimeral
ἀνδρός τε προτέρου καὶ ἄστεος ἠδὲ τοκήων·	-- - uu- - -uu -u u--	dactylic hexameter	masculine penthemimeral, trithemimeral
αὐτίκα δ’ἀργεννῇσι καλυψαμένη ὀθόνῃσιν	-uu ---u u-uu- uu--	dactylic hexameter	feminine penthemimeral
ὁρμᾶτ’ ἐκ θαλάμοιο τέρεν κατὰ δάκρυ χέουσα	-- - uu-u u- uu -u u--	dactylic hexameter	feminine penthemimeral, hepthemimeral, trithemimeral
οὐκ οἴη, ἅμα τῇ γε καὶ ἀμφίπολοι δύ’ ἕποντο,	- -- uu - u u -uu- u u--	dactylic hexameter	masculine penthemimeral, trithemimeral
Αἴθρη Πιτθῆος θυγάτηρ, Κλυμένη τε βοῶπις·	-- --- uu- uu- u u--	dactylic hexameter	masculine penthemimeral, hepthemimeral
αἶψα δ’ἔπειθ’ ἵκανον ὅθι Σκαιαὶ πύλαι ἦσαν.	-u u- --u u- -- uu --	dactylic hexameter	feminine penthemimeral, hepthemimeral, trithemimeral
Οἳ δ’ἀμφὶ Πρίαμον καὶ Πάνθοον ἠδὲ Θυμοίτην	- -- uu- - -uu -u u--	dactylic hexameter	masculine penthemimeral, trithemimeral
Λάμπόν τε Κλυτίον θ’Ἱκετάονά τ’ὄζον Ἄρηος	-- - uu- uu-uu -u u--	dactylic hexameter	masculine penthemimeral, trithemimeral
Οὐκαλέγων τε καὶ Ἀντήνωρ πεπνυμένω ἄμφω	-uu- u u --- --uu --	dactylic hexameter	hepthemimeral, trithemimeral
ἥατο δημογέροντες ἐπὶ Σκαιῇσι πύλῃσι,	-uu -uu-u u- --u u--	dactylic hexameter	feminine penthemimeral, hepthemimeral
γήραϊ δὴ πολέμοιο πεπαυμένοι, ἀλλ’ ἀγορηταὶ	-uu - uu-u u-uu - uu--	dactylic hexameter	feminine penthemimeral, trithemimeral
ἐσθλοί, τεττίγεσσιν ἐοικότες οἵ τε καθ’ ὕλην	-- ---u u-uu - u u --	dactylic hexameter	feminine penthemimeral
δενδρέῳ ἐφεζόμενοι ὄπα λειριόεσσαν ἱεῖσι·	-u u-uu- uu -uu-u u--	dactylic hexameter	masculine penthemimeral
τοῖοι ἄρα Τρώων ἡγήτορες ἧντ’ ἐπὶ πύργῳ.	-u u- -- --uu - uu --	dactylic hexameter	masculine penthemimeral, trithemimeral
Οἳ δ’ὡς οὖν εἴδονθ’ Ἑλένην ἐπὶ πύργον ἰοῦσαν,	- - - -- uu- uu -u u--	dactylic hexameter	masculine penthemimeral, hepthemimeral, trithemimeral
ἦκα πρὸς ἀλλήλους ἔπεα πτερόεντ’ ἀγόρευον·	-u u --- uu- uu- uu--	dactylic hexameter	masculine penthemimeral, hepthemimeral
οὐ νέμεσις Τρῶας καὶ ἐϋκνήμιδας Ἀχαιοὺς	- uu- -- u u---u u--	dactylic hexameter	masculine penthemimeral, trithemimeral
τοιῇδ’ ἀμφὶ γυναικὶ πολὺν χρόνον ἄλγεα πάσχειν·	-- -u u-u u- uu -uu --	dactylic hexameter	feminine penthemimeral, hepthemimeral
αἰνῶς ἀθανάτῃσι θεῇς εἰς ὦπα ἔοικεν·	-- -uu-u u- - -u u--	dactylic hexameter	feminine penthemimeral, hepthemimeral
ἀλλὰ καὶ ὧς τοίη περ ἐοῦσ’ ἐν νηυσὶ νεέσθω,	-u u - -- u u- - -u u--	dactylic hexameter	masculine penthemimeral, hepthemimeral, trithemimeral
μηδ’ ἡμῖν τεκέεσσί τ’ ὀπίσσω πῆμα λίποιτο.	- -- uu-u u-- -u u--	dactylic hexameter	feminine penthemimeral, trithemimeral
Ὣς ἄρ’ ἔφαν, Πρίαμος δ’Ἑλένην ἐκαλέσσατο φωνῇ·	- u u- uu- uu- uu-uu --	dactylic hexameter	masculine penthemimeral, hepthemimeral, trithemimeral
δεῦρο πάροιθ’ ἐλθοῦσα φίλον τέκος ἵζευ ἐμεῖο,	-u u- --u u- uu -u u--	dactylic hexameter	feminine penthemimeral, hepthemimeral, trithemimeral
ὄφρα ἴδῃ πρότερόν τε πόσιν πηούς τε φίλους τε·	-u u- uu- u u- -- u u- -	dactylic hexameter	masculine penthemimeral, hepthemimeral, trithemimeral
οὔ τί μοι αἰτίη ἐσσί, θεοί νύ μοι αἴτιοί εἰσιν	- u u -uu -u u- u u -uu --	dactylic hexameter	feminine penthemimeral, hepthemimeral
οἵ μοι ἐφώρμησαν πόλεμον πολύδακρυν Ἀχαιῶν·	- u u--- uu- uu-u u--	dactylic hexameter	masculine penthemimeral, hepthemimeral
ὥς μοι καὶ τόνδ’ ἄνδρα πελώριον ἐξονομήνῃς	- - - - -u u-uu -uu--	dactylic hexameter	feminine penthemimeral, trithemimeral
ὅς τις ὅδ’ ἐστὶν Ἀχαιὸς ἀνὴρ ἠΰς τε μέγας τε.	- u u -u u-u u- -- u u- -	dactylic hexameter	feminine penthemimeral, hepthemimeral
Ἤτοι μὲν κεφαλῇ καὶ μείζονες ἄλλοι ἔασι,	-- - uu- - -uu -u u--	dactylic hexameter	masculine penthemimeral, trithemimeral
καλὸν δ’οὕτω ἐγὼν οὔ πω ἴδον ὀφθαλμοῖσιν,	-- -u u- - - uu ----	dactylic hexameter	masculine penthemimeral, hepthemimeral
οὐδ’ οὕτω γεραρόν· βασιλῆϊ γὰρ ἀνδρὶ ἔοικε.	- -- uu- uu-u u -u u--	dactylic hexameter	masculine penthemimeral, trithemimeral
Τὸν δ’Ἑλένη μύθοισιν ἀμείβετο δῖα γυναικῶν·	- uu- --u u-uu -u u--	dactylic hexameter	feminine penthemimeral, trithemimeral
αἰδοῖός τέ μοί ἐσσι φίλε ἑκυρὲ δεινός τε·	--- u u -u u- uu- -- -	dactylic hexameter	feminine penthemimeral, hepthemimeral, trithemimeral
ὡς ὄφελεν θάνατός μοι ἁδεῖν κακὸς ὁππότε δεῦρο	- uu- uu- u u- uu -uu --	dactylic hexameter	masculine penthemimeral, hepthemimeral, trithemimeral
υἱέϊ σῷ ἑπόμην θάλαμον γνωτούς τε λιποῦσα	-uu - uu- uu- -- u u--	dactylic hexameter	masculine penthemimeral, hepthemimeral, trithemimeral
παῖδά τε τηλυγέτην καὶ ὁμηλικίην ἐρατεινήν.	-u u -uu- u u-uu- uu--	dactylic hexameter	masculine penthemimeral
Ἀλλὰ τά γ’οὐκ ἐγένοντο· τὸ καὶ κλαίουσα τέτηκα.	-u u - uu-u u - --u u--	dactylic hexameter	feminine penthemimeral, hepthemimeral, trithemimeral
Τοῦτο δέ τοι ἐρέω ὅ μ’ἀνείρεαι ἠδὲ μεταλλᾷς·	-u u - uu- u u-uu -u u--	dactylic hexameter	masculine penthemimeral, trithemimeral
οὗτός γ’Ἀτρεΐδης εὐρὺ κρείων Ἀγαμέμνων,	-- -uu- -- -- uu--	dactylic hexameter	masculine penthemimeral, hepthemimeral
ἀμφότερον βασιλεύς τ’ἀγαθὸς κρατερός τ’αἰχμητής·	-uu- uu- uu- uu- ---	dactylic hexameter	masculine penthemimeral, hepthemimeral, trithemimeral
δαὴρ αὖτ’ ἐμὸς ἔσκε κυνώπιδος, εἴ ποτ’ ἔην γε.	-- - uu -u u-uu - u u- -	dactylic hexameter	feminine penthemimeral, trithemimeral
Ὣς φάτο, τὸν δ’ὁ γέρων ἠγάσσατο φώνησέν τε·	- uu - u u- --uu --- -	dactylic hexameter	masculine penthemimeral, trithemimeral
ὦ μάκαρ Ἀτρεΐδη μοιρηγενὲς ὀλβιόδαιμον,	- uu -uu- --uu -uu--	dactylic hexameter	masculine penthemimeral
ἦ ῥά νύ τοι πολλοὶ δεδμήατο κοῦροι Ἀχαιῶν.	- u u - -- --uu -u u--	dactylic hexameter	masculine penthemimeral, trithemimeral
Ἤδη καὶ Φρυγίην εἰσήλυθον ἀμπελόεσσαν,	-- - uu- --uu -uu--	dactylic hexameter	masculine penthemimeral, trithemimeral
ἔνθα ἴδον πλείστους Φρύγας ἀνέρας αἰολοπώλους	-u u- -- uu -uu -uu--	dactylic hexameter	masculine penthemimeral, trithemimeral
λαοὺς Ὀτρῆος καὶ Μυγδόνος ἀντιθέοιο,	-- --- - -uu -uu--	dactylic hexameter	masculine penthemimeral
οἵ ῥα τότ’ ἐστρατόωντο παρ’ ὄχθας Σαγγαρίοιο·	- u u -uu-u u -- -uu--	dactylic hexameter	feminine penthemimeral
καὶ γὰρ ἐγὼν ἐπίκουρος ἐὼν μετὰ τοῖσιν ἐλέχθην	- u u- uu-u u- uu -u u--	dactylic hexameter	feminine penthemimeral, hepthemimeral, trithemimeral
ἤματι τῷ ὅτε τ’ἦλθον Ἀμαζόνες ἀντιάνειραι·	-uu - uu -u u-uu -uu--	dactylic hexameter	feminine penthemimeral, trithemimeral
ἀλλ’ οὐδ’ οἳ τόσοι ἦσαν ὅσοι ἑλίκωπες Ἀχαιοί.	- - - uu -u u- uu-u u--	dactylic hexameter	feminine penthemimeral, hepthemimeral, trithemimeral
Δεύτερον αὖτ’ Ὀδυσῆα ἰδὼν ἐρέειν’ ὁ γεραιός·	-uu - uu-u u- uu- u u--	dactylic hexameter	feminine penthemimeral, hepthemimeral, trithemimeral
εἴπ’ ἄγε μοι καὶ τόνδε φίλον τέκος ὅς τις ὅδ’ ἐστί·	- uu - - -u u- uu - u u --	dactylic hexameter	feminine penthemimeral, hepthemimeral, trithemimeral
μείων μὲν κεφαλῇ Ἀγαμέμνονος Ἀτρεΐδαο,	-- - uu- uu-uu -uu--	dactylic hexameter	masculine penthemimeral, trithemimeral
εὐρύτερος δ’ὤμοισιν ἰδὲ στέρνοισιν ἰδέσθαι.	-uu- --u u- --u u--	dactylic hexameter	feminine penthemimeral, hepthemimeral, trithemimeral
Τεύχεα μέν οἱ κεῖται ἐπὶ χθονὶ πουλυβοτείρῃ,	-uu - - -u u- uu -uu--	dactylic hexameter	feminine penthemimeral, hepthemimeral, trithemimeral
αὐτὸς δὲ κτίλος ὣς ἐπιπωλεῖται στίχας ἀνδρῶν·	-- - uu - uu--- uu --	dactylic hexameter	masculine penthemimeral, trithemimeral
ἀρνειῷ μιν ἔγωγε ἐΐσκω πηγεσιμάλλῳ,	--- u u-u u-- -uu--	dactylic hexameter	feminine penthemimeral, trithemimeral
ὅς τ’οἰῶν μέγα πῶϋ διέρχεται ἀργεννάων.	- -- uu -u u-uu ----	dactylic hexameter	feminine penthemimeral, trithemimeral
Τὸν δ’ἠμείβετ’ ἔπειθ’ Ἑλένη Διὸς ἐκγεγαυῖα·	- --u u- uu- uu -uu--	dactylic hexameter	masculine penthemimeral, hepthemimeral
οὗτος δ’αὖ Λαερτιάδης πολύμητις Ὀδυσσεύς,	-- - --uu- uu-u u--	dactylic hexameter	hepthemimeral, trithemimeral
ὃς τράφη ἐν δήμῳ Ἰθάκης κραναῆς περ ἐούσης	- uu - -- uu- uu- u u--	dactylic hexameter	masculine penthemimeral, hepthemimeral, trithemimeral
εἰδὼς παντοίους τε δόλους καὶ μήδεα πυκνά.	-- --- u u- - -uu --	dactylic hexameter	masculine penthemimeral, hepthemimeral
Τὴν δ’αὖτ’ Ἀντήνωρ πεπνυμένος ἀντίον ηὔδα·	- - --- --uu -uu --	dactylic hexameter	masculine penthemimeral
ὦ γύναι ἦ μάλα τοῦτο ἔπος νημερτὲς ἔειπες·	- uu - uu -u u- --u u--	dactylic hexameter	feminine penthemimeral, hepthemimeral, trithemimeral
ἤδη γὰρ καὶ δεῦρό ποτ’ ἤλυθε δῖος Ὀδυσσεὺς	-- - - -u u -uu -u u--	dactylic hexameter	feminine penthemimeral, trithemimeral
σεῦ ἕνεκ’ ἀγγελίης σὺν ἀρηϊφίλῳ Μενελάῳ·	- uu -uu- u u-uu- uu--	dactylic hexameter	masculine penthemimeral
τοὺς δ’ἐγὼ ἐξείνισσα καὶ ἐν μεγάροισι φίλησα,	- uu ---u u - uu-u u--	dactylic hexameter	feminine penthemimeral, hepthemimeral
ἀμφοτέρων δὲ φυὴν ἐδάην καὶ μήδεα πυκνά.	-uu- u u- uu- - -uu --	dactylic hexameter	masculine penthemimeral, hepthemimeral, trithemimeral
Ἀλλ’ ὅτε δὴ Τρώεσσιν ἐν ἀγρομένοισιν ἔμιχθεν	- uu - --u u -uu-u u--	dactylic hexameter	feminine penthemimeral, trithemimeral
στάντων μὲν Μενέλαος ὑπείρεχεν εὐρέας ὤμους,	-- - uu-u u-uu -uu --	dactylic hexameter	feminine penthemimeral, trithemimeral
ἄμφω δ’ἑζομένω γεραρώτερος ἦεν Ὀδυσσεύς·	-- -uu- uu-uu -u u--	dactylic hexameter	masculine penthemimeral
ἀλλ’ ὅτε δὴ μύθους καὶ μήδεα πᾶσιν ὕφαινον	- uu - -- - -uu -u u--	dactylic hexameter	masculine penthemimeral, trithemimeral
ἤτοι μὲν Μενέλαος ἐπιτροχάδην ἀγόρευε,	-- - uu-u u-uu- uu--	dactylic hexameter	feminine penthemimeral, trithemimeral
παῦρα μὲν ἀλλὰ μάλα λιγέως, ἐπεὶ οὐ πολύμυθος	-u u -u u- uu- uu - uu--	dactylic hexameter	masculine penthemimeral, hepthemimeral
οὐδ’ ἀφαμαρτοεπής· ἦ καὶ γένει ὕστερος ἦεν.	- uu-uu- - - uu -uu --	dactylic hexameter	masculine penthemimeral, hepthemimeral
Ἀλλ’ ὅτε δὴ πολύμητις ἀναΐξειεν Ὀδυσσεὺς	- uu - uu-u u---u u--	dactylic hexameter	feminine penthemimeral, trithemimeral
στάσκεν, ὑπαὶ δὲ ἴδεσκε κατὰ χθονὸς ὄμματα πήξας,	-u u- u u-u u- uu -uu --	dactylic hexameter	feminine penthemimeral, hepthemimeral, trithemimeral
σκῆπτρον δ’οὔτ’ ὀπίσω οὔτε προπρηνὲς ἐνώμα,	-- - uu- -- --u u--	dactylic hexameter	masculine penthemimeral, hepthemimeral, trithemimeral
ἀλλ’ ἀστεμφὲς ἔχεσκεν ἀΐδρεϊ φωτὶ ἐοικώς·	- --u u-u u-uu -u u--	dactylic hexameter	feminine penthemimeral
φαίης κε ζάκοτόν τέ τιν’ ἔμμεναι ἄφρονά τ’αὔτως.	-- - uu- u u -uu -uu --	dactylic hexameter	masculine penthemimeral, trithemimeral
Ἀλλ’ ὅτε δὴ ὄπα τε μεγάλην ἐκ στήθεος εἵη	- uu - uu - uu- - -uu --	dactylic hexameter	masculine penthemimeral, hepthemimeral, trithemimeral
καὶ ἔπεα νιφάδεσσιν ἐοικότα χειμερίῃσιν,	- uu- uu-u u-uu -uu--	dactylic hexameter	feminine penthemimeral, trithemimeral
οὐκ ἂν ἔπειτ’ Ὀδυσῆΐ γ’ ἐρίσσειε βροτὸς ἄλλος·	- u u- uu-u u--- uu --	dactylic hexameter	feminine penthemimeral, trithemimeral
οὐ τότε γ’ὧδ’ Ὀδυσῆος ἀγασσάμεθ’ εἶδος ἰδόντες.	- uu - uu-u u-uu -u u--	dactylic hexameter	feminine penthemimeral, trithemimeral
Τὸ τρίτον αὖτ’ Αἴαντα ἰδὼν ἐρέειν’ ὃ γεραιός·	- uu - --u u- uu- u u--	dactylic hexameter	feminine penthemimeral, hepthemimeral, trithemimeral
τίς τὰρ ὅδ’ ἄλλος Ἀχαιὸς ἀνὴρ ἠΰς τε μέγας τε	- u u -u u-u u- -- u u- -	dactylic hexameter	feminine penthemimeral, hepthemimeral
ἔξοχος Ἀργείων κεφαλήν τε καὶ εὐρέας ὤμους;	-uu --- uu- u u -uu --	dactylic hexameter	masculine penthemimeral, hepthemimeral
τὸν δ’Ἑλένη τανύπεπλος ἀμείβετο δῖα γυναικῶν·	- uu- uu-u u-uu -u u--	dactylic hexameter	feminine penthemimeral, trithemimeral
οὗτος δ’Αἴας ἐστὶ πελώριος ἕρκος Ἀχαιῶν·	-- -- -u u-uu -u u--	dactylic hexameter	feminine penthemimeral
Ἰδομενεὺς δ’ἑτέρωθεν ἐνὶ Κρήτεσσι θεὸς ὣς	-uu- uu-u u- --u u- -	dactylic hexameter	feminine penthemimeral, hepthemimeral, trithemimeral
ἕστηκ’, ἀμφὶ δέ μιν Κρητῶν ἀγοὶ ἠγερέθονται.	-- -u u - -- uu -uu--	dactylic hexameter	masculine penthemimeral, hepthemimeral
Πολλάκι μιν ξείνισσεν ἀρηΐφιλος Μενέλαος	-uu - --u u-uu- uu--	dactylic hexameter	feminine penthemimeral, trithemimeral
οἴκῳ ἐν ἡμετέρῳ ὁπότε Κρήτηθεν ἵκοιτο.	-u u -uu- uu- --u u--	dactylic hexameter	masculine penthemimeral, hepthemimeral
Νῦν δ’ἄλλους μὲν πάντας ὁρῶ ἑλίκωπας Ἀχαιούς,	- -- - -u u- uu-u u--	dactylic hexameter	feminine penthemimeral, hepthemimeral, trithemimeral
οὕς κεν ἐῢ γνοίην καί τ’οὔνομα μυθησαίμην·	- u u- -- - -uu ----	dactylic hexameter	masculine penthemimeral, trithemimeral
δοιὼ δ’οὐ δύναμαι ἰδέειν κοσμήτορε λαῶν	-- - uu- uu- --uu --	dactylic hexameter	masculine penthemimeral, hepthemimeral, trithemimeral
Κάστορά θ’ἱππόδαμον καὶ πὺξ ἀγαθὸν Πολυδεύκεα	-uu -uu- - - uu- uu--	dactylic hexameter	masculine penthemimeral, hepthemimeral
αὐτοκασιγνήτω, τώ μοι μία γείνατο μήτηρ.	-uu--- - - uu -uu --	dactylic hexameter	masculine penthemimeral, hepthemimeral
Ἢ οὐχ ἑσπέσθην Λακεδαίμονος ἐξ ἐρατεινῆς,	- - --- uu-uu - uu--	dactylic hexameter	masculine penthemimeral
ἢ δεύρω μὲν ἕποντο νέεσσ’ ἔνι ποντοπόροισι,	- -- u u-u u- uu -uu--	dactylic hexameter	feminine penthemimeral, hepthemimeral, trithemimeral
νῦν αὖτ’ οὐκ ἐθέλουσι μάχην καταδύμεναι ἀνδρῶν	- - - uu-u u- uu-uu --	dactylic hexameter	feminine penthemimeral, hepthemimeral, trithemimeral
αἴσχεα δειδιότες καὶ ὀνείδεα πόλλ’ ἅ μοί ἐστιν.	-uu -uu- u u-uu - u u --	dactylic hexameter	masculine penthemimeral
Ὣς φάτο, τοὺς δ’ἤδη κάτεχεν φυσίζοος αἶα	- uu - -- uu- --uu --	dactylic hexameter	masculine penthemimeral, hepthemimeral, trithemimeral
ἐν Λακεδαίμονι αὖθι φίλῃ ἐν πατρίδι γαίῃ.	- uu-uu -u u- - -uu --	dactylic hexameter	feminine penthemimeral, hepthemimeral
Κήρυκες δ’ἀνὰ ἄστυ θεῶν φέρον ὅρκια πιστὰ	--- uu -u u- uu -uu --	dactylic hexameter	feminine penthemimeral, hepthemimeral, trithemimeral
ἄρνε δύω καὶ οἶνον ἐΰφρονα καρπὸν ἀρούρης	-u u- - -u u-uu -u u--	dactylic hexameter	feminine penthemimeral, trithemimeral
ἀσκῷ ἐν αἰγείῳ· φέρε δὲ κρητῆρα φαεινὸν	-u u --- uu - --u u--	dactylic hexameter	masculine penthemimeral, hepthemimeral
κῆρυξ Ἰδαῖος ἠδὲ χρύσεια κύπελλα·	-- --- -- --u u--	dactylic hexameter	masculine penthemimeral, hepthemimeral
ὄτρυνεν δὲ γέροντα παριστάμενος ἐπέεσσιν·	--- u u-u u-uu- uu--	dactylic hexameter	feminine penthemimeral, trithemimeral
ὄρσεο Λαομεδοντιάδη, καλέουσιν ἄριστοι	-uu -uu-uu- uu-u u--	dactylic hexameter	hepthemimeral
Τρώων θ’ἱπποδάμων καὶ Ἀχαιῶν χαλκοχιτώνων	-- -uu- u u-- -uu--	dactylic hexameter	masculine penthemimeral
ἐς πεδίον καταβῆναι ἵν’ ὅρκια πιστὰ τάμητε·	- uu- uu-u u -uu -u u--	dactylic hexameter	feminine penthemimeral, trithemimeral
αὐτὰρ Ἀλέξανδρος καὶ ἀρηΐφιλος Μενέλαος	-u u--- u u-uu- uu--	dactylic hexameter	masculine penthemimeral
μακρῇς ἐγχείῃσι μαχήσοντ’ ἀμφὶ γυναικί·	-- ---u u-- -u u--	dactylic hexameter	feminine penthemimeral
τῷ δέ κε νικήσαντι γυνὴ καὶ κτήμαθ’ ἕποιτο·	- u u ---u u- - -u u--	dactylic hexameter	feminine penthemimeral, hepthemimeral
οἳ δ’ἄλλοι φιλότητα καὶ ὅρκια πιστὰ ταμόντες	- -- uu-u u -uu -u u--	dactylic hexameter	feminine penthemimeral, trithemimeral
ναίοιμεν Τροίην ἐριβώλακα, τοὶ δὲ νέονται	--- -- uu-uu - u u--	dactylic hexameter	masculine penthemimeral, trithemimeral
Ἄργος ἐς ἱππόβοτον καὶ Ἀχαιΐδα καλλιγύναικα.	-u u -uu- u u-uu -uu--	dactylic hexameter	masculine penthemimeral
Ὣς φάτο ῥίγησεν δ’ὃ γέρων, ἐκέλευσε δ’ἑταίρους	- uu --- u u- uu-u u--	dactylic hexameter	masculine penthemimeral, hepthemimeral
ἵππους ζευγνύμεναι· τοὶ δ’ὀτραλέως ἐπίθοντο.	-- -uu- - -uu- uu--	dactylic hexameter	masculine penthemimeral
Ἂν δ’ἄρ’ ἔβη Πρίαμος, κατὰ δ’ἡνία τεῖνεν ὀπίσσω·	- u u- uu- uu -uu -u u--	dactylic hexameter	masculine penthemimeral, trithemimeral
πὰρ δέ οἱ Ἀντήνωρ περικαλλέα βήσετο δίφρον·	- u u --- uu-uu -uu --	dactylic hexameter	masculine penthemimeral
τὼ δὲ διὰ Σκαιῶν πεδίον δ’ἔχον ὠκέας ἵππους.	- u u- -- uu- uu -uu --	dactylic hexameter	masculine penthemimeral, hepthemimeral, trithemimeral
Ἀλλ’ ὅτε δή ῥ’ἵκοντο μετὰ Τρῶας καὶ Ἀχαιούς,	- uu - --u u- -- u u--	dactylic hexameter	feminine penthemimeral, hepthemimeral, trithemimeral
ἐξ ἵππων ἀποβάντες ἐπὶ χθόνα πουλυβότειραν	- -- uu-u u- uu -uu--	dactylic hexameter	feminine penthemimeral, hepthemimeral, trithemimeral
ἐς μέσσον Τρώων καὶ Ἀχαιῶν ἐστιχόωντο.	- -- -- u u-- -uu--	dactylic hexameter	masculine penthemimeral, trithemimeral
Ὄρνυτο δ’αὐτίκ’ ἔπειτα ἄναξ ἀνδρῶν Ἀγαμέμνων,	-uu -u u-u u- -- uu--	dactylic hexameter	feminine penthemimeral, hepthemimeral
ἂν δ’Ὀδυσεὺς πολύμητις· ἀτὰρ κήρυκες ἀγαυοὶ	- uu- uu-u u- --u u--	dactylic hexameter	feminine penthemimeral, hepthemimeral, trithemimeral
ὅρκια πιστὰ θεῶν σύναγον, κρητῆρι δὲ οἶνον	-uu -u u- uu- --u u --	dactylic hexameter	masculine penthemimeral, hepthemimeral
μίσγον, ἀτὰρ βασιλεῦσιν ὕδωρ ἐπὶ χεῖρας ἔχευαν.	-u u- uu-u u- uu -u u--	dactylic hexameter	feminine penthemimeral, hepthemimeral, trithemimeral
Ἀτρεΐδης δὲ ἐρυσσάμενος χείρεσσι μάχαιραν,	-uu- u u-uu- --u u--	dactylic hexameter	hepthemimeral, trithemimeral
ἥ οἱ πὰρ ξίφεος μέγα κουλεόν αἰὲν ἄωρτο,	- - - uu- uu -uu -u u--	dactylic hexameter	masculine penthemimeral, trithemimeral
ἀρνῶν ἐκ κεφαλέων τάμνε τρίχας· αὐτὰρ ἔπειτα	-- - uu- -- uu -u u--	dactylic hexameter	masculine penthemimeral, hepthemimeral, trithemimeral
κήρυκες Τρώων καὶ Ἀχαιῶν νεῖμαν ἀρίστοις.	--- -- u u-- -u u--	dactylic hexameter	masculine penthemimeral, trithemimeral
Τοῖσιν δ’Ἀτρεΐδης μεγάλ’ εὔχετο χεῖρας ἀνασχών·	-- -uu- uu -uu -u u--	dactylic hexameter	masculine penthemimeral
Ζεῦ πάτερ Ἴδηθεν μεδέων κύδιστε μέγιστε,	- uu --- uu- --u u--	dactylic hexameter	masculine penthemimeral, hepthemimeral
Ἠέλιός θ’,ὃς πάντ’ ἐφορᾷς καὶ πάντ’ ἐπακούεις,	-uu- - - uu- - - uu--	dactylic hexameter	masculine penthemimeral, hepthemimeral, trithemimeral
καὶ ποταμοὶ καὶ γαῖα, καὶ οἳ ὑπένερθε καμόντας	- uu- - -u u - uu-u u--	dactylic hexameter	feminine penthemimeral, hepthemimeral, trithemimeral
ἀνθρώπους τίνυσθον ὅτις κ’ἐπίορκον ὀμόσσῃ,	--- --u u- uu-u u--	dactylic hexameter	feminine penthemimeral, hepthemimeral, trithemimeral
ὑμεῖς μάρτυροι ἔστε, φυλάσσετε δ’ὅρκια πιστά·	-- -uu -u u-uu -uu --	dactylic hexameter	feminine penthemimeral
εἰ μέν κεν Μενέλαον Ἀλέξανδρος καταπέφνῃ	- - - uu-u u--- uu--	dactylic hexameter	feminine penthemimeral, trithemimeral
αὐτὸς ἔπειθ’ Ἑλένην ἐχέτω καὶ κτήματα πάντα,	-u u- uu- uu- - -uu --	dactylic hexameter	masculine penthemimeral, hepthemimeral, trithemimeral
ἡμεῖς δ’ἐν νήεσσι νεώμεθα ποντοπόροισιν·	-- - --u u-uu -uu--	dactylic hexameter	feminine penthemimeral, trithemimeral
εἰ δέ κ’Ἀλέξανδρον κτείνῃ ξανθὸς Μενέλαος,	- u u--- -- -- uu--	dactylic hexameter	masculine penthemimeral, hepthemimeral
Τρῶας ἔπειθ’ Ἑλένην καὶ κτήματα πάντ’ ἀποδοῦναι,	-u u- uu- - -uu - uu--	dactylic hexameter	masculine penthemimeral, trithemimeral
τιμὴν δ’Ἀργείοις ἀποτινέμεν ἥν τιν’ ἔοικεν,	-- --- uu-uu - u u--	dactylic hexameter	masculine penthemimeral
ἥ τε καὶ ἐσσομένοισι μετ’ ἀνθρώποισι πέληται.	- u u -uu-u u ---u u--	dactylic hexameter	feminine penthemimeral
Εἰ δ’ἂν ἐμοὶ τιμὴν Πρίαμος Πριάμοιό τε παῖδες	- u u- -- uu- uu-u u --	dactylic hexameter	masculine penthemimeral, hepthemimeral, trithemimeral
τίνειν οὐκ ἐθέλωσιν Ἀλεξάνδροιο πεσόντος,	-- - uu-u u---u u--	dactylic hexameter	feminine penthemimeral, trithemimeral
αὐτὰρ ἐγὼ καὶ ἔπειτα μαχήσομαι εἵνεκα ποινῆς	-u u- u u-u u-uu -uu --	dactylic hexameter	feminine penthemimeral, trithemimeral
αὖθι μένων, ἧός κε τέλος πολέμοιο κιχείω.	-u u- -- u u- uu-u u--	dactylic hexameter	masculine penthemimeral, hepthemimeral, trithemimeral
Ἦ, καὶ ἀπὸ στομάχους ἀρνῶν τάμε νηλέϊ χαλκῷ·	- u u- uu- -- uu -uu --	dactylic hexameter	masculine penthemimeral, hepthemimeral, trithemimeral
καὶ τοὺς μὲν κατέθηκεν ἐπὶ χθονὸς ἀσπαίροντας	- - - uu-u u- uu ----	dactylic hexameter	feminine penthemimeral, hepthemimeral, trithemimeral
θυμοῦ δευομένους· ἀπὸ γὰρ μένος εἵλετο χαλκός.	-- -uu- uu - uu -uu --	dactylic hexameter	masculine penthemimeral, hepthemimeral
Οἶνον δ’ἐκ κρητῆρος ἀφυσσόμενοι δεπάεσσιν	-- - --u u-uu- uu--	dactylic hexameter	feminine penthemimeral, trithemimeral
ἔκχεον, ἠδ’ εὔχοντο θεοῖς αἰειγενέτῃσιν.	-uu - --u u- --uu--	dactylic hexameter	feminine penthemimeral, hepthemimeral, trithemimeral
Ὧδε δέ τις εἴπεσκεν Ἀχαιῶν τε Τρώων τε·	-u u - --u u-- - -- -	dactylic hexameter	feminine penthemimeral, trithemimeral
Ζεῦ κύδιστε μέγιστε καὶ ἀθάνατοι θεοὶ ἄλλοι	- --u u-u u -uu- uu --	dactylic hexameter	feminine penthemimeral
ὁππότεροι πρότεροι ὑπὲρ ὅρκια πημήνειαν	-uu- uu- uu -uu ----	dactylic hexameter	masculine penthemimeral, trithemimeral
ὧδέ σφ’ἐγκέφαλος χαμάδις ῥέοι ὡς ὅδε οἶνος	-- -uu- uu- uu - uu --	dactylic hexameter	masculine penthemimeral, hepthemimeral
αὐτῶν καὶ τεκέων, ἄλοχοι δ’ἄλλοισι δαμεῖεν.	-- - uu- uu- --u u--	dactylic hexameter	masculine penthemimeral, hepthemimeral, trithemimeral
Ὣς ἔφαν, οὐδ’ ἄρα πώ σφιν ἐπεκραίαινε Κρονίων.	- uu - uu - u u---u u--	dactylic hexameter	masculine penthemimeral, trithemimeral
Τοῖσι δὲ Δαρδανίδης Πρίαμος μετὰ μῦθον ἔειπε·	-u u -uu- uu- uu -u u--	dactylic hexameter	masculine penthemimeral, hepthemimeral
κέκλυτέ μευ Τρῶες καὶ ἐϋκνήμιδες Ἀχαιοί·	-uu - -- u u---u u--	dactylic hexameter	masculine penthemimeral, trithemimeral
ἤτοι ἐγὼν εἶμι προτὶ Ἴλιον ἠνεμόεσσαν	-u u- -- uu -uu -uu--	dactylic hexameter	masculine penthemimeral, trithemimeral
ἄψ, ἐπεὶ οὔ πω τλήσομ’ ἐν ὀφθαλμοῖσιν ὁρᾶσθαι	- uu - - -u u ---u u--	dactylic hexameter	feminine penthemimeral, trithemimeral
μαρνάμενον φίλον υἱὸν ἀρηϊφίλῳ Μενελάῳ·	-uu- uu -u u-uu- uu--	dactylic hexameter	feminine penthemimeral, trithemimeral
Ζεὺς μέν που τό γε οἶδε καὶ ἀθάνατοι θεοὶ ἄλλοι	- - - u u -u u -uu- uu --	dactylic hexameter	feminine penthemimeral, trithemimeral
ὁπποτέρῳ θανάτοιο τέλος πεπρωμένον ἐστίν.	-uu- uu-u u- --uu --	dactylic hexameter	feminine penthemimeral, hepthemimeral, trithemimeral
Ἦ ῥα καὶ ἐς δίφρον ἄρνας θέτο ἰσόθεος φώς,	- u u - -- -- uu -uu- -	dactylic hexameter	masculine penthemimeral, hepthemimeral, trithemimeral
ἂν δ’ἄρ’ ἔβαιν’ αὐτός, κατὰ δ’ἡνία τεῖνεν ὀπίσσω·	- u u- -- uu -uu -u u--	dactylic hexameter	masculine penthemimeral, trithemimeral
πὰρ δέ οἱ Ἀντήνωρ περικαλλέα βήσετο δίφρον.	- u u --- uu-uu -uu --	dactylic hexameter	masculine penthemimeral
Τὼ μὲν ἄρ’ ἄψορροι προτὶ Ἴλιον ἀπονέοντο·	- u u --- uu -uu -uu--	dactylic hexameter	masculine penthemimeral
Ἕκτωρ δὲ Πριάμοιο πάϊς καὶ δῖος Ὀδυσσεὺς	-- - uu-u u- - -u u--	dactylic hexameter	feminine penthemimeral, hepthemimeral, trithemimeral
χῶρον μὲν πρῶτον διεμέτρεον, αὐτὰρ ἔπειτα	-- - -- uu-uu -u u--	dactylic hexameter	masculine penthemimeral, trithemimeral
κλήρους ἐν κυνέῃ χαλκήρεϊ πάλλον ἑλόντες,	-- - uu- --uu -u u--	dactylic hexameter	masculine penthemimeral, trithemimeral
ὁππότερος δὴ πρόσθεν ἀφείη χάλκεον ἔγχος.	-uu- - -u u-- -uu --	dactylic hexameter	feminine penthemimeral, trithemimeral
Λαοὶ δ’ἠρήσαντο, θεοῖσι δὲ χεῖρας ἀνέσχον,	-- ---u u-u u -u u--	dactylic hexameter	feminine penthemimeral
ὧδε δέ τις εἴπεσκεν Ἀχαιῶν τε Τρώων τε·	-u u - --u u-- - -- -	dactylic hexameter	feminine penthemimeral, trithemimeral
Ζεῦ πάτερ Ἴδηθεν μεδέων κύδιστε μέγιστε	- uu --- uu- --u u--	dactylic hexameter	masculine penthemimeral, hepthemimeral
ὁππότερος τάδε ἔργα μετ’ ἀμφοτέροισιν ἔθηκε,	-uu- uu -u u -uu-u u--	dactylic hexameter	feminine penthemimeral, trithemimeral
τὸν δὸς ἀποφθίμενον δῦναι δόμον Ἄϊδος εἴσω,	- u u-uu- -- uu -uu --	dactylic hexameter	masculine penthemimeral, hepthemimeral
ἡμῖν δ’αὖ φιλότητα καὶ ὅρκια πιστὰ γενέσθαι.	-- - uu-u u -uu -u u--	dactylic hexameter	feminine penthemimeral, trithemimeral
Ὣς ἄρ’ ἔφαν, πάλλεν δὲ μέγας κορυθαίολος Ἕκτωρ	- u u- -- u u- uu-uu --	dactylic hexameter	masculine penthemimeral, hepthemimeral, trithemimeral
ἂψ ὁρόων· Πάριος δὲ θοῶς ἐκ κλῆρος ὄρουσεν.	- uu- uu- u u- - -u u--	dactylic hexameter	masculine penthemimeral, hepthemimeral, trithemimeral
Οἳ μὲν ἔπειθ’ ἵζοντο κατὰ στίχας, ἧχι ἑκάστῳ	- u u- --u u- uu -u u--	dactylic hexameter	feminine penthemimeral, hepthemimeral, trithemimeral
ἵπποι ἀερσίποδες καὶ ποικίλα τεύχε’ ἔκειτο·	-u u-uu- - -uu -u u--	dactylic hexameter	masculine penthemimeral
αὐτὰρ ὅ γ’ἀμφ’ ὤμοισιν ἐδύσετο τεύχεα καλὰ	-u u - --u u-uu -uu --	dactylic hexameter	feminine penthemimeral, trithemimeral
δῖος Ἀλέξανδρος Ἑλένης πόσις ἠϋκόμοιο.	-u u--- uu- uu -uu--	dactylic hexameter	masculine penthemimeral, hepthemimeral
Κνημῖδας μὲν πρῶτα περὶ κνήμῃσιν ἔθηκε	--- - -u u- --u u--	dactylic hexameter	feminine penthemimeral, hepthemimeral, trithemimeral
καλάς, ἀργυρέοισιν ἐπισφυρίοις ἀραρυίας·	-- -uu-u u-uu- uu--	dactylic hexameter	feminine penthemimeral
δεύτερον αὖ θώρηκα περὶ στήθεσσιν ἔδυνεν	-uu - --u u- --u u--	dactylic hexameter	feminine penthemimeral, hepthemimeral, trithemimeral
οἷο κασιγνήτοιο Λυκάονος· ἥρμοσε δ’αὐτῷ.	-u u---u u-uu -uu --	dactylic hexameter	feminine penthemimeral
Ἀμφὶ δ’ἄρ’ ὤμοισιν βάλετο ξίφος ἀργυρόηλον	-u u --- uu- uu -uu--	dactylic hexameter	masculine penthemimeral, hepthemimeral
χάλκεον, αὐτὰρ ἔπειτα σάκος μέγα τε στιβαρόν τε·	-uu -u u-u u- uu - uu- -	dactylic hexameter	feminine penthemimeral, hepthemimeral
κρατὶ δ’ἐπ’ ἰφθίμῳ κυνέην εὔτυκτον ἔθηκεν	-u u --- uu- --u u--	dactylic hexameter	masculine penthemimeral, hepthemimeral
ἵππουριν· δεινὸν δὲ λόφος καθύπερθεν ἔνευεν·	--- -- u u- uu-u u--	dactylic hexameter	masculine penthemimeral, hepthemimeral, trithemimeral
εἵλετο δ’ἄλκιμον ἔγχος, ὅ οἱ παλάμηφιν ἀρήρει.	-uu -uu -u u - uu-u u--	dactylic hexameter	feminine penthemimeral, hepthemimeral
Ὣς δ’αὔτως Μενέλαος ἀρήϊος ἔντε’ ἔδυνεν.	- -- uu-u u-uu -u u--	dactylic hexameter	feminine penthemimeral, trithemimeral
Οἳ δ’ἐπεὶ οὖν ἑκάτερθεν ὁμίλου θωρήχθησαν,	- uu - uu-u u-- ----	dactylic hexameter	feminine penthemimeral, trithemimeral
ἐς μέσσον Τρώων καὶ Ἀχαιῶν ἐστιχόωντο	- -- -- u u-- -uu--	dactylic hexameter	masculine penthemimeral, trithemimeral
δεινὸν δερκόμενοι· θάμβος δ’ἔχεν εἰσορόωντας	-- -uu- -- uu -uu--	dactylic hexameter	masculine penthemimeral, hepthemimeral
Τρῶάς θ’ἱπποδάμους καὶ ἐϋκνήμιδας Ἀχαιούς.	-- -uu- u u---u u--	dactylic hexameter	masculine penthemimeral
Καί ῥ’ἐγγὺς στήτην διαμετρητῷ ἐνὶ χώρῳ	- -- -- uu--- uu --	dactylic hexameter	masculine penthemimeral, trithemimeral
σείοντ’ ἐγχείας ἀλλήλοισιν κοτέοντε.	-- --- ---- uu--	dactylic hexameter	masculine penthemimeral
Πρόσθε δ’Ἀλέξανδρος προΐει δολιχόσκιον ἔγχος,	-u u--- uu- uu-uu --	dactylic hexameter	masculine penthemimeral, hepthemimeral
καὶ βάλεν Ἀτρεΐδαο κατ’ ἀσπίδα πάντοσε ἴσην,	- uu -uu-u u -uu -uu --	dactylic hexameter	feminine penthemimeral
οὐδ’ ἔρρηξεν χαλκός, ἀνεγνάμφθη δέ οἱ αἰχμὴ	- --- -u u--- u u --	dactylic hexameter	feminine penthemimeral
ἀσπίδ’ ἐνὶ κρατερῇ· ὃ δὲ δεύτερον ὄρνυτο χαλκῷ	-u u- uu- u u -uu -uu --	dactylic hexameter	masculine penthemimeral, trithemimeral
Ἀτρεΐδης Μενέλαος ἐπευξάμενος Διὶ πατρί·	-uu- uu-u u-uu- uu --	dactylic hexameter	feminine penthemimeral, trithemimeral
Ζεῦ ἄνα δὸς τίσασθαι ὅ με πρότερος κάκ’ ἔοργε	- uu - --u u - uu- u u--	dactylic hexameter	feminine penthemimeral, hepthemimeral, trithemimeral
δῖον Ἀλέξανδρον, καὶ ἐμῇς ὑπὸ χερσὶ δάμασσον,	-u u--- u u- uu -u u--	dactylic hexameter	masculine penthemimeral, hepthemimeral
ὄφρα τις ἐρρίγῃσι καὶ ὀψιγόνων ἀνθρώπων	-u u ---u u -uu- ---	dactylic hexameter	feminine penthemimeral
ξεινοδόκον κακὰ ῥέξαι, ὅ κεν φιλότητα παράσχῃ.	-uu- uu -u u - uu-u u--	dactylic hexameter	feminine penthemimeral, hepthemimeral, trithemimeral
Ἦ ῥα καὶ ἀμπεπαλὼν προΐει δολιχόσκιον ἔγχος,	- u u -uu- uu- uu-uu --	dactylic hexameter	masculine penthemimeral, hepthemimeral
καὶ βάλε Πριαμίδαο κατ’ ἀσπίδα πάντοσε ἴσην·	- uu -uu-u u -uu -uu --	dactylic hexameter	feminine penthemimeral
διὰ μὲν ἀσπίδος ἦλθε φαεινῆς ὄβριμον ἔγχος,	-u u -uu -u u-- -uu --	dactylic hexameter	feminine penthemimeral
καὶ διὰ θώρηκος πολυδαιδάλου ἠρήρειστο·	- uu --- uu-uu ----	dactylic hexameter	masculine penthemimeral
ἀντικρὺ δὲ παραὶ λαπάρην διάμησε χιτῶνα	--- u u- uu- uu-u u--	dactylic hexameter	masculine penthemimeral, hepthemimeral, trithemimeral
ἔγχος· ὃ δ’ἐκλίνθη καὶ ἀλεύατο κῆρα μέλαιναν.	-u u --- u u-uu -u u--	dactylic hexameter	masculine penthemimeral
Ἀτρεΐδης δὲ ἐρυσσάμενος ξίφος ἀργυρόηλον	-uu- u u-uu- uu -uu--	dactylic hexameter	hepthemimeral, trithemimeral
πλῆξεν ἀνασχόμενος κόρυθος φάλον· ἀμφὶ δ’ἄρ’ αὐτῷ	-u u-uu- uu- uu -u u --	dactylic hexameter	masculine penthemimeral, hepthemimeral
τριχθά τε καὶ τετραχθὰ διατρυφὲν ἔκπεσε χειρός.	-u u - --u u-uu -uu --	dactylic hexameter	feminine penthemimeral, trithemimeral
Ἀτρεΐδης δ’ᾤμωξεν ἰδὼν εἰς οὐρανὸν εὐρύν·	-uu- --u u- - -uu --	dactylic hexameter	feminine penthemimeral, hepthemimeral, trithemimeral
Ζεῦ πάτερ οὔ τις σεῖο θεῶν ὀλοώτερος ἄλλος·	- uu - - -u u- uu-uu --	dactylic hexameter	feminine penthemimeral, hepthemimeral, trithemimeral
ἦ τ’ἐφάμην τίσασθαι Ἀλέξανδρον κακότητος·	- uu- --u u--- uu--	dactylic hexameter	feminine penthemimeral, trithemimeral
νῦν δέ μοι ἐν χείρεσσιν ἄγη ξίφος, ἐκ δέ μοι ἔγχος	- u u - --u u- uu - u u --	dactylic hexameter	feminine penthemimeral, hepthemimeral, trithemimeral
ἠΐχθη παλάμηφιν ἐτώσιον, οὐδ’ ἔβαλόν μιν.	--- uu-u u-uu - uu- -	dactylic hexameter	feminine penthemimeral, trithemimeral
Ἦ καὶ ἐπαΐξας κόρυθος λάβεν ἱπποδασείης,	- u u--- uu- uu -uu--	dactylic hexameter	masculine penthemimeral, hepthemimeral
ἕλκε δ’ἐπιστρέψας μετ’ ἐϋκνήμιδας Ἀχαιούς·	-u u--- u u---u u--	dactylic hexameter	masculine penthemimeral
ἄγχε δέ μιν πολύκεστος ἱμὰς ἁπαλὴν ὑπὸ δειρήν,	-u u - uu-u u- uu- uu --	dactylic hexameter	feminine penthemimeral, hepthemimeral, trithemimeral
ὅς οἱ ὑπ’ ἀνθερεῶνος ὀχεὺς τέτατο τρυφαλείης.	- u u -uu-u u- uu- uu--	dactylic hexameter	feminine penthemimeral, hepthemimeral
Καί νύ κεν εἴρυσσέν τε καὶ ἄσπετον ἤρατο κῦδος,	- u u --- u u -uu -uu --	dactylic hexameter	masculine penthemimeral
εἰ μὴ ἄρ’ ὀξὺ νόησε Διὸς θυγάτηρ Ἀφροδίτη,	- u u -u u-u u- uu- uu--	dactylic hexameter	feminine penthemimeral, hepthemimeral
ἥ οἱ ῥῆξεν ἱμάντα βοὸς ἶφι κταμένοιο·	- - -u u-u u- -- uu--	dactylic hexameter	feminine penthemimeral, hepthemimeral
κεινὴ δὲ τρυφάλεια ἅμ’ ἕσπετο χειρὶ παχείῃ.	-- - uu-u u -uu -u u--	dactylic hexameter	feminine penthemimeral, trithemimeral
Τὴν μὲν ἔπειθ’ ἥρως μετ’ ἐϋκνήμιδας Ἀχαιοὺς	- u u- -- u u---u u--	dactylic hexameter	masculine penthemimeral, trithemimeral
ῥῖψ’ ἐπιδινήσας, κόμισαν δ’ἐρίηρες ἑταῖροι·	- uu--- uu- uu-u u--	dactylic hexameter	masculine penthemimeral, hepthemimeral
αὐτὰρ ὃ ἂψ ἐπόρουσε κατακτάμεναι μενεαίνων	-u u - uu-u u-uu- uu--	dactylic hexameter	feminine penthemimeral, trithemimeral
ἔγχεϊ χαλκείῳ· τὸν δ’ἐξήρπαξ’ Ἀφροδίτη	-uu --- - --- uu--	dactylic hexameter	masculine penthemimeral
ῥεῖα μάλ’ ὥς τε θεός, ἐκάλυψε δ’ἄρ’ ἠέρι πολλῇ,	-u u - u u- uu-u u -uu --	dactylic hexameter	masculine penthemimeral, trithemimeral
κὰδ δ’εἷσ’ ἐν θαλάμῳ εὐώδεϊ κηώεντι.	- - - uu- --uu ----	dactylic hexameter	masculine penthemimeral, trithemimeral
Αὐτὴ δ’αὖ Ἑλένην καλέουσ’ ἴε· τὴν δὲ κίχανε	-- - uu- uu- uu - u u--	dactylic hexameter	masculine penthemimeral, hepthemimeral, trithemimeral
πύργῳ ἐφ’ ὑψηλῷ, περὶ δὲ Τρῳαὶ ἅλις ἦσαν·	-u u --- uu - -- uu --	dactylic hexameter	masculine penthemimeral, hepthemimeral
χειρὶ δὲ νεκταρέου ἑανοῦ ἐτίναξε λαβοῦσα,	-u u -uu- uu- uu-u u--	dactylic hexameter	masculine penthemimeral, hepthemimeral
γρηῒ δέ μιν ἐϊκυῖα παλαιγενέϊ προσέειπεν	-u u - uu-u u-uu- uu--	dactylic hexameter	feminine penthemimeral, trithemimeral
εἰροκόμῳ, ἥ οἱ Λακεδαίμονι ναιετοώσῃ	-uu- - - uu-uu -uu--	dactylic hexameter	masculine penthemimeral, trithemimeral
ἤσκειν εἴρια καλά, μάλιστα δέ μιν φιλέεσκε·	-- -uu -u u-u u - uu--	dactylic hexameter	feminine penthemimeral
τῇ μιν ἐεισαμένη προσεφώνεε δῖ’ Ἀφροδίτη·	- u u-uu- uu-uu - uu--	dactylic hexameter	masculine penthemimeral
δεῦρ’ ἴθ’· Ἀλέξανδρός σε καλεῖ οἶκον δὲ νέεσθαι.	- u u--- u u- -- u u--	dactylic hexameter	masculine penthemimeral, hepthemimeral
Κεῖνος ὅ γ’ἐν θαλάμῳ καὶ δινωτοῖσι λέχεσσι	-u u - uu- - ---u u--	dactylic hexameter	masculine penthemimeral, trithemimeral
κάλλεΐ τε στίλβων καὶ εἵμασιν· οὐδέ κε φαίης	-uu - -- - -uu -u u --	dactylic hexameter	masculine penthemimeral, trithemimeral
ἀνδρὶ μαχεσσάμενον τόν γ’ἐλθεῖν, ἀλλὰ χορὸν δὲ	-u u-uu- - -- -u u- -	dactylic hexameter	masculine penthemimeral
ἔρχεσθ’, ἠὲ χοροῖο νέον λήγοντα καθίζειν.	-- -u u-u u- --u u--	dactylic hexameter	feminine penthemimeral, hepthemimeral
Ὣς φάτο, τῇ δ’ἄρα θυμὸν ἐνὶ στήθεσσιν ὄρινε·	- uu - uu -u u- --u u--	dactylic hexameter	feminine penthemimeral, hepthemimeral, trithemimeral
καί ῥ’ὡς οὖν ἐνόησε θεᾶς περικαλλέα δειρὴν	- - - uu-u u- uu-uu --	dactylic hexameter	feminine penthemimeral, hepthemimeral, trithemimeral
στήθεά θ’ἱμερόεντα καὶ ὄμματα μαρμαίροντα,	-uu -uu-u u -uu ----	dactylic hexameter	feminine penthemimeral
θάμβησέν τ’ἄρ’ ἔπειτα ἔπος τ’ἔφατ’ ἔκ τ’ὀνόμαζε·	--- u u-u u- uu - uu--	dactylic hexameter	feminine penthemimeral, hepthemimeral, trithemimeral
δαιμονίη, τί με ταῦτα λιλαίεαι ἠπεροπεύειν;	-uu- u u -u u-uu -uu--	dactylic hexameter	feminine penthemimeral, trithemimeral
ἦ πῄ με προτέρω πολίων εὖ ναιομενάων	- - - uu- uu- - -uu--	dactylic hexameter	masculine penthemimeral, hepthemimeral, trithemimeral
ἄξεις, ἢ Φρυγίης ἢ Μῃονίης ἐρατεινῆς,	-- - uu- - -uu- uu--	dactylic hexameter	masculine penthemimeral, trithemimeral
εἴ τίς τοι καὶ κεῖθι φίλος μερόπων ἀνθρώπων·	- - - - -u u- uu- ---	dactylic hexameter	feminine penthemimeral, hepthemimeral, trithemimeral
οὕνεκα δὴ νῦν δῖον Ἀλέξανδρον Μενέλαος	-uu - - -u u--- uu--	dactylic hexameter	feminine penthemimeral, trithemimeral
νικήσας ἐθέλει στυγερὴν ἐμὲ οἴκαδ’ ἄγεσθαι,	--- uu- uu- uu -u u--	dactylic hexameter	masculine penthemimeral, hepthemimeral, trithemimeral
τοὔνεκα δὴ νῦν δεῦρο δολοφρονέουσα παρέστης;	-uu - - -u u-uu-u u--	dactylic hexameter	feminine penthemimeral, trithemimeral
ἧσο παρ’ αὐτὸν ἰοῦσα, θεῶν δ’ἀπόεικε κελεύθου,	-u u -u u-u u- uu-u u--	dactylic hexameter	feminine penthemimeral, hepthemimeral
μηδ’ ἔτι σοῖσι πόδεσσιν ὑποστρέψειας Ὄλυμπον,	- uu -u u-u u---u u--	dactylic hexameter	feminine penthemimeral
ἀλλ’ αἰεὶ περὶ κεῖνον ὀΐζυε καί ἑ φύλασσε,	- -- uu -u u-uu - u u--	dactylic hexameter	feminine penthemimeral, trithemimeral
εἰς ὅ κέ σ’ἢ ἄλοχον ποιήσεται ἢ ὅ γε δούλην.	- u u - uu- --uu - u u --	dactylic hexameter	masculine penthemimeral, trithemimeral
Κεῖσε δ’ἐγὼν οὐκ εἶμι· νεμεσσητὸν δέ κεν εἴη·	-u u- - -u u--- u u --	dactylic hexameter	feminine penthemimeral, trithemimeral
κείνου πορσανέουσα λέχος· Τρῳαὶ δέ μ’ὀπίσσω	-- -uu-u u- -- u u--	dactylic hexameter	feminine penthemimeral, hepthemimeral
πᾶσαι μωμήσονται· ἔχω δ’ἄχε’ ἄκριτα θυμῷ.	-- ---u u- uu -uu --	dactylic hexameter	feminine penthemimeral, hepthemimeral
Τὴν δὲ χολωσαμένη προσεφώνεε δῖ’ Ἀφροδίτη·	- u u-uu- uu-uu - uu--	dactylic hexameter	masculine penthemimeral
μή μ’ἔρεθε σχετλίη, μὴ χωσαμένη σε μεθείω,	- uu- uu- - -uu- u u--	dactylic hexameter	masculine penthemimeral, trithemimeral
τὼς δέ σ’ἀπεχθήρω ὡς νῦν ἔκπαγλ’ ἐφίλησα,	- u u--- - - -- uu--	dactylic hexameter	masculine penthemimeral, hepthemimeral
μέσσῳ δ’ἀμφοτέρων μητίσομαι ἔχθεα λυγρὰ	-- -uu- --uu -uu --	dactylic hexameter	masculine penthemimeral
Τρώων καὶ Δαναῶν, σὺ δέ κεν κακὸν οἶτον ὄληαι.	-- - uu- u u - uu -u u--	dactylic hexameter	masculine penthemimeral, hepthemimeral, trithemimeral
Ὣς ἔφατ’, ἔδεισεν δ’Ἑλένη Διὸς ἐκγεγαυῖα,	- uu --- uu- uu -uu--	dactylic hexameter	masculine penthemimeral, hepthemimeral
βῆ δὲ κατασχομένη ἑανῷ ἀργῆτι φαεινῷ	- u u-uu- uu- --u u--	dactylic hexameter	masculine penthemimeral, hepthemimeral
σιγῇ, πάσας δὲ Τρῳὰς λάθεν· ἦρχε δὲ δαίμων.	-- -- - -- uu -u u --	dactylic hexameter	masculine penthemimeral, hepthemimeral
Αἳ δ’ὅτ’ Ἀλεξάνδροιο δόμον περικαλλέ’ ἵκοντο,	- u u---u u- uu-u u--	dactylic hexameter	feminine penthemimeral, hepthemimeral
ἀμφίπολοι μὲν ἔπειτα θοῶς ἐπὶ ἔργα τράποντο,	-uu- u u-u u- uu -u u--	dactylic hexameter	feminine penthemimeral, hepthemimeral, trithemimeral
ἣ δ’εἰς ὑψόροφον θάλαμον κίε δῖα γυναικῶν.	- - -uu- uu- uu -u u--	dactylic hexameter	masculine penthemimeral, hepthemimeral
Τῇ δ’ἄρα δίφρον ἑλοῦσα φιλομειδὴς Ἀφροδίτη	- uu -u u-u u--- uu--	dactylic hexameter	feminine penthemimeral
ἀντί’ Ἀλεξάνδροιο θεὰ κατέθηκε φέρουσα·	-u u---u u- uu-u u--	dactylic hexameter	feminine penthemimeral, hepthemimeral
ἔνθα κάθιζ’ Ἑλένη κούρη Διὸς αἰγιόχοιο	-u u- uu- -- uu -uu--	dactylic hexameter	masculine penthemimeral, hepthemimeral, trithemimeral
ὄσσε πάλιν κλίνασα, πόσιν δ’ἠνίπαπε μύθῳ·	-u u- --u u- --uu --	dactylic hexameter	feminine penthemimeral, hepthemimeral, trithemimeral
ἤλυθες ἐκ πολέμου· ὡς ὤφελες αὐτόθ’ ὀλέσθαι	-uu - uu- - -uu -u u--	dactylic hexameter	masculine penthemimeral, trithemimeral
ἀνδρὶ δαμεὶς κρατερῷ, ὃς ἐμὸς πρότερος πόσις ἦεν.	-u u- uu- u u- uu- uu --	dactylic hexameter	masculine penthemimeral, hepthemimeral, trithemimeral
Ἦ μὲν δὴ πρίν γ’εὔχε’ ἀρηϊφίλου Μενελάου	- - - - -u u-uu- uu--	dactylic hexameter	feminine penthemimeral, trithemimeral
σῇ τε βίῃ καὶ χερσὶ καὶ ἔγχεϊ φέρτερος εἶναι·	- u u- - -u u -uu -uu --	dactylic hexameter	feminine penthemimeral, trithemimeral
ἀλλ’ ἴθι νῦν προκάλεσσαι ἀρηΐφιλον Μενέλαον	- uu - uu-u u-uu- uu--	dactylic hexameter	feminine penthemimeral, trithemimeral
ἐξαῦτις μαχέσασθαι ἐναντίον· ἀλλά σ’ἔγωγε	--- uu-u u-uu -u u--	dactylic hexameter	feminine penthemimeral, trithemimeral
παύεσθαι κέλομαι, μηδὲ ξανθῷ Μενελάῳ	--- uu- -- -- uu--	dactylic hexameter	masculine penthemimeral, hepthemimeral, trithemimeral
ἀντίβιον πόλεμον πολεμίζειν ἠδὲ μάχεσθαι	-uu- uu- uu-- -u u--	dactylic hexameter	masculine penthemimeral, trithemimeral
ἀφραδέως, μή πως τάχ’ ὑπ’ αὐτοῦ δουρὶ δαμήῃς.	-uu- - - u u -- -u u--	dactylic hexameter	masculine penthemimeral, trithemimeral
Τὴν δὲ Πάρις μύθοισιν ἀμειβόμενος προσέειπε·	- u u- --u u-uu- uu--	dactylic hexameter	feminine penthemimeral, trithemimeral
μή με γύναι χαλεποῖσιν ὀνείδεσι θυμὸν ἔνιπτε·	- u u- uu-u u-uu -u u--	dactylic hexameter	feminine penthemimeral, trithemimeral
νῦν μὲν γὰρ Μενέλαος ἐνίκησεν σὺν Ἀθήνῃ,	- - - uu-u u--- u u--	dactylic hexameter	feminine penthemimeral, trithemimeral
κεῖνον δ’αὖτις ἐγώ· πάρα γὰρ θεοί εἰσι καὶ ἡμῖν.	-- -u u- uu - uu -u u --	dactylic hexameter	masculine penthemimeral, hepthemimeral
Ἀλλ’ ἄγε δὴ φιλότητι τραπείομεν εὐνηθέντε·	- uu - uu-u u-uu ----	dactylic hexameter	feminine penthemimeral, trithemimeral
οὐ γάρ πώ ποτέ μ’ὧδέ γ’ ἔρως φρένας ἀμφεκάλυψεν,	- - - uu -u u- uu -uu--	dactylic hexameter	feminine penthemimeral, hepthemimeral, trithemimeral
οὐδ’ ὅτε σε πρῶτον Λακεδαίμονος ἐξ ἐρατεινῆς	- uu - -- uu-uu - uu--	dactylic hexameter	masculine penthemimeral, trithemimeral
ἔπλεον ἁρπάξας ἐν ποντοπόροισι νέεσσι,	-uu --- - -uu-u u--	dactylic hexameter	masculine penthemimeral
νήσῳ δ’ἐν Κραναῇ ἐμίγην φιλότητι καὶ εὐνῇ,	-- - uu- uu- uu-u u --	dactylic hexameter	masculine penthemimeral, hepthemimeral, trithemimeral
ὥς σεο νῦν ἔραμαι καί με γλυκὺς ἵμερος αἱρεῖ.	- uu - uu- - - uu -uu --	dactylic hexameter	masculine penthemimeral, hepthemimeral, trithemimeral
Ἦ ῥα, καὶ ἄρχε λέχος δὲ κιών· ἅμα δ’εἵπετ’ ἄκοιτις.	- u u -u u- u u- uu -u u--	dactylic hexameter	masculine penthemimeral, hepthemimeral
Τὼ μὲν ἄρ’ ἐν τρητοῖσι κατεύνασθεν λεχέεσσιν,	- u u - --u u--- uu--	dactylic hexameter	feminine penthemimeral, trithemimeral
Ἀτρεΐδης δ’ἀν’ ὅμιλον ἐφοίτα θηρὶ ἐοικὼς	-uu- u u-u u-- -u u--	dactylic hexameter	feminine penthemimeral, trithemimeral
εἴ που ἐσαθρήσειεν Ἀλέξανδρον θεοειδέα.	- u u---u u--- uu--	dactylic hexameter	feminine penthemimeral
Ἀλλ’ οὔ τις δύνατο Τρώων κλειτῶν τ’ἐπικούρων	- - - uu- -- -- uu--	dactylic hexameter	masculine penthemimeral, hepthemimeral, trithemimeral
δεῖξαι Ἀλέξανδρον τότ’ ἀρηϊφίλῳ Μενελάῳ·	-u u--- u u-uu- uu--	dactylic hexameter	masculine penthemimeral
οὐ μὲν γὰρ φιλότητί γ’ ἐκεύθανον εἴ τις ἴδοιτο·	- - - uu-u u-uu - u u--	dactylic hexameter	feminine penthemimeral, trithemimeral
ἶσον γάρ σφιν πᾶσιν ἀπήχθετο κηρὶ μελαίνῃ.	-- - - -u u-uu -u u--	dactylic hexameter	feminine penthemimeral, trithemimeral
Τοῖσι δὲ καὶ μετέειπεν ἄναξ ἀνδρῶν Ἀγαμέμνων·	-u u - uu-u u- -- uu--	dactylic hexameter	feminine penthemimeral, hepthemimeral, trithemimeral
κέκλυτέ μευ Τρῶες καὶ Δάρδανοι ἠδ’ ἐπίκουροι·	-uu - -- - -uu - uu--	dactylic hexameter	masculine penthemimeral, trithemimeral
νίκη μὲν δὴ φαίνετ’ ἀρηϊφίλου Μενελάου,	-- - - -u u-uu- uu--	dactylic hexameter	feminine penthemimeral, trithemimeral
ὑμεῖς δ’Ἀργείην Ἑλένην καὶ κτήμαθ’ ἅμ’ αὐτῇ	-- --- uu- - -u u --	dactylic hexameter	masculine penthemimeral, hepthemimeral
ἔκδοτε, καὶ τιμὴν ἀποτινέμεν ἥν τιν’ ἔοικεν,	-uu - -- uu-uu - u u--	dactylic hexameter	masculine penthemimeral, trithemimeral
ἥ τε καὶ ἐσσομένοισι μετ’ ἀνθρώποισι πέληται.	- u u -uu-u u ---u u--	dactylic hexameter	feminine penthemimeral
Ὣς ἔφατ’ Ἀτρεΐδης, ἐπὶ δ’ᾔνεον ἄλλοι Ἀχαιοί.	- uu -uu- uu -uu -u u--	dactylic hexameter	masculine penthemimeral
