ὣς οἳ μὲν μάρναντο δέμας πυρὸς αἰθομένοιο,	- - - --u u- uu -uu--	dactylic hexameter	feminine penthemimeral, hepthemimeral, trithemimeral
Ἀντίλοχος δ’Ἀχιλῆϊ πόδας ταχὺς ἄγγελος ἦλθε.	-uu- uu-u u- uu -uu --	dactylic hexameter	feminine penthemimeral, hepthemimeral, trithemimeral
τὸν δ’εὗρε προπάροιθε νεῶν ὀρθοκραιράων	- -- uu-u u- -----	dactylic hexameter	feminine penthemimeral, hepthemimeral, trithemimeral
τὰ φρονέοντ’ ἀνὰ θυμὸν ἃ δὴ τετελεσμένα ἦεν·	- uu- uu -u u - uu-uu --	dactylic hexameter	feminine penthemimeral, hepthemimeral, trithemimeral
ὀχθήσας δ’ἄρα εἶπε πρὸς ὃν μεγαλήτορα θυμόν·	--- uu -u u - uu-uu --	dactylic hexameter	feminine penthemimeral, hepthemimeral, trithemimeral
ὤ μοι ἐγώ, τί τ’ἄρ’ αὖτε κάρη κομόωντες Ἀχαιοὶ	- u u- u u -u u- uu-u u--	dactylic hexameter	feminine penthemimeral, hepthemimeral, trithemimeral
νηυσὶν ἔπι κλονέονται ἀτυζόμενοι πεδίοιο;	-u u- uu-u u-uu- uu--	dactylic hexameter	feminine penthemimeral, trithemimeral
μὴ δή μοι τελέσωσι θεοὶ κακὰ κήδεα θυμῷ,	- - - uu-u u- uu -uu --	dactylic hexameter	feminine penthemimeral, hepthemimeral, trithemimeral
ὥς ποτέ μοι μήτηρ διεπέφραδε καί μοι ἔειπε	- uu - -- uu-uu - u u--	dactylic hexameter	masculine penthemimeral, trithemimeral
Μυρμιδόνων τὸν ἄριστον ἔτι ζώοντος ἐμεῖο	-uu- u u-u u- --u u--	dactylic hexameter	feminine penthemimeral, hepthemimeral, trithemimeral
χερσὶν ὕπο Τρώων λείψειν φάος ἠελίοιο.	-u u- -- -- uu -uu--	dactylic hexameter	masculine penthemimeral, hepthemimeral, trithemimeral
ἦ μάλα δὴ τέθνηκε Μενοιτίου ἄλκιμος υἱὸς	- uu - --u u-uu -uu --	dactylic hexameter	feminine penthemimeral, trithemimeral
σχέτλιος· ἦ τ’ἐκέλευον ἀπωσάμενον δήιον πῦρ	-uu - uu-u u-uu- -- -	dactylic hexameter	feminine penthemimeral, trithemimeral
ἂψ ἐπὶ νῆας ἴμεν, μηδ’ Ἕκτορι ἶφι μάχεσθαι.	- uu -u u- - -uu -u u--	dactylic hexameter	masculine penthemimeral
εἷος ὃ ταῦθ’ ὥρμαινε κατὰ φρένα καὶ κατὰ θυμόν,	-u u - --u u- uu - uu --	dactylic hexameter	feminine penthemimeral, hepthemimeral, trithemimeral
τόφρά οἱ ἐγγύθεν ἦλθεν ἀγαυοῦ Νέστορος υἱὸς	-u u -uu -u u-- -uu --	dactylic hexameter	feminine penthemimeral
δάκρυα θερμὰ χέων, φάτο δ’ἀγγελίην ἀλεγεινήν·	-uu -u u- uu -uu- uu--	dactylic hexameter	masculine penthemimeral
ὤ μοι Πηλέος υἱὲ δαΐφρονος ἦ μάλα λυγρῆς	- - -uu -u u-uu - uu --	dactylic hexameter	feminine penthemimeral
πεύσεαι ἀγγελίης, ἣ μὴ ὤφελλε γενέσθαι.	-uu -uu- - - --u u--	dactylic hexameter	masculine penthemimeral, hepthemimeral
κεῖται Πάτροκλος, νέκυος δὲ δὴ ἀμφιμάχονται	-- --- uu- u u -uu--	dactylic hexameter	masculine penthemimeral, hepthemimeral
γυμνοῦ· ἀτὰρ τά γε τεύχε’ ἔχει κορυθαίολος Ἕκτωρ.	-u u- u u -u u- uu-uu --	dactylic hexameter	feminine penthemimeral, hepthemimeral, trithemimeral
ὣς φάτο, τὸν δ’ἄχεος νεφέλη ἐκάλυψε μέλαινα·	- uu - uu- uu- uu-u u--	dactylic hexameter	masculine penthemimeral, hepthemimeral, trithemimeral
ἀμφοτέρῃσι δὲ χερσὶν ἑλὼν κόνιν αἰθαλόεσσαν	-uu-u u -u u- uu -uu--	dactylic hexameter	feminine penthemimeral, hepthemimeral
χεύατο κὰκ κεφαλῆς, χαρίεν δ’ᾔσχυνε πρόσωπον·	-uu - uu- uu- --u u--	dactylic hexameter	masculine penthemimeral, hepthemimeral, trithemimeral
νεκταρέῳ δὲ χιτῶνι μέλαιν’ ἀμφίζανε τέφρη.	-uu- u u-u u- --uu --	dactylic hexameter	feminine penthemimeral, hepthemimeral, trithemimeral
αὐτὸς δ’ἐν κονίῃσι μέγας μεγαλωστὶ τανυσθεὶς	-- - uu-u u- uu-u u--	dactylic hexameter	feminine penthemimeral, hepthemimeral, trithemimeral
κεῖτο, φίλῃσι δὲ χερσὶ κόμην ᾔσχυνε δαΐζων.	-u u-u u -u u- --u u--	dactylic hexameter	feminine penthemimeral, hepthemimeral
δμῳαὶ δ’ἃς Ἀχιλεὺς ληΐσσατο Πάτροκλός τε	-- - uu- --uu --- -	dactylic hexameter	masculine penthemimeral, trithemimeral
θυμὸν ἀκηχέμεναι μεγάλ’ ἴαχον, ἐκ δὲ θύραζε	-u u-uu- uu -uu - u u--	dactylic hexameter	masculine penthemimeral
ἔδραμον ἀμφ’ Ἀχιλῆα δαΐφρονα, χερσὶ δὲ πᾶσαι	-uu - uu-u u-uu -u u --	dactylic hexameter	feminine penthemimeral, trithemimeral
στήθεα πεπλήγοντο, λύθεν δ’ὑπὸ γυῖα ἑκάστης.	-uu ---u u- uu -u u--	dactylic hexameter	feminine penthemimeral, hepthemimeral
Ἀντίλοχος δ’ἑτέρωθεν ὀδύρετο δάκρυα λείβων	-uu- uu-u u-uu -uu --	dactylic hexameter	feminine penthemimeral, trithemimeral
χεῖρας ἔχων Ἀχιλῆος· ὃ δ’ἔστενε κυδάλιμον κῆρ·	-u u- uu-u u -uu -uu- -	dactylic hexameter	feminine penthemimeral, trithemimeral
δείδιε γὰρ μὴ λαιμὸν ἀπαμήσειε σιδήρῳ.	-uu - - -u u---u u--	dactylic hexameter	feminine penthemimeral, trithemimeral
σμερδαλέον δ’ᾤμωξεν· ἄκουσε δὲ πότνια μήτηρ	-uu- --u u-u u -uu --	dactylic hexameter	feminine penthemimeral, trithemimeral
ἡμένη ἐν βένθεσσιν ἁλὸς παρὰ πατρὶ γέροντι,	-uu - --u u- uu -u u--	dactylic hexameter	feminine penthemimeral, hepthemimeral, trithemimeral
κώκυσέν τ’ἄρ’ ἔπειτα· θεαὶ δέ μιν ἀμφαγέροντο	--- u u-u u- u u -uu--	dactylic hexameter	feminine penthemimeral, hepthemimeral, trithemimeral
πᾶσαι ὅσαι κατὰ βένθος ἁλὸς Νηρηΐδες ἦσαν.	-u u- uu -u u- --uu --	dactylic hexameter	feminine penthemimeral, hepthemimeral, trithemimeral
ἔνθ’ ἄρ’ ἔην Γλαύκη τε Θάλειά τε Κυμοδόκη τε	- u u- -- u u-u u -uu- -	dactylic hexameter	masculine penthemimeral, trithemimeral
Νησαίη Σπειώ τε Θόη θ’Ἁλίη τε βοῶπις	--- -- u u- uu- u u--	dactylic hexameter	masculine penthemimeral, hepthemimeral, trithemimeral
Κυμοθόη τε καὶ Ἀκταίη καὶ Λιμνώρεια	-uu- u u --- - ----	dactylic hexameter	hepthemimeral, trithemimeral
καὶ Μελίτη καὶ Ἴαιρα καὶ Ἀμφιθόη καὶ Ἀγαυὴ	- uu- u u-u u -uu- u u--	dactylic hexameter	feminine penthemimeral, trithemimeral
Δωτώ τε Πρωτώ τε Φέρουσά τε Δυναμένη τε	-- - -- u u-u u -uu- -	dactylic hexameter	masculine penthemimeral, trithemimeral
Δεξαμένη τε καὶ Ἀμφινόμη καὶ Καλλιάνειρα	-uu- u u -uu- - -uu--	dactylic hexameter	hepthemimeral, trithemimeral
Δωρὶς καὶ Πανόπη καὶ ἀγακλειτὴ Γαλάτεια	-- - uu- u u--- uu--	dactylic hexameter	masculine penthemimeral, trithemimeral
Νημερτής τε καὶ Ἀψευδὴς καὶ Καλλιάνασσα·	--- u u --- - -uu--	dactylic hexameter	hepthemimeral, trithemimeral
ἔνθα δ’ἔην Κλυμένη Ἰάνειρά τε καὶ Ἰάνασσα	-u u- uu- uu-u u - uu--	dactylic hexameter	masculine penthemimeral, trithemimeral
Μαῖρα καὶ Ὠρείθυια ἐϋπλόκαμός τ’Ἀμάθεια	-u u ---u u-uu- uu--	dactylic hexameter	feminine penthemimeral
ἄλλαι θ’αἳ κατὰ βένθος ἁλὸς Νηρηΐδες ἦσαν.	-- - uu -u u- --uu --	dactylic hexameter	feminine penthemimeral, hepthemimeral, trithemimeral
τῶν δὲ καὶ ἀργύφεον πλῆτο σπέος· αἳ δ’ἅμα πᾶσαι	- u u -uu- -- uu - uu --	dactylic hexameter	masculine penthemimeral, hepthemimeral
στήθεα πεπλήγοντο, Θέτις δ’ἐξῆρχε γόοιο·	-uu ---u u- --u u--	dactylic hexameter	feminine penthemimeral, hepthemimeral
κλῦτε κασίγνηται Νηρηΐδες, ὄφρ’ ἐῢ πᾶσαι	-u u--- --uu - uu --	dactylic hexameter	masculine penthemimeral
εἴδετ’ ἀκούουσαι ὅσ’ ἐμῷ ἔνι κήδεα θυμῷ.	-u u--- u u- uu -uu --	dactylic hexameter	masculine penthemimeral, hepthemimeral
ὤ μοι ἐγὼ δειλή, ὤ μοι δυσαριστοτόκεια,	- u u- -- - - uu-uu--	dactylic hexameter	masculine penthemimeral, hepthemimeral, trithemimeral
ἥ τ’ἐπεὶ ἂρ τέκον υἱὸν ἀμύμονά τε κρατερόν τε	- uu - uu -u u-uu - uu- -	dactylic hexameter	feminine penthemimeral, trithemimeral
ἔξοχον ἡρώων· ὃ δ’ἀνέδραμεν ἔρνεϊ ἶσος·	-uu --- u u-uu -uu --	dactylic hexameter	masculine penthemimeral
τὸν μὲν ἐγὼ θρέψασα φυτὸν ὣς γουνῷ ἀλωῆς	- u u- --u u- - -u u--	dactylic hexameter	feminine penthemimeral, hepthemimeral, trithemimeral
νηυσὶν ἐπιπροέηκα κορωνίσιν Ἴλιον εἴσω	-u u-uu-u u-uu -uu --	dactylic hexameter	feminine penthemimeral
Τρωσὶ μαχησόμενον· τὸν δ’οὐχ ὑποδέξομαι αὖτις	-u u-uu- - - uu-uu --	dactylic hexameter	masculine penthemimeral, hepthemimeral
οἴκαδε νοστήσαντα δόμον Πηλήϊον εἴσω.	-uu ---u u- --uu --	dactylic hexameter	feminine penthemimeral, hepthemimeral
ὄφρα δέ μοι ζώει καὶ ὁρᾷ φάος ἠελίοιο	-u u - -- u u- uu -uu--	dactylic hexameter	masculine penthemimeral, hepthemimeral, trithemimeral
ἄχνυται, οὐδέ τί οἱ δύναμαι χραισμῆσαι ἰοῦσα.	-uu -u u - uu- --u u--	dactylic hexameter	masculine penthemimeral, hepthemimeral
ἀλλ’ εἶμ’, ὄφρα ἴδωμι φίλον τέκος, ἠδ’ ἐπακούσω	- - -u u-u u- uu - uu--	dactylic hexameter	feminine penthemimeral, hepthemimeral
ὅττί μιν ἵκετο πένθος ἀπὸ πτολέμοιο μένοντα.	-u u -uu -u u- uu-u u--	dactylic hexameter	feminine penthemimeral, hepthemimeral
ὣς ἄρα φωνήσασα λίπε σπέος· αἳ δὲ σὺν αὐτῇ	- uu ---u u- uu - u u --	dactylic hexameter	feminine penthemimeral, hepthemimeral
δακρυόεσσαι ἴσαν, περὶ δέ σφισι κῦμα θαλάσσης	-uu-u u- uu - uu -u u--	dactylic hexameter	masculine penthemimeral, hepthemimeral
ῥήγνυτο· ταὶ δ’ὅτε δὴ Τροίην ἐρίβωλον ἵκοντο	-uu - uu - -- uu-u u--	dactylic hexameter	masculine penthemimeral, hepthemimeral, trithemimeral
ἀκτὴν εἰσανέβαινον ἐπισχερώ, ἔνθα θαμειαὶ	-- -uu-u u-uu -u u--	dactylic hexameter	feminine penthemimeral
Μυρμιδόνων εἴρυντο νέες ταχὺν ἀμφ’ Ἀχιλῆα.	-uu- --u u- uu - uu--	dactylic hexameter	feminine penthemimeral, hepthemimeral, trithemimeral
τῷ δὲ βαρὺ στενάχοντι παρίστατο πότνια μήτηρ,	- u u- uu-u u-uu -uu --	dactylic hexameter	feminine penthemimeral, trithemimeral
ὀξὺ δὲ κωκύσασα κάρη λάβε παιδὸς ἑοῖο,	-u u ---u u- uu -u u--	dactylic hexameter	feminine penthemimeral, hepthemimeral
καί ῥ’ὀλοφυρομένη ἔπεα πτερόεντα προσηύδα·	- uu-uu- uu- uu-u u--	dactylic hexameter	masculine penthemimeral, hepthemimeral
τέκνον τί κλαίεις; τί δέ σε φρένας ἵκετο πένθος;	-- - -- u u - uu -uu --	dactylic hexameter	masculine penthemimeral, hepthemimeral, trithemimeral
ἐξαύδα, μὴ κεῦθε· τὰ μὲν δή τοι τετέλεσται	--- - -u u - - - uu--	dactylic hexameter	feminine penthemimeral, hepthemimeral, trithemimeral
ἐκ Διός, ὡς ἄρα δὴ πρίν γ’εὔχεο χεῖρας ἀνασχὼν	- uu - uu - - -uu -u u--	dactylic hexameter	masculine penthemimeral, trithemimeral
πάντας ἐπὶ πρύμνῃσιν ἀλήμεναι υἷας Ἀχαιῶν	-u u- --u u-uu -u u--	dactylic hexameter	feminine penthemimeral, trithemimeral
σεῦ ἐπιδευομένους, παθέειν τ’ἀεκήλια ἔργα.	- uu-uu- uu- uu-uu --	dactylic hexameter	masculine penthemimeral, hepthemimeral
τὴν δὲ βαρὺ στενάχων προσέφη πόδας ὠκὺς Ἀχιλλεύς·	- u u- uu- uu- uu -u u--	dactylic hexameter	masculine penthemimeral, hepthemimeral, trithemimeral
μῆτερ ἐμή, τὰ μὲν ἄρ μοι Ὀλύμπιος ἐξετέλεσσεν·	-u u- u u - u u-uu -uu--	dactylic hexameter	masculine penthemimeral, trithemimeral
ἀλλὰ τί μοι τῶν ἦδος ἐπεὶ φίλος ὤλεθ’ ἑταῖρος	-u u - - -u u- uu -u u--	dactylic hexameter	feminine penthemimeral, hepthemimeral, trithemimeral
Πάτροκλος, τὸν ἐγὼ περὶ πάντων τῖον ἑταίρων	--- u u- uu -- -u u--	dactylic hexameter	masculine penthemimeral, trithemimeral
ἶσον ἐμῇ κεφαλῇ; τὸν ἀπώλεσα, τεύχεα δ’Ἕκτωρ	-u u- uu- u u-uu -uu --	dactylic hexameter	masculine penthemimeral, trithemimeral
δῃώσας ἀπέδυσε πελώρια θαῦμα ἰδέσθαι	--- uu-u u-uu -u u--	dactylic hexameter	feminine penthemimeral, trithemimeral
καλά· τὰ μὲν Πηλῆϊ θεοὶ δόσαν ἀγλαὰ δῶρα	-u u - --u u- uu -uu --	dactylic hexameter	feminine penthemimeral, hepthemimeral, trithemimeral
ἤματι τῷ ὅτε σε βροτοῦ ἀνέρος ἔμβαλον εὐνῇ.	-uu - uu - uu -uu -uu --	dactylic hexameter	masculine penthemimeral, trithemimeral
αἴθ’ ὄφελες σὺ μὲν αὖθι μετ’ ἀθανάτῃς ἁλίῃσι	- uu- u u -u u -uu- uu--	dactylic hexameter	feminine penthemimeral, trithemimeral
ναίειν, Πηλεὺς δὲ θνητὴν ἀγαγέσθαι ἄκοιτιν.	-- -- - -- uu-u u--	dactylic hexameter	masculine penthemimeral, hepthemimeral
νῦν δ’ἵνα καὶ σοὶ πένθος ἐνὶ φρεσὶ μυρίον εἴη	- uu - - -u u- uu -uu --	dactylic hexameter	feminine penthemimeral, hepthemimeral, trithemimeral
παιδὸς ἀποφθιμένοιο, τὸν οὐχ ὑποδέξεαι αὖτις	-u u-uu-u u - uu-uu --	dactylic hexameter	feminine penthemimeral, hepthemimeral
οἴκαδε νοστήσαντ’, ἐπεὶ οὐδ’ ἐμὲ θυμὸς ἄνωγε	-uu --- uu - uu -u u--	dactylic hexameter	masculine penthemimeral, hepthemimeral
ζώειν οὐδ’ ἄνδρεσσι μετέμμεναι, αἴ κε μὴ Ἕκτωρ	-- - --u u-uu - u u --	dactylic hexameter	feminine penthemimeral, trithemimeral
πρῶτος ἐμῷ ὑπὸ δουρὶ τυπεὶς ἀπὸ θυμὸν ὀλέσσῃ,	-u u- uu -u u- uu -u u--	dactylic hexameter	feminine penthemimeral, hepthemimeral, trithemimeral
Πατρόκλοιο δ’ἕλωρα Μενοιτιάδεω ἀποτίσῃ.	---u u-u u-uu- uu--	dactylic hexameter	feminine penthemimeral
τὸν δ’αὖτε προσέειπε Θέτις κατὰ δάκρυ χέουσα·	- -- uu-u u- uu -u u--	dactylic hexameter	feminine penthemimeral, hepthemimeral, trithemimeral
ὠκύμορος δή μοι τέκος ἔσσεαι, οἷ’ ἀγορεύεις·	-uu- - - uu -uu - uu--	dactylic hexameter	masculine penthemimeral, trithemimeral
αὐτίκα γάρ τοι ἔπειτα μεθ’ Ἕκτορα πότμος ἑτοῖμος.	-uu - u u-u u -uu -u u--	dactylic hexameter	feminine penthemimeral, trithemimeral
τὴν δὲ μέγ’ ὀχθήσας προσέφη πόδας ὠκὺς Ἀχιλλεύς·	- u u --- uu- uu -u u--	dactylic hexameter	masculine penthemimeral, hepthemimeral
αὐτίκα τεθναίην, ἐπεὶ οὐκ ἄρ’ ἔμελλον ἑταίρῳ	-uu --- uu - u u-u u--	dactylic hexameter	masculine penthemimeral, hepthemimeral
κτεινομένῳ ἐπαμῦναι· ὃ μὲν μάλα τηλόθι πάτρης	-uu- uu-u u - uu -uu --	dactylic hexameter	feminine penthemimeral, hepthemimeral, trithemimeral
ἔφθιτ’, ἐμεῖο δὲ δῆσεν ἀρῆς ἀλκτῆρα γενέσθαι.	-u u-u u -u u- --u u--	dactylic hexameter	feminine penthemimeral, hepthemimeral
νῦν δ’ἐπεὶ οὐ νέομαί γε φίλην ἐς πατρίδα γαῖαν,	- uu - uu- u u- - -uu --	dactylic hexameter	masculine penthemimeral, hepthemimeral, trithemimeral
οὐδέ τι Πατρόκλῳ γενόμην φάος οὐδ’ ἑτάροισι	-u u --- uu- uu - uu--	dactylic hexameter	masculine penthemimeral, hepthemimeral
τοῖς ἄλλοις, οἳ δὴ πολέες δάμεν Ἕκτορι δίῳ,	- -- - - uu- uu -uu --	dactylic hexameter	masculine penthemimeral, hepthemimeral, trithemimeral
ἀλλ’ ἧμαι παρὰ νηυσὶν ἐτώσιον ἄχθος ἀρούρης,	- -- uu -u u-uu -u u--	dactylic hexameter	feminine penthemimeral, trithemimeral
τοῖος ἐὼν οἷος οὔ τις Ἀχαιῶν χαλκοχιτών ων	-u u- uu - u u-- -uu- -	dactylic hexameter	masculine penthemimeral, trithemimeral
ἐν πολέμῳ· ἀγορῇ δέ τ’ἀμείνονές εἰσι καὶ ἄλλοι.	- uu- uu- u u-uu -u u --	dactylic hexameter	masculine penthemimeral, trithemimeral
ὡς ἔρις ἔκ τε θεῶν ἔκ τ’ἀνθρώπων ἀπόλοιτο	- uu - u u- - --- uu--	dactylic hexameter	masculine penthemimeral, trithemimeral
καὶ χόλος, ὅς τ’ἐφέηκε πολύφρονά περ χαλεπῆναι,	- uu - uu-u u-uu - uu--	dactylic hexameter	feminine penthemimeral, trithemimeral
ὅς τε πολὺ γλυκίων μέλιτος καταλειβομένοιο	- u u- uu- uu- uu-uu--	dactylic hexameter	masculine penthemimeral, hepthemimeral, trithemimeral
ἀνδρῶν ἐν στήθεσσιν ἀέξεται ἠΰτε καπνός·	-- - --u u-uu -uu --	dactylic hexameter	feminine penthemimeral, trithemimeral
ὡς ἐμὲ νῦν ἐχόλωσεν ἄναξ ἀνδρῶν Ἀγαμέμνων.	- uu - uu-u u- -- uu--	dactylic hexameter	feminine penthemimeral, hepthemimeral, trithemimeral
ἀλλὰ τὰ μὲν προτετύχθαι ἐάσομεν ἀχνύμενοί περ,	-u u - uu-u u-uu -uu- -	dactylic hexameter	feminine penthemimeral, trithemimeral
θυμὸν ἐνὶ στήθεσσι φίλον δαμάσαντες ἀνάγκῃ·	-u u- --u u- uu-u u--	dactylic hexameter	feminine penthemimeral, hepthemimeral, trithemimeral
νῦν δ’εἶμ’ ὄφρα φίλης κεφαλῆς ὀλετῆρα κιχείω	- - -u u- uu- uu-u u--	dactylic hexameter	masculine penthemimeral, hepthemimeral
Ἕκτορα· κῆρα δ’ἐγὼ τότε δέξομαι ὁππότε κεν δὴ	-uu -u u- uu -uu -uu - -	dactylic hexameter	masculine penthemimeral
Ζεὺς ἐθέλῃ τελέσαι ἠδ’ ἀθάνατοι θεοὶ ἄλλοι.	- uu- uu- - -uu- uu --	dactylic hexameter	masculine penthemimeral, trithemimeral
οὐδὲ γὰρ οὐδὲ βίη Ἡρακλῆος φύγε κῆρα,	-u u -u u- ---- uu --	dactylic hexameter	masculine penthemimeral
ὅς περ φίλτατος ἔσκε Διὶ Κρονίωνι ἄνακτι·	- - -uu -u u- uu-u u--	dactylic hexameter	feminine penthemimeral, hepthemimeral
ἀλλά ἑ μοῖρα δάμασσε καὶ ἀργαλέος χόλος Ἥρης.	-u u -u u-u u -uu- uu --	dactylic hexameter	feminine penthemimeral
ὣς καὶ ἐγών, εἰ δή μοι ὁμοίη μοῖρα τέτυκται,	- u u- - - u u-- -u u--	dactylic hexameter	masculine penthemimeral, trithemimeral
κείσομ’ ἐπεί κε θάνω· νῦν δὲ κλέος ἐσθλὸν ἀροίμην,	-u u- u u- - - uu -u u--	dactylic hexameter	masculine penthemimeral, hepthemimeral, trithemimeral
καί τινα Τρωϊάδων καὶ Δαρδανίδων βαθυκόλπων	- uu -uu- - -uu- uu--	dactylic hexameter	masculine penthemimeral
ἀμφοτέρῃσιν χερσὶ παρειάων ἁπαλάων	-uu-- -u u--- uu--	dactylic hexameter	feminine penthemimeral
δάκρυ’ ὀμορξαμένην ἁδινὸν στοναχῆσαι ἐφείην,	-u u-uu- uu- uu-u u--	dactylic hexameter	masculine penthemimeral, hepthemimeral
γνοῖεν δ’ὡς δὴ δηρὸν ἐγὼ πολέμοιο πέπαυμαι·	-- - - -u u- uu-u u--	dactylic hexameter	feminine penthemimeral, hepthemimeral, trithemimeral
μὴ δέ μ’ἔρυκε μάχης φιλέουσά περ· οὐδέ με πείσεις.	- u u-u u- uu-u u -u u --	dactylic hexameter	masculine penthemimeral
τὸν δ’ἠμείβετ’ ἔπειτα θεὰ Θέτις ἀργυρόπεζα·	- --u u-u u- uu -uu--	dactylic hexameter	feminine penthemimeral, hepthemimeral
ναὶ δὴ ταῦτά γε τέκνον ἐτήτυμον οὐ κακόν ἐστι	- - -u u -u u-uu - uu --	dactylic hexameter	feminine penthemimeral
τειρομένοις ἑτάροισιν ἀμυνέμεν αἰπὺν ὄλεθρον.	-uu- uu-u u-uu -u u--	dactylic hexameter	feminine penthemimeral, trithemimeral
ἀλλά τοι ἔντεα καλὰ μετὰ Τρώεσσιν ἔχονται	-u u -uu -u u- --u u--	dactylic hexameter	feminine penthemimeral, hepthemimeral
χάλκεα μαρμαίροντα· τὰ μὲν κορυθαίολος Ἕκτωρ	-uu ---u u - uu-uu --	dactylic hexameter	feminine penthemimeral, hepthemimeral
αὐτὸς ἔχων ὤμοισιν ἀγάλλεται· οὐδέ ἕ φημι	-u u- --u u-uu -u u --	dactylic hexameter	feminine penthemimeral, trithemimeral
δηρὸν ἐπαγλαϊεῖσθαι, ἐπεὶ φόνος ἐγγύθεν αὐτῷ.	-u u-uu-u u- uu -uu --	dactylic hexameter	feminine penthemimeral, hepthemimeral
ἀλλὰ σὺ μὲν μή πω καταδύσεο μῶλον Ἄρηος	-u u - - - uu-uu -u u--	dactylic hexameter	masculine penthemimeral, trithemimeral
πρίν γ’ἐμὲ δεῦρ’ ἐλθοῦσαν ἐν ὀφθαλμοῖσιν ἴδηαι·	- uu - --u u ---u u--	dactylic hexameter	feminine penthemimeral, trithemimeral
ἠῶθεν γὰρ νεῦμαι ἅμ’ ἠελίῳ ἀνιόντι	--- - -u u -uu- uu--	dactylic hexameter	feminine penthemimeral, trithemimeral
τεύχεα καλὰ φέρουσα παρ’ Ἡφαίστοιο ἄνακτος.	-uu -u u-u u ---u u--	dactylic hexameter	feminine penthemimeral
ὣς ἄρα φωνήσασα πάλιν τράπεθ’ υἷος ἑοῖο,	- uu ---u u- uu -u u--	dactylic hexameter	feminine penthemimeral, hepthemimeral
καὶ στρεφθεῖσ’ ἁλίῃσι κασιγνήτῃσι μετηύδα·	- -- uu-u u---u u--	dactylic hexameter	feminine penthemimeral, trithemimeral
ὑμεῖς μὲν νῦν δῦτε θαλάσσης εὐρέα κόλπον	-- - - -u u-- -uu --	dactylic hexameter	feminine penthemimeral, trithemimeral
ὀψόμεναί τε γέρονθ’ ἅλιον καὶ δώματα πατρός,	-uu- u u- uu- - -uu --	dactylic hexameter	masculine penthemimeral, hepthemimeral, trithemimeral
καί οἱ πάντ’ ἀγορεύσατ’· ἐγὼ δ’ἐς μακρὸν Ὄλυμπον	- - - uu-u u- - -u u--	dactylic hexameter	feminine penthemimeral, hepthemimeral, trithemimeral
εἶμι παρ’ Ἥφαιστον κλυτοτέχνην, αἴ κ’ἐθέλῃσιν	-u u --- uu-- - uu--	dactylic hexameter	masculine penthemimeral
υἱεῖ ἐμῷ δόμεναι κλυτὰ τεύχεα παμφανόωντα.	-u u- uu- uu -uu -uu--	dactylic hexameter	masculine penthemimeral, trithemimeral
ὣς ἔφαθ’, αἳ δ’ὑπὸ κῦμα θαλάσσης αὐτίκ’ ἔδυσαν·	- uu - uu -u u-- -u u--	dactylic hexameter	feminine penthemimeral, trithemimeral
ἣ δ’αὖτ’ Οὔλυμπον δὲ θεὰ Θέτις ἀργυρόπεζα	- - --- u u- uu -uu--	dactylic hexameter	masculine penthemimeral, hepthemimeral
ἤϊεν ὄφρα φίλῳ παιδὶ κλυτὰ τεύχε’ ἐνείκαι.	-uu -u u- -- uu -u u--	dactylic hexameter	masculine penthemimeral, hepthemimeral
τὴν μὲν ἄρ’ Οὔλυμπον δὲ πόδες φέρον· αὐτὰρ Ἀχαιοὶ	- u u --- u u- uu -u u--	dactylic hexameter	masculine penthemimeral, hepthemimeral
θεσπεσίῳ ἀλαλητῷ ὑφ’ Ἕκτορος ἀνδροφόνοιο	-uu- uu-u u -uu -uu--	dactylic hexameter	feminine penthemimeral, trithemimeral
φεύγοντες νῆάς τε καὶ Ἑλλήσποντον ἵκοντο.	--- -- u u ---u u--	dactylic hexameter	masculine penthemimeral, trithemimeral
οὐδέ κε Πάτροκλόν περ ἐϋκνήμιδες Ἀχαιοὶ	-u u --- u u---u u--	dactylic hexameter	masculine penthemimeral
ἐκ βελέων ἐρύσαντο νέκυν θεράποντ’ Ἀχιλῆος·	- uu- uu-u u- uu- uu--	dactylic hexameter	feminine penthemimeral, hepthemimeral, trithemimeral
αὖτις γὰρ δὴ τόν γε κίχον λαός τε καὶ ἵπποι	-- - - - u u- -- u u --	dactylic hexameter	masculine penthemimeral, hepthemimeral, trithemimeral
Ἕκτωρ τε Πριάμοιο πάϊς φλογὶ εἴκελος ἀλκήν.	-- - uu-u u- uu -uu --	dactylic hexameter	feminine penthemimeral, hepthemimeral, trithemimeral
τρὶς μέν μιν μετόπισθε ποδῶν λάβε φαίδιμος Ἕκτωρ	- - - uu-u u- uu -uu --	dactylic hexameter	feminine penthemimeral, hepthemimeral, trithemimeral
ἑλκέμεναι μεμαώς, μέγα δὲ Τρώεσσιν ὁμόκλα·	-uu- uu- uu - --u u--	dactylic hexameter	masculine penthemimeral, hepthemimeral, trithemimeral
τρὶς δὲ δύ’ Αἴαντες θοῦριν ἐπιειμένοι ἀλκὴν	- u u --- -- uu-uu --	dactylic hexameter	masculine penthemimeral, hepthemimeral
νεκροῦ ἀπεστυφέλιξαν· ὃ δ’ἔμπεδον ἀλκὶ πεποιθὼς	-u u-uu-u u -uu -u u--	dactylic hexameter	feminine penthemimeral
ἄλλοτ’ ἐπαΐξασκε κατὰ μόθον, ἄλλοτε δ’αὖτε	-u u---u u- uu -uu --	dactylic hexameter	feminine penthemimeral, hepthemimeral
στάσκε μέγα ἰάχων· ὀπίσω δ’οὐ χάζετο πάμπαν.	-u u- uu- uu- - -uu --	dactylic hexameter	masculine penthemimeral, hepthemimeral, trithemimeral
ὡς δ’ἀπὸ σώματος οὔ τι λέοντ’ αἴθωνα δύνανται	- uu -uu - u u- --u u--	dactylic hexameter	masculine penthemimeral, hepthemimeral
ποιμένες ἄγραυλοι μέγα πεινάοντα δίεσθαι,	-uu --- uu ---u u--	dactylic hexameter	masculine penthemimeral
ὥς ῥα τὸν οὐκ ἐδύναντο δύω Αἴαντε κορυστὰ	- u u - uu-u u- --u u--	dactylic hexameter	feminine penthemimeral, hepthemimeral, trithemimeral
Ἕκτορα Πριαμίδην ἀπὸ νεκροῦ δειδίξασθαι.	-uu -uu- uu -- ----	dactylic hexameter	masculine penthemimeral
καί νύ κεν εἴρυσσέν τε καὶ ἄσπετον ἤρατο κῦδος,	- u u --- u u -uu -uu --	dactylic hexameter	masculine penthemimeral
εἰ μὴ Πηλεΐωνι ποδήνεμος ὠκέα Ἶρις	- - -uu-u u-uu -uu --	dactylic hexameter	feminine penthemimeral
ἄγγελος ἦλθε θέουσ’ ἀπ’ Ὀλύμπου θωρήσσεσθαι	-uu -u u- u u-- ----	dactylic hexameter	masculine penthemimeral
κρύβδα Διὸς ἄλλων τε θεῶν· πρὸ γὰρ ἧκέ μιν Ἥρη.	-u u- -- u u- u u -u u --	dactylic hexameter	masculine penthemimeral, hepthemimeral, trithemimeral
ἀγχοῦ δ’ἱσταμένη ἔπεα πτερόεντα προσηύδα·	-- -uu- uu- uu-u u--	dactylic hexameter	masculine penthemimeral, hepthemimeral
ὄρσεο Πηλεΐδη, πάντων ἐκπαγλότατ’ ἀνδρῶν·	-uu -uu- -- --uu --	dactylic hexameter	masculine penthemimeral, hepthemimeral
Πατρόκλῳ ἐπάμυνον, οὗ εἵνεκα φύλοπις αἰνὴ	--- uu-u u -uu -uu --	dactylic hexameter	feminine penthemimeral, trithemimeral
ἕστηκε πρὸ νεῶν· οἳ δ’ἀλλήλους ὀλέκουσιν	--- u u- - --- uu--	dactylic hexameter	masculine penthemimeral, trithemimeral
οἳ μὲν ἀμυνόμενοι νέκυος πέρι τεθνηῶτος,	- u u-uu- uu- uu ----	dactylic hexameter	masculine penthemimeral, hepthemimeral
οἳ δὲ ἐρύσσασθαι ποτὶ Ἴλιον ἠνεμόεσσαν	- u u--- uu -uu -uu--	dactylic hexameter	masculine penthemimeral
Τρῶες ἐπιθύουσι· μάλιστα δὲ φαίδιμος Ἕκτωρ	-u u---u u-u u -uu --	dactylic hexameter	feminine penthemimeral
ἑλκέμεναι μέμονεν· κεφαλὴν δέ ἑ θυμὸς ἄνωγε	-uu- uu- uu- u u -u u--	dactylic hexameter	masculine penthemimeral, hepthemimeral, trithemimeral
πῆξαι ἀνὰ σκολόπεσσι ταμόνθ’ ἁπαλῆς ἀπὸ δειρῆς.	-u u- uu-u u- uu- uu --	dactylic hexameter	feminine penthemimeral, hepthemimeral, trithemimeral
ἀλλ’ ἄνα μηδ’ ἔτι κεῖσο· σέβας δέ σε θυμὸν ἱκέσθω	- uu - uu -u u- u u -u u--	dactylic hexameter	feminine penthemimeral, hepthemimeral, trithemimeral
Πάτροκλον Τρῳῇσι κυσὶν μέλπηθρα γενέσθαι·	--- --u u- --u u--	dactylic hexameter	feminine penthemimeral, hepthemimeral, trithemimeral
σοὶ λώβη, αἴ κέν τι νέκυς ᾐσχυμμένος ἔλθῃ.	- -- - - u u- --uu --	dactylic hexameter	masculine penthemimeral, hepthemimeral, trithemimeral
τὴν δ’ἠμείβετ’ ἔπειτα ποδάρκης δῖος Ἀχιλλεύς·	- --u u-u u-- -u u--	dactylic hexameter	feminine penthemimeral
Ἶρι θεὰ τίς γάρ σε θεῶν ἐμοὶ ἄγγελον ἧκε;	-u u- - - u u- uu -uu --	dactylic hexameter	masculine penthemimeral, hepthemimeral, trithemimeral
τὸν δ’αὖτε προσέειπε ποδήνεμος ὠκέα Ἶρις·	- -- uu-u u-uu -uu --	dactylic hexameter	feminine penthemimeral, trithemimeral
Ἥρη με προέηκε Διὸς κυδρὴ παράκοιτις·	-- - uu-u u- -- uu--	dactylic hexameter	feminine penthemimeral, hepthemimeral, trithemimeral
οὐδ’ οἶδε Κρονίδης ὑψίζυγος οὐδέ τις ἄλλος	- -- uu- --uu -u u --	dactylic hexameter	masculine penthemimeral, trithemimeral
ἀθανάτων, οἳ Ὄλυμπον ἀγάννιφον ἀμφινέμονται.	-uu- u u-u u-uu -uu--	dactylic hexameter	feminine penthemimeral, trithemimeral
τὴν δ’ἀπαμειβόμενος προσέφη πόδας ὠκὺς Ἀχιλλεύς·	- uu-uu- uu- uu -u u--	dactylic hexameter	masculine penthemimeral, hepthemimeral
πῶς τὰρ ἴω μετὰ μῶλον; ἔχουσι δὲ τεύχε’ ἐκεῖνοι·	- u u- uu -u u-u u -u u--	dactylic hexameter	feminine penthemimeral, trithemimeral
μήτηρ δ’οὔ με φίλη πρίν γ’εἴα θωρήσσεσθαι	-- - u u- - -- ----	dactylic hexameter	masculine penthemimeral, trithemimeral
πρίν γ’αὐτὴν ἐλθοῦσαν ἐν ὀφθαλμοῖσιν ἴδωμαι·	- -- --u u ---u u--	dactylic hexameter	feminine penthemimeral, trithemimeral
στεῦτο γὰρ Ἡφαίστοιο πάρ’ οἰσέμεν ἔντεα καλά.	-u u ---u u -uu -uu --	dactylic hexameter	feminine penthemimeral
ἄλλου δ’οὔ τευ οἶδα τεῦ ἂν κλυτὰ τεύχεα δύω,	-- - - -u u - uu -uu --	dactylic hexameter	feminine penthemimeral, hepthemimeral, trithemimeral
εἰ μὴ Αἴαντός γε σάκος Τελαμωνιάδαο.	- - --- u u- uu-uu--	dactylic hexameter	masculine penthemimeral, hepthemimeral
ἀλλὰ καὶ αὐτὸς ὅ γ’ἔλπομ’ ἐνὶ πρώτοισιν ὁμιλεῖ	-u u -u u -u u- --u u--	dactylic hexameter	feminine penthemimeral, hepthemimeral
ἔγχεϊ δηϊόων περὶ Πατρόκλοιο θανόντος.	-uu -uu- uu ---u u--	dactylic hexameter	masculine penthemimeral
τὸν δ’αὖτε προσέειπε ποδήνεμος ὠκέα Ἶρις·	- -- uu-u u-uu -uu --	dactylic hexameter	feminine penthemimeral, trithemimeral
εὖ νυ καὶ ἡμεῖς ἴδμεν ὅ τοι κλυτὰ τεύχε’ ἔχονται·	- u u -- -u u - uu -u u--	dactylic hexameter	feminine penthemimeral, hepthemimeral
ἀλλ’ αὔτως ἐπὶ τάφρον ἰὼν Τρώεσσι φάνηθι,	- -- uu -u u- --u u--	dactylic hexameter	feminine penthemimeral, hepthemimeral, trithemimeral
αἴ κέ σ’ὑποδείσαντες ἀπόσχωνται πολέμοιο	- u u---u u--- uu--	dactylic hexameter	feminine penthemimeral
Τρῶες, ἀναπνεύσωσι δ’ ἀρήϊοι υἷες Ἀχαιῶν	-u u---u u-uu -u u--	dactylic hexameter	feminine penthemimeral
τειρόμενοι· ὀλίγη δέ τ’ἀνάπνευσις πολέμοιο.	-uu- uu- u u--- uu--	dactylic hexameter	masculine penthemimeral, trithemimeral
ἣ μὲν ἄρ’ ὣς εἰποῦσ’ ἀπέβη πόδας ὠκέα Ἶρις,	- u u - -- uu- uu -uu --	dactylic hexameter	masculine penthemimeral, hepthemimeral, trithemimeral
αὐτὰρ Ἀχιλλεὺς ὦρτο Διῒ φίλος· ἀμφὶ δ’Ἀθήνη	-u u-- -u u- uu -u u--	dactylic hexameter	feminine penthemimeral, hepthemimeral
ὤμοις ἰφθίμοισι βάλ’ αἰγίδα θυσσανόεσσαν,	-- ---u u -uu -uu--	dactylic hexameter	feminine penthemimeral
ἀμφὶ δέ οἱ κεφαλῇ νέφος ἔστεφε δῖα θεάων	-u u - uu- uu -uu -u u--	dactylic hexameter	masculine penthemimeral, trithemimeral
χρύσεον, ἐκ δ’αὐτοῦ δαῖε φλόγα παμφανόωσαν.	-uu - -- -- uu -uu--	dactylic hexameter	masculine penthemimeral, hepthemimeral, trithemimeral
ὡς δ’ὅτε καπνὸς ἰὼν ἐξ ἄστεος αἰθέρ’ ἵκηται	- uu -u u- - -uu -u u--	dactylic hexameter	masculine penthemimeral
τηλόθεν ἐκ νήσου, τὴν δήϊοι ἀμφιμάχωνται,	-uu - -- - -uu -uu--	dactylic hexameter	masculine penthemimeral, trithemimeral
οἵ τε πανημέριοι στυγερῷ κρίνονται Ἄρηϊ	- u u-uu- uu- --u u--	dactylic hexameter	masculine penthemimeral, hepthemimeral
ἄστεος ἐκ σφετέρου· ἅμα δ’ἠελίῳ καταδύντι	-uu - uu- uu -uu- uu--	dactylic hexameter	masculine penthemimeral, trithemimeral
πυρσοί τε φλεγέθουσιν ἐπήτριμοι, ὑψόσε δ’αὐγὴ	-- - uu-u u-uu -uu --	dactylic hexameter	feminine penthemimeral, trithemimeral
γίγνεται ἀΐσσουσα περικτιόνεσσιν ἰδέσθαι,	-uu ---u u-uu-u u--	dactylic hexameter	feminine penthemimeral
αἴ κέν πως σὺν νηυσὶν ἄρεω ἀλκτῆρες ἵκωνται·	- - - - -u u- --u u--	dactylic hexameter	feminine penthemimeral, hepthemimeral, trithemimeral
ὣς ἀπ’ Ἀχιλλῆος κεφαλῆς σέλας αἰθέρ’ ἵκανε·	- u u--- uu- uu -u u--	dactylic hexameter	masculine penthemimeral, hepthemimeral
στῆ δ’ἐπὶ τάφρον ἰὼν ἀπὸ τείχεος, οὐδ’ ἐς Ἀχαιοὺς	- uu -u u- uu -uu - u u--	dactylic hexameter	masculine penthemimeral
μίσγετο· μητρὸς γὰρ πυκινὴν ὠπίζετ’ ἐφετμήν.	-uu -- - uu- --u u--	dactylic hexameter	masculine penthemimeral, hepthemimeral
ἔνθα στὰς ἤϋσ’, ἀπάτερθε δὲ Παλλὰς Ἀθήνη	-- - -- uu-u u -u u--	dactylic hexameter	masculine penthemimeral, trithemimeral
φθέγξατ’· ἀτὰρ Τρώεσσιν ἐν ἄσπετον ὦρσε κυδοιμόν.	-u u- --u u -uu -u u--	dactylic hexameter	feminine penthemimeral, trithemimeral
ὡς δ’ὅτ’ ἀριζήλη φωνή, ὅτε τ’ἴαχε σάλπιγξ	- u u--- -- uu -uu --	dactylic hexameter	masculine penthemimeral, hepthemimeral
ἄστυ περιπλομένων δηίων ὕπο θυμοραϊστέων,	-u u-uu- -- uu -uu--	dactylic hexameter	masculine penthemimeral, hepthemimeral
ὣς τότ’ ἀριζήλη φωνὴ γένετ’ Αἰακίδαο.	- u u--- -- uu -uu--	dactylic hexameter	masculine penthemimeral, hepthemimeral
οἳ δ’ὡς οὖν ἄϊον ὄπα χάλκεον Αἰακίδαο,	- - - uu- uu -uu -uu--	dactylic hexameter	masculine penthemimeral, trithemimeral
πᾶσιν ὀρίνθη θυμός· ἀτὰρ καλλίτριχες ἵπποι	-u u-- -u u- --uu --	dactylic hexameter	feminine penthemimeral, hepthemimeral
ἂψ ὄχεα τρόπεον· ὄσσοντο γὰρ ἄλγεα θυμῷ.	- uu- uu- --u u -uu --	dactylic hexameter	masculine penthemimeral, trithemimeral
ἡνίοχοι δ’ἔκπληγεν, ἐπεὶ ἴδον ἀκάματον πῦρ	-uu- --u u- uu -uu- -	dactylic hexameter	feminine penthemimeral, hepthemimeral, trithemimeral
δεινὸν ὑπὲρ κεφαλῆς μεγαθύμου Πηλεΐωνος	-u u- uu- uu-- -uu--	dactylic hexameter	masculine penthemimeral, trithemimeral
δαιόμενον· τὸ δὲ δαῖε θεὰ γλαυκῶπις Ἀθήνη.	-uu- u u -u u- --u u--	dactylic hexameter	feminine penthemimeral, hepthemimeral, trithemimeral
τρὶς μὲν ὑπὲρ τάφρου μεγάλ’ ἴαχε δῖος Ἀχιλλεύς,	- u u- -- uu -uu -u u--	dactylic hexameter	masculine penthemimeral, trithemimeral
τρὶς δὲ κυκήθησαν Τρῶες κλειτοί τ’ἐπίκουροι.	- u u--- -- -- uu--	dactylic hexameter	masculine penthemimeral, hepthemimeral
ἔνθα δὲ καὶ τότ’ ὄλοντο δυώδεκα φῶτες ἄριστοι	-u u - u u-u u-uu -u u--	dactylic hexameter	feminine penthemimeral, trithemimeral
ἀμφὶ σφοῖς ὀχέεσσι καὶ ἔγχεσιν. αὐτὰρ Ἀχαιοὶ	-- - uu-u u -uu -u u--	dactylic hexameter	feminine penthemimeral, trithemimeral
ἀσπασίως Πάτροκλον ὑπ’ ἐκ βελέων ἐρύσαντες	-uu- --u u - uu- uu--	dactylic hexameter	feminine penthemimeral, hepthemimeral, trithemimeral
κάτθεσαν ἐν λεχέεσσι· φίλοι δ’ἀμφέσταν ἑταῖροι	-uu - uu-u u- --u u--	dactylic hexameter	feminine penthemimeral, hepthemimeral, trithemimeral
μυρόμενοι· μετὰ δέ σφι ποδώκης εἵπετ’ Ἀχιλλεὺς	-uu- uu - u u-- -u u--	dactylic hexameter	masculine penthemimeral, trithemimeral
δάκρυα θερμὰ χέων, ἐπεὶ εἴσιδε πιστὸν ἑταῖρον	-uu -u u- uu -uu -u u--	dactylic hexameter	masculine penthemimeral
κείμενον ἐν φέρτρῳ δεδαϊγμένον ὀξέϊ χαλκῷ,	-uu - -- uu-uu -uu --	dactylic hexameter	masculine penthemimeral, trithemimeral
τόν ῥ’ἤτοι μὲν ἔπεμπε σὺν ἵπποισιν καὶ ὄχεσφιν	- -- u u-u u --- u u--	dactylic hexameter	feminine penthemimeral, trithemimeral
ἐς πόλεμον, οὐδ’ αὖτις ἐδέξατο νοστήσαντα.	- uu- - -u u-uu ----	dactylic hexameter	feminine penthemimeral, trithemimeral
Ἠέλιον δ’ἀκάμαντα βοῶπις πότνια Ἥρη	-uu- uu-u u-- -uu --	dactylic hexameter	feminine penthemimeral, trithemimeral
πέμψεν ἐπ’ Ὠκεανοῖο ῥοὰς ἀέκοντα νέεσθαι·	-u u -uu-u u- uu-u u--	dactylic hexameter	feminine penthemimeral, hepthemimeral
ἠέλιος μὲν ἔδυ, παύσαντο δὲ δῖοι Ἀχαιοὶ	-uu- u u- --u u -u u--	dactylic hexameter	masculine penthemimeral, trithemimeral
φυλόπιδος κρατερῆς καὶ ὁμοιΐου πολέμοιο.	-uu- uu- u u--- uu--	dactylic hexameter	masculine penthemimeral, trithemimeral
Τρῶες δ’αὖθ’ ἑτέρωθεν ἀπὸ κρατερῆς ὑσμίνης	-- - uu-u u- uu- ---	dactylic hexameter	feminine penthemimeral, hepthemimeral, trithemimeral
χωρήσαντες ἔλυσαν ὑφ’ ἅρμασιν ὠκέας ἵππους,	---u u-u u -uu -uu --	dactylic hexameter	feminine penthemimeral
ἐς δ’ἀγορὴν ἀγέροντο πάρος δόρποιο μέδεσθαι.	- uu- uu-u u- --u u--	dactylic hexameter	feminine penthemimeral, hepthemimeral, trithemimeral
ὀρθῶν δ’ἑσταότων ἀγορὴ γένετ’, οὐδέ τις ἔτλη	-- -uu- uu- uu -u u --	dactylic hexameter	masculine penthemimeral, hepthemimeral
ἕζεσθαι· πάντας γὰρ ἔχε τρόμος, οὕνεκ’ Ἀχιλλεὺς	--- -- u u- uu -u u--	dactylic hexameter	masculine penthemimeral, hepthemimeral, trithemimeral
ἐξεφάνη, δηρὸν δὲ μάχης ἐπέπαυτ’ ἀλεγεινῆς.	-uu- -- u u- uu- uu--	dactylic hexameter	masculine penthemimeral, hepthemimeral, trithemimeral
τοῖσι δὲ Πουλυδάμας πεπνυμένος ἦρχ’ ἀγορεύειν	-u u -uu- --uu - uu--	dactylic hexameter	masculine penthemimeral
Πανθοΐδης· ὃ γὰρ οἶος ὅρα πρόσσω καὶ ὀπίσσω·	-uu- u u -u u- -- u u--	dactylic hexameter	feminine penthemimeral, hepthemimeral, trithemimeral
Ἕκτορι δ’ἦεν ἑταῖρος, ἰῇ δ’ἐν νυκτὶ γένοντο,	-uu -u u-u u- - -u u--	dactylic hexameter	feminine penthemimeral, hepthemimeral
ἀλλ’ ὃ μὲν ἂρ μύθοισιν, ὃ δ’ἔγχεϊ πολλὸν ἐνίκα·	- u u - --u u -uu -u u--	dactylic hexameter	feminine penthemimeral, trithemimeral
ὅ σφιν ἐϋφρονέων ἀγορήσατο καὶ μετέειπεν·	- u u-uu- uu-uu - uu--	dactylic hexameter	masculine penthemimeral
ἀμφὶ μάλα φράζεσθε φίλοι· κέλομαι γὰρ ἔγωγε	-u u- --u u- uu- u u--	dactylic hexameter	feminine penthemimeral, hepthemimeral, trithemimeral
ἄστυδε νῦν ἰέναι, μὴ μίμνειν ἠῶ δῖαν	-uu - uu- - -- -- --	dactylic hexameter	masculine penthemimeral, trithemimeral
ἐν πεδίῳ παρὰ νηυσίν· ἑκὰς δ’ἀπὸ τείχεός εἰμεν.	- uu- uu -u u- uu -uu --	dactylic hexameter	feminine penthemimeral, hepthemimeral, trithemimeral
ὄφρα μὲν οὗτος ἀνὴρ Ἀγαμέμνονι μήνιε δίῳ	-u u -u u- uu-uu -uu --	dactylic hexameter	masculine penthemimeral
τόφρα δὲ ῥηΐτεροι πολεμίζειν ἦσαν Ἀχαιοί·	-u u -uu- uu-- -u u--	dactylic hexameter	masculine penthemimeral
χαίρεσκον γὰρ ἔγωγε θοῇς ἐπὶ νηυσὶν ἰαύων	--- u u-u u- uu -u u--	dactylic hexameter	feminine penthemimeral, hepthemimeral, trithemimeral
ἐλπόμενος νῆας αἱρησέμεν ἀμφιελίσσας.	-uu- -- --uu -uu--	dactylic hexameter	masculine penthemimeral, trithemimeral
νῦν δ’αἰνῶς δείδοικα ποδώκεα Πηλεΐωνα·	- -- --u u-uu -uu--	dactylic hexameter	feminine penthemimeral, trithemimeral
οἷος κείνου θυμὸς ὑπέρβιος, οὐκ ἐθελήσει	-- -- -u u-uu - uu--	dactylic hexameter	feminine penthemimeral
μίμνειν ἐν πεδίῳ, ὅθι περ Τρῶες καὶ Ἀχαιοὶ	-- - uu- uu - -- u u--	dactylic hexameter	masculine penthemimeral, hepthemimeral, trithemimeral
ἐν μέσῳ ἀμφότεροι μένος Ἄρηος δατέονται,	- uu -uu- uu --- uu--	dactylic hexameter	masculine penthemimeral
ἀλλὰ περὶ πτόλιός τε μαχήσεται ἠδὲ γυναικῶν.	-u u- uu- u u-uu -u u--	dactylic hexameter	masculine penthemimeral, trithemimeral
ἀλλ’ ἴομεν προτὶ ἄστυ, πίθεσθέ μοι· ὧδε γὰρ ἔσται·	- uu- uu -u u-u u -u u --	dactylic hexameter	feminine penthemimeral, trithemimeral
νῦν μὲν νὺξ ἀπέπαυσε ποδώκεα Πηλεΐωνα	- - - uu-u u-uu -uu--	dactylic hexameter	feminine penthemimeral, trithemimeral
ἀμβροσίη· εἰ δ’ἄμμε κιχήσεται ἐνθάδ’ ἐόντας	-uu- - -u u-uu -u u--	dactylic hexameter	feminine penthemimeral, trithemimeral
αὔριον ὁρμηθεὶς σὺν τεύχεσιν, εὖ νύ τις αὐτὸν	-uu --- - -uu - u u --	dactylic hexameter	masculine penthemimeral
γνώσεται· ἀσπασίως γὰρ ἀφίξεται Ἴλιον ἱρὴν	-uu -uu- u u-uu -uu --	dactylic hexameter	masculine penthemimeral
ὅς κε φύγῃ, πολλοὺς δὲ κύνες καὶ γῦπες ἔδονται	- u u- -- u u- - -u u--	dactylic hexameter	masculine penthemimeral, hepthemimeral, trithemimeral
Τρώων· αἲ γὰρ δή μοι ἀπ’ οὔατος ὧδε γένοιτο.	-- - - - u u -uu -u u--	dactylic hexameter	masculine penthemimeral, trithemimeral
εἰ δ’ἂν ἐμοῖς ἐπέεσσι πιθώμεθα κηδόμενοί περ,	- u u- uu-u u-uu -uu- -	dactylic hexameter	feminine penthemimeral, trithemimeral
νύκτα μὲν εἰν ἀγορῇ σθένος ἕξομεν, ἄστυ δὲ πύργοι	-u u - uu- uu -uu -u u --	dactylic hexameter	masculine penthemimeral, trithemimeral
ὑψηλαί τε πύλαι σανίδες τ’ἐπὶ τῇς ἀραρυῖαι	--- u u- uu- uu - uu--	dactylic hexameter	masculine penthemimeral, hepthemimeral, trithemimeral
μακραὶ ἐΰξεστοι ἐζευγμέναι εἰρύσσονται·	-u u--- --uu ----	dactylic hexameter	masculine penthemimeral
πρῶϊ δ’ὑπηοῖοι σὺν τεύχεσι θωρηχθέντες	-u u--- - -uu ----	dactylic hexameter	masculine penthemimeral
στησόμεθ’ ἂμ πύργους· τῷ δ’ἄλγιον, αἴ κ’ἐθέλῃσιν	-uu - -- - -uu - uu--	dactylic hexameter	masculine penthemimeral, trithemimeral
ἐλθὼν ἐκ νηῶν περὶ τείχεος ἄμμι μάχεσθαι.	-- - -- uu -uu -u u--	dactylic hexameter	masculine penthemimeral, trithemimeral
ἂψ πάλιν εἶσ’ ἐπὶ νῆας, ἐπεί κ’ἐριαύχενας ἵππους	- uu - uu -u u- uu-uu --	dactylic hexameter	feminine penthemimeral, hepthemimeral, trithemimeral
παντοίου δρόμου ἄσῃ ὑπὸ πτόλιν ἠλασκάζων·	--- uu -u u- uu ----	dactylic hexameter	feminine penthemimeral, hepthemimeral, trithemimeral
εἴσω δ’οὔ μιν θυμὸς ἐφορμηθῆναι ἐάσει,	-- - - -u u---u u--	dactylic hexameter	feminine penthemimeral, trithemimeral
οὐδέ ποτ’ ἐκπέρσει· πρίν μιν κύνες ἀργοὶ ἔδονται.	-u u --- - - uu -u u--	dactylic hexameter	masculine penthemimeral, hepthemimeral
τὸν δ’ἄρ’ ὑπόδρα ἰδὼν προσέφη κορυθαίολος Ἕκτωρ·	- u u-u u- uu- uu-uu --	dactylic hexameter	masculine penthemimeral, hepthemimeral
Πουλυδάμα σὺ μὲν οὐκέτ’ ἐμοὶ φίλα ταῦτ’ ἀγορεύεις,	-uu- u u -u u- uu - uu--	dactylic hexameter	feminine penthemimeral, hepthemimeral, trithemimeral
ὃς κέλεαι κατὰ ἄστυ ἀλήμεναι αὖτις ἰόντας.	- uu- uu -u u-uu -u u--	dactylic hexameter	feminine penthemimeral, trithemimeral
ἦ οὔ πω κεκόρησθε ἐελμένοι ἔνδοθι πύργων;	- - - uu-u u-uu -uu --	dactylic hexameter	feminine penthemimeral, trithemimeral
πρὶν μὲν γὰρ Πριάμοιο πόλιν μέροπες ἄνθρωποι	- - - uu-u u- uu- ---	dactylic hexameter	feminine penthemimeral, hepthemimeral, trithemimeral
πάντες μυθέσκοντο πολύχρυσον πολύχαλκον·	-- ---u u--- uu--	dactylic hexameter	feminine penthemimeral
νῦν δὲ δὴ ἐξαπόλωλε δόμων κειμήλια καλά,	- u u -uu-u u- --uu --	dactylic hexameter	feminine penthemimeral, hepthemimeral
πολλὰ δὲ δὴ Φρυγίην καὶ Μῃονίην ἐρατεινὴν	-u u - uu- - -uu- uu--	dactylic hexameter	masculine penthemimeral, trithemimeral
κτήματα περνάμεν’ ἵκει, ἐπεὶ μέγας ὠδύσατο Ζεύς.	-uu -uu -u u- uu -uu- -	dactylic hexameter	feminine penthemimeral, hepthemimeral
νῦν δ’ὅτε πέρ μοι ἔδωκε Κρόνου πάϊς ἀγκυλομήτεω	- uu - u u-u u- uu -uu--	dactylic hexameter	feminine penthemimeral, hepthemimeral, trithemimeral
κῦδος ἀρέσθ’ ἐπὶ νηυσί, θαλάσσῃ τ’ἔλσαι Ἀχαιούς,	-u u- uu -u u-- -u u--	dactylic hexameter	feminine penthemimeral, trithemimeral
νήπιε μηκέτι ταῦτα νοήματα φαῖν’ ἐνὶ δήμῳ·	-uu -uu -u u-uu - uu --	dactylic hexameter	feminine penthemimeral
οὐ γάρ τις Τρώων ἐπιπείσεται· οὐ γὰρ ἐάσω.	- - - -- uu-uu - u u--	dactylic hexameter	masculine penthemimeral, trithemimeral
ἀλλ’ ἄγεθ’ ὡς ἂν ἐγὼ εἴπω, πειθώμεθα πάντες.	- uu - u u- -- --uu --	dactylic hexameter	masculine penthemimeral, hepthemimeral, trithemimeral
νῦν μὲν δόρπον ἕλεσθε κατὰ στρατὸν ἐν τελέεσσι,	- - -u u-u u- uu - uu--	dactylic hexameter	feminine penthemimeral, hepthemimeral
καὶ φυλακῆς μνήσασθε, καὶ ἐγρήγορθε ἕκαστος·	- uu- --u u ---u u--	dactylic hexameter	feminine penthemimeral, trithemimeral
Τρώων δ’ὃς κτεάτεσσιν ὑπερφιάλως ἀνιάζει,	-- - uu-u u-uu- uu--	dactylic hexameter	feminine penthemimeral, trithemimeral
συλλέξας λαοῖσι δότω καταδημοβορῆσαι·	--- --u u- uu-uu--	dactylic hexameter	feminine penthemimeral, hepthemimeral, trithemimeral
τῶν τινὰ βέλτερόν ἐστιν ἐπαυρέμεν ἤ περ Ἀχαιούς.	- uu -uu -u u-uu - u u--	dactylic hexameter	feminine penthemimeral
πρῶϊ δ’ὑπηοῖοι σὺν τεύχεσι θωρηχθέντες	-u u--- - -uu ----	dactylic hexameter	masculine penthemimeral
νηυσὶν ἔπι γλαφυρῇσιν ἐγείρομεν ὀξὺν Ἄρηα.	-u u- uu-u u-uu -u u--	dactylic hexameter	feminine penthemimeral, trithemimeral
εἰ δ’ἐτεὸν παρὰ ναῦφιν ἀνέστη δῖος Ἀχιλλεύς,	- uu- uu -u u-- -u u--	dactylic hexameter	feminine penthemimeral, trithemimeral
ἄλγιον αἴ κ’ἐθέλῃσι τῷ ἔσσεται· οὔ μιν ἔγωγε	-uu - uu-u u -uu - u u--	dactylic hexameter	feminine penthemimeral, trithemimeral
φεύξομαι ἐκ πολέμοιο δυσηχέος, ἀλλὰ μάλ’ ἄντην	-uu - uu-u u-uu -u u --	dactylic hexameter	feminine penthemimeral, trithemimeral
στήσομαι, ἤ κε φέρῃσι μέγα κράτος, ἦ κε φεροίμην.	-uu - u u-u u- uu - u u--	dactylic hexameter	feminine penthemimeral, hepthemimeral, trithemimeral
ξυνὸς Ἐνυάλιος, καί τε κτανέοντα κατέκτα.	-u u-uu- - - uu-u u--	dactylic hexameter	masculine penthemimeral, hepthemimeral
ὣς Ἕκτωρ ἀγόρευ’, ἐπὶ δὲ Τρῶες κελάδησαν	- -- uu- uu - -- uu--	dactylic hexameter	masculine penthemimeral, hepthemimeral, trithemimeral
νήπιοι· ἐκ γάρ σφεων φρένας εἵλετο Παλλὰς Ἀθήνη.	-uu - - - uu -uu -u u--	dactylic hexameter	masculine penthemimeral, trithemimeral
Ἕκτορι μὲν γὰρ ἐπῄνησαν κακὰ μητιόωντι,	-uu - u u--- uu -uu--	dactylic hexameter	hepthemimeral, trithemimeral
Πουλυδάμαντι δ’ἄρ’ οὔ τις ὃς ἐσθλὴν φράζετο βουλήν.	-uu-u u - u u -- -uu --	dactylic hexameter	masculine penthemimeral
δόρπον ἔπειθ’ εἵλοντο κατὰ στρατόν· αὐτὰρ Ἀχαιοὶ	-u u- --u u- uu -u u--	dactylic hexameter	feminine penthemimeral, hepthemimeral, trithemimeral
παννύχιοι Πάτροκλον ἀνεστενάχοντο γοῶντες.	-uu- --u u-uu-u u--	dactylic hexameter	feminine penthemimeral, trithemimeral
τοῖσι δὲ Πηλεΐδης ἁδινοῦ ἐξῆρχε γόοιο	-u u -uu- uu- --u u--	dactylic hexameter	masculine penthemimeral, hepthemimeral
χεῖρας ἐπ’ ἀνδροφόνους θέμενος στήθεσσιν ἑταίρου	-u u -uu- uu- --u u--	dactylic hexameter	masculine penthemimeral, hepthemimeral
πυκνὰ μάλα στενάχων ὥς τε λὶς ἠϋγένειος,	-u u- uu- - - - -uu--	dactylic hexameter	masculine penthemimeral, hepthemimeral, trithemimeral
ᾧ ῥά θ’ὑπὸ σκύμνους ἐλαφηβόλος ἁρπάσῃ ἀνὴρ	- u u- -- uu-uu -uu --	dactylic hexameter	masculine penthemimeral, trithemimeral
ὕλης ἐκ πυκινῆς· ὃ δέ τ’ἄχνυται ὕστερος ἐλθών,	-- - uu- u u -uu -uu --	dactylic hexameter	masculine penthemimeral, trithemimeral
πολλὰ δέ τ’ἄγκε’ ἐπῆλθε μετ’ ἀνέρος ἴχνι’ ἐρευνῶν	-u u -u u-u u -uu -u u--	dactylic hexameter	feminine penthemimeral
εἴ ποθεν ἐξεύροι· μάλα γὰρ δριμὺς χόλος αἱρεῖ·	- uu --- uu - -- uu --	dactylic hexameter	masculine penthemimeral, hepthemimeral
ὣς ὃ βαρὺ στενάχων μετεφώνεε Μυρμιδόνεσσιν·	- u u- uu- uu-uu -uu--	dactylic hexameter	masculine penthemimeral, trithemimeral
ὢ πόποι ἦ ῥ’ἅλιον ἔπος ἔκβαλον ἤματι κείνῳ	- uu - uu- uu -uu -uu --	dactylic hexameter	masculine penthemimeral, trithemimeral
θαρσύνων ἥρωα Μενοίτιον ἐν μεγάροισι·	--- --u u-uu - uu--	dactylic hexameter	feminine penthemimeral, trithemimeral
φῆν δέ οἱ εἰς Ὀπόεντα περικλυτὸν υἱὸν ἀπάξειν	- u u - uu-u u-uu -u u--	dactylic hexameter	feminine penthemimeral, trithemimeral
Ἴλιον ἐκπέρσαντα, λαχόντα τε ληΐδος αἶσαν.	-uu ---u u-u u -uu --	dactylic hexameter	feminine penthemimeral
ἀλλ’ οὐ Ζεὺς ἄνδρεσσι νοήματα πάντα τελευτᾷ·	- - - --u u-uu -u u--	dactylic hexameter	feminine penthemimeral, trithemimeral
ἄμφω γὰρ πέπρωται ὁμοίην γαῖαν ἐρεῦσαι	-- - --u u-- -u u--	dactylic hexameter	feminine penthemimeral, trithemimeral
αὐτοῦ ἐνὶ Τροίῃ, ἐπεὶ οὐδ’ ἐμὲ νοστήσαντα	-u u- -- uu - uu ----	dactylic hexameter	masculine penthemimeral, hepthemimeral, trithemimeral
δέξεται ἐν μεγάροισι γέρων ἱππηλάτα Πηλεὺς	-uu - uu-u u- --uu --	dactylic hexameter	feminine penthemimeral, hepthemimeral, trithemimeral
οὐδὲ Θέτις μήτηρ, ἀλλ’ αὐτοῦ γαῖα καθέξει.	-u u- -- - -- -u u--	dactylic hexameter	masculine penthemimeral, trithemimeral
νῦν δ’ἐπεὶ οὖν Πάτροκλε σεῦ ὕστερος εἶμ’ ὑπὸ γαῖαν,	- uu - --u u -uu - uu --	dactylic hexameter	feminine penthemimeral, trithemimeral
οὔ σε πρὶν κτεριῶ πρίν γ’Ἕκτορος ἐνθάδ’ ἐνεῖκαι	- - - uu- - -uu -u u--	dactylic hexameter	masculine penthemimeral, trithemimeral
τεύχεα καὶ κεφαλὴν μεγαθύμου σοῖο φονῆος·	-uu - uu- uu-- -u u--	dactylic hexameter	masculine penthemimeral, trithemimeral
δώδεκα δὲ προπάροιθε πυρῆς ἀποδειροτομήσω	-uu - uu-u u- uu-uu--	dactylic hexameter	feminine penthemimeral, hepthemimeral, trithemimeral
Τρώων ἀγλαὰ τέκνα σέθεν κταμένοιο χολωθείς.	-- -uu -u u- uu-u u--	dactylic hexameter	feminine penthemimeral, hepthemimeral
τόφρα δέ μοι παρὰ νηυσὶ κορωνίσι κείσεαι αὔτως,	-u u - uu -u u-uu -uu --	dactylic hexameter	feminine penthemimeral, trithemimeral
ἀμφὶ δὲ σὲ Τρῳαὶ καὶ Δαρδανίδες βαθύκολποι	-u u - -- - -uu- uu--	dactylic hexameter	masculine penthemimeral, trithemimeral
κλαύσονται νύκτάς τε καὶ ἤματα δάκρυ χέουσαι,	--- -- u u -uu -u u--	dactylic hexameter	masculine penthemimeral, trithemimeral
τὰς αὐτοὶ καμόμεσθα βίηφί τε δουρί τε μακρῷ	- -- uu-u u-u u -u u --	dactylic hexameter	feminine penthemimeral, trithemimeral
πιείρας πέρθοντε πόλεις μερόπων ἀνθρώπων.	--- --u u- uu- ---	dactylic hexameter	feminine penthemimeral, hepthemimeral, trithemimeral
ὣς εἰπὼν ἑτάροισιν ἐκέκλετο δῖος Ἀχιλλεὺς	- -- uu-u u-uu -u u--	dactylic hexameter	feminine penthemimeral, trithemimeral
ἀμφὶ πυρὶ στῆσαι τρίποδα μέγαν, ὄφρα τάχιστα	-u u- -- uu- uu -u u--	dactylic hexameter	masculine penthemimeral, hepthemimeral, trithemimeral
Πάτροκλον λούσειαν ἄπο βρότον αἱματόεντα.	--- --u u- uu -uu--	dactylic hexameter	feminine penthemimeral, hepthemimeral, trithemimeral
οἳ δὲ λοετροχόον τρίποδ’ ἵστασαν ἐν πυρὶ κηλέῳ,	- u u-uu- uu -uu - uu --	dactylic hexameter	masculine penthemimeral
ἐν δ’ἄρ’ ὕδωρ ἔχεαν, ὑπὸ δὲ ξύλα δαῖον ἑλόντες.	- u u- uu- uu - uu -u u--	dactylic hexameter	masculine penthemimeral, hepthemimeral, trithemimeral
γάστρην μὲν τρίποδος πῦρ ἄμφεπε, θέρμετο δ’ὕδωρ·	-- - uu- - -uu -uu --	dactylic hexameter	masculine penthemimeral, trithemimeral
αὐτὰρ ἐπεὶ δὴ ζέσσεν ὕδωρ ἐνὶ ἤνοπι χαλκῷ,	-u u- - -u u- uu -uu --	dactylic hexameter	feminine penthemimeral, hepthemimeral, trithemimeral
καὶ τότε δὴ λοῦσάν τε καὶ ἤλειψαν λίπ’ ἐλαίῳ,	- uu - -- u u --- u u--	dactylic hexameter	masculine penthemimeral, trithemimeral
ἐν δ’ὠτειλὰς πλῆσαν ἀλείφατος ἐννεώροιο·	- --- -u u-uu ----	dactylic hexameter	feminine penthemimeral
ἐν λεχέεσσι δὲ θέντες ἑανῷ λιτὶ κάλυψαν	- uu-u u -u u-- -u u--	dactylic hexameter	feminine penthemimeral
ἐς πόδας ἐκ κεφαλῆς, καθύπερθε δὲ φάρεϊ λευκῷ.	- uu - uu- uu-u u -uu --	dactylic hexameter	masculine penthemimeral, trithemimeral
παννύχιοι μὲν ἔπειτα πόδας ταχὺν ἀμφ’ Ἀχιλῆα	-uu- u u-u u- uu - uu--	dactylic hexameter	feminine penthemimeral, hepthemimeral, trithemimeral
Μυρμιδόνες Πάτροκλον ἀνεστενάχοντο γοῶντες·	-uu- --u u-uu-u u--	dactylic hexameter	feminine penthemimeral, trithemimeral
Ζεὺς δ’Ἥρην προσέειπε κασιγνήτην ἄλοχόν τε·	- -- uu-u u--- uu- -	dactylic hexameter	feminine penthemimeral, trithemimeral
ἔπρηξας καὶ ἔπειτα βοῶπις πότνια Ἥρη	--- u u-u u-- -uu --	dactylic hexameter	feminine penthemimeral, trithemimeral
ἀνστήσασ’ Ἀχιλῆα πόδας ταχύν· ἦ ῥά νυ σεῖο	--- uu-u u- uu - u u --	dactylic hexameter	feminine penthemimeral, hepthemimeral, trithemimeral
ἐξ αὐτῆς ἐγένοντο κάρη κομόωντες Ἀχαιοί.	- -- uu-u u- uu-u u--	dactylic hexameter	feminine penthemimeral, hepthemimeral, trithemimeral
τὸν δ’ἠμείβετ’ ἔπειτα βοῶπις πότνια Ἥρη·	- --u u-u u-- -uu --	dactylic hexameter	feminine penthemimeral
αἰνότατε Κρονίδη ποῖον τὸν μῦθον ἔειπες.	-uu- uu- -- - -u u--	dactylic hexameter	masculine penthemimeral, hepthemimeral, trithemimeral
καὶ μὲν δή πού τις μέλλει βροτὸς ἀνδρὶ τελέσσαι,	- - - - - -- uu -u u--	dactylic hexameter	masculine penthemimeral, hepthemimeral, trithemimeral
ὅς περ θνητός τ’ἐστὶ καὶ οὐ τόσα μήδεα οἶδε·	- - -- -u u - uu -uu --	dactylic hexameter	feminine penthemimeral, hepthemimeral
πῶςδὴ ἔγωγ’, ἥ φημι θεάων ἔμμεν ἀρίστη,	-u u- - -u u-- -u u--	dactylic hexameter	feminine penthemimeral, trithemimeral
ἀμφότερον γενεῇ τε καὶ οὕνεκα σὴ παράκοιτις	-uu- uu- u u -uu - uu--	dactylic hexameter	masculine penthemimeral, trithemimeral
κέκλημαι, σὺ δὲ πᾶσι μετ’ ἀθανάτοισιν ἀνάσσεις,	--- u u -u u -uu-u u--	dactylic hexameter	feminine penthemimeral, trithemimeral
οὐκ ὄφελον Τρώεσσι κοτεσσαμένη κακὰ ῥάψαι;	- uu- --u u-uu- uu --	dactylic hexameter	feminine penthemimeral, trithemimeral
ὣς οἳ μὲν τοιαῦτα πρὸς ἀλλήλους ἀγόρευον·	- - - --u u --- uu--	dactylic hexameter	feminine penthemimeral, trithemimeral
Ἡφαίστου δ’ἵκανε δόμον Θέτις ἀργυρόπεζα	--- --u u- uu -uu--	dactylic hexameter	feminine penthemimeral, hepthemimeral, trithemimeral
ἄφθιτον ἀστερόεντα μεταπρεπέ’ ἀθανάτοισι	-uu -uu-u u-uu -uu--	dactylic hexameter	feminine penthemimeral
χάλκεον, ὅν ῥ’αὐτὸς ποιήσατο κυλλοποδίων.	-uu - -- --uu -uu--	dactylic hexameter	masculine penthemimeral, trithemimeral
τὸν δ’εὗρ’ ἱδρώοντα ἑλισσόμενον περὶ φύσας	- - ---u u-uu- uu --	dactylic hexameter	feminine penthemimeral
σπεύδοντα· τρίποδας γὰρ ἐείκοσι πάντας ἔτευχεν	--- uu- u u-uu -u u--	dactylic hexameter	masculine penthemimeral, trithemimeral
ἑστάμεναι περὶ τοῖχον ἐϋσταθέος μεγάροιο,	-uu- uu -u u-uu- uu--	dactylic hexameter	feminine penthemimeral, trithemimeral
χρύσεα δέ σφ’ὑπὸ κύκλα ἑκάστῳ πυθμένι θῆκεν,	-uu - uu -u u-- -uu --	dactylic hexameter	feminine penthemimeral, trithemimeral
ὄφρά οἱ αὐτόματοι θεῖον δυσαίατ’ ἀγῶνα	-u u -uu- -- --u u--	dactylic hexameter	masculine penthemimeral, hepthemimeral
ἠδ’ αὖτις πρὸς δῶμα νεοίατο θαῦμα ἰδέσθαι.	- -- - -u u-uu -u u--	dactylic hexameter	feminine penthemimeral, trithemimeral
οἳ δ’ἤτοι τόσσον μὲν ἔχον τέλος, οὔατα δ’οὔ πω	- -- -- u u- uu -uu - -	dactylic hexameter	masculine penthemimeral, hepthemimeral, trithemimeral
δαιδάλεα προσέκειτο· τά ῥ’ἤρτυε, κόπτε δὲ δεσμούς.	-uu- uu-u u -uu -u u --	dactylic hexameter	feminine penthemimeral, trithemimeral
ὄφρ’ ὅ γε ταῦτ’ ἐπονεῖτο ἰδυίῃσι πραπίδεσσι,	- u u - uu-u u--- uu--	dactylic hexameter	feminine penthemimeral, trithemimeral
τόφρά οἱ ἐγγύθεν ἦλθε θεὰ Θέτις ἀργυρόπεζα.	-u u -uu -u u- uu -uu--	dactylic hexameter	feminine penthemimeral, hepthemimeral
τὴν δὲ ἴδε προμολοῦσα Χάρις λιπαροκρήδεμνος	- u u- uu-u u- uu----	dactylic hexameter	feminine penthemimeral, hepthemimeral, trithemimeral
καλή, τὴν ὤπυιε περικλυτὸς ἀμφιγυήεις·	-- - --u u-uu -uu--	dactylic hexameter	feminine penthemimeral, trithemimeral
ἔν τ’ἄρα οἱ φῦ χειρὶ ἔπος τ’ἔφατ’ ἔκ τ’ὀνόμαζε·	- uu - - -u u- uu - uu--	dactylic hexameter	feminine penthemimeral, hepthemimeral, trithemimeral
τίπτε Θέτι τανύπεπλε ἱκάνεις ἡμέτερον δῶ	-u u- uu-u u-- -uu- -	dactylic hexameter	feminine penthemimeral, trithemimeral
αἰδοίη τε φίλη τε; πάρος γε μὲν οὔ τι θαμίζεις.	--- u u- u u- u u - u u--	dactylic hexameter	masculine penthemimeral, hepthemimeral, trithemimeral
ἀλλ’ ἕπεο προτέρω, ἵνα τοι πὰρ ξείνια θείω.	- uu- uu- uu - - -uu --	dactylic hexameter	masculine penthemimeral, hepthemimeral, trithemimeral
ὣς ἄρα φωνήσασα πρόσω ἄγε δῖα θεάων.	- uu ---u u- uu -u u--	dactylic hexameter	feminine penthemimeral, hepthemimeral
τὴν μὲν ἔπειτα καθεῖσεν ἐπὶ θρόνου ἀργυροήλου	- u u-u u-u u- uu -uu--	dactylic hexameter	feminine penthemimeral, hepthemimeral
καλοῦ δαιδαλέου· ὑπὸ δὲ θρῆνυς ποσὶν ἦεν·	-- -uu- uu - -- uu --	dactylic hexameter	masculine penthemimeral, hepthemimeral
κέκλετο δ’Ἥφαιστον κλυτοτέχνην εἶπέ τε μῦθον·	-uu --- uu-- -u u --	dactylic hexameter	masculine penthemimeral
Ἥφαιστε πρόμολ’ ὧδε· Θέτις νύ τι σεῖο χατίζει.	--- uu -u u- u u -u u--	dactylic hexameter	feminine penthemimeral, hepthemimeral, trithemimeral
τὴν δ’ἠμείβετ’ ἔπειτα περικλυτὸς ἀμφιγυήεις·	- --u u-u u-uu -uu--	dactylic hexameter	feminine penthemimeral
ἦ ῥά νύ μοι δεινή τε καὶ αἰδοίη θεὸς ἔνδον,	- u u - -- u u --- uu --	dactylic hexameter	masculine penthemimeral, trithemimeral
ἥ μ’ἐσάωσ’ ὅτε μ’ἄλγος ἀφίκετο τῆλε πεσόντα	- uu- uu -u u-uu -u u--	dactylic hexameter	feminine penthemimeral, trithemimeral
μητρὸς ἐμῆς ἰότητι κυνώπιδος, ἥ μ’ἐθέλησε	-u u- uu-u u-uu - uu--	dactylic hexameter	feminine penthemimeral, trithemimeral
κρύψαι χωλὸν ἐόντα· τότ’ ἂν πάθον ἄλγεα θυμῷ,	-- -u u-u u - uu -uu --	dactylic hexameter	feminine penthemimeral, hepthemimeral
εἰ μή μ’Εὐρυνόμη τε Θέτις θ’ὑπεδέξατο κόλπῳ	- - -uu- u u- uu-uu --	dactylic hexameter	masculine penthemimeral, hepthemimeral
Εὐρυνόμη θυγάτηρ ἀψορρόου Ὠκεανοῖο.	-uu- uu- --uu -uu--	dactylic hexameter	masculine penthemimeral, trithemimeral
τῇσι παρ’ εἰνάετες χάλκευον δαίδαλα πολλά,	-u u -uu- --- -uu --	dactylic hexameter	masculine penthemimeral
πόρπας τε γναμπτάς θ’ἕλικας κάλυκάς τε καὶ ὅρμους	-- - -- uu- uu- u u --	dactylic hexameter	masculine penthemimeral, hepthemimeral, trithemimeral
ἐν σπῆϊ γλαφυρῷ· περὶ δὲ ῥόος Ὠκεανοῖο	- -- uu- uu - uu -uu--	dactylic hexameter	masculine penthemimeral, hepthemimeral, trithemimeral
ἀφρῷ μορμύρων ῥέεν ἄσπετος· οὐδέ τις ἄλλος	-- --- uu -uu -u u --	dactylic hexameter	masculine penthemimeral
ᾔδεεν οὔτε θεῶν οὔτε θνητῶν ἀνθρώπων,	-uu -u u- -- -- ---	dactylic hexameter	masculine penthemimeral, hepthemimeral
ἀλλὰ Θέτις τε καὶ Εὐρυνόμη ἴσαν, αἵ μ’ἐσάωσαν.	-u u- u u -uu- uu - uu--	dactylic hexameter	hepthemimeral, trithemimeral
ἣ νῦν ἡμέτερον δόμον ἵκει· τώ με μάλα χρεὼ	- - -uu- uu -- - u u- -	dactylic hexameter	masculine penthemimeral
πάντα Θέτι καλλιπλοκάμῳ ζῳάγρια τίνειν.	-u u- --uu- --uu --	dactylic hexameter	hepthemimeral, trithemimeral
ἀλλὰ σὺ μὲν νῦν οἱ παράθες ξεινήϊα καλά,	-u u - - - uu- --uu --	dactylic hexameter	masculine penthemimeral, hepthemimeral, trithemimeral
ὄφρ’ ἂν ἐγὼ φύσας ἀποθείομαι ὅπλά τε πάντα.	- u u- -- uu-uu -u u --	dactylic hexameter	masculine penthemimeral, trithemimeral
ἦ, καὶ ἀπ’ ἀκμοθέτοιο πέλωρ αἴητον ἀνέστη	- u u -uu-u u- --u u--	dactylic hexameter	feminine penthemimeral, hepthemimeral
χωλεύων· ὑπὸ δὲ κνῆμαι ῥώοντο ἀραιαί.	--- uu - -- --u u--	dactylic hexameter	masculine penthemimeral, hepthemimeral, trithemimeral
φύσας μέν ῥ’ἀπάνευθε τίθει πυρός, ὅπλά τε πάντα	-- - uu-u u- uu -u u --	dactylic hexameter	feminine penthemimeral, hepthemimeral, trithemimeral
λάρνακ’ ἐς ἀργυρέην συλλέξατο, τοῖς ἐπονεῖτο·	-u u -uu- --uu - uu--	dactylic hexameter	masculine penthemimeral
σπόγγῳ δ’ἀμφὶ πρόσωπα καὶ ἄμφω χεῖρ’ ἀπομόργνυ	-- -u u-u u -- - uu--	dactylic hexameter	feminine penthemimeral
αὐχένα τε στιβαρὸν καὶ στήθεα λαχνήεντα,	-uu - uu- - -uu ----	dactylic hexameter	masculine penthemimeral, trithemimeral
δῦ δὲ χιτῶν’, ἕλε δὲ σκῆπτρον παχύ, βῆ δὲ θύραζε	- u u- uu - -- uu - u u--	dactylic hexameter	masculine penthemimeral, hepthemimeral, trithemimeral
χωλεύων· ὑπὸ δ’ἀμφίπολοι ῥώοντο ἄνακτι	--- uu -uu- --u u--	dactylic hexameter	hepthemimeral, trithemimeral
χρύσειαι ζωῇσι νεήνισιν εἰοικυῖαι.	--- --u u-uu ----	dactylic hexameter	feminine penthemimeral, trithemimeral
τῇς ἐν μὲν νόος ἐστὶ μετὰ φρεσίν, ἐν δὲ καὶ αὐδὴ	- - - uu -u u- uu - u u --	dactylic hexameter	feminine penthemimeral, hepthemimeral, trithemimeral
καὶ σθένος, ἀθανάτων δὲ θεῶν ἄπο ἔργα ἴσασιν.	- uu -uu- u u- uu -u u--	dactylic hexameter	masculine penthemimeral, hepthemimeral
αἳ μὲν ὕπαιθα ἄνακτος ἐποίπνυον· αὐτὰρ ὃ ἔρρων	- u u-u u-u u-uu -u u --	dactylic hexameter	feminine penthemimeral
πλησίον, ἔνθα Θέτις περ, ἐπὶ θρόνου ἷζε φαεινοῦ,	-uu -u u- u u- uu -u u--	dactylic hexameter	masculine penthemimeral, hepthemimeral
ἔν τ’ἄρα οἱ φῦ χειρὶ ἔπος τ’ἔφατ’ ἔκ τ’ὀνόμαζε·	- uu - - -u u- uu - uu--	dactylic hexameter	feminine penthemimeral, hepthemimeral, trithemimeral
τίπτε Θέτι τανύπεπλε ἱκάνεις ἡμέτερον δῶ	-u u- uu-u u-- -uu- -	dactylic hexameter	feminine penthemimeral, trithemimeral
αἰδοίη τε φίλη τε; πάρος γε μὲν οὔ τι θαμίζεις.	--- u u- u u- u u - u u--	dactylic hexameter	masculine penthemimeral, hepthemimeral, trithemimeral
αὔδα ὅ τι φρονέεις· τελέσαι δέ με θυμὸς ἄνωγεν,	-u u - uu- uu- u u -u u--	dactylic hexameter	masculine penthemimeral, hepthemimeral, trithemimeral
εἰ δύναμαι τελέσαι γε καὶ εἰ τετελεσμένον ἐστίν.	- uu- uu- u u - uu-uu --	dactylic hexameter	masculine penthemimeral, hepthemimeral, trithemimeral
τὸν δ’ἠμείβετ’ ἔπειτα Θέτις κατὰ δάκρυ χέουσα·	- --u u-u u- uu -u u--	dactylic hexameter	feminine penthemimeral, hepthemimeral
Ἥφαιστ’, ἦ ἄρα δή τις, ὅσαι θεαί εἰσ’ ἐν Ὀλύμπῳ,	-- - uu - u u- uu - u u--	dactylic hexameter	masculine penthemimeral, hepthemimeral, trithemimeral
τοσσάδ’ ἐνὶ φρεσὶν ᾗσιν ἀνέσχετο κήδεα λυγρὰ	-u u- uu -u u-uu -uu --	dactylic hexameter	feminine penthemimeral, trithemimeral
ὅσσ’ ἐμοὶ ἐκ πασέων Κρονίδης Ζεὺς ἄλγε’ ἔδωκεν;	- uu - -- uu- - -u u--	dactylic hexameter	masculine penthemimeral, hepthemimeral, trithemimeral
ἐκ μέν μ’ἀλλάων ἁλιάων ἀνδρὶ δάμασσεν	- - --- uu-- -u u--	dactylic hexameter	masculine penthemimeral
Αἰακίδῃ Πηλῆϊ, καὶ ἔτλην ἀνέρος εὐνὴν	-uu- --u u -- -uu --	dactylic hexameter	feminine penthemimeral, trithemimeral
πολλὰ μάλ’ οὐκ ἐθέλουσα. ὃ μὲν δὴ γήραϊ λυγρῷ	-u u - uu-u u - - -uu --	dactylic hexameter	feminine penthemimeral, hepthemimeral, trithemimeral
κεῖται ἐνὶ μεγάροις ἀρημένος, ἄλλα δέ μοι νῦν,	-u u- uu- --uu -u u - -	dactylic hexameter	masculine penthemimeral, trithemimeral
υἱὸν ἐπεί μοι δῶκε γενέσθαί τε τραφέμεν τε	-u u- - -u u-- - uu- -	dactylic hexameter	feminine penthemimeral, trithemimeral
ἔξοχον ἡρώων· ὃ δ’ἀνέδραμεν ἔρνεϊ ἶσος·	-uu --- u u-uu -uu --	dactylic hexameter	masculine penthemimeral
τὸν μὲν ἐγὼ θρέψασα φυτὸν ὣς γουνῷ ἀλωῆς	- u u- --u u- - -u u--	dactylic hexameter	feminine penthemimeral, hepthemimeral, trithemimeral
νηυσὶν ἐπιπροέηκα κορωνίσιν Ἴλιον εἴσω	-u u-uu-u u-uu -uu --	dactylic hexameter	feminine penthemimeral
Τρωσὶ μαχησόμενον· τὸν δ’οὐχ ὑποδέξομαι αὖτις	-u u-uu- - - uu-uu --	dactylic hexameter	masculine penthemimeral, hepthemimeral
οἴκαδε νοστήσαντα δόμον Πηλήϊον εἴσω.	-uu ---u u- --uu --	dactylic hexameter	feminine penthemimeral, hepthemimeral
ὄφρα δέ μοι ζώει καὶ ὁρᾷ φάος ἠελίοιο	-u u - -- u u- uu -uu--	dactylic hexameter	masculine penthemimeral, hepthemimeral, trithemimeral
ἄχνυται, οὐδέ τί οἱ δύναμαι χραισμῆσαι ἰοῦσα.	-uu -u u - uu- --u u--	dactylic hexameter	masculine penthemimeral, hepthemimeral
κούρην ἣν ἄρα οἱ γέρας ἔξελον υἷες Ἀχαιῶν,	-- - uu - uu -uu -u u--	dactylic hexameter	masculine penthemimeral, trithemimeral
τὴν ἂψ ἐκ χειρῶν ἕλετο κρείων Ἀγαμέμνων.	- - - -- uu- -- uu--	dactylic hexameter	masculine penthemimeral, hepthemimeral, trithemimeral
ἤτοι ὃ τῆς ἀχέων φρένας ἔφθιεν· αὐτὰρ Ἀχαιοὺς	-u u - uu- uu -uu -u u--	dactylic hexameter	masculine penthemimeral, trithemimeral
Τρῶες ἐπὶ πρύμνῃσιν ἐείλεον, οὐδὲ θύραζε	-u u- --u u-uu -u u--	dactylic hexameter	feminine penthemimeral, trithemimeral
εἴων ἐξιέναι· τὸν δὲ λίσσοντο γέροντες	-- -uu- - - --u u--	dactylic hexameter	masculine penthemimeral, hepthemimeral
Ἀργείων, καὶ πολλὰ περικλυτὰ δῶρ’ ὀνόμαζον.	--- - -u u-uu - uu--	dactylic hexameter	feminine penthemimeral, trithemimeral
ἔνθ’ αὐτὸς μὲν ἔπειτ’ ἠναίνετο λοιγὸν ἀμῦναι,	- -- u u- --uu -u u--	dactylic hexameter	masculine penthemimeral, trithemimeral
αὐτὰρ ὃ Πάτροκλον περὶ μὲν τὰ ἃ τεύχεα ἕσσε,	-u u --- uu - u u -uu --	dactylic hexameter	masculine penthemimeral, hepthemimeral
πέμπε δέ μιν πόλεμον δέ, πολὺν δ’ἅμα λαὸν ὄπασσε.	-u u - uu- u u- uu -u u--	dactylic hexameter	masculine penthemimeral, hepthemimeral, trithemimeral
πᾶν δ’ἦμαρ μάρναντο περὶ Σκαιῇσι πύλῃσι·	- -- --u u- --u u--	dactylic hexameter	feminine penthemimeral, hepthemimeral, trithemimeral
καί νύ κεν αὐτῆμαρ πόλιν ἔπραθον, εἰ μὴ Ἀπόλλων	- u u --- uu -uu - u u--	dactylic hexameter	masculine penthemimeral
πολλὰ κακὰ ῥέξαντα Μενοιτίου ἄλκιμον υἱὸν	-u u- --u u-uu -uu --	dactylic hexameter	feminine penthemimeral, trithemimeral
ἔκταν’ ἐνὶ προμάχοισι καὶ Ἕκτορι κῦδος ἔδωκε.	-u u- uu-u u -uu -u u--	dactylic hexameter	feminine penthemimeral, trithemimeral
τοὔνεκα νῦν τὰ σὰ γούναθ’ ἱκάνομαι, αἴ κ’ἐθέλῃσθα	-uu - u u -u u-uu - uu--	dactylic hexameter	feminine penthemimeral, trithemimeral
υἱεῖ ἐμῷ ὠκυμόρῳ δόμεν ἀσπίδα καὶ τρυφάλειαν	-u uu -uu- uu -uu - uu--	lyric	
καὶ καλὰς κνημῖδας ἐπισφυρίοις ἀραρυίας	- -- --u u-uu- uu--	dactylic hexameter	feminine penthemimeral, trithemimeral
καὶ θώρηχ’· ὃ γὰρ ἦν οἱ ἀπώλεσε πιστὸς ἑταῖρος	- -- u u - u u-uu -u u--	dactylic hexameter	masculine penthemimeral, trithemimeral
Τρωσὶ δαμείς· ὃ δὲ κεῖται ἐπὶ χθονὶ θυμὸν ἀχεύων.	-u u- u u -u u- uu -u u--	dactylic hexameter	feminine penthemimeral, hepthemimeral, trithemimeral
τὴν δ’ἠμείβετ’ ἔπειτα περικλυτὸς ἀμφιγυήεις·	- --u u-u u-uu -uu--	dactylic hexameter	feminine penthemimeral
θάρσει· μή τοι ταῦτα μετὰ φρεσὶ σῇσι μελόντων.	-- - - -u u- uu -u u--	dactylic hexameter	feminine penthemimeral, hepthemimeral, trithemimeral
αἲ γάρ μιν θανάτοιο δυσηχέος ὧδε δυναίμην	- - - uu-u u-uu -u u--	dactylic hexameter	feminine penthemimeral, trithemimeral
νόσφιν ἀποκρύψαι, ὅτε μιν μόρος αἰνὸς ἱκάνοι,	-u u--- uu - uu -u u--	dactylic hexameter	masculine penthemimeral, hepthemimeral
ὥς οἱ τεύχεα καλὰ παρέσσεται, οἷά τις αὖτε	- - -uu -u u-uu -u u --	dactylic hexameter	feminine penthemimeral
ἀνθρώπων πολέων θαυμάσσεται, ὅς κεν ἴδηται.	--- uu- --uu - u u--	dactylic hexameter	masculine penthemimeral, trithemimeral
ὣς εἰπὼν τὴν μὲν λίπεν αὐτοῦ, βῆ δ’ἐπὶ φύσας·	- -- - - uu -- - uu --	dactylic hexameter	masculine penthemimeral, trithemimeral
τὰς δ’ἐς πῦρ ἔτρεψε κέλευσέ τε ἐργάζεσθαι.	- - - --u u-u u ----	dactylic hexameter	feminine penthemimeral, trithemimeral
φῦσαι δ’ἐν χοάνοισιν ἐείκοσι πᾶσαι ἐφύσων	-- - uu-u u-uu -u u--	dactylic hexameter	feminine penthemimeral, trithemimeral
παντοίην εὔπρηστον ἀϋτμὴν ἐξανιεῖσαι,	--- --u u-- -uu--	dactylic hexameter	feminine penthemimeral, trithemimeral
ἄλλοτε μὲν σπεύδοντι παρέμμεναι, ἄλλοτε δ’αὖτε,	-uu - --u u-uu -uu --	dactylic hexameter	feminine penthemimeral, trithemimeral
ὅππως Ἥφαιστός τ’ἐθέλοι καὶ ἔργον ἄνοιτο.	-- --- uu- - -u u--	dactylic hexameter	masculine penthemimeral, hepthemimeral
χαλκὸν δ’ἐν πυρὶ βάλλεν ἀτειρέα κασσίτερόν τε	-- - uu -u u-uu -uu- -	dactylic hexameter	feminine penthemimeral, trithemimeral
καὶ χρυσὸν τιμῆντα καὶ ἄργυρον· αὐτὰρ ἔπειτα	- -- --u u -uu -u u--	dactylic hexameter	feminine penthemimeral, trithemimeral
θῆκεν ἐν ἀκμοθέτῳ μέγαν ἄκμονα, γέντο δὲ χειρὶ	-u u -uu- uu -uu -u u --	dactylic hexameter	masculine penthemimeral
ῥαιστῆρα κρατερήν, ἑτέρηφι δὲ γέντο πυράγρην.	--- uu- uu-u u -u u--	dactylic hexameter	masculine penthemimeral, trithemimeral
ποίει δὲ πρώτιστα σάκος μέγα τε στιβαρόν τε	-- - --u u- uu - uu- -	dactylic hexameter	feminine penthemimeral, hepthemimeral, trithemimeral
πάντοσε δαιδάλλων, περὶ δ’ἄντυγα βάλλε φαεινὴν	-uu --- uu -uu -u u--	dactylic hexameter	masculine penthemimeral
τρίπλακα μαρμαρέην, ἐκ δ’ἀργύρεον τελαμῶνα.	-uu -uu- - -uu- uu--	dactylic hexameter	masculine penthemimeral
πέντε δ’ἄρ’ αὐτοῦ ἔσαν σάκεος πτύχες· αὐτὰρ ἐν αὐτῷ	-u u -u u- uu- uu -u u --	dactylic hexameter	masculine penthemimeral, hepthemimeral
ποίει δαίδαλα πολλὰ ἰδυίῃσι πραπίδεσσιν.	-- -uu -u u--- uu--	dactylic hexameter	feminine penthemimeral
ἐν μὲν γαῖαν ἔτευξ’, ἐν δ’οὐρανόν, ἐν δὲ θάλασσαν,	- - -u u- - -uu - u u--	dactylic hexameter	masculine penthemimeral
ἠέλιόν τ’ἀκάμαντα σελήνην τε πλήθουσαν,	-uu- uu-u u-- - ---	dactylic hexameter	feminine penthemimeral, trithemimeral
ἐν δὲ τὰ τείρεα πάντα, τά τ’οὐρανὸς ἐστεφάνωται,	- u u -uu -u u -uu -uu--	dactylic hexameter	feminine penthemimeral
Πληϊάδας θ’Ὑάδας τε τό τε σθένος Ὠρίωνος	-uu- uu- u u - uu ----	dactylic hexameter	masculine penthemimeral, hepthemimeral, trithemimeral
Ἄρκτόν θ’,ἣν καὶ Ἄμαξαν ἐπίκλησιν καλέουσιν,	-- - u u-u u--- uu--	dactylic hexameter	feminine penthemimeral, trithemimeral
ἥ τ’αὐτοῦ στρέφεται καί τ’Ὠρίωνα δοκεύει,	- -- uu- - ---u u--	dactylic hexameter	masculine penthemimeral, trithemimeral
οἴη δ’ἄμμορός ἐστι λοετρῶν Ὠκεανοῖο.	-- -uu -u u-- -uu--	dactylic hexameter	feminine penthemimeral
ἐν δὲ δύω ποίησε πόλεις μερόπων ἀνθρώπων	- u u- --u u- uu- ---	dactylic hexameter	feminine penthemimeral, hepthemimeral, trithemimeral
καλάς. ἐν τῇ μέν ῥα γάμοι τ’ἔσαν εἰλαπίναι τε,	-- - - - u u- uu -uu- -	dactylic hexameter	masculine penthemimeral, hepthemimeral, trithemimeral
νύμφας δ’ἐκ θαλάμων δαΐδων ὕπο λαμπομενάων	-- - uu- uu- uu -uu--	dactylic hexameter	masculine penthemimeral, hepthemimeral, trithemimeral
ἠγίνεον ἀνὰ ἄστυ, πολὺς δ’ὑμέναιος ὀρώρει·	-uu- uu -u u- uu-u u--	dactylic hexameter	feminine penthemimeral, hepthemimeral, trithemimeral
κοῦροι δ’ὀρχηστῆρες ἐδίνεον, ἐν δ’ἄρα τοῖσιν	-- ---u u-uu - uu --	dactylic hexameter	feminine penthemimeral
αὐλοὶ φόρμιγγές τε βοὴν ἔχον· αἳ δὲ γυναῖκες	-- --- u u- uu - u u--	dactylic hexameter	masculine penthemimeral, hepthemimeral
ἱστάμεναι θαύμαζον ἐπὶ προθύροισιν ἑκάστη.	-uu- --u u- uu-u u--	dactylic hexameter	feminine penthemimeral, hepthemimeral, trithemimeral
λαοὶ δ’εἰν ἀγορῇ ἔσαν ἀθρόοι· ἔνθα δὲ νεῖκος	-- - uu- uu -uu -u u --	dactylic hexameter	masculine penthemimeral, trithemimeral
ὠρώρει, δύο δ’ἄνδρες ἐνείκεον εἵνεκα ποινῆς	--- uu -u u-uu -uu --	dactylic hexameter	feminine penthemimeral, trithemimeral
ἀνδρὸς ἀποφθιμένου· ὃ μὲν εὔχετο πάντ’ ἀποδοῦναι	-u u-uu- u u -uu - uu--	dactylic hexameter	masculine penthemimeral
δήμῳ πιφαύσκων, ὃ δ’ἀναίνετο μηδὲν ἑλέσθαι·	-- --- u u-uu -u u--	dactylic hexameter	masculine penthemimeral
ἄμφω δ’ἱέσθην ἐπὶ ἴστορι πεῖραρ ἑλέσθαι.	-- --- uu -uu -u u--	dactylic hexameter	masculine penthemimeral
λαοὶ δ’ἀμφοτέροισιν ἐπήπυον ἀμφὶς ἀρωγοί·	-- -uu-u u-uu -u u--	dactylic hexameter	feminine penthemimeral
κήρυκες δ’ἄρα λαὸν ἐρήτυον· οἳ δὲ γέροντες	--- uu -u u-uu - u u--	dactylic hexameter	feminine penthemimeral, trithemimeral
εἵατ’ ἐπὶ ξεστοῖσι λίθοις ἱερῷ ἐνὶ κύκλῳ,	-u u- --u u- uu- uu --	dactylic hexameter	feminine penthemimeral, hepthemimeral, trithemimeral
σκῆπτρα δὲ κηρύκων ἐν χέρσ’ ἔχον ἠεροφώνων·	-u u --- - - uu -uu--	dactylic hexameter	masculine penthemimeral, hepthemimeral
τοῖσιν ἔπειτ’ ἤϊσσον, ἀμοιβηδὶς δὲ δίκαζον.	-u u- --u u--- u u--	dactylic hexameter	feminine penthemimeral, trithemimeral
κεῖτο δ’ἄρ’ ἐν μέσσοισι δύω χρυσοῖο τάλαντα,	-u u - --u u- --u u--	dactylic hexameter	feminine penthemimeral, hepthemimeral, trithemimeral
τῷ δόμεν ὃς μετὰ τοῖσι δίκην ἰθύντατα εἴποι.	- uu - uu -u u- --uu --	dactylic hexameter	feminine penthemimeral, hepthemimeral, trithemimeral
τὴν δ’ἑτέρην πόλιν ἀμφὶ δύω στρατοὶ ἥατο λαῶν	- uu- uu -u u- uu -uu --	dactylic hexameter	feminine penthemimeral, hepthemimeral, trithemimeral
τεύχεσι λαμπόμενοι· δίχα δέ σφισιν ἥνδανε βουλή,	-uu -uu- uu - uu -uu --	dactylic hexameter	masculine penthemimeral, hepthemimeral
ἠὲ διαπραθέειν ἢ ἄνδιχα πάντα δάσασθαι	-u u-uu- - -uu -u u--	dactylic hexameter	masculine penthemimeral
κτῆσιν ὅσην πτολίεθρον ἐπήρατον ἐντὸς ἔεργεν·	-u u- uu-u u-uu -u u--	dactylic hexameter	feminine penthemimeral, trithemimeral
οἳ δ’οὔ πω πείθοντο, λόχῳ δ’ὑπεθωρήσσοντο.	- - - --u u- uu----	dactylic hexameter	feminine penthemimeral, hepthemimeral, trithemimeral
τεῖχος μέν ῥ’ἄλοχοί τε φίλαι καὶ νήπια τέκνα	-- - uu- u u- - -uu --	dactylic hexameter	masculine penthemimeral, hepthemimeral, trithemimeral
ῥύατ’ ἐφεσταότες, μετὰ δ’ἀνέρες οὓς ἔχε γῆρας·	-u u-uu- uu -uu - uu --	dactylic hexameter	masculine penthemimeral
οἳ δ’ἴσαν· ἦρχε δ’ἄρά σφιν Ἄρης καὶ Παλλὰς Ἀθήνη	- uu -u u- u u- - -u u--	dactylic hexameter	masculine penthemimeral, hepthemimeral
ἄμφω χρυσείω, χρύσεια δὲ εἵματα ἕσθην,	-- --- --u u -uu --	dactylic hexameter	masculine penthemimeral
καλὼ καὶ μεγάλω σὺν τεύχεσιν, ὥς τε θεώ περ	-- - uu- - -uu - u u- -	dactylic hexameter	masculine penthemimeral, trithemimeral
ἀμφὶς ἀριζήλω· λαοὶ δ’ὑπολίζονες ἦσαν.	-u u--- -- uu-uu --	dactylic hexameter	masculine penthemimeral, hepthemimeral
οἳ δ’ὅτε δή ῥ’ἵκανον ὅθι σφίσιν εἶκε λοχῆσαι	- uu - --u u- uu -u u--	dactylic hexameter	feminine penthemimeral, hepthemimeral, trithemimeral
ἐν ποταμῷ, ὅθι τ’ἀρδμὸς ἔην πάντεσσι βοτοῖσιν,	- uu- uu -u u- --u u--	dactylic hexameter	feminine penthemimeral, hepthemimeral, trithemimeral
ἔνθ’ ἄρα τοί γ’ἵζοντ’ εἰλυμένοι αἴθοπι χαλκῷ.	- uu - -- --uu -uu --	dactylic hexameter	masculine penthemimeral, trithemimeral
τοῖσι δ’ἔπειτ’ ἀπάνευθε δύω σκοποὶ εἵατο λαῶν	-u u- uu-u u- uu -uu --	dactylic hexameter	feminine penthemimeral, hepthemimeral, trithemimeral
δέγμενοι ὁππότε μῆλα ἰδοίατο καὶ ἕλικας βοῦς.	-uu -uu -u u-uu - uu- -	dactylic hexameter	feminine penthemimeral
οἳ δὲ τάχα προγένοντο, δύω δ’ἅμ’ ἕποντο νομῆες	- u u- uu-u u- u u-u u--	dactylic hexameter	feminine penthemimeral, hepthemimeral, trithemimeral
τερπόμενοι σύριγξι· δόλον δ’οὔ τι προνόησαν.	-uu- --u u- - - uu--	dactylic hexameter	feminine penthemimeral, hepthemimeral, trithemimeral
οἳ μὲν τὰ προϊδόντες ἐπέδραμον, ὦκα δ’ἔπειτα	- - - uu-u u-uu -u u--	dactylic hexameter	feminine penthemimeral, trithemimeral
τάμνοντ’ ἀμφὶ βοῶν ἀγέλας καὶ πώεα καλὰ	-- -u u- uu- - -uu --	dactylic hexameter	masculine penthemimeral, hepthemimeral
ἀργεννέων οἰῶν, κτεῖνον δ’ἐπὶ μηλοβοτῆρας.	--- -- -- uu -uu--	dactylic hexameter	masculine penthemimeral, hepthemimeral, trithemimeral
οἳ δ’ὡς οὖν ἐπύθοντο πολὺν κέλαδον παρὰ βουσὶν	- - - uu-u u- uu- uu --	dactylic hexameter	feminine penthemimeral, hepthemimeral, trithemimeral
εἰράων προπάροιθε καθήμενοι, αὐτίκ’ ἐφ’ ἵππων	--- uu-u u-uu -u u --	dactylic hexameter	feminine penthemimeral, trithemimeral
βάντες ἀερσιπόδων μετεκίαθον, αἶψα δ’ἵκοντο.	-u u-uu- uu-uu -u u--	dactylic hexameter	masculine penthemimeral
στησάμενοι δ’ἐμάχοντο μάχην ποταμοῖο παρ’ ὄχθας,	-uu- uu-u u- uu-u u --	dactylic hexameter	feminine penthemimeral, hepthemimeral, trithemimeral
βάλλον δ’ἀλλήλους χαλκήρεσιν ἐγχείῃσιν.	-- --- --uu ----	dactylic hexameter	masculine penthemimeral
ἐν δ’Ἔρις ἐν δὲ Κυδοιμὸς ὁμίλεον, ἐν δ’ὀλοὴ Κήρ,	- uu - u u-u u-uu - uu- -	dactylic hexameter	feminine penthemimeral, trithemimeral
ἄλλον ζωὸν ἔχουσα νεούτατον, ἄλλον ἄουτον,	-- -u u-u u-uu -u u--	dactylic hexameter	feminine penthemimeral
ἄλλον τεθνηῶτα κατὰ μόθον ἕλκε ποδοῖιν·	-- ---u u- uu -u u--	dactylic hexameter	feminine penthemimeral, hepthemimeral
εἷμα δ’ἔχ’ ἀμφ’ ὤμοισι δαφοινεὸν αἵματι φωτῶν.	-u u - --u u-uu -uu --	dactylic hexameter	feminine penthemimeral, trithemimeral
ὡμίλευν δ’ὥς τε ζωοὶ βροτοὶ ἠδ’ ἐμάχοντο,	--- - - -- uu - uu--	dactylic hexameter	masculine penthemimeral, hepthemimeral, trithemimeral
νεκρούς τ’ἀλλήλων ἔρυον κατατεθνηῶτας.	-- --- uu- uu----	dactylic hexameter	masculine penthemimeral, hepthemimeral
ἐν δ’ἐτίθει νειὸν μαλακὴν πίειραν ἄρουραν	- uu- -- uu- --u u--	dactylic hexameter	masculine penthemimeral, hepthemimeral, trithemimeral
εὐρεῖαν τρίπολον· πολλοὶ δ’ἀροτῆρες ἐν αὐτῇ	--- uu- -- uu-u u --	dactylic hexameter	masculine penthemimeral, hepthemimeral, trithemimeral
ζεύγεα δινεύοντες ἐλάστρεον ἔνθα καὶ ἔνθα.	-uu ---u u-uu -u u --	dactylic hexameter	feminine penthemimeral
οἳ δ’ὁπότε στρέψαντες ἱκοίατο τέλσον ἀρούρης,	- uu- --u u-uu -u u--	dactylic hexameter	feminine penthemimeral, trithemimeral
τοῖσι δ’ἔπειτ’ ἐν χερσὶ δέπας μελιηδέος οἴνου	-u u- - -u u- uu-uu --	dactylic hexameter	feminine penthemimeral, hepthemimeral, trithemimeral
δόσκεν ἀνὴρ ἐπιών· τοὶ δὲ στρέψασκον ἀν’ ὄγμους,	-u u- uu- - - --u u --	dactylic hexameter	masculine penthemimeral, hepthemimeral, trithemimeral
ἱέμενοι νειοῖο βαθείης τέλσον ἱκέσθαι.	-uu- --u u-- -u u--	dactylic hexameter	feminine penthemimeral, trithemimeral
ἣ δὲ μελαίνετ’ ὄπισθεν, ἀρηρομένῃ δὲ ἐῴκει,	- u u-u u-u u-uu- u u--	dactylic hexameter	feminine penthemimeral
χρυσείη περ ἐοῦσα· τὸ δὴ περὶ θαῦμα τέτυκτο.	--- u u-u u - uu -u u--	dactylic hexameter	feminine penthemimeral, hepthemimeral, trithemimeral
ἐν δ’ἐτίθει τέμενος βασιλήϊον· ἔνθα δ’ἔριθοι	- uu- uu- uu-uu -u u--	dactylic hexameter	masculine penthemimeral, trithemimeral
ἤμων ὀξείας δρεπάνας ἐν χερσὶν ἔχοντες.	-- --- uu- - -u u--	dactylic hexameter	masculine penthemimeral, hepthemimeral
δράγματα δ’ἄλλα μετ’ ὄγμον ἐπήτριμα πῖπτον ἔραζε,	-uu -u u -u u-uu -u u--	dactylic hexameter	feminine penthemimeral
ἄλλα δ’ἀμαλλοδετῆρες ἐν ἐλλεδανοῖσι δέοντο.	-u u-uu-u u -uu-u u--	dactylic hexameter	feminine penthemimeral
τρεῖς δ’ἄρ’ ἀμαλλοδετῆρες ἐφέστασαν· αὐτὰρ ὄπισθε	- u u-uu-u u-uu -u u--	dactylic hexameter	feminine penthemimeral
παῖδες δραγμεύοντες ἐν ἀγκαλίδεσσι φέροντες	-- ---u u -uu-u u--	dactylic hexameter	feminine penthemimeral
ἀσπερχὲς πάρεχον· βασιλεὺς δ’ἐν τοῖσι σιωπῇ	--- uu- uu- - -u u--	dactylic hexameter	masculine penthemimeral, hepthemimeral, trithemimeral
σκῆπτρον ἔχων ἑστήκει ἐπ’ ὄγμου γηθόσυνος κῆρ.	-u u- --u u -- -uu- -	dactylic hexameter	feminine penthemimeral, trithemimeral
κήρυκες δ’ἀπάνευθεν ὑπὸ δρυῒ δαῖτα πένοντο,	--- uu-u u- uu -u u--	dactylic hexameter	feminine penthemimeral, hepthemimeral, trithemimeral
βοῦν δ’ἱερεύσαντες μέγαν ἄμφεπον· αἳ δὲ γυναῖκες	- uu--- uu -uu - u u--	dactylic hexameter	masculine penthemimeral
δεῖπνον ἐρίθοισιν λεύκ’ ἄλφιτα πολλὰ πάλυνον.	-u u--- - -uu -u u--	dactylic hexameter	masculine penthemimeral
ἐν δ’ἐτίθει σταφυλῇσι μέγα βρίθουσαν ἀλωὴν	- uu- uu-u u- --u u--	dactylic hexameter	feminine penthemimeral, hepthemimeral, trithemimeral
καλὴν χρυσείην· μέλανες δ’ἀνὰ βότρυες ἦσαν,	-- --- uu- uu -uu --	dactylic hexameter	masculine penthemimeral, hepthemimeral
ἑστήκει δὲ κάμαξι διαμπερὲς ἀργυρέῃσιν.	--- u u-u u-uu -uu--	dactylic hexameter	feminine penthemimeral, trithemimeral
ἀμφὶ δὲ κυανέην κάπετον, περὶ δ’ἕρκος ἔλασσε	-u u -uu- uu- uu -u u--	dactylic hexameter	masculine penthemimeral, hepthemimeral
κασσιτέρου· μία δ’οἴη ἀταρπιτὸς ἦεν ἐπ’ αὐτήν,	-uu- uu -u u-uu -u u --	dactylic hexameter	feminine penthemimeral, trithemimeral
τῇ νίσοντο φορῆες ὅτε τρυγόῳεν ἀλωήν.	- --u u-u u- uu-u u--	dactylic hexameter	feminine penthemimeral, hepthemimeral
παρθενικαὶ δὲ καὶ ἠΐθεοι ἀταλὰ φρονέοντες	-uu- u u -uu- uu- uu--	dactylic hexameter	hepthemimeral, trithemimeral
πλεκτοῖς ἐν ταλάροισι φέρον μελιηδέα καρπόν.	-- - uu-u u- uu-uu --	dactylic hexameter	feminine penthemimeral, hepthemimeral, trithemimeral
τοῖσιν δ’ἐν μέσσοισι πάϊς φόρμιγγι λιγείῃ	-- - --u u- --u u--	dactylic hexameter	feminine penthemimeral, hepthemimeral, trithemimeral
ἱμερόεν κιθάριζε, λίνον δ’ὑπὸ καλὸν ἄειδε	-uu- uu-u u- uu -u u--	dactylic hexameter	feminine penthemimeral, hepthemimeral, trithemimeral
λεπταλέῃ φωνῇ· τοὶ δὲ ῥήσσοντες ἁμαρτῇ	-uu- -- - - --u u--	dactylic hexameter	masculine penthemimeral, hepthemimeral, trithemimeral
μολπῇ τ’ἰυγμῷ τε ποσὶ σκαίροντες ἕποντο.	-- --- u u- --u u--	dactylic hexameter	masculine penthemimeral, hepthemimeral
ἐν δ’ἀγέλην ποίησε βοῶν ὀρθοκραιράων·	- uu- --u u- -----	dactylic hexameter	feminine penthemimeral, hepthemimeral, trithemimeral
αἳ δὲ βόες χρυσοῖο τετεύχατο κασσιτέρου τε,	- u u- --u u-uu -uu- -	dactylic hexameter	feminine penthemimeral, trithemimeral
μυκηθμῷ δ’ἀπὸ κόπρου ἐπεσσεύοντο νομὸν δὲ	--- uu -u u---u u- -	dactylic hexameter	feminine penthemimeral, trithemimeral
πὰρ ποταμὸν κελάδοντα, παρὰ ῥοδανὸν δονακῆα.	- uu- uu-u u- uu- uu--	dactylic hexameter	feminine penthemimeral, hepthemimeral, trithemimeral
χρύσειοι δὲ νομῆες ἅμ’ ἐστιχόωντο βόεσσι	--- u u-u u -uu-u u--	dactylic hexameter	feminine penthemimeral, trithemimeral
τέσσαρες, ἐννέα δέ σφι κύνες πόδας ἀργοὶ ἕποντο.	-uu -uu - u u- uu -u u--	dactylic hexameter	masculine penthemimeral, hepthemimeral
σμερδαλέω δὲ λέοντε δύ’ ἐν πρώτῃσι βόεσσι	-uu- u u-u u - --u u--	dactylic hexameter	feminine penthemimeral, hepthemimeral, trithemimeral
ταῦρον ἐρύγμηλον ἐχέτην· ὃ δὲ μακρὰ μεμυκὼς	-u u--- uu- u u -u u--	dactylic hexameter	masculine penthemimeral, hepthemimeral
ἕλκετο· τὸν δὲ κύνες μετεκίαθον ἠδ’ αἰζηοί.	-uu - u u- uu-uu - ---	dactylic hexameter	masculine penthemimeral, trithemimeral
τὼ μὲν ἀναρρήξαντε βοὸς μεγάλοιο βοείην	- u u---u u- uu-u u--	dactylic hexameter	feminine penthemimeral, hepthemimeral
ἔγκατα καὶ μέλαν αἷμα λαφύσσετον· οἳ δὲ νομῆες	-uu - uu -u u-uu - u u--	dactylic hexameter	feminine penthemimeral, trithemimeral
αὔτως ἐνδίεσαν ταχέας κύνας ὀτρύνοντες.	-- -uu- uu- uu ----	dactylic hexameter	masculine penthemimeral, hepthemimeral
οἳ δ’ἤτοι δακέειν μὲν ἀπετρωπῶντο λεόντων,	- -- uu- u u---u u--	dactylic hexameter	masculine penthemimeral, trithemimeral
ἱστάμενοι δὲ μάλ’ ἐγγὺς ὑλάκτεον ἔκ τ’ἀλέοντο.	-uu- u u -u u-uu - uu--	dactylic hexameter	feminine penthemimeral, trithemimeral
ἐν δὲ νομὸν ποίησε περικλυτὸς ἀμφιγυήεις	- u u- --u u-uu -uu--	dactylic hexameter	feminine penthemimeral, trithemimeral
ἐν καλῇ βήσσῃ μέγαν οἰῶν ἀργεννάων,	- -- -- uu -- ----	dactylic hexameter	masculine penthemimeral, trithemimeral
σταθμούς τε κλισίας τε κατηρεφέας ἰδὲ σηκούς.	-- - uu- u u-uu- uu --	dactylic hexameter	masculine penthemimeral, trithemimeral
ἐν δὲ χορὸν ποίκιλλε περικλυτὸς ἀμφιγυήεις,	- u u- --u u-uu -uu--	dactylic hexameter	feminine penthemimeral, trithemimeral
τῷ ἴκελον οἷόν ποτ’ ἐνὶ Κνωσῷ εὐρείῃ	- uu- -- u u- -- ---	dactylic hexameter	masculine penthemimeral, hepthemimeral, trithemimeral
Δαίδαλος ἤσκησεν καλλιπλοκάμῳ Ἀριάδνῃ.	-uu --- --uu- uu--	dactylic hexameter	masculine penthemimeral
ἔνθα μὲν ἠΐθεοι καὶ παρθένοι ἀλφεσίβοιαι	-u u -uu- - -uu -uu--	dactylic hexameter	masculine penthemimeral
ὀρχεῦντ’ ἀλλήλων ἐπὶ καρπῷ χεῖρας ἔχοντες.	-- --- uu -- -u u--	dactylic hexameter	masculine penthemimeral
τῶν δ’αἳ μὲν λεπτὰς ὀθόνας ἔχον, οἳ δὲ χιτῶνας	- - - -- uu- uu - u u--	dactylic hexameter	masculine penthemimeral, hepthemimeral, trithemimeral
εἵατ’ ἐϋννήτους, ἦκα στίλβοντας ἐλαίῳ·	-u u--- -- --u u--	dactylic hexameter	masculine penthemimeral, hepthemimeral
καί ῥ’αἳ μὲν καλὰς στεφάνας ἔχον, οἳ δὲ μαχαίρας	- - - -- uu- uu - u u--	dactylic hexameter	masculine penthemimeral, hepthemimeral, trithemimeral
εἶχον χρυσείας ἐξ ἀργυρέων τελαμώνων.	-- --- - -uu- uu--	dactylic hexameter	masculine penthemimeral
οἳ δ’ὁτὲ μὲν θρέξασκον ἐπισταμένοισι πόδεσσι	- uu - --u u-uu-u u--	dactylic hexameter	feminine penthemimeral, trithemimeral
ῥεῖα μάλ’, ὡς ὅτε τις τροχὸν ἄρμενον ἐν παλάμῃσιν	-u u - uu - uu -uu - uu--	dactylic hexameter	masculine penthemimeral, trithemimeral
ἑζόμενος κεραμεὺς πειρήσεται, αἴ κε θέῃσιν·	-uu- uu- --uu - u u--	dactylic hexameter	masculine penthemimeral, trithemimeral
ἄλλοτε δ’αὖ θρέξασκον ἐπὶ στίχας ἀλλήλοισι.	-uu - --u u- uu ----	dactylic hexameter	feminine penthemimeral, hepthemimeral, trithemimeral
πολλὸς δ’ἱμερόεντα χορὸν περιίσταθ’ ὅμιλος	-- -uu-u u- uu-u u--	dactylic hexameter	feminine penthemimeral, hepthemimeral
τερρπόμενοι· δοιὼ δὲ κυβιστητῆρε κατ’ αὐτοὺς	-uu- -- u u---u u --	dactylic hexameter	masculine penthemimeral, trithemimeral
μολπῆς ἐξάρχοντες ἐδίνευον κατὰ μέσσους.	-- ---u u--- uu --	dactylic hexameter	feminine penthemimeral
ἐν δ’ἐτίθει ποταμοῖο μέγα σθένος Ὠκεανοῖο	- uu- uu-u u- uu -uu--	dactylic hexameter	feminine penthemimeral, hepthemimeral, trithemimeral
ἄντυγα πὰρ πυμάτην σάκεος πύκα ποιητοῖο.	-uu - uu- uu- uu ----	dactylic hexameter	masculine penthemimeral, hepthemimeral, trithemimeral
αὐτὰρ ἐπεὶ δὴ τεῦξε σάκος μέγα τε στιβαρόν τε,	-u u- - -u u- uu - uu- -	dactylic hexameter	feminine penthemimeral, hepthemimeral, trithemimeral
τεῦξ’ ἄρα οἱ θώρηκα φαεινότερον πυρὸς αὐγῆς,	- uu - --u u-uu- uu --	dactylic hexameter	feminine penthemimeral, trithemimeral
τεῦξε δέ οἱ κόρυθα βριαρὴν κροτάφοις ἀραρυῖαν	-u u - uu- uu- uu- uu--	dactylic hexameter	masculine penthemimeral, hepthemimeral, trithemimeral
καλὴν δαιδαλέην, ἐπὶ δὲ χρύσεον λόφον ἧκε,	-- -uu- uu - uu- uu --	dactylic hexameter	masculine penthemimeral, hepthemimeral
τεῦξε δέ οἱ κνημῖδας ἑανοῦ κασσιτέροιο.	-u u - --u u-- -uu--	dactylic hexameter	feminine penthemimeral, trithemimeral
αὐτὰρ ἐπεὶ πάνθ’ ὅπλα κάμε κλυτὸς ἀμφιγυήεις,	-u u- - -u u- uu -uu--	dactylic hexameter	feminine penthemimeral, hepthemimeral, trithemimeral
μητρὸς Ἀχιλλῆος θῆκε προπάροιθεν ἀείρας.	-u u--- -- uu-u u--	dactylic hexameter	masculine penthemimeral, hepthemimeral
ἣ δ’ἴρηξ ὣς ἆλτο κατ’ Οὐλύμπου νιφόεντος	- -- - -u u --- uu--	dactylic hexameter	feminine penthemimeral, trithemimeral
τεύχεα μαρμαίροντα παρ’ Ἡφαίστοιο φέρουσα.	-uu ---u u ---u u--	dactylic hexameter	feminine penthemimeral
