ὣς οἳ μὲν περὶ νηὸς ἐϋσσέλμοιο μάχοντο·	- - - uu -u u---u u--	dactylic hexameter	feminine penthemimeral, trithemimeral
Πάτροκλος δ’Ἀχιλῆϊ παρίστατο ποιμένι λαῶν	--- uu-u u-uu -uu --	dactylic hexameter	feminine penthemimeral, trithemimeral
δάκρυα θερμὰ χέων ὥς τε κρήνη μελάνυδρος,	-uu -u u- - - -- uu--	dactylic hexameter	masculine penthemimeral, hepthemimeral
ἥ τε κατ’ αἰγίλιπος πέτρης δνοφερὸν χέει ὕδωρ.	- u u -uu- -- uu- uu --	dactylic hexameter	masculine penthemimeral, hepthemimeral
τὸν δὲ ἰδὼν ᾤκτιρε ποδάρκης δῖος Ἀχιλλεύς,	- u u- --u u-- -u u--	dactylic hexameter	feminine penthemimeral, trithemimeral
καί μιν φωνήσας ἔπεα πτερόεντα προσηύδα·	- - --- uu- uu-u u--	dactylic hexameter	masculine penthemimeral, hepthemimeral
τίπτε δεδάκρυσαι Πατρόκλεες, ἠΰτε κούρη	-u u--- --uu -uu --	dactylic hexameter	masculine penthemimeral
νηπίη, ἥ θ’ἅμα μητρὶ θέουσ’ ἀνελέσθαι ἀνώγει	-uu - uu -u u- uu-u u--	dactylic hexameter	feminine penthemimeral, hepthemimeral, trithemimeral
εἱανοῦ ἁπτομένη, καί τ’ἐσσυμένην κατερύκει,	-uu -uu- - -uu- uu--	dactylic hexameter	masculine penthemimeral
δακρυόεσσα δέ μιν ποτιδέρκεται, ὄφρ’ ἀνέληται·	-uu-u u - uu-uu - uu--	dactylic hexameter	masculine penthemimeral
τῇ ἴκελος Πάτροκλε τέρεν κατὰ δάκρυον εἴβεις.	- uu- --u u- uu -uu --	dactylic hexameter	feminine penthemimeral, hepthemimeral, trithemimeral
ἠέ τι Μυρμιδόνεσσι πιφαύσκεαι, ἢ ἐμοὶ αὐτῷ,	-u u -uu-u u-uu - uu --	dactylic hexameter	feminine penthemimeral
ἦέ τιν’ ἀγγελίην Φθίης ἐξέκλυες οἶος;	-u u -uu- -- --uu --	dactylic hexameter	masculine penthemimeral, hepthemimeral
ζώειν μὰν ἔτι φασὶ Μενοίτιον Ἄκτορος υἱόν,	-- - uu -u u-uu -uu --	dactylic hexameter	feminine penthemimeral, trithemimeral
ζώει δ’Αἰακίδης Πηλεὺς μετὰ Μυρμιδόνεσσι;	-- -uu- -- uu -uu--	dactylic hexameter	masculine penthemimeral, hepthemimeral
τῶν κε μάλ’ ἀμφοτέρων ἀκαχοίμεθα τεθνηώτων.	- u u -uu- uu-uu ----	dactylic hexameter	masculine penthemimeral
ἦε σύ γ’Ἀργείων ὀλοφύρεαι, ὡς ὀλέκονται	-u u --- uu-uu - uu--	dactylic hexameter	masculine penthemimeral
νηυσὶν ἔπι γλαφυρῇσιν ὑπερβασίης ἕνεκα σφῆς;	-u u- uu-u u-uu- uu- -	dactylic hexameter	feminine penthemimeral, trithemimeral
ἐξαύδα, μὴ κεῦθε νόῳ, ἵνα εἴδομεν ἄμφω.	--- - -u u- uu -uu --	dactylic hexameter	feminine penthemimeral, hepthemimeral, trithemimeral
τὸν δὲ βαρὺ στενάχων προσέφης Πατρόκλεες ἱππεῦ·	u u u- uu- uu- --uu --	lyric	
ὦ Ἀχιλεῦ Πηλῆος υἱὲ μέγα φέρτατ’ Ἀχαιῶν	- uu- --u u- uu -u u--	dactylic hexameter	feminine penthemimeral, hepthemimeral, trithemimeral
μὴ νεμέσα· τοῖον γὰρ ἄχος βεβίηκεν Ἀχαιούς.	- uu- -- u u- uu-u u--	dactylic hexameter	masculine penthemimeral, hepthemimeral, trithemimeral
οἳ μὲν γὰρ δὴ πάντες, ὅσοι πάρος ἦσαν ἄριστοι,	- - - - -u u- uu -u u--	dactylic hexameter	feminine penthemimeral, hepthemimeral, trithemimeral
ἐν νηυσὶν κέαται βεβλημένοι οὐτάμενοί τε.	- -- uu- --uu -uu- -	dactylic hexameter	masculine penthemimeral, trithemimeral
βέβληται μὲν ὃ Τυδεΐδης κρατερὸς Διομήδης,	--- u u -uu- uu- uu--	dactylic hexameter	hepthemimeral, trithemimeral
οὔτασται δ’Ὀδυσεὺς δουρικλυτὸς ἠδ’ Ἀγαμέμνων,	--- uu- --uu - uu--	dactylic hexameter	masculine penthemimeral, trithemimeral
βέβληται δὲ καὶ Εὐρύπυλος κατὰ μηρὸν ὀϊστῷ.	--- u u -uu- uu -u u--	dactylic hexameter	hepthemimeral, trithemimeral
τοὺς μέν τ’ἰητροὶ πολυφάρμακοι ἀμφιπένονται	- - --- uu-uu -uu--	dactylic hexameter	masculine penthemimeral
ἕλκε’ ἀκειόμενοι· σὺ δ’ἀμήχανος ἔπλευ Ἀχιλλεῦ.	-u u-uu- u u-uu -u u--	dactylic hexameter	masculine penthemimeral
μὴ ἐμέ γ’οὖν οὗτός γε λάβοι χόλος, ὃν σὺ φυλάσσεις	- uu - -- u u- uu - u u--	dactylic hexameter	masculine penthemimeral, hepthemimeral, trithemimeral
αἰναρέτη· τί σευ ἄλλος ὀνήσεται ὀψίγονός περ	-uu- u u -u u-uu -uu- -	dactylic hexameter	feminine penthemimeral, trithemimeral
αἴ κε μὴ Ἀργείοισιν ἀεικέα λοιγὸν ἀμύνῃς;	- u u ---u u-uu -u u--	dactylic hexameter	feminine penthemimeral
νηλεές, οὐκ ἄρα σοί γε πατὴρ ἦν ἱππότα Πηλεύς,	-uu - uu - u u- - -uu --	dactylic hexameter	masculine penthemimeral, hepthemimeral, trithemimeral
οὐδὲ Θέτις μήτηρ· γλαυκὴ δέ σε τίκτε θάλασσα	-u u- -- -- u u -u u--	dactylic hexameter	masculine penthemimeral, hepthemimeral, trithemimeral
πέτραι τ’ἠλίβατοι, ὅτι τοι νόος ἐστὶν ἀπηνής.	-- -uu- uu - uu -u u--	dactylic hexameter	masculine penthemimeral, hepthemimeral
εἰ δέ τινα φρεσὶ σῇσι θεοπροπίην ἀλεείνεις	- u u- uu -u u-uu- uu--	dactylic hexameter	feminine penthemimeral, trithemimeral
καί τινά τοι πὰρ Ζηνὸς ἐπέφραδε πότνια μήτηρ,	- uu - - -u u-uu -uu --	dactylic hexameter	feminine penthemimeral, trithemimeral
ἀλλ’ ἐμέ περ πρόες ὦχ’, ἃμα δ’ἄλλον λαὸν ὄπασσον	- uu - uu - uu -- -u u--	dactylic hexameter	masculine penthemimeral, trithemimeral
Μυρμιδόνων, ἤν πού τι φόως Δαναοῖσι γένωμαι.	-uu- - - u u- uu-u u--	dactylic hexameter	masculine penthemimeral, hepthemimeral, trithemimeral
δὸς δέ μοι ὤμοιιν τὰ σὰ τεύχεα θωρηχθῆναι,	- u u --- u u -uu ----	dactylic hexameter	masculine penthemimeral
αἴ κ’ἐμὲ σοὶ ἴσκοντες ἀπόσχωνται πολέμοιο	- uu - --u u--- uu--	dactylic hexameter	feminine penthemimeral, trithemimeral
Τρῶες, ἀναπνεύσωσι δ’Ἀρήϊοι υἷες Ἀχαιῶν	-u u---u u-uu -u u--	dactylic hexameter	feminine penthemimeral
τειρόμενοι· ὀλίγη δέ τ’ἀνάπνευσις πολέμοιο.	-uu- uu- u u--- uu--	dactylic hexameter	masculine penthemimeral, trithemimeral
ῥεῖα δέ κ’ἀκμῆτες κεκμηότας ἄνδρας ἀϋτῇ	-u u --- --uu -u u--	dactylic hexameter	masculine penthemimeral
ὤσαιμεν προτὶ ἄστυ νεῶν ἄπο καὶ κλισιάων.	--- uu -u u- uu - uu--	dactylic hexameter	feminine penthemimeral, hepthemimeral, trithemimeral
ὣς φάτο λισσόμενος μέγα νήπιος· ἦ γὰρ ἔμελλεν	- uu -uu- uu -uu - u u--	dactylic hexameter	masculine penthemimeral
οἷ αὐτῷ θάνατόν τε κακὸν καὶ κῆρα λιτέσθαι.	- -- uu- u u- - -u u--	dactylic hexameter	masculine penthemimeral, hepthemimeral, trithemimeral
τὸν δὲ μέγ’ ὀχθήσας προσέφη πόδας ὠκὺς Ἀχιλλεύς·	- u u -u- uu- uu -u u--	lyric	
ὤ μοι διογενὲς Πατρόκλεες οἷον ἔειπες·	- - -uuu --uu -u u--	lyric	
οὔτε θεοπροπίης ἐμπάζομαι ἥν τινα οἶδα,	-u u-uu- --uu - uu --	dactylic hexameter	masculine penthemimeral
οὔτέ τί μοι πὰρ Ζηνὸς ἐπέφραδε πότνια μήτηρ·	-u u - - -u u-uu -uu --	dactylic hexameter	feminine penthemimeral, trithemimeral
ἀλλὰ τόδ’ αἰνὸν ἄχος κραδίην καὶ θυμὸν ἱκάνει,	-u u -u u- uu- - -u u--	dactylic hexameter	masculine penthemimeral, hepthemimeral
ὁππότε δὴ τὸν ὁμοῖον ἀνὴρ ἐθέλῃσιν ἀμέρσαι	-uu - u u-u u- uu-u u--	dactylic hexameter	feminine penthemimeral, hepthemimeral, trithemimeral
καὶ γέρας ἂψ ἀφελέσθαι, ὅ τε κράτεϊ προβεβήκῃ·	- uu - uu-u u - uu- uu--	dactylic hexameter	feminine penthemimeral, hepthemimeral, trithemimeral
αἰνὸν ἄχος τό μοί ἐστιν, ἐπεὶ πάθον ἄλγεα θυμῷ.	-u u- u u -u u- uu -uu --	dactylic hexameter	feminine penthemimeral, hepthemimeral, trithemimeral
κούρην ἣν ἄρα μοι γέρας ἔξελον υἷες Ἀχαιῶν,	-- - uu - uu -uu -u u--	dactylic hexameter	masculine penthemimeral, trithemimeral
δουρὶ δ’ἐμῷ κτεάτισσα πόλιν εὐτείχεα πέρσας,	-u u- --u u- --uu --	dactylic hexameter	feminine penthemimeral, hepthemimeral, trithemimeral
τὴν ἂψ ἐκ χειρῶν ἕλετο κρείων Ἀγαμέμνων	- - - -- uu- -- uu--	dactylic hexameter	masculine penthemimeral, hepthemimeral, trithemimeral
Ἀτρεΐδης ὡς εἴ τιν’ ἀτίμητον μετανάστην.	-uu- - - u u--- uu--	dactylic hexameter	masculine penthemimeral, trithemimeral
ἀλλὰ τὰ μὲν προτετύχθαι ἐάσομεν· οὐδ’ ἄρα πως ἦν	-u u - uu-u u-uu - uu - -	dactylic hexameter	feminine penthemimeral, trithemimeral
ἀσπερχὲς κεχολῶσθαι ἐνὶ φρεσίν· ἤτοι ἔφην γε	--- uu-u u- uu -u u- -	dactylic hexameter	feminine penthemimeral, hepthemimeral, trithemimeral
οὐ πρὶν μηνιθμὸν καταπαυσέμεν, ἀλλ’ ὁπότ’ ἂν δὴ	- - --- uu-uu - uu - -	dactylic hexameter	masculine penthemimeral
νῆας ἐμὰς ἀφίκηται ἀϋτή τε πτόλεμός τε.	-u u- uu-u u-- - uu- -	dactylic hexameter	feminine penthemimeral, trithemimeral
τύνη δ’ὤμοιιν μὲν ἐμὰ κλυτὰ τεύχεα δῦθι,	-- --- u u- uu -uu --	dactylic hexameter	masculine penthemimeral, hepthemimeral
ἄρχε δὲ Μυρμιδόνεσσι φιλοπτολέμοισι μάχεσθαι,	-u u -uu-u u-uu-u u--	dactylic hexameter	feminine penthemimeral
εἰ δὴ κυάνεον Τρώων νέφος ἀμφιβέβηκε	- - -uu- -- uu -uu--	dactylic hexameter	masculine penthemimeral, hepthemimeral
νηυσὶν ἐπικρατέως, οἳ δὲ ῥηγμῖνι θαλάσσης	-u u-uu- - - --u u--	dactylic hexameter	masculine penthemimeral, hepthemimeral
κεκλίαται, χώρης ὀλίγην ἔτι μοῖραν ἔχοντες	-uu- -- uu- uu -u u--	dactylic hexameter	masculine penthemimeral, hepthemimeral, trithemimeral
Ἀργεῖοι, Τρώων δὲ πόλις ἐπὶ πᾶσα βέβηκε	--- -- u u- uu -u u--	dactylic hexameter	masculine penthemimeral, hepthemimeral, trithemimeral
θάρσυνος· οὐ γὰρ ἐμῆς κόρυθος λεύσσουσι μέτωπον	-uu - u u- uu- --u u--	dactylic hexameter	masculine penthemimeral, hepthemimeral, trithemimeral
ἐγγύθι λαμπομένης· τάχα κεν φεύγοντες ἐναύλους	-uu -uu- uu - --u u--	dactylic hexameter	masculine penthemimeral, hepthemimeral
πλήσειαν νεκύων, εἴ μοι κρείων Ἀγαμέμνων	--- uu- - - -- uu--	dactylic hexameter	masculine penthemimeral, hepthemimeral, trithemimeral
ἤπια εἰδείη· νῦν δὲ στρατὸν ἀμφιμάχονται.	-uu --- - - uu -uu--	dactylic hexameter	masculine penthemimeral, hepthemimeral
οὐ γὰρ Τυδεΐδεω Διομήδεος ἐν παλάμῃσι	- - -uu- uu-uu - uu--	dactylic hexameter	masculine penthemimeral
μαίνεται ἐγχείη Δαναῶν ἀπὸ λοιγὸν ἀμῦναι·	-uu --- uu- uu -u u--	dactylic hexameter	masculine penthemimeral, hepthemimeral
οὐδέ πω Ἀτρεΐδεω ὀπὸς ἔκλυον αὐδήσαντος	-u u -uu- uu -uu ----	dactylic hexameter	masculine penthemimeral
ἐχθρῆς ἐκ κεφαλῆς· ἀλλ’ Ἕκτορος ἀνδροφόνοιο	-- - uu- - -uu -uu--	dactylic hexameter	masculine penthemimeral, trithemimeral
Τρωσὶ κελεύοντος περιάγνυται, οἳ δ’ἀλαλητῷ	-u u--- uu-uu - uu--	dactylic hexameter	masculine penthemimeral
πᾶν πεδίον κατέχουσι μάχῃ νικῶντες Ἀχαιούς.	- uu- uu-u u- --u u--	dactylic hexameter	feminine penthemimeral, hepthemimeral, trithemimeral
ἀλλὰ καὶ ὧς Πάτροκλε νεῶν ἄπο λοιγὸν ἀμύνων	-u u - --u u- uu -u u--	dactylic hexameter	feminine penthemimeral, hepthemimeral, trithemimeral
ἔμπεσ’ ἐπικρατέως, μὴ δὴ πυρὸς αἰθομένοιο	-u u-uu- - - uu -uu--	dactylic hexameter	masculine penthemimeral, hepthemimeral
νῆας ἐνιπρήσωσι, φίλον δ’ἀπὸ νόστον ἕλωνται.	-u u---u u- uu -u u--	dactylic hexameter	feminine penthemimeral, hepthemimeral
πείθεο δ’ὥς τοι ἐγὼ μύθου τέλος ἐν φρεσὶ θείω,	-uu - u u- -- uu - uu --	dactylic hexameter	masculine penthemimeral, hepthemimeral, trithemimeral
ὡς ἄν μοι τιμὴν μεγάλην καὶ κῦδος ἄρηαι	- - - -- uu- - -u u--	dactylic hexameter	masculine penthemimeral, hepthemimeral, trithemimeral
πρὸς πάντων Δαναῶν, ἀτὰρ οἳ περικαλλέα κούρην	- -- uu- uu - uu-uu --	dactylic hexameter	masculine penthemimeral, hepthemimeral, trithemimeral
ἂψ ἀπονάσσωσιν, ποτὶ δ’ἀγλαὰ δῶρα πόρωσιν.	- uu--- uu -uu -u u--	dactylic hexameter	masculine penthemimeral
ἐκ νηῶν ἐλάσας ἰέναι πάλιν· εἰ δέ κεν αὖ τοι	- -- uu- uu- uu - u u - -	dactylic hexameter	masculine penthemimeral, hepthemimeral, trithemimeral
δώῃ κῦδος ἀρέσθαι ἐρίγδουπος πόσις Ἥρης,	-- -u u-u u--- uu --	dactylic hexameter	feminine penthemimeral
μὴ σύ γ’ἄνευθεν ἐμεῖο λιλαίεσθαι πολεμίζειν	- u u-u u-u u--- uu--	dactylic hexameter	feminine penthemimeral
Τρωσὶ φιλοπτολέμοισιν· ἀτιμότερον δέ με θήσεις·	-u u-uu-u u-uu- u u --	dactylic hexameter	feminine penthemimeral
μὴ δ’ἐπαγαλλόμενος πολέμῳ καὶ δηϊοτῆτι	- uu-uu- uu- - -uu--	dactylic hexameter	masculine penthemimeral, hepthemimeral
Τρῶας ἐναιρόμενος προτὶ Ἴλιον ἡγεμονεύειν,	-u u-uu- uu -uu -uu--	dactylic hexameter	masculine penthemimeral
μή τις ἀπ’ Οὐλύμποιο θεῶν αἰειγενετάων	- u u ---u u- --uu--	dactylic hexameter	feminine penthemimeral, hepthemimeral
ἐμβήῃ· μάλα τούς γε φιλεῖ ἑκάεργος Ἀπόλλων·	--- uu - u u- uu-u u--	dactylic hexameter	masculine penthemimeral, hepthemimeral, trithemimeral
ἀλλὰ πάλιν τρωπᾶσθαι, ἐπὴν φάος ἐν νήεσσι	-u u- --u u- uu - ---	dactylic hexameter	feminine penthemimeral, hepthemimeral, trithemimeral
θήῃς, τοὺς δ’ἔτ’ ἐᾶν πεδίον κάτα δηριάασθαι.	-- - u u- uu- uu -uu--	dactylic hexameter	masculine penthemimeral, hepthemimeral, trithemimeral
αἲ γὰρ Ζεῦ τε πάτερ καὶ Ἀθηναίη καὶ Ἄπολλον	- - - u u- u u--- u u--	dactylic hexameter	masculine penthemimeral, trithemimeral
μήτέ τις οὖν Τρώων θάνατον φύγοι ὅσσοι ἔασι,	-u u - -- uu- uu -u u--	dactylic hexameter	masculine penthemimeral, hepthemimeral, trithemimeral
μήτέ τις Ἀργείων, νῶϊν δ’ἐκδῦμεν ὄλεθρον,	-u u --- -- --u u--	dactylic hexameter	masculine penthemimeral, hepthemimeral
ὄφρ’ οἶοι Τροίης ἱερὰ κρήδεμνα λύωμεν.	- -- -- uu- --u u--	dactylic hexameter	masculine penthemimeral, hepthemimeral, trithemimeral
ὣς οἳ μὲν τοιαῦτα πρὸς ἀλλήλους ἀγόρευον,	- - - u-u u --- uu--	lyric	
Αἴας δ’οὐκ ἔτ’ ἔμιμνε· βιάζετο γὰρ βελέεσσι·	-- - u u-u u-uu - uu--	dactylic hexameter	feminine penthemimeral, trithemimeral
δάμνα μιν Ζηνός τε νόος καὶ Τρῶες ἀγαυοὶ	-- - -- u u- - -u u--	dactylic hexameter	masculine penthemimeral, hepthemimeral, trithemimeral
βάλλοντες· δεινὴν δὲ περὶ κροτάφοισι φαεινὴ	--- -- u u- uu-u u--	dactylic hexameter	masculine penthemimeral, hepthemimeral, trithemimeral
πήληξ βαλλομένη καναχὴν ἔχε, βάλλετο δ’αἰεὶ	-- -uu- uu- uu -uu --	dactylic hexameter	masculine penthemimeral, hepthemimeral
κὰπ φάλαρ’ εὐποίηθ’· ὃ δ’ἀριστερὸν ὦμον ἔκαμνεν	- uu --- u u-uu -u u--	dactylic hexameter	masculine penthemimeral
ἔμπεδον αἰὲν ἔχων σάκος αἰόλον· οὐδὲ δύναντο	-uu -u u- uu -uu -u u--	dactylic hexameter	masculine penthemimeral
ἀμφ’ αὐτῷ πελεμίξαι ἐρείδοντες βελέεσσιν.	- -- uu-u u--- uu--	dactylic hexameter	feminine penthemimeral, trithemimeral
αἰεὶ δ’ἀργαλέῳ ἔχετ’ ἄσθματι, κὰδ δέ οἱ ἱδρὼς	-- -uu- uu -uu - u u --	dactylic hexameter	masculine penthemimeral
πάντοθεν ἐκ μελέων πολὺς ἔρρεεν, οὐδέ πῃ εἶχεν	-uu - uu- uu -uu -u u --	dactylic hexameter	masculine penthemimeral, trithemimeral
ἀμπνεῦσαι· πάντῃ δὲ κακὸν κακῷ ἐστήρικτο.	--- -- u u- uu ----	dactylic hexameter	masculine penthemimeral, hepthemimeral, trithemimeral
ἔσπετε νῦν μοι Μοῦσαι Ὀλύμπια δώματ’ ἔχουσαι,	-uu - - -u u-uu -u u--	dactylic hexameter	feminine penthemimeral, trithemimeral
ὅππως δὴ πρῶτον πῦρ ἔμπεσε νηυσὶν Ἀχαιῶν.	-- - -- - -uu -u u--	dactylic hexameter	masculine penthemimeral, trithemimeral
Ἕκτωρ Αἴαντος δόρυ μείλινον ἄγχι παραστὰς	-- --- uu -uu -u u--	dactylic hexameter	masculine penthemimeral
πλῆξ’ ἄορι μεγάλῳ αἰχμῆς παρὰ καυλὸν ὄπισθεν,	- uu- uu- -- uu -u u--	dactylic hexameter	masculine penthemimeral, hepthemimeral, trithemimeral
ἀντικρὺ δ’ἀπάραξε· τὸ μὲν Τελαμώνιος Αἴας	--- uu-u u - uu-uu --	dactylic hexameter	feminine penthemimeral, hepthemimeral, trithemimeral
πῆλ’ αὔτως ἐν χειρὶ κόλον δόρυ, τῆλε δ’ἀπ’ αὐτοῦ	- -- - -u u- uu -u u --	dactylic hexameter	feminine penthemimeral, hepthemimeral, trithemimeral
αἰχμὴ χαλκείη χαμάδις βόμβησε πεσοῦσα.	-- --- uu- --u u--	dactylic hexameter	masculine penthemimeral, hepthemimeral
γνῶ δ’Αἴας κατὰ θυμὸν ἀμύμονα ῥίγησέν τε	- -- uu -u u-uu --- -	dactylic hexameter	feminine penthemimeral, trithemimeral
ἔργα θεῶν, ὅ ῥα πάγχυ μάχης ἐπὶ μήδεα κεῖρε	-u u- u u -u u- uu -uu --	dactylic hexameter	feminine penthemimeral, hepthemimeral, trithemimeral
Ζεὺς ὑψιβρεμέτης, Τρώεσσι δὲ βούλετο νίκην·	- --uu- --u u -uu --	dactylic hexameter	masculine penthemimeral
χάζετο δ’ἐκ βελέων. τοὶ δ’ἔμβαλον ἀκάματον πῦρ	-uu - uu- - -uu -uu- -	dactylic hexameter	masculine penthemimeral, trithemimeral
νηῒ θοῇ· τῆς δ’αἶψα κατ’ ἀσβέστη κέχυτο φλόξ.	-u u- - -u u --- uu- -	dactylic hexameter	feminine penthemimeral, trithemimeral
ὣς τὴν μὲν πρυμνὴν πῦρ ἄμφεπεν· αὐτὰρ Ἀχιλλεὺς	- - - -- - -uu -u u--	dactylic hexameter	masculine penthemimeral, trithemimeral
μηρὼ πληξάμενος Πατροκλῆα προσέειπεν·	-- -uu- ---- uu--	dactylic hexameter	masculine penthemimeral
ὄρσεο διογενὲς Πατρόκλεες ἱπποκέλευθε·	-uu -uu- --uu -uu--	dactylic hexameter	masculine penthemimeral
λεύσσω δὴ παρὰ νηυσὶ πυρὸς δηίοιο ἰωήν·	-- - uu -u u- --u u--	dactylic hexameter	feminine penthemimeral, hepthemimeral, trithemimeral
μὴ δὴ νῆας ἕλωσι καὶ οὐκέτι φυκτὰ πέλωνται·	- - -u u-u u -uu -u u--	dactylic hexameter	feminine penthemimeral
δύσεο τεύχεα θᾶσσον, ἐγὼ δέ κε λαὸν ἀγείρω.	-uu -uu -u u- u u -u u--	dactylic hexameter	feminine penthemimeral, hepthemimeral
ὣς φάτο, Πάτροκλος δὲ κορύσσετο νώροπι χαλκῷ.	- uu --- u u-uu -uu --	dactylic hexameter	masculine penthemimeral
κνημῖδας μὲν πρῶτα περὶ κνήμῃσιν ἔθηκε	--- - -u u- --u u--	dactylic hexameter	feminine penthemimeral, hepthemimeral, trithemimeral
καλάς, ἀργυρέοισιν ἐπισφυρίοις ἀραρυίας·	-- -uu-u u-uu- uu--	dactylic hexameter	feminine penthemimeral
δεύτερον αὖ θώρηκα περὶ στήθεσσιν ἔδυνε	-uu - --u u- --u u--	dactylic hexameter	feminine penthemimeral, hepthemimeral, trithemimeral
ποικίλον ἀστερόεντα ποδώκεος Αἰακίδαο.	-uu -uu-u u-uu -uu--	dactylic hexameter	feminine penthemimeral
ἀμφὶ δ’ἄρ’ ὤμοισιν βάλετο ξίφος ἀργυρόηλον	-u u --- uu- uu -uu--	dactylic hexameter	masculine penthemimeral, hepthemimeral
χάλκεον, αὐτὰρ ἔπειτα σάκος μέγα τε στιβαρόν τε·	-uu -u u-u u- uu - uu- -	dactylic hexameter	feminine penthemimeral, hepthemimeral
κρατὶ δ’ἐπ’ ἰφθίμῳ κυνέην εὔτυκτον ἔθηκεν	-u u --- uu- --u u--	dactylic hexameter	masculine penthemimeral, hepthemimeral
ἵππουριν· δεινὸν δὲ λόφος καθύπερθεν ἔνευεν.	--- -- u u- uu-u u--	dactylic hexameter	masculine penthemimeral, hepthemimeral, trithemimeral
εἵλετο δ’ἄλκιμα δοῦρε, τά οἱ παλάμηφιν ἀρήρει.	-uu -uu -u u - uu-u u--	dactylic hexameter	feminine penthemimeral, hepthemimeral
ἔγχος δ’οὐχ ἕλετ’ οἶον ἀμύμονος Αἰακίδαο	-- - uu -u u-uu -uu--	dactylic hexameter	feminine penthemimeral, trithemimeral
βριθὺ μέγα στιβαρόν· τὸ μὲν οὐ δύνατ’ ἄλλος Ἀχαιῶν	-u u- uu- u u - uu -u u--	dactylic hexameter	masculine penthemimeral, hepthemimeral, trithemimeral
πάλλειν, ἀλλά μιν οἶος ἐπίστατο πῆλαι Ἀχιλλεὺς	-- -u u -u u-uu -u u--	dactylic hexameter	feminine penthemimeral
Πηλιάδα μελίην, τὴν πατρὶ φίλῳ πόρε Χείρων	-uu- uu- - -u u- uu --	dactylic hexameter	masculine penthemimeral, trithemimeral
Πηλίου ἐκ κορυφῆς, φόνον ἔμμεναι ἡρώεσσιν.	-uu - uu- uu -uu ----	dactylic hexameter	masculine penthemimeral, trithemimeral
ἵππους δ’Αὐτομέδοντα θοῶς ζευγνῦμεν ἄνωγε,	-- -uu-u u- --u u--	dactylic hexameter	feminine penthemimeral, hepthemimeral
τὸν μετ’ Ἀχιλλῆα ῥηξήνορα τῖε μάλιστα,	- u u--- --uu -u u--	dactylic hexameter	masculine penthemimeral
πιστότατος δέ οἱ ἔσκε μάχῃ ἔνι μεῖναι ὁμοκλήν.	-uu- u u -u u- uu -u u--	dactylic hexameter	feminine penthemimeral, hepthemimeral, trithemimeral
τῷ δὲ καὶ Αὐτομέδων ὕπαγε ζυγὸν ὠκέας ἵππους	- u u -uu- uu- uu -uu --	dactylic hexameter	masculine penthemimeral, hepthemimeral
Ξάνθον καὶ Βαλίον, τὼ ἅμα πνοιῇσι πετέσθην,	-- - uu- u u- --u u--	dactylic hexameter	masculine penthemimeral, hepthemimeral, trithemimeral
τοὺς ἔτεκε Ζεφύρῳ ἀνέμῳ Ἅρπυια Ποδάργη	- uu- uu- uu- --u u--	dactylic hexameter	masculine penthemimeral, hepthemimeral, trithemimeral
βοσκομένη λειμῶνι παρὰ ῥόον Ὠκεανοῖο.	-uu- --u u- uu -uu--	dactylic hexameter	feminine penthemimeral, hepthemimeral, trithemimeral
ἐν δὲ παρηορίῃσιν ἀμύμονα Πήδασον ἵει,	- u u-uu-u u-uu -uu --	dactylic hexameter	feminine penthemimeral
τόν ῥά ποτ’ Ἠετίωνος ἑλὼν πόλιν ἤγαγ’ Ἀχιλλεύς,	- u u -uu-u u- uu -u u--	dactylic hexameter	feminine penthemimeral, hepthemimeral
ὃς καὶ θνητὸς ἐὼν ἕπεθ’ ἵπποις ἀθανάτοισι.	- - -u u- uu -- -uu--	dactylic hexameter	masculine penthemimeral
Μυρμιδόνας δ’ἄρ’ ἐποιχόμενος θώρηξεν Ἀχιλλεὺς	-uu- u u-uu- --u u--	dactylic hexameter	hepthemimeral, trithemimeral
πάντας ἀνὰ κλισίας σὺν τεύχεσιν· οἳ δὲ λύκοι ὣς	-u u- uu- - -uu - u u- -	dactylic hexameter	masculine penthemimeral, trithemimeral
ὠμοφάγοι, τοῖσίν τε περὶ φρεσὶν ἄσπετος ἀλκή,	-uu- -- u u- uu -uu --	dactylic hexameter	masculine penthemimeral, hepthemimeral, trithemimeral
οἵ τ’ἔλαφον κεραὸν μέγαν οὔρεσι δῃώσαντες	- uu- uu- uu -uu ----	dactylic hexameter	masculine penthemimeral, trithemimeral
δάπτουσιν· πᾶσιν δὲ παρήϊον αἵματι φοινόν·	--- -- u u-uu -uu --	dactylic hexameter	masculine penthemimeral, trithemimeral
καί τ’ἀγεληδὸν ἴασιν ἀπὸ κρήνης μελανύδρου	- uu-u u-u u- -- uu--	dactylic hexameter	feminine penthemimeral, hepthemimeral
λάψοντες γλώσσῃσιν ἀραιῇσιν μέλαν ὕδωρ	--- --u u--- uu --	dactylic hexameter	feminine penthemimeral, trithemimeral
ἄκρον ἐρευγόμενοι φόνον αἵματος· ἐν δέ τε θυμὸς	-u u-uu- uu -uu - u u --	dactylic hexameter	masculine penthemimeral
στήθεσιν ἄτρομός ἐστι, περιστένεται δέ τε γαστήρ·	-uu -uu -u u-uu- u u --	dactylic hexameter	feminine penthemimeral
τοῖοι Μυρμιδόνων ἡγήτορες ἠδὲ μέδοντες	-- -uu- --uu -u u--	dactylic hexameter	masculine penthemimeral
ἀμφ’ ἀγαθὸν θεράποντα ποδώκεος Αἰακίδαο	- uu- uu-u u-uu -uu--	dactylic hexameter	feminine penthemimeral, trithemimeral
ῥώοντ’· ἐν δ’ἄρα τοῖσιν ἀρήϊος ἵστατ’ Ἀχιλλεύς,	-- - uu -u u-uu -u u--	dactylic hexameter	feminine penthemimeral, trithemimeral
ὀτρύνων ἵππους τε καὶ ἀνέρας ἀσπιδιώτας.	--- -- u u -uu -uu--	dactylic hexameter	masculine penthemimeral, trithemimeral
πεντήκοντ’ ἦσαν νῆες θοαί, ᾗσιν Ἀχιλλεὺς	--- -- -- uu -u u--	dactylic hexameter	masculine penthemimeral, hepthemimeral, trithemimeral
ἐς Τροίην ἡγεῖτο Διῒ φίλος· ἐν δὲ ἑκάστῃ	- -- --u u- uu - u u--	dactylic hexameter	feminine penthemimeral, hepthemimeral, trithemimeral
πεντήκοντ’ ἔσαν ἄνδρες ἐπὶ κληῖσιν ἑταῖροι·	--- uu -u u- --u u--	dactylic hexameter	feminine penthemimeral, hepthemimeral, trithemimeral
πέντε δ’ἄρ’ ἡγεμόνας ποιήσατο τοῖς ἐπεποίθει	-u u -uu- --uu - uu--	dactylic hexameter	masculine penthemimeral
σημαίνειν· αὐτὸς δὲ μέγα κρατέων ἤνασσε.	--- -- u u- uu- ---	dactylic hexameter	masculine penthemimeral, hepthemimeral, trithemimeral
τῆς μὲν ἰῆς στιχὸς ἦρχε Μενέσθιος αἰολοθώρηξ	- u u- uu -u u-uu -uu--	dactylic hexameter	feminine penthemimeral, trithemimeral
υἱὸς Σπερχειοῖο διιπετέος ποταμοῖο·	-- ---u u-uu- uu--	dactylic hexameter	feminine penthemimeral
ὃν τέκε Πηλῆος θυγάτηρ καλὴ Πολυδώρη	- uu --- uu- -- uu--	dactylic hexameter	masculine penthemimeral, hepthemimeral
Σπερχειῷ ἀκάμαντι γυνὴ θεῷ εὐνηθεῖσα,	--- uu-u u- uu ----	dactylic hexameter	feminine penthemimeral, hepthemimeral, trithemimeral
αὐτὰρ ἐπίκλησιν Βώρῳ Περιήρεος υἷι,	-u u--- -- uu-uu --	dactylic hexameter	masculine penthemimeral, hepthemimeral
ὅς ῥ’ἀναφανδὸν ὄπυιε πορὼν ἀπερείσια ἕδνα.	- uu-u u-u u- uu-uu --	dactylic hexameter	feminine penthemimeral, hepthemimeral
τῆς δ’ἑτέρης Εὔδωρος ἀρήϊος ἡγεμόνευε	- uu- --u u-uu -uu--	dactylic hexameter	feminine penthemimeral, trithemimeral
παρθένιος, τὸν ἔτικτε χορῷ καλὴ Πολυμήλη	-uu- u u-u u- -- uu--	dactylic hexameter	feminine penthemimeral, hepthemimeral, trithemimeral
Φύλαντος θυγάτηρ· τῆς δὲ κρατὺς ἀργεϊφόντης	--- uu- - - uu -uu--	dactylic hexameter	masculine penthemimeral, hepthemimeral, trithemimeral
ἠράσατ’, ὀφθαλμοῖσιν ἰδὼν μετὰ μελπομένῃσιν	-uu ---u u- uu -uu--	dactylic hexameter	feminine penthemimeral, hepthemimeral
ἐν χορῷ Ἀρτέμιδος χρυσηλακάτου κελαδεινῆς.	- uu -uu- --uu- uu--	dactylic hexameter	masculine penthemimeral
αὐτίκα δ’εἰς ὑπερῷ’ ἀναβὰς παρελέξατο λάθρῃ	-uu - uu- uu- uu-uu --	dactylic hexameter	masculine penthemimeral, hepthemimeral, trithemimeral
Ἑρμείας ἀκάκητα, πόρεν δέ οἱ ἀγλαὸν υἱὸν	--- uu-u u- u u -uu --	dactylic hexameter	feminine penthemimeral, hepthemimeral, trithemimeral
Εὔδωρον πέρι μὲν θείειν ταχὺν ἠδὲ μαχητήν.	--- uu - -- uu -u u--	dactylic hexameter	masculine penthemimeral, hepthemimeral, trithemimeral
αὐτὰρ ἐπεὶ δὴ τόν γε μογοστόκος Εἰλείθυια	-u u- - - u u-uu ----	dactylic hexameter	masculine penthemimeral, trithemimeral
ἐξάγαγε πρὸ φόως δὲ καὶ ἠελίου ἴδεν αὐγάς,	-uu- u u- u u -uu- uu --	dactylic hexameter	masculine penthemimeral, trithemimeral
τὴν μὲν Ἐχεκλῆος κρατερὸν μένος Ἀκτορίδαο	- u u--- uu- uu -uu--	dactylic hexameter	masculine penthemimeral, hepthemimeral
ἠγάγετο πρὸς δώματ’, ἐπεὶ πόρε μυρία ἕδνα,	-uu- - -u u- uu -uu --	dactylic hexameter	feminine penthemimeral, hepthemimeral, trithemimeral
τὸν δ’ὃ γέρων Φύλας εὖ ἔτρεφεν ἠδ’ ἀτίταλλεν	- u u- -- - -uu - uu--	dactylic hexameter	masculine penthemimeral, trithemimeral
ἀμφαγαπαζόμενος ὡς εἴ θ’ἑὸν υἱὸν ἐόντα.	-uu-uu- - - uu -u u--	dactylic hexameter	masculine penthemimeral, hepthemimeral
τῆς δὲ τρίτης Πείσανδρος ἀρήϊος ἡγεμόνευε	- u u- --u u-uu -uu--	dactylic hexameter	feminine penthemimeral, trithemimeral
Μαιμαλίδης, ὃς πᾶσι μετέπρεπε Μυρμιδόνεσσιν	-uu- - -u u-uu -uu--	dactylic hexameter	feminine penthemimeral, trithemimeral
ἔγχεϊ μάρνασθαι μετὰ Πηλεΐωνος ἑταῖρον.	-uu --- uu -uu-u u--	dactylic hexameter	masculine penthemimeral
τῆς δὲ τετάρτης ἦρχε γέρων ἱππηλάτα Φοῖνιξ,	- u u-- -u u- --uu --	dactylic hexameter	feminine penthemimeral, hepthemimeral
πέμπτης δ’Ἀλκιμέδων Λαέρκεος υἱὸς ἀμύμων.	-- -uu- --uu -u u--	dactylic hexameter	masculine penthemimeral
αὐτὰρ ἐπεὶ δὴ πάντας ἅμ’ ἡγεμόνεσσιν Ἀχιλλεὺς	-u u- - -u u -uu-u u--	dactylic hexameter	feminine penthemimeral, trithemimeral
στῆσεν ἐῢ κρίνας, κρατερὸν δ’ἐπὶ μῦθον ἔτελλε·	-u u- -- uu- uu -u u--	dactylic hexameter	masculine penthemimeral, hepthemimeral, trithemimeral
Μυρμιδόνες μή τίς μοι ἀπειλάων λελαθέσθω,	-uu- - - u u--- uu--	dactylic hexameter	masculine penthemimeral, trithemimeral
ἃς ἐπὶ νηυσὶ θοῇσιν ἀπειλεῖτε Τρώεσσι	- uu -u u-u u--- ---	dactylic hexameter	feminine penthemimeral
πάνθ’ ὑπὸ μηνιθμόν, καί μ’ᾐτιάασθε ἕκαστος·	- uu --- - -uu-u u--	dactylic hexameter	masculine penthemimeral
σχέτλιε Πηλέος υἱὲ χόλῳ ἄρα σ’ἔτρεφε μήτηρ,	-uu -uu -u u- uu -uu --	dactylic hexameter	feminine penthemimeral, hepthemimeral
νηλεές, ὃς παρὰ νηυσὶν ἔχεις ἀέκοντας ἑταίρους·	-uu - uu -u u- uu-u u--	dactylic hexameter	feminine penthemimeral, hepthemimeral, trithemimeral
οἴκαδέ περ σὺν νηυσὶ νεώμεθα ποντοπόροισιν	-uu - - -- -uu -uu--	dactylic hexameter	trithemimeral
αὖτις, ἐπεί ῥά τοι ὧδε κακὸς χόλος ἔμπεσε θυμῷ.	-u u- u u -u u- uu -uu --	dactylic hexameter	feminine penthemimeral, hepthemimeral, trithemimeral
ταῦτά μ’ἀγειρόμενοι θάμ’ ἐβάζετε· νῦν δὲ πέφανται	-u u-uu- u u-uu - u u--	dactylic hexameter	masculine penthemimeral
φυλόπιδος μέγα ἔργον, ἕης τὸ πρίν γ’ἐράασθε.	-uu- uu -u u- - - uu--	dactylic hexameter	feminine penthemimeral, hepthemimeral, trithemimeral
ἔνθά τις ἄλκιμον ἦτορ ἔχων Τρώεσσι μαχέσθω.	-u u -uu -u u- --u u--	dactylic hexameter	feminine penthemimeral, hepthemimeral
ὣς εἰπὼν ὄτρυνε μένος καὶ θυμὸν ἑκάστου.	- -- -uu u- - -u u--	lyric	
μᾶλλον δὲ στίχες ἄρθεν, ἐπεὶ βασιλῆος ἄκουσαν.	-- - uu -u u- uu-u u--	dactylic hexameter	feminine penthemimeral, hepthemimeral, trithemimeral
ὡς δ’ὅτε τοῖχον ἀνὴρ ἀράρῃ πυκινοῖσι λίθοισι	- uu -u u- uu- uu-u u--	dactylic hexameter	masculine penthemimeral, hepthemimeral
δώματος ὑψηλοῖο βίας ἀνέμων ἀλεείνων,	-uu ---u u- uu- uu--	dactylic hexameter	feminine penthemimeral, hepthemimeral
ὣς ἄραρον κόρυθές τε καὶ ἀσπίδες ὀμφαλόεσσαι.	- uu- uu- u u -uu -uu--	dactylic hexameter	masculine penthemimeral, trithemimeral
ἀσπὶς ἄρ’ ἀσπίδ’ ἔρειδε, κόρυς κόρυν, ἀνέρα δ’ἀνήρ·	-u u -u u-u u- uu -uu --	dactylic hexameter	feminine penthemimeral, hepthemimeral
ψαῦον δ’ἱππόκομοι κόρυθες λαμπροῖσι φάλοισι	-- -uu- uu- --u u--	dactylic hexameter	masculine penthemimeral, hepthemimeral
νευόντων, ὡς πυκνοὶ ἐφέστασαν ἀλλήλοισι.	--- - -u u-uu ----	dactylic hexameter	feminine penthemimeral, trithemimeral
πάντων δὲ προπάροιθε δύ’ ἀνέρε θωρήσσοντο	-- - uu-u u -uu ----	dactylic hexameter	feminine penthemimeral, trithemimeral
Πάτροκλός τε καὶ Αὐτομέδων ἕνα θυμὸν ἔχοντες	--- u u -uu- uu -u u--	dactylic hexameter	hepthemimeral, trithemimeral
πρόσθεν Μυρμιδόνων πολεμιζέμεν. αὐτὰρ Ἀχιλλεὺς	-- -uu- uu-uu -u u--	dactylic hexameter	masculine penthemimeral
βῆ ῥ’ἴμεν ἐς κλισίην, χηλοῦ δ’ἀπὸ πῶμ’ ἀνέῳγε	- uu - uu- -- uu - uu--	dactylic hexameter	masculine penthemimeral, hepthemimeral, trithemimeral
καλῆς δαιδαλέης, τήν οἱ Θέτις ἀργυρόπεζα	-- -uu- - - uu -uu--	dactylic hexameter	masculine penthemimeral, hepthemimeral
θῆκ’ ἐπὶ νηὸς ἄγεσθαι ἐῢ πλήσασα χιτώνων	- uu -u u-u u- --u u--	dactylic hexameter	feminine penthemimeral, hepthemimeral
χλαινάων τ’ἀνεμοσκεπέων οὔλων τε ταπήτων.	--- uu-uu- -- u u--	dactylic hexameter	hepthemimeral, trithemimeral
ἔνθα δέ οἱ δέπας ἔσκε τετυγμένον, οὐδέ τις ἄλλος	-u u - uu -u u-uu -u u --	dactylic hexameter	feminine penthemimeral, trithemimeral
οὔτ’ ἀνδρῶν πίνεσκεν ἀπ’ αὐτοῦ αἴθοπα οἶνον,	- -- --u u -- -uu --	dactylic hexameter	feminine penthemimeral, trithemimeral
οὔτέ τεῳ σπένδεσκε θεῶν, ὅτε μὴ Διὶ πατρί.	-u u- --u u- uu - uu --	dactylic hexameter	feminine penthemimeral, hepthemimeral, trithemimeral
τό ῥα τότ’ ἐκ χηλοῖο λαβὼν ἐκάθηρε θεείῳ	- u u - --u u- uu-u u--	dactylic hexameter	feminine penthemimeral, hepthemimeral, trithemimeral
πρῶτον, ἔπειτα δ’ἔνιψ’ ὕδατος καλῇσι ῥοῇσι,	-u u-u u- uu- --u u--	dactylic hexameter	masculine penthemimeral, hepthemimeral
νίψατο δ’αὐτὸς χεῖρας, ἀφύσσατο δ’αἴθοπα οἶνον.	-uu -- -u u-uu -uu --	dactylic hexameter	feminine penthemimeral
εὔχετ’ ἔπειτα στὰς μέσῳ ἕρκεϊ, λεῖβε δὲ οἶνον	-u u-- - uu -uu -u u --	dactylic hexameter	masculine penthemimeral
οὐρανὸν εἰσανιδών· Δία δ’οὐ λάθε τερπικέραυνον·	-uu -uu- uu - uu -uu--	dactylic hexameter	masculine penthemimeral, hepthemimeral
Ζεῦ ἄνα Δωδωναῖε Πελασγικὲ τηλόθι ναίων	- uu -u-u u-uu -uu --	lyric	
Δωδώνης μεδέων δυσχειμέρου, ἀμφὶ δὲ Σελλοὶ	--- uu- --uu -u u --	dactylic hexameter	masculine penthemimeral, trithemimeral
σοὶ ναίουσ’ ὑποφῆται ἀνιπτόποδες χαμαιεῦναι,	- -- uu-u u-uu- uu--	dactylic hexameter	feminine penthemimeral, trithemimeral
ἠμὲν δή ποτ’ ἐμὸν ἔπος ἔκλυες εὐξαμένοιο,	-- - u u- uu -uu -uu--	dactylic hexameter	masculine penthemimeral, trithemimeral
τίμησας μὲν ἐμέ, μέγα δ’ἴψαο λαὸν Ἀχαιῶν,	--- u u- uu -uu -u u--	dactylic hexameter	masculine penthemimeral, trithemimeral
ἠδ’ ἔτι καὶ νῦν μοι τόδ’ ἐπικρήηνον ἐέλδωρ·	- uu - - - u u---u u--	dactylic hexameter	masculine penthemimeral, trithemimeral
αὐτὸς μὲν γὰρ ἐγὼ μενέω νηῶν ἐν ἀγῶνι,	-- - u u- uu- -- u u--	dactylic hexameter	masculine penthemimeral, hepthemimeral, trithemimeral
ἀλλ’ ἕταρον πέμπω πολέσιν μετὰ Μυρμιδόνεσσι	- uu- -- uu- uu -uu--	dactylic hexameter	masculine penthemimeral, hepthemimeral, trithemimeral
μάρνασθαι· τῷ κῦδος ἅμα πρόες εὐρύοπα Ζεῦ,	--- - -u u- uu -uu- -	dactylic hexameter	feminine penthemimeral, hepthemimeral, trithemimeral
θάρσυνον δέ οἱ ἦτορ ἐνὶ φρεσίν, ὄφρα καὶ Ἕκτωρ	--- u u -u u- uu -u u --	dactylic hexameter	feminine penthemimeral, hepthemimeral, trithemimeral
εἴσεται ἤ ῥα καὶ οἶος ἐπίστηται πολεμίζειν	-uu - u u -u u--- uu--	dactylic hexameter	feminine penthemimeral, trithemimeral
ἡμέτερος θεράπων, ἦ οἱ τότε χεῖρες ἄαπτοι	-uu- uu- - - uu -u u--	dactylic hexameter	masculine penthemimeral, hepthemimeral, trithemimeral
μαίνονθ’, ὁππότ’ ἐγώ περ ἴω μετὰ μῶλον Ἄρηος.	-- -u u- u u- uu -u u--	dactylic hexameter	masculine penthemimeral, hepthemimeral
αὐτὰρ ἐπεί κ’ἀπὸ ναῦφι μάχην ἐνοπήν τε δίηται,	-u u- uu -u u- uu- u u--	dactylic hexameter	feminine penthemimeral, hepthemimeral, trithemimeral
ἀσκηθής μοι ἔπειτα θοὰς ἐπὶ νῆας ἵκοιτο	--- u u-u u- uu -u u--	dactylic hexameter	feminine penthemimeral, hepthemimeral, trithemimeral
τεύχεσί τε ξὺν πᾶσι καὶ ἀγχεμάχοις ἑτάροισιν.	-uu - - -u u -uu- uu--	dactylic hexameter	feminine penthemimeral, trithemimeral
ὣς ἔφατ’ εὐχόμενος, τοῦ δ’ἔκλυε μητίετα Ζεύς.	- uu -uu- - -uu -uu- -	dactylic hexameter	masculine penthemimeral
τῷ δ’ἕτερον μὲν ἔδωκε πατήρ, ἕτερον δ’ἀνένευσε·	- uu- u u-u u- uu- uu--	dactylic hexameter	feminine penthemimeral, hepthemimeral, trithemimeral
νηῶν μέν οἱ ἀπώσασθαι πόλεμόν τε μάχην τε	-- - u u--- uu- u u- -	dactylic hexameter	hepthemimeral, trithemimeral
δῶκε, σόον δ’ἀνένευσε μάχης ἐξαπονέεσθαι.	-u u- uu-u u- --uu--	dactylic hexameter	feminine penthemimeral, hepthemimeral, trithemimeral
ἤτοι ὃ μὲν σπείσας τε καὶ εὐξάμενος Διὶ πατρὶ	-u u - -- u u -uu- uu --	dactylic hexameter	masculine penthemimeral, trithemimeral
ἂψ κλισίην εἰσῆλθε, δέπας δ’ἀπέθηκ’ ἐνὶ χηλῷ,	- uu- --u u- uu- uu --	dactylic hexameter	feminine penthemimeral, hepthemimeral, trithemimeral
στῆ δὲ πάροιθ’ ἐλθὼν κλισίης, ἔτι δ’ἤθελε θυμῷ	- u u- -- uu- uu -uu --	dactylic hexameter	masculine penthemimeral, hepthemimeral, trithemimeral
εἰσιδέειν Τρώων καὶ Ἀχαιῶν φύλοπιν αἰνήν.	-uu- -- u u-- -uu --	dactylic hexameter	masculine penthemimeral, trithemimeral
οἳ δ’ἅμα Πατρόκλῳ μεγαλήτορι θωρηχθέντες	- uu --- uu-uu ----	dactylic hexameter	masculine penthemimeral
ἔστιχον, ὄφρ’ ἐν Τρωσὶ μέγα φρονέοντες ὄρουσαν.	-uu - - -u u- uu-u u--	dactylic hexameter	feminine penthemimeral, hepthemimeral, trithemimeral
αὐτίκα δὲ σφήκεσσιν ἐοικότες ἐξεχέοντο	-uu - --u u-uu -uu--	dactylic hexameter	feminine penthemimeral, trithemimeral
εἰνοδίοις, οὓς παῖδες ἐριδμαίνωσιν ἔθοντες	-uu- - -u u---u u--	dactylic hexameter	feminine penthemimeral, trithemimeral
αἰεὶ κερτομέοντες ὁδῷ ἔπι οἰκί’ ἔχοντας	-- -uu-u u- uu -u u--	dactylic hexameter	feminine penthemimeral, hepthemimeral
νηπίαχοι· ξυνὸν δὲ κακὸν πολέεσσι τιθεῖσι.	-uu- -- u u- uu-u u--	dactylic hexameter	masculine penthemimeral, hepthemimeral, trithemimeral
τοὺς δ’εἴ περ παρά τίς τε κιὼν ἄνθρωπος ὁδίτης	- - - uu - u u- --u u--	dactylic hexameter	masculine penthemimeral, hepthemimeral, trithemimeral
κινήσῃ ἀέκων, οἳ δ’ἄλκιμον ἦτορ ἔχοντες	--- uu- - -uu -u u--	dactylic hexameter	masculine penthemimeral, trithemimeral
πρόσσω πᾶς πέτεται καὶ ἀμύνει οἷσι τέκεσσι.	-- - uu- u u-- -u u--	dactylic hexameter	masculine penthemimeral, trithemimeral
τῶν τότε Μυρμιδόνες κραδίην καὶ θυμὸν ἔχοντες	- uu -uu- uu- - -u u--	dactylic hexameter	masculine penthemimeral, hepthemimeral
ἐκ νηῶν ἐχέοντο· βοὴ δ’ἄσβεστος ὀρώρει.	- -- uu-u u- --u u--	dactylic hexameter	feminine penthemimeral, hepthemimeral, trithemimeral
Πάτροκλος δ’ἑτάροισιν ἐκέκλετο μακρὸν ἀΰσας·	--- uu-u u-uu -u u--	dactylic hexameter	feminine penthemimeral, trithemimeral
Μυρμιδόνες ἕταροι Πηληϊάδεω Ἀχιλῆος	-uuu uu- --uu- uu--	lyric	
ἀνέρες ἔστε φίλοι, μνήσασθε δὲ θούριδος ἀλκῆς,	-uu -u u- --u u -uu --	dactylic hexameter	masculine penthemimeral
ὡς ἂν Πηλεΐδην τιμήσομεν, ὃς μέγ’ ἄριστος	- - -uu- --uu - u u--	dactylic hexameter	masculine penthemimeral
Ἀργείων παρὰ νηυσὶ καὶ ἀγχέμαχοι θεράποντες,	--- uu -u u -uu- uu--	dactylic hexameter	feminine penthemimeral, trithemimeral
γνῷ δὲ καὶ Ἀτρεΐδης εὐρὺ κρείων Ἀγαμέμνων	- u u -uu- -- -- uu--	dactylic hexameter	masculine penthemimeral, hepthemimeral
ἣν ἄτην, ὅ τ’ἄριστον Ἀχαιῶν οὐδὲν ἔτισεν.	- -- u u-u u-- -u u--	dactylic hexameter	feminine penthemimeral, trithemimeral
ὣς εἰπὼν ὄτρυνε μένος καὶ θυμὸν ἑκάστου,	- -- -uu u- - -u u--	lyric	
ἐν δ’ἔπεσον Τρώεσσιν ἀολλέες· ἀμφὶ δὲ νῆες	- uu- --u u-uu -u u --	dactylic hexameter	feminine penthemimeral, trithemimeral
σμερδαλέον κονάβησαν ἀϋσάντων ὑπ’ Ἀχαιῶν.	-uu- uu-u u--- u u--	dactylic hexameter	feminine penthemimeral, trithemimeral
Τρῶες δ’ὡς εἴδοντο Μενοιτίου ἄλκιμον υἱὸν	-- - --u u-uu -uu --	dactylic hexameter	feminine penthemimeral, trithemimeral
αὐτὸν καὶ θεράποντα σὺν ἔντεσι μαρμαίροντας,	-- - uu-u u -uu ----	dactylic hexameter	feminine penthemimeral, trithemimeral
πᾶσιν ὀρίνθη θυμός, ἐκίνηθεν δὲ φάλαγγες	-u u-- -u u--- u u--	dactylic hexameter	feminine penthemimeral
ἐλπόμενοι παρὰ ναῦφι ποδώκεα Πηλεΐωνα	-uu- uu -u u-uu -uu--	dactylic hexameter	feminine penthemimeral, trithemimeral
μηνιθμὸν μὲν ἀπορρῖψαι, φιλότητα δ’ἑλέσθαι·	--- u u--- uu-u u--	dactylic hexameter	hepthemimeral, trithemimeral
πάπτηνεν δὲ ἕκαστος ὅπῃ φύγοι αἰπὺν ὄλεθρον.	--- u u-u u- uu -u u--	dactylic hexameter	feminine penthemimeral, hepthemimeral, trithemimeral
Πάτροκλος δὲ πρῶτος ἀκόντισε δουρὶ φαεινῷ	--- - -u u-uu -u u--	dactylic hexameter	feminine penthemimeral, trithemimeral
ἀντικρὺ κατὰ μέσσον, ὅθι πλεῖστοι κλονέοντο,	--- uu -u u- -- uu--	dactylic hexameter	feminine penthemimeral, hepthemimeral, trithemimeral
νηῒ πάρα πρυμνῇ μεγαθύμου Πρωτεσιλάου,	-u u- -- uu-- -uu--	dactylic hexameter	masculine penthemimeral, trithemimeral
καὶ βάλε Πυραίχμην, ὃς Παίονας ἱπποκορυστὰς	- uu --- - -uu -uu--	dactylic hexameter	masculine penthemimeral
ἤγαγεν ἐξ Ἀμυδῶνος ἀπ’ Ἀξιοῦ εὐρὺ ῥέοντος·	-uu - uu-u u -uu -u u--	dactylic hexameter	feminine penthemimeral, trithemimeral
τὸν βάλε δεξιὸν ὦμον· ὃ δ’ὕπτιος ἐν κονίῃσι	- uu -uu -u u -uu - uu--	dactylic hexameter	feminine penthemimeral
κάππεσεν οἰμώξας, ἕταροι δέ μιν ἀμφεφόβηθεν	-uu --- uu- u u -uu--	dactylic hexameter	masculine penthemimeral, hepthemimeral
Παίονες· ἐν γὰρ Πάτροκλος φόβον ἧκεν ἅπασιν	-uu - - --- uu -u u--	dactylic hexameter	hepthemimeral, trithemimeral
ἡγεμόνα κτείνας, ὃς ἀριστεύεσκε μάχεσθαι.	-uu- -- u u---u u--	dactylic hexameter	masculine penthemimeral, trithemimeral
ἐκ νηῶν δ’ἔλασεν, κατὰ δ’ἔσβεσεν αἰθόμενον πῦρ.	- -- uu- -- -uu -uu- -	lyric	
ἡμιδαὴς δ’ἄρα νηῦς λίπετ’ αὐτόθι· τοὶ δὲ φόβηθεν	-uu- uu - uu -uu - u u--	dactylic hexameter	masculine penthemimeral, trithemimeral
Τρῶες θεσπεσίῳ ὁμάδῳ· Δαναοὶ δ’ἐπέχυντο	-- -uu- uu- uu- uu--	dactylic hexameter	masculine penthemimeral, hepthemimeral
νῆας ἀνὰ γλαφυράς· ὅμαδος δ’ἀλίαστος ἐτύχθη.	-u u- uu- uu- uu-u u--	dactylic hexameter	masculine penthemimeral, hepthemimeral, trithemimeral
ὡς δ’ὅτ’ ἀφ’ ὑψηλῆς κορυφῆς ὄρεος μεγάλοιο	- u u --- uu- uu- uu--	dactylic hexameter	masculine penthemimeral, hepthemimeral
κινήσῃ πυκινὴν νεφέλην στεροπηγερέτα Ζεύς,	--- uu- uu- uu-uu- -	dactylic hexameter	masculine penthemimeral, hepthemimeral, trithemimeral
ἔκ τ’ἔφανεν πᾶσαι σκοπιαὶ καὶ πρώονες ἄκροι	- uu- -- uu- - -uu --	dactylic hexameter	masculine penthemimeral, hepthemimeral, trithemimeral
καὶ νάπαι, οὐρανόθεν δ’ἄρ’ ὑπερράγη ἄσπετος αἰθήρ,	- uu -uu- u u-uu -uu --	dactylic hexameter	masculine penthemimeral
ὣς Δαναοὶ νηῶν μὲν ἀπωσάμενοι δήιον πῦρ*	- uu- -- u u-uu- -- -	dactylic hexameter	masculine penthemimeral, trithemimeral
τυτθὸν ἀνέπνευσαν, πολέμου δ’οὐ γίγνετ’ ἐρωή·	-u u--- uu- - -u u--	dactylic hexameter	masculine penthemimeral, hepthemimeral
οὐ γάρ πώ τι Τρῶες ἀρηϊφίλων ὑπ’ Ἀχαιῶν	- - - - -u u-uu- u u--	dactylic hexameter	feminine penthemimeral, trithemimeral
προτροπάδην φοβέοντο μελαινάων ἀπὸ νηῶν,	-uu- uu-u u--- uu --	dactylic hexameter	feminine penthemimeral, trithemimeral
ἀλλ’ ἔτ’ ἄρ’ ἀνθίσταντο, νεῶν δ’ὑπόεικον ἀνάγκῃ.	- u u ---u u- uu-u u--	dactylic hexameter	feminine penthemimeral, hepthemimeral
ἔνθα δ’ἀνὴρ ἕλεν ἄνδρα κεδασθείσης ὑσμίνης	-u u- uu -u u--- ---	dactylic hexameter	feminine penthemimeral, trithemimeral
ἡγεμόνων. πρῶτος δὲ Μενοιτίου ἄλκιμος υἱὸς	-uu- -- u u-uu -uu --	dactylic hexameter	masculine penthemimeral, trithemimeral
αὐτίκ’ ἄρα στρεφθέντος Ἀρηϊλύκου βάλε μηρὸν	-u u- --u u-uu- uu --	dactylic hexameter	feminine penthemimeral, trithemimeral
ἔγχεϊ ὀξυόεντι, διὰ πρὸ δὲ χαλκὸν ἔλασσε·	-uu -uu-u u- u u -u u--	dactylic hexameter	feminine penthemimeral, hepthemimeral
ῥῆξεν δ’ὀστέον ἔγχος, ὃ δὲ πρηνὴς ἐπὶ γαίῃ	-- -uu -u u - -- uu --	dactylic hexameter	feminine penthemimeral, hepthemimeral
κάππεσ’· ἀτὰρ Μενέλαος ἀρήϊος οὖτα Θόαντα	-u u- uu-u u-uu -u u--	dactylic hexameter	feminine penthemimeral, trithemimeral
στέρνον γυμνωθέντα παρ’ ἀσπίδα, λῦσε δὲ γυῖα.	-- ---u u -uu -u u --	dactylic hexameter	feminine penthemimeral
Φυλεΐδης δ’Ἄμφικλον ἐφορμηθέντα δοκεύσας	-uu- --u u---u u--	dactylic hexameter	feminine penthemimeral, trithemimeral
ἔφθη ὀρεξάμενος πρυμνὸν σκέλος, ἔνθα πάχιστος	-u u-uu- -- uu -u u--	dactylic hexameter	masculine penthemimeral, hepthemimeral
μυὼν ἀνθρώπου πέλεται· περὶ δ’ἔγχεος αἰχμῇ	-- --- uu- uu -uu --	dactylic hexameter	masculine penthemimeral, hepthemimeral
νεῦρα διεσχίσθη· τὸν δὲ σκότος ὄσσε κάλυψε.	-u u--- - - uu -u u--	dactylic hexameter	masculine penthemimeral, hepthemimeral
Νεστορίδαι δ’ὃ μὲν οὔτασ’ Ἀτύμνιον ὀξέϊ δουρὶ	-uu- u u -u u-uu -uu --	dactylic hexameter	feminine penthemimeral, trithemimeral
Ἀντίλοχος, λαπάρης δὲ διήλασε χάλκεον ἔγχος·	-uu- uu- u u-uu -uu --	dactylic hexameter	masculine penthemimeral, trithemimeral
ἤριπε δὲ προπάροιθε. Μάρις δ’αὐτοσχεδὰ δουρὶ	-uu - uu-u u- --uu --	dactylic hexameter	feminine penthemimeral, hepthemimeral, trithemimeral
Ἀντιλόχῳ ἐπόρουσε κασιγνήτοιο χολωθεὶς	-uu- uu-u u---u u--	dactylic hexameter	feminine penthemimeral, trithemimeral
στὰς πρόσθεν νέκυος· τοῦ δ’ἀντίθεος Θρασυμήδης	- -- uu- - -uu- uu--	dactylic hexameter	masculine penthemimeral, trithemimeral
ἔφθη ὀρεξάμενος πρὶν οὐτάσαι, οὐδ’ ἀφάμαρτεν,	-u u-uu- - -uu - uu--	dactylic hexameter	masculine penthemimeral
ὦμον ἄφαρ· πρυμνὸν δὲ βραχίονα δουρὸς ἀκωκὴ	-u u- -- u u-uu -u u--	dactylic hexameter	masculine penthemimeral, trithemimeral
δρύψ’ ἀπὸ μυώνων, ἀπὸ δ’ὀστέον ἄχρις ἄραξε·	- uu --- uu -uu -u u--	dactylic hexameter	masculine penthemimeral
δούπησεν δὲ πεσών, κατὰ δὲ σκότος ὄσσε κάλυψεν.	--- u u- uu - uu -u u--	dactylic hexameter	masculine penthemimeral, hepthemimeral, trithemimeral
ὣς τὼ μὲν δοιοῖσι κασιγνήτοισι δαμέντε	- - - u-u u---u u--	lyric	
βήτην εἰς Ἔρεβος Σαρπηδόνος ἐσθλοὶ ἑταῖροι	-- - uu- --uu -u u--	dactylic hexameter	masculine penthemimeral, trithemimeral
υἷες ἀκοντισταὶ Ἀμισωδάρου, ὅς ῥα Χίμαιραν	-u u--- uu-uu - u u--	dactylic hexameter	masculine penthemimeral
θρέψεν ἀμαιμακέτην πολέσιν κακὸν ἀνθρώποισιν.	-u u-uu- uu- uu ----	dactylic hexameter	masculine penthemimeral, hepthemimeral
Αἴας δὲ Κλεόβουλον Ὀϊλιάδης ἐπορούσας	-- - --u u-uu- uu--	dactylic hexameter	feminine penthemimeral, trithemimeral
ζωὸν ἕλε βλαφθέντα κατὰ κλόνον· ἀλλά οἱ αὖθι	-u u- --u u- uu -u u --	dactylic hexameter	feminine penthemimeral, hepthemimeral, trithemimeral
λῦσε μένος πλήξας ξίφει αὐχένα κωπήεντι.	-u u- -- uu -uu ----	dactylic hexameter	masculine penthemimeral, trithemimeral
πᾶν δ’ὑπεθερμάνθη ξίφος αἵματι· τὸν δὲ κατ’ ὄσσε	- uu--- uu -uu - u u --	dactylic hexameter	masculine penthemimeral
ἔλλαβε πορφύρεος θάνατος καὶ μοῖρα κραταιή.	-uu -uu- uu- - -u u--	dactylic hexameter	masculine penthemimeral, hepthemimeral
Πηνέλεως δὲ Λύκων τε συνέδραμον· ἔγχεσι μὲν γὰρ	-uu- u u- u u-uu -uu - -	dactylic hexameter	masculine penthemimeral, trithemimeral
ἤμβροτον ἀλλήλων, μέλεον δ’ἠκόντισαν ἄμφω·	-uu --- uu- --uu --	dactylic hexameter	masculine penthemimeral, hepthemimeral
τὼ δ’αὖτις ξιφέεσσι συνέδραμον. ἔνθα Λύκων μὲν	- -- uu-u u-uu -u u- -	dactylic hexameter	feminine penthemimeral, trithemimeral
ἱπποκόμου κόρυθος φάλον ἤλασεν, ἀμφὶ δὲ καυλὸν	-uu- uu- uu -uu -u u --	dactylic hexameter	masculine penthemimeral, trithemimeral
φάσγανον ἐρραίσθη· ὃ δ’ὑπ’ οὔατος αὐχένα θεῖνε	-uu --- u u -uu -uu --	dactylic hexameter	masculine penthemimeral
Πηνέλεως, πᾶν δ’εἴσω ἔδυ ξίφος, ἔσχεθε δ’οἶον	-uu- - -u u- uu -uu --	dactylic hexameter	feminine penthemimeral, hepthemimeral, trithemimeral
δέρμα, παρηέρθη δὲ κάρη, ὑπέλυντο δὲ γυῖα.	-u u--- u u- uu-u u --	dactylic hexameter	masculine penthemimeral, hepthemimeral
Μηριόνης δ’Ἀκάμαντα κιχεὶς ποσὶ καρπαλίμοισι	-uu- uu-u u- uu -uu--	dactylic hexameter	feminine penthemimeral, hepthemimeral, trithemimeral
νύξ’ ἵππων ἐπιβησόμενον κατὰ δεξιὸν ὦμον·	- -- uu-uu- uu -uu --	dactylic hexameter	hepthemimeral, trithemimeral
ἤριπε δ’ἐξ ὀχέων, κατὰ δ’ὀφθαλμῶν κέχυτ’ ἀχλύς.	-uu - uu- uu --- uu --	dactylic hexameter	masculine penthemimeral, trithemimeral
Ἰδομενεὺς δ’Ἐρύμαντα κατὰ στόμα νηλέϊ χαλκῷ	-uu- uu-u u- uu -uu --	dactylic hexameter	feminine penthemimeral, hepthemimeral, trithemimeral
νύξε· τὸ δ’ἀντικρὺ δόρυ χάλκεον ἐξεπέρησε	-u u --- uu -uu -uu--	dactylic hexameter	masculine penthemimeral
νέρθεν ὑπ’ ἐγκεφάλοιο, κέασσε δ’ἄρ’ ὀστέα λευκά·	-u u -uu-u u-u u -uu --	dactylic hexameter	feminine penthemimeral
ἐκ δ’ἐτίναχθεν ὀδόντες, ἐνέπλησθεν δέ οἱ ἄμφω	- uu-u u-u u--- u u --	dactylic hexameter	feminine penthemimeral
αἵματος ὀφθαλμοί· τὸ δ’ἀνὰ στόμα καὶ κατὰ ῥῖνας	-uu --- u u- uu - uu --	dactylic hexameter	masculine penthemimeral, hepthemimeral
πρῆσε χανών· θανάτου δὲ μέλαν νέφος ἀμφεκάλυψεν.	-u u- uu- u u- uu -uu--	dactylic hexameter	masculine penthemimeral, hepthemimeral, trithemimeral
οὗτοι ἄρ’ ἡγεμόνες Δαναῶν ἕλον ἄνδρα ἕκαστος.	-u u -uu- uu- uu -u u--	dactylic hexameter	masculine penthemimeral, hepthemimeral
ὡς δὲ λύκοι ἄρνεσσιν ἐπέχραον ἢ ἐρίφοισι	- u u- -uu u-uu - uu--	lyric	
σίνται ὑπ’ ἐκ μήλων αἱρεύμενοι, αἵ τ’ἐν ὄρεσσι	-u u - -- --uu - u u--	dactylic hexameter	masculine penthemimeral, trithemimeral
ποιμένος ἀφραδίῃσι διέτμαγεν· οἳ δὲ ἰδόντες	-uu -uu-u u-uu - u u--	dactylic hexameter	feminine penthemimeral
αἶψα διαρπάζουσιν ἀνάλκιδα θυμὸν ἐχούσας·	-u u---u u-uu -u u--	dactylic hexameter	feminine penthemimeral
ὣς Δαναοὶ Τρώεσσιν ἐπέχραον· οἳ δὲ φόβοιο	- uu- --u u-uu - u u--	dactylic hexameter	feminine penthemimeral, trithemimeral
δυσκελάδου μνήσαντο, λάθοντο δὲ θούριδος ἀλκῆς.	-uu- --u u-u u -uu --	dactylic hexameter	feminine penthemimeral, trithemimeral
Αἴας δ’ὃ μέγας αἰὲν ἐφ’ Ἕκτορι χαλκοκορυστῇ	-- - uu -u u -uu -uu--	dactylic hexameter	feminine penthemimeral, trithemimeral
ἵετ’ ἀκοντίσσαι· ὃ δὲ ἰδρείῃ πολέμοιο	-u u--- u u --- uu--	dactylic hexameter	masculine penthemimeral
ἀσπίδι ταυρείῃ κεκαλυμμένος εὐρέας ὤμους	-uu --- uu-uu -uu --	dactylic hexameter	masculine penthemimeral
σκέπτετ’ ὀϊστῶν τε ῥοῖζον καὶ δοῦπον ἀκόντων.	-u u-- - -- - -u u--	dactylic hexameter	masculine penthemimeral, hepthemimeral
ἦ μὲν δὴ γίγνωσκε μάχης ἑτεραλκέα νίκην·	- - - --u u- uu-uu --	dactylic hexameter	feminine penthemimeral, hepthemimeral, trithemimeral
ἀλλὰ καὶ ὧς ἀνέμιμνε, σάω δ’ἐρίηρας ἑταίρους.	-u u - uu-u u- uu-u u--	dactylic hexameter	feminine penthemimeral, hepthemimeral, trithemimeral
ὡς δ’ὅτ’ ἀπ’ Οὐλύμπου νέφος ἔρχεται οὐρανὸν εἴσω	- u u --- uu -uu -uu --	dactylic hexameter	masculine penthemimeral
αἰθέρος ἐκ δίης, ὅτε τε Ζεὺς λαίλαπα τείνῃ,	-uu - -- uu - - -uu --	dactylic hexameter	masculine penthemimeral, hepthemimeral, trithemimeral
ὣς τῶν ἐκ νηῶν γένετο ἰαχή τε φόβος τε,	- - - -- uu- uu- u u- -	dactylic hexameter	masculine penthemimeral, hepthemimeral, trithemimeral
οὐδὲ κατὰ μοῖραν πέραον πάλιν. Ἕκτορα δ’ἵπποι	-u u- -- uu- uu -uu --	dactylic hexameter	masculine penthemimeral, hepthemimeral, trithemimeral
ἔκφερον ὠκύποδες σὺν τεύχεσι, λεῖπε δὲ λαὸν	-uu -uu- - -uu -u u --	dactylic hexameter	masculine penthemimeral
Τρωϊκόν, οὓς ἀέκοντας ὀρυκτὴ τάφρος ἔρυκε.	-uu - uu-u u-- -u u--	dactylic hexameter	feminine penthemimeral, trithemimeral
πολλοὶ δ’ἐν τάφρῳ ἐρυσάρματες ὠκέες ἵπποι	-- - -- uu-uu -uu --	dactylic hexameter	masculine penthemimeral, trithemimeral
ἄξαντ’ ἐν πρώτῳ ῥυμῷ λίπον ἅρματ’ ἀνάκτων,	-- - -- -- uu -u u--	dactylic hexameter	masculine penthemimeral, hepthemimeral, trithemimeral
Πάτροκλος δ’ἕπετο σφεδανὸν Δαναοῖσι κελεύων	-u- uu- uu- uu-u u--	lyric	
Τρωσὶ κακὰ φρονέων· οἳ δὲ ἰαχῇ τε φόβῳ τε	-u u- uu- - - uu- u u- -	dactylic hexameter	masculine penthemimeral, hepthemimeral, trithemimeral
πάσας πλῆσαν ὁδούς, ἐπεὶ ἂρ τμάγεν· ὕψι δ’ἀέλλη	-- -u u- uu - uu -u u--	dactylic hexameter	masculine penthemimeral, hepthemimeral
σκίδναθ’ ὑπὸ νεφέων, τανύοντο δὲ μώνυχες ἵπποι	-u u- uu- uu-u u -uu --	dactylic hexameter	masculine penthemimeral, trithemimeral
ἄψορρον προτὶ ἄστυ νεῶν ἄπο καὶ κλισιάων.	--- uu -u u- uu - uu--	dactylic hexameter	feminine penthemimeral, hepthemimeral, trithemimeral
Πάτροκλος δ’ᾗ πλεῖστον ὀρινόμενον ἴδε λαόν,	--- - -u u-uu- uu --	dactylic hexameter	feminine penthemimeral, trithemimeral
τῇ ῥ’ἔχ’ ὁμοκλήσας· ὑπὸ δ’ἄξοσι φῶτες ἔπιπτον	- u u--- uu -uu -u u--	dactylic hexameter	masculine penthemimeral
πρηνέες ἐξ ὀχέων, δίφροι δ’ἀνακυμβαλίαζον.	-uu - uu- -- uu-uu--	dactylic hexameter	masculine penthemimeral, hepthemimeral, trithemimeral
ἀντικρὺ δ’ἄρα τάφρον ὑπέρθορον ὠκέες ἵπποι	--- uu -u u-uu -uu --	dactylic hexameter	feminine penthemimeral, trithemimeral
ἄμβροτοι, οὓς Πηλῆϊ θεοὶ δόσαν ἀγλαὰ δῶρα,	-uu - --u u- uu -uu --	dactylic hexameter	feminine penthemimeral, hepthemimeral, trithemimeral
πρόσσω ἱέμενοι, ἐπὶ δ’Ἕκτορι κέκλετο θυμός·	-- -uu- uu -uu -uu --	dactylic hexameter	masculine penthemimeral
ἵετο γὰρ βαλέειν· τὸν δ’ἔκφερον ὠκέες ἵπποι.	-uu - uu- - -uu -uu --	dactylic hexameter	masculine penthemimeral, trithemimeral
ὡς δ’ὑπὸ λαίλαπι πᾶσα κελαινὴ βέβριθε χθὼν	- uu -uu -u u-- --- -	dactylic hexameter	feminine penthemimeral
ἤματ’ ὀπωρινῷ, ὅτε λαβρότατον χέει ὕδωρ	-u u--- uu -uu- uu --	dactylic hexameter	masculine penthemimeral
Ζεύς, ὅτε δή ῥ’ἄνδρεσσι κοτεσσάμενος χαλεπήνῃ,	- uu - --u u-uu- uu--	dactylic hexameter	feminine penthemimeral, trithemimeral
οἳ βίῃ εἰν ἀγορῇ σκολιὰς κρίνωσι θέμιστας,	- uu - uu- uu- --u u--	dactylic hexameter	masculine penthemimeral, hepthemimeral, trithemimeral
ἐκ δὲ δίκην ἐλάσωσι θεῶν ὄπιν οὐκ ἀλέγοντες·	- u u- uu-u u- uu - uu--	dactylic hexameter	feminine penthemimeral, hepthemimeral, trithemimeral
τῶν δέ τε πάντες μὲν ποταμοὶ πλήθουσι ῥέοντες,	- u u -- - uu- --u u--	dactylic hexameter	masculine penthemimeral, hepthemimeral
πολλὰς δὲ κλιτῦς τότ’ ἀποτμήγουσι χαράδραι,	-- - -- u u---u u--	dactylic hexameter	masculine penthemimeral, trithemimeral
ἐς δ’ἅλα πορφυρέην μεγάλα στενάχουσι ῥέουσαι	- uu -uu- uu- uu-u u--	dactylic hexameter	masculine penthemimeral, hepthemimeral
ἐξ ὀρέων ἐπικάρ, μινύθει δέ τε ἔργ’ ἀνθρώπων·	- uu- uu- uu- u u - ---	dactylic hexameter	masculine penthemimeral, hepthemimeral, trithemimeral
ὣς ἵπποι Τρῳαὶ μεγάλα στενάχοντο θέουσαι.	- -- -- uu- uu-u u--	dactylic hexameter	masculine penthemimeral, hepthemimeral, trithemimeral
Πάτροκλος δ’ἐπεὶ οὖν πρώτας ἐπέκερσε φάλαγγας,	--- uu - -- uu-u u--	dactylic hexameter	masculine penthemimeral, hepthemimeral, trithemimeral
ἂψ ἐπὶ νῆας ἔεργε παλιμπετές, οὐδὲ πόληος	- uu -u u-u u-uu -u u--	dactylic hexameter	feminine penthemimeral
εἴα ἱεμένους ἐπιβαινέμεν, ἀλλὰ μεσηγὺ	-- -uu- uu-uu -u u--	dactylic hexameter	masculine penthemimeral
νηῶν καὶ ποταμοῦ καὶ τείχεος ὑψηλοῖο	-- - uu- - -uu ----	dactylic hexameter	masculine penthemimeral, trithemimeral
κτεῖνε μεταΐσσων, πολέων δ’ἀπετίνυτο ποινήν.	-u u--- uu- uu-uu --	dactylic hexameter	masculine penthemimeral, hepthemimeral
ἔνθ’ ἤτοι Πρόνοον πρῶτον βάλε δουρὶ φαεινῷ	- -- uu- -- uu -u u--	dactylic hexameter	masculine penthemimeral, hepthemimeral, trithemimeral
στέρνον γυμνωθέντα παρ’ ἀσπίδα, λῦσε δὲ γυῖα·	-- ---u u -uu -u u --	dactylic hexameter	feminine penthemimeral
δούπησεν δὲ πεσών· ὃ δὲ Θέστορα Ἤνοπος υἱὸν	--- u u- u u -uu -uu --	dactylic hexameter	masculine penthemimeral, trithemimeral
δεύτερον ὁρμηθείς· ὃ μὲν εὐξέστῳ ἐνὶ δίφρῳ	-uu --- u u --- uu --	dactylic hexameter	masculine penthemimeral
ἧστο ἀλείς· ἐκ γὰρ πλήγη φρένας, ἐκ δ’ἄρα χειρῶν	-u u- - - -- uu - uu --	dactylic hexameter	masculine penthemimeral, hepthemimeral, trithemimeral
ἡνία ἠΐχθησαν· ὃ δ’ἔγχεϊ νύξε παραστὰς	-uu ---u u -uu -u u--	dactylic hexameter	feminine penthemimeral
γναθμὸν δεξιτερόν, διὰ δ’αὐτοῦ πεῖρεν ὀδόντων,	-- -uu- uu -- -u u--	dactylic hexameter	masculine penthemimeral
ἕλκε δὲ δουρὸς ἑλὼν ὑπὲρ ἄντυγος, ὡς ὅτε τις φὼς	-u u -u u- uu -uu - uu - -	dactylic hexameter	masculine penthemimeral
πέτρῃ ἔπι προβλῆτι καθήμενος ἱερὸν ἰχθὺν	-u u- --u u-uu -uu --	dactylic hexameter	feminine penthemimeral, trithemimeral
ἐκ πόντοιο θύραζε λίνῳ καὶ ἤνοπι χαλκῷ·	- --u u-u u- - -uu --	dactylic hexameter	feminine penthemimeral, hepthemimeral
ὣς ἕλκ’ ἐκ δίφροιο κεχηνότα δουρὶ φαεινῷ,	- - - --u u-uu -u u--	dactylic hexameter	feminine penthemimeral, trithemimeral
κὰδ δ’ἄρ’ ἐπὶ στόμ’ ἔωσε· πεσόντα δέ μιν λίπε θυμός.	- u u- u u-u u-u u - uu --	dactylic hexameter	feminine penthemimeral, trithemimeral
αὐτὰρ ἔπειτ’ Ἐρύλαον ἐπεσσύμενον βάλε πέτρῳ	-u u- uu-u u-uu- uu --	dactylic hexameter	feminine penthemimeral, trithemimeral
μέσσην κὰκ κεφαλήν· ἣ δ’ἄνδιχα πᾶσα κεάσθη	-- - uu- - -uu -u u--	dactylic hexameter	masculine penthemimeral, trithemimeral
ἐν κόρυθι βριαρῇ· ὃ δ’ἄρα πρηνὴς ἐπὶ γαίῃ	- uu- uu- u u- -- uu --	dactylic hexameter	masculine penthemimeral, hepthemimeral, trithemimeral
κάππεσεν, ἀμφὶ δέ μιν θάνατος χύτο θυμοραϊστής.	-uu -u u - uu- uu -uu--	dactylic hexameter	masculine penthemimeral, hepthemimeral
αὐτὰρ ἔπειτ’ Ἐρύμαντα καὶ Ἀμφοτερὸν καὶ Ἐπάλτην	-u u- uu-u u -uu- u u--	dactylic hexameter	feminine penthemimeral, trithemimeral
Τληπόλεμόν τε Δαμαστορίδην Ἐχίον τε Πύριν τε	-uu- u u-uu- uu- u u- -	dactylic hexameter	hepthemimeral, trithemimeral
Ἰφέα τ’Εὔιππόν τε καὶ Ἀργεάδην Πολύμηλον	-uu --- u u --- uu--	dactylic hexameter	masculine penthemimeral
πάντας ἐπασσυτέρους πέλασε χθονὶ πουλυβοτείρῃ.	-u u-uu- uu- uu -uu--	dactylic hexameter	masculine penthemimeral, hepthemimeral
Σαρπηδὼν δ’ὡς οὖν ἴδ’ ἀμιτροχίτωνας ἑταίρους	--- - - u u-uu-u u--	dactylic hexameter	masculine penthemimeral, trithemimeral
χέρσ’ ὕπο Πατρόκλοιο Μενοιτιάδαο δαμέντας,	- uu ---u u-uu-u u--	dactylic hexameter	feminine penthemimeral
κέκλετ’ ἄρ’ ἀντιθέοισι καθαπτόμενος Λυκίοισιν·	-u u -uu-u u-uu- uu--	dactylic hexameter	feminine penthemimeral
αἰδὼς ὦ Λύκιοι· πόσε φεύγετε; νῦν θοοὶ ἔστε.	-- - uu- uu -uu - uu --	dactylic hexameter	masculine penthemimeral, trithemimeral
ἀντήσω γὰρ ἐγὼ τοῦδ’ ἀνέρος, ὄφρα δαείω	--- u u- - -uu -u u--	dactylic hexameter	masculine penthemimeral, trithemimeral
ὅς τις ὅδε κρατέει καὶ δὴ κακὰ πολλὰ ἔοργε	- u u- uu- - - uu -u u--	dactylic hexameter	masculine penthemimeral, hepthemimeral, trithemimeral
Τρῶας, ἐπεὶ πολλῶν τε καὶ ἐσθλῶν γούνατ’ ἔλυσεν.	-u u- -- u u -- -u u--	dactylic hexameter	masculine penthemimeral, trithemimeral
ἦ ῥα, καὶ ἐξ ὀχέων σὺν τεύχεσιν ἆλτο χαμᾶζε.	- u u - uu- - -uu -u u--	dactylic hexameter	masculine penthemimeral, trithemimeral
Πάτροκλος δ’ἑτέρωθεν ἐπεὶ ἴδεν ἔκθορε δίφρου.	--- uu-u u- uu -uu --	dactylic hexameter	feminine penthemimeral, hepthemimeral, trithemimeral
οἳ δ’ὥς τ’αἰγυπιοὶ γαμψώνυχες ἀγκυλοχεῖλαι	- - -uu- --uu -uu--	dactylic hexameter	masculine penthemimeral
πέτρῃ ἐφ’ ὑψηλῇ μεγάλα κλάζοντε μάχωνται,	-u u --- uu- --u u--	dactylic hexameter	masculine penthemimeral, hepthemimeral
ὣς οἳ κεκλήγοντες ἐπ’ ἀλλήλοισιν ὄρουσαν.	- - ---u u ---u u--	dactylic hexameter	feminine penthemimeral
τοὺς δὲ ἰδὼν ἐλέησε Κρόνου πάϊς ἀγκυλομήτεω,	- u u- uu-u u- uu -uu--	dactylic hexameter	feminine penthemimeral, hepthemimeral, trithemimeral
Ἥρην δὲ προσέειπε κασιγνήτην ἄλοχόν τε·	-- - uu-u u--- uu- -	dactylic hexameter	feminine penthemimeral, trithemimeral
ὤ μοι ἐγών, ὅ τέ μοι Σαρπηδόνα φίλτατον ἀνδρῶν	- u uu u u - --uu -uu --	lyric	
μοῖρ’ ὑπὸ Πατρόκλοιο Μενοιτιάδαο δαμῆναι.	- uu ---u u-uu-u u--	dactylic hexameter	feminine penthemimeral
διχθὰ δέ μοι κραδίη μέμονε φρεσὶν ὁρμαίνοντι,	-u u - uu- uu- uu ----	dactylic hexameter	masculine penthemimeral, hepthemimeral, trithemimeral
ἤ μιν ζωὸν ἐόντα μάχης ἄπο δακρυοέσσης	- - -u u-u u- uu -uu--	dactylic hexameter	feminine penthemimeral, hepthemimeral
θείω ἀναρπάξας Λυκίης ἐν πίονι δήμῳ,	-u u--- uu- - -uu --	dactylic hexameter	masculine penthemimeral, hepthemimeral
ἦ ἤδη ὑπὸ χερσὶ Μενοιτιάδαο δαμάσσω.	- -- uu -u u-uu-u u--	dactylic hexameter	feminine penthemimeral, trithemimeral
τὸν δ’ἠμείβετ’ ἔπειτα βοῶπις πότνια Ἥρη·	- -uu u-u u-- -uu --	lyric	
αἰνότατε Κρονίδη ποῖον τὸν μῦθον ἔειπες.	-uu- uu- -- - -u u--	dactylic hexameter	masculine penthemimeral, hepthemimeral, trithemimeral
ἄνδρα θνητὸν ἐόντα πάλαι πεπρωμένον αἴσῃ	-- -u u-u u- --uu --	dactylic hexameter	feminine penthemimeral, hepthemimeral
ἂψ ἐθέλεις θανάτοιο δυσηχέος ἐξαναλῦσαι;	- uu- uu-u u-uu -uu--	dactylic hexameter	feminine penthemimeral, trithemimeral
ἔρδ’· ἀτὰρ οὔ τοι πάντες ἐπαινέομεν θεοὶ ἄλλοι.	- uu - - -u u-uu- uu --	dactylic hexameter	feminine penthemimeral, trithemimeral
ἄλλο δέ τοι ἐρέω, σὺ δ’ἐνὶ φρεσὶ βάλλεο σῇσιν·	-u u - uu- u u- uu -uu --	dactylic hexameter	masculine penthemimeral, hepthemimeral, trithemimeral
αἴ κε ζὼν πέμψῃς Σαρπηδόνα ὃν δὲ δόμον δέ,	- - - -- --uu - u u- -	dactylic hexameter	masculine penthemimeral, trithemimeral
φράζεο μή τις ἔπειτα θεῶν ἐθέλῃσι καὶ ἄλλος	-uu - u u-u u- uu-u u --	dactylic hexameter	feminine penthemimeral, hepthemimeral, trithemimeral
πέμπειν ὃν φίλον υἱὸν ἀπὸ κρατερῆς ὑσμίνης·	-- - uu -u u- uu- ---	dactylic hexameter	feminine penthemimeral, hepthemimeral, trithemimeral
πολλοὶ γὰρ περὶ ἄστυ μέγα Πριάμοιο μάχονται	-- - uu -u u- uu-u u--	dactylic hexameter	feminine penthemimeral, hepthemimeral, trithemimeral
υἱέες ἀθανάτων, τοῖσιν κότον αἰνὸν ἐνήσεις.	-uu -uu- -- uu -u u--	dactylic hexameter	masculine penthemimeral, hepthemimeral
ἀλλ’ εἴ τοι φίλος ἐστί, τεὸν δ’ὀλοφύρεται ἦτορ,	- - - uu -u u- uu-uu --	dactylic hexameter	feminine penthemimeral, hepthemimeral, trithemimeral
ἤτοι μέν μιν ἔασον ἐνὶ κρατερῇ ὑσμίνῃ	-- - u u-u u- uu- ---	dactylic hexameter	feminine penthemimeral, hepthemimeral, trithemimeral
χέρσ’ ὕπο Πατρόκλοιο Μενοιτιάδαο δαμῆναι·	- uu ---u u-uu-u u--	dactylic hexameter	feminine penthemimeral
αὐτὰρ ἐπὴν δὴ τόν γε λίπῃ ψυχή τε καὶ αἰών,	-u u- - - u u- -- u u --	dactylic hexameter	masculine penthemimeral, hepthemimeral, trithemimeral
πέμπειν μιν θάνατόν τε φέρειν καὶ νήδυμον ὕπνον	-- - uu- u u- - -uu --	dactylic hexameter	masculine penthemimeral, hepthemimeral, trithemimeral
εἰς ὅ κε δὴ Λυκίης εὐρείης δῆμον ἵκωνται,	- u u - uu- --- -u u--	dactylic hexameter	masculine penthemimeral, trithemimeral
ἔνθά ἑ ταρχύσουσι κασίγνητοί τε ἔται τε	-u u ---u u--- u u- -	dactylic hexameter	feminine penthemimeral
τύμβῳ τε στήλῃ τε· τὸ γὰρ γέρας ἐστὶ θανόντων.	-- - -- u u - uu -u u--	dactylic hexameter	masculine penthemimeral, hepthemimeral, trithemimeral
ὣς ἔφατ’, οὐδ’ ἀπίθησε πατὴρ ἀνδρῶν τε θεῶν τε·	- uu - uu-u u- -- u u- -	dactylic hexameter	feminine penthemimeral, hepthemimeral, trithemimeral
αἱματοέσσας δὲ ψιάδας κατέχευεν ἔραζε	-uu-- - uu- uu-u u--	dactylic hexameter	masculine penthemimeral, hepthemimeral
παῖδα φίλον τιμῶν, τόν οἱ Πάτροκλος ἔμελλε	-u u- -- - - --u u--	dactylic hexameter	masculine penthemimeral, hepthemimeral, trithemimeral
φθίσειν ἐν Τροίῃ ἐριβώλακι τηλόθι πάτρης.	-- - -- uu-uu -uu --	dactylic hexameter	masculine penthemimeral, trithemimeral
οἳ δ’ὅτε δὴ σχεδὸν ἦσαν ἐπ’ ἀλλήλοισιν ἰόντες,	- uu - uu -u u ---u u--	dactylic hexameter	feminine penthemimeral, trithemimeral
ἔνθ’ ἤτοι Πάτροκλος ἀγακλειτὸν Θρασύμηλον,	- -- --u u--- uu--	dactylic hexameter	feminine penthemimeral, trithemimeral
ὅς ῥ’ἠῢς θεράπων Σαρπηδόνος ἦεν ἄνακτος,	- -- uu- --uu -u u--	dactylic hexameter	masculine penthemimeral, trithemimeral
τὸν βάλε νείαιραν κατὰ γαστέρα, λῦσε δὲ γυῖα.	- uu --- uu -uu -u u --	dactylic hexameter	masculine penthemimeral
Σαρπηδὼν δ’αὐτοῦ μὲν ἀπήμβροτε δουρὶ φαεινῷ	--- -- u u-uu -u u--	dactylic hexameter	masculine penthemimeral, trithemimeral
δεύτερον ὁρμηθείς, ὃ δὲ Πήδασον οὔτασεν ἵππον	-uu --- u u -uu -uu --	dactylic hexameter	masculine penthemimeral
ἔγχεϊ δεξιὸν ὦμον· ὃ δ’ἔβραχε θυμὸν ἀΐσθων,	-uu -uu -u u -uu -u u--	dactylic hexameter	feminine penthemimeral
κὰδ δ’ἔπεσ’ ἐν κονίῃσι μακών, ἀπὸ δ’ἔπτατο θυμός.	- uu - uu-u u- uu -uu --	dactylic hexameter	feminine penthemimeral, hepthemimeral, trithemimeral
τὼ δὲ διαστήτην, κρίκε δὲ ζυγόν, ἡνία δέ σφι	- u u--- uu - uu -uu - -	dactylic hexameter	masculine penthemimeral, hepthemimeral
σύγχυτ’, ἐπεὶ δὴ κεῖτο παρήορος ἐν κονίῃσι.	-u u- - -u u-uu - uu--	dactylic hexameter	feminine penthemimeral, trithemimeral
τοῖο μὲν Αὐτομέδων δουρικλυτὸς εὕρετο τέκμωρ·	-u u -uu- --uu -uu --	dactylic hexameter	masculine penthemimeral
σπασσάμενος τανύηκες ἄορ παχέος παρὰ μηροῦ	-uu- uu-u u- uu- uu --	dactylic hexameter	feminine penthemimeral, hepthemimeral, trithemimeral
ἀΐξας ἀπέκοψε παρήορον οὐδ’ ἐμάτησε·	--- uu-u u-uu - uu--	dactylic hexameter	feminine penthemimeral, trithemimeral
τὼ δ’ἰθυνθήτην, ἐν δὲ ῥυτῆρσι τάνυσθεν·	- ---- - - --u u--	dactylic hexameter	masculine penthemimeral, hepthemimeral
τὼ δ’αὖτις συνίτην ἔριδος πέρι θυμοβόροιο.	- -- uu- uu- uu -uu--	dactylic hexameter	masculine penthemimeral, hepthemimeral, trithemimeral
ἔνθ’ αὖ Σαρπηδὼν μὲν ἀπήμβροτε δουρὶ φαεινῷ,	- - --- u u-uu -u u--	dactylic hexameter	masculine penthemimeral
Πατρόκλου δ’ὑπὲρ ὦμον ἀριστερὸν ἤλυθ’ ἀκωκὴ	--- uu -u u-uu -u u--	dactylic hexameter	feminine penthemimeral, trithemimeral
ἔγχεος, οὐδ’ ἔβαλ’ αὐτόν· ὃ δ’ὕστερος ὄρνυτο χαλκῷ	-uu - uu -u u -uu -uu --	dactylic hexameter	feminine penthemimeral, trithemimeral
Πάτροκλος· τοῦ δ’οὐχ ἅλιον βέλος ἔκφυγε χειρός,	--- - - uu- uu -uu --	dactylic hexameter	masculine penthemimeral, hepthemimeral, trithemimeral
ἀλλ’ ἔβαλ’ ἔνθ’ ἄρα τε φρένες ἔρχαται ἀμφ’ ἁδινὸν κῆρ.	- uu - uu - uu -uu - uu- -	dactylic hexameter	masculine penthemimeral, trithemimeral
ἤριπε δ’ὡς ὅτε τις δρῦς ἤριπεν ἢ ἀχερωῒς	-uu - uu - - -uu - uu--	dactylic hexameter	masculine penthemimeral, trithemimeral
ἠὲ πίτυς βλωθρή, τήν τ’οὔρεσι τέκτονες ἄνδρες	-u u- -- - -uu -uu --	dactylic hexameter	masculine penthemimeral, trithemimeral
ἐξέταμον πελέκεσσι νεήκεσι νήϊον εἶναι·	-uu- uu-u u-uu -uu --	dactylic hexameter	feminine penthemimeral, trithemimeral
ὣς ὃ πρόσθ’ ἵππων καὶ δίφρου κεῖτο τανυσθεὶς	- - - -- - -- -u u--	dactylic hexameter	masculine penthemimeral, trithemimeral
βεβρυχὼς κόνιος δεδραγμένος αἱματοέσσης.	--- uu- --uu -uu--	dactylic hexameter	masculine penthemimeral, trithemimeral
ἠΰτε ταῦρον ἔπεφνε λέων ἀγέληφι μετελθὼν	-uu -u u-u u- uu-u u--	dactylic hexameter	feminine penthemimeral, hepthemimeral
αἴθωνα μεγάθυμον ἐν εἰλιπόδεσσι βόεσσι,	--- uu-u u -uu-u u--	dactylic hexameter	feminine penthemimeral, trithemimeral
ὤλετό τε στενάχων ὑπὸ γαμφηλῇσι λέοντος,	-uu - uu- uu ---u u--	dactylic hexameter	masculine penthemimeral, trithemimeral
ὣς ὑπὸ Πατρόκλῳ Λυκίων ἀγὸς ἀσπιστάων	- uu --- uu- uu ----	dactylic hexameter	masculine penthemimeral, hepthemimeral
κτεινόμενος μενέαινε, φίλον δ’ὀνόμηνεν ἑταῖρον·	-uu- uu-u u- uu-u u--	dactylic hexameter	feminine penthemimeral, hepthemimeral, trithemimeral
Γλαῦκε πέπον πολεμιστὰ μετ’ ἀνδράσι νῦν σε μάλα χρὴ	-u u- uu-u u -uu - u u- -	dactylic hexameter	feminine penthemimeral, trithemimeral
αἰχμητήν τ’ἔμεναι καὶ θαρσαλέον πολεμιστήν·	--- uu- - -uu- uu--	dactylic hexameter	masculine penthemimeral, trithemimeral
νῦν τοι ἐελδέσθω πόλεμος κακός, εἰ θοός ἐσσι.	- u u--- uu- uu - uu --	dactylic hexameter	masculine penthemimeral, hepthemimeral
πρῶτα μὲν ὄτρυνον Λυκίων ἡγήτορας ἄνδρας	-u u --- uu- --uu --	dactylic hexameter	masculine penthemimeral, hepthemimeral
πάντῃ ἐποιχόμενος Σαρπηδόνος ἀμφιμάχεσθαι·	-u u-uu- --uu -uu--	dactylic hexameter	masculine penthemimeral
αὐτὰρ ἔπειτα καὶ αὐτὸς ἐμεῦ πέρι μάρναο χαλκῷ.	-u u-u u -u u- uu -uu --	dactylic hexameter	feminine penthemimeral, hepthemimeral
σοὶ γὰρ ἐγὼ καὶ ἔπειτα κατηφείη καὶ ὄνειδος	- u u- u u-u u--- u u--	dactylic hexameter	feminine penthemimeral, trithemimeral
ἔσσομαι ἤματα πάντα διαμπερές, εἴ κέ μ’Ἀχαιοὶ	-uu -uu -u u-uu - u u--	dactylic hexameter	feminine penthemimeral
τεύχεα συλήσωσι νεῶν ἐν ἀγῶνι πεσόντα.	-uu ---u u- u u-u u--	dactylic hexameter	feminine penthemimeral, hepthemimeral
ἀλλ’ ἔχεο κρατερῶς, ὄτρυνε δὲ λαὸν ἅπαντα.	- uu- uu- --u u -u u--	dactylic hexameter	masculine penthemimeral, trithemimeral
ὣς ἄρα μιν εἰπόντα τέλος θανάτοιο κάλυψεν	- uu - --u u- uu-u u--	dactylic hexameter	feminine penthemimeral, hepthemimeral, trithemimeral
ὀφθαλμοὺς ῥῖνάς θ’·ὃ δὲ λὰξ ἐν στήθεσι βαίνων	--- -- u u - - -uu --	dactylic hexameter	masculine penthemimeral, hepthemimeral, trithemimeral
ἐκ χροὸς ἕλκε δόρυ, προτὶ δὲ φρένες αὐτῷ ἕποντο·	- uu -u u- uu - uu -u u--	dactylic hexameter	masculine penthemimeral, hepthemimeral
τοῖο δ’ἅμα ψυχήν τε καὶ ἔγχεος ἐξέρυσ’ αἰχμήν.	-u u- -- u u -uu -uu --	dactylic hexameter	masculine penthemimeral, trithemimeral
Μυρμιδόνες δ’αὐτοῦ σχέθον ἵππους φυσιόωντας	-uu- -- uu -- -uu--	dactylic hexameter	masculine penthemimeral, trithemimeral
ἱεμένους φοβέεσθαι, ἐπεὶ λίπον ἅρματ’ ἀνάκτων.	-uu- uu-u u- uu -u u--	dactylic hexameter	feminine penthemimeral, hepthemimeral, trithemimeral
Γλαύκῳ δ’αἰνὸν ἄχος γένετο φθογγῆς ἀΐοντι·	-- -u u- uu- -- uu--	dactylic hexameter	masculine penthemimeral, hepthemimeral
ὠρίνθη δέ οἱ ἦτορ ὅ τ’οὐ δύνατο προσαμῦναι.	--- u u -u u - uu- uu--	dactylic hexameter	feminine penthemimeral, hepthemimeral, trithemimeral
χειρὶ δ’ἑλὼν ἐπίεζε βραχίονα· τεῖρε γὰρ αὐτὸν	-u u- uu-u u-uu -u u --	dactylic hexameter	feminine penthemimeral, trithemimeral
ἕλκος, ὃ δή μιν Τεῦκρος ἐπεσσύμενον βάλεν ἰῷ	-u u - - -u u-uu- uu --	dactylic hexameter	feminine penthemimeral, trithemimeral
τείχεος ὑψηλοῖο, ἀρὴν ἑτάροισιν ἀμύνων.	-uu ---u u- uu-u u--	dactylic hexameter	feminine penthemimeral, hepthemimeral
εὐχόμενος δ’ἄρα εἶπεν ἑκηβόλῳ Ἀπόλλωνι·	-uu- uu -u u-uu ----	dactylic hexameter	feminine penthemimeral, trithemimeral
κλῦθι ἄναξ ὅς που Λυκίης ἐν πίονι δήμῳ	-u u- - - uu- - -uu --	dactylic hexameter	masculine penthemimeral, hepthemimeral, trithemimeral
εἲς ἢ ἐνὶ Τροίῃ· δύνασαι δὲ σὺ πάντοσ’ ἀκούειν	- u u- -- uu- u u -u u--	dactylic hexameter	masculine penthemimeral, hepthemimeral, trithemimeral
ἀνέρι κηδομένῳ, ὡς νῦν ἐμὲ κῆδος ἱκάνει.	-uu -uu- - - uu -u u--	dactylic hexameter	masculine penthemimeral, hepthemimeral
ἕλκος μὲν γὰρ ἔχω τόδε καρτερόν, ἀμφὶ δέ μοι χεὶρ	-- - u u- uu -uu -u u - -	dactylic hexameter	masculine penthemimeral, trithemimeral
ὀξείῃς ὀδύνῃσιν ἐλήλαται, οὐδέ μοι αἷμα	--- uu-u u-uu -u u --	dactylic hexameter	feminine penthemimeral, trithemimeral
τερσῆναι δύναται, βαρύθει δέ μοι ὦμος ὑπ’ αὐτοῦ·	--- uu- uu- u u -u u --	dactylic hexameter	masculine penthemimeral, hepthemimeral, trithemimeral
ἔγχος δ’οὐ δύναμαι σχεῖν ἔμπεδον, οὐδὲ μάχεσθαι	-- - uu- - -uu -u u--	dactylic hexameter	masculine penthemimeral, trithemimeral
ἐλθὼν δυσμενέεσσιν. ἀνὴρ δ’ὤριστος ὄλωλε	-- -uu-u u- --u u--	dactylic hexameter	feminine penthemimeral, hepthemimeral
Σαρπηδὼν Διὸς υἱός· ὃ δ’οὐ οὗ παιδὸς ἀμύνει.	--- uu -u u - - -u u--	dactylic hexameter	feminine penthemimeral, hepthemimeral, trithemimeral
ἀλλὰ σύ πέρ μοι ἄναξ τόδε καρτερὸν ἕλκος ἄκεσσαι,	-u u - u u- uu -uu -u u--	dactylic hexameter	masculine penthemimeral, trithemimeral
κοίμησον δ’ὀδύνας, δὸς δὲ κράτος, ὄφρ’ ἑτάροισι	--- uu- - - uu - uu--	dactylic hexameter	masculine penthemimeral, hepthemimeral, trithemimeral
κεκλόμενος Λυκίοισιν ἐποτρύνω πολεμίζειν,	-uu- uu-u u--- uu--	dactylic hexameter	feminine penthemimeral, trithemimeral
αὐτός τ’ἀμφὶ νέκυι κατατεθνηῶτι μάχωμαι.	-- -u u- uu---u u--	dactylic hexameter	masculine penthemimeral
ὣς ἔφατ’ εὐχόμενος, τοῦ δ’ἔκλυε Φοῖβος Ἀπόλλων.	- uu -uu- - -uu -u u--	dactylic hexameter	masculine penthemimeral
αὐτίκα παῦσ’ ὀδύνας ἀπὸ δ’ἕλκεος ἀργαλέοιο	-uu - uu- uu -uu -uu--	dactylic hexameter	masculine penthemimeral, trithemimeral
αἷμα μέλαν τέρσηνε, μένος δέ οἱ ἔμβαλε θυμῷ.	-u u- --u u- u u -uu --	dactylic hexameter	feminine penthemimeral, hepthemimeral, trithemimeral
Γλαῦκος δ’ἔγνω ᾗσιν ἐνὶ φρεσὶ γήθησέν τε	-- -- -u u- uu --- -	dactylic hexameter	feminine penthemimeral, hepthemimeral
ὅττί οἱ ὦκ’ ἤκουσε μέγας θεὸς εὐξαμένοιο.	-u u - --u u- uu -uu--	dactylic hexameter	feminine penthemimeral, hepthemimeral, trithemimeral
πρῶτα μὲν ὄτρυνεν Λυκίων ἡγήτορας ἄνδρας	-u u --- uu- --uu --	dactylic hexameter	masculine penthemimeral, hepthemimeral
πάντῃ ἐποιχόμενος Σαρπηδόνος ἀμφιμάχεσθαι·	-u u-uu- --uu -uu--	dactylic hexameter	masculine penthemimeral
αὐτὰρ ἔπειτα μετὰ Τρῶας κίε μακρὰ βιβάσθων	-u u-u u- -- uu -u u--	dactylic hexameter	masculine penthemimeral, hepthemimeral
Πουλυδάμαντ’ ἔπι Πανθοΐδην καὶ Ἀγήνορα δῖον,	-uu- uu -uu- u u-uu --	dactylic hexameter	hepthemimeral, trithemimeral
βῆ δὲ μετ’ Αἰνείαν τε καὶ Ἕκτορα χαλκοκορυστήν,	- u u --- u u -uu -uu--	dactylic hexameter	masculine penthemimeral
ἀγχοῦ δ’ἱστάμενος ἔπεα πτερόεντα προσηύδα·	-- -uu- uu- uu-u u--	dactylic hexameter	masculine penthemimeral, hepthemimeral
Ἕκτορ νῦν δὴ πάγχυ λελασμένος εἰς ἐπικούρων,	-- u - -u u-uu - uu--	lyric	
οἳ σέθεν εἵνεκα τῆλε φίλων καὶ πατρίδος αἴης	- uu -uu -u u- - -uu --	dactylic hexameter	feminine penthemimeral, hepthemimeral
θυμὸν ἀποφθινύθουσι· σὺ δ’οὐκ ἐθέλεις ἐπαμύνειν.	-u u-uu-u u - uu- uu--	dactylic hexameter	feminine penthemimeral, hepthemimeral
κεῖται Σαρπηδὼν Λυκίων ἀγὸς ἀσπιστάων,	-- --- uu- uu ----	dactylic hexameter	masculine penthemimeral, hepthemimeral
ὃς Λυκίην εἴρυτο δίκῃσί τε καὶ σθένεϊ ᾧ·	- uu- --u u-u u - uu- -	dactylic hexameter	feminine penthemimeral, trithemimeral
τὸν δ’ὑπὸ Πατρόκλῳ δάμασ’ ἔγχεϊ χάλκεος Ἄρης.	- uu --- uu -uu -uu --	dactylic hexameter	masculine penthemimeral
ἀλλὰ φίλοι πάρστητε, νεμεσσήθητε δὲ θυμῷ,	-u u- --u u---u u --	dactylic hexameter	feminine penthemimeral, trithemimeral
μὴ ἀπὸ τεύχε’ ἕλωνται, ἀεικίσσωσι δὲ νεκρὸν	- uu -u u-u u---u u --	dactylic hexameter	feminine penthemimeral
Μυρμιδόνες, Δαναῶν κεχολωμένοι ὅσσοι ὄλοντο,	-uu- uu- uu-uu -u u--	dactylic hexameter	masculine penthemimeral, trithemimeral
τοὺς ἐπὶ νηυσὶ θοῇσιν ἐπέφνομεν ἐγχείῃσιν.	- uu -u u-u u-uu ----	dactylic hexameter	feminine penthemimeral
ὣς ἔφατο, Τρῶας δὲ κατὰ κρῆθεν λάβε πένθος	- uu- -- u u- -- uu --	dactylic hexameter	masculine penthemimeral, hepthemimeral, trithemimeral
ἄσχετον, οὐκ ἐπιεικτόν, ἐπεί σφισιν ἕρμα πόληος	-uu - uu-u u- uu -u u--	dactylic hexameter	feminine penthemimeral, hepthemimeral, trithemimeral
ἔσκε καὶ ἀλλοδαπός περ ἐών· πολέες γὰρ ἅμ’ αὐτῷ	-u u -uu- u u- uu- u u --	dactylic hexameter	masculine penthemimeral, hepthemimeral
λαοὶ ἕποντ’, ἐν δ’αὐτὸς ἀριστεύεσκε μάχεσθαι·	-u u- - -u u---u u--	dactylic hexameter	feminine penthemimeral, trithemimeral
βὰν δ’ἰθὺς Δαναῶν λελιημένοι· ἦρχε δ’ἄρά σφιν	- -- uu- uu-uu -u u- -	dactylic hexameter	masculine penthemimeral, trithemimeral
Ἕκτωρ χωόμενος Σαρπηδόνος. αὐτὰρ Ἀχαιοὺς	-- -uu- --uu -u u--	dactylic hexameter	masculine penthemimeral
ὦρσε Μενοιτιάδεω Πατροκλῆος λάσιον κῆρ·	-u u-uu- ---- uu- -	dactylic hexameter	masculine penthemimeral
Αἴαντε πρώτω προσέφη μεμαῶτε καὶ αὐτώ·	--- -- uu- uu-u u --	dactylic hexameter	masculine penthemimeral, hepthemimeral, trithemimeral
Αἴαντε νῦν σφῶϊν ἀμύνεσθαι φίλον ἔστω,	--- - -u u--- uu --	dactylic hexameter	feminine penthemimeral, trithemimeral
οἷοί περ πάρος ἦτε μετ’ ἀνδράσιν ἢ καὶ ἀρείους.	-u - uu -u u -uu - u u--	lyric	
κεῖται ἀνὴρ ὃς πρῶτος ἐσήλατο τεῖχος Ἀχαιῶν	-u u- - -u u-uu -u u--	dactylic hexameter	feminine penthemimeral, trithemimeral
Σαρπηδών· ἀλλ’ εἴ μιν ἀεικισσαίμεθ’ ἑλόντες,	--- - - u u---u u--	dactylic hexameter	masculine penthemimeral, trithemimeral
τεύχεά τ’ὤμοιιν ἀφελοίμεθα, καί τιν’ ἑταίρων	-- --- uu-uu - u u--	dactylic hexameter	masculine penthemimeral
αὐτοῦ ἀμυνομένων δαμασαίμεθα νηλέϊ χαλκῷ.	-u u-uu- uu-uu -uu --	dactylic hexameter	masculine penthemimeral
ὣς ἔφαθ’, οἳ δὲ καὶ αὐτοὶ ἀλέξασθαι μενέαινον.	- uu - u u -u u--- uu--	dactylic hexameter	feminine penthemimeral, trithemimeral
οἳ δ’ἐπεὶ ἀμφοτέρωθεν ἐκαρτύναντο φάλαγγας	- uu -uu-u u---u u--	dactylic hexameter	feminine penthemimeral
Τρῶες καὶ Λύκιοι καὶ Μυρμιδόνες καὶ Ἀχαιοί,	-- - uu- - -uu- u u--	dactylic hexameter	masculine penthemimeral, trithemimeral
σύμβαλον ἀμφὶ νέκυι κατατεθνηῶτι μάχεσθαι	-uu -u u- uu---u u--	dactylic hexameter	masculine penthemimeral
δεινὸν ἀΰσαντες· μέγα δ’ἔβραχε τεύχεα φωτῶν.	-u u--- uu -uu -uu --	dactylic hexameter	masculine penthemimeral
Ζεὺς δ’ἐπὶ νύκτ’ ὀλοὴν τάνυσε κρατερῇ ὑσμίνῃ,	- uu - uu- uu- uu- ---	dactylic hexameter	masculine penthemimeral, hepthemimeral, trithemimeral
ὄφρα φίλῳ περὶ παιδὶ μάχης ὀλοὸς πόνος εἴη.	-u u- uu -u u- uu- uu --	dactylic hexameter	feminine penthemimeral, hepthemimeral, trithemimeral
ὦσαν δὲ πρότεροι Τρῶες ἑλίκωπας Ἀχαιούς·	-- - uu- -- uu-u u--	dactylic hexameter	masculine penthemimeral, hepthemimeral, trithemimeral
βλῆτο γὰρ οὔ τι κάκιστος ἀνὴρ μετὰ Μυρμιδόνεσσιν	-u u - u u-u u- uu -uu--	dactylic hexameter	feminine penthemimeral, hepthemimeral, trithemimeral
υἱὸς Ἀγακλῆος μεγαθύμου δῖος Ἐπειγεύς,	-u u--- uu-- -u u--	dactylic hexameter	masculine penthemimeral
ὅς ῥ’ἐν Βουδείῳ εὖ ναιομένῳ ἤνασσε	- - --- - -uu- ---	dactylic hexameter	masculine penthemimeral
τὸ πρίν· ἀτὰρ τότε γ’ἐσθλὸν ἀνεψιὸν ἐξεναρίξας	- u u- uu -u u-uu -uu--	dactylic hexameter	feminine penthemimeral, trithemimeral
ἐς Πηλῆ’ ἱκέτευσε καὶ ἐς Θέτιν ἀργυρόπεζαν·	- -- uu-u u - uu -uu--	dactylic hexameter	feminine penthemimeral, hepthemimeral, trithemimeral
οἳ δ’ἅμ’ Ἀχιλλῆϊ ῥηξήνορι πέμπον ἕπεσθαι	- u u--- --uu -u u--	dactylic hexameter	masculine penthemimeral
Ἴλιον εἰς εὔπωλον, ἵνα Τρώεσσι μάχοιτο.	-uu - --u u- --u u--	dactylic hexameter	feminine penthemimeral, hepthemimeral, trithemimeral
τόν ῥα τόθ’ ἁπτόμενον νέκυος βάλε φαίδιμος Ἕκτωρ	- u u -uu- uu- uu -uu --	dactylic hexameter	masculine penthemimeral, hepthemimeral
χερμαδίῳ κεφαλήν· ἣ δ’ἄνδιχα πᾶσα κεάσθη	-uu- uu- - -uu -u u--	dactylic hexameter	masculine penthemimeral, trithemimeral
ἐν κόρυθι βριαρῇ· ὃ δ’ἄρα πρηνὴς ἐπὶ νεκρῷ	- uu- uu- u u- -- uu --	dactylic hexameter	masculine penthemimeral, hepthemimeral, trithemimeral
κάππεσεν, ἀμφὶ δέ μιν θάνατος χύτο θυμοραϊστής.	-uu -u u - uu- uu -uu--	dactylic hexameter	masculine penthemimeral, hepthemimeral
Πατρόκλῳ δ’ἄρ’ ἄχος γένετο φθιμένου ἑτάροιο,	--- u u- uu- uu- uu--	dactylic hexameter	masculine penthemimeral, hepthemimeral, trithemimeral
ἴθυσεν δὲ διὰ προμάχων ἴρηκι ἐοικὼς	--- u u- uu- --u u--	dactylic hexameter	masculine penthemimeral, hepthemimeral, trithemimeral
ὠκέϊ, ὅς τ’ἐφόβησε κολοιούς τε ψῆράς τε·	-uu - uu-u u-- - -- -	dactylic hexameter	feminine penthemimeral, trithemimeral
ὣς ἰθὺς Λυκίων Πατρόκλεες ἱπποκέλευθε	- -- uu- --uu -uu--	dactylic hexameter	masculine penthemimeral, trithemimeral
ἔσσυο καὶ Τρώων, κεχόλωσο δὲ κῆρ ἑτάροιο.	-uu - -- uu-u u - uu--	dactylic hexameter	masculine penthemimeral, trithemimeral
καί ῥ’ἔβαλε Σθενέλαον Ἰθαιμένεος φίλον υἱὸν	- uu- uu-u u-uu- uu --	dactylic hexameter	feminine penthemimeral, trithemimeral
αὐχένα χερμαδίῳ, ῥῆξεν δ’ἀπὸ τοῖο τένοντας.	-uu -uu- -- uu -u u--	dactylic hexameter	masculine penthemimeral, hepthemimeral
χώρησαν δ’ὑπό τε πρόμαχοι καὶ φαίδιμος Ἕκτωρ.	--- uu - uu- - -uu --	dactylic hexameter	masculine penthemimeral, hepthemimeral, trithemimeral
ὅσση δ’αἰγανέης ῥιπὴ ταναοῖο τέτυκται,	-- -uu- -- uu-u u--	dactylic hexameter	masculine penthemimeral, hepthemimeral
ἥν ῥά τ’ἀνὴρ ἀφέῃ πειρώμενος ἢ ἐν ἀέθλῳ	- u u- uu- --uu - u u--	dactylic hexameter	masculine penthemimeral, trithemimeral
ἠὲ καὶ ἐν πολέμῳ δηίων ὕπο θυμοραϊστέων,	-u u - uu- -- uu -uu--	dactylic hexameter	masculine penthemimeral, hepthemimeral, trithemimeral
τόσσον ἐχώρησαν Τρῶες, ὤσαντο δ’Ἀχαιοί.	-u u--- -- --u u--	dactylic hexameter	masculine penthemimeral, hepthemimeral
Γλαῦκος δὲ πρῶτος Λυκίων ἀγὸς ἀσπιστάων	u- - -- uu- uu ----	lyric	
ἐτράπετ’, ἔκτεινεν δὲ Βαθυκλῆα μεγάθυμον	-uu --- u u--- uu--	dactylic hexameter	masculine penthemimeral
Χάλκωνος φίλον υἱόν, ὃς Ἑλλάδι οἰκία ναίων	--- uu -u u -uu -uu --	dactylic hexameter	feminine penthemimeral, trithemimeral
ὄλβῳ τε πλούτῳ τε μετέπρεπε Μυρμιδόνεσσι.	-- - -- u u-uu -uu--	dactylic hexameter	masculine penthemimeral, trithemimeral
τὸν μὲν ἄρα Γλαῦκος στῆθος μέσον οὔτασε δουρὶ	- u u- -- -- uu -uu --	dactylic hexameter	masculine penthemimeral, hepthemimeral, trithemimeral
στρεφθεὶς ἐξαπίνης, ὅτε μιν κατέμαρπτε διώκων·	-- -uu- uu - uu-u u--	dactylic hexameter	masculine penthemimeral, hepthemimeral
δούπησεν δὲ πεσών· πυκινὸν δ’ἄχος ἔλλαβ’ Ἀχαιούς,	--- u u- uu- uu -u u--	dactylic hexameter	masculine penthemimeral, hepthemimeral, trithemimeral
ὡς ἔπεσ’ ἐσθλὸς ἀνήρ· μέγα δὲ Τρῶες κεχάροντο,	- uu -u u- uu - -- uu--	dactylic hexameter	masculine penthemimeral, hepthemimeral
στὰν δ’ἀμφ’ αὐτὸν ἰόντες ἀολλέες· οὐδ’ ἄρ’ Ἀχαιοὶ	- - -u u-u u-uu - u u--	dactylic hexameter	feminine penthemimeral
ἀλκῆς ἐξελάθοντο, μένος δ’ἰθὺς φέρον αὐτῶν.	-- -uu-u u- -- uu --	dactylic hexameter	feminine penthemimeral, hepthemimeral
ἔνθ’ αὖ Μηριόνης Τρώων ἕλεν ἄνδρα κορυστὴν	- - -uu- -- uu -u u--	dactylic hexameter	masculine penthemimeral, hepthemimeral
Λαόγονον θρασὺν υἱὸν Ὀνήτορος, ὃς Διὸς ἱρεὺς	-uu- uu -u u-uu - uu --	dactylic hexameter	feminine penthemimeral, trithemimeral
Ἰδαίου ἐτέτυκτο, θεὸς δ’ὣς τίετο δήμῳ.	--- uu-u u- - -uu --	dactylic hexameter	feminine penthemimeral, hepthemimeral, trithemimeral
τὸν βάλ’ ὑπὸ γναθμοῖο καὶ οὔατος· ὦκα δὲ θυμὸς	- u u- --u u -uu -u u --	dactylic hexameter	feminine penthemimeral, trithemimeral
ᾤχετ’ ἀπὸ μελέων, στυγερὸς δ’ἄρα μιν σκότος εἷλεν.	-u u- uu- uu- uu - uu --	dactylic hexameter	masculine penthemimeral, hepthemimeral, trithemimeral
Αἰνείας δ’ἐπὶ Μηριόνῃ δόρυ χάλκεον ἧκεν·	--- uu -uu- uu -uu --	dactylic hexameter	hepthemimeral, trithemimeral
ἔλπετο γὰρ τεύξεσθαι ὑπασπίδια προβιβῶντος.	-uu - --u u-uu- uu--	dactylic hexameter	feminine penthemimeral, trithemimeral
ἀλλ’ ὃ μὲν ἄντα ἰδὼν ἠλεύατο χάλκεον ἔγχος·	- u u -u u- --uu -uu --	dactylic hexameter	masculine penthemimeral
πρόσσω γὰρ κατέκυψε, τὸ δ’ἐξόπιθεν δόρυ μακρὸν	-- - uu-u u -uu- uu --	dactylic hexameter	feminine penthemimeral, trithemimeral
οὔδει ἐνισκίμφθη, ἐπὶ δ’οὐρίαχος πελεμίχθη	-u u--- uu -uu- uu--	dactylic hexameter	masculine penthemimeral
ἔγχεος· ἔνθα δ’ἔπειτ’ ἀφίει μένος ὄβριμος Ἄρης.	-uu -u u- uu- uu -uu --	dactylic hexameter	masculine penthemimeral, hepthemimeral
αἰχμὴ δ’Αἰνείαο κραδαινομένη κατὰ γαίης	-- ---u u-uu- uu --	dactylic hexameter	feminine penthemimeral
ᾤχετ’, ἐπεί ῥ’ἅλιον στιβαρῆς ἀπὸ χειρὸς ὄρουσεν.	-u u- uu- uu- uu -u u--	dactylic hexameter	masculine penthemimeral, hepthemimeral, trithemimeral
Αἰνείας δ’ἄρα θυμὸν ἐχώσατο φώνησέν τε·	--- uu -u u-uu --- -	dactylic hexameter	feminine penthemimeral, trithemimeral
Μηριόνη τάχα κέν σε καὶ ὀρχηστήν περ ἐόντα	-uu- uu - u u --- u u--	dactylic hexameter	masculine penthemimeral, trithemimeral
ἔγχος ἐμὸν κατέπαυσε διαμπερές, εἴ σ’ἔβαλόν περ.	-u u- uu-u u-uu - uu- -	dactylic hexameter	feminine penthemimeral, trithemimeral
τὸν δ’αὖ Μηριόνης δουρικλυτὸς ἀντίον ηὔδα·	- - -uuu --uu -uu --	lyric	
Αἰνεία χαλεπόν σε καὶ ἴφθιμόν περ ἐόντα	--- uu- u u --- u u--	dactylic hexameter	masculine penthemimeral, trithemimeral
πάντων ἀνθρώπων σβέσσαι μένος, ὅς κέ σευ ἄντα	-- --- -- uu - u u --	dactylic hexameter	masculine penthemimeral, hepthemimeral
ἔλθῃ ἀμυνόμενος· θνητὸς δέ νυ καὶ σὺ τέτυξαι.	-u u-uu- -- u u - u u--	dactylic hexameter	masculine penthemimeral, hepthemimeral
εἰ καὶ ἐγώ σε βάλοιμι τυχὼν μέσον ὀξέϊ χαλκῷ,	- u u- u u-u u- uu -uu --	dactylic hexameter	feminine penthemimeral, hepthemimeral, trithemimeral
αἶψά κε καὶ κρατερός περ ἐὼν καὶ χερσὶ πεποιθὼς	-u u - uu- u u- - -u u--	dactylic hexameter	masculine penthemimeral, hepthemimeral, trithemimeral
εὖχος ἐμοὶ δοίης, ψυχὴν δ’Ἄϊδι κλυτοπώλῳ.	-u u- -- -- uu- uu--	dactylic hexameter	masculine penthemimeral, hepthemimeral, trithemimeral
ὣς φάτο, τὸν δ’ἐνένιπε Μενοιτίου ἄλκιμος υἱός·	- uu - uu-u u-uu -uu --	dactylic hexameter	feminine penthemimeral, trithemimeral
Μηριόνη τί σὺ ταῦτα καὶ ἐσθλὸς ἐὼν ἀγορεύεις;	-uu- u u -u u -u u- uu--	dactylic hexameter	feminine penthemimeral, trithemimeral
ὦ πέπον οὔ τοι Τρῶες ὀνειδείοις ἐπέεσσι	- uu - - -u u--- uu--	dactylic hexameter	feminine penthemimeral, trithemimeral
νεκροῦ χωρήσουσι· πάρος τινὰ γαῖα καθέξει.	-- ---u u- uu -u u--	dactylic hexameter	feminine penthemimeral, hepthemimeral
ἐν γὰρ χερσὶ τέλος πολέμου, ἐπέων δ’ἐνὶ βουλῇ·	- - -u u- uu- uu- uu --	dactylic hexameter	masculine penthemimeral, hepthemimeral
τὼ οὔ τι χρὴ μῦθον ὀφέλλειν, ἀλλὰ μάχεσθαι.	- - - - -u u-- -u u--	dactylic hexameter	feminine penthemimeral, trithemimeral
ὣς εἰπὼν ὃ μὲν ἦρχ’, ὃ δ’ἅμ’ ἕσπετο ἰσόθεος φώς.	- -u u u - u u -uu -uu- -	lyric	
τῶν δ’ὥς τε δρυτόμων ἀνδρῶν ὀρυμαγδὸς ὀρώρει	- - - uu- -- uu-u u--	dactylic hexameter	masculine penthemimeral, hepthemimeral, trithemimeral
οὔρεος ἐν βήσσῃς, ἕκαθεν δέ τε γίγνετ’ ἀκουή,	-uu - -- uu- u u -u u--	dactylic hexameter	masculine penthemimeral, hepthemimeral, trithemimeral
ὣς τῶν ὄρνυτο δοῦπος ἀπὸ χθονὸς εὐρυοδείης	- - -uu -u u- uu -uu--	dactylic hexameter	feminine penthemimeral, hepthemimeral
χαλκοῦ τε ῥινοῦ τε βοῶν τ’εὐποιητάων,	-- - -- u u- -----	dactylic hexameter	masculine penthemimeral, hepthemimeral, trithemimeral
νυσσομένων ξίφεσίν τε καὶ ἔγχεσιν ἀμφιγύοισιν.	-uu- uu- u u -uu -uu--	dactylic hexameter	masculine penthemimeral, trithemimeral
οὐδ’ ἂν ἔτι φράδμων περ ἀνὴρ Σαρπηδόνα δῖον	- u u- -- u u- --uu --	dactylic hexameter	masculine penthemimeral, hepthemimeral, trithemimeral
ἔγνω, ἐπεὶ βελέεσσι καὶ αἵματι καὶ κονίῃσιν	-u u- uu-u u -uu - uu--	dactylic hexameter	feminine penthemimeral, trithemimeral
ἐκ κεφαλῆς εἴλυτο διαμπερὲς ἐς πόδας ἄκρους.	- uu- --u u-uu - uu --	dactylic hexameter	feminine penthemimeral, trithemimeral
οἳ δ’αἰεὶ περὶ νεκρὸν ὁμίλεον, ὡς ὅτε μυῖαι	- -- uu -u u-uu - uu --	dactylic hexameter	feminine penthemimeral, trithemimeral
σταθμῷ ἔνι βρομέωσι περιγλαγέας κατὰ πέλλας	-u u- uu-u u-uu- uu --	dactylic hexameter	feminine penthemimeral, trithemimeral
ὥρῃ ἐν εἰαρινῇ, ὅτε τε γλάγος ἄγγεα δεύει·	-u u -uu- uu - uu -uu --	dactylic hexameter	masculine penthemimeral, hepthemimeral
ὣς ἄρα τοὶ περὶ νεκρὸν ὁμίλεον, οὐδέ ποτε Ζεὺς	- uu - uu -u u-uu -u u- -	dactylic hexameter	feminine penthemimeral, trithemimeral
τρέψεν ἀπὸ κρατερῆς ὑσμίνης ὄσσε φαεινώ,	-u u- uu- --- -u u--	dactylic hexameter	masculine penthemimeral, trithemimeral
ἀλλὰ κατ’ αὐτοὺς αἰὲν ὅρα καὶ φράζετο θυμῷ,	-u u -- -u u- - -uu --	dactylic hexameter	feminine penthemimeral, hepthemimeral
πολλὰ μάλ’ ἀμφὶ φόνῳ Πατρόκλου μερμηρίζων,	-u u -u u- --- ----	dactylic hexameter	masculine penthemimeral
ἢ ἤδη καὶ κεῖνον ἐνὶ κρατερῇ ὑσμίνῃ	- -- - -u u- uu- ---	dactylic hexameter	feminine penthemimeral, hepthemimeral, trithemimeral
αὐτοῦ ἐπ’ ἀντιθέῳ Σαρπηδόνι φαίδιμος Ἕκτωρ	-u u -uu- --uu -uu --	dactylic hexameter	masculine penthemimeral
χαλκῷ δῃώσῃ, ἀπό τ’ὤμων τεύχε’ ἕληται,	-- --- uu -- -u u--	dactylic hexameter	masculine penthemimeral
ἦ ἔτι καὶ πλεόνεσσιν ὀφέλλειεν πόνον αἰπύν.	- uu - --u u--- uu --	dactylic hexameter	feminine penthemimeral, trithemimeral
ὧδε δέ οἱ φρονέοντι δοάσσατο κέρδιον εἶναι	-u u - uu-u u-uu -uu --	dactylic hexameter	feminine penthemimeral, trithemimeral
ὄφρ’ ἠῢς θεράπων Πηληϊάδεω Ἀχιλῆος	- -- uu- --uu- uu--	dactylic hexameter	masculine penthemimeral, trithemimeral
ἐξαῦτις Τρῶάς τε καὶ Ἕκτορα χαλκοκορυστὴν	--- -- u u -uu -uu--	dactylic hexameter	masculine penthemimeral, trithemimeral
ὤσαιτο προτὶ ἄστυ, πολέων δ’ἀπὸ θυμὸν ἕλοιτο.	--- uu -u u- uu -u u--	dactylic hexameter	feminine penthemimeral, hepthemimeral, trithemimeral
Ἕκτορι δὲ πρωτίστῳ ἀνάλκιδα θυμὸν ἐνῆκεν·	-uu - --u u-uu -u u--	dactylic hexameter	feminine penthemimeral, trithemimeral
ἐς δίφρον δ’ἀναβὰς φύγαδ’ ἔτραπε, κέκλετο δ’ἄλλους	- -- uu- uu -uu -uu --	dactylic hexameter	masculine penthemimeral, trithemimeral
Τρῶας φευγέμεναι· γνῶ γὰρ Διὸς ἱρὰ τάλαντα.	-- -uu- - - uu -u u--	dactylic hexameter	masculine penthemimeral, hepthemimeral
ἔνθ’ οὐδ’ ἴφθιμοι Λύκιοι μένον, ἀλλὰ φόβηθεν	- - --- uu- uu -u u--	dactylic hexameter	masculine penthemimeral, hepthemimeral
πάντες, ἐπεὶ βασιλῆα ἴδον βεβλαμμένον ἦτορ	-u u- uu-u u- --uu --	dactylic hexameter	feminine penthemimeral, hepthemimeral, trithemimeral
κείμενον ἐν νεκύων ἀγύρει· πολέες γὰρ ἐπ’ αὐτῷ	-uu - uu- uu- uu- u u --	dactylic hexameter	masculine penthemimeral, hepthemimeral, trithemimeral
κάππεσον, εὖτ’ ἔριδα κρατερὴν ἐτάνυσσε Κρονίων.	-uu - uu- uu- uu-u u--	dactylic hexameter	masculine penthemimeral, hepthemimeral, trithemimeral
οἳ δ’ἄρ’ ἀπ’ ὤμοιιν Σαρπηδόνος ἔντε’ ἕλοντο	- u u --- --uu -u u--	dactylic hexameter	masculine penthemimeral
χάλκεα μαρμαίροντα, τὰ μὲν κοίλας ἐπὶ νῆας	-uu ---u u - -- uu --	dactylic hexameter	feminine penthemimeral, hepthemimeral
δῶκε φέρειν ἑτάροισι Μενοιτίου ἄλκιμος υἱός.	-u u- uu-u u-uu -uu --	dactylic hexameter	feminine penthemimeral, trithemimeral
καὶ τότ’ Ἀπόλλωνα προσέφη νεφεληγερέτα Ζεύς·	- u u--- uu- uu-uu- -	dactylic hexameter	masculine penthemimeral, hepthemimeral
εἰ δ’ἄγε νῦν φίλε Φοῖβε, κελαινεφὲς αἷμα κάθηρον	- uu - uu -u u-uu -u u--	dactylic hexameter	feminine penthemimeral, trithemimeral
ἐλθὼν ἐκ βελέων Σαρπηδόνα, καί μιν ἔπειτα	-- - uu- --uu - u u--	dactylic hexameter	masculine penthemimeral, trithemimeral
πολλὸν ἀπὸ πρὸ φέρων λοῦσον ποταμοῖο ῥοῇσι	-u u- u u- -- uu-u u--	dactylic hexameter	masculine penthemimeral, hepthemimeral, trithemimeral
χρῖσόν τ’ἀμβροσίῃ, περὶ δ’ἄμβροτα εἵματα ἕσσον·	-- -uu- uu -uu -uu --	dactylic hexameter	masculine penthemimeral
πέμπε δέ μιν πομποῖσιν ἅμα κραιπνοῖσι φέρεσθαι	-u u - --u u- --u u--	dactylic hexameter	feminine penthemimeral, hepthemimeral, trithemimeral
ὕπνῳ καὶ θανάτῳ διδυμάοσιν, οἵ ῥά μιν ὦκα	-- - uu- uu-uu - u u --	dactylic hexameter	masculine penthemimeral, trithemimeral
θήσουσ’ ἐν Λυκίης εὐρείης πίονι δήμῳ,	-- - uu- --- -uu --	dactylic hexameter	masculine penthemimeral, trithemimeral
ἔνθά ἑ ταρχύσουσι κασίγνητοί τε ἔται τε	-u u ---u u--- u u- -	dactylic hexameter	feminine penthemimeral
τύμβῳ τε στήλῃ τε· τὸ γὰρ γέρας ἐστὶ θανόντων.	-- - -- u u - uu -u u--	dactylic hexameter	masculine penthemimeral, hepthemimeral, trithemimeral
ὣς ἔφατ’, οὐδ’ ἄρα πατρὸς ἀνηκούστησεν Ἀπόλλων.	- uu - uu -u u---u u--	dactylic hexameter	feminine penthemimeral, trithemimeral
βῆ δὲ κατ’ Ἰδαίων ὀρέων ἐς φύλοπιν αἰνήν,	- u u --- uu- - -uu --	dactylic hexameter	masculine penthemimeral, hepthemimeral
αὐτίκα δ’ἐκ βελέων Σαρπηδόνα δῖον ἀείρας	-uu - uu- --uu -u u--	dactylic hexameter	masculine penthemimeral, trithemimeral
πολλὸν ἀπὸ πρὸ φέρων λοῦσεν ποταμοῖο ῥοῇσι	-u u- u u- -- uu-u u--	dactylic hexameter	masculine penthemimeral, hepthemimeral, trithemimeral
χρῖσέν τ’ἀμβροσίῃ, περὶ δ’ἄμβροτα εἵματα ἕσσε·	-- -uu- uu -uu -uu --	dactylic hexameter	masculine penthemimeral
πέμπε δέ μιν πομποῖσιν ἅμα κραιπνοῖσι φέρεσθαι,	-u u - --u u- --u u--	dactylic hexameter	feminine penthemimeral, hepthemimeral, trithemimeral
ὕπνῳ καὶ θανάτῳ διδυμάοσιν, οἵ ῥά μιν ὦκα	-- - uu- uu-uu - u u --	dactylic hexameter	masculine penthemimeral, trithemimeral
κάτθεσαν ἐν Λυκίης εὐρείης πίονι δήμῳ.	-uu - uu- --- -uu --	dactylic hexameter	masculine penthemimeral, trithemimeral
Πάτροκλος δ’ἵπποισι καὶ Αὐτομέδοντι κελεύσας	--- --u u -uu-u u--	dactylic hexameter	feminine penthemimeral, trithemimeral
Τρῶας καὶ Λυκίους μετεκίαθε, καὶ μέγ’ ἀάσθη	-- - uu- uu-uu - u u--	dactylic hexameter	masculine penthemimeral, trithemimeral
νήπιος· εἰ δὲ ἔπος Πηληϊάδαο φύλαξεν	-uu - u u- --uu-u u--	dactylic hexameter	masculine penthemimeral, trithemimeral
ἦ τ’ἂν ὑπέκφυγε κῆρα κακὴν μέλανος θανάτοιο.	- u u-uu -u u- uu- uu--	dactylic hexameter	feminine penthemimeral, hepthemimeral
ἀλλ’ αἰεί τε Διὸς κρείσσων νόος ἠέ περ ἀνδρῶν·	- -- u u- -- uu -u u --	dactylic hexameter	masculine penthemimeral, hepthemimeral, trithemimeral
ὅς τε καὶ ἄλκιμον ἄνδρα φοβεῖ καὶ ἀφείλετο νίκην	- u u -uu -u u- u u-uu --	dactylic hexameter	feminine penthemimeral, hepthemimeral
ῥηϊδίως, ὅτε δ’αὐτὸς ἐποτρύνῃσι μάχεσθαι·	-uu- uu -u u---u u--	dactylic hexameter	feminine penthemimeral, trithemimeral
ὅς οἱ καὶ τότε θυμὸν ἐνὶ στήθεσσιν ἀνῆκεν.	- - - uu -u u- --u u--	dactylic hexameter	feminine penthemimeral, hepthemimeral, trithemimeral
ἔνθα τίνα πρῶτον τίνα δ’ὕστατον ἐξενάριξας	-u u- -- uu -uu -uu--	dactylic hexameter	masculine penthemimeral, trithemimeral
Πατρόκλεις, ὅτε δή σε θεοὶ θάνατον δὲ κάλεσσαν;	--- uu - u u- uu- u u--	dactylic hexameter	masculine penthemimeral, hepthemimeral, trithemimeral
Ἄδρηστον μὲν πρῶτα καὶ Αὐτόνοον καὶ Ἔχεκλον	--- - -u u -uu- u u--	dactylic hexameter	feminine penthemimeral, trithemimeral
καὶ Πέριμον Μεγάδην καὶ Ἐπίστορα καὶ Μελάνιππον,	- uu- uu- u u-uu - uu--	dactylic hexameter	masculine penthemimeral, trithemimeral
αὐτὰρ ἔπειτ’ Ἔλασον καὶ Μούλιον ἠδὲ Πυλάρτην·	-u u- uu- - -uu -u u--	dactylic hexameter	masculine penthemimeral, trithemimeral
τοὺς ἕλεν· οἳ δ’ἄλλοι φύγαδε μνώοντο ἕκαστος.	- uu - -- uu- --u u--	dactylic hexameter	masculine penthemimeral, hepthemimeral, trithemimeral
ἔνθά κεν ὑψίπυλον Τροίην ἕλον υἷες Ἀχαιῶν	-u u -uu- -- uu -u u--	dactylic hexameter	masculine penthemimeral, hepthemimeral
Πατρόκλου ὑπὸ χερσί, περὶ πρὸ γὰρ ἔγχεϊ θῦεν,	--- uu -u u- u u -uu --	dactylic hexameter	feminine penthemimeral, hepthemimeral, trithemimeral
εἰ μὴ Ἀπόλλων Φοῖβος ἐϋδμήτου ἐπὶ πύργου	- u u-- -u u--- uu --	dactylic hexameter	feminine penthemimeral
ἔστη τῷ ὀλοὰ φρονέων, Τρώεσσι δ’ἀρήγων.	-- - uu- uu- --u u--	dactylic hexameter	masculine penthemimeral, hepthemimeral, trithemimeral
τρὶς μὲν ἐπ’ ἀγκῶνος βῆ τείχεος ὑψηλοῖο	- u u --- - -uu ----	dactylic hexameter	masculine penthemimeral
Πάτροκλος, τρὶς δ’αὐτὸν ἀπεστυφέλιξεν Ἀπόλλων	--- - -u u-uu-u u--	dactylic hexameter	feminine penthemimeral, trithemimeral
χείρεσσ’ ἀθανάτῃσι φαεινὴν ἀσπίδα νύσσων.	-- -uu-u u-- -uu --	dactylic hexameter	feminine penthemimeral
ἀλλ’ ὅτε δὴ τὸ τέταρτον ἐπέσσυτο δαίμονι ἶσος,	- uu - u u-u u-uu -uu --	dactylic hexameter	feminine penthemimeral, trithemimeral
δεινὰ δ’ὁμοκλήσας ἔπεα πτερόεντα προσηύδα·	-u u--- uu- uu-u u--	dactylic hexameter	masculine penthemimeral, hepthemimeral
χάζεο διογενὲς Πατρόκλεες· οὔ νύ τοι αἶσα	-uu -uu- --uu - u u --	dactylic hexameter	masculine penthemimeral
σῷ ὑπὸ δουρὶ πόλιν πέρθαι Τρώων ἀγερώχων,	- uu -u u- -- -- uu--	dactylic hexameter	masculine penthemimeral, hepthemimeral
οὐδ’ ὑπ’ Ἀχιλλῆος, ὅς περ σέο πολλὸν ἀμείνων.	- u u--- - - uu -u u--	dactylic hexameter	masculine penthemimeral, hepthemimeral
ὣς φάτο, Πάτροκλος δ’ἀνεχάζετο πολλὸν ὀπίσσω	- uu --- uu-uu -u u--	dactylic hexameter	masculine penthemimeral
μῆνιν ἀλευάμενος ἑκατηβόλου Ἀπόλλωνος.	-u u-uu- uu-uu ----	dactylic hexameter	masculine penthemimeral
Ἕκτωρ δ’ἐν Σκαιῇσι πύλῃς ἔχε μώνυχας ἵππους·	-- - --u u- uu -uu --	dactylic hexameter	feminine penthemimeral, hepthemimeral, trithemimeral
δίζε γὰρ ἠὲ μάχοιτο κατὰ κλόνον αὖτις ἐλάσσας,	-u u -u u-u u- uu -u u--	dactylic hexameter	feminine penthemimeral, hepthemimeral
ἦ λαοὺς ἐς τεῖχος ὁμοκλήσειεν ἀλῆναι.	- -- - -u u---u u--	dactylic hexameter	feminine penthemimeral, trithemimeral
ταῦτ’ ἄρα οἱ φρονέοντι παρίστατο Φοῖβος Ἀπόλλων	- uu - uu-u u-uu -u u--	dactylic hexameter	feminine penthemimeral, trithemimeral
ἀνέρι εἰσάμενος αἰζηῷ τε κρατερῷ τε	-uu -uu- --- - uu- -	dactylic hexameter	masculine penthemimeral
Ἀσίῳ, ὃς μήτρως ἦν Ἕκτορος ἱπποδάμοιο	-uu - -- - -uu -uu--	dactylic hexameter	masculine penthemimeral, trithemimeral
αὐτοκασίγνητος Ἑκάβης, υἱὸς δὲ Δύμαντος,	-uu--- uu- -- u u--	dactylic hexameter	masculine penthemimeral, hepthemimeral
ὃς Φρυγίῃ ναίεσκε ῥοῇς ἔπι Σαγγαρίοιο·	- uu- --u u- uu -uu--	dactylic hexameter	feminine penthemimeral, hepthemimeral, trithemimeral
τῷ μιν ἐεισάμενος προσέφη Διὸς υἱὸς Ἀπόλλων·	- u u-uu- uu- uu -u u--	dactylic hexameter	masculine penthemimeral, hepthemimeral
Ἕκτορ τίπτε μάχης ἀποπαύεαι; οὐδέ τί σε χρή.	-u -u u- uu-uu -u u - -	lyric	
αἴθ’ ὅσον ἥσσων εἰμί, τόσον σέο φέρτερος εἴην·	- uu -- -u u- uu -uu --	dactylic hexameter	feminine penthemimeral, hepthemimeral
τώ κε τάχα στυγερῶς πολέμου ἀπερωήσειας.	- u u- uu- uu- uu----	dactylic hexameter	masculine penthemimeral, hepthemimeral, trithemimeral
ἀλλ’ ἄγε Πατρόκλῳ ἔφεπε κρατερώνυχας ἵππους,	- uu --- uu- uu-uu --	dactylic hexameter	masculine penthemimeral, hepthemimeral
αἴ κέν πώς μιν ἕλῃς, δώῃ δέ τοι εὖχος Ἀπόλλων.	- - - u u- -- u u -u u--	dactylic hexameter	masculine penthemimeral, hepthemimeral, trithemimeral
ὣς εἰπὼν ὃ μὲν αὖτις ἔβη θεὸς ἂμ πόνον ἀνδρῶν,	- -u u u -u u- uu - uu --	lyric	
Κεβριόνῃ δ’ἐκέλευσε δαΐφρονι φαίδιμος Ἕκτωρ	-uu- uu-u u-uu -uu --	dactylic hexameter	feminine penthemimeral, trithemimeral
ἵππους ἐς πόλεμον πεπληγέμεν. αὐτὰρ Ἀπόλλων	-- - uu- --uu -u u--	dactylic hexameter	masculine penthemimeral, trithemimeral
δύσεθ’ ὅμιλον ἰών, ἐν δὲ κλόνον Ἀργείοισιν	-u u-u u- - - uu ----	dactylic hexameter	masculine penthemimeral, hepthemimeral
ἧκε κακόν, Τρωσὶν δὲ καὶ Ἕκτορι κῦδος ὄπαζεν.	-u u- -- u u -uu -u u--	dactylic hexameter	masculine penthemimeral, trithemimeral
Ἕκτωρ δ’ἄλλους μὲν Δαναοὺς ἔα οὐδ’ ἐνάριζεν·	-- -- - uu- uu - uu--	dactylic hexameter	masculine penthemimeral, hepthemimeral
αὐτὰρ ὃ Πατρόκλῳ ἔφεπε κρατερώνυχας ἵππους.	-u u --- uu- uu-uu --	dactylic hexameter	masculine penthemimeral, hepthemimeral
Πάτροκλος δ’ἑτέρωθεν ἀφ’ ἵππων ἆλτο χαμᾶζε	--- uu-u u -- -u u--	dactylic hexameter	feminine penthemimeral, trithemimeral
σκαιῇ ἔγχος ἔχων· ἑτέρηφι δὲ λάζετο πέτρον	-- -u u- uu-u u -uu --	dactylic hexameter	masculine penthemimeral
μάρμαρον ὀκριόεντα τόν οἱ περὶ χεὶρ ἐκάλυψεν,	-uu -uu-u u - uu - uu--	dactylic hexameter	feminine penthemimeral, hepthemimeral
ἧκε δ’ἐρεισάμενος, οὐδὲ δὴν χάζετο φωτός,	-u u-uu- -- - -uu --	dactylic hexameter	masculine penthemimeral, hepthemimeral
οὐδ’ ἁλίωσε βέλος, βάλε δ’Ἕκτορος ἡνιοχῆα	- uu-u u- uu -uu -uu--	dactylic hexameter	masculine penthemimeral
Κεβριόνην νόθον υἱὸν ἀγακλῆος Πριάμοιο	-uu- uu -u u--- uu--	dactylic hexameter	feminine penthemimeral, trithemimeral
ἵππων ἡνί’ ἔχοντα μετώπιον ὀξέϊ λᾶϊ.	-- -u u-u u-uu -uu --	dactylic hexameter	feminine penthemimeral
ἀμφοτέρας δ’ὀφρῦς σύνελεν λίθος, οὐδέ οἱ ἔσχεν	-uu- -- uu- uu -u u --	dactylic hexameter	masculine penthemimeral, hepthemimeral, trithemimeral
ὀστέον, ὀφθαλμοὶ δὲ χαμαὶ πέσον ἐν κονίῃσιν	-uu --- u u- uu - uu--	dactylic hexameter	masculine penthemimeral, hepthemimeral
αὐτοῦ πρόσθε ποδῶν· ὃ δ’ἄρ’ ἀρνευτῆρι ἐοικὼς	-- -u u- u u ---u u--	dactylic hexameter	masculine penthemimeral
κάππεσ’ ἀπ’ εὐεργέος δίφρου, λίπε δ’ὀστέα θυμός.	-u u --- -- uu -uu --	dactylic hexameter	masculine penthemimeral, hepthemimeral
τὸν δ’ἐπικερτομέων προσέφης Πατρόκλεες ἱππεῦ·	- uu-uu- uu- --uu --	dactylic hexameter	masculine penthemimeral, hepthemimeral
ὢ πόποι ἦ μάλ’ ἐλαφρὸς ἀνήρ, ὡς ῥεῖα κυβιστᾷ.	- uu - u u-u u- - -u u--	dactylic hexameter	feminine penthemimeral, hepthemimeral, trithemimeral
εἰ δή που καὶ πόντῳ ἐν ἰχθυόεντι γένοιτο,	- - - - -u u -uu-u u--	dactylic hexameter	feminine penthemimeral, trithemimeral
πολλοὺς ἂν κορέσειεν ἀνὴρ ὅδε τήθεα διφῶν	-- - uu-u u- uu -uu --	dactylic hexameter	feminine penthemimeral, hepthemimeral, trithemimeral
νηὸς ἀποθρῴσκων, εἰ καὶ δυσπέμφελος εἴη,	-u u--- - - --uu --	dactylic hexameter	masculine penthemimeral, hepthemimeral
ὡς νῦν ἐν πεδίῳ ἐξ ἵππων ῥεῖα κυβιστᾷ.	- - - uu- - -- -u u--	dactylic hexameter	masculine penthemimeral, trithemimeral
ἦ ῥα καὶ ἐν Τρώεσσι κυβιστητῆρες ἔασιν.	- u u - --u u---u u--	dactylic hexameter	feminine penthemimeral, trithemimeral
ὣς εἰπὼν ἐπὶ Κεβριόνῃ ἥρωϊ βεβήκει	- -u uu -uu- --u u--	lyric	
οἶμα λέοντος ἔχων, ὅς τε σταθμοὺς κεραΐζων	-u u-u u- - - -- uu--	dactylic hexameter	masculine penthemimeral, hepthemimeral
ἔβλητο πρὸς στῆθος, ἑή τέ μιν ὤλεσεν ἀλκή·	--- - -u u- u u -uu --	dactylic hexameter	feminine penthemimeral, hepthemimeral, trithemimeral
ὣς ἐπὶ Κεβριόνῃ Πατρόκλεες ἆλσο μεμαώς.	- uu -uu- --uu -u u--	dactylic hexameter	masculine penthemimeral
Ἕκτωρ δ’αὖθ’ ἑτέρωθεν ἀφ’ ἵππων ἆλτο χαμᾶζε.	-- - uu-u u -- -u u--	dactylic hexameter	feminine penthemimeral, trithemimeral
τὼ περὶ Κεβριόναο λέονθ’ ὣς δηρινθήτην,	- uu -uu-u u- - ----	dactylic hexameter	feminine penthemimeral, hepthemimeral
ὥ τ’ὄρεος κορυφῇσι περὶ κταμένης ἐλάφοιο	- uu- uu-u u- uu- uu--	dactylic hexameter	feminine penthemimeral, hepthemimeral, trithemimeral
ἄμφω πεινάοντε μέγα φρονέοντε μάχεσθον·	-- ---u u- uu-u u--	dactylic hexameter	feminine penthemimeral, hepthemimeral
ὣς περὶ Κεβριόναο δύω μήστωρες ἀϋτῆς	- uu -uu-u u- --u u--	dactylic hexameter	feminine penthemimeral, hepthemimeral
Πάτροκλός τε Μενοιτιάδης καὶ φαίδιμος Ἕκτωρ	--- u u-uu- - -uu --	dactylic hexameter	hepthemimeral, trithemimeral
ἵεντ’ ἀλλήλων ταμέειν χρόα νηλέϊ χαλκῷ.	-- --- uu- uu -uu --	dactylic hexameter	masculine penthemimeral, hepthemimeral
Ἕκτωρ μὲν κεφαλῆφιν ἐπεὶ λάβεν οὐχὶ μεθίει·	-- - uu-u u- uu -u u--	dactylic hexameter	feminine penthemimeral, hepthemimeral, trithemimeral
Πάτροκλος δ’ἑτέρωθεν ἔχεν ποδός· οἳ δὲ δὴ ἄλλοι	--- uu-u u- uu - u u --	dactylic hexameter	feminine penthemimeral, hepthemimeral, trithemimeral
Τρῶες καὶ Δαναοὶ σύναγον κρατερὴν ὑσμίνην.	-- - uu- uu- uu- ---	dactylic hexameter	masculine penthemimeral, hepthemimeral, trithemimeral
ὡς δ’Εὖρός τε Νότος τ’ἐριδαίνετον ἀλλήλοιιν	- -- u u- uu-uu ----	dactylic hexameter	masculine penthemimeral, trithemimeral
οὔρεος ἐν βήσσῃς βαθέην πελεμιζέμεν ὕλην	-uu - -- uu- uu-uu --	dactylic hexameter	masculine penthemimeral, hepthemimeral, trithemimeral
φηγόν τε μελίην τε τανύφλοιόν τε κράνειαν,	-- - uu- u u--- u u--	dactylic hexameter	masculine penthemimeral, trithemimeral
αἵ τε πρὸς ἀλλήλας ἔβαλον τανυήκεας ὄζους	- u u --- uu- uu-uu --	dactylic hexameter	masculine penthemimeral, hepthemimeral
ἠχῇ θεσπεσίῃ, πάταγος δέ τε ἀγνυμενάων,	-- -uu- uu- u u -uu--	dactylic hexameter	masculine penthemimeral, hepthemimeral
ὣς Τρῶες καὶ Ἀχαιοὶ ἐπ’ ἀλλήλοισι θορόντες	- -- u u-u u ---u u--	dactylic hexameter	feminine penthemimeral, trithemimeral
δῄουν, οὐδ’ ἕτεροι μνώοντ’ ὀλοοῖο φόβοιο.	-- - uu- -- uu-u u--	dactylic hexameter	masculine penthemimeral, hepthemimeral, trithemimeral
πολλὰ δὲ Κεβριόνην ἀμφ’ ὀξέα δοῦρα πεπήγει	-u u -uu- - -uu -u u--	dactylic hexameter	masculine penthemimeral
ἰοί τε πτερόεντες ἀπὸ νευρῆφι θορόντες,	-- - uu-u u- --u u--	dactylic hexameter	feminine penthemimeral, hepthemimeral, trithemimeral
πολλὰ δὲ χερμάδια μεγάλ’ ἀσπίδας ἐστυφέλιξαν	-u u -uu- uu -uu -uu--	dactylic hexameter	masculine penthemimeral
μαρναμένων ἀμφ’ αὐτόν· ὃ δ’ἐν στροφάλιγγι κονίης	-uu- - -u u - uu-u u--	dactylic hexameter	feminine penthemimeral, hepthemimeral, trithemimeral
κεῖτο μέγας μεγαλωστί, λελασμένος ἱπποσυνάων.	-u u- uu-u u-uu -uu--	dactylic hexameter	feminine penthemimeral, trithemimeral
ὄφρα μὲν Ἠέλιος μέσον οὐρανὸν ἀμφιβεβήκει,	-u u -uu- uu -uu -uu--	dactylic hexameter	masculine penthemimeral
τόφρα μάλ’ ἀμφοτέρων βέλε’ ἥπτετο, πῖπτε δὲ λαός·	-u u -uu- uu -uu -u u --	dactylic hexameter	masculine penthemimeral
ἦμος δ’Ἠέλιος μετενίσετο βουλυτὸν δέ,	-- -uu- uu-uu --- -	dactylic hexameter	masculine penthemimeral
καὶ τότε δή ῥ’ὑπὲρ αἶσαν Ἀχαιοὶ φέρτεροι ἦσαν.	- uu - uu -u u-- -uu --	dactylic hexameter	feminine penthemimeral, trithemimeral
ἐκ μὲν Κεβριόνην βελέων ἥρωα ἔρυσσαν	- - -uu- uu- --u u--	dactylic hexameter	masculine penthemimeral, hepthemimeral
Τρώων ἐξ ἐνοπῆς, καὶ ἀπ’ ὤμων τεύχε’ ἕλοντο,	-- - uu- u u -- -u u--	dactylic hexameter	masculine penthemimeral, trithemimeral
Πάτροκλος δὲ Τρωσὶ κακὰ φρονέων ἐνόρουσε.	--- - -u u- uu- uu--	dactylic hexameter	feminine penthemimeral, hepthemimeral, trithemimeral
τρὶς μὲν ἔπειτ’ ἐπόρουσε θοῷ ἀτάλαντος Ἄρηϊ	- u u- uu-u u- uu-u u--	dactylic hexameter	feminine penthemimeral, hepthemimeral, trithemimeral
σμερδαλέα ἰάχων, τρὶς δ’ἐννέα φῶτας ἔπεφνεν.	-uu- uu- - -uu -u u--	dactylic hexameter	masculine penthemimeral, trithemimeral
ἀλλ’ ὅτε δὴ τὸ τέταρτον ἐπέσσυτο δαίμονι ἶσος,	- uu - u u-u u-uu -uu --	dactylic hexameter	feminine penthemimeral, trithemimeral
ἔνθ’ ἄρα τοι Πάτροκλε φάνη βιότοιο τελευτή·	- uu - --u u- uu-u u--	dactylic hexameter	feminine penthemimeral, hepthemimeral, trithemimeral
ἤντετο γάρ τοι Φοῖβος ἐνὶ κρατερῇ ὑσμίνῃ	-uu - - -u u- uu- ---	dactylic hexameter	feminine penthemimeral, hepthemimeral, trithemimeral
δεινός· ὃ μὲν τὸν ἰόντα κατὰ κλόνον οὐκ ἐνόησεν,	-u u - u u-u u- uu - uu--	dactylic hexameter	feminine penthemimeral, hepthemimeral, trithemimeral
ἠέρι γὰρ πολλῇ κεκαλυμμένος ἀντεβόλησε·	-uu - -- uu-uu -uu--	dactylic hexameter	masculine penthemimeral, trithemimeral
στῆ δ’ὄπιθεν, πλῆξεν δὲ μετάφρενον εὐρέε τ’ὤμω	- uu- -- u u-uu -uu --	dactylic hexameter	masculine penthemimeral, trithemimeral
χειρὶ καταπρηνεῖ, στρεφεδίνηθεν δέ οἱ ὄσσε.	-u u--- uu--- u u --	dactylic hexameter	masculine penthemimeral
τοῦ δ’ἀπὸ μὲν κρατὸς κυνέην βάλε Φοῖβος Ἀπόλλων·	- uu - -- uu- uu -u u--	dactylic hexameter	masculine penthemimeral, hepthemimeral, trithemimeral
ἣ δὲ κυλινδομένη καναχὴν ἔχε ποσσὶν ὑφ’ ἵππων	- u u-uu- uu- uu -u u --	dactylic hexameter	masculine penthemimeral, hepthemimeral
αὐλῶπις τρυφάλεια, μιάνθησαν δὲ ἔθειραι	--- uu-u u--- u u--	dactylic hexameter	feminine penthemimeral, trithemimeral
αἵματι καὶ κονίῃσι· πάρος γε μὲν οὐ θέμις ἦεν	-uu - uu-u u- u u - uu --	dactylic hexameter	feminine penthemimeral, hepthemimeral, trithemimeral
ἱππόκομον πήληκα μιαίνεσθαι κονίῃσιν,	-uu- --u u--- uu--	dactylic hexameter	feminine penthemimeral, trithemimeral
ἀλλ’ ἀνδρὸς θείοιο κάρη χαρίεν τε μέτωπον	- -- --u u- uu- u u--	dactylic hexameter	feminine penthemimeral, hepthemimeral, trithemimeral
ῥύετ’ Ἀχιλλῆος· τότε δὲ Ζεὺς Ἕκτορι δῶκεν	-u u--- uu - - -uu --	dactylic hexameter	masculine penthemimeral, hepthemimeral
ᾗ κεφαλῇ φορέειν, σχεδόθεν δέ οἱ ἦεν ὄλεθρος.	- uu- uu- uu- u u -u u--	dactylic hexameter	masculine penthemimeral, hepthemimeral, trithemimeral
πᾶν δέ οἱ ἐν χείρεσσιν ἄγη δολιχόσκιον ἔγχος	- u u - --u u- uu-uu --	dactylic hexameter	feminine penthemimeral, hepthemimeral, trithemimeral
βριθὺ μέγα στιβαρὸν κεκορυθμένον· αὐτὰρ ἀπ’ ὤμων	-u u- uu- uu-uu -u u --	dactylic hexameter	masculine penthemimeral, trithemimeral
ἀσπὶς σὺν τελαμῶνι χαμαὶ πέσε τερμιόεσσα.	-- - uu-u u- uu -uu--	dactylic hexameter	feminine penthemimeral, hepthemimeral, trithemimeral
λῦσε δέ οἱ θώρηκα ἄναξ Διὸς υἱὸς Ἀπόλλων.	-u u - --u u- uu -u u--	dactylic hexameter	feminine penthemimeral, hepthemimeral, trithemimeral
τὸν δ’ἄτη φρένας εἷλε, λύθεν δ’ὑπὸ φαίδιμα γυῖα,	- -- uu -u u- uu -uu --	dactylic hexameter	feminine penthemimeral, hepthemimeral, trithemimeral
στῆ δὲ ταφών· ὄπιθεν δὲ μετάφρενον ὀξέϊ δουρὶ	- u u- uu- u u-uu -uu --	dactylic hexameter	masculine penthemimeral, trithemimeral
ὤμων μεσσηγὺς σχεδόθεν βάλε Δάρδανος ἀνὴρ	-- --- uu- uu -uu --	dactylic hexameter	masculine penthemimeral, hepthemimeral
Πανθοΐδης Εὔφορβος, ὃς ἡλικίην ἐκέκαστο	-uu- --u u -uu- uu--	dactylic hexameter	feminine penthemimeral, trithemimeral
ἔγχεΐ θ’ἱπποσύνῃ τε πόδεσσί τε καρπαλίμοισι·	-uu -uu- u u-u u -uu--	dactylic hexameter	masculine penthemimeral
καὶ γὰρ δὴ τότε φῶτας ἐείκοσι βῆσεν ἀφ’ ἵππων	- - - uu -u u-uu -u u --	dactylic hexameter	feminine penthemimeral, trithemimeral
πρῶτ’ ἐλθὼν σὺν ὄχεσφι διδασκόμενος πολέμοιο·	- -- u u-u u-uu- uu--	dactylic hexameter	feminine penthemimeral, trithemimeral
ὅς τοι πρῶτος ἐφῆκε βέλος Πατρόκλεες ἱππεῦ	- - -u u-u u- --uu --	dactylic hexameter	feminine penthemimeral, hepthemimeral
οὐδὲ δάμασσ’· ὃ μὲν αὖτις ἀνέδραμε, μίκτο δ’ὁμίλῳ,	-u u- u u -u u-uu -u u--	dactylic hexameter	feminine penthemimeral, trithemimeral
ἐκ χροὸς ἁρπάξας δόρυ μείλινον, οὐδ’ ὑπέμεινε	- uu --- uu -uu - uu--	dactylic hexameter	masculine penthemimeral
Πάτροκλον γυμνόν περ ἐόντ’ ἐν δηϊοτῆτι.	--- -- u u- - -uu--	dactylic hexameter	masculine penthemimeral, hepthemimeral, trithemimeral
Πάτροκλος δὲ θεοῦ πληγῇ καὶ δουρὶ δαμασθεὶς	--- u u- -- - -u u--	dactylic hexameter	masculine penthemimeral, hepthemimeral, trithemimeral
ἂψ ἑτάρων εἰς ἔθνος ἐχάζετο κῆρ’ ἀλεείνων.	- uu- - -u u-uu - uu--	dactylic hexameter	feminine penthemimeral, trithemimeral
Ἕκτωρ δ’ὡς εἶδεν Πατροκλῆα μεγάθυμον	-- - -- ---- uu--	dactylic hexameter	masculine penthemimeral, trithemimeral
ἂψ ἀναχαζόμενον βεβλημένον ὀξέϊ χαλκῷ,	- uu-uu- --uu -uu --	dactylic hexameter	masculine penthemimeral
ἀγχίμολόν ῥά οἱ ἦλθε κατὰ στίχας, οὖτα δὲ δουρὶ	-uu- u u -u u- uu -u u --	dactylic hexameter	feminine penthemimeral, hepthemimeral, trithemimeral
νείατον ἐς κενεῶνα, διὰ πρὸ δὲ χαλκὸν ἔλασσε·	-uu - uu-u u- u u -u u--	dactylic hexameter	feminine penthemimeral, hepthemimeral, trithemimeral
δούπησεν δὲ πεσών, μέγα δ’ἤκαχε λαὸν Ἀχαιῶν·	--- u u- uu -uu -u u--	dactylic hexameter	masculine penthemimeral, trithemimeral
ὡς δ’ὅτε σῦν ἀκάμαντα λέων ἐβιήσατο χάρμῃ,	- uu - uu-u u- uu-uu --	dactylic hexameter	feminine penthemimeral, hepthemimeral, trithemimeral
ὥ τ’ὄρεος κορυφῇσι μέγα φρονέοντε μάχεσθον	- uu- uu-u u- uu-u u--	dactylic hexameter	feminine penthemimeral, hepthemimeral, trithemimeral
πίδακος ἀμφ’ ὀλίγης· ἐθέλουσι δὲ πιέμεν ἄμφω·	-uu - uu- uu-u u -uu --	dactylic hexameter	masculine penthemimeral, trithemimeral
πολλὰ δέ τ’ἀσθμαίνοντα λέων ἐδάμασσε βίηφιν·	-u u ---u u- uu-u u--	dactylic hexameter	feminine penthemimeral, hepthemimeral
ὣς πολέας πεφνόντα Μενοιτίου ἄλκιμον υἱὸν	- uu- --u u-uu -uu --	dactylic hexameter	feminine penthemimeral, trithemimeral
Ἕκτωρ Πριαμίδης σχεδὸν ἔγχεϊ θυμὸν ἀπηύρα,	-- -uu- uu -uu -u u--	dactylic hexameter	masculine penthemimeral
καί οἱ ἐπευχόμενος ἔπεα πτερόεντα προσηύδα·	- u u-uu- uu- uu-u u--	dactylic hexameter	masculine penthemimeral, hepthemimeral
Πάτροκλ’ ἦ που ἔφησθα πόλιν κεραϊξέμεν ἁμήν,	-u - u u-u u- uu-uu --	lyric	
Τρωϊάδας δὲ γυναῖκας ἐλεύθερον ἦμαρ ἀπούρας	-uu- u u-u u-uu -u u--	dactylic hexameter	feminine penthemimeral, trithemimeral
ἄξειν ἐν νήεσσι φίλην ἐς πατρίδα γαῖαν	-- - --u u- - -uu --	dactylic hexameter	feminine penthemimeral, hepthemimeral, trithemimeral
νήπιε· τάων δὲ πρόσθ’ Ἕκτορος ὠκέες ἵπποι	-uu -- - - -uu -uu --	dactylic hexameter	masculine penthemimeral
ποσσὶν ὀρωρέχαται πολεμίζειν· ἔγχεϊ δ’αὐτὸς	-u u-uu- uu-- -uu --	dactylic hexameter	masculine penthemimeral
Τρωσὶ φιλοπτολέμοισι μεταπρέπω, ὅ σφιν ἀμύνω	-u u-uu-u u-uu - u u--	dactylic hexameter	feminine penthemimeral
ἦμαρ ἀναγκαῖον· σὲ δέ τ’ἐνθάδε γῦπες ἔδονται.	-u u--- u u -uu -u u--	dactylic hexameter	masculine penthemimeral
ἆ δείλ’, οὐδέ τοι ἐσθλὸς ἐὼν χραίσμησεν Ἀχιλλεύς,	- - -u u -u u- --u u--	dactylic hexameter	feminine penthemimeral, hepthemimeral
ὅς πού τοι μάλα πολλὰ μένων ἐπετέλλετ’ ἰόντι·	- - - uu -u u- uu-u u--	dactylic hexameter	feminine penthemimeral, hepthemimeral, trithemimeral
μή μοι πρὶν ἰέναι Πατρόκλεες ἱπποκέλευθε	- - - uu- --uu -uu--	dactylic hexameter	masculine penthemimeral, trithemimeral
νῆας ἔπι γλαφυρὰς πρὶν Ἕκτορος ἀνδροφόνοιο	-u u- uu- - -uu -uu--	dactylic hexameter	masculine penthemimeral, trithemimeral
αἱματόεντα χιτῶνα περὶ στήθεσσι δαΐξαι.	-uu-u u-u u- --u u--	dactylic hexameter	feminine penthemimeral, hepthemimeral
ὥς πού σε προσέφη, σοὶ δὲ φρένας ἄφρονι πεῖθε.	- - - uu- - - uu -uu --	dactylic hexameter	masculine penthemimeral, hepthemimeral, trithemimeral
τὸν δ’ὀλιγοδρανέων προσέφης Πατρόκλεες ἱππεῦ·	- uuuuu- uu- --uu --	lyric	
ἤδη νῦν Ἕκτορ μεγάλ’ εὔχεο· σοὶ γὰρ ἔδωκε	-- - -u uu -uu - u u--	lyric	
νίκην Ζεὺς Κρονίδης καὶ Ἀπόλλων, οἵ με δάμασσαν	-- - uu- u u-- - u u--	dactylic hexameter	masculine penthemimeral, trithemimeral
ῥηιδίως· αὐτοὶ γὰρ ἀπ’ ὤμων τεύχε’ ἕλοντο.	-uu- -- u u -- -u u--	dactylic hexameter	masculine penthemimeral, trithemimeral
τοιοῦτοι δ’εἴ πέρ μοι ἐείκοσιν ἀντεβόλησαν,	--- - - u u-uu -uu--	dactylic hexameter	masculine penthemimeral, trithemimeral
πάντές κ’αὐτόθ’ ὄλοντο ἐμῷ ὑπὸ δουρὶ δαμέντες.	-- -u u-u u- uu -u u--	dactylic hexameter	feminine penthemimeral, hepthemimeral
ἀλλά με μοῖρ’ ὀλοὴ καὶ Λητοῦς ἔκτανεν υἱός,	-u u - uu- - -- -uu --	dactylic hexameter	masculine penthemimeral, trithemimeral
ἀνδρῶν δ’Εὔφορβος· σὺ δέ με τρίτος ἐξεναρίζεις.	-- --- u u - uu -uu--	dactylic hexameter	masculine penthemimeral, hepthemimeral
ἄλλο δέ τοι ἐρέω, σὺ δ’ἐνὶ φρεσὶ βάλλεο σῇσιν·	-u u - uu- u u- uu -uu --	dactylic hexameter	masculine penthemimeral, hepthemimeral, trithemimeral
οὔ θην οὐδ’ αὐτὸς δηρὸν βέῃ, ἀλλά τοι ἤδη	- - - -- -- uu -u u --	dactylic hexameter	masculine penthemimeral, hepthemimeral, trithemimeral
ἄγχι παρέστηκεν θάνατος καὶ μοῖρα κραταιὴ	-u u--- uu- - -u u--	dactylic hexameter	masculine penthemimeral, hepthemimeral
χερσὶ δαμέντ’ Ἀχιλῆος ἀμύμονος Αἰακίδαο.	-u u- uu-u u-uu -uu--	dactylic hexameter	feminine penthemimeral, trithemimeral
ὣς ἄρα μιν εἰπόντα τέλος θανάτοιο κάλυψε·	- uu - -uu u- uu-u u--	lyric	
ψυχὴ δ’ἐκ ῥεθέων πταμένη Ἄϊδος δὲ βεβήκει	-- - uu- uu- uu- u u--	dactylic hexameter	masculine penthemimeral, hepthemimeral, trithemimeral
ὃν πότμον γοόωσα λιποῦσ’ ἀνδροτῆτα καὶ ἥβην.	- -- uu-u u- uu-u u --	dactylic hexameter	feminine penthemimeral, hepthemimeral, trithemimeral
τὸν καὶ τεθνηῶτα προσηύδα φαίδιμος Ἕκτωρ·	- - ---u u-- -uu --	dactylic hexameter	feminine penthemimeral
Πατρόκλεις τί νύ μοι μαντεύεαι αἰπὺν ὄλεθρον;	--u u u - --uu -u u--	lyric	
τίς δ’οἶδ’ εἴ κ’Ἀχιλεὺς Θέτιδος πάϊς ἠϋκόμοιο	- - - uu- uu- uu -uu--	dactylic hexameter	masculine penthemimeral, hepthemimeral, trithemimeral
φθήῃ ἐμῷ ὑπὸ δουρὶ τυπεὶς ἀπὸ θυμὸν ὀλέσσαι;	-u u- uu -u u- uu -u u--	dactylic hexameter	feminine penthemimeral, hepthemimeral, trithemimeral
ὣς ἄρα φωνήσας δόρυ χάλκεον ἐξ ὠτειλῆς	- uu u-- uu -uu - ---	lyric	
εἴρυσε λὰξ προσβάς, τὸν δ’ὕπτιον ὦσ’ ἀπὸ δουρός.	-uu - -- - -uu - uu --	dactylic hexameter	masculine penthemimeral, trithemimeral
αὐτίκα δὲ ξὺν δουρὶ μετ’ Αὐτομέδοντα βεβήκει	-uu - - -u u -uu-u u--	dactylic hexameter	feminine penthemimeral, trithemimeral
ἀντίθεον θεράποντα ποδώκεος Αἰακίδαο·	-uu- uu-u u-uu -uu--	dactylic hexameter	feminine penthemimeral, trithemimeral
ἵετο γὰρ βαλέειν· τὸν δ’ἔκφερον ὠκέες ἵπποι	-uu - uu- - -uu -uu --	dactylic hexameter	masculine penthemimeral, trithemimeral
ἄμβροτοι, οὓς Πηλῆϊ θεοὶ δόσαν ἀγλαὰ δῶρα.	-uu - --u u- uu -uu --	dactylic hexameter	feminine penthemimeral, hepthemimeral, trithemimeral
