οὐδ’ ἔλαθ’ Ἀτρέος υἱὸν ἀρηΐφιλον Μενέλαον	- uu -uu -u u-uu- uu--	dactylic hexameter	feminine penthemimeral
Πάτροκλος Τρώεσσι δαμεὶς ἐν δηϊοτῆτι.	--- --u u- - -uu--	dactylic hexameter	feminine penthemimeral, hepthemimeral, trithemimeral
βῆ δὲ διὰ προμάχων κεκορυθμένος αἴθοπι χαλκῷ,	- u u- uu- uu-uu -uu --	dactylic hexameter	masculine penthemimeral, trithemimeral
ἀμφὶ δ’ἄρ’ αὐτῷ βαῖν’ ὥς τις περὶ πόρτακι μήτηρ	-u u -- - - - uu -uu --	dactylic hexameter	masculine penthemimeral, hepthemimeral
πρωτοτόκος κινυρὴ οὐ πρὶν εἰδυῖα τόκοιο·	-uu- uu- - - --u u--	dactylic hexameter	masculine penthemimeral, hepthemimeral, trithemimeral
ὣς περὶ Πατρόκλῳ βαῖνε ξανθὸς Μενέλαος.	- uu --- -- -- uu--	dactylic hexameter	masculine penthemimeral, hepthemimeral
πρόσθε δέ οἱ δόρυ τ’ἔσχε καὶ ἀσπίδα πάντοσ’ ἐΐσην,	-u u - uu -u u -uu -u u--	dactylic hexameter	feminine penthemimeral, trithemimeral
τὸν κτάμεναι μεμαὼς ὅς τις τοῦ γ’ἀντίος ἔλθοι.	- uu- uu- - - - -uu --	dactylic hexameter	masculine penthemimeral, hepthemimeral, trithemimeral
οὐδ’ ἄρα Πάνθου υἱὸς ἐϋμμελίης ἀμέλησε	- uu -- -u u-uu- uu--	dactylic hexameter	feminine penthemimeral
Πατρόκλοιο πεσόντος ἀμύμονος· ἄγχι δ’ἄρ’ αὐτοῦ	---u u-u u-uu -u u --	dactylic hexameter	feminine penthemimeral
ἔστη, καὶ προσέειπεν ἀρηΐφιλον Μενέλαον·	-- - uu-u u-uu- uu--	dactylic hexameter	feminine penthemimeral, trithemimeral
Ἀτρεΐδη Μενέλαε διοτρεφὲς ὄρχαμε λαῶν	-uu- uu-u u-uu -uu --	dactylic hexameter	feminine penthemimeral, trithemimeral
χάζεο, λεῖπε δὲ νεκρόν, ἔα δ’ἔναρα βροτόεντα·	-uu -u u -u u- uu- uu--	dactylic hexameter	feminine penthemimeral, hepthemimeral
οὐ γάρ τις πρότερος Τρώων κλειτῶν τ’ἐπικούρων	- - - uu- -- -- uu--	dactylic hexameter	masculine penthemimeral, hepthemimeral, trithemimeral
Πάτροκλον βάλε δουρὶ κατὰ κρατερὴν ὑσμίνην·	--- uu -u u- uu- ---	dactylic hexameter	feminine penthemimeral, hepthemimeral, trithemimeral
τώ με ἔα κλέος ἐσθλὸν ἐνὶ Τρώεσσιν ἀρέσθαι,	- u u- uu -u u- --u u--	dactylic hexameter	feminine penthemimeral, hepthemimeral, trithemimeral
μή σε βάλω, ἀπὸ δὲ μελιηδέα θυμὸν ἕλωμαι.	- u u- uu - uu-uu -u u--	dactylic hexameter	masculine penthemimeral, trithemimeral
τὸν δὲ μέγ’ ὀχθήσας προσέφη ξανθὸς Μενέλαος·	- u u --- uu- -- uu--	dactylic hexameter	masculine penthemimeral, hepthemimeral
Ζεῦ πάτερ οὐ μὲν καλὸν ὑπέρβιον εὐχετάασθαι.	- uu - - -u u-uu -uu--	dactylic hexameter	feminine penthemimeral, trithemimeral
οὔτ’ οὖν παρδάλιος τόσσον μένος οὔτε λέοντος	- - -uu- -- uu -u u--	dactylic hexameter	masculine penthemimeral, hepthemimeral
οὔτε συὸς κάπρου ὀλοόφρονος, οὗ τε μέγιστος	-u u- -- uu-uu - u u--	dactylic hexameter	masculine penthemimeral, trithemimeral
θυμὸς ἐνὶ στήθεσσι περὶ σθένεϊ βλεμεαίνει,	-u u- --u u- uu- uu--	dactylic hexameter	feminine penthemimeral, hepthemimeral, trithemimeral
ὅσσον Πάνθου υἷες ἐϋμμελίαι φρονέουσιν.	-- -- -u u-uu- uu--	dactylic hexameter	feminine penthemimeral
οὐδὲ μὲν οὐδὲ βίη Ὑπερήνορος ἱπποδάμοιο	-u u -u u- uu-uu -uu--	dactylic hexameter	masculine penthemimeral
ἧς ἥβης ἀπόνηθ’, ὅτε μ’ὤνατο καί μ’ὑπέμεινε	- -- uu- uu -uu - uu--	dactylic hexameter	masculine penthemimeral, trithemimeral
καί μ’ἔφατ’ ἐν Δαναοῖσιν ἐλέγχιστον πολεμιστὴν	- uu - uu-u u--- uu--	dactylic hexameter	feminine penthemimeral, trithemimeral
ἔμμεναι· οὐδέ ἕ φημι πόδεσσί γε οἷσι κιόντα	-uu -u u -u u-u u -u u--	dactylic hexameter	feminine penthemimeral
εὐφρῆναι ἄλοχόν τε φίλην κεδνούς τε τοκῆας.	--- uu- u u- -- u u--	dactylic hexameter	masculine penthemimeral, hepthemimeral, trithemimeral
ὥς θην καὶ σὸν ἐγὼ λύσω μένος εἴ κέ μευ ἄντα	- - - u u- -- uu - u u --	dactylic hexameter	masculine penthemimeral, hepthemimeral, trithemimeral
στήῃς· ἀλλά σ’ἔγωγ’ ἀναχωρήσαντα κελεύω	-- -u u- uu---u u--	dactylic hexameter	masculine penthemimeral
ἐς πληθὺν ἰέναι, μηδ’ ἀντίος ἵστασ’ ἐμεῖο	- -- uu- - -uu -u u--	dactylic hexameter	masculine penthemimeral, trithemimeral
πρίν τι κακὸν παθέειν· ῥεχθὲν δέ τε νήπιος ἔγνω.	- u u- uu- -- u u -uu --	dactylic hexameter	masculine penthemimeral, hepthemimeral, trithemimeral
ὣς φάτο, τὸν δ’οὐ πεῖθεν· ἀμειβόμενος δὲ προσηύδα·	- uu - - -u u-uu- u u--	dactylic hexameter	feminine penthemimeral, trithemimeral
νῦν μὲν δὴ Μενέλαε διοτρεφὲς ἦ μάλα τείσεις	- - - uu-u u-uu - uu --	dactylic hexameter	feminine penthemimeral, trithemimeral
γνωτὸν ἐμὸν τὸν ἔπεφνες, ἐπευχόμενος δ’ἀγορεύεις,	-u u- u u-u u-uu- uu--	dactylic hexameter	feminine penthemimeral, trithemimeral
χήρωσας δὲ γυναῖκα μυχῷ θαλάμοιο νέοιο,	--- u u-u u- uu-u u--	dactylic hexameter	feminine penthemimeral, hepthemimeral, trithemimeral
ἀρητὸν δὲ τοκεῦσι γόον καὶ πένθος ἔθηκας.	--- u u-u u- - -u u--	dactylic hexameter	feminine penthemimeral, hepthemimeral, trithemimeral
ἦ κέ σφιν δειλοῖσι γόου κατάπαυμα γενοίμην	- - - --u u- uu-u u--	dactylic hexameter	feminine penthemimeral, hepthemimeral, trithemimeral
εἴ κεν ἐγὼ κεφαλήν τε τεὴν καὶ τεύχε’ ἐνείκας	- u u- uu- u u- - -u u--	dactylic hexameter	masculine penthemimeral, hepthemimeral, trithemimeral
Πάνθῳ ἐν χείρεσσι βάλω καὶ Φρόντιδι δίῃ.	-- - --u u- - -uu --	dactylic hexameter	feminine penthemimeral, hepthemimeral, trithemimeral
ἀλλ’ οὐ μὰν ἔτι δηρὸν ἀπείρητος πόνος ἔσται	- - - uu -u u--- uu --	dactylic hexameter	feminine penthemimeral, trithemimeral
οὐδ’ ἔτ’ ἀδήριτος ἤτ’ ἀλκῆς ἤτε φόβοιο.	- u u--- - -- -u u--	dactylic hexameter	masculine penthemimeral
ὣς εἰπὼν οὔτησε κατ’ ἀσπίδα πάντοσ’ ἐΐσην·	- -- --u u -uu -u u--	dactylic hexameter	feminine penthemimeral, trithemimeral
οὐδ’ ἔρρηξεν χαλκός, ἀνεγνάμφθη δέ οἱ αἰχμὴ	- --- -u u--- u u --	dactylic hexameter	feminine penthemimeral
ἀσπίδ’ ἐνὶ κρατερῇ· ὃ δὲ δεύτερος ὄρνυτο χαλκῷ	-u u- uu- u u -uu -uu --	dactylic hexameter	masculine penthemimeral, trithemimeral
Ἀτρεΐδης Μενέλαος ἐπευξάμενος Διὶ πατρί·	-uu- uu-u u-uu- uu --	dactylic hexameter	feminine penthemimeral, trithemimeral
ἂψ δ’ἀναχαζομένοιο κατὰ στομάχοιο θέμεθλα	- uu-uu-u u- uu-u u--	dactylic hexameter	feminine penthemimeral, hepthemimeral
νύξ’, ἐπὶ δ’αὐτὸς ἔρεισε βαρείῃ χειρὶ πιθήσας·	- uu -u u-u u-- -u u--	dactylic hexameter	feminine penthemimeral
ἀντικρὺ δ’ἁπαλοῖο δι’ αὐχένος ἤλυθ’ ἀκωκή,	--- uu-u u -uu -u u--	dactylic hexameter	feminine penthemimeral, trithemimeral
δούπησεν δὲ πεσών, ἀράβησε δὲ τεύχε’ ἐπ’ αὐτῷ.	--- u u- uu-u u -u u --	dactylic hexameter	masculine penthemimeral, trithemimeral
αἵματί οἱ δεύοντο κόμαι Χαρίτεσσιν ὁμοῖαι	-uu - --u u- uu-u u--	dactylic hexameter	feminine penthemimeral, hepthemimeral, trithemimeral
πλοχμοί θ’,οἳ χρυσῷ τε καὶ ἀργύρῳ ἐσφήκωντο.	-- - -- u u -uu ----	dactylic hexameter	masculine penthemimeral, trithemimeral
οἷον δὲ τρέφει ἔρνος ἀνὴρ ἐριθηλὲς ἐλαίης	-- - uu -u u- uu-u u--	dactylic hexameter	feminine penthemimeral, hepthemimeral, trithemimeral
χώρῳ ἐν οἰοπόλῳ, ὅθ’ ἅλις ἀναβέβροχεν ὕδωρ,	-u u -uu- u u- uu-uu --	dactylic hexameter	masculine penthemimeral, hepthemimeral
καλὸν τηλεθάον· τὸ δέ τε πνοιαὶ δονέουσι	-- -uu- u u - -- uu--	dactylic hexameter	masculine penthemimeral, hepthemimeral
παντοίων ἀνέμων, καί τε βρύει ἄνθεϊ λευκῷ·	--- uu- - - uu -uu --	dactylic hexameter	masculine penthemimeral, hepthemimeral, trithemimeral
ἐλθὼν δ’ἐξαπίνης ἄνεμος σὺν λαίλαπι πολλῇ	-- -uu- uu- - -uu --	dactylic hexameter	masculine penthemimeral, hepthemimeral
βόθρου τ’ἐξέστρεψε καὶ ἐξετάνυσσ’ ἐπὶ γαίῃ·	-- ---u u -uu- uu --	dactylic hexameter	feminine penthemimeral
τοῖον Πάνθου υἱὸν ἐϋμμελίην Εὔφορβον	-- -- -u u-uu- ---	dactylic hexameter	feminine penthemimeral
Ἀτρεΐδης Μενέλαος ἐπεὶ κτάνε τεύχε’ ἐσύλα.	-uu- uu-u u- uu -u u--	dactylic hexameter	feminine penthemimeral, hepthemimeral, trithemimeral
ὡς δ’ὅτε τίς τε λέων ὀρεσίτροφος ἀλκὶ πεποιθὼς	- uu - u u- uu-uu -u u--	dactylic hexameter	masculine penthemimeral, trithemimeral
βοσκομένης ἀγέλης βοῦν ἁρπάσῃ ἥ τις ἀρίστη·	-uu- uu- - -uu - u u--	dactylic hexameter	masculine penthemimeral, trithemimeral
τῆς δ’ἐξ αὐχέν’ ἔαξε λαβὼν κρατεροῖσιν ὀδοῦσι	- - -u u-u u- uu-u u--	dactylic hexameter	feminine penthemimeral, hepthemimeral
πρῶτον, ἔπειτα δέ θ’αἷμα καὶ ἔγκατα πάντα λαφύσσει	-u u-u u -u u -uu -u u--	dactylic hexameter	feminine penthemimeral
δῃῶν· ἀμφὶ δὲ τόν γε κύνες τ’ἄνδρές τε νομῆες	-- -u u - u u- -- u u--	dactylic hexameter	masculine penthemimeral, hepthemimeral
πολλὰ μάλ’ ἰύζουσιν ἀπόπροθεν οὐδ’ ἐθέλουσιν	-u u ---u u-uu - uu--	dactylic hexameter	feminine penthemimeral
ἀντίον ἐλθέμεναι· μάλα γὰρ χλωρὸν δέος αἱρεῖ·	-uu -uu- uu - -- uu --	dactylic hexameter	masculine penthemimeral, hepthemimeral
ὣς τῶν οὔ τινι θυμὸς ἐνὶ στήθεσσιν ἐτόλμα	- - - uu -u u- --u u--	dactylic hexameter	feminine penthemimeral, hepthemimeral, trithemimeral
ἀντίον ἐλθέμεναι Μενελάου κυδαλίμοιο.	-uu -uu- uu-- -uu--	dactylic hexameter	masculine penthemimeral
ἔνθά κε ῥεῖα φέροι κλυτὰ τεύχεα Πανθοΐδαο	-u u -u u- uu -uu -uu--	dactylic hexameter	masculine penthemimeral
Ἀτρεΐδης, εἰ μή οἱ ἀγάσσατο Φοῖβος Ἀπόλλων,	-uu- - - u u-uu -u u--	dactylic hexameter	masculine penthemimeral, trithemimeral
ὅς ῥά οἱ Ἕκτορ’ ἐπῶρσε θοῷ ἀτάλαντον Ἄρηϊ	- u u -u u-u u- uu-u u--	dactylic hexameter	feminine penthemimeral, hepthemimeral
ἀνέρι εἰσάμενος Κικόνων ἡγήτορι Μέντῃ·	-uu -uu- uu- --uu --	dactylic hexameter	masculine penthemimeral, hepthemimeral
καί μιν φωνήσας ἔπεα πτερόεντα προσηύδα·	- - --- uu- uu-u u--	dactylic hexameter	masculine penthemimeral, hepthemimeral
Ἕκτορ νῦν σὺ μὲν ὧδε θέεις ἀκίχητα διώκων	-- - u u -u u- uu-u u--	dactylic hexameter	feminine penthemimeral, hepthemimeral, trithemimeral
ἵππους Αἰακίδαο δαΐφρονος· οἳ δ’ἀλεγεινοὶ	-- -uu-u u-uu - uu--	dactylic hexameter	feminine penthemimeral
ἀνδράσι γε θνητοῖσι δαμήμεναι ἠδ’ ὀχέεσθαι	-uu - --u u-uu - uu--	dactylic hexameter	feminine penthemimeral, trithemimeral
ἄλλῳ γ’ἢ Ἀχιλῆϊ, τὸν ἀθανάτη τέκε μήτηρ.	-- - uu-u u -uu- uu --	dactylic hexameter	feminine penthemimeral, trithemimeral
τόφρα δέ τοι Μενέλαος ἀρήϊος Ἀτρέος υἱὸς	-u u - uu-u u-uu -uu --	dactylic hexameter	feminine penthemimeral, trithemimeral
Πατρόκλῳ περιβὰς Τρώων τὸν ἄριστον ἔπεφνε	--- uu- -- u u-u u--	dactylic hexameter	masculine penthemimeral, hepthemimeral, trithemimeral
Πανθοΐδην Εὔφορβον, ἔπαυσε δὲ θούριδος ἀλκῆς.	-uu- --u u-u u -uu --	dactylic hexameter	feminine penthemimeral, trithemimeral
ὣς εἰπὼν ὃ μὲν αὖτις ἔβη θεὸς ἂμ πόνον ἀνδρῶν,	- -- u u -u u- uu - uu --	dactylic hexameter	feminine penthemimeral, hepthemimeral, trithemimeral
Ἕκτορα δ’αἰνὸν ἄχος πύκασε φρένας ἀμφὶ μελαίνας·	-uu -u u- uu- uu -u u--	dactylic hexameter	masculine penthemimeral, hepthemimeral
πάπτηνεν δ’ἄρ’ ἔπειτα κατὰ στίχας, αὐτίκα δ’ἔγνω	--- u u-u u- uu -uu --	dactylic hexameter	feminine penthemimeral, hepthemimeral, trithemimeral
τὸν μὲν ἀπαινύμενον κλυτὰ τεύχεα, τὸν δ’ἐπὶ γαίῃ	- u u-uu- uu -uu - uu --	dactylic hexameter	masculine penthemimeral
κείμενον· ἔρρει δ’αἷμα κατ’ οὐταμένην ὠτειλήν.	-uu -- -u u -uu- ---	dactylic hexameter	feminine penthemimeral
βῆ δὲ διὰ προμάχων κεκορυθμένος αἴθοπι χαλκῷ	- u u- uu- uu-uu -uu --	dactylic hexameter	masculine penthemimeral, trithemimeral
ὀξέα κεκλήγων φλογὶ εἴκελος Ἡφαίστοιο	-uu --- uu -uu ----	dactylic hexameter	masculine penthemimeral
ἀσβέστῳ· οὐδ’ υἱὸν λάθεν Ἀτρέος ὀξὺ βοήσας·	--- u -- uu -uu -u u--	lyric	
ὀχθήσας δ’ἄρα εἶπε πρὸς ὃν μεγαλήτορα θυμόν·	--- uu -u u - uu-uu --	dactylic hexameter	feminine penthemimeral, hepthemimeral, trithemimeral
ὤ μοι ἐγὼν εἰ μέν κε λίπω κάτα τεύχεα καλὰ	- u u- - - u u- uu -uu --	dactylic hexameter	masculine penthemimeral, hepthemimeral, trithemimeral
Πάτροκλόν θ’,ὃς κεῖται ἐμῆς ἕνεκ’ ἐνθάδε τιμῆς,	--- - -u u- uu -uu --	dactylic hexameter	feminine penthemimeral, hepthemimeral, trithemimeral
μή τίς μοι Δαναῶν νεμεσήσεται ὅς κεν ἴδηται.	- - - uu- uu-uu - u u--	dactylic hexameter	masculine penthemimeral, trithemimeral
εἰ δέ κεν Ἕκτορι μοῦνος ἐὼν καὶ Τρωσὶ μάχωμαι	- u u -uu -u u- - -u u--	dactylic hexameter	feminine penthemimeral, hepthemimeral
αἰδεσθείς, μή πώς με περιστήωσ’ ἕνα πολλοί·	--- - - u u--- uu --	dactylic hexameter	masculine penthemimeral, trithemimeral
Τρῶας δ’ἐνθάδε πάντας ἄγει κορυθαίολος Ἕκτωρ.	-- -uu -u u- uu-uu --	dactylic hexameter	feminine penthemimeral, hepthemimeral
ἀλλὰ τί ἤ μοι ταῦτα φίλος διελέξατο θυμός;	-u u - - -u u- uu-uu --	dactylic hexameter	feminine penthemimeral, hepthemimeral, trithemimeral
ὁππότ’ ἀνὴρ ἐθέλῃ πρὸς δαίμονα φωτὶ μάχεσθαι	-u u- uu- - -uu -u u--	dactylic hexameter	masculine penthemimeral, trithemimeral
ὅν κε θεὸς τιμᾷ, τάχα οἱ μέγα πῆμα κυλίσθη.	- u u- -- uu - uu -u u--	dactylic hexameter	masculine penthemimeral, hepthemimeral, trithemimeral
τώ μ’οὔ τις Δαναῶν νεμεσήσεται ὅς κεν ἴδηται	- - - uu- uu-uu - u u--	dactylic hexameter	masculine penthemimeral, trithemimeral
Ἕκτορι χωρήσαντ’, ἐπεὶ ἐκ θεόφιν πολεμίζει.	-uu --- uu - uu- uu--	dactylic hexameter	masculine penthemimeral, hepthemimeral
εἰ δέ που Αἴαντός γε βοὴν ἀγαθοῖο πυθοίμην,	- u u --- u u- uu-u u--	dactylic hexameter	masculine penthemimeral, hepthemimeral
ἄμφω κ’αὖτις ἰόντες ἐπιμνησαίμεθα χάρμης	-- -u u-u u---uu --	dactylic hexameter	feminine penthemimeral
καὶ πρὸς δαίμονά περ, εἴ πως ἐρυσαίμεθα νεκρὸν	- - -uu - - - uu-uu --	dactylic hexameter	masculine penthemimeral, hepthemimeral
Πηλεΐδῃ Ἀχιλῆϊ· κακῶν δέ κε φέρτατον εἴη.	-uu- uu-u u- u u -uu --	dactylic hexameter	feminine penthemimeral, hepthemimeral, trithemimeral
εἷος ὁ ταῦθ’ ὅρμαινε κατὰ φρένα καὶ κατὰ θυμὸν	-u u - --u u- uu - uu --	dactylic hexameter	feminine penthemimeral, hepthemimeral, trithemimeral
τόφρα δ’ἐπὶ Τρώων στίχες ἤλυθον· ἦρχε δ’ἄρ’ Ἕκτωρ.	-u u- -- uu -uu -u u --	dactylic hexameter	masculine penthemimeral, trithemimeral
αὐτὰρ ὅ γ’ἐξοπίσω ἀνεχάζετο, λεῖπε δὲ νεκρὸν	-u u -uu- uu-uu -u u --	dactylic hexameter	masculine penthemimeral
ἐντροπαλιζόμενος ὥς τε λὶς ἠϋγένειος,	-uu-uu- - - - -uu--	dactylic hexameter	masculine penthemimeral, hepthemimeral
ὅν ῥα κύνες τε καὶ ἄνδρες ἀπὸ σταθμοῖο δίωνται	- u u- u u -u u- --u u--	dactylic hexameter	feminine penthemimeral, hepthemimeral, trithemimeral
ἔγχεσι καὶ φωνῇ· τοῦ δ’ἐν φρεσὶν ἄλκιμον ἦτορ	-uu - -- - - uu -uu --	dactylic hexameter	masculine penthemimeral, hepthemimeral, trithemimeral
παχνοῦται, ἀέκων δέ τ’ἔβη ἀπὸ μεσσαύλοιο·	--- uu- u u- uu ----	dactylic hexameter	masculine penthemimeral, hepthemimeral, trithemimeral
ὣς ἀπὸ Πατρόκλοιο κίε ξανθὸς Μενέλαος.	- uu ---u u- -- uu--	dactylic hexameter	feminine penthemimeral, hepthemimeral
στῆ δὲ μεταστρεφθεὶς ἐπεὶ ἵκετο ἔθνος ἑταίρων	- u u--- uu -uu -u u--	dactylic hexameter	masculine penthemimeral
παπταίνων Αἴαντα μέγαν Τελαμώνιον υἱόν.	--- --u u- uu-uu --	dactylic hexameter	feminine penthemimeral, hepthemimeral, trithemimeral
τὸν δὲ μάλ’ αἶψ’ ἐνόησε μάχης ἐπ’ ἀριστερὰ πάσης	- u u - uu-u u- u u-uu --	dactylic hexameter	feminine penthemimeral, hepthemimeral, trithemimeral
θαρσύνονθ’ ἑτάρους καὶ ἐποτρύνοντα μάχεσθαι·	--- uu- u u---u u--	dactylic hexameter	masculine penthemimeral, trithemimeral
θεσπέσιον γάρ σφιν φόβον ἔμβαλε Φοῖβος Ἀπόλλων·	-uu- - - uu -uu -u u--	dactylic hexameter	masculine penthemimeral, trithemimeral
βῆ δὲ θέειν, εἶθαρ δὲ παριστάμενος ἔπος ηὔδα.	- u u- -- u u-uu- uu --	dactylic hexameter	masculine penthemimeral, trithemimeral
Αἶαν δεῦρο πέπον, περὶ Πατρόκλοιο θανόντος	-- -u u- uu ---u u--	dactylic hexameter	masculine penthemimeral
σπεύσομεν, αἴ κε νέκυν περ Ἀχιλλῆϊ προφέρωμεν	-uu - u u- u u--- uu--	dactylic hexameter	masculine penthemimeral, trithemimeral
γυμνόν· ἀτὰρ τά γε τεύχε’ ἔχει κορυθαίολος Ἕκτωρ.	-u u- u u -u u- uu-uu --	dactylic hexameter	feminine penthemimeral, hepthemimeral, trithemimeral
ὣς ἔφατ’, Αἴαντι δὲ δαΐφρονι θυμὸν ὄρινε·	- uu --- u u-uu -u u--	dactylic hexameter	masculine penthemimeral
βῆ δὲ διὰ προμάχων, ἅμα δὲ ξανθὸς Μενέλαος.	- u u- uu- uu - -- uu--	dactylic hexameter	masculine penthemimeral, hepthemimeral, trithemimeral
Ἕκτωρ μὲν Πάτροκλον ἐπεὶ κλυτὰ τεύχε’ ἀπηύρα,	-- - --u u- uu -u u--	dactylic hexameter	feminine penthemimeral, hepthemimeral, trithemimeral
ἕλχ’ ἵν’ ἀπ’ ὤμοιιν κεφαλὴν τάμοι ὀξέϊ χαλκῷ,	- u u --- uu- uu -uu --	dactylic hexameter	masculine penthemimeral, hepthemimeral
τὸν δὲ νέκυν Τρῳῇσιν ἐρυσσάμενος κυσὶ δοίη.	- u u- --u u-uu- uu --	dactylic hexameter	feminine penthemimeral, trithemimeral
Αἴας δ’ἐγγύθεν ἦλθε φέρων σάκος ἠΰτε πύργον·	-- -uu -u u- uu -uu --	dactylic hexameter	feminine penthemimeral, hepthemimeral
Ἕκτωρ δ’ἂψ ἐς ὅμιλον ἰὼν ἀνεχάζεθ’ ἑταίρων,	-- - u u-u u- uu-u u--	dactylic hexameter	feminine penthemimeral, hepthemimeral, trithemimeral
ἐς δίφρον δ’ἀνόρουσε· δίδου δ’ὅ γε τεύχεα καλὰ	- -- uu-u u- u u -uu --	dactylic hexameter	feminine penthemimeral, hepthemimeral, trithemimeral
Τρωσὶ φέρειν προτὶ ἄστυ, μέγα κλέος ἔμμεναι αὐτῷ.	-u u- uu -u u- uu -uu --	dactylic hexameter	feminine penthemimeral, hepthemimeral, trithemimeral
Αἴας δ’ἀμφὶ Μενοιτιάδῃ σάκος εὐρὺ καλύψας	-- -u u-uu- uu -u u--	dactylic hexameter	hepthemimeral
ἑστήκει ὥς τίς τε λέων περὶ οἷσι τέκεσσιν,	--- - - u u- uu -u u--	dactylic hexameter	masculine penthemimeral, hepthemimeral, trithemimeral
ᾧ ῥά τε νήπι’ ἄγοντι συναντήσωνται ἐν ὕλῃ	- u u -u u-u u---u u --	dactylic hexameter	feminine penthemimeral
ἄνδρες ἐπακτῆρες· ὃ δέ τε σθένεϊ βλεμεαίνει,	-u u--- u u - uu- uu--	dactylic hexameter	masculine penthemimeral, hepthemimeral
πᾶν δέ τ’ἐπισκύνιον κάτω ἕλκεται ὄσσε καλύπτων·	- u u-uu- uu -uu -u u--	dactylic hexameter	masculine penthemimeral
ὣς Αἴας περὶ Πατρόκλῳ ἥρωϊ βεβήκει.	- -- uu --- --u u--	dactylic hexameter	hepthemimeral, trithemimeral
Ἀτρεΐδης δ’ἑτέρωθεν ἀρηΐφιλος Μενέλαος	-uu- uu-u u-uu- uu--	dactylic hexameter	feminine penthemimeral, trithemimeral
ἑστήκει, μέγα πένθος ἐνὶ στήθεσσιν ἀέξων.	--- uu -u u- --u u--	dactylic hexameter	feminine penthemimeral, hepthemimeral, trithemimeral
Γλαῦκος δ’Ἱππολόχοιο πάϊς Λυκίων ἀγὸς ἀνδρῶν	-- -uu-u u- uu- uu --	dactylic hexameter	feminine penthemimeral, hepthemimeral
Ἕκτορ’ ὑπόδρα ἰδὼν χαλεπῷ ἠνίπαπε μύθῳ·	-u u-u u- uu- --uu --	dactylic hexameter	masculine penthemimeral, hepthemimeral
Ἕκτορ εἶδος ἄριστε μάχης ἄρα πολλὸν ἐδεύεο.	-- -u u-u u- uu -u u--	dactylic hexameter	feminine penthemimeral, hepthemimeral
ἦ σ’αὔτως κλέος ἐσθλὸν ἔχει φύξηλιν ἐόντα.	- -- uu -u u- --u u--	dactylic hexameter	feminine penthemimeral, hepthemimeral, trithemimeral
φράζεο νῦν ὅππως κε πόλιν καὶ ἄστυ σαώσῃς	-uu - -- u u- - -u u--	dactylic hexameter	masculine penthemimeral, hepthemimeral, trithemimeral
οἶος σὺν λαοῖς τοὶ Ἰλίῳ ἐγγεγάασιν·	-- - -- - -uu -uu--	dactylic hexameter	masculine penthemimeral, trithemimeral
οὐ γάρ τις Λυκίων γε μαχησόμενος Δαναοῖσιν	- - - uu- u u-uu- uu--	dactylic hexameter	masculine penthemimeral, trithemimeral
εἶσι περὶ πτόλιος, ἐπεὶ οὐκ ἄρα τις χάρις ἦεν	-u u- uu- uu - uu - uu --	dactylic hexameter	masculine penthemimeral, hepthemimeral, trithemimeral
μάρνασθαι δηίοισιν ἐπ’ ἀνδράσι νωλεμὲς αἰεί.	--- --u u -uu -uu --	dactylic hexameter	feminine penthemimeral, trithemimeral
πῶς κε σὺ χείρονα φῶτα σαώσειας μεθ’ ὅμιλον	- u u -uu -u u--- u u--	dactylic hexameter	feminine penthemimeral
σχέτλι’, ἐπεὶ Σαρπηδόν’ ἅμα ξεῖνον καὶ ἑταῖρον	-u u- --u u- -- u u--	dactylic hexameter	feminine penthemimeral, hepthemimeral, trithemimeral
κάλλιπες Ἀργείοισιν ἕλωρ καὶ κύρμα γενέσθαι,	-uu ---u u- - -u u--	dactylic hexameter	feminine penthemimeral, hepthemimeral
ὅς τοι πόλλ’ ὄφελος γένετο πτόλεΐ τε καὶ αὐτῷ	- - - uu- uu- uu- u u --	dactylic hexameter	masculine penthemimeral, hepthemimeral, trithemimeral
ζωὸς ἐών· νῦν δ’οὔ οἱ ἀλαλκέμεναι κύνας ἔτλης.	-u u- - - u u-uu- uu --	dactylic hexameter	masculine penthemimeral, trithemimeral
τὼ νῦν εἴ τις ἐμοὶ Λυκίων ἐπιπείσεται ἀνδρῶν	- - - u u- uu- uu-uu --	dactylic hexameter	masculine penthemimeral, hepthemimeral, trithemimeral
οἴκαδ’ ἴμεν, Τροίῃ δὲ πεφήσεται αἰπὺς ὄλεθρος.	-u u- -- u u-uu -u u--	dactylic hexameter	masculine penthemimeral, trithemimeral
εἰ γὰρ νῦν Τρώεσσι μένος πολυθαρσὲς ἐνείη	- - - --u u- uu-u u--	dactylic hexameter	feminine penthemimeral, hepthemimeral, trithemimeral
ἄτρομον, οἷόν τ’ἄνδρας ἐσέρχεται οἳ περὶ πάτρης	-uu -- -u u-uu - uu --	dactylic hexameter	feminine penthemimeral
ἀνδράσι δυσμενέεσσι πόνον καὶ δῆριν ἔθεντο,	-uu -uu-u u- - -u u--	dactylic hexameter	feminine penthemimeral, hepthemimeral
αἶψά κε Πάτροκλον ἐρυσαίμεθα Ἴλιον εἴσω.	-u u --- uu-uu -uu --	dactylic hexameter	masculine penthemimeral
εἰ δ’οὗτος προτὶ ἄστυ μέγα Πριάμοιο ἄνακτος	- -- uu -u u- uu-u u--	dactylic hexameter	feminine penthemimeral, hepthemimeral, trithemimeral
ἔλθοι τεθνηὼς καί μιν ἐρυσαίμεθα χάρμης,	-- --- - - uu-uu --	dactylic hexameter	masculine penthemimeral, hepthemimeral
αἶψά κεν Ἀργεῖοι Σαρπηδόνος ἔντεα καλὰ	-u u --- --uu -uu --	dactylic hexameter	masculine penthemimeral
λύσειαν, καί κ’αὐτὸν ἀγοίμεθα Ἴλιον εἴσω·	--- - -u u-uu -uu --	dactylic hexameter	feminine penthemimeral, trithemimeral
τοίου γὰρ θεράπων πέφατ’ ἀνέρος, ὃς μέγ’ ἄριστος	-- - uu- uu -uu - u u--	dactylic hexameter	masculine penthemimeral, trithemimeral
Ἀργείων παρὰ νηυσὶ καὶ ἀγχέμαχοι θεράποντες.	--- uu -u u -uu- uu--	dactylic hexameter	feminine penthemimeral, trithemimeral
ἀλλὰ σύ γ’Αἴαντος μεγαλήτορος οὐκ ἐτάλασσας	-u u --- uu-uu - uu--	dactylic hexameter	masculine penthemimeral
στήμεναι ἄντα κατ’ ὄσσε ἰδὼν δηίων ἐν ἀϋτῇ,	-uu -u u -u u- -- u u--	dactylic hexameter	feminine penthemimeral, hepthemimeral
οὐδ’ ἰθὺς μαχέσασθαι, ἐπεὶ σέο φέρτερός ἐστι.	- -- uu-u u- uu -uu --	dactylic hexameter	feminine penthemimeral, hepthemimeral, trithemimeral
τὸν δ’ἄρ’ ὑπόδρα ἰδὼν προσέφη κορυθαίολος Ἕκτωρ·	- u u-u u- uu- uu-uu --	dactylic hexameter	masculine penthemimeral, hepthemimeral
Γλαῦκε τί ἢ δὲ σὺ τοῖος ἐὼν ὑπέροπλον ἔειπες;	-u u - u u -u u- uu-u u--	dactylic hexameter	feminine penthemimeral, hepthemimeral, trithemimeral
ὢ πόποι ἦ τ’ἐφάμην σὲ περὶ φρένας ἔμμεναι ἄλλων	- uu - uu- u u- uu -uu --	dactylic hexameter	masculine penthemimeral, hepthemimeral, trithemimeral
τῶν ὅσσοι Λυκίην ἐριβώλακα ναιετάουσι·	- -- uu- uu-uu -uu--	dactylic hexameter	masculine penthemimeral, trithemimeral
νῦν δέ σευ ὠνοσάμην πάγχυ φρένας οἷον ἔειπες,	- u u -uu- -- uu -u u--	dactylic hexameter	masculine penthemimeral, hepthemimeral
ὅς τέ με φῂς Αἴαντα πελώριον οὐχ ὑπομεῖναι.	- u u - --u u-uu - uu--	dactylic hexameter	feminine penthemimeral, trithemimeral
οὔ τοι ἐγὼν ἔρριγα μάχην οὐδὲ κτύπον ἵππων·	- u u- --u u- -- uu --	dactylic hexameter	feminine penthemimeral, hepthemimeral, trithemimeral
ἀλλ’ αἰεί τε Διὸς κρείσσων νόος αἰγιόχοιο,	- -- u u- -- uu -uu--	dactylic hexameter	masculine penthemimeral, hepthemimeral, trithemimeral
ὅς τε καὶ ἄλκιμον ἄνδρα φοβεῖ καὶ ἀφείλετο νίκην	- u u -uu -u u- u u-uu --	dactylic hexameter	feminine penthemimeral, hepthemimeral
ῥηϊδίως, ὁτὲ δ’αὐτὸς ἐποτρύνει μαχέσασθαι.	-uu- uu -u u--- uu--	dactylic hexameter	feminine penthemimeral, trithemimeral
ἀλλ’ ἄγε δεῦρο πέπον, παρ’ ἔμ’ ἵστασο καὶ ἴδε ἔργον,	- uu -u u- u u -uu - uu --	dactylic hexameter	masculine penthemimeral
ἠὲ πανημέριος κακὸς ἔσσομαι, ὡς ἀγορεύεις,	-u u-uu- uu -uu - uu--	dactylic hexameter	masculine penthemimeral
ἦ τινα καὶ Δαναῶν ἀλκῆς μάλα περ μεμαῶτα	- uu - uu- -- uu - uu--	dactylic hexameter	masculine penthemimeral, hepthemimeral, trithemimeral
σχήσω ἀμυνέμεναι περὶ Πατρόκλοιο θανόντος.	-u u-uu- uu ---u u--	dactylic hexameter	masculine penthemimeral
ὣς εἰπὼν Τρώεσσιν ἐκέκλετο μακρὸν ἀΰσας·	- -- --u u-uu -u u--	dactylic hexameter	feminine penthemimeral, trithemimeral
Τρῶες καὶ Λύκιοι καὶ Δάρδανοι ἀγχιμαχηταί,	-- - uu- - -uu -uu--	dactylic hexameter	masculine penthemimeral, trithemimeral
ἀνέρες ἔστε φίλοι, μνήσασθε δὲ θούριδος ἀλκῆς,	-uu -u u- --u u -uu --	dactylic hexameter	masculine penthemimeral
ὄφρ’ ἂν ἐγὼν Ἀχιλῆος ἀμύμονος ἔντεα δύω	- u u- uu-u u-uu -uu --	dactylic hexameter	feminine penthemimeral, trithemimeral
καλά, τὰ Πατρόκλοιο βίην ἐνάριξα κατακτάς.	-u u ---u u- uu-u u--	dactylic hexameter	feminine penthemimeral, hepthemimeral
ὣς ἄρα φωνήσας ἀπέβη κορυθαίολος Ἕκτωρ	- uu --- uu- uu-uu --	dactylic hexameter	masculine penthemimeral, hepthemimeral
δηΐου ἐκ πολέμοιο· θέων δ’ἐκίχανεν ἑταίρους	-uu - uu-u u- uu-u u--	dactylic hexameter	feminine penthemimeral, hepthemimeral, trithemimeral
ὦκα μάλ’ οὔ πω τῆλε ποσὶ κραιπνοῖσι μετασπών,	-u u - - -u u- --u u--	dactylic hexameter	feminine penthemimeral, hepthemimeral, trithemimeral
οἳ προτὶ ἄστυ φέρον κλυτὰ τεύχεα Πηλεΐωνος.	- uu -u u- uu -uu -uu--	dactylic hexameter	masculine penthemimeral
στὰς δ’ἀπάνευθε μάχης πολυδακρύου ἔντε’ ἄμειβεν·	- uu-u u- uu-uu -u u--	dactylic hexameter	masculine penthemimeral
ἤτοι ὃ μὲν τὰ ἃ δῶκε φέρειν προτὶ Ἴλιον ἱρὴν	-u u - u u -u u- uu -uu --	dactylic hexameter	feminine penthemimeral, hepthemimeral, trithemimeral
Τρωσὶ φιλοπτολέμοισιν, ὃ δ’ἄμβροτα τεύχεα δῦνε	-u u-uu-u u -uu -uu --	dactylic hexameter	feminine penthemimeral
Πηλεΐδεω Ἀχιλῆος ἅ οἱ θεοὶ Οὐρανίωνες	-uu- uu-u u - uu -uu--	dactylic hexameter	feminine penthemimeral, hepthemimeral, trithemimeral
πατρὶ φίλῳ ἔπορον· ὃ δ’ἄρα ᾧ παιδὶ ὄπασσε	-u u- uu- u u- - -u u--	dactylic hexameter	masculine penthemimeral, hepthemimeral, trithemimeral
γηράς· ἀλλ’ οὐχ υἱὸς ἐν ἔντεσι πατρὸς ἐγήρα.	-- - - -u u -uu -u u--	dactylic hexameter	feminine penthemimeral, trithemimeral
τὸν δ’ὡς οὖν ἀπάνευθεν ἴδεν νεφεληγερέτα Ζεὺς	- - - uu-u u- uu-uu- -	dactylic hexameter	feminine penthemimeral, hepthemimeral, trithemimeral
τεύχεσι Πηλεΐδαο κορυσσόμενον θείοιο,	-uu -uu-u u-uu- ---	dactylic hexameter	feminine penthemimeral
κινήσας ῥα κάρη προτὶ ὃν μυθήσατο θυμόν·	--- u u- uu - --uu --	dactylic hexameter	masculine penthemimeral, hepthemimeral, trithemimeral
ἆ δείλ’ οὐδέ τί τοι θάνατος καταθύμιός ἐστιν	- - -u u - uu- uu-uu --	dactylic hexameter	masculine penthemimeral, hepthemimeral
ὃς δή τοι σχεδὸν εἶσι· σὺ δ’ἄμβροτα τεύχεα δύνεις	- - - uu -u u -uu -uu --	dactylic hexameter	feminine penthemimeral, trithemimeral
ἀνδρὸς ἀριστῆος, τόν τε τρομέουσι καὶ ἄλλοι·	-u u--- - - uu-u u --	dactylic hexameter	masculine penthemimeral, hepthemimeral
τοῦ δὴ ἑταῖρον ἔπεφνες ἐνηέα τε κρατερόν τε,	- u u-u u-u u-uu - uu- -	dactylic hexameter	feminine penthemimeral
τεύχεα δ’οὐ κατὰ κόσμον ἀπὸ κρατός τε καὶ ὤμων	-uu - uu -u u- -- u u --	dactylic hexameter	feminine penthemimeral, hepthemimeral, trithemimeral
εἵλευ· ἀτάρ τοι νῦν γε μέγα κράτος ἐγγυαλίξω,	-u u- - - u u- uu -uu--	dactylic hexameter	masculine penthemimeral, hepthemimeral, trithemimeral
τῶν ποινὴν ὅ τοι οὔ τι μάχης ἐκνοστήσαντι	- -- u u - u u- -----	dactylic hexameter	masculine penthemimeral, hepthemimeral, trithemimeral
δέξεται Ἀνδρομάχη κλυτὰ τεύχεα Πηλεΐωνος.	-uu -uu- uu -uu -uu--	dactylic hexameter	masculine penthemimeral
ἦ καὶ κυανέῃσιν ἐπ’ ὀφρύσι νεῦσε Κρονίων.	- - -uu-u u -uu -u u--	dactylic hexameter	feminine penthemimeral
Ἕκτορι δ’ἥρμοσε τεύχε’ ἐπὶ χροΐ, δῦ δέ μιν Ἄρης	-uu -uu -u u- uu - u u --	dactylic hexameter	feminine penthemimeral, hepthemimeral
δεινὸς ἐνυάλιος, πλῆσθεν δ’ἄρα οἱ μέλε’ ἐντὸς	-u u-uu- -- uu - uu --	dactylic hexameter	masculine penthemimeral, hepthemimeral
ἀλκῆς καὶ σθένεος· μετὰ δὲ κλειτοὺς ἐπικούρους	-- - uu- uu - -- uu--	dactylic hexameter	masculine penthemimeral, hepthemimeral, trithemimeral
βῆ ῥα μέγα ἰάχων· ἰνδάλλετο δέ σφισι πᾶσι	- u u- uu- --uu - uu --	dactylic hexameter	masculine penthemimeral, trithemimeral
τεύχεσι λαμπόμενος μεγαθύμου Πηλεΐωνος.	-uu -uu- uu-- -uu--	dactylic hexameter	masculine penthemimeral
ὄτρυνεν δὲ ἕκαστον ἐποιχόμενος ἐπέεσσι	--- u u-u u-uu- uu--	dactylic hexameter	feminine penthemimeral, trithemimeral
Μέσθλην τε Γλαῦκόν τε Μέδοντά τε Θερσίλοχόν τε	-- - -- u u-u u -uu- -	dactylic hexameter	masculine penthemimeral, trithemimeral
Ἀστεροπαῖόν τε Δεισήνορά θ’Ἱππόθοόν τε	-uu-- - --uu -uu- -	dactylic hexameter	masculine penthemimeral
Φόρκυν τε Χρομίον τε καὶ Ἔννομον οἰωνιστήν·	-- - uu- u u -uu ----	dactylic hexameter	masculine penthemimeral, trithemimeral
τοὺς ὅ γ’ἐποτρύνων ἔπεα πτερόεντα προσηύδα·	- u u--- uu- uu-u u--	dactylic hexameter	masculine penthemimeral, hepthemimeral
κέκλυτε μυρία φῦλα περικτιόνων ἐπικούρων·	-uu -uu -u u-uu- uu--	dactylic hexameter	feminine penthemimeral
οὐ γὰρ ἐγὼ πληθὺν διζήμενος οὐδὲ χατίζων	- u u- -- --uu -u u--	dactylic hexameter	masculine penthemimeral, trithemimeral
ἐνθάδ’ ἀφ’ ὑμετέρων πολίων ἤγειρα ἕκαστον,	-u u -uu- uu- --u u--	dactylic hexameter	masculine penthemimeral, hepthemimeral
ἀλλ’ ἵνα μοι Τρώων ἀλόχους καὶ νήπια τέκνα	- uu - -- uu- - -uu --	dactylic hexameter	masculine penthemimeral, hepthemimeral, trithemimeral
προφρονέως ῥύοισθε φιλοπτολέμων ὑπ’ Ἀχαιῶν.	-uu- --u u-uu- u u--	dactylic hexameter	feminine penthemimeral, trithemimeral
τὰ φρονέων δώροισι κατατρύχω καὶ ἐδωδῇ	- uu- --u u--- u u--	dactylic hexameter	feminine penthemimeral, trithemimeral
λαούς, ὑμέτερον δὲ ἑκάστου θυμὸν ἀέξω.	-- -uu- u u-- -u u--	dactylic hexameter	masculine penthemimeral
τώ τις νῦν ἰθὺς τετραμμένος ἢ ἀπολέσθω	- - - -- --uu - uu--	dactylic hexameter	masculine penthemimeral, trithemimeral
ἠὲ σαωθήτω· ἣ γὰρ πολέμου ὀαριστύς.	-u u--- - - uu- uu--	dactylic hexameter	masculine penthemimeral, hepthemimeral
ὃς δέ κε Πάτροκλον καὶ τεθνηῶτά περ ἔμπης	- u u --- - ---u u --	dactylic hexameter	masculine penthemimeral
Τρῶας ἐς ἱπποδάμους ἐρύσῃ, εἴξῃ δέ οἱ Αἴας,	-u u -uu- uu- -- u u --	dactylic hexameter	masculine penthemimeral, hepthemimeral
ἥμισυ τῷ ἐνάρων ἀποδάσσομαι, ἥμισυ δ’αὐτὸς	-uu - uu- uu-uu -uu --	dactylic hexameter	masculine penthemimeral, trithemimeral
ἕξω ἐγώ· τὸ δέ οἱ κλέος ἔσσεται ὅσσον ἐμοί περ.	-u u- u u - uu -uu -u u- -	dactylic hexameter	masculine penthemimeral, trithemimeral
ὣς ἔφαθ’, οἳ δ’ἰθὺς Δαναῶν βρίσαντες ἔβησαν	- uu - -- uu- --u u--	dactylic hexameter	masculine penthemimeral, hepthemimeral, trithemimeral
δούρατ’ ἀνασχόμενοι· μάλα δέ σφισιν ἔλπετο θυμὸς	-u u-uu- uu - uu -uu --	dactylic hexameter	masculine penthemimeral, hepthemimeral
νεκρὸν ὑπ’ Αἴαντος ἐρύειν Τελαμωνιάδαο	-u u --- uu- uu-uu--	dactylic hexameter	masculine penthemimeral, hepthemimeral
νήπιοι· ἦ τε πολέσσιν ἐπ’ αὐτῷ θυμὸν ἀπηύρα.	-uu - u u-u u -- -u u--	dactylic hexameter	feminine penthemimeral, trithemimeral
καὶ τότ’ ἄρ’ Αἴας εἶπε βοὴν ἀγαθὸν Μενέλαον·	- u u -- -u u- uu- uu--	dactylic hexameter	feminine penthemimeral, hepthemimeral
ὦ πέπον ὦ Μενέλαε διοτρεφὲς οὐκέτι νῶϊ	- uu - uu-u u-uu -uu --	dactylic hexameter	feminine penthemimeral, trithemimeral
ἔλπομαι αὐτώ περ νοστησέμεν ἐκ πολέμοιο.	-uu -- - --uu - uu--	dactylic hexameter	masculine penthemimeral
οὔ τι τόσον νέκυος περιδείδια Πατρόκλοιο,	- u u- uu- uu-uu ----	dactylic hexameter	masculine penthemimeral, trithemimeral
ὅς κε τάχα Τρώων κορέει κύνας ἠδ’ οἰωνούς,	- u u- -- uu- uu - ---	dactylic hexameter	masculine penthemimeral, hepthemimeral, trithemimeral
ὅσσον ἐμῇ κεφαλῇ περιδείδια μή τι πάθῃσι,	-u u- uu- uu-uu - u u--	dactylic hexameter	masculine penthemimeral, trithemimeral
καὶ σῇ, ἐπεὶ πολέμοιο νέφος περὶ πάντα καλύπτει	- u u- uu-u u- uu -u u--	dactylic hexameter	feminine penthemimeral, hepthemimeral, trithemimeral
Ἕκτωρ, ἡμῖν δ’αὖτ’ ἀναφαίνεται αἰπὺς ὄλεθρος.	-- -- - uu-uu -u u--	dactylic hexameter	masculine penthemimeral
ἀλλ’ ἄγ’ ἀριστῆας Δαναῶν κάλει, ἤν τις ἀκούσῃ.	- u u--- uu- uu - u u--	dactylic hexameter	masculine penthemimeral, hepthemimeral
ὣς ἔφατ’, οὐδ’ ἀπίθησε βοὴν ἀγαθὸς Μενέλαος,	- uu - uu-u u- uu- uu--	dactylic hexameter	feminine penthemimeral, hepthemimeral, trithemimeral
ἤϋσεν δὲ διαπρύσιον Δαναοῖσι γεγωνώς·	--- u u-uu- uu-u u--	dactylic hexameter	hepthemimeral, trithemimeral
ὦ φίλοι Ἀργείων ἡγήτορες ἠδὲ μέδοντες	- uu --- --uu -u u--	dactylic hexameter	masculine penthemimeral
οἵ τε παρ’ Ἀτρεΐδῃς Ἀγαμέμνονι καὶ Μενελάῳ	- u u -uu- uu-uu - uu--	dactylic hexameter	masculine penthemimeral
δήμια πίνουσιν καὶ σημαίνουσιν ἕκαστος	-uu --- - ---u u--	dactylic hexameter	masculine penthemimeral
λαοῖς· ἐκ δὲ Διὸς τιμὴ καὶ κῦδος ὀπηδεῖ.	-- - u u- -- - -u u--	dactylic hexameter	masculine penthemimeral, hepthemimeral, trithemimeral
ἀργαλέον δέ μοί ἐστι διασκοπιᾶσθαι ἕκαστον	-uu- u u -u u-uu-u u--	dactylic hexameter	feminine penthemimeral, trithemimeral
ἡγεμόνων· τόσση γὰρ ἔρις πολέμοιο δέδηεν·	-uu- -- u u- uu-u u--	dactylic hexameter	masculine penthemimeral, hepthemimeral, trithemimeral
ἀλλά τις αὐτὸς ἴτω, νεμεσιζέσθω δ’ἐνὶ θυμῷ	-u u -u u- uu--- uu --	dactylic hexameter	masculine penthemimeral
Πάτροκλον Τρῳῇσι κυσὶν μέλπηθρα γενέσθαι.	--- --u u- --u u--	dactylic hexameter	feminine penthemimeral, hepthemimeral, trithemimeral
ὣς ἔφατ’, ὀξὺ δ’ἄκουσεν Ὀϊλῆος ταχὺς Αἴας·	- uu -u u-u u--- uu --	dactylic hexameter	feminine penthemimeral
πρῶτος δ’ἀντίος ἦλθε θέων ἀνὰ δηϊοτῆτα,	-- -uu -u u- uu -uu--	dactylic hexameter	feminine penthemimeral, hepthemimeral
τὸν δὲ μετ’ Ἰδομενεὺς καὶ ὀπάων Ἰδομενῆος	- u u -uu- u u-- -uu--	dactylic hexameter	masculine penthemimeral
Μηριόνης ἀτάλαντος Ἐνυαλίῳ ἀνδρειφόντῃ.	-uu- uu-u u-uu ----	dactylic hexameter	feminine penthemimeral, trithemimeral
τῶν δ’ἄλλων τίς κεν ᾗσι φρεσὶν οὐνόματ’ εἴποι,	- -- - - -- uu -uu --	dactylic hexameter	masculine penthemimeral, hepthemimeral, trithemimeral
ὅσσοι δὴ μετόπισθε μάχην ἤγειραν Ἀχαιῶν;	-- - uu-u u- --u u--	dactylic hexameter	feminine penthemimeral, hepthemimeral, trithemimeral
Τρῶες δὲ προὔτυψαν ἀολλέες· ἦρχε δ’ἄρ’ Ἕκτωρ.	-- - --u u-uu -u u --	dactylic hexameter	feminine penthemimeral, trithemimeral
ὡς δ’ὅτ’ ἐπὶ προχοῇσι διιπετέος ποταμοῖο	- u u- uu-u u-uu- uu--	dactylic hexameter	feminine penthemimeral, trithemimeral
βέβρυχεν μέγα κῦμα ποτὶ ῥόον, ἀμφὶ δέ τ’ἄκραι	--- uu -u u- uu -u u --	dactylic hexameter	feminine penthemimeral, hepthemimeral, trithemimeral
ἠϊόνες βοόωσιν ἐρευγομένης ἁλὸς ἔξω,	-uu- uu-u u-uu- uu --	dactylic hexameter	feminine penthemimeral, trithemimeral
τόσσῃ ἄρα Τρῶες ἰαχῇ ἴσαν. αὐτὰρ Ἀχαιοὶ	-u u- -- uu- uu -u u--	dactylic hexameter	masculine penthemimeral, hepthemimeral, trithemimeral
ἕστασαν ἀμφὶ Μενοιτιάδῃ ἕνα θυμὸν ἔχοντες	-uu -u u-uu- uu -u u--	dactylic hexameter	hepthemimeral
φραχθέντες σάκεσιν χαλκήρεσιν· ἀμφὶ δ’ἄρά σφι	--- uu- --uu -u u- -	dactylic hexameter	masculine penthemimeral, trithemimeral
λαμπρῇσιν κορύθεσσι Κρονίων ἠέρα πολλὴν	--- uu-u u-- -uu --	dactylic hexameter	feminine penthemimeral, trithemimeral
χεῦ’, ἐπεὶ οὐδὲ Μενοιτιάδην ἔχθαιρε πάρος γε,	- uu -u u-uu- --u u- -	dactylic hexameter	hepthemimeral
ὄφρα ζωὸς ἐὼν θεράπων ἦν Αἰακίδαο·	-- -u u- uu- - -uu--	dactylic hexameter	masculine penthemimeral, hepthemimeral
μίσησεν δ’ἄρα μιν δηίων κυσὶ κύρμα γενέσθαι	--- uu - -- uu -u u--	dactylic hexameter	masculine penthemimeral, hepthemimeral, trithemimeral
Τρῳῇσιν· τὼ καί οἱ ἀμυνέμεν ὦρσεν ἑταίρους.	--- - - u u-uu -u u--	dactylic hexameter	masculine penthemimeral, trithemimeral
ὦσαν δὲ πρότεροι Τρῶες ἑλίκωπας Ἀχαιούς·	-- - uu- -- uu-u u--	dactylic hexameter	masculine penthemimeral, hepthemimeral, trithemimeral
νεκρὸν δὲ προλιπόντες ὑπέτρεσαν, οὐδέ τιν’ αὐτῶν	-- - uu-u u-uu -u u --	dactylic hexameter	feminine penthemimeral, trithemimeral
Τρῶες ὑπέρθυμοι ἕλον ἔγχεσιν ἱέμενοί περ,	-u u--- uu -uu -uu- -	dactylic hexameter	masculine penthemimeral
ἀλλὰ νέκυν ἐρύοντο· μίνυνθα δὲ καὶ τοῦ Ἀχαιοὶ	-u u- uu-u u-u u - u u--	dactylic hexameter	feminine penthemimeral, trithemimeral
μέλλον ἀπέσσεσθαι· μάλα γάρ σφεας ὦκ’ ἐλέλιξεν	-u u--- uu - - - uu--	dactylic hexameter	masculine penthemimeral, hepthemimeral
Αἴας, ὃς περὶ μὲν εἶδος, περὶ δ’ἔργα τέτυκτο	-- - uu - -- uu -u u--	dactylic hexameter	masculine penthemimeral, hepthemimeral, trithemimeral
τῶν ἄλλων Δαναῶν μετ’ ἀμύμονα Πηλεΐωνα.	- -- uu- u u-uu -uu--	dactylic hexameter	masculine penthemimeral, trithemimeral
ἴθυσεν δὲ διὰ προμάχων συῒ εἴκελος ἀλκὴν	--- u u- uu- uu -uu --	dactylic hexameter	masculine penthemimeral, hepthemimeral, trithemimeral
καπρίῳ, ὅς τ’ἐν ὄρεσσι κύνας θαλερούς τ’αἰζηοὺς	-uu - u u-u u- uu- ---	dactylic hexameter	feminine penthemimeral, hepthemimeral, trithemimeral
ῥηϊδίως ἐκέδασσεν, ἑλιξάμενος διὰ βήσσας·	-uu- uu-u u-uu- uu --	dactylic hexameter	feminine penthemimeral, trithemimeral
ὣς υἱὸς Τελαμῶνος ἀγαυοῦ φαίδιμος Αἴας	- -- uu-u u-- -uu --	dactylic hexameter	feminine penthemimeral, trithemimeral
ῥεῖα μετεισάμενος Τρώων ἐκέδασσε φάλαγγας	-u u-uu- -- uu-u u--	dactylic hexameter	masculine penthemimeral, hepthemimeral
οἳ περὶ Πατρόκλῳ βέβασαν, φρόνεον δὲ μάλιστα	- uu --- uu- uu- u u--	dactylic hexameter	masculine penthemimeral, hepthemimeral
ἄστυ πότι σφέτερον ἐρύειν καὶ κῦδος ἀρέσθαι.	-u u- uu- uu- - -u u--	dactylic hexameter	masculine penthemimeral, hepthemimeral, trithemimeral
ἤτοι τὸν Λήθοιο Πελασγοῦ φαίδιμος υἱὸς	-- - --u u-- -uu --	dactylic hexameter	feminine penthemimeral, trithemimeral
Ἱππόθοος ποδὸς ἕλκε κατὰ κρατερὴν ὑσμίνην	-uu- uu -u u- uu- ---	dactylic hexameter	feminine penthemimeral, hepthemimeral, trithemimeral
δησάμενος τελαμῶνι παρὰ σφυρὸν ἀμφὶ τένοντας	-uu- uu-u u- uu -u u--	dactylic hexameter	feminine penthemimeral, hepthemimeral, trithemimeral
Ἕκτορι καὶ Τρώεσσι χαριζόμενος· τάχα δ’αὐτῷ	-uu - --u u-uu- uu --	dactylic hexameter	feminine penthemimeral, trithemimeral
ἦλθε κακόν, τό οἱ οὔ τις ἐρύκακεν ἱεμένων περ.	-u u- u u - u u-uu -uu- -	dactylic hexameter	masculine penthemimeral, trithemimeral
τὸν δ’υἱὸς Τελαμῶνος ἐπαΐξας δι’ ὁμίλου	- -- uu-u u--- u u--	dactylic hexameter	feminine penthemimeral, trithemimeral
πλῆξ’ αὐτοσχεδίην κυνέης διὰ χαλκοπαρῄου·	- --uu- uu- uu -uu--	dactylic hexameter	masculine penthemimeral, hepthemimeral
ἤρικε δ’ἱπποδάσεια κόρυς περὶ δουρὸς ἀκωκῇ	-uu -uu-u u- uu -u u--	dactylic hexameter	feminine penthemimeral, hepthemimeral
πληγεῖσ’ ἔγχεΐ τε μεγάλῳ καὶ χειρὶ παχείῃ,	-- -uu - uu- - -u u--	dactylic hexameter	masculine penthemimeral, hepthemimeral
ἐγκέφαλος δὲ παρ’ αὐλὸν ἀνέδραμεν ἐξ ὠτειλῆς	-uu- u u -u u-uu - ---	dactylic hexameter	feminine penthemimeral, trithemimeral
αἱματόεις· τοῦ δ’αὖθι λύθη μένος, ἐκ δ’ἄρα χειρῶν	-uu- - -u u- uu - uu --	dactylic hexameter	feminine penthemimeral, hepthemimeral, trithemimeral
Πατρόκλοιο πόδα μεγαλήτορος ἧκε χαμᾶζε	---u u- uu-uu -u u--	dactylic hexameter	masculine penthemimeral
κεῖσθαι· ὃ δ’ἄγχ’ αὐτοῖο πέσε πρηνὴς ἐπὶ νεκρῷ	-u u - --u u- -- uu --	dactylic hexameter	feminine penthemimeral, hepthemimeral, trithemimeral
τῆλ’ ἀπὸ Λαρίσης ἐριβώλακος, οὐδὲ τοκεῦσι	- uu --- uu-uu -u u--	dactylic hexameter	masculine penthemimeral
θρέπτρα φίλοις ἀπέδωκε, μινυνθάδιος δέ οἱ αἰὼν	-u u- uu-u u-uu- u u --	dactylic hexameter	feminine penthemimeral, trithemimeral
ἔπλεθ’ ὑπ’ Αἴαντος μεγαθύμου δουρὶ δαμέντι.	-u u --- uu-- -u u--	dactylic hexameter	masculine penthemimeral
Ἕκτωρ δ’αὖτ’ Αἴαντος ἀκόντισε δουρὶ φαεινῷ·	-- - --u u-uu -u u--	dactylic hexameter	feminine penthemimeral, trithemimeral
ἀλλ’ ὃ μὲν ἄντα ἰδὼν ἠλεύατο χάλκεον ἔγχος	- u u -u u- --uu -uu --	dactylic hexameter	masculine penthemimeral
τυτθόν· ὃ δὲ Σχεδίον μεγαθύμου Ἰφίτου υἱὸν	-u u - uu- uu-- -uu --	dactylic hexameter	masculine penthemimeral, trithemimeral
Φωκήων ὄχ’ ἄριστον, ὃς ἐν κλειτῷ Πανοπῆϊ	--- u u-u u - -- uu--	dactylic hexameter	feminine penthemimeral, hepthemimeral, trithemimeral
οἰκία ναιετάασκε πολέσσ’ ἄνδρεσσιν ἀνάσσων,	-uu -uu-u u- --u u--	dactylic hexameter	feminine penthemimeral, hepthemimeral
τὸν βάλ’ ὑπὸ κληῖδα μέσην· διὰ δ’ἀμπερὲς ἄκρη	- u u- --u u- uu -uu --	dactylic hexameter	feminine penthemimeral, hepthemimeral, trithemimeral
αἰχμὴ χαλκείη παρὰ νείατον ὦμον ἀνέσχε·	-- --- uu -uu -u u--	dactylic hexameter	masculine penthemimeral
δούπησεν δὲ πεσών, ἀράβησε δὲ τεύχε’ ἐπ’ αὐτῷ.	--- u u- uu-u u -u u --	dactylic hexameter	masculine penthemimeral, trithemimeral
Αἴας δ’αὖ Φόρκυνα δαΐφρονα Φαίνοπος υἱὸν	-- - --u u-uu -uu --	dactylic hexameter	feminine penthemimeral, trithemimeral
Ἱπποθόῳ περιβάντα μέσην κατὰ γαστέρα τύψε·	-uu- uu-u u- uu -uu --	dactylic hexameter	feminine penthemimeral, hepthemimeral, trithemimeral
ῥῆξε δὲ θώρηκος γύαλον, διὰ δ’ἔντερα χαλκὸς	-u u --- uu- uu -uu --	dactylic hexameter	masculine penthemimeral, hepthemimeral
ἤφυσ’· ὃ δ’ἐν κονίῃσι πεσὼν ἕλε γαῖαν ἀγοστῷ.	-u u - uu-u u- uu -u u--	dactylic hexameter	feminine penthemimeral, hepthemimeral, trithemimeral
χώρησαν δ’ὑπό τε πρόμαχοι καὶ φαίδιμος Ἕκτωρ·	--- uu - uu- - -uu --	dactylic hexameter	masculine penthemimeral, hepthemimeral, trithemimeral
Ἀργεῖοι δὲ μέγα ἴαχον, ἐρύσαντο δὲ νεκροὺς	--- u u- uu- uu-u u --	dactylic hexameter	masculine penthemimeral, hepthemimeral, trithemimeral
Φόρκυν θ’Ἱππόθοόν τε, λύοντο δὲ τεύχε’ ἀπ’ ὤμων.	-- -uu- u u-u u -u u --	dactylic hexameter	masculine penthemimeral
ἔνθά κεν αὖτε Τρῶες ἀρηϊφίλων ὑπ’ Ἀχαιῶν	-u u -- -u u-uu- u u--	dactylic hexameter	feminine penthemimeral
Ἴλιον εἰσανέβησαν ἀναλκείῃσι δαμέντες,	-uu -uu-u u---u u--	dactylic hexameter	feminine penthemimeral
Ἀργεῖοι δέ κε κῦδος ἕλον καὶ ὑπὲρ Διὸς αἶσαν	--- u u -u u- u u- uu --	dactylic hexameter	feminine penthemimeral, hepthemimeral, trithemimeral
κάρτεϊ καὶ σθένεϊ σφετέρῳ· ἀλλ’ αὐτὸς Ἀπόλλων	-uu - uu- uu- - -u u--	dactylic hexameter	masculine penthemimeral, hepthemimeral, trithemimeral
Αἰνείαν ὄτρυνε δέμας Περίφαντι ἐοικὼς	--- --u u- uu-u u--	dactylic hexameter	feminine penthemimeral, hepthemimeral, trithemimeral
κήρυκι Ἠπυτίδῃ, ὅς οἱ παρὰ πατρὶ γέροντι	-uu ---u u - uu -u u--	dactylic hexameter	feminine penthemimeral, hepthemimeral
κηρύσσων γήρασκε φίλα φρεσὶ μήδεα εἰδώς·	--- --u u- uu -uu --	dactylic hexameter	feminine penthemimeral, hepthemimeral, trithemimeral
τῷ μιν ἐεισάμενος προσέφη Διὸς υἱὸς Ἀπόλλων·	- u u-uu- uu- uu -u u--	dactylic hexameter	masculine penthemimeral, hepthemimeral
Αἰνεία πῶς ἂν καὶ ὑπὲρ θεὸν εἰρύσσαισθε	--- - - u u- uu ----	dactylic hexameter	masculine penthemimeral, hepthemimeral, trithemimeral
Ἴλιον αἰπεινήν; ὡς δὴ ἴδον ἀνέρας ἄλλους	-uu --- - - uu -uu --	dactylic hexameter	masculine penthemimeral, hepthemimeral
κάρτεΐ τε σθένεΐ τε πεποιθότας ἠνορέῃ τε	-uu - uu- u u-uu -uu- -	dactylic hexameter	masculine penthemimeral, trithemimeral
πλήθεΐ τε σφετέρῳ καὶ ὑπερδέα δῆμον ἔχοντας·	-uu - uu- u u-uu -u u--	dactylic hexameter	masculine penthemimeral, trithemimeral
ἡμῖν δὲ Ζεὺς μὲν πολὺ βούλεται ἢ Δαναοῖσι	-- - - - uu -uu - uu--	dactylic hexameter	masculine penthemimeral, trithemimeral
νίκην· ἀλλ’ αὐτοὶ τρεῖτ’ ἄσπετον οὐδὲ μάχεσθε.	-- - -- - -uu -u u--	dactylic hexameter	masculine penthemimeral, trithemimeral
ὣς ἔφατ’, Αἰνείας δ’ἑκατηβόλον Ἀπόλλωνα	- uu --- uu-uu ----	dactylic hexameter	masculine penthemimeral
ἔγνω ἐς ἄντα ἰδών, μέγα δ’Ἕκτορα εἶπε βοήσας·	-u u -u u- uu -uu -u u--	dactylic hexameter	masculine penthemimeral
Ἕκτόρ τ’ἠδ’ ἄλλοι Τρώων ἀγοὶ ἠδ’ ἐπικούρων	-- - -- -- uu - uu--	dactylic hexameter	masculine penthemimeral, hepthemimeral, trithemimeral
αἰδὼς μὲν νῦν ἥδε γ’ἀρηϊφίλων ὑπ’ Ἀχαιῶν	-- - - -u u-uu- u u--	dactylic hexameter	feminine penthemimeral, trithemimeral
Ἴλιον εἰσαναβῆναι ἀναλκείῃσι δαμέντας.	-uu -uu-u u---u u--	dactylic hexameter	feminine penthemimeral
ἀλλ’ ἔτι γάρ τίς φησι θεῶν ἐμοὶ ἄγχι παραστὰς	- uu - - -u u- uu -u u--	dactylic hexameter	feminine penthemimeral, hepthemimeral, trithemimeral
Ζῆν’ ὕπατον μήστωρα μάχης ἐπιτάρροθον εἶναι·	- uu- --u u- uu-uu --	dactylic hexameter	feminine penthemimeral, hepthemimeral, trithemimeral
τώ ῥ’ἰθὺς Δαναῶν ἴομεν, μηδ’ οἵ γε ἕκηλοι	- -- uu- uu- - - u u--	dactylic hexameter	masculine penthemimeral, hepthemimeral, trithemimeral
Πάτροκλον νηυσὶν πελασαίατο τεθνηῶτα.	--- -- uu-uu ----	dactylic hexameter	masculine penthemimeral, trithemimeral
ὣς φάτο, καί ῥα πολὺ προμάχων ἐξάλμενος ἔστη·	- uu - u u- uu- --uu --	dactylic hexameter	masculine penthemimeral, hepthemimeral, trithemimeral
οἳ δ’ἐλελίχθησαν καὶ ἐναντίοι ἔσταν Ἀχαιῶν.	- uu--- u u-uu -u u--	dactylic hexameter	masculine penthemimeral
ἔνθ’ αὖτ’ Αἰνείας Λειώκριτον οὔτασε δουρὶ	- - --- --uu -uu --	dactylic hexameter	masculine penthemimeral
υἱὸν Ἀρίσβαντος Λυκομήδεος ἐσθλὸν ἑταῖρον.	-u u--- uu-uu -u u--	dactylic hexameter	masculine penthemimeral
τὸν δὲ πεσόντ’ ἐλέησεν ἀρηΐφιλος Λυκομήδης,	- u u- uu-u u-uu- uu--	dactylic hexameter	feminine penthemimeral, trithemimeral
στῆ δὲ μάλ’ ἐγγὺς ἰών, καὶ ἀκόντισε δουρὶ φαεινῷ,	- u u -u u- u u-uu -u u--	dactylic hexameter	masculine penthemimeral
καὶ βάλεν Ἱππασίδην Ἀπισάονα ποιμένα λαῶν	- uu -uu- uu-uu -uu --	dactylic hexameter	masculine penthemimeral
ἧπαρ ὑπὸ πραπίδων, εἶθαρ δ’ὑπὸ γούνατ’ ἔλυσεν,	-u u- uu- -- uu -u u--	dactylic hexameter	masculine penthemimeral, hepthemimeral, trithemimeral
ὅς ῥ’ἐκ Παιονίης ἐριβώλακος εἰληλούθει,	- - -uu- uu-uu ----	dactylic hexameter	masculine penthemimeral
καὶ δὲ μετ’ Ἀστεροπαῖον ἀριστεύεσκε μάχεσθαι.	- u u -uu-u u---u u--	dactylic hexameter	feminine penthemimeral
τὸν δὲ πεσόντ’ ἐλέησεν ἀρήϊος Ἀστεροπαῖος,	- u u- uu-u u-uu -uu--	dactylic hexameter	feminine penthemimeral, trithemimeral
ἴθυσεν δὲ καὶ ὃ πρόφρων Δαναοῖσι μάχεσθαι·	--- u u - -- uu-u u--	dactylic hexameter	masculine penthemimeral, hepthemimeral, trithemimeral
ἀλλ’ οὔ πως ἔτι εἶχε· σάκεσσι γὰρ ἔρχατο πάντῃ	- - - uu -u u-u u -uu --	dactylic hexameter	feminine penthemimeral, trithemimeral
ἑσταότες περὶ Πατρόκλῳ, πρὸ δὲ δούρατ’ ἔχοντο.	-uu- uu --- u u -u u--	dactylic hexameter	hepthemimeral, trithemimeral
Αἴας γὰρ μάλα πάντας ἐπῴχετο πολλὰ κελεύων·	-- - uu -u u-uu -u u--	dactylic hexameter	feminine penthemimeral, trithemimeral
οὔτέ τιν’ ἐξοπίσω νεκροῦ χάζεσθαι ἀνώγει	-u u -uu- -- --u u--	dactylic hexameter	masculine penthemimeral, hepthemimeral
οὔτέ τινα προμάχεσθαι Ἀχαιῶν ἔξοχον ἄλλων,	-u u- uu-u u-- -uu --	dactylic hexameter	feminine penthemimeral, trithemimeral
ἀλλὰ μάλ’ ἀμφ’ αὐτῷ βεβάμεν, σχεδόθεν δὲ μάχεσθαι.	-u u - -- uu- uu- u u--	dactylic hexameter	masculine penthemimeral, hepthemimeral, trithemimeral
ὣς Αἴας ἐπέτελλε πελώριος, αἵματι δὲ χθὼν	- -- uu-u u-uu -uu - -	dactylic hexameter	feminine penthemimeral, trithemimeral
δεύετο πορφυρέῳ, τοὶ δ’ἀγχιστῖνοι ἔπιπτον	-uu -uu- - ---u u--	dactylic hexameter	masculine penthemimeral
νεκροὶ ὁμοῦ Τρώων καὶ ὑπερμενέων ἐπικούρων	-u u- -- u u-uu- uu--	dactylic hexameter	masculine penthemimeral, trithemimeral
καὶ Δαναῶν· οὐδ’ οἳ γὰρ ἀναιμωτί γε μάχοντο,	- uu- - - u u--- u u--	dactylic hexameter	masculine penthemimeral, trithemimeral
παυρότεροι δὲ πολὺ φθίνυθον· μέμνηντο γὰρ αἰεὶ	-uu- u u- uu- --u u --	dactylic hexameter	masculine penthemimeral, hepthemimeral, trithemimeral
ἀλλήλοις ἀν’ ὅμιλον ἀλεξέμεναι φόνον αἰπύν.	--- u u-u u-uu- uu --	dactylic hexameter	feminine penthemimeral, trithemimeral
ὣς οἳ μὲν μάρναντο δέμας πυρός, οὐδέ κε φαίης	- - - --u u- uu -u u --	dactylic hexameter	feminine penthemimeral, hepthemimeral, trithemimeral
οὔτέ ποτ’ ἠέλιον σῶν ἔμμεναι οὔτε σελήνην·	-u u -uu- - -uu -u u--	dactylic hexameter	masculine penthemimeral
ἠέρι γὰρ κατέχοντο μάχης ἐπί θ’ὅσσον ἄριστοι	-uu - uu-u u- uu -u u--	dactylic hexameter	feminine penthemimeral, hepthemimeral, trithemimeral
ἕστασαν ἀμφὶ Μενοιτιάδῃ κατατεθνηῶτι.	-uu -u u-uu- uu----	dactylic hexameter	hepthemimeral
οἳ δ’ἄλλοι Τρῶες καὶ ἐϋκνήμιδες Ἀχαιοὶ	- -- -- u u---u u--	dactylic hexameter	masculine penthemimeral, trithemimeral
εὔκηλοι πολέμιζον ὑπ’ αἰθέρι, πέπτατο δ’αὐγὴ	--- uu-u u -uu -uu --	dactylic hexameter	feminine penthemimeral, trithemimeral
ἠελίου ὀξεῖα, νέφος δ’οὐ φαίνετο πάσης	-uu- --u u- - -uu --	dactylic hexameter	feminine penthemimeral, hepthemimeral, trithemimeral
γαίης οὐδ’ ὀρέων· μεταπαυόμενοι δὲ μάχοντο	-- - uu- uu-uu- u u--	dactylic hexameter	masculine penthemimeral, trithemimeral
ἀλλήλων ἀλεείνοντες βέλεα στονόεντα	--- uu--- uu- uu--	dactylic hexameter	hepthemimeral, trithemimeral
πολλὸν ἀφεσταότες. τοὶ δ’ἐν μέσῳ ἄλγε’ ἔπασχον	-u u-uu- - - uu -u u--	dactylic hexameter	masculine penthemimeral, hepthemimeral
ἠέρι καὶ πολέμῳ, τείροντο δὲ νηλέϊ χαλκῷ	-uu - uu- --u u -uu --	dactylic hexameter	masculine penthemimeral, trithemimeral
ὅσσοι ἄριστοι ἔσαν· δύο δ’οὔ πω φῶτε πεπύσθην	-u u-u u- uu - - -u u--	dactylic hexameter	masculine penthemimeral, hepthemimeral
ἀνέρε κυδαλίμω Θρασυμήδης Ἀντίλοχός τε	-uu -uu- uu-- -uu- -	dactylic hexameter	masculine penthemimeral
Πατρόκλοιο θανόντος ἀμύμονος, ἀλλ’ ἔτ’ ἔφαντο	---u u-u u-uu - u u--	dactylic hexameter	feminine penthemimeral
ζωὸν ἐνὶ πρώτῳ ὁμάδῳ Τρώεσσι μάχεσθαι.	-u u- -- uu- --u u--	dactylic hexameter	masculine penthemimeral, hepthemimeral, trithemimeral
τὼ δ’ἐπιοσσομένω θάνατον καὶ φύζαν ἑταίρων	- uu-uu- uu- - -u u--	dactylic hexameter	masculine penthemimeral, hepthemimeral
νόσφιν ἐμαρνάσθην, ἐπεὶ ὣς ἐπετέλλετο Νέστωρ	-u u--- uu - uu-uu --	dactylic hexameter	masculine penthemimeral, hepthemimeral
ὀτρύνων πόλεμον δὲ μελαινάων ἀπὸ νηῶν.	--- uu- u u--- uu --	dactylic hexameter	masculine penthemimeral, trithemimeral
τοῖς δὲ πανημερίοις ἔριδος μέγα νεῖκος ὀρώρει	- u u-uu- uu- uu -u u--	dactylic hexameter	masculine penthemimeral, hepthemimeral
ἀργαλέης· καμάτῳ δὲ καὶ ἱδρῷ νωλεμὲς αἰεὶ	-uu- uu- u u -- -uu --	dactylic hexameter	masculine penthemimeral, trithemimeral
γούνατά τε κνῆμαί τε πόδες θ’ὑπένερθεν ἑκάστου	-uu - -- u u- uu-u u--	dactylic hexameter	masculine penthemimeral, hepthemimeral, trithemimeral
χεῖρές τ’ὀφθαλμοί τε παλάσσετο μαρναμένοιιν	-- --- u u-uu -uu--	dactylic hexameter	masculine penthemimeral
ἀμφ’ ἀγαθὸν θεράποντα ποδώκεος Αἰακίδαο.	- uu- uu-u u-uu -uu--	dactylic hexameter	feminine penthemimeral, trithemimeral
ὡς δ’ὅτ’ ἀνὴρ ταύροιο βοὸς μεγάλοιο βοείην	- u u- --u u- uu-u u--	dactylic hexameter	feminine penthemimeral, hepthemimeral, trithemimeral
λαοῖσιν δώῃ τανύειν μεθύουσαν ἀλοιφῇ·	--- -- uu- uu-u u--	dactylic hexameter	masculine penthemimeral, hepthemimeral, trithemimeral
δεξάμενοι δ’ἄρα τοί γε διαστάντες τανύουσι	-uu- uu - u u--- uu--	dactylic hexameter	masculine penthemimeral, trithemimeral
κυκλόσ’, ἄφαρ δέ τε ἰκμὰς ἔβη, δύνει δέ τ’ἀλοιφὴ	-u u- u u -u u- -- u u--	dactylic hexameter	feminine penthemimeral, hepthemimeral, trithemimeral
πολλῶν ἑλκόντων, τάνυται δέ τε πᾶσα διὰ πρό·	-- --- uu- u u -u u- -	dactylic hexameter	masculine penthemimeral, hepthemimeral
ὣς οἵ γ’ἔνθα καὶ ἔνθα νέκυν ὀλίγῃ ἐνὶ χώρῃ	- - -u u -u u- uu- uu --	dactylic hexameter	feminine penthemimeral, hepthemimeral
εἵλκεον ἀμφότεροι· μάλα δέ σφισιν ἔλπετο θυμὸς	-uu -uu- uu - uu -uu --	dactylic hexameter	masculine penthemimeral, hepthemimeral
Τρωσὶν μὲν ἐρύειν προτὶ Ἴλιον, αὐτὰρ Ἀχαιοῖς	-- - uu- uu -uu -u u--	dactylic hexameter	masculine penthemimeral, trithemimeral
νῆας ἔπι γλαφυράς· περὶ δ’αὐτοῦ μῶλος ὀρώρει	-u u- uu- uu -- -u u--	dactylic hexameter	masculine penthemimeral, trithemimeral
ἄγριος· οὐδέ κ’Ἄρης λαοσσόος οὐδέ κ’Ἀθήνη	-uu -u u- --uu -u u--	dactylic hexameter	masculine penthemimeral
τόν γε ἰδοῦσ’ ὀνόσαιτ’, οὐδ’ εἰ μάλα μιν χόλος ἵκοι·	- u u- uu- - - uu - uu --	dactylic hexameter	masculine penthemimeral, hepthemimeral, trithemimeral
τοῖον Ζεὺς ἐπὶ Πατρόκλῳ ἀνδρῶν τε καὶ ἵππων	-- - uu --- -- u u --	dactylic hexameter	hepthemimeral, trithemimeral
ἤματι τῷ ἐτάνυσσε κακὸν πόνον· οὐδ’ ἄρα πώ τι	-uu - uu-u u- uu - uu - -	dactylic hexameter	feminine penthemimeral, hepthemimeral, trithemimeral
ᾔδεε Πάτροκλον τεθνηότα δῖος Ἀχιλλεύς·	-uu --- --uu -u u--	dactylic hexameter	masculine penthemimeral
πολλὸν γὰρ ῥ’ἀπάνευθε νεῶν μάρναντο θοάων	-- - uu-u u- --u u--	dactylic hexameter	feminine penthemimeral, hepthemimeral, trithemimeral
τείχει ὕπο Τρώων· τό μιν οὔ ποτε ἔλπετο θυμῷ	-u u- -- u u - uu -uu --	dactylic hexameter	masculine penthemimeral, hepthemimeral, trithemimeral
τεθνάμεν, ἀλλὰ ζωὸν ἐνιχριμφθέντα πύλῃσιν	-uu -- -u u---u u--	dactylic hexameter	feminine penthemimeral
ἂψ ἀπονοστήσειν, ἐπεὶ οὐδὲ τὸ ἔλπετο πάμπαν	- uu--- uu -u u -uu --	dactylic hexameter	masculine penthemimeral
ἐκπέρσειν πτολίεθρον ἄνευ ἕθεν, οὐδὲ σὺν αὐτῷ·	--- uu-u u- uu -u u --	dactylic hexameter	feminine penthemimeral, hepthemimeral, trithemimeral
πολλάκι γὰρ τό γε μητρὸς ἐπεύθετο νόσφιν ἀκούων,	-uu - u u -u u-uu -u u--	dactylic hexameter	feminine penthemimeral, trithemimeral
ἥ οἱ ἀπαγγέλλεσκε Διὸς μεγάλοιο νόημα.	- u u---u u- uu-u u--	dactylic hexameter	feminine penthemimeral, hepthemimeral
δὴ τότε γ’οὔ οἱ ἔειπε κακὸν τόσον ὅσσον ἐτύχθη	- uu - u u-u u- uu -u u--	dactylic hexameter	feminine penthemimeral, hepthemimeral, trithemimeral
μήτηρ, ὅττί ῥά οἱ πολὺ φίλτατος ὤλεθ’ ἑταῖρος.	-- -u u - uu -uu -u u--	dactylic hexameter	masculine penthemimeral
οἳ δ’αἰεὶ περὶ νεκρὸν ἀκαχμένα δούρατ’ ἔχοντες	- -- uu -u u-uu -u u--	dactylic hexameter	feminine penthemimeral, trithemimeral
νωλεμὲς ἐγχρίμπτοντο καὶ ἀλλήλους ἐνάριζον·	-uu ---u u --- uu--	dactylic hexameter	feminine penthemimeral
ὧδε δέ τις εἴπεσκεν Ἀχαιῶν χαλκοχιτώνων·	-u u - --u u-- -uu--	dactylic hexameter	feminine penthemimeral, trithemimeral
ὦ φίλοι οὐ μὰν ἧμιν ἐϋκλεὲς ἀπονέεσθαι	- uu - - -u u-uu -uu--	dactylic hexameter	feminine penthemimeral, trithemimeral
νῆας ἔπι γλαφυράς, ἀλλ’ αὐτοῦ γαῖα μέλαινα	-u u- uu- - -- -u u--	dactylic hexameter	masculine penthemimeral, trithemimeral
πᾶσι χάνοι· τό κεν ἧμιν ἄφαρ πολὺ κέρδιον εἴη	-u u- u u -u u- uu -uu --	dactylic hexameter	feminine penthemimeral, hepthemimeral, trithemimeral
εἰ τοῦτον Τρώεσσι μεθήσομεν ἱπποδάμοισιν	- -- --u u-uu -uu--	dactylic hexameter	feminine penthemimeral, trithemimeral
ἄστυ πότι σφέτερον ἐρύσαι καὶ κῦδος ἀρέσθαι.	-u u- uu- uu- - -u u--	dactylic hexameter	masculine penthemimeral, hepthemimeral, trithemimeral
ὣς δέ τις αὖ Τρώων μεγαθύμων αὐδήσασκεν·	- u u - -- uu-- ----	dactylic hexameter	masculine penthemimeral, trithemimeral
ὦ φίλοι, εἰ καὶ μοῖρα παρ’ ἀνέρι τῷδε δαμῆναι	- uu - - -u u -uu -u u--	dactylic hexameter	feminine penthemimeral, trithemimeral
πάντας ὁμῶς, μή πώ τις ἐρωείτω πολέμοιο.	-u u- - - u u--- uu--	dactylic hexameter	masculine penthemimeral, trithemimeral
ὣς ἄρα τις εἴπεσκε, μένος δ’ὄρσασκεν ἑκάστου.	- uu - --u u- --u u--	dactylic hexameter	feminine penthemimeral, hepthemimeral, trithemimeral
ὣς οἳ μὲν μάρναντο, σιδήρειος δ’ὀρυμαγδὸς	- - - --u u--- uu--	dactylic hexameter	feminine penthemimeral, trithemimeral
χάλκεον οὐρανὸν ἷκε δι’ αἰθέρος ἀτρυγέτοιο·	-uu -uu -u u -uu -uu--	dactylic hexameter	feminine penthemimeral
ἵπποι δ’Αἰακίδαο μάχης ἀπάνευθεν ἐόντες	-- -uu-u u- uu-u u--	dactylic hexameter	feminine penthemimeral, hepthemimeral
κλαῖον, ἐπεὶ δὴ πρῶτα πυθέσθην ἡνιόχοιο	-u u- - -u u-- -uu--	dactylic hexameter	feminine penthemimeral, trithemimeral
ἐν κονίῃσι πεσόντος ὑφ’ Ἕκτορος ἀνδροφόνοιο.	- uu-u u-u u -uu -uu--	dactylic hexameter	feminine penthemimeral
ἦ μὰν Αὐτομέδων Διώρεος ἄλκιμος υἱὸς	- - -uu- --uu -uu --	dactylic hexameter	masculine penthemimeral
πολλὰ μὲν ἂρ μάστιγι θοῇ ἐπεμαίετο θείνων,	-u u - --u u- uu-uu --	dactylic hexameter	feminine penthemimeral, hepthemimeral, trithemimeral
πολλὰ δὲ μειλιχίοισι προσηύδα, πολλὰ δ’ἀρειῇ·	-u u -uu-u u-- -u u--	dactylic hexameter	feminine penthemimeral
τὼ δ’οὔτ’ ἂψ ἐπὶ νῆας ἐπὶ πλατὺν Ἑλλήσποντον	- - - uu -u u- uu ----	dactylic hexameter	feminine penthemimeral, hepthemimeral, trithemimeral
ἠθελέτην ἰέναι οὔτ’ ἐς πόλεμον μετ’ Ἀχαιούς,	-uu- uu- - - uu- u u--	dactylic hexameter	masculine penthemimeral, hepthemimeral, trithemimeral
ἀλλ’ ὥς τε στήλη μένει ἔμπεδον, ἥ τ’ἐπὶ τύμβῳ	- - - -- uu -uu - uu --	dactylic hexameter	masculine penthemimeral, trithemimeral
ἀνέρος ἑστήκῃ τεθνηότος ἠὲ γυναικός,	-uu --- --uu -u u--	dactylic hexameter	masculine penthemimeral
ὣς μένον ἀσφαλέως περικαλλέα δίφρον ἔχοντες	- uu -uu- uu-uu -u u--	dactylic hexameter	masculine penthemimeral
οὔδει ἐνισκίμψαντε καρήατα· δάκρυα δέ σφι	-u u---u u-uu -uu - -	dactylic hexameter	feminine penthemimeral
θερμὰ κατὰ βλεφάρων χαμάδις ῥέε μυρομένοισιν	-u u- uu- uu- uu -uu--	dactylic hexameter	masculine penthemimeral, hepthemimeral, trithemimeral
ἡνιόχοιο πόθῳ· θαλερὴ δ’ἐμιαίνετο χαίτη	-uu-u u- uu- uu-uu --	dactylic hexameter	masculine penthemimeral, hepthemimeral
ζεύγλης ἐξεριποῦσα παρὰ ζυγὸν ἀμφοτέρωθεν.	-- -uu-u u- uu -uu--	dactylic hexameter	feminine penthemimeral, hepthemimeral
μυρομένω δ’ἄρα τώ γε ἰδὼν ἐλέησε Κρονίων,	-uu- uu - u u- uu-u u--	dactylic hexameter	masculine penthemimeral, hepthemimeral, trithemimeral
κινήσας δὲ κάρη προτὶ ὃν μυθήσατο θυμόν·	--- u u- uu - --uu --	dactylic hexameter	masculine penthemimeral, hepthemimeral, trithemimeral
ἆ δειλώ, τί σφῶϊ δόμεν Πηλῆϊ ἄνακτι	- -- - -u u- --u u--	dactylic hexameter	feminine penthemimeral, hepthemimeral, trithemimeral
θνητῷ, ὑμεῖς δ’ἐστὸν ἀγήρω τ’ἀθανάτω τε;	-- -- -u u-- -uu- -	dactylic hexameter	feminine penthemimeral
ἦ ἵνα δυστήνοισι μετ’ ἀνδράσιν ἄλγε’ ἔχητον;	- uu ---u u -uu -u u--	dactylic hexameter	feminine penthemimeral
οὐ μὲν γάρ τί πού ἐστιν ὀϊζυρώτερον ἀνδρὸς	- - - u u -u u---uu --	dactylic hexameter	feminine penthemimeral, trithemimeral
πάντων, ὅσσά τε γαῖαν ἔπι πνείει τε καὶ ἕρπει.	-- -u u -u u- -- u u --	dactylic hexameter	feminine penthemimeral, hepthemimeral
ἀλλ’ οὐ μὰν ὑμῖν γε καὶ ἅρμασι δαιδαλέοισιν	- - - -- u u -uu -uu--	dactylic hexameter	masculine penthemimeral, trithemimeral
Ἕκτωρ Πριαμίδης ἐποχήσεται· οὐ γὰρ ἐάσω.	-- -uu- uu-uu - u u--	dactylic hexameter	masculine penthemimeral
ἦ οὐχ ἅλις ὡς καὶ τεύχε’ ἔχει καὶ ἐπεύχεται αὔτως;	- uu - - -u u- u u-uu --	dactylic hexameter	feminine penthemimeral, hepthemimeral, trithemimeral
σφῶϊν δ’ἐν γούνεσσι βαλῶ μένος ἠδ’ ἐνὶ θυμῷ,	-- - --u u- uu - uu --	dactylic hexameter	feminine penthemimeral, hepthemimeral, trithemimeral
ὄφρα καὶ Αὐτομέδοντα σαώσετον ἐκ πολέμοιο	-u u -uu-u u-uu - uu--	dactylic hexameter	feminine penthemimeral
νῆας ἔπι γλαφυράς· ἔτι γάρ σφισι κῦδος ὀρέξω	-u u- uu- uu - uu -u u--	dactylic hexameter	masculine penthemimeral, hepthemimeral, trithemimeral
κτείνειν, εἰς ὅ κε νῆας ἐϋσσέλμους ἀφίκωνται	-- - u u -u u--- uu--	dactylic hexameter	feminine penthemimeral, trithemimeral
δύῃ τ’ἠέλιος καὶ ἐπὶ κνέφας ἱερὸν ἔλθῃ·	-- -uu- u u- uu -uu --	dactylic hexameter	masculine penthemimeral, hepthemimeral
ὣς εἰπὼν ἵπποισιν ἐνέπνευσεν μένος ἠΰ.	- -- --u u--- uu --	dactylic hexameter	feminine penthemimeral, trithemimeral
τὼ δ’ἀπὸ χαιτάων κονίην οὖδας δὲ βαλόντε	- uu --- uu- -- u u--	dactylic hexameter	masculine penthemimeral, hepthemimeral
ῥίμφα φέρον θοὸν ἅρμα μετὰ Τρῶας καὶ Ἀχαιούς.	-u u- uu -u u- -- u u--	dactylic hexameter	feminine penthemimeral, hepthemimeral, trithemimeral
τοῖσι δ’ἐπ’ Αὐτομέδων μάχετ’ ἀχνύμενός περ ἑταίρου	-u u -uu- uu -uu- u u--	dactylic hexameter	masculine penthemimeral
ἵπποις ἀΐσσων ὥς τ’αἰγυπιὸς μετὰ χῆνας·	-- --- - -uu- uu --	dactylic hexameter	masculine penthemimeral
ῥέα μὲν γὰρ φεύγεσκεν ὑπ’ ἐκ Τρώων ὀρυμαγδοῦ,	- - - --u u - -- uu--	dactylic hexameter	feminine penthemimeral, hepthemimeral, trithemimeral
ῥεῖα δ’ἐπαΐξασκε πολὺν καθ’ ὅμιλον ὀπάζων.	-u u---u u- u u-u u--	dactylic hexameter	feminine penthemimeral, hepthemimeral
ἀλλ’ οὐχ ᾕρει φῶτας ὅτε σεύαιτο διώκειν·	- - -- -u u- --u u--	dactylic hexameter	feminine penthemimeral, hepthemimeral
οὐ γάρ πως ἦν οἶον ἐόνθ’ ἱερῷ ἐνὶ δίφρῳ	- - - - -u u- uu- uu --	dactylic hexameter	feminine penthemimeral, hepthemimeral, trithemimeral
ἔγχει ἐφορμᾶσθαι καὶ ἐπίσχειν ὠκέας ἵππους.	-u u--- u u-- -uu --	dactylic hexameter	masculine penthemimeral
ὀψὲ δὲ δή μιν ἑταῖρος ἀνὴρ ἴδεν ὀφθαλμοῖσιν	-u u - u u-u u- uu ----	dactylic hexameter	feminine penthemimeral, hepthemimeral, trithemimeral
Ἀλκιμέδων υἱὸς Λαέρκεος Αἱμονίδαο·	-uu- -- --uu -uu--	dactylic hexameter	masculine penthemimeral, trithemimeral
στῆ δ’ὄπιθεν δίφροιο καὶ Αὐτομέδοντα προσηύδα·	- uu- --u u -uu-u u--	dactylic hexameter	feminine penthemimeral, trithemimeral
Αὐτόμεδον, τίς τοί νυ θεῶν νηκερδέα βουλὴν	-uu- - - u u- --uu --	dactylic hexameter	masculine penthemimeral, hepthemimeral, trithemimeral
ἐν στήθεσσιν ἔθηκε, καὶ ἐξέλετο φρένας ἐσθλάς;	- --u u-u u -uu- uu --	dactylic hexameter	feminine penthemimeral
οἷον πρὸς Τρῶας μάχεαι πρώτῳ ἐν ὁμίλῳ	-- - -- uu- -- u u--	dactylic hexameter	masculine penthemimeral, hepthemimeral, trithemimeral
μοῦνος· ἀτάρ τοι ἑταῖρος ἀπέκτατο, τεύχεα δ’Ἕκτωρ	-u u- u u-u u-uu -uu --	dactylic hexameter	feminine penthemimeral, trithemimeral
αὐτὸς ἔχων ὤμοισιν ἀγάλλεται Αἰακίδαο.	-u u- --u u-uu -uu--	dactylic hexameter	feminine penthemimeral, trithemimeral
τὸν δ’αὖτ’ Αὐτομέδων προσέφη Διώρεος υἱός·	- - -uu- uu- --uu --	dactylic hexameter	masculine penthemimeral, hepthemimeral
Ἀλκίμεδον τίς γάρ τοι Ἀχαιῶν ἄλλος ὁμοῖος	-uu- - - u u-- -u u--	dactylic hexameter	masculine penthemimeral, trithemimeral
ἵππων ἀθανάτων ἐχέμεν δμῆσίν τε μένος τε,	-- -uu- uu- -- u u- -	dactylic hexameter	masculine penthemimeral, hepthemimeral
εἰ μὴ Πάτροκλος θεόφιν μήστωρ ἀτάλαντος	- - --- uu- -- uu--	dactylic hexameter	masculine penthemimeral, hepthemimeral
ζωὸς ἐών; νῦν αὖ θάνατος καὶ μοῖρα κιχάνει.	-u u- - - uu- - -u u--	dactylic hexameter	masculine penthemimeral, hepthemimeral, trithemimeral
ἀλλὰ σὺ μὲν μάστιγα καὶ ἡνία σιγαλόεντα	-u u - --u u -uu -uu--	dactylic hexameter	feminine penthemimeral, trithemimeral
δέξαι, ἐγὼ δ’ἵππων ἀποβήσομαι, ὄφρα μάχωμαι.	-u u- -- uu-uu -u u--	dactylic hexameter	masculine penthemimeral, trithemimeral
ὣς ἔφατ’, Ἀλκιμέδων δὲ βοηθόον ἅρμ’ ἐπορούσας	- uu -uu- u u-uu - uu--	dactylic hexameter	masculine penthemimeral
καρπαλίμως μάστιγα καὶ ἡνία λάζετο χερσίν,	-uu- --u u -uu -uu --	dactylic hexameter	feminine penthemimeral, trithemimeral
Αὐτομέδων δ’ἀπόρουσε· νόησε δὲ φαίδιμος Ἕκτωρ,	-uu- uu-u u-u u -uu --	dactylic hexameter	feminine penthemimeral, trithemimeral
αὐτίκα δ’Αἰνείαν προσεφώνεεν ἐγγὺς ἐόντα·	-uu --- uu-uu -u u--	dactylic hexameter	masculine penthemimeral
Αἰνεία Τρώων βουληφόρε χαλκοχιτώνων	--- -- --uu -uu--	dactylic hexameter	masculine penthemimeral, trithemimeral
ἵππω τώδ’ ἐνόησα ποδώκεος Αἰακίδαο	-- - uu-u u-uu -uu--	dactylic hexameter	feminine penthemimeral, trithemimeral
ἐς πόλεμον προφανέντε σὺν ἡνιόχοισι κακοῖσι·	- uu- uu-u u -uu-u u--	dactylic hexameter	feminine penthemimeral, trithemimeral
τώ κεν ἐελποίμην αἱρησέμεν, εἰ σύ γε θυμῷ	- u u--- --uu - u u --	dactylic hexameter	masculine penthemimeral
σῷ ἐθέλεις, ἐπεὶ οὐκ ἂν ἐφορμηθέντε γε νῶϊ	- uu- uu - u u---u u --	dactylic hexameter	masculine penthemimeral, trithemimeral
τλαῖεν ἐναντίβιον στάντες μαχέσασθαι Ἄρηϊ.	-u u-uu- -- uu-u u--	dactylic hexameter	masculine penthemimeral, hepthemimeral
ὣς ἔφατ’, οὐδ’ ἀπίθησεν ἐῢς πάϊς Ἀγχίσαο.	- uu - uu-u u- uu ----	dactylic hexameter	feminine penthemimeral, hepthemimeral, trithemimeral
τὼ δ’ἰθὺς βήτην βοέῃς εἰλυμένω ὤμους	- -- -- uu- --uu --	dactylic hexameter	masculine penthemimeral, hepthemimeral, trithemimeral
αὔῃσι στερεῇσι· πολὺς δ’ἐπελήλατο χαλκός.	--- uu-u u- uu-uu --	dactylic hexameter	feminine penthemimeral, hepthemimeral, trithemimeral
τοῖσι δ’ἅμα Χρομίος τε καὶ Ἄρητος θεοειδὴς	-u u- uu- u u --- uu--	dactylic hexameter	masculine penthemimeral, trithemimeral
ἤϊσαν ἀμφότεροι· μάλα δέ σφισιν ἔλπετο θυμὸς	-uu -uu- uu - uu -uu --	dactylic hexameter	masculine penthemimeral, hepthemimeral
αὐτώ τε κτενέειν ἐλάαν τ’ἐριαύχενας ἵππους	-- - uu- uu- uu-uu --	dactylic hexameter	masculine penthemimeral, hepthemimeral, trithemimeral
νήπιοι, οὐδ’ ἄρ’ ἔμελλον ἀναιμωτί γε νέεσθαι	-uu - u u-u u--- u u--	dactylic hexameter	feminine penthemimeral, trithemimeral
αὖτις ἀπ’ Αὐτομέδοντος. ὃ δ’εὐξάμενος Διὶ πατρὶ	-u u -uu-u u -uu- uu --	dactylic hexameter	feminine penthemimeral
ἀλκῆς καὶ σθένεος πλῆτο φρένας ἀμφὶ μελαίνας·	-- - uu- -- uu -u u--	dactylic hexameter	masculine penthemimeral, hepthemimeral, trithemimeral
αὐτίκα δ’Ἀλκιμέδοντα προσηύδα πιστὸν ἑταῖρον·	-uu -uu-u u-- -u u--	dactylic hexameter	feminine penthemimeral
Ἀλκίμεδον μὴ δή μοι ἀπόπροθεν ἰσχέμεν ἵππους,	-uu- - - u u-uu -uu --	dactylic hexameter	masculine penthemimeral, trithemimeral
ἀλλὰ μάλ’ ἐμπνείοντε μεταφρένῳ· οὐ γὰρ ἔγωγε	-u u ---u u-uu - u u--	dactylic hexameter	feminine penthemimeral
Ἕκτορα Πριαμίδην μένεος σχήσεσθαι ὀΐω,	-uu -uu- uu- --u u--	dactylic hexameter	masculine penthemimeral, hepthemimeral
πρίν γ’ἐπ’ Ἀχιλλῆος καλλίτριχε βήμεναι ἵππω	- u u--- --uu -uu --	dactylic hexameter	masculine penthemimeral
νῶϊ κατακτείναντα, φοβῆσαί τε στίχας ἀνδρῶν	-u u---u u-- - uu --	dactylic hexameter	feminine penthemimeral
Ἀργείων, ἤ κ’αὐτὸς ἐνὶ πρώτοισιν ἁλοίη.	--- - -u u- --u u--	dactylic hexameter	feminine penthemimeral, hepthemimeral, trithemimeral
ὣς εἰπὼν Αἴαντε καλέσσατο καὶ Μενέλαον·	- -- --u u-uu - uu--	dactylic hexameter	feminine penthemimeral, trithemimeral
Αἴαντ’ Ἀργείων ἡγήτορε καὶ Μενέλαε	-- --- --uu - uu--	dactylic hexameter	masculine penthemimeral
ἤτοι μὲν τὸν νεκρὸν ἐπιτράπεθ’ οἵ περ ἄριστοι	-- - - -u u-uu - u u--	dactylic hexameter	feminine penthemimeral, trithemimeral
ἀμφ’ αὐτῷ βεβάμεν καὶ ἀμύνεσθαι στίχας ἀνδρῶν,	- -- uu- u u--- uu --	dactylic hexameter	masculine penthemimeral, trithemimeral
νῶϊν δὲ ζωοῖσιν ἀμύνετε νηλεὲς ἦμαρ·	-- - --u u-uu -uu --	dactylic hexameter	feminine penthemimeral, trithemimeral
τῇδε γὰρ ἔβρισαν πόλεμον κάτα δακρυόεντα	-u u --- uu- uu -uu--	dactylic hexameter	masculine penthemimeral, hepthemimeral
Ἕκτωρ Αἰνείας θ’,οἳ Τρώων εἰσὶν ἄριστοι.	-- --- - -- -u u--	dactylic hexameter	masculine penthemimeral
ἀλλ’ ἤτοι μὲν ταῦτα θεῶν ἐν γούνασι κεῖται·	- -- - -u u- - -uu --	dactylic hexameter	feminine penthemimeral, hepthemimeral, trithemimeral
ἥσω γὰρ καὶ ἐγώ, τὰ δέ κεν Διὶ πάντα μελήσει.	-- - u u- u u - uu -u u--	dactylic hexameter	masculine penthemimeral, hepthemimeral, trithemimeral
ἦ ῥα, καὶ ἀμπεπαλὼν προΐει δολιχόσκιον ἔγχος,	- u u -uu- uu- uu-uu --	dactylic hexameter	masculine penthemimeral, hepthemimeral
καὶ βάλεν Ἀρήτοιο κατ’ ἀσπίδα πάντοσ’ ἐΐσην·	- uu ---u u -uu -u u--	dactylic hexameter	feminine penthemimeral
ἣ δ’οὐκ ἔγχος ἔρυτο, διὰ πρὸ δὲ εἴσατο χαλκός,	- - -u u-u u- u u -uu --	dactylic hexameter	feminine penthemimeral, hepthemimeral
νειαίρῃ δ’ἐν γαστρὶ διὰ ζωστῆρος ἔλασσεν.	--- - -u u- --u u--	dactylic hexameter	feminine penthemimeral, hepthemimeral, trithemimeral
ὡς δ’ὅτ’ ἂν ὀξὺν ἔχων πέλεκυν αἰζήϊος ἀνὴρ	- u u -u u- uu- --uu --	dactylic hexameter	masculine penthemimeral, hepthemimeral
κόψας ἐξόπιθεν κεράων βοὸς ἀγραύλοιο	-- -uu- uu- uu ----	dactylic hexameter	masculine penthemimeral, hepthemimeral
ἶνα τάμῃ διὰ πᾶσαν, ὃ δὲ προθορὼν ἐρίπῃσιν,	-u u- uu -u u - uu- uu--	dactylic hexameter	feminine penthemimeral, hepthemimeral, trithemimeral
ὣς ἄρ’ ὅ γε προθορὼν πέσεν ὕπτιος· ἐν δέ οἱ ἔγχος	- u u - uu- uu -uu - u u --	dactylic hexameter	masculine penthemimeral, trithemimeral
νηδυίοισι μάλ’ ὀξὺ κραδαινόμενον λύε γυῖα.	---u u -u u-uu- uu --	dactylic hexameter	feminine penthemimeral
Ἕκτωρ δ’Αὐτομέδοντος ἀκόντισε δουρὶ φαεινῷ·	-- -uu-u u-uu -u u--	dactylic hexameter	feminine penthemimeral
ἀλλ’ ὃ μὲν ἄντα ἰδὼν ἠλεύατο χάλκεον ἔγχος·	- u u -u u- --uu -uu --	dactylic hexameter	masculine penthemimeral
πρόσσω γὰρ κατέκυψε, τὸ δ’ἐξόπιθεν δόρυ μακρὸν	-- - uu-u u -uu- uu --	dactylic hexameter	feminine penthemimeral, trithemimeral
οὔδει ἐνισκίμφθη, ἐπὶ δ’οὐρίαχος πελεμίχθη	-u u--- uu -uu- uu--	dactylic hexameter	masculine penthemimeral
ἔγχεος· ἔνθα δ’ἔπειτ’ ἀφίει μένος ὄβριμος Ἄρης.	-uu -u u- uu- uu -uu --	dactylic hexameter	masculine penthemimeral, hepthemimeral
καί νύ κε δὴ ξιφέεσσ’ αὐτοσχεδὸν ὁρμηθήτην	- u u - uu- --uu ----	dactylic hexameter	masculine penthemimeral, trithemimeral
εἰ μή σφω’ Αἴαντε διέκριναν μεμαῶτε,	- - - --u u--- uu--	dactylic hexameter	feminine penthemimeral, trithemimeral
οἵ ῥ’ἦλθον καθ’ ὅμιλον ἑταίρου κικλήσκοντος·	- -- u u-u u-- ----	dactylic hexameter	feminine penthemimeral, trithemimeral
τοὺς ὑποταρβήσαντες ἐχώρησαν πάλιν αὖτις	- uu---u u--- uu --	dactylic hexameter	feminine penthemimeral
Ἕκτωρ Αἰνείας τ’ἠδὲ Χρομίος θεοειδής,	-- --- -- uu- uu--	dactylic hexameter	masculine penthemimeral, hepthemimeral
Ἄρητον δὲ κατ’ αὖθι λίπον δεδαϊγμένον ἦτορ	--- u u -u u- uu-uu --	dactylic hexameter	feminine penthemimeral, hepthemimeral, trithemimeral
κείμενον· Αὐτομέδων δὲ θοῷ ἀτάλαντος Ἄρηϊ	-uu -uu- u u- uu-u u--	dactylic hexameter	masculine penthemimeral, hepthemimeral
τεύχεά τ’ἐξενάριξε καὶ εὐχόμενος ἔπος ηὔδα·	-uu -uu-u u -uu- uu --	dactylic hexameter	feminine penthemimeral
ἦ δὴ μὰν ὀλίγον γε Μενοιτιάδαο θανόντος	- - - uu- u u-uu-u u--	dactylic hexameter	masculine penthemimeral, trithemimeral
κῆρ ἄχεος μεθέηκα χερείονά περ καταπέφνων.	- uu- uu-u u-uu - uu--	dactylic hexameter	feminine penthemimeral, trithemimeral
ὣς εἰπὼν ἐς δίφρον ἑλὼν ἔναρα βροτόεντα	- -- - -u u- uu- uu--	dactylic hexameter	feminine penthemimeral, hepthemimeral, trithemimeral
θῆκ’, ἂν δ’αὐτὸς ἔβαινε πόδας καὶ χεῖρας ὕπερθεν	- - -u u-u u- - -u u--	dactylic hexameter	feminine penthemimeral, hepthemimeral
αἱματόεις ὥς τίς τε λέων κατὰ ταῦρον ἐδηδώς.	-uu- - - u u- uu -u u--	dactylic hexameter	masculine penthemimeral, hepthemimeral, trithemimeral
ἂψ δ’ἐπὶ Πατρόκλῳ τέτατο κρατερὴ ὑσμίνη	- uu --- uu- uu- ---	dactylic hexameter	masculine penthemimeral, hepthemimeral
ἀργαλέη πολύδακρυς, ἔγειρε δὲ νεῖκος Ἀθήνη	-uu- uu-u u-u u -u u--	dactylic hexameter	feminine penthemimeral, trithemimeral
οὐρανόθεν καταβᾶσα· προῆκε γὰρ εὐρύοπα Ζεὺς	-uu- uu-u u-u u -uu- -	dactylic hexameter	feminine penthemimeral, trithemimeral
ὀρνύμεναι Δαναούς· δὴ γὰρ νόος ἐτράπετ’ αὐτοῦ.	-uu- uu- - - uu -uu --	dactylic hexameter	masculine penthemimeral, hepthemimeral, trithemimeral
ἠΰτε πορφυρέην ἶριν θνητοῖσι τανύσσῃ	-uu -uu- -- --u u--	dactylic hexameter	masculine penthemimeral, hepthemimeral
Ζεὺς ἐξ οὐρανόθεν τέρας ἔμμεναι ἢ πολέμοιο	- - -uu- uu -uu - uu--	dactylic hexameter	masculine penthemimeral
ἢ καὶ χειμῶνος δυσθαλπέος, ὅς ῥά τε ἔργων	- - --- --uu - u u --	dactylic hexameter	masculine penthemimeral
ἀνθρώπους ἀνέπαυσεν ἐπὶ χθονί, μῆλα δὲ κήδει,	--- uu-u u- uu -u u --	dactylic hexameter	feminine penthemimeral, hepthemimeral, trithemimeral
ὣς ἣ πορφυρέῃ νεφέλῃ πυκάσασα ἓ αὐτὴν	- - -uu- uu- uu-u u --	dactylic hexameter	masculine penthemimeral, hepthemimeral
δύσετ’ Ἀχαιῶν ἔθνος, ἔγειρε δὲ φῶτα ἕκαστον.	-u u-- -u u-u u -u u--	dactylic hexameter	feminine penthemimeral
πρῶτον δ’Ἀτρέος υἱὸν ἐποτρύνουσα προσηύδα	-- -uu -u u---u u--	dactylic hexameter	feminine penthemimeral
ἴφθιμον Μενέλαον· ὃ γάρ ῥά οἱ ἐγγύθεν ἦεν·	--- uu-u u - u u -uu --	dactylic hexameter	feminine penthemimeral, hepthemimeral, trithemimeral
εἰσαμένη Φοίνικι δέμας καὶ ἀτειρέα φωνήν·	-uu- --u u- u u-uu --	dactylic hexameter	feminine penthemimeral, hepthemimeral, trithemimeral
σοὶ μὲν δὴ Μενέλαε κατηφείη καὶ ὄνειδος	- - - uu-u u--- u u--	dactylic hexameter	feminine penthemimeral, trithemimeral
ἔσσεται εἴ κ’Ἀχιλῆος ἀγαυοῦ πιστὸν ἑταῖρον	-uu - uu-u u-- -u u--	dactylic hexameter	feminine penthemimeral, trithemimeral
τείχει ὕπο Τρώων ταχέες κύνες ἑλκήσουσιν.	-u u- -- uu- uu ----	dactylic hexameter	masculine penthemimeral, hepthemimeral, trithemimeral
ἀλλ’ ἔχεο κρατερῶς, ὄτρυνε δὲ λαὸν ἅπαντα.	- uu- uu- --u u -u u--	dactylic hexameter	masculine penthemimeral, trithemimeral
τὴν δ’αὖτε προσέειπε βοὴν ἀγαθὸς Μενέλαος·	- -- uu-u u- uu- uu--	dactylic hexameter	feminine penthemimeral, hepthemimeral, trithemimeral
Φοῖνιξ ἄττα γεραιὲ παλαιγενές, εἰ γὰρ Ἀθήνη	-- -u u-u u-uu - u u--	dactylic hexameter	feminine penthemimeral
δοίη κάρτος ἐμοί, βελέων δ’ἀπερύκοι ἐρωήν·	-- -u u- uu- uu-u u--	dactylic hexameter	masculine penthemimeral, hepthemimeral
τώ κεν ἔγωγ’ ἐθέλοιμι παρεστάμεναι καὶ ἀμύνειν	- u u- uu-u u-uu- u u--	dactylic hexameter	feminine penthemimeral, trithemimeral
Πατρόκλῳ· μάλα γάρ με θανὼν ἐσεμάσσατο θυμόν.	--- uu - u u- uu-uu --	dactylic hexameter	masculine penthemimeral, hepthemimeral, trithemimeral
ἀλλ’ Ἕκτωρ πυρὸς αἰνὸν ἔχει μένος, οὐδ’ ἀπολήγει	- -- uu -u u- uu - uu--	dactylic hexameter	feminine penthemimeral, hepthemimeral, trithemimeral
χαλκῷ δηϊόων· τῷ γὰρ Ζεὺς κῦδος ὀπάζει.	-- -uu- - - - -u u--	dactylic hexameter	masculine penthemimeral, hepthemimeral
ὣς φάτο, γήθησεν δὲ θεὰ γλαυκῶπις Ἀθήνη,	- uu --- u u- --u u--	dactylic hexameter	masculine penthemimeral, hepthemimeral
ὅττί ῥά οἱ πάμπρωτα θεῶν ἠρήσατο πάντων.	-u u - --u u- --uu --	dactylic hexameter	feminine penthemimeral, hepthemimeral, trithemimeral
ἐν δὲ βίην ὤμοισι καὶ ἐν γούνεσσιν ἔθηκε,	- u u- --u u - --u u--	dactylic hexameter	feminine penthemimeral, hepthemimeral, trithemimeral
καί οἱ μυίης θάρσος ἐνὶ στήθεσσιν ἐνῆκεν,	- - -- -u u- --u u--	dactylic hexameter	feminine penthemimeral, hepthemimeral
ἥ τε καὶ ἐργομένη μάλα περ χροὸς ἀνδρομέοιο	- u u -uu- uu - uu -uu--	dactylic hexameter	masculine penthemimeral, hepthemimeral
ἰσχανάᾳ δακέειν, λαρόν τέ οἱ αἷμ’ ἀνθρώπου·	-uu- uu- -- u u - ---	dactylic hexameter	masculine penthemimeral, hepthemimeral, trithemimeral
τοίου μιν θάρσευς πλῆσε φρένας ἀμφὶ μελαίνας,	-- - -- -- uu -u u--	dactylic hexameter	masculine penthemimeral, hepthemimeral, trithemimeral
βῆ δ’ἐπὶ Πατρόκλῳ, καὶ ἀκόντισε δουρὶ φαεινῷ.	- uu --- u u-uu -u u--	dactylic hexameter	masculine penthemimeral
ἔσκε δ’ἐνὶ Τρώεσσι Ποδῆς υἱὸς Ἠετίωνος	-u u- --u u- uu -uu--	dactylic hexameter	feminine penthemimeral, hepthemimeral, trithemimeral
ἀφνειός τ’ἀγαθός τε· μάλιστα δέ μιν τίεν Ἕκτωρ	--- uu- u u-u u - uu --	dactylic hexameter	masculine penthemimeral, trithemimeral
δήμου, ἐπεί οἱ ἑταῖρος ἔην φίλος εἰλαπιναστής·	-u u- u u-u u- uu -uu--	dactylic hexameter	feminine penthemimeral, hepthemimeral, trithemimeral
τόν ῥα κατὰ ζωστῆρα βάλε ξανθὸς Μενέλαος	- u u- --u u- -- uu--	dactylic hexameter	feminine penthemimeral, hepthemimeral, trithemimeral
ἀΐξαντα φόβον δέ, διὰ πρὸ δὲ χαλκὸν ἔλασσε·	---u u- u u- u u -u u--	dactylic hexameter	masculine penthemimeral, hepthemimeral
δούπησεν δὲ πεσών· ἀτὰρ Ἀτρεΐδης Μενέλαος	--- u u- uu -uu- uu--	dactylic hexameter	masculine penthemimeral, trithemimeral
νεκρὸν ὑπ’ ἐκ Τρώων ἔρυσεν μετὰ ἔθνος ἑταίρων.	-u u - -- uu- uu -u u--	dactylic hexameter	masculine penthemimeral, hepthemimeral, trithemimeral
Ἕκτορα δ’ἐγγύθεν ἱστάμενος ὄτρυνεν Ἀπόλλων	-uu -uu -uu- --u u--	dactylic hexameter	hepthemimeral
Φαίνοπι Ἀσιάδῃ ἐναλίγκιος, ὅς οἱ ἁπάντων	-uu -uu- uu-uu - u u--	dactylic hexameter	masculine penthemimeral
ξείνων φίλτατος ἔσκεν Ἀβυδόθι οἰκία ναίων·	-- -uu -u u-uu -uu --	dactylic hexameter	feminine penthemimeral
τῷ μιν ἐεισάμενος προσέφη ἑκάεργος Ἀπόλλων·	- u u-uu- uu- uu-u u--	dactylic hexameter	masculine penthemimeral, hepthemimeral
Ἕκτορ τίς κέ σ’ἔτ’ ἄλλος Ἀχαιῶν ταρβήσειεν;	-- - u u -u u-- ----	dactylic hexameter	feminine penthemimeral, trithemimeral
οἷον δὴ Μενέλαον ὑπέτρεσας, ὃς τὸ πάρος γε	-- - uu-u u-uu - u u- -	dactylic hexameter	feminine penthemimeral, trithemimeral
μαλθακὸς αἰχμητής· νῦν δ’οἴχεται οἶος ἀείρας	-uu --- - -uu -u u--	dactylic hexameter	masculine penthemimeral
νεκρὸν ὑπ’ ἐκ Τρώων, σὸν δ’ἔκτανε πιστὸν ἑταῖρον	-u u - -- - -uu -u u--	dactylic hexameter	masculine penthemimeral, trithemimeral
ἐσθλὸν ἐνὶ προμάχοισι Ποδῆν υἱὸν Ἠετίωνος.	-u u- uu-u u- uu -uu--	dactylic hexameter	feminine penthemimeral, hepthemimeral, trithemimeral
ὣς φάτο, τὸν δ’ἄχεος νεφέλη ἐκάλυψε μέλαινα,	- uu - uu- uu- uu-u u--	dactylic hexameter	masculine penthemimeral, hepthemimeral, trithemimeral
βῆ δὲ διὰ προμάχων κεκορυθμένος αἴθοπι χαλκῷ.	- u u- uu- uu-uu -uu --	dactylic hexameter	masculine penthemimeral, trithemimeral
καὶ τότ’ ἄρα Κρονίδης ἕλετ’ αἰγίδα θυσσανόεσσαν	- u u- uu- uu -uu -uu--	dactylic hexameter	masculine penthemimeral, trithemimeral
μαρμαρέην, Ἴδην δὲ κατὰ νεφέεσσι κάλυψεν,	-uu- -- u u- uu-u u--	dactylic hexameter	masculine penthemimeral, hepthemimeral, trithemimeral
ἀστράψας δὲ μάλα μεγάλ’ ἔκτυπε, τὴν δὲ τίναξε,	--- u u- uu -uu - u u--	dactylic hexameter	masculine penthemimeral, trithemimeral
νίκην δὲ Τρώεσσι δίδου, ἐφόβησε δ’Ἀχαιούς.	-- - --u u- uu-u u--	dactylic hexameter	feminine penthemimeral, hepthemimeral, trithemimeral
πρῶτος Πηνέλεως Βοιώτιος ἦρχε φόβοιο.	-- -uu- --uu -u u--	dactylic hexameter	masculine penthemimeral
βλῆτο γὰρ ὦμον δουρὶ πρόσω τετραμμένος αἰεὶ	-u u -- -u u- --uu --	dactylic hexameter	feminine penthemimeral, hepthemimeral
ἄκρον ἐπιλίγδην· γράψεν δέ οἱ ὀστέον ἄχρις	-u u--- -- u u -uu --	dactylic hexameter	masculine penthemimeral, hepthemimeral
αἰχμὴ Πουλυδάμαντος· ὃ γάρ ῥ’ἔβαλε σχεδὸν ἐλθών.	-- -uu-u u - uu- uu --	dactylic hexameter	feminine penthemimeral, hepthemimeral
Λήϊτον αὖθ’ Ἕκτωρ σχεδὸν οὔτασε χεῖρ’ ἐπὶ καρπῷ	-uu - -- uu -uu - uu --	dactylic hexameter	masculine penthemimeral, trithemimeral
υἱὸν Ἀλεκτρυόνος μεγαθύμου, παῦσε δὲ χάρμης·	-u u-uu- uu-- -u u --	dactylic hexameter	masculine penthemimeral
τρέσσε δὲ παπτήνας, ἐπεὶ οὐκέτι ἔλπετο θυμῷ	-u u --- uu -uu -uu --	dactylic hexameter	masculine penthemimeral
ἔγχος ἔχων ἐν χειρὶ μαχήσεσθαι Τρώεσσιν.	-u u- - -u u--- ---	dactylic hexameter	feminine penthemimeral, trithemimeral
Ἕκτορα δ’Ἰδομενεὺς μετὰ Λήϊτον ὁρμηθέντα	-uu -uu- uu -uu ----	dactylic hexameter	masculine penthemimeral
βεβλήκει θώρηκα κατὰ στῆθος παρὰ μαζόν·	--- --u u- -- uu --	dactylic hexameter	feminine penthemimeral, hepthemimeral, trithemimeral
ἐν καυλῷ δ’ἐάγη δολιχὸν δόρυ, τοὶ δὲ βόησαν	- -- uu- uu- uu - u u--	dactylic hexameter	masculine penthemimeral, hepthemimeral, trithemimeral
Τρῶες· ὃ δ’Ἰδομενῆος ἀκόντισε Δευκαλίδαο	-u u -uu-u u-uu -uu--	dactylic hexameter	feminine penthemimeral
δίφρῳ ἐφεσταότος· τοῦ μέν ῥ’ἀπὸ τυτθὸν ἅμαρτεν·	-u u-uu- - - uu -u u--	dactylic hexameter	masculine penthemimeral, hepthemimeral
αὐτὰρ ὃ Μηριόναο ὀπάονά θ’ἡνίοχόν τε	-u u -uu-u u-uu -uu- -	dactylic hexameter	feminine penthemimeral
Κοίρανον, ὅς ῥ’ἐκ Λύκτου ἐϋκτιμένης ἕπετ’ αὐτῷ·	-uu - - -u u-uu- uu --	dactylic hexameter	feminine penthemimeral, trithemimeral
πεζὸς γὰρ τὰ πρῶτα λιπὼν νέας ἀμφιελίσσας	-- - - -u u- uu -uu--	dactylic hexameter	feminine penthemimeral, hepthemimeral, trithemimeral
ἤλυθε, καί κε Τρωσὶ μέγα κράτος ἐγγυάλιξεν,	-uu - - -u u- uu -uu--	dactylic hexameter	feminine penthemimeral, hepthemimeral, trithemimeral
εἰ μὴ Κοίρανος ὦκα ποδώκεας ἤλασεν ἵππους·	- - -uu -u u-uu -uu --	dactylic hexameter	feminine penthemimeral
καὶ τῷ μὲν φάος ἦλθεν, ἄμυνε δὲ νηλεὲς ἦμαρ,	- - - uu -u u-u u -uu --	dactylic hexameter	feminine penthemimeral, trithemimeral
αὐτὸς δ’ὤλεσε θυμὸν ὑφ’ Ἕκτορος ἀνδροφόνοιο·	-- -uu -u u -uu -uu--	dactylic hexameter	feminine penthemimeral
τὸν βάλ’ ὑπὸ γναθμοῖο καὶ οὔατος, ἐκ δ’ἄρ’ ὀδόντας	- u u- --u u -uu - u u--	dactylic hexameter	feminine penthemimeral, trithemimeral
ὦσε δόρυ πρυμνόν, διὰ δὲ γλῶσσαν τάμε μέσσην.	-u u- -- uu - -- uu --	dactylic hexameter	masculine penthemimeral, hepthemimeral, trithemimeral
ἤριπε δ’ἐξ ὀχέων, κατὰ δ’ἡνία χεῦεν ἔραζε.	-uu - uu- uu -uu -u u--	dactylic hexameter	masculine penthemimeral, trithemimeral
καὶ τά γε Μηριόνης ἔλαβεν χείρεσσι φίλῃσι	- u u -uu- uu- --u u--	dactylic hexameter	masculine penthemimeral, hepthemimeral
κύψας ἐκ πεδίοιο, καὶ Ἰδομενῆα προσηύδα·	-- - uu-u u -uu-u u--	dactylic hexameter	feminine penthemimeral, trithemimeral
μάστιε νῦν εἷός κε θοὰς ἐπὶ νῆας ἵκηαι·	-uu - -- u u- uu -u u--	dactylic hexameter	masculine penthemimeral, hepthemimeral, trithemimeral
γιγνώσκεις δὲ καὶ αὐτὸς ὅ τ’οὐκέτι κάρτος Ἀχαιῶν.	--- u u -u u -uu -u u--	dactylic hexameter	feminine penthemimeral, trithemimeral
ὣς ἔφατ’, Ἰδομενεὺς δ’ἵμασεν καλλίτριχας ἵππους	- uu -uu- uu- --uu --	dactylic hexameter	masculine penthemimeral, hepthemimeral
νῆας ἔπι γλαφυράς· δὴ γὰρ δέος ἔμπεσε θυμῷ.	-u u- uu- - - uu -uu --	dactylic hexameter	masculine penthemimeral, hepthemimeral, trithemimeral
οὐδ’ ἔλαθ’ Αἴαντα μεγαλήτορα καὶ Μενέλαον	- uu --- uu-uu - uu--	dactylic hexameter	masculine penthemimeral
Ζεύς, ὅτε δὴ Τρώεσσι δίδου ἑτεραλκέα νίκην.	- uu - --u u- uu-uu --	dactylic hexameter	feminine penthemimeral, hepthemimeral, trithemimeral
τοῖσι δὲ μύθων ἦρχε μέγας Τελαμώνιος Αἴας·	-u u -- -u u- uu-uu --	dactylic hexameter	feminine penthemimeral, hepthemimeral
ὢ πόποι ἤδη μέν κε καὶ ὃς μάλα νήπιός ἐστι	- uu -- - u u - uu -uu --	dactylic hexameter	masculine penthemimeral, hepthemimeral
γνοίη ὅτι Τρώεσσι πατὴρ Ζεὺς αὐτὸς ἀρήγει.	-u u- --u u- - -u u--	dactylic hexameter	feminine penthemimeral, hepthemimeral, trithemimeral
τῶν μὲν γὰρ πάντων βέλε’ ἅπτεται ὅς τις ἀφήῃ	- - - -- uu -uu - u u--	dactylic hexameter	masculine penthemimeral, trithemimeral
ἢ κακὸς ἢ ἀγαθός· Ζεὺς δ’ἔμπης πάντ’ ἰθύνει·	- uu - uu- - -- - ---	dactylic hexameter	masculine penthemimeral, trithemimeral
ἡμῖν δ’αὔτως πᾶσιν ἐτώσια πίπτει ἔραζε.	-- -- -u u-uu -u u--	dactylic hexameter	feminine penthemimeral
ἀλλ’ ἄγετ’ αὐτοί περ φραζώμεθα μῆτιν ἀρίστην,	- uu -- - --uu -u u--	dactylic hexameter	masculine penthemimeral
ἠμὲν ὅπως τὸν νεκρὸν ἐρύσσομεν, ἠδὲ καὶ αὐτοὶ	-u u- - -u u-uu -u u --	dactylic hexameter	feminine penthemimeral, trithemimeral
χάρμα φίλοις ἑτάροισι γενώμεθα νοστήσαντες,	-u u- uu-u u-uu ----	dactylic hexameter	feminine penthemimeral, trithemimeral
οἵ που δεῦρ’ ὁρόωντες ἀκηχέδατ’, οὐδ’ ἔτι φασὶν	- - - uu-u u-uu - uu --	dactylic hexameter	feminine penthemimeral, trithemimeral
Ἕκτορος ἀνδροφόνοιο μένος καὶ χεῖρας ἀάπτους	-uu -uu-u u- - -u u--	dactylic hexameter	feminine penthemimeral, hepthemimeral
σχήσεσθ’, ἀλλ’ ἐν νηυσὶ μελαίνῃσιν πεσέεσθαι.	-- - - -u u--- uu--	dactylic hexameter	feminine penthemimeral, trithemimeral
εἴη δ’ὅς τις ἑταῖρος ἀπαγγείλειε τάχιστα	-- - u u-u u---u u--	dactylic hexameter	feminine penthemimeral, trithemimeral
Πηλεΐδῃ, ἐπεὶ οὔ μιν ὀΐομαι οὐδὲ πεπύσθαι	-uu- uu - u u-uu -u u--	dactylic hexameter	masculine penthemimeral, trithemimeral
λυγρῆς ἀγγελίης, ὅτι οἱ φίλος ὤλεθ’ ἑταῖρος.	-- -uu- uu - uu -u u--	dactylic hexameter	masculine penthemimeral, hepthemimeral
ἀλλ’ οὔ πῃ δύναμαι ἰδέειν τοιοῦτον Ἀχαιῶν·	- - - uu- uu- --u u--	dactylic hexameter	masculine penthemimeral, hepthemimeral, trithemimeral
ἠέρι γὰρ κατέχονται ὁμῶς αὐτοί τε καὶ ἵπποι.	-uu - uu-u u- -- u u --	dactylic hexameter	feminine penthemimeral, hepthemimeral, trithemimeral
Ζεῦ πάτερ ἀλλὰ σὺ ῥῦσαι ὑπ’ ἠέρος υἷας Ἀχαιῶν,	- uu -u u -u u -uu -u u--	dactylic hexameter	feminine penthemimeral
ποίησον δ’αἴθρην, δὸς δ’ὀφθαλμοῖσιν ἰδέσθαι·	--- -- - ---u u--	dactylic hexameter	masculine penthemimeral, trithemimeral
ἐν δὲ φάει καὶ ὄλεσσον, ἐπεί νύ τοι εὔαδεν οὕτως.	- u u- u u-u u- u u -uu --	dactylic hexameter	feminine penthemimeral, hepthemimeral, trithemimeral
ὣς φάτο, τὸν δὲ πατὴρ ὀλοφύρατο δάκρυ χέοντα·	- uu - u u- uu-uu -u u--	dactylic hexameter	masculine penthemimeral, trithemimeral
αὐτίκα δ’ἠέρα μὲν σκέδασεν καὶ ἀπῶσεν ὀμίχλην,	-uu -uu - uu- u u-u u--	dactylic hexameter	masculine penthemimeral, hepthemimeral
ἠέλιος δ’ἐπέλαμψε, μάχη δ’ἐπὶ πᾶσα φαάνθη·	-uu- uu-u u- uu -u u--	dactylic hexameter	feminine penthemimeral, hepthemimeral, trithemimeral
καὶ τότ’ ἄρ’ Αἴας εἶπε βοὴν ἀγαθὸν Μενέλαον·	- u u -- -u u- uu- uu--	dactylic hexameter	feminine penthemimeral, hepthemimeral
σκέπτεο νῦν Μενέλαε διοτρεφὲς αἴ κεν ἴδηαι	-uu - uu-u u-uu - u u--	dactylic hexameter	feminine penthemimeral, trithemimeral
ζωὸν ἔτ’ Ἀντίλοχον μεγαθύμου Νέστορος υἱόν,	-u u -uu- uu-- -uu --	dactylic hexameter	masculine penthemimeral
ὄτρυνον δ’Ἀχιλῆϊ δαΐφρονι θᾶσσον ἰόντα	--- uu-u u-uu -u u--	dactylic hexameter	feminine penthemimeral, trithemimeral
εἰπεῖν ὅττι ῥά οἱ πολὺ φίλτατος ὤλεθ’ ἑταῖρος.	-- -u u - uu -uu -u u--	dactylic hexameter	masculine penthemimeral
ὣς ἔφατ’, οὐδ’ ἀπίθησε βοὴν ἀγαθὸς Μενέλαος,	- uu - uu-u u- uu- uu--	dactylic hexameter	feminine penthemimeral, hepthemimeral, trithemimeral
βῆ δ’ἰέναι ὥς τίς τε λέων ἀπὸ μεσσαύλοιο,	- uu- - - u u- uu ----	dactylic hexameter	masculine penthemimeral, hepthemimeral, trithemimeral
ὅς τ’ἐπεὶ ἄρ κε κάμῃσι κύνας τ’ἄνδρας τ’ἐρεθίζων,	- uu - u u-u u- -- uu--	dactylic hexameter	feminine penthemimeral, hepthemimeral, trithemimeral
οἵ τέ μιν οὐκ εἰῶσι βοῶν ἐκ πῖαρ ἑλέσθαι	- u u - --u u- - -u u--	dactylic hexameter	feminine penthemimeral, hepthemimeral, trithemimeral
πάννυχοι ἐγρήσσοντες· ὃ δὲ κρειῶν ἐρατίζων	-uu ---u u - -- uu--	dactylic hexameter	feminine penthemimeral, hepthemimeral
ἰθύει, ἀλλ’ οὔ τι πρήσσει· θαμέες γὰρ ἄκοντες	-uu - - - -- uu- u u--	dactylic hexameter	masculine penthemimeral, hepthemimeral, trithemimeral
ἀντίον ἀΐσσουσι θρασειάων ἀπὸ χειρῶν,	-uu ---u u--- uu --	dactylic hexameter	feminine penthemimeral
καιόμεναί τε δεταί, τάς τε τρεῖ ἐσσύμενός περ·	-uu- u u- - - - -uu- -	dactylic hexameter	masculine penthemimeral, hepthemimeral, trithemimeral
ἠῶθεν δ’ἀπονόσφιν ἔβη τετιηότι θυμῷ·	--- uu-u u- uu-uu --	dactylic hexameter	feminine penthemimeral, hepthemimeral, trithemimeral
ὣς ἀπὸ Πατρόκλοιο βοὴν ἀγαθὸς Μενέλαος	- uu ---u u- uu- uu--	dactylic hexameter	feminine penthemimeral, hepthemimeral
ἤϊε πόλλ’ ἀέκων· περὶ γὰρ δίε μή μιν Ἀχαιοὶ	-uu - uu- uu - uu - u u--	dactylic hexameter	masculine penthemimeral, hepthemimeral, trithemimeral
ἀργαλέου πρὸ φόβοιο ἕλωρ δηίοισι λίποιεν.	-uu- u u-u u- --u u--	dactylic hexameter	feminine penthemimeral, hepthemimeral, trithemimeral
πολλὰ δὲ Μηριόνῃ τε καὶ Αἰάντεσσ’ ἐπέτελλεν·	-u u -uu- u u --- uu--	dactylic hexameter	masculine penthemimeral
Αἴαντ’ Ἀργείων ἡγήτορε Μηριόνη τε	-- --- --uu -uu- -	dactylic hexameter	masculine penthemimeral
νῦν τις ἐνηείης Πατροκλῆος δειλοῖο	- u u--- ---- ---	dactylic hexameter	masculine penthemimeral
μνησάσθω· πᾶσιν γὰρ ἐπίστατο μείλιχος εἶναι	--- -- u u-uu -uu --	dactylic hexameter	masculine penthemimeral, trithemimeral
ζωὸς ἐών· νῦν αὖ θάνατος καὶ μοῖρα κιχάνει.	-u u- - - uu- - -u u--	dactylic hexameter	masculine penthemimeral, hepthemimeral, trithemimeral
ὣς ἄρα φωνήσας ἀπέβη ξανθὸς Μενέλαος,	- uu --- uu- -- uu--	dactylic hexameter	masculine penthemimeral, hepthemimeral
πάντοσε παπταίνων ὥς τ’αἰετός, ὅν ῥά τέ φασιν	-uu --- - -uu - u u --	dactylic hexameter	masculine penthemimeral
ὀξύτατον δέρκεσθαι ὑπουρανίων πετεηνῶν,	-uu- --u u-uu- uu--	dactylic hexameter	feminine penthemimeral, trithemimeral
ὅν τε καὶ ὑψόθ’ ἐόντα πόδας ταχὺς οὐκ ἔλαθε πτὼξ	- u u -u u-u u- uu - uu- -	dactylic hexameter	feminine penthemimeral, hepthemimeral
θάμνῳ ὑπ’ ἀμφικόμῳ κατακείμενος, ἀλλά τ’ἐπ’ αὐτῷ	-u u -uu- uu-uu -u u --	dactylic hexameter	masculine penthemimeral
ἔσσυτο, καί τέ μιν ὦκα λαβὼν ἐξείλετο θυμόν.	-uu - u u -u u- --uu --	dactylic hexameter	feminine penthemimeral, hepthemimeral, trithemimeral
ὣς τότε σοὶ Μενέλαε διοτρεφὲς ὄσσε φαεινὼ	- uu - uu-u u-uu -u u--	dactylic hexameter	feminine penthemimeral, trithemimeral
πάντοσε δινείσθην πολέων κατὰ ἔθνος ἑταίρων,	-uu --- uu- uu -u u--	dactylic hexameter	masculine penthemimeral, hepthemimeral
εἴ που Νέστορος υἱὸν ἔτι ζώοντα ἴδοιτο.	- - -uu -u u- --u u--	dactylic hexameter	feminine penthemimeral, hepthemimeral
τὸν δὲ μάλ’ αἶψ’ ἐνόησε μάχης ἐπ’ ἀριστερὰ πάσης	- u u - uu-u u- u u-uu --	dactylic hexameter	feminine penthemimeral, hepthemimeral, trithemimeral
θαρσύνονθ’ ἑτάρους καὶ ἐποτρύνοντα μάχεσθαι,	--- uu- u u---u u--	dactylic hexameter	masculine penthemimeral, trithemimeral
ἀγχοῦ δ’ἱστάμενος προσέφη ξανθὸς Μενέλαος·	-- -uu- uu- -- uu--	dactylic hexameter	masculine penthemimeral, hepthemimeral
Ἀντίλοχ’ εἰ δ’ἄγε δεῦρο διοτρεφὲς ὄφρα πύθηαι	-uu - uu -u u-uu -u u--	dactylic hexameter	feminine penthemimeral, trithemimeral
λυγρῆς ἀγγελίης, ἣ μὴ ὤφελλε γενέσθαι.	-- -uu- - - --u u--	dactylic hexameter	masculine penthemimeral, hepthemimeral
ἤδη μὲν σὲ καὶ αὐτὸν ὀΐομαι εἰσορόωντα	-- - u u -u u-uu -uu--	dactylic hexameter	feminine penthemimeral, trithemimeral
γιγνώσκειν ὅτι πῆμα θεὸς Δαναοῖσι κυλίνδει,	--- uu -u u- uu-u u--	dactylic hexameter	feminine penthemimeral, hepthemimeral, trithemimeral
νίκη δὲ Τρώων· πέφαται δ’ὤριστος Ἀχαιῶν	-- - -- uu- --u u--	dactylic hexameter	masculine penthemimeral, hepthemimeral, trithemimeral
Πάτροκλος, μεγάλη δὲ ποθὴ Δαναοῖσι τέτυκται.	--- uu- u u- uu-u u--	dactylic hexameter	masculine penthemimeral, hepthemimeral, trithemimeral
ἀλλὰ σύ γ’αἶψ’ Ἀχιλῆϊ θέων ἐπὶ νῆας Ἀχαιῶν	-u u - uu-u u- uu -u u--	dactylic hexameter	feminine penthemimeral, hepthemimeral, trithemimeral
εἰπεῖν, αἴ κε τάχιστα νέκυν ἐπὶ νῆα σαώσῃ	-- - u u-u u- uu -u u--	dactylic hexameter	feminine penthemimeral, hepthemimeral, trithemimeral
γυμνόν· ἀτὰρ τά γε τεύχε’ ἔχει κορυθαίολος Ἕκτωρ.	-u u- u u -u u- uu-uu --	dactylic hexameter	feminine penthemimeral, hepthemimeral, trithemimeral
ὣς ἔφατ’, Ἀντίλοχος δὲ κατέστυγε μῦθον ἀκούσας·	- uu -uu- u u-uu -u u--	dactylic hexameter	masculine penthemimeral
δὴν δέ μιν ἀμφασίη ἐπέων λάβε, τὼ δέ οἱ ὄσσε	- u u -uu- uu- uu - u u --	dactylic hexameter	masculine penthemimeral, hepthemimeral
δακρυόφι πλῆσθεν, θαλερὴ δέ οἱ ἔσχετο φωνή.	-uu- -- uu- u u -uu --	dactylic hexameter	masculine penthemimeral, hepthemimeral, trithemimeral
ἀλλ’ οὐδ’ ὧς Μενελάου ἐφημοσύνης ἀμέλησε,	- - - uu-u u-uu- uu--	dactylic hexameter	feminine penthemimeral, trithemimeral
βῆ δὲ θέειν, τὰ δὲ τεύχε’ ἀμύμονι δῶκεν ἑταίρῳ	- u u- u u -u u-uu -u u--	dactylic hexameter	feminine penthemimeral, trithemimeral
Λαοδόκῳ, ὅς οἱ σχεδὸν ἔστρεφε μώνυχας ἵππους.	-uu- - - uu -uu -uu --	dactylic hexameter	masculine penthemimeral, trithemimeral
τὸν μὲν δάκρυ χέοντα πόδες φέρον ἐκ πολέμοιο	- - -u u-u u- uu - uu--	dactylic hexameter	feminine penthemimeral, hepthemimeral
Πηλεΐδῃ Ἀχιλῆϊ κακὸν ἔπος ἀγγελέοντα.	-uu- uu-u u- uu -uu--	dactylic hexameter	feminine penthemimeral, hepthemimeral, trithemimeral
οὐδ’ ἄρα σοὶ Μενέλαε διοτρεφὲς ἤθελε θυμὸς	- uu - uu-u u-uu -uu --	dactylic hexameter	feminine penthemimeral, trithemimeral
τειρομένοις ἑτάροισιν ἀμυνέμεν, ἔνθεν ἀπῆλθεν	-uu- uu-u u-uu -u u--	dactylic hexameter	feminine penthemimeral, trithemimeral
Ἀντίλοχος, μεγάλη δὲ ποθὴ Πυλίοισιν ἐτύχθη·	-uu- uu- u u- uu-u u--	dactylic hexameter	masculine penthemimeral, hepthemimeral, trithemimeral
ἀλλ’ ὅ γε τοῖσιν μὲν Θρασυμήδεα δῖον ἀνῆκεν,	- u u -- - uu-uu -u u--	dactylic hexameter	masculine penthemimeral
αὐτὸς δ’αὖτ’ ἐπὶ Πατρόκλῳ ἥρωϊ βεβήκει,	-- - uu --- --u u--	dactylic hexameter	hepthemimeral, trithemimeral
στῆ δὲ παρ’ Αἰάντεσσι θέων, εἶθαρ δὲ προσηύδα·	- u u ---u u- -- u u--	dactylic hexameter	feminine penthemimeral, hepthemimeral
κεῖνον μὲν δὴ νηυσὶν ἐπιπροέηκα θοῇσιν	-- - - -u u-uu-u u--	dactylic hexameter	feminine penthemimeral, trithemimeral
ἐλθεῖν εἰς Ἀχιλῆα πόδας ταχύν· οὐδέ μιν οἴω	-- - uu-u u- uu -u u --	dactylic hexameter	feminine penthemimeral, hepthemimeral, trithemimeral
νῦν ἰέναι μάλα περ κεχολωμένον Ἕκτορι δίῳ·	- uu- uu - uu-uu -uu --	dactylic hexameter	masculine penthemimeral, trithemimeral
οὐ γάρ πως ἂν γυμνὸς ἐὼν Τρώεσσι μάχοιτο.	- - - - -u u- --u u--	dactylic hexameter	feminine penthemimeral, hepthemimeral, trithemimeral
ἡμεῖς δ’αὐτοί περ φραζώμεθα μῆτιν ἀρίστην,	-- -- - --uu -u u--	dactylic hexameter	masculine penthemimeral
ἠμὲν ὅπως τὸν νεκρὸν ἐρύσσομεν, ἠδὲ καὶ αὐτοὶ	-u u- - -u u-uu -u u --	dactylic hexameter	feminine penthemimeral, trithemimeral
Τρώων ἐξ ἐνοπῆς θάνατον καὶ κῆρα φύγωμεν.	-- - uu- uu- - -u u--	dactylic hexameter	masculine penthemimeral, hepthemimeral, trithemimeral
τὸν δ’ἠμείβετ’ ἔπειτα μέγας Τελαμώνιος Αἴας·	- --u u-u u- uu-uu --	dactylic hexameter	feminine penthemimeral, hepthemimeral
πάντα κατ’ αἶσαν ἔειπες ἀγακλεὲς ὦ Μενέλαε·	-u u -u u-u u-uu - uu--	dactylic hexameter	feminine penthemimeral
ἀλλὰ σὺ μὲν καὶ Μηριόνης ὑποδύντε μάλ’ ὦκα	-u u - - -uu- uu-u u --	dactylic hexameter	hepthemimeral, trithemimeral
νεκρὸν ἀείραντες φέρετ’ ἐκ πόνου· αὐτὰρ ὄπισθε	-u u--- uu - uu -u u--	dactylic hexameter	masculine penthemimeral, hepthemimeral
νῶϊ μαχησόμεθα Τρωσίν τε καὶ Ἕκτορι δίῳ	-u u-uu- -- u u -uu --	dactylic hexameter	masculine penthemimeral, hepthemimeral
ἶσον θυμὸν ἔχοντες ὁμώνυμοι, οἳ τὸ πάρος περ	-- -u u-u u-uu - u u- -	dactylic hexameter	feminine penthemimeral
μίμνομεν ὀξὺν Ἄρηα παρ’ ἀλλήλοισι μένοντες.	-uu -u u-u u ---u u--	dactylic hexameter	feminine penthemimeral
ὣς ἔφαθ’, οἳ δ’ἄρα νεκρὸν ἀπὸ χθονὸς ἀγκάζοντο	- uu - uu -u u- uu ----	dactylic hexameter	feminine penthemimeral, hepthemimeral, trithemimeral
ὕψι μάλα μεγάλως· ἐπὶ δ’ἴαχε λαὸς ὄπισθε	-u u- uu- uu -uu -u u--	dactylic hexameter	masculine penthemimeral, trithemimeral
Τρωϊκός, ὡς εἴδοντο νέκυν αἴροντας Ἀχαιούς.	-uu - --u u- --u u--	dactylic hexameter	feminine penthemimeral, hepthemimeral, trithemimeral
ἴθυσαν δὲ κύνεσσιν ἐοικότες, οἵ τ’ἐπὶ κάπρῳ	--- u u-u u-uu - uu --	dactylic hexameter	feminine penthemimeral, trithemimeral
βλημένῳ ἀΐξωσι πρὸ κούρων θηρητήρων·	-uu ---u u -- ----	dactylic hexameter	feminine penthemimeral
ἕως μὲν γάρ τε θέουσι διαρραῖσαι μεμαῶτες,	- - - u u-u u--- uu--	dactylic hexameter	feminine penthemimeral, trithemimeral
ἀλλ’ ὅτε δή ῥ’ἐν τοῖσιν ἑλίξεται ἀλκὶ πεποιθώς,	- uu - - -u u-uu -u u--	dactylic hexameter	feminine penthemimeral, trithemimeral
ἄψ τ’ἀνεχώρησαν διά τ’ἔτρεσαν ἄλλυδις ἄλλος.	- uu--- uu -uu -uu --	dactylic hexameter	masculine penthemimeral
ὣς Τρῶες εἷος μὲν ὁμιλαδὸν αἰὲν ἕποντο	- -- -- u u-uu -u u--	dactylic hexameter	masculine penthemimeral, trithemimeral
νύσσοντες ξίφεσίν τε καὶ ἔγχεσιν ἀμφιγύοισιν·	--- uu- u u -uu -uu--	dactylic hexameter	masculine penthemimeral, trithemimeral
ἀλλ’ ὅτε δή ῥ’Αἴαντε μεταστρεφθέντε κατ’ αὐτοὺς	- uu - --u u---u u --	dactylic hexameter	feminine penthemimeral, trithemimeral
σταίησαν, τῶν δὲ τράπετο χρώς, οὐδέ τις ἔτλη	--- - - uu- - -u u --	dactylic hexameter	masculine penthemimeral, hepthemimeral, trithemimeral
πρόσσω ἀΐξας περὶ νεκροῦ δηριάασθαι.	-- --- uu -- -uu--	dactylic hexameter	masculine penthemimeral
ὣς οἵ γ’ἐμμεμαῶτε νέκυν φέρον ἐκ πολέμοιο	- - -uu-u u- uu - uu--	dactylic hexameter	feminine penthemimeral, hepthemimeral
νῆας ἔπι γλαφυράς· ἐπὶ δὲ πτόλεμος τέτατό σφιν	-u u- uu- uu - uu- uu- -	dactylic hexameter	masculine penthemimeral, hepthemimeral, trithemimeral
ἄγριος ἠΰτε πῦρ, τό τ’ἐπεσσύμενον πόλιν ἀνδρῶν	-uu -uu - u u-uu- uu --	dactylic hexameter	masculine penthemimeral
ὄρμενον ἐξαίφνης φλεγέθει, μινύθουσι δὲ οἶκοι	-uu --- uu- uu-u u --	dactylic hexameter	masculine penthemimeral, hepthemimeral
ἐν σέλαϊ μεγάλῳ· τὸ δ’ἐπιβρέμει ἲς ἀνέμοιο.	- uu- uu- u u-uu - uu--	dactylic hexameter	masculine penthemimeral, trithemimeral
ὣς μὲν τοῖς ἵππων τε καὶ ἀνδρῶν αἰχμητάων	- - - -- u u -- ----	dactylic hexameter	masculine penthemimeral, trithemimeral
ἀζηχὴς ὀρυμαγδὸς ἐπήϊεν ἐρχομένοισιν·	--- uu-u u-uu -uu--	dactylic hexameter	feminine penthemimeral, trithemimeral
οἳ δ’ὥς θ’ἡμίονοι κρατερὸν μένος ἀμφιβαλόντες	- - -uu- uu- uu -uu--	dactylic hexameter	masculine penthemimeral, hepthemimeral
ἕλκωσ’ ἐξ ὄρεος κατὰ παιπαλόεσσαν ἀταρπὸν	-- - uu- uu -uu-u u--	dactylic hexameter	masculine penthemimeral, trithemimeral
ἢ δοκὸν ἠὲ δόρυ μέγα νήϊον· ἐν δέ τε θυμὸς	- uu -u u- uu -uu - u u --	dactylic hexameter	masculine penthemimeral
τείρεθ’ ὁμοῦ καμάτῳ τε καὶ ἱδρῷ σπευδόντεσσιν·	-u u- uu- u u -- ----	dactylic hexameter	masculine penthemimeral, trithemimeral
ὣς οἵ γ’ἐμμεμαῶτε νέκυν φέρον. αὐτὰρ ὄπισθεν	- - -uu-u u- uu -u u--	dactylic hexameter	feminine penthemimeral, hepthemimeral
Αἴαντ’ ἰσχανέτην, ὥς τε πρὼν ἰσχάνει ὕδωρ	-- -uu- - - - -uu --	dactylic hexameter	masculine penthemimeral, hepthemimeral
ὑλήεις πεδίοιο διαπρύσιον τετυχηκώς,	--- uu-u u-uu- uu--	dactylic hexameter	feminine penthemimeral, trithemimeral
ὅς τε καὶ ἰφθίμων ποταμῶν ἀλεγεινὰ ῥέεθρα	- u u --- uu- uu-u u--	dactylic hexameter	masculine penthemimeral, hepthemimeral
ἴσχει, ἄφαρ δέ τε πᾶσι ῥόον πεδίον δὲ τίθησι	-u u- u u -u u- uu- u u--	dactylic hexameter	feminine penthemimeral, hepthemimeral, trithemimeral
πλάζων· οὐδέ τί μιν σθένεϊ ῥηγνῦσι ῥέοντες·	-- -u u - uu- --u u--	dactylic hexameter	masculine penthemimeral, hepthemimeral
ὣς αἰεὶ Αἴαντε μάχην ἀνέεργον ὀπίσσω	- -- --u u- uu-u u--	dactylic hexameter	feminine penthemimeral, hepthemimeral, trithemimeral
Τρώων· οἳ δ’ἅμ’ ἕποντο, δύω δ’ἐν τοῖσι μάλιστα	-- - u u-u u- - -u u--	dactylic hexameter	feminine penthemimeral, hepthemimeral, trithemimeral
Αἰνείας τ’Ἀγχισιάδης καὶ φαίδιμος Ἕκτωρ.	--- --uu- - -uu --	dactylic hexameter	hepthemimeral, trithemimeral
τῶν δ’ὥς τε ψαρῶν νέφος ἔρχεται ἠὲ κολοιῶν	- - - -- uu -uu -u u--	dactylic hexameter	masculine penthemimeral, trithemimeral
οὖλον κεκλήγοντες, ὅτε προΐδωσιν ἰόντα	-- ---u u- uu-u u--	dactylic hexameter	feminine penthemimeral, hepthemimeral
κίρκον, ὅ τε σμικρῇσι φόνον φέρει ὀρνίθεσσιν,	-u u - --u u- uu ----	dactylic hexameter	feminine penthemimeral, hepthemimeral, trithemimeral
ὣς ἄρ’ ὑπ’ Αἰνείᾳ τε καὶ Ἕκτορι κοῦροι Ἀχαιῶν	- u u --- u u -uu -u u--	dactylic hexameter	masculine penthemimeral
οὖλον κεκλήγοντες ἴσαν, λήθοντο δὲ χάρμης.	-- ---u u- --u u --	dactylic hexameter	feminine penthemimeral, hepthemimeral
πολλὰ δὲ τεύχεα καλὰ πέσον περί τ’ἀμφί τε τάφρον	-u u -uu -u u- uu -u u --	dactylic hexameter	feminine penthemimeral, hepthemimeral
φευγόντων Δαναῶν· πολέμου δ’οὐ γίγνετ’ ἐρωή.	--- uu- uu- - -u u--	dactylic hexameter	masculine penthemimeral, hepthemimeral, trithemimeral
