ὣς εἰπὼν πυλέων ἐξέσσυτο φαίδιμος Ἕκτωρ,	- -- -- --uu -uu --	dactylic hexameter	masculine penthemimeral, trithemimeral
τῷ δ’ἅμ’ Ἀλέξανδρος κί’ ἀδελφεός· ἐν δ’ἄρα θυμῷ	- u u--- u u-uu - uu --	dactylic hexameter	masculine penthemimeral
ἀμφότεροι μέμασαν πολεμίζειν ἠδὲ μάχεσθαι.	-uu- uu- uu-- -u u--	dactylic hexameter	masculine penthemimeral, trithemimeral
ὡς δὲ θεὸς ναύτῃσιν ἐελδομένοισιν ἔδωκεν	- u u- --u u-uu-u u--	dactylic hexameter	feminine penthemimeral, trithemimeral
οὖρον, ἐπεί κε κάμωσιν ἐϋξέστῃς ἐλάτῃσι	-u u- u u-u u--- uu--	dactylic hexameter	feminine penthemimeral, trithemimeral
πόντον ἐλαύνοντες, καμάτῳ δ’ὑπὸ γυῖα λέλυνται,	-u u--- uu- uu -u u--	dactylic hexameter	masculine penthemimeral, hepthemimeral
ὣς ἄρα τὼ Τρώεσσιν ἐελδομένοισι φανήτην.	- uu - --u u-uu-u u--	dactylic hexameter	feminine penthemimeral, trithemimeral
ἔνθ’ ἑλέτην ὃ μὲν υἱὸν Ἀρηϊθόοιο ἄνακτος	- uu- u u -u u-uu-u u--	dactylic hexameter	feminine penthemimeral, trithemimeral
Ἄρνῃ ναιετάοντα Μενέσθιον, ὃν κορυνήτης	-- -uu-u u-uu - uu--	dactylic hexameter	feminine penthemimeral
γείνατ’ Ἀρηΐθοος καὶ Φυλομέδουσα βοῶπις·	-u u-uu- - -uu-u u--	dactylic hexameter	masculine penthemimeral
Ἕκτωρ δ’Ἠϊονῆα βάλ’ ἔγχεϊ ὀξυόεντι	-- -uu-u u -uu -uu--	dactylic hexameter	feminine penthemimeral
αὐχέν’ ὑπὸ στεφάνης εὐχάλκου, λύντο δὲ γυῖα.	-u u- uu- --- -u u --	dactylic hexameter	masculine penthemimeral, trithemimeral
Γλαῦκος δ’Ἱππολόχοιο πάϊς Λυκίων ἀγὸς ἀνδρῶν	-- -uu-u u- uu- uu --	dactylic hexameter	feminine penthemimeral, hepthemimeral
Ἰφίνοον βάλε δουρὶ κατὰ κρατερὴν ὑσμίνην	-uu- uu -u u- uu- ---	dactylic hexameter	feminine penthemimeral, hepthemimeral, trithemimeral
Δεξιάδην ἵππων ἐπιάλμενον ὠκειάων	-uu- -- uu-uu ----	dactylic hexameter	masculine penthemimeral, trithemimeral
ὦμον· ὃ δ’ἐξ ἵππων χαμάδις πέσε, λύντο δὲ γυῖα.	-u u - -- uu- uu -u u --	dactylic hexameter	masculine penthemimeral, hepthemimeral, trithemimeral
τοὺς δ’ὡς οὖν ἐνόησε θεὰ γλαυκῶπις Ἀθήνη	- - - uu-u u- --u u--	dactylic hexameter	feminine penthemimeral, hepthemimeral, trithemimeral
Ἀργείους ὀλέκοντας ἐνὶ κρατερῇ ὑσμίνῃ,	--- uu-u u- uu- ---	dactylic hexameter	feminine penthemimeral, hepthemimeral, trithemimeral
βῆ ῥα κατ’ Οὐλύμποιο καρήνων ἀΐξασα	- u u ---u u-- ----	dactylic hexameter	feminine penthemimeral
Ἴλιον εἰς ἱερήν· τῇ δ’ἀντίος ὄρνυτ’ Ἀπόλλων	-uu - uu- - -uu -u u--	dactylic hexameter	masculine penthemimeral, trithemimeral
Περγάμου ἐκκατιδών, Τρώεσσι δὲ βούλετο νίκην·	-uu -uu- --u u -uu --	dactylic hexameter	masculine penthemimeral
ἀλλήλοισι δὲ τώ γε συναντέσθην παρὰ φηγῷ.	---u u - u u--- uu --	dactylic hexameter	masculine penthemimeral
τὴν πρότερος προσέειπεν ἄναξ Διὸς υἱὸς Ἀπόλλων·	- uu- uu-u u- uu -u u--	dactylic hexameter	feminine penthemimeral, hepthemimeral, trithemimeral
τίπτε σὺ δ’αὖ μεμαυῖα Διὸς θύγατερ μεγάλοιο	-u u - uu-u u- uu- uu--	dactylic hexameter	feminine penthemimeral, hepthemimeral, trithemimeral
ἦλθες ἀπ’ Οὐλύμποιο, μέγας δέ σε θυμὸς ἀνῆκεν;	-u u ---u u- u u -u u--	dactylic hexameter	feminine penthemimeral, hepthemimeral
ἦ ἵνα δὴ Δαναοῖσι μάχης ἑτεραλκέα νίκην	- uu - uu-u u- uu-uu --	dactylic hexameter	feminine penthemimeral, hepthemimeral, trithemimeral
δῷς; ἐπεὶ οὔ τι Τρῶας ἀπολλυμένους ἐλεαίρεις.	- uu - - -u u-uu- uu--	dactylic hexameter	feminine penthemimeral, trithemimeral
ἀλλ’ εἴ μοί τι πίθοιο τό κεν πολὺ κέρδιον εἴη·	- - - u u-u u - uu -uu --	dactylic hexameter	feminine penthemimeral, hepthemimeral, trithemimeral
νῦν μὲν παύσωμεν πόλεμον καὶ δηϊοτῆτα	- - --- uu- - -uu--	dactylic hexameter	masculine penthemimeral, hepthemimeral
σήμερον· ὕστερον αὖτε μαχήσοντ’ εἰς ὅ κε τέκμωρ	-uu -uu -u u-- - u u --	dactylic hexameter	feminine penthemimeral
Ἰλίου εὕρωσιν, ἐπεὶ ὣς φίλον ἔπλετο θυμῷ	-uu --- uu - uu -uu --	dactylic hexameter	masculine penthemimeral, hepthemimeral
ὑμῖν ἀθανάτῃσι, διαπραθέειν τόδε ἄστυ.	-- -uu-u u-uu- uu --	dactylic hexameter	feminine penthemimeral
τὸν δ’αὖτε προσέειπε θεὰ γλαυκῶπις Ἀθήνη·	- -- uu-u u- --u u--	dactylic hexameter	feminine penthemimeral, hepthemimeral, trithemimeral
ὧδ’ ἔστω ἑκάεργε· τὰ γὰρ φρονέουσα καὶ αὐτὴ	- -- uu-u u - uu-u u --	dactylic hexameter	feminine penthemimeral, hepthemimeral, trithemimeral
ἦλθον ἀπ’ Οὐλύμποιο μετὰ Τρῶας καὶ Ἀχαιούς.	-u u ---u u- -- u u--	dactylic hexameter	feminine penthemimeral, hepthemimeral
ἀλλ’ ἄγε πῶς μέμονας πόλεμον καταπαυσέμεν ἀνδρῶν;	- uu - uu- uu- uu-uu --	dactylic hexameter	masculine penthemimeral, hepthemimeral, trithemimeral
τὴν δ’αὖτε προσέειπεν ἄναξ Διὸς υἱὸς Ἀπόλλων·	- -- uu-u u- uu -u u--	dactylic hexameter	feminine penthemimeral, hepthemimeral, trithemimeral
Ἕκτορος ὄρσωμεν κρατερὸν μένος ἱπποδάμοιο,	-uu --- uu- uu -uu--	dactylic hexameter	masculine penthemimeral, hepthemimeral
ἤν τινά που Δαναῶν προκαλέσσεται οἰόθεν οἶος	- uu - uu- uu-uu -uu --	dactylic hexameter	masculine penthemimeral, trithemimeral
ἀντίβιον μαχέσασθαι ἐν αἰνῇ δηϊοτῆτι,	-uu- uu-u u -- -uu--	dactylic hexameter	feminine penthemimeral, trithemimeral
οἳ δέ κ’ἀγασσάμενοι χαλκοκνήμιδες Ἀχαιοὶ	- u u-uu- ----u u--	dactylic hexameter	masculine penthemimeral
οἶον ἐπόρσειαν πολεμίζειν Ἕκτορι δίῳ.	-u u--- uu-- -uu --	dactylic hexameter	masculine penthemimeral
ὣς ἔφατ’, οὐδ’ ἀπίθησε θεὰ γλαυκῶπις Ἀθήνη.	- uu - uu-u u- --u u--	dactylic hexameter	feminine penthemimeral, hepthemimeral, trithemimeral
τῶν δ’Ἕλενος Πριάμοιο φίλος παῖς σύνθετο θυμῷ	- uu- uu-u u- - -uu --	dactylic hexameter	feminine penthemimeral, hepthemimeral, trithemimeral
βουλήν, ἥ ῥα θεοῖσιν ἐφήνδανε μητιόωσι·	-- - u u-u u-uu -uu--	dactylic hexameter	feminine penthemimeral, trithemimeral
στῆ δὲ παρ’ Ἕκτορ’ ἰὼν καί μιν πρὸς μῦθον ἔειπεν·	- u u -u u- - - - -u u--	dactylic hexameter	masculine penthemimeral, hepthemimeral
Ἕκτορ υἱὲ Πριάμοιο Διὶ μῆτιν ἀτάλαντε	-u u- uu-u u- -- uu--	dactylic hexameter	feminine penthemimeral, hepthemimeral, trithemimeral
ἦ ῥά νύ μοί τι πίθοιο, κασίγνητος δέ τοί εἰμι·	- u u - u u-u u--- u u --	dactylic hexameter	feminine penthemimeral, trithemimeral
ἄλλους μὲν κάθισον Τρῶας καὶ πάντας Ἀχαιούς,	-- - uu- -- - -u u--	dactylic hexameter	masculine penthemimeral, hepthemimeral, trithemimeral
αὐτὸς δὲ προκάλεσσαι Ἀχαιῶν ὅς τις ἄριστος	-- - uu-u u-- - u u--	dactylic hexameter	feminine penthemimeral, trithemimeral
ἀντίβιον μαχέσασθαι ἐν αἰνῇ δηϊοτῆτι·	-uu- uu-u u -- -uu--	dactylic hexameter	feminine penthemimeral, trithemimeral
οὐ γάρ πώ τοι μοῖρα θανεῖν καὶ πότμον ἐπισπεῖν·	- - - - -u u- - -u u--	dactylic hexameter	feminine penthemimeral, hepthemimeral, trithemimeral
ὣς γὰρ ἐγὼ ὄπ’ ἄκουσα θεῶν αἰειγενετάων.	- u u- u u-u u- --uu--	dactylic hexameter	feminine penthemimeral, hepthemimeral, trithemimeral
ὣς ἔφαθ’, Ἕκτωρ δ’αὖτε χάρη μέγα μῦθον ἀκούσας,	- uu -- -u u- uu -u u--	dactylic hexameter	feminine penthemimeral, hepthemimeral
καί ῥ’ἐς μέσσον ἰὼν Τρώων ἀνέεργε φάλαγγας,	- - -u u- -- uu-u u--	dactylic hexameter	masculine penthemimeral, hepthemimeral
μέσσου δουρὸς ἑλών· οἳ δ’ἱδρύνθησαν ἅπαντες.	-- -u u- - ---u u--	dactylic hexameter	masculine penthemimeral
κὰδ δ’Ἀγαμέμνων εἷσεν ἐϋκνήμιδας Ἀχαιούς·	- uu-- -u u---u u--	dactylic hexameter	feminine penthemimeral
κὰδ δ’ἄρ’ Ἀθηναίη τε καὶ ἀργυρότοξος Ἀπόλλων	- u u--- u u -uu-u u--	dactylic hexameter	masculine penthemimeral
ἑζέσθην ὄρνισιν ἐοικότες αἰγυπιοῖσι	--- --u u-uu -uu--	dactylic hexameter	feminine penthemimeral, trithemimeral
φηγῷ ἐφ’ ὑψηλῇ πατρὸς Διὸς αἰγιόχοιο	-u u --- -- uu -uu--	dactylic hexameter	masculine penthemimeral, hepthemimeral
ἀνδράσι τερπόμενοι· τῶν δὲ στίχες εἵατο πυκναὶ	-uu -uu- - - uu -uu --	dactylic hexameter	masculine penthemimeral, hepthemimeral
ἀσπίσι καὶ κορύθεσσι καὶ ἔγχεσι πεφρικυῖαι.	-uu - uu-u u -uu ----	dactylic hexameter	feminine penthemimeral, trithemimeral
οἵη δὲ Ζεφύροιο ἐχεύατο πόντον ἔπι φρὶξ	-- - uu-u u-uu -u u- -	dactylic hexameter	feminine penthemimeral, trithemimeral
ὀρνυμένοιο νέον, μελάνει δέ τε πόντος ὑπ’ αὐτῆς,	-uu-u u- uu- u u -u u --	dactylic hexameter	masculine penthemimeral, hepthemimeral
τοῖαι ἄρα στίχες εἵατ’ Ἀχαιῶν τε Τρώων τε	-u u- uu -u u-- - -- -	dactylic hexameter	feminine penthemimeral, trithemimeral
ἐν πεδίῳ· Ἕκτωρ δὲ μετ’ ἀμφοτέροισιν ἔειπε·	- uu- -- u u -uu-u u--	dactylic hexameter	masculine penthemimeral, trithemimeral
κέκλυτέ μευ Τρῶες καὶ ἐϋκνήμιδες Ἀχαιοὶ	-uu - -- u u---u u--	dactylic hexameter	masculine penthemimeral, trithemimeral
ὄφρ’ εἴπω τά με θυμὸς ἐνὶ στήθεσσι κελεύει.	- -- u u -u u- --u u--	dactylic hexameter	feminine penthemimeral, hepthemimeral, trithemimeral
ὅρκια μὲν Κρονίδης ὑψίζυγος οὐκ ἐτέλεσσεν,	-uu - uu- --uu - uu--	dactylic hexameter	masculine penthemimeral, trithemimeral
ἀλλὰ κακὰ φρονέων τεκμαίρεται ἀμφοτέροισιν	-u u- uu- --uu -uu--	dactylic hexameter	masculine penthemimeral, trithemimeral
εἰς ὅ κεν ἢ ὑμεῖς Τροίην εὔπυργον ἕλητε	- u u - -- -- --u u--	dactylic hexameter	masculine penthemimeral, hepthemimeral, trithemimeral
ἢ αὐτοὶ παρὰ νηυσὶ δαμείετε ποντοπόροισιν.	- -- uu -u u-uu -uu--	dactylic hexameter	feminine penthemimeral, trithemimeral
ὑμῖν δ’ἐν γὰρ ἔασιν ἀριστῆες Παναχαιῶν·	-- - u u-u u--- uu--	dactylic hexameter	feminine penthemimeral, trithemimeral
τῶν νῦν ὅν τινα θυμὸς ἐμοὶ μαχέσασθαι ἀνώγει	- - - uu -u u- uu-u u--	dactylic hexameter	feminine penthemimeral, hepthemimeral, trithemimeral
δεῦρ’ ἴτω ἐκ πάντων πρόμος ἔμμεναι Ἕκτορι δίῳ.	- uu - -- uu -uu -uu --	dactylic hexameter	masculine penthemimeral, trithemimeral
ὧδε δὲ μυθέομαι, Ζεὺς δ’ἄμμ’ ἐπιμάρτυρος ἔστω·	-u u -uu- - - uu-uu --	dactylic hexameter	masculine penthemimeral, hepthemimeral
εἰ μέν κεν ἐμὲ κεῖνος ἕλῃ ταναήκεϊ χαλκῷ,	- - - uu -u u- uu-uu --	dactylic hexameter	feminine penthemimeral, hepthemimeral, trithemimeral
τεύχεα συλήσας φερέτω κοίλας ἐπὶ νῆας,	-uu --- uu- -- uu --	dactylic hexameter	masculine penthemimeral, hepthemimeral
σῶμα δὲ οἴκαδ’ ἐμὸν δόμεναι πάλιν, ὄφρα πυρός με	-u u -u u- uu- uu -u u- -	dactylic hexameter	masculine penthemimeral, hepthemimeral
Τρῶες καὶ Τρώων ἄλοχοι λελάχωσι θανόντα.	-- - -- uu- uu-u u--	dactylic hexameter	masculine penthemimeral, hepthemimeral, trithemimeral
εἰ δέ κ’ἐγὼ τὸν ἕλω, δώῃ δέ μοι εὖχος Ἀπόλλων,	- u u- u u- -- u u -u u--	dactylic hexameter	masculine penthemimeral, hepthemimeral, trithemimeral
τεύχεα σύλησας οἴσω προτὶ Ἴλιον ἱρήν,	-uu --- -- uu -uu --	dactylic hexameter	masculine penthemimeral, hepthemimeral
καὶ κρεμόω προτὶ νηὸν Ἀπόλλωνος ἑκάτοιο,	- uu- uu -u u--- uu--	dactylic hexameter	feminine penthemimeral, trithemimeral
τὸν δὲ νέκυν ἐπὶ νῆας ἐϋσσέλμους ἀποδώσω,	- u u- uu -u u--- uu--	dactylic hexameter	feminine penthemimeral, trithemimeral
ὄφρά ἑ ταρχύσωσι κάρη κομόωντες Ἀχαιοί,	-u u ---u u- uu-u u--	dactylic hexameter	feminine penthemimeral, hepthemimeral
σῆμά τέ οἱ χεύωσιν ἐπὶ πλατεῖ Ἑλλησπόντῳ.	-u u - --u u- uu ----	dactylic hexameter	feminine penthemimeral, hepthemimeral, trithemimeral
καί ποτέ τις εἴπῃσι καὶ ὀψιγόνων ἀνθρώπων	- uu - --u u -uu- ---	dactylic hexameter	feminine penthemimeral, trithemimeral
νηῒ πολυκλήϊδι πλέων ἐπὶ οἴνοπα πόντον·	-u u---- - uu -uu --	dactylic hexameter	hepthemimeral
ἀνδρὸς μὲν τόδε σῆμα πάλαι κατατεθνηῶτος,	-- - uu -u u- uu----	dactylic hexameter	feminine penthemimeral, hepthemimeral, trithemimeral
ὅν ποτ’ ἀριστεύοντα κατέκτανε φαίδιμος Ἕκτωρ.	- u u---u u-uu -uu --	dactylic hexameter	feminine penthemimeral
ὥς ποτέ τις ἐρέει· τὸ δ’ἐμὸν κλέος οὔ ποτ’ ὀλεῖται.	- uu - uu- u u- uu - u u--	dactylic hexameter	masculine penthemimeral, hepthemimeral, trithemimeral
ὣς ἔφαθ’, οἱ δ’ἄρα πάντες ἀκὴν ἐγένοντο σιωπῇ·	- uu - uu -u u- uu-u u--	dactylic hexameter	feminine penthemimeral, hepthemimeral, trithemimeral
αἴδεσθεν μὲν ἀνήνασθαι, δεῖσαν δ’ὑποδέχθαι·	--- u u--- -- uu--	dactylic hexameter	hepthemimeral, trithemimeral
ὀψὲ δὲ δὴ Μενέλαος ἀνίστατο καὶ μετέειπε	-u u - uu-u u-uu - uu--	dactylic hexameter	feminine penthemimeral, trithemimeral
νείκει ὀνειδίζων, μέγα δὲ στεναχίζετο θυμῷ·	-u u--- uu - uu-uu --	dactylic hexameter	masculine penthemimeral, hepthemimeral
ὤ μοι ἀπειλητῆρες Ἀχαιΐδες οὐκέτ’ Ἀχαιοί·	- u u---u u-uu -u u--	dactylic hexameter	feminine penthemimeral
ἦ μὲν δὴ λώβη τάδε γ’ἔσσεται αἰνόθεν αἰνῶς	- - - -- uu -uu -uu --	dactylic hexameter	masculine penthemimeral, trithemimeral
εἰ μή τις Δαναῶν νῦν Ἕκτορος ἀντίος εἶσιν.	- - - uu- - -uu -uu --	dactylic hexameter	masculine penthemimeral, trithemimeral
ἀλλ’ ὑμεῖς μὲν πάντες ὕδωρ καὶ γαῖα γένοισθε	- -- - -u u- - -u u--	dactylic hexameter	feminine penthemimeral, hepthemimeral, trithemimeral
ἥμενοι αὖθι ἕκαστοι ἀκήριοι ἀκλεὲς αὔτως·	-uu -u u-u u-uu -uu --	dactylic hexameter	feminine penthemimeral
τῷδε δ’ἐγὼν αὐτὸς θωρήξομαι· αὐτὰρ ὕπερθε	-u u- -- --uu -u u--	dactylic hexameter	masculine penthemimeral, trithemimeral
νίκης πείρατ’ ἔχονται ἐν ἀθανάτοισι θεοῖσιν.	-- -u u-u u -uu-u u--	dactylic hexameter	feminine penthemimeral
ὣς ἄρα φωνήσας κατεδύσετο τεύχεα καλά.	- uu --- uu-uu -uu --	dactylic hexameter	masculine penthemimeral
ἔνθά κέ τοι Μενέλαε φάνη βιότοιο τελευτὴ	-u u - uu-u u- uu-u u--	dactylic hexameter	feminine penthemimeral, hepthemimeral, trithemimeral
Ἕκτορος ἐν παλάμῃσιν, ἐπεὶ πολὺ φέρτερος ἦεν,	-uu - uu-u u- uu -uu --	dactylic hexameter	feminine penthemimeral, hepthemimeral, trithemimeral
εἰ μὴ ἀναΐξαντες ἕλον βασιλῆες Ἀχαιῶν,	- u u---u u- uu-u u--	dactylic hexameter	feminine penthemimeral, hepthemimeral
αὐτός τ’Ἀτρεΐδης εὐρὺ κρείων Ἀγαμέμνων	-- -uu- -- -- uu--	dactylic hexameter	masculine penthemimeral, hepthemimeral
δεξιτερῆς ἕλε χειρὸς ἔπος τ’ἔφατ’ ἔκ τ’ὀνόμαζεν·	-uu- uu -u u- uu - uu--	dactylic hexameter	feminine penthemimeral, hepthemimeral, trithemimeral
ἀφραίνεις Μενέλαε διοτρεφές, οὐδέ τί σε χρὴ	--- uu-u u-uu -u u - -	dactylic hexameter	feminine penthemimeral, trithemimeral
ταύτης ἀφροσύνης· ἀνὰ δὲ σχέο κηδόμενός περ,	-- -uu- uu - uu -uu- -	dactylic hexameter	masculine penthemimeral, hepthemimeral
μηδ’ ἔθελ’ ἐξ ἔριδος σεῦ ἀμείνονι φωτὶ μάχεσθαι	- uu - uu- u u-uu -u u--	dactylic hexameter	masculine penthemimeral, trithemimeral
Ἕκτορι Πριαμίδῃ, τόν τε στυγέουσι καὶ ἄλλοι.	-uu -uu- - - uu-u u --	dactylic hexameter	masculine penthemimeral, hepthemimeral
καὶ δ’Ἀχιλεὺς τούτῳ γε μάχῃ ἔνι κυδιανείρῃ	- uu- -- u u- uu -uu--	dactylic hexameter	masculine penthemimeral, hepthemimeral, trithemimeral
ἔρριγ’ ἀντιβολῆσαι, ὅ περ σέο πολλὸν ἀμείνων.	-- -uu-u u - uu -u u--	dactylic hexameter	feminine penthemimeral, hepthemimeral
ἀλλὰ σὺ μὲν νῦν ἵζευ ἰὼν μετὰ ἔθνος ἑταίρων,	-u u - - -u u- uu -u u--	dactylic hexameter	feminine penthemimeral, hepthemimeral, trithemimeral
τούτῳ δὲ πρόμον ἄλλον ἀναστήσουσιν Ἀχαιοί.	-- - uu -u u---u u--	dactylic hexameter	feminine penthemimeral, trithemimeral
εἴ περ ἀδειής τ’ἐστὶ καὶ εἰ μόθου ἔστ’ ἀκόρητος,	- u u-- -u u - uu - uu--	dactylic hexameter	feminine penthemimeral, hepthemimeral
φημί μιν ἀσπασίως γόνυ κάμψειν, αἴ κε φύγῃσι	-u u -uu- uu -- - u u--	dactylic hexameter	masculine penthemimeral
δηΐου ἐκ πολέμοιο καὶ αἰνῆς δηϊοτῆτος.	-uu - uu-u u -- -uu--	dactylic hexameter	feminine penthemimeral, trithemimeral
ὣς εἰπὼν παρέπεισεν ἀδελφειοῦ φρένας ἥρως	- -- uu-u u--- uu --	dactylic hexameter	feminine penthemimeral, trithemimeral
αἴσιμα παρειπών, ὃ δ’ἐπείθετο· τοῦ μὲν ἔπειτα	-uu --- u u-uu - u u--	dactylic hexameter	masculine penthemimeral
γηθόσυνοι θεράποντες ἀπ’ ὤμων τεύχε’ ἕλοντο·	-uu- uu-u u -- -u u--	dactylic hexameter	feminine penthemimeral, trithemimeral
Νέστωρ δ’Ἀργείοισιν ἀνίστατο καὶ μετέειπεν·	-- ---u u-uu - uu--	dactylic hexameter	feminine penthemimeral
ὢ πόποι ἦ μέγα πένθος Ἀχαιΐδα γαῖαν ἱκάνει.	- uu - uu -u u-uu -u u--	dactylic hexameter	feminine penthemimeral, trithemimeral
ἦ κε μέγ’ οἰμώξειε γέρων ἱππηλάτα Πηλεὺς	- u u ---u u- --uu --	dactylic hexameter	feminine penthemimeral, hepthemimeral
ἐσθλὸς Μυρμιδόνων βουληφόρος ἠδ’ ἀγορητής,	-- -uu- --uu - uu--	dactylic hexameter	masculine penthemimeral
ὅς ποτέ μ’εἰρόμενος μέγ’ ἐγήθεεν ᾧ ἐνὶ οἴκῳ	- uu -uu- u u-uu - uu --	dactylic hexameter	masculine penthemimeral
πάντων Ἀργείων ἐρέων γενεήν τε τόκον τε.	-- --- uu- uu- u u- -	dactylic hexameter	masculine penthemimeral, hepthemimeral
τοὺς νῦν εἰ πτώσσοντας ὑφ’ Ἕκτορι πάντας ἀκούσαι,	- - - --u u -uu -u u--	dactylic hexameter	feminine penthemimeral, trithemimeral
πολλά κεν ἀθανάτοισι φίλας ἀνὰ χεῖρας ἀείραι	-u u -uu-u u- uu -u u--	dactylic hexameter	feminine penthemimeral, hepthemimeral
θυμὸν ἀπὸ μελέων δῦναι δόμον Ἄϊδος εἴσω.	-u u- uu- -- uu -uu --	dactylic hexameter	masculine penthemimeral, hepthemimeral, trithemimeral
αἲ γὰρ Ζεῦ τε πάτερ καὶ Ἀθηναίη καὶ Ἄπολλον	- - - u u- u u--- u u--	dactylic hexameter	masculine penthemimeral, trithemimeral
ἡβῷμ’ ὡς ὅτ’ ἐπ’ ὠκυρόῳ Κελάδοντι μάχοντο	-- - u u -uu- uu-u u--	dactylic hexameter	hepthemimeral, trithemimeral
ἀγρόμενοι Πύλιοί τε καὶ Ἀρκάδες ἐγχεσίμωροι	-uu- uu- u u -uu -uu--	dactylic hexameter	masculine penthemimeral, trithemimeral
Φειᾶς πὰρ τείχεσσιν Ἰαρδάνου ἀμφὶ ῥέεθρα.	-- - --u u-uu -u u--	dactylic hexameter	feminine penthemimeral, trithemimeral
τοῖσι δ’Ἐρευθαλίων πρόμος ἵστατο ἰσόθεος φὼς	-u u-uu- uu -uu -uu- -	dactylic hexameter	masculine penthemimeral
τεύχε’ ἔχων ὤμοισιν Ἀρηϊθόοιο ἄνακτος	-u u- --u u-uu-u u--	dactylic hexameter	feminine penthemimeral, trithemimeral
δίου Ἀρηϊθόου, τὸν ἐπίκλησιν κορυνήτην	-u u-uu- u u--- uu--	dactylic hexameter	masculine penthemimeral
ἄνδρες κίκλησκον καλλίζωνοί τε γυναῖκες	-- --- ---- u u--	dactylic hexameter	masculine penthemimeral
οὕνεκ’ ἄρ’ οὐ τόξοισι μαχέσκετο δουρί τε μακρῷ,	-u u - --u u-uu -u u --	dactylic hexameter	feminine penthemimeral, trithemimeral
ἀλλὰ σιδηρείῃ κορύνῃ ῥήγνυσκε φάλαγγας.	-u u--- uu- --u u--	dactylic hexameter	masculine penthemimeral, hepthemimeral
τὸν Λυκόοργος ἔπεφνε δόλῳ, οὔ τι κράτεΐ γε,	- uu-u u-u u- - - uu- -	dactylic hexameter	feminine penthemimeral, hepthemimeral
στεινωπῷ ἐν ὁδῷ ὅθ’ ἄρ’ οὐ κορύνη οἱ ὄλεθρον	--- u u- u u - uu- u u--	dactylic hexameter	masculine penthemimeral, hepthemimeral, trithemimeral
χραῖσμε σιδηρείη· πρὶν γὰρ Λυκόοργος ὑποφθὰς	-u u--- - - uu-u u--	dactylic hexameter	masculine penthemimeral, hepthemimeral
δουρὶ μέσον περόνησεν, ὃ δ’ὕπτιος οὔδει ἐρείσθη·	-u u- uu-u u -uu -u u--	dactylic hexameter	feminine penthemimeral, trithemimeral
τεύχεα δ’ἐξενάριξε, τά οἱ πόρε χάλκεος Ἄρης.	-uu -uu-u u - uu -uu --	dactylic hexameter	feminine penthemimeral, hepthemimeral
καὶ τὰ μὲν αὐτὸς ἔπειτα φόρει μετὰ μῶλον Ἄρηος·	- u u -u u-u u- uu -u u--	dactylic hexameter	feminine penthemimeral, hepthemimeral
αὐτὰρ ἐπεὶ Λυκόοργος ἐνὶ μεγάροισιν ἐγήρα,	-u u- uu-u u- uu-u u--	dactylic hexameter	feminine penthemimeral, hepthemimeral, trithemimeral
δῶκε δ’Ἐρευθαλίωνι φίλῳ θεράποντι φορῆναι·	-u u-uu-u u- uu-u u--	dactylic hexameter	feminine penthemimeral, hepthemimeral
τοῦ ὅ γε τεύχε’ ἔχων προκαλίζετο πάντας ἀρίστους.	- u u -u u- uu-uu -u u--	dactylic hexameter	masculine penthemimeral
οἳ δὲ μάλ’ ἐτρόμεον καὶ ἐδείδισαν, οὐδέ τις ἔτλη·	- u u -uu- u u-uu -u u --	dactylic hexameter	masculine penthemimeral
ἀλλ’ ἐμὲ θυμὸς ἀνῆκε πολυτλήμων πολεμίζειν	- uu -u u-u u--- uu--	dactylic hexameter	feminine penthemimeral
θάρσεϊ ᾧ· γενεῇ δὲ νεώτατος ἔσκον ἁπάντων·	-uu - uu- u u-uu -u u--	dactylic hexameter	masculine penthemimeral, trithemimeral
καὶ μαχόμην οἱ ἐγώ, δῶκεν δέ μοι εὖχος Ἀθήνη.	- uu- u u- -- u u -u u--	dactylic hexameter	masculine penthemimeral, hepthemimeral, trithemimeral
τὸν δὴ μήκιστον καὶ κάρτιστον κτάνον ἄνδρα·	- - --- - --- uu --	dactylic hexameter	masculine penthemimeral
πολλὸς γάρ τις ἔκειτο παρήορος ἔνθα καὶ ἔνθα.	-- - u u-u u-uu -u u --	dactylic hexameter	feminine penthemimeral, trithemimeral
εἴθ’ ὣς ἡβώοιμι, βίη δέ μοι ἔμπεδος εἴη·	- - ---u u- u u -uu --	dactylic hexameter	feminine penthemimeral, hepthemimeral
τώ κε τάχ’ ἀντήσειε μάχης κορυθαίολος Ἕκτωρ.	- u u ---u u- uu-uu --	dactylic hexameter	feminine penthemimeral, hepthemimeral
ὑμέων δ’οἵ περ ἔασιν ἀριστῆες Παναχαιῶν	-- - u u-u u--- uu--	dactylic hexameter	feminine penthemimeral, trithemimeral
οὐδ’ οἳ προφρονέως μέμαθ’ Ἕκτορος ἀντίον ἐλθεῖν.	- - -uu- uu -uu -uu --	dactylic hexameter	masculine penthemimeral
ὣς νείκεσσ’ ὃ γέρων, οἳ δ’ἐννέα πάντες ἀνέσταν.	- -- u u- - -uu -u u--	dactylic hexameter	masculine penthemimeral, trithemimeral
ὦρτο πολὺ πρῶτος μὲν ἄναξ ἀνδρῶν Ἀγαμέμνων,	-u u- -- u u- -- uu--	dactylic hexameter	masculine penthemimeral, hepthemimeral, trithemimeral
τῷ δ’ἐπὶ Τυδεΐδης ὦρτο κρατερὸς Διομήδης,	- uu -uu- -- uu- uu--	dactylic hexameter	masculine penthemimeral, hepthemimeral
τοῖσι δ’ἐπ’ Αἴαντες θοῦριν ἐπιειμένοι ἀλκήν,	-u u --- -- uu-uu --	dactylic hexameter	masculine penthemimeral, hepthemimeral
τοῖσι δ’ἐπ’ Ἰδομενεὺς καὶ ὀπάων Ἰδομενῆος	-u u -uu- u u-- -uu--	dactylic hexameter	masculine penthemimeral
Μηριόνης ἀτάλαντος Ἐνυαλίῳ ἀνδρειφόντῃ,	-uu- uu-u u-uu -uu--	dactylic hexameter	feminine penthemimeral, trithemimeral
τοῖσι δ’ἐπ’ Εὐρύπυλος Εὐαίμονος ἀγλαὸς υἱός,	-u u -uu- --uu -uu --	dactylic hexameter	masculine penthemimeral
ἂν δὲ Θόας Ἀνδραιμονίδης καὶ δῖος Ὀδυσσεύς·	- u u- --uu- - -u u--	dactylic hexameter	hepthemimeral, trithemimeral
πάντες ἄρ’ οἵ γ’ἔθελον πολεμίζειν Ἕκτορι δίῳ.	-u u - uu- uu-- -uu --	dactylic hexameter	masculine penthemimeral, trithemimeral
τοῖς δ’αὖτις μετέειπε Γερήνιος ἱππότα Νέστωρ·	- -- uu-u u-uu -uu --	dactylic hexameter	feminine penthemimeral, trithemimeral
κλήρῳ νῦν πεπάλασθε διαμπερὲς ὅς κε λάχῃσιν·	-- - uu-u u-uu - u u--	dactylic hexameter	feminine penthemimeral, trithemimeral
οὗτος γὰρ δὴ ὀνήσει ἐϋκνήμιδας Ἀχαιούς,	-- - u u-u u---u u--	dactylic hexameter	feminine penthemimeral, trithemimeral
καὶ δ’αὐτὸς ὃν θυμὸν ὀνήσεται αἴ κε φύγῃσι	- -- - -u u-uu - u u--	dactylic hexameter	feminine penthemimeral, trithemimeral
δηΐου ἐκ πολέμοιο καὶ αἰνῆς δηϊοτῆτος.	-uu - uu-u u -- -uu--	dactylic hexameter	feminine penthemimeral, trithemimeral
ὣς ἔφαθ’, οἳ δὲ κλῆρον ἐσημήναντο ἕκαστος,	- uu - - -u u---u u--	dactylic hexameter	feminine penthemimeral, trithemimeral
ἐν δ’ἔβαλον κυνέῃ Ἀγαμέμνονος Ἀτρεΐδαο.	- uu- uu- uu-uu -uu--	dactylic hexameter	masculine penthemimeral, trithemimeral
λαοὶ δ’ἠρήσαντο, θεοῖσι δὲ χεῖρας ἀνέσχον·	-- ---u u-u u -u u--	dactylic hexameter	feminine penthemimeral
ὧδε δέ τις εἴπεσκεν ἰδὼν εἰς οὐρανὸν εὐρύν·	-u u - --u u- - -uu --	dactylic hexameter	feminine penthemimeral, hepthemimeral, trithemimeral
Ζεῦ πάτερ ἢ Αἴαντα λαχεῖν, ἢ Τυδέος υἱόν,	- uu - --u u- - -uu --	dactylic hexameter	feminine penthemimeral, hepthemimeral, trithemimeral
ἢ αὐτὸν βασιλῆα πολυχρύσοιο Μυκήνης.	- -- uu-u u---u u--	dactylic hexameter	feminine penthemimeral, trithemimeral
ὣς ἄρ’ ἔφαν, πάλλεν δὲ Γερήνιος ἱππότα Νέστωρ,	- u u- -- u u-uu -uu --	dactylic hexameter	masculine penthemimeral, trithemimeral
ἐκ δ’ἔθορε κλῆρος κυνέης ὃν ἄρ’ ἤθελον αὐτοὶ	- uu- -- uu- u u -uu --	dactylic hexameter	masculine penthemimeral, hepthemimeral, trithemimeral
Αἴαντος· κῆρυξ δὲ φέρων ἀν’ ὅμιλον ἁπάντῃ	--- -- u u- u u-u u--	dactylic hexameter	masculine penthemimeral, hepthemimeral, trithemimeral
δεῖξ’ ἐνδέξια πᾶσιν ἀριστήεσσιν Ἀχαιῶν.	- --uu -u u---u u--	dactylic hexameter	feminine penthemimeral
οἳ δ’οὐ γιγνώσκοντες ἀπηνήναντο ἕκαστος.	- - ---u u---u u--	dactylic hexameter	feminine penthemimeral
ἀλλ’ ὅτε δὴ τὸν ἵκανε φέρων ἀν’ ὅμιλον ἁπάντῃ	- uu - u u-u u- u u-u u--	dactylic hexameter	feminine penthemimeral, hepthemimeral, trithemimeral
ὅς μιν ἐπιγράψας κυνέῃ βάλε φαίδιμος Αἴας,	- u u--- uu- uu -uu --	dactylic hexameter	masculine penthemimeral, hepthemimeral
ἤτοι ὑπέσχεθε χεῖρ’, ὃ δ’ἄρ’ ἔμβαλεν ἄγχι παραστάς,	-u u-uu - u u -uu -u u--	dactylic hexameter	masculine penthemimeral
γνῶ δὲ κλήρου σῆμα ἰδών, γήθησε δὲ θυμῷ.	- - -- -u u- --u u --	dactylic hexameter	feminine penthemimeral, hepthemimeral
τὸν μὲν πὰρ πόδ’ ἑὸν χαμάδις βάλε φώνησέν τε·	- - - u u- uu- uu --- -	dactylic hexameter	masculine penthemimeral, hepthemimeral, trithemimeral
ὦ φίλοι ἤτοι κλῆρος ἐμός, χαίρω δὲ καὶ αὐτὸς	- uu -- -u u- -- u u --	dactylic hexameter	feminine penthemimeral, hepthemimeral
θυμῷ, ἐπεὶ δοκέω νικησέμεν Ἕκτορα δῖον.	-u u- uu- --uu -uu --	dactylic hexameter	masculine penthemimeral, trithemimeral
ἀλλ’ ἄγετ’ ὄφρ’ ἂν ἐγὼ πολεμήϊα τεύχεα δύω,	- uu - u u- uu-uu -uu --	dactylic hexameter	masculine penthemimeral, trithemimeral
τόφρ’ ὑμεῖς εὔχεσθε Διὶ Κρονίωνι ἄνακτι	- -- --u u- uu-u u--	dactylic hexameter	feminine penthemimeral, hepthemimeral, trithemimeral
σιγῇ ἐφ’ ὑμείων ἵνα μὴ Τρῶές γε πύθωνται,	-u u --- uu - -- u u--	dactylic hexameter	masculine penthemimeral, hepthemimeral
ἠὲ καὶ ἀμφαδίην, ἐπεὶ οὔ τινα δείδιμεν ἔμπης·	-u u -uu- uu - uu -uu --	dactylic hexameter	masculine penthemimeral, hepthemimeral
οὐ γάρ τίς με βίῃ γε ἑκὼν ἀέκοντα δίηται	- - - u u- u u- uu-u u--	dactylic hexameter	masculine penthemimeral, hepthemimeral, trithemimeral
οὐδέ τι ἰδρείῃ, ἐπεὶ οὐδ’ ἐμὲ νήϊδά γ’οὕτως	-u u --- uu - uu -uu --	dactylic hexameter	masculine penthemimeral, hepthemimeral
ἔλπομαι ἐν Σαλαμῖνι γενέσθαι τε τραφέμεν τε.	-uu - uu-u u-- - uu- -	dactylic hexameter	feminine penthemimeral, trithemimeral
ὣς ἔφαθ’, οἳ δ’εὔχοντο Διὶ Κρονίωνι ἄνακτι·	- uu - --u u- uu-u u--	dactylic hexameter	feminine penthemimeral, hepthemimeral, trithemimeral
ὧδε δέ τις εἴπεσκεν ἰδὼν εἰς οὐρανὸν εὐρύν·	-u u - --u u- - -uu --	dactylic hexameter	feminine penthemimeral, hepthemimeral, trithemimeral
Ζεῦ πάτερ Ἴδηθεν μεδέων κύδιστε μέγιστε	- uu --- uu- --u u--	dactylic hexameter	masculine penthemimeral, hepthemimeral
δὸς νίκην Αἴαντι καὶ ἀγλαὸν εὖχος ἀρέσθαι·	- -- --u u -uu -u u--	dactylic hexameter	feminine penthemimeral, trithemimeral
εἰ δὲ καὶ Ἕκτορά περ φιλέεις καὶ κήδεαι αὐτοῦ,	- u u -uu - uu- - -uu --	dactylic hexameter	masculine penthemimeral, hepthemimeral
ἴσην ἀμφοτέροισι βίην καὶ κῦδος ὄπασσον.	-- -uu-u u- - -u u--	dactylic hexameter	feminine penthemimeral, hepthemimeral
ὣς ἄρ’ ἔφαν, Αἴας δὲ κορύσσετο νώροπι χαλκῷ.	- u u- -- u u-uu -uu --	dactylic hexameter	masculine penthemimeral, trithemimeral
αὐτὰρ ἐπεὶ δὴ πάντα περὶ χροῒ ἕσσατο τεύχεα,	-u u- - -u u- uu -uu --	dactylic hexameter	feminine penthemimeral, hepthemimeral, trithemimeral
σεύατ’ ἔπειθ’ οἷός τε πελώριος ἔρχεται Ἄρης,	-u u- -- u u-uu -uu --	dactylic hexameter	masculine penthemimeral, trithemimeral
ὅς τ’εἶσιν πόλεμον δὲ μετ’ ἀνέρας οὕς τε Κρονίων	- -- uu- u u -uu - u u--	dactylic hexameter	masculine penthemimeral, trithemimeral
θυμοβόρου ἔριδος μένεϊ ξυνέηκε μάχεσθαι.	-uu- uu- uu- uu-u u--	dactylic hexameter	masculine penthemimeral, hepthemimeral, trithemimeral
τοῖος ἄρ’ Αἴας ὦρτο πελώριος ἕρκος Ἀχαιῶν	-u u -- -u u-uu -u u--	dactylic hexameter	feminine penthemimeral
μειδιόων βλοσυροῖσι προσώπασι· νέρθε δὲ ποσσὶν	-uu- uu-u u-uu -u u --	dactylic hexameter	feminine penthemimeral, trithemimeral
ἤϊε μακρὰ βιβάς, κραδάων δολιχόσκιον ἔγχος.	-uu -u u- uu- uu-uu --	dactylic hexameter	masculine penthemimeral, hepthemimeral
τὸν δὲ καὶ Ἀργεῖοι μὲν ἐγήθεον εἰσορόωντες,	- u u --- u u-uu -uu--	dactylic hexameter	masculine penthemimeral
Τρῶας δὲ τρόμος αἰνὸς ὑπήλυθε γυῖα ἕκαστον,	-- - uu -u u-uu -u u--	dactylic hexameter	feminine penthemimeral, trithemimeral
Ἕκτορί τ’αὐτῷ θυμὸς ἐνὶ στήθεσσι πάτασσεν·	-uu -- -u u- --u u--	dactylic hexameter	feminine penthemimeral, hepthemimeral
ἀλλ’ οὔ πως ἔτι εἶχεν ὑποτρέσαι οὐδ’ ἀναδῦναι	- - - uu -u u-uu - uu--	dactylic hexameter	feminine penthemimeral, trithemimeral
ἂψ λαῶν ἐς ὅμιλον, ἐπεὶ προκαλέσσατο χάρμῃ.	- -- u u-u u- uu-uu --	dactylic hexameter	feminine penthemimeral, hepthemimeral, trithemimeral
Αἴας δ’ἐγγύθεν ἦλθε φέρων σάκος ἠΰτε πύργον	-- -uu -u u- uu -uu --	dactylic hexameter	feminine penthemimeral, hepthemimeral
χάλκεον ἑπταβόειον, ὅ οἱ Τυχίος κάμε τεύχων	-uu -uu-u u - uu- uu --	dactylic hexameter	feminine penthemimeral, hepthemimeral
σκυτοτόμων ὄχ’ ἄριστος Ὕλῃ ἔνι οἰκία ναίων,	-uu- u u-u u- uu -uu --	dactylic hexameter	feminine penthemimeral, hepthemimeral, trithemimeral
ὅς οἱ ἐποίησεν σάκος αἰόλον ἑπταβόειον	- u u--- uu -uu -uu--	dactylic hexameter	masculine penthemimeral
ταύρων ζατρεφέων, ἐπὶ δ’ὄγδοον ἤλασε χαλκόν.	-- -uu- uu -uu -uu --	dactylic hexameter	masculine penthemimeral
τὸ πρόσθε στέρνοιο φέρων Τελαμώνιος Αἴας	- -- --u u- uu-uu --	dactylic hexameter	feminine penthemimeral, hepthemimeral, trithemimeral
στῆ ῥα μάλ’ Ἕκτορος ἐγγύς, ἀπειλήσας δὲ προσηύδα·	- u u -uu -u u--- u u--	dactylic hexameter	feminine penthemimeral
Ἕκτορ νῦν μὲν δὴ σάφα εἴσεαι οἰόθεν οἶος	-- - - - uu -uu -uu --	dactylic hexameter	masculine penthemimeral, trithemimeral
οἷοι καὶ Δαναοῖσιν ἀριστῆες μετέασι	-- - uu-u u--- uu--	dactylic hexameter	feminine penthemimeral, trithemimeral
καὶ μετ’ Ἀχιλλῆα ῥηξήνορα θυμολέοντα.	- u u--- --uu -uu--	dactylic hexameter	masculine penthemimeral
ἀλλ’ ὃ μὲν ἐν νήεσσι κορωνίσι ποντοπόροισι	- u u - --u u-uu -uu--	dactylic hexameter	feminine penthemimeral, trithemimeral
κεῖτ’ ἀπομηνίσας Ἀγαμέμνονι ποιμένι λαῶν·	- uu--- uu-uu -uu --	dactylic hexameter	masculine penthemimeral
ἡμεῖς δ’εἰμὲν τοῖοι οἳ ἂν σέθεν ἀντιάσαιμεν	-- -- -u u - uu -uu--	dactylic hexameter	feminine penthemimeral, hepthemimeral
καὶ πολέες· ἀλλ’ ἄρχε μάχης ἠδὲ πτολέμοιο.	- uu- - -u u- -- uu--	dactylic hexameter	feminine penthemimeral, hepthemimeral, trithemimeral
τὸν δ’αὖτε προσέειπε μέγας κορυθαίολος Ἕκτωρ·	- -- uu-u u- uu-uu --	dactylic hexameter	feminine penthemimeral, hepthemimeral, trithemimeral
Αἶαν διογενὲς Τελαμώνιε κοίρανε λαῶν	-- -uu- uu-uu -uu --	dactylic hexameter	masculine penthemimeral
μή τί μευ ἠΰτε παιδὸς ἀφαυροῦ πειρήτιζε	- u u -uu -u u-- ----	dactylic hexameter	feminine penthemimeral
ἠὲ γυναικός, ἣ οὐκ οἶδεν πολεμήϊα ἔργα.	-u u-u u - -- uu-uu --	dactylic hexameter	masculine penthemimeral, hepthemimeral
αὐτὰρ ἐγὼν εὖ οἶδα μάχας τ’ἀνδροκτασίας τε·	-u u- - -u u- --uu- -	dactylic hexameter	feminine penthemimeral, hepthemimeral, trithemimeral
οἶδ’ ἐπὶ δεξιά, οἶδ’ ἐπ’ ἀριστερὰ νωμῆσαι βῶν	- uu -uu - u u-uu --- -	dactylic hexameter	masculine penthemimeral
ἀζαλέην, τό μοι ἔστι ταλαύρινον πολεμίζειν·	-uu- u u -u u--- uu--	dactylic hexameter	feminine penthemimeral, trithemimeral
οἶδα δ’ἐπαΐξαι μόθον ἵππων ὠκειάων·	-u u--- uu -- ----	dactylic hexameter	masculine penthemimeral
οἶδα δ’ἐνὶ σταδίῃ δηίῳ μέλπεσθαι Ἄρηϊ.	-u u- uu- -- --u u--	dactylic hexameter	masculine penthemimeral, hepthemimeral, trithemimeral
ἀλλ’ οὐ γάρ σ’ἐθέλω βαλέειν τοιοῦτον ἐόντα	- - - uu- uu- --u u--	dactylic hexameter	masculine penthemimeral, hepthemimeral, trithemimeral
λάθρῃ ὀπιπεύσας, ἀλλ’ ἀμφαδόν, αἴ κε τύχωμι.	-u u--- - -uu - u u--	dactylic hexameter	masculine penthemimeral
ἦ ῥα, καὶ ἀμπεπαλὼν προΐει δολιχόσκιον ἔγχος,	- u u -uu- uu- uu-uu --	dactylic hexameter	masculine penthemimeral, hepthemimeral
καὶ βάλεν Αἴαντος δεινὸν σάκος ἑπταβόειον	- uu --- -- uu -uu--	dactylic hexameter	masculine penthemimeral, hepthemimeral
ἀκρότατον κατὰ χαλκόν, ὃς ὄγδοος ἦεν ἐπ’ αὐτῷ.	-uu- uu -u u -uu -u u --	dactylic hexameter	feminine penthemimeral, trithemimeral
ἓξ δὲ διὰ πτύχας ἦλθε δαΐζων χαλκὸς ἀτειρής,	- u u- uu -u u-- -u u--	dactylic hexameter	feminine penthemimeral, trithemimeral
ἐν τῇ δ’ἑβδομάτῃ ῥινῷ σχέτο· δεύτερος αὖτε	- - -uu- -- uu -uu --	dactylic hexameter	masculine penthemimeral, hepthemimeral
Αἴας διογενὴς προΐει δολιχόσκιον ἔγχος,	-- -uu- uu- uu-uu --	dactylic hexameter	masculine penthemimeral, hepthemimeral
καὶ βάλε Πριαμίδαο κατ’ ἀσπίδα πάντοσ’ ἐΐσην.	- uu -uu-u u -uu -u u--	dactylic hexameter	feminine penthemimeral
διὰ μὲν ἀσπίδος ἦλθε φαεινῆς ὄβριμον ἔγχος,	-u u -uu -u u-- -uu --	dactylic hexameter	feminine penthemimeral
καὶ διὰ θώρηκος πολυδαιδάλου ἠρήρειστο·	- uu --- uu-uu ----	dactylic hexameter	masculine penthemimeral
ἀντικρὺ δὲ παραὶ λαπάρην διάμησε χιτῶνα	--- u u- uu- uu-u u--	dactylic hexameter	masculine penthemimeral, hepthemimeral, trithemimeral
ἔγχος· ὃ δ’ἐκλίνθη καὶ ἀλεύατο κῆρα μέλαιναν.	-u u --- u u-uu -u u--	dactylic hexameter	masculine penthemimeral
τὼ δ’ἐκσπασσαμένω δολίχ’ ἔγχεα χερσὶν ἅμ’ ἄμφω	- --uu- uu -uu -u u --	dactylic hexameter	masculine penthemimeral
σύν ῥ’ἔπεσον λείουσιν ἐοικότες ὠμοφάγοισιν	- uu- --u u-uu -uu--	dactylic hexameter	feminine penthemimeral, trithemimeral
ἢ συσὶ κάπροισιν, τῶν τε σθένος οὐκ ἀλαπαδνόν.	- uu --- - - uu - uu--	dactylic hexameter	masculine penthemimeral, hepthemimeral
Πριαμίδης μὲν ἔπειτα μέσον σάκος οὔτασε δουρί,	-uu- u u-u u- uu -uu --	dactylic hexameter	feminine penthemimeral, hepthemimeral, trithemimeral
οὐδ’ ἔρρηξεν χαλκός, ἀνεγνάμφθη δέ οἱ αἰχμή.	- --- -u u--- u u --	dactylic hexameter	feminine penthemimeral
Αἴας δ’ἀσπίδα νύξεν ἐπάλμενος· ἣ δὲ διαπρὸ	-- -uu -u u-uu - u u--	dactylic hexameter	feminine penthemimeral
ἤλυθεν ἐγχείη, στυφέλιξε δέ μιν μεμαῶτα,	-uu --- uu-u u - uu--	dactylic hexameter	masculine penthemimeral
τμήδην δ’αὐχέν’ ἐπῆλθε, μέλαν δ’ἀνεκήκιεν αἷμα,	-- -u u-u u- uu-uu --	dactylic hexameter	feminine penthemimeral, hepthemimeral
ἀλλ’ οὐδ’ ὧς ἀπέληγε μάχης κορυθαίολος Ἕκτωρ,	- - - uu-u u- uu-uu --	dactylic hexameter	feminine penthemimeral, hepthemimeral, trithemimeral
ἀλλ’ ἀναχασσάμενος λίθον εἵλετο χειρὶ παχείῃ	- uu-uu- uu -uu -u u--	dactylic hexameter	masculine penthemimeral
κείμενον ἐν πεδίῳ μέλανα τρηχύν τε μέγαν τε·	-uu - uu- uu- -- u u- -	dactylic hexameter	masculine penthemimeral, hepthemimeral, trithemimeral
τῷ βάλεν Αἴαντος δεινὸν σάκος ἑπταβόειον	- uu --- -- uu -uu--	dactylic hexameter	masculine penthemimeral, hepthemimeral
μέσσον ἐπομφάλιον· περιήχησεν δ’ἄρα χαλκός.	-u u-uu- uu--- uu --	dactylic hexameter	masculine penthemimeral
δεύτερος αὖτ’ Αἴας πολὺ μείζονα λᾶαν ἀείρας	-uu - -- uu -uu -u u--	dactylic hexameter	masculine penthemimeral, trithemimeral
ἧκ’ ἐπιδινήσας, ἐπέρεισε δὲ ἶν’ ἀπέλεθρον,	- uu--- uu-u u - uu--	dactylic hexameter	masculine penthemimeral
εἴσω δ’ἀσπίδ’ ἔαξε βαλὼν μυλοειδέϊ πέτρῳ,	-- -u u-u u- uu-uu --	dactylic hexameter	feminine penthemimeral, hepthemimeral
βλάψε δέ οἱ φίλα γούναθ’· ὃ δ’ὕπτιος ἐξετανύσθη	-u u - uu -u u -uu -uu--	dactylic hexameter	feminine penthemimeral, trithemimeral
ἀσπίδι ἐγχριμφθείς· τὸν δ’αἶψ’ ὤρθωσεν Ἀπόλλων.	-uu --- - - --u u--	dactylic hexameter	masculine penthemimeral, hepthemimeral
καί νύ κε δὴ ξιφέεσσ’ αὐτοσχεδὸν οὐτάζοντο,	- u u - uu- --uu ----	dactylic hexameter	masculine penthemimeral, trithemimeral
εἰ μὴ κήρυκες Διὸς ἄγγελοι ἠδὲ καὶ ἀνδρῶν	- - --- uu -uu -u u --	dactylic hexameter	masculine penthemimeral
ἦλθον, ὃ μὲν Τρώων, ὃ δ’Ἀχαιῶν χαλκοχιτώνων,	-u u - -- u u-- -uu--	dactylic hexameter	masculine penthemimeral, trithemimeral
Ταλθύβιός τε καὶ Ἰδαῖος πεπνυμένω ἄμφω·	-uu- u u --- --uu --	dactylic hexameter	hepthemimeral, trithemimeral
μέσσῳ δ’ἀμφοτέρων σκῆπτρα σχέθον, εἶπέ τε μῦθον	-- -uu- -- uu -u u --	dactylic hexameter	masculine penthemimeral, hepthemimeral
κῆρυξ Ἰδαῖος πεπνυμένα μήδεα εἰδώς·	-- --- --uu -uu --	dactylic hexameter	masculine penthemimeral
μηκέτι παῖδε φίλω πολεμίζετε μηδὲ μάχεσθον·	-uu -u u- uu-uu -u u--	dactylic hexameter	masculine penthemimeral
ἀμφοτέρω γὰρ σφῶϊ φιλεῖ νεφεληγερέτα Ζεύς,	-uu- - -u u- uu-uu- -	dactylic hexameter	feminine penthemimeral, hepthemimeral, trithemimeral
ἄμφω δ’αἰχμητά· τό γε δὴ καὶ ἴδμεν ἅπαντες.	-- --- u u - - -u u--	dactylic hexameter	masculine penthemimeral, hepthemimeral
νὺξ δ’ἤδη τελέθει· ἀγαθὸν καὶ νυκτὶ πιθέσθαι.	- -- uu- uu- - -u u--	dactylic hexameter	masculine penthemimeral, hepthemimeral, trithemimeral
τὸν δ’ἀπαμειβόμενος προσέφη Τελαμώνιος Αἴας·	- uu-uu- uu- uu-uu --	dactylic hexameter	masculine penthemimeral, hepthemimeral
Ἰδαῖ’ Ἕκτορα ταῦτα κελεύετε μυθήσασθαι·	-- -uu -u u-uu ----	dactylic hexameter	feminine penthemimeral
αὐτὸς γὰρ χάρμῃ προκαλέσσατο πάντας ἀρίστους.	-- - -- uu-uu -u u--	dactylic hexameter	masculine penthemimeral, trithemimeral
ἀρχέτω· αὐτὰρ ἐγὼ μάλα πείσομαι ᾗ περ ἂν οὗτος.	-uu -u u- uu -uu - u u --	dactylic hexameter	masculine penthemimeral
τὸν δ’αὖτε προσέειπε μέγας κορυθαίολος Ἕκτωρ·	- -- uu-u u- uu-uu --	dactylic hexameter	feminine penthemimeral, hepthemimeral, trithemimeral
Αἶαν ἐπεί τοι δῶκε θεὸς μέγεθός τε βίην τε	-u u- - -u u- uu- u u- -	dactylic hexameter	feminine penthemimeral, hepthemimeral, trithemimeral
καὶ πινυτήν, περὶ δ’ἔγχει Ἀχαιῶν φέρτατός ἐσσι,	- uu- uu -u u-- -uu --	dactylic hexameter	feminine penthemimeral, trithemimeral
νῦν μὲν παυσώμεσθα μάχης καὶ δηϊοτῆτος	- - ---u u- - -uu--	dactylic hexameter	feminine penthemimeral, hepthemimeral
σήμερον· ὕστερον αὖτε μαχησόμεθ’ εἰς ὅ κε δαίμων	-uu -uu -u u-uu - u u --	dactylic hexameter	feminine penthemimeral
ἄμμε διακρίνῃ, δώῃ δ’ἑτέροισί γε νίκην.	-u u--- -- uu-u u --	dactylic hexameter	masculine penthemimeral, hepthemimeral
νὺξ δ’ἤδη τελέθει· ἀγαθὸν καὶ νυκτὶ πιθέσθαι,	- -- uu- uu- - -u u--	dactylic hexameter	masculine penthemimeral, hepthemimeral, trithemimeral
ὡς σύ τ’ἐϋφρήνῃς πάντας παρὰ νηυσὶν Ἀχαιούς,	- u u--- -- uu -u u--	dactylic hexameter	masculine penthemimeral, hepthemimeral
σούς τε μάλιστα ἔτας καὶ ἑταίρους, οἵ τοι ἔασιν·	- u u-u u- u u-- - u u--	dactylic hexameter	masculine penthemimeral
αὐτὰρ ἐγὼ κατὰ ἄστυ μέγα Πριάμοιο ἄνακτος	-u u- uu -u u- uu-u u--	dactylic hexameter	feminine penthemimeral, hepthemimeral, trithemimeral
Τρῶας ἐϋφρανέω καὶ Τρῳάδας ἑλκεσιπέπλους,	-u u-uu- - -uu -uu--	dactylic hexameter	masculine penthemimeral
αἵ τέ μοι εὐχόμεναι θεῖον δύσονται ἀγῶνα.	- u u -uu- -- --u u--	dactylic hexameter	masculine penthemimeral, hepthemimeral
δῶρα δ’ἄγ’ ἀλλήλοισι περικλυτὰ δώομεν ἄμφω,	-u u ---u u-uu -uu --	dactylic hexameter	feminine penthemimeral
ὄφρά τις ὧδ’ εἴπῃσιν Ἀχαιῶν τε Τρώων τε·	-u u - --u u-- - -- -	dactylic hexameter	feminine penthemimeral, trithemimeral
ἠμὲν ἐμαρνάσθην ἔριδος πέρι θυμοβόροιο,	-u u--- uu- uu -uu--	dactylic hexameter	masculine penthemimeral, hepthemimeral
ἠδ’ αὖτ’ ἐν φιλότητι διέτμαγεν ἀρθμήσαντε.	- - - uu-u u-uu ----	dactylic hexameter	feminine penthemimeral, trithemimeral
ὣς ἄρα φωνήσας δῶκε ξίφος ἀργυρόηλον	- uu --- -- uu -uu--	dactylic hexameter	masculine penthemimeral, hepthemimeral
σὺν κολεῷ τε φέρων καὶ ἐϋτμήτῳ τελαμῶνι·	- uu- u u- u u--- uu--	dactylic hexameter	masculine penthemimeral, trithemimeral
Αἴας δὲ ζωστῆρα δίδου φοίνικι φαεινόν.	-- - --u u- --u u--	dactylic hexameter	feminine penthemimeral, hepthemimeral, trithemimeral
τὼ δὲ διακρινθέντε ὃ μὲν μετὰ λαὸν Ἀχαιῶν	- u u---u u - uu -u u--	dactylic hexameter	feminine penthemimeral, hepthemimeral
ἤϊ’, ὃ δ’ἐς Τρώων ὅμαδον κίε· τοὶ δὲ χάρησαν,	-u u - -- uu- uu - u u--	dactylic hexameter	masculine penthemimeral, hepthemimeral, trithemimeral
ὡς εἶδον ζωόν τε καὶ ἀρτεμέα προσιόντα,	- -- -- u u -uu- uu--	dactylic hexameter	masculine penthemimeral, trithemimeral
Αἴαντος προφυγόντα μένος καὶ χεῖρας ἀάπτους·	--- uu-u u- - -u u--	dactylic hexameter	feminine penthemimeral, hepthemimeral, trithemimeral
καί ῥ’ἦγον προτὶ ἄστυ ἀελπτέοντες σόον εἶναι.	- -- uu -u u--- uu --	dactylic hexameter	feminine penthemimeral, trithemimeral
Αἴαντ’ αὖθ’ ἑτέρωθεν ἐϋκνήμιδες Ἀχαιοὶ	-- - uu-u u---u u--	dactylic hexameter	feminine penthemimeral, trithemimeral
εἰς Ἀγαμέμνονα δῖον ἄγον κεχαρηότα νίκῃ.	- uu-uu -u u- uu-uu --	dactylic hexameter	feminine penthemimeral, hepthemimeral
οἳ δ’ὅτε δὴ κλισίῃσιν ἐν Ἀτρεΐδαο γένοντο,	- uu - uu-u u -uu-u u--	dactylic hexameter	feminine penthemimeral, trithemimeral
τοῖσι δὲ βοῦν ἱέρευσεν ἄναξ ἀνδρῶν Ἀγαμέμνων	-u u - uu-u u- -- uu--	dactylic hexameter	feminine penthemimeral, hepthemimeral, trithemimeral
ἄρσενα πενταέτηρον ὑπερμενέϊ Κρονίωνι.	-uu -uu-u u-uu- uu--	dactylic hexameter	feminine penthemimeral
τὸν δέρον ἀμφί θ’ἕπον, καί μιν διέχευαν ἅπαντα,	- uu -u u- - - uu-u u--	dactylic hexameter	masculine penthemimeral, hepthemimeral
μίστυλλόν τ’ἄρ’ ἐπισταμένως πεῖράν τ’ὀβελοῖσιν,	--- u u-uu- -- uu--	dactylic hexameter	hepthemimeral, trithemimeral
ὄπτησάν τε περιφραδέως, ἐρύσαντό τε πάντα.	--- u u-uu- uu-u u --	dactylic hexameter	hepthemimeral, trithemimeral
αὐτὰρ ἐπεὶ παύσαντο πόνου τετύκοντό τε δαῖτα,	-u u- --u u- uu-u u --	dactylic hexameter	feminine penthemimeral, hepthemimeral, trithemimeral
δαίνυντ’, οὐδέ τι θυμὸς ἐδεύετο δαιτὸς ἐΐσης·	-- -u u -u u-uu -u u--	dactylic hexameter	feminine penthemimeral
νώτοισιν δ’Αἴαντα διηνεκέεσσι γέραιρεν	--- --u u-uu-u u--	dactylic hexameter	feminine penthemimeral, trithemimeral
ἥρως Ἀτρεΐδης εὐρὺ κρείων Ἀγαμέμνων.	-- -uu- -- -- uu--	dactylic hexameter	masculine penthemimeral, hepthemimeral
αὐτὰρ ἐπεὶ πόσιος καὶ ἐδητύος ἐξ ἔρον ἕντο,	-u u- uu- u u-uu - uu --	dactylic hexameter	masculine penthemimeral, trithemimeral
τοῖς ὁ γέρων πάμπρωτος ὑφαίνειν ἤρχετο μῆτιν	- u u- --u u-- -uu --	dactylic hexameter	feminine penthemimeral, trithemimeral
Νέστωρ, οὗ καὶ πρόσθεν ἀρίστη φαίνετο βουλή·	-- - - -u u-- -uu --	dactylic hexameter	feminine penthemimeral, trithemimeral
ὅ σφιν ἐϋφρονέων ἀγορήσατο καὶ μετέειπεν·	- u u-uu- uu-uu - uu--	dactylic hexameter	masculine penthemimeral
Ἀτρεΐδη τε καὶ ἄλλοι ἀριστῆες Παναχαιῶν,	-uu- u u -u u--- uu--	dactylic hexameter	feminine penthemimeral, trithemimeral
πολλοὶ γὰρ τεθνᾶσι κάρη κομόωντες Ἀχαιοί,	-- - --u u- uu-u u--	dactylic hexameter	feminine penthemimeral, hepthemimeral, trithemimeral
τῶν νῦν αἷμα κελαινὸν ἐΰρροον ἀμφὶ Σκάμανδρον	- - -u u-u u-uu -u u--	dactylic hexameter	feminine penthemimeral
ἐσκέδασ’ ὀξὺς Ἄρης, ψυχαὶ δ’Ἄϊδος δὲ κατῆλθον·	-uu -u u- -- uu- u u--	dactylic hexameter	masculine penthemimeral, hepthemimeral
τώ σε χρὴ πόλεμον μὲν ἅμ’ ἠοῖ παῦσαι Ἀχαιῶν,	- - - uu- u u -- -u u--	dactylic hexameter	masculine penthemimeral, trithemimeral
αὐτοὶ δ’ἀγρόμενοι κυκλήσομεν ἐνθάδε νεκροὺς	-- -uu- --uu -uu --	dactylic hexameter	masculine penthemimeral
βουσὶ καὶ ἡμιόνοισιν· ἀτὰρ κατακήομεν αὐτοὺς	-u u -uu-u u- uu-uu --	dactylic hexameter	feminine penthemimeral, hepthemimeral
τυτθὸν ἀπὸ πρὸ νεῶν, ὥς κ’ὀστέα παισὶν ἕκαστος	-u u- u u- - -uu -u u--	dactylic hexameter	masculine penthemimeral, trithemimeral
οἴκαδ’ ἄγῃ ὅτ’ ἂν αὖτε νεώμεθα πατρίδα γαῖαν.	-u u- u u -u u-uu -uu --	dactylic hexameter	feminine penthemimeral, trithemimeral
τύμβον δ’ἀμφὶ πυρὴν ἕνα χεύομεν ἐξαγαγόντες	-- -u u- uu -uu -uu--	dactylic hexameter	masculine penthemimeral
ἄκριτον ἐκ πεδίου· ποτὶ δ’αὐτὸν δείμομεν ὦκα	-uu - uu- uu -- -uu --	dactylic hexameter	masculine penthemimeral, trithemimeral
πύργους ὑψηλοὺς εἶλαρ νηῶν τε καὶ αὐτῶν.	-- --- -- -- u u --	dactylic hexameter	masculine penthemimeral, hepthemimeral
ἐν δ’αὐτοῖσι πύλας ποιήσομεν εὖ ἀραρυίας,	- --u u- --uu - uu--	dactylic hexameter	masculine penthemimeral
ὄφρα δι’ αὐτάων ἱππηλασίη ὁδὸς εἴη·	-u u --- --uu- uu --	dactylic hexameter	masculine penthemimeral
ἔκτοσθεν δὲ βαθεῖαν ὀρύξομεν ἐγγύθι τάφρον,	--- u u-u u-uu -uu --	dactylic hexameter	feminine penthemimeral, trithemimeral
ἥ χ’ἵππον καὶ λαὸν ἐρυκάκοι ἀμφὶς ἐοῦσα,	- -- - -u u-uu -u u--	dactylic hexameter	feminine penthemimeral, trithemimeral
μή ποτ’ ἐπιβρίσῃ πόλεμος Τρώων ἀγερώχων.	- u u--- uu- -- uu--	dactylic hexameter	masculine penthemimeral, hepthemimeral
ὣς ἔφαθ’, οἳ δ’ἄρα πάντες ἐπῄνησαν βασιλῆες.	- uu - uu -u u--- uu--	dactylic hexameter	feminine penthemimeral, trithemimeral
Τρώων αὖτ’ ἀγορὴ γένετ’ Ἰλίου ἐν πόλει ἄκρῃ	-- - uu- uu -uu - uu --	dactylic hexameter	masculine penthemimeral, trithemimeral
δεινὴ τετρηχυῖα, παρὰ Πριάμοιο θύρῃσι·	-- ---u u- uu-u u--	dactylic hexameter	feminine penthemimeral, hepthemimeral
τοῖσιν δ’Ἀντήνωρ πεπνυμένος ἦρχ’ ἀγορεύειν·	-- --- --uu - uu--	dactylic hexameter	masculine penthemimeral
κέκλυτέ μευ Τρῶες καὶ Δάρδανοι ἠδ’ ἐπίκουροι,	-uu - -- - -uu - uu--	dactylic hexameter	masculine penthemimeral, trithemimeral
ὄφρ’ εἴπω τά με θυμὸς ἐνὶ στήθεσσι κελεύει.	- -- u u -u u- --u u--	dactylic hexameter	feminine penthemimeral, hepthemimeral, trithemimeral
δεῦτ’ ἄγετ’ Ἀργείην Ἑλένην καὶ κτήμαθ’ ἅμ’ αὐτῇ	- uu --- uu- - -u u --	dactylic hexameter	masculine penthemimeral, hepthemimeral
δώομεν Ἀτρεΐδῃσιν ἄγειν· νῦν δ’ὅρκια πιστὰ	-uu -uu-u u- - -uu --	dactylic hexameter	feminine penthemimeral, hepthemimeral
ψευσάμενοι μαχόμεσθα· τὼ οὔ νύ τι κέρδιον ἡμῖν	-uu- uu-u u - u u -uu --	dactylic hexameter	feminine penthemimeral, hepthemimeral, trithemimeral
ἔλπομαι ἐκτελέεσθαι, ἵνα μὴ ῥέξομεν ὧδε.	-uu -uu-u u- - -uu --	dactylic hexameter	feminine penthemimeral, hepthemimeral
ἤτοι ὅ γ’ὣς εἰπὼν κατ’ ἄρ’ ἕζετο· τοῖσι δ’ἀνέστη	-u u - -- u u -uu -u u--	dactylic hexameter	masculine penthemimeral, trithemimeral
δῖος Ἀλέξανδρος Ἑλένης πόσις ἠϋκόμοιο,	-u u--- uu- uu -uu--	dactylic hexameter	masculine penthemimeral, hepthemimeral
ὅς μιν ἀμειβόμενος ἔπεα πτερόεντα προσηύδα·	- u u-uu- uu- uu-u u--	dactylic hexameter	masculine penthemimeral, hepthemimeral
Ἀντῆνορ σὺ μὲν οὐκέτ’ ἐμοὶ φίλα ταῦτ’ ἀγορεύεις·	--- u u -u u- uu - uu--	dactylic hexameter	feminine penthemimeral, hepthemimeral, trithemimeral
οἶσθα καὶ ἄλλον μῦθον ἀμείνονα τοῦδε νοῆσαι.	-u u -- -u u-uu -u u--	dactylic hexameter	feminine penthemimeral
εἰ δ’ἐτεὸν δὴ τοῦτον ἀπὸ σπουδῆς ἀγορεύεις,	- uu- - -u u- -- uu--	dactylic hexameter	feminine penthemimeral, hepthemimeral, trithemimeral
ἐξ ἄρα δή τοι ἔπειτα θεοὶ φρένας ὤλεσαν αὐτοί.	- uu - u u-u u- uu -uu --	dactylic hexameter	feminine penthemimeral, hepthemimeral, trithemimeral
αὐτὰρ ἐγὼ Τρώεσσι μεθ’ ἱπποδάμοις ἀγορεύσω·	-u u- --u u -uu- uu--	dactylic hexameter	feminine penthemimeral, trithemimeral
ἀντικρὺ δ’ἀπόφημι γυναῖκα μὲν οὐκ ἀποδώσω·	--- uu-u u-u u - uu--	dactylic hexameter	feminine penthemimeral, trithemimeral
κτήματα δ’ὅσσ’ ἀγόμην ἐξ Ἄργεος ἡμέτερον δῶ	-uu - uu- - -uu -uu- -	dactylic hexameter	masculine penthemimeral, trithemimeral
πάντ’ ἐθέλω δόμεναι καὶ οἴκοθεν ἄλλ’ ἐπιθεῖναι.	- uu- uu- - -uu - uu--	dactylic hexameter	masculine penthemimeral, trithemimeral
ἤτοι ὅ γ’ὣς εἰπὼν κατ’ ἄρ’ ἕζετο· τοῖσι δ’ἀνέστη	-u u - -- u u -uu -u u--	dactylic hexameter	masculine penthemimeral, trithemimeral
Δαρδανίδης Πρίαμος, θεόφιν μήστωρ ἀτάλαντος,	-uu- uu- uu- -- uu--	dactylic hexameter	masculine penthemimeral, hepthemimeral, trithemimeral
ὅ σφιν ἐϋφρονέων ἀγορήσατο καὶ μετέειπε·	- u u-uu- uu-uu - uu--	dactylic hexameter	masculine penthemimeral
κέκλυτέ μευ Τρῶες καὶ Δάρδανοι ἠδ’ ἐπίκουροι,	-uu - -- - -uu - uu--	dactylic hexameter	masculine penthemimeral, trithemimeral
ὄφρ’ εἴπω τά με θυμὸς ἐνὶ στήθεσσι κελεύει.	- -- u u -u u- --u u--	dactylic hexameter	feminine penthemimeral, hepthemimeral, trithemimeral
νῦν μὲν δόρπον ἕλεσθε κατὰ πτόλιν ὡς τὸ πάρος περ,	- - -u u-u u- uu - u u- -	dactylic hexameter	feminine penthemimeral, hepthemimeral
καὶ φυλακῆς μνήσασθε καὶ ἐγρήγορθε ἕκαστος·	- uu- --u u ---u u--	dactylic hexameter	feminine penthemimeral, trithemimeral
ἠῶθεν δ’Ἰδαῖος ἴτω κοίλας ἐπὶ νῆας	--- --u u- -- uu --	dactylic hexameter	feminine penthemimeral, hepthemimeral, trithemimeral
εἰπέμεν Ἀτρεΐδῃς Ἀγαμέμνονι καὶ Μενελάῳ	-uu -uu- uu-uu - uu--	dactylic hexameter	masculine penthemimeral
μῦθον Ἀλεξάνδροιο, τοῦ εἵνεκα νεῖκος ὄρωρε·	-u u---u u -uu -u u--	dactylic hexameter	feminine penthemimeral
καὶ δὲ τόδ’ εἰπέμεναι πυκινὸν ἔπος, αἴ κ’ἐθέλωσι	- u u -uu- uu- uu - uu--	dactylic hexameter	masculine penthemimeral, hepthemimeral
παύσασθαι πολέμοιο δυσηχέος, εἰς ὅ κε νεκροὺς	--- uu-u u-uu - u u --	dactylic hexameter	feminine penthemimeral, trithemimeral
κήομεν· ὕστερον αὖτε μαχησόμεθ’ εἰς ὅ κε δαίμων	-uu -uu -u u-uu - u u --	dactylic hexameter	feminine penthemimeral
ἄμμε διακρίνῃ, δώῃ δ’ἑτέροισί γε νίκην.	-u u--- -- uu-u u --	dactylic hexameter	masculine penthemimeral, hepthemimeral
ὣς ἔφαθ’, οἳ δ’ἄρα τοῦ μάλα μὲν κλύον ἠδ’ ἐπίθοντο·	- uu - uu - uu - uu - uu--	dactylic hexameter	masculine penthemimeral, hepthemimeral, trithemimeral
δόρπον ἔπειθ’ εἵλοντο κατὰ στρατὸν ἐν τελέεσσιν·	-u u- --u u- uu - uu--	dactylic hexameter	feminine penthemimeral, hepthemimeral, trithemimeral
ἠῶθεν δ’Ἰδαῖος ἔβη κοίλας ἐπὶ νῆας·	--- --u u- -- uu --	dactylic hexameter	feminine penthemimeral, hepthemimeral, trithemimeral
τοὺς δ’εὗρ’ εἰν ἀγορῇ Δαναοὺς θεράποντας Ἄρηος	- - - uu- uu- uu-u u--	dactylic hexameter	masculine penthemimeral, hepthemimeral, trithemimeral
νηῒ πάρα πρύμνῃ Ἀγαμέμνονος· αὐτὰρ ὃ τοῖσι	-u u- -- uu-uu -u u --	dactylic hexameter	masculine penthemimeral, trithemimeral
στὰς ἐν μέσσοισιν μετεφώνεεν ἠπύτα κῆρυξ·	- - --- uu-uu -uu --	dactylic hexameter	masculine penthemimeral
Ἀτρεΐδη τε καὶ ἄλλοι ἀριστῆες Παναχαιῶν	-uu- u u -u u--- uu--	dactylic hexameter	feminine penthemimeral, trithemimeral
ἠνώγει Πρίαμός τε καὶ ἄλλοι Τρῶες ἀγαυοὶ	--- uu- u u -- -u u--	dactylic hexameter	masculine penthemimeral, trithemimeral
εἰπεῖν, αἴ κέ περ ὔμμι φίλον καὶ ἡδὺ γένοιτο,	-- - u u -u u- - -u u--	dactylic hexameter	feminine penthemimeral, hepthemimeral, trithemimeral
μῦθον Ἀλεξάνδροιο, τοῦ εἵνεκα νεῖκος ὄρωρε·	-u u---u u -uu -u u--	dactylic hexameter	feminine penthemimeral
κτήματα μὲν ὅσ’ Ἀλέξανδρος κοίλῃς ἐνὶ νηυσὶν	-uu - u u--- -- uu --	dactylic hexameter	hepthemimeral, trithemimeral
ἠγάγετο Τροίηνδ’· ὡς πρὶν ὤφελλ’ ἀπολέσθαι·	-uu- -- - - -- uu--	dactylic hexameter	masculine penthemimeral, hepthemimeral, trithemimeral
πάντ’ ἐθέλει δόμεναι καὶ οἴκοθεν ἄλλ’ ἐπιθεῖναι·	- uu- uu- - -uu - uu--	dactylic hexameter	masculine penthemimeral, trithemimeral
κουριδίην δ’ἄλοχον Μενελάου κυδαλίμοιο	-uu- uu- uu-- -uu--	dactylic hexameter	masculine penthemimeral, trithemimeral
οὔ φησιν δώσειν· ἦ μὴν Τρῶές γε κέλονται.	- -- -- - - -- u u--	dactylic hexameter	masculine penthemimeral, hepthemimeral, trithemimeral
καὶ δὲ τόδ’ ἠνώγεον εἰπεῖν ἔπος αἴ κ’ἐθέλητε	- u u --- -- uu - uu--	dactylic hexameter	masculine penthemimeral, hepthemimeral
παύσασθαι πολέμοιο δυσηχέος εἰς ὅ κε νεκροὺς	--- uu-u u-uu - u u --	dactylic hexameter	feminine penthemimeral, trithemimeral
κήομεν· ὕστερον αὖτε μαχησόμεθ’ εἰς ὅ κε δαίμων	-uu -uu -u u-uu - u u --	dactylic hexameter	feminine penthemimeral
ἄμμε διακρίνῃ, δώῃ δ’ἑτέροισί γε νίκην.	-u u--- -- uu-u u --	dactylic hexameter	masculine penthemimeral, hepthemimeral
ὣς ἔφαθ’, οἳ δ’ἄρα πάντες ἀκὴν ἐγένοντο σιωπῇ·	- uu - uu -u u- uu-u u--	dactylic hexameter	feminine penthemimeral, hepthemimeral, trithemimeral
ὀψὲ δὲ δὴ μετέειπε βοὴν ἀγαθὸς Διομήδης·	-u u - uu-u u- uu- uu--	dactylic hexameter	feminine penthemimeral, hepthemimeral, trithemimeral
μήτ’ ἄρ τις νῦν κτήματ’ Ἀλεξάνδροιο δεχέσθω	- - - - -u u---u u--	dactylic hexameter	feminine penthemimeral, trithemimeral
μήθ’ Ἑλένην· γνωτὸν δὲ καὶ ὃς μάλα νήπιός ἐστιν	- uu- -- u u - uu -uu --	dactylic hexameter	masculine penthemimeral, hepthemimeral, trithemimeral
ὡς ἤδη Τρώεσσιν ὀλέθρου πείρατ’ ἐφῆπται.	- -- --u u-- -u u--	dactylic hexameter	feminine penthemimeral, trithemimeral
ὣς ἔφαθ’, οἳ δ’ἄρα πάντες ἐπίαχον υἷες Ἀχαιῶν	- uu - uu -u u-uu -u u--	dactylic hexameter	feminine penthemimeral, trithemimeral
μῦθον ἀγασσάμενοι Διομήδεος ἱπποδάμοιο·	-u u-uu- uu-uu -uu--	dactylic hexameter	masculine penthemimeral
καὶ τότ’ ἄρ’ Ἰδαῖον προσέφη κρείων Ἀγαμέμνων·	- u u --- uu- -- uu--	dactylic hexameter	masculine penthemimeral, hepthemimeral
Ἰδαῖ’ ἤτοι μῦθον Ἀχαιῶν αὐτὸς ἀκούεις	-- -- -u u-- -u u--	dactylic hexameter	feminine penthemimeral
ὥς τοι ὑποκρίνονται· ἐμοὶ δ’ἐπιανδάνει οὕτως	- u u---u u- uu-uu --	dactylic hexameter	feminine penthemimeral, hepthemimeral
ἀμφὶ δὲ νεκροῖσιν κατακαιέμεν οὔ τι μεγαίρω·	-u u --- uu-uu - u u--	dactylic hexameter	masculine penthemimeral
οὐ γάρ τις φειδὼ νεκύων κατατεθνηώτων	- - - -- uu- -uu---	anapaestic	
γίγνετ’ ἐπεί κε θάνωσι πυρὸς μειλισσέμεν ὦκα.	-u u- u u-u u- --uu --	dactylic hexameter	feminine penthemimeral, hepthemimeral, trithemimeral
ὅρκια δὲ Ζεὺς ἴστω ἐρίγδουπος πόσις Ἥρης.	-uu - - -u u--- uu --	dactylic hexameter	feminine penthemimeral, trithemimeral
ὣς εἰπὼν τὸ σκῆπτρον ἀνέσχεθε πᾶσι θεοῖσιν,	- -- - -u u-uu -u u--	dactylic hexameter	feminine penthemimeral, trithemimeral
ἄψορρον δ’Ἰδαῖος ἔβη προτὶ Ἴλιον ἱρήν.	--- --u u- uu -uu --	dactylic hexameter	feminine penthemimeral, hepthemimeral, trithemimeral
οἳ δ’ἕατ’ εἰν ἀγορῇ Τρῶες καὶ Δαρδανίωνες	- - - uu- -- - -uu--	dactylic hexameter	masculine penthemimeral, hepthemimeral, trithemimeral
πάντες ὁμηγερέες, ποτιδέγμενοι ὁππότ’ ἄρ’ ἔλθοι	-u u-uu- uu-uu -u u --	dactylic hexameter	masculine penthemimeral
Ἰδαῖος· ὃ δ’ἄρ’ ἦλθε καὶ ἀγγελίην ἀπέειπε	--- u u -u u -uu- uu--	dactylic hexameter	feminine penthemimeral, trithemimeral
στὰς ἐν μέσσοισιν· τοὶ δ’ὁπλίζοντο μάλ’ ὦκα,	- - --- - ---u u --	dactylic hexameter	masculine penthemimeral
ἀμφότερον νέκυάς τ’ἀγέμεν ἕτεροι δὲ μεθ’ ὕλην·	-uu- uu- uu- uu- u u --	dactylic hexameter	masculine penthemimeral, hepthemimeral, trithemimeral
Ἀργεῖοι δ’ἑτέρωθεν ἐϋσσέλμων ἀπὸ νηῶν	--- uu-u u--- uu --	dactylic hexameter	feminine penthemimeral, trithemimeral
ὀτρύνοντο νέκυς τ’ἀγέμεν, ἕτεροι δὲ μεθ’ ὕλην.	---u u- uu- uu- u u --	dactylic hexameter	masculine penthemimeral, hepthemimeral
Ἠέλιος μὲν ἔπειτα νέον προσέβαλλεν ἀρούρας	-uu- u u-u u- uu-u u--	dactylic hexameter	feminine penthemimeral, hepthemimeral, trithemimeral
ἐξ ἀκαλαρρείταο βαθυρρόου Ὠκεανοῖο	- uu---u u-uu -uu--	dactylic hexameter	feminine penthemimeral
οὐρανὸν εἰσανιών· οἳ δ’ἤντεον ἀλλήλοισιν.	-uu -uu- - -uu ----	dactylic hexameter	masculine penthemimeral
ἔνθα διαγνῶναι χαλεπῶς ἦν ἄνδρα ἕκαστον·	-u u--- uu- - -u u--	dactylic hexameter	masculine penthemimeral, hepthemimeral
ἀλλ’ ὕδατι νίζοντες ἄπο βρότον αἱματόεντα	- uu- --u u- uu -uu--	dactylic hexameter	feminine penthemimeral, hepthemimeral, trithemimeral
δάκρυα θερμὰ χέοντες ἀμαξάων ἐπάειραν.	-uu -u u-u u--- uu--	dactylic hexameter	feminine penthemimeral
οὐδ’ εἴα κλαίειν Πρίαμος μέγας· οἳ δὲ σιωπῇ	- -- -- uu- uu - u u--	dactylic hexameter	masculine penthemimeral, hepthemimeral, trithemimeral
νεκροὺς πυρκαϊῆς ἐπινήνεον ἀχνύμενοι κῆρ,	-- -uu- uu-uu -uu- -	dactylic hexameter	masculine penthemimeral
ἐν δὲ πυρὶ πρήσαντες ἔβαν προτὶ Ἴλιον ἱρήν.	- u u- --u u- uu -uu --	dactylic hexameter	feminine penthemimeral, hepthemimeral, trithemimeral
ὣς δ’αὔτως ἑτέρωθεν ἐϋκνήμιδες Ἀχαιοὶ	- -- uu-u u---u u--	dactylic hexameter	feminine penthemimeral, trithemimeral
νεκροὺς πυρκαϊῆς ἐπινήνεον ἀχνύμενοι κῆρ,	-- -uu- uu-uu -uu- -	dactylic hexameter	masculine penthemimeral
ἐν δὲ πυρὶ πρήσαντες ἔβαν κοίλας ἐπὶ νῆας.	- u u- --u u- -- uu --	dactylic hexameter	feminine penthemimeral, hepthemimeral, trithemimeral
ἦμος δ’οὔτ’ ἄρ πω ἠώς, ἔτι δ’ἀμφιλύκη νύξ,	-- - - - u- uu -uu- -	lyric	
τῆμος ἄρ’ ἀμφὶ πυρὴν κριτὸς ἔγρετο λαὸς Ἀχαιῶν,	-u u -u u- uu -uu -u u--	dactylic hexameter	masculine penthemimeral
τύμβον δ’ἀμφ’ αὐτὴν ἕνα ποίεον ἐξαγαγόντες	-- - -- uu -uu -uu--	dactylic hexameter	masculine penthemimeral, trithemimeral
ἄκριτον ἐκ πεδίου, ποτὶ δ’αὐτὸν τεῖχος ἔδειμαν	-uu - uu- uu -- -u u--	dactylic hexameter	masculine penthemimeral, trithemimeral
πύργους θ’ὑψηλούς, εἶλαρ νηῶν τε καὶ αὐτῶν.	-- --- -- -- u u --	dactylic hexameter	masculine penthemimeral, hepthemimeral
ἐν δ’αὐτοῖσι πύλας ἐνεποίεον εὖ ἀραρυίας,	- --u u- uu-uu - uu--	dactylic hexameter	masculine penthemimeral
ὄφρα δι’ αὐτάων ἱππηλασίη ὁδὸς εἴη·	-u u --- --uu- uu --	dactylic hexameter	masculine penthemimeral
ἔκτοσθεν δὲ βαθεῖαν ἐπ’ αὐτῷ τάφρον ὄρυξαν	--- u u-u u -- -u u--	dactylic hexameter	feminine penthemimeral, trithemimeral
εὐρεῖαν μεγάλην, ἐν δὲ σκόλοπας κατέπηξαν.	--- uu- - - uu- uu--	dactylic hexameter	masculine penthemimeral, hepthemimeral, trithemimeral
ὣς οἳ μὲν πονέοντο κάρη κομόωντες Ἀχαιοί·	- - - uu-u u- uu-u u--	dactylic hexameter	feminine penthemimeral, hepthemimeral, trithemimeral
οἳ δὲ θεοὶ πὰρ Ζηνὶ καθήμενοι ἀστεροπητῇ	- u u- - -u u-uu -uu--	dactylic hexameter	feminine penthemimeral, trithemimeral
θηεῦντο μέγα ἔργον Ἀχαιῶν χαλκοχιτώνων.	--- uu -u u-- -uu--	dactylic hexameter	feminine penthemimeral, trithemimeral
τοῖσι δὲ μύθων ἦρχε Ποσειδάων ἐνοσίχθων·	-u u -- -u u--- uu--	dactylic hexameter	feminine penthemimeral
Ζεῦ πάτερ, ἦ ῥά τίς ἐστι βροτῶν ἐπ’ ἀπείρονα γαῖαν	- uu - u u -u u- u u-uu --	dactylic hexameter	feminine penthemimeral, hepthemimeral, trithemimeral
ὅς τις ἔτ’ ἀθανάτοισι νόον καὶ μῆτιν ἐνίψει;	- u u -uu-u u- - -u u--	dactylic hexameter	feminine penthemimeral, hepthemimeral
οὐχ ὁράᾳς ὅτι δ’αὖτε κάρη κομόωντες Ἀχαιοὶ	- uu- uu -u u- uu-u u--	dactylic hexameter	feminine penthemimeral, hepthemimeral, trithemimeral
τεῖχος ἐτειχίσσαντο νεῶν ὕπερ, ἀμφὶ δὲ τάφρον	-u u---u u- uu -u u --	dactylic hexameter	feminine penthemimeral, hepthemimeral
ἤλασαν, οὐδὲ θεοῖσι δόσαν κλειτὰς ἑκατόμβας;	-uu -u u-u u- -- uu--	dactylic hexameter	feminine penthemimeral, hepthemimeral
τοῦ δ’ἤτοι κλέος ἔσται ὅσον τ’ἐπικίδναται ἠώς·	- -- uu -u u- uu-uu --	dactylic hexameter	feminine penthemimeral, hepthemimeral, trithemimeral
τοῦ δ’ἐπιλήσονται τὸ ἐγὼ καὶ Φοῖβος Ἀπόλλων	- uu--- u u- - -u u--	dactylic hexameter	masculine penthemimeral, hepthemimeral
ἥρῳ Λαομέδοντι πολίσσαμεν ἀθλήσαντε.	-- -uu-u u-uu ----	dactylic hexameter	feminine penthemimeral
τὸν δὲ μέγ’ ὀχθήσας προσέφη νεφεληγερέτα Ζεύς·	- u u --- uu- uu-uu- -	dactylic hexameter	masculine penthemimeral, hepthemimeral
ὢ πόποι ἐννοσίγαι’ εὐρυσθενές, οἷον ἔειπες.	- uu -uu- --uu -u u--	dactylic hexameter	masculine penthemimeral
ἄλλός κέν τις τοῦτο θεῶν δείσειε νόημα,	-- - - -u u- --u u--	dactylic hexameter	feminine penthemimeral, hepthemimeral, trithemimeral
ὃς σέο πολλὸν ἀφαυρότερος χεῖράς τε μένος τε·	- uu -u u-uu- -- u u- -	dactylic hexameter	hepthemimeral
σὸν δ’ἤτοι κλέος ἔσται ὅσον τ’ἐπικίδναται ἠώς.	- -- uu -u u- uu-uu --	dactylic hexameter	feminine penthemimeral, hepthemimeral, trithemimeral
ἄγρει μὰν ὅτ’ ἂν αὖτε κάρη κομόωντες Ἀχαιοὶ	-- - u u -u u- uu-u u--	dactylic hexameter	feminine penthemimeral, hepthemimeral, trithemimeral
οἴχωνται σὺν νηυσὶ φίλην ἐς πατρίδα γαῖαν	--- - -u u- - -uu --	dactylic hexameter	feminine penthemimeral, hepthemimeral, trithemimeral
τεῖχος ἀναρρήξας τὸ μὲν εἰς ἅλα πᾶν καταχεῦαι,	-u u--- u u - uu - uu--	dactylic hexameter	masculine penthemimeral, hepthemimeral
αὖτις δ’ἠϊόνα μεγάλην ψαμάθοισι καλύψαι,	-- -uu- uu- uu-u u--	dactylic hexameter	masculine penthemimeral, hepthemimeral
ὥς κέν τοι μέγα τεῖχος ἀμαλδύνηται Ἀχαιῶν.	- - - uu -u u---u u--	dactylic hexameter	feminine penthemimeral, trithemimeral
ὣς οἳ μὲν τοιαῦτα πρὸς ἀλλήλους ἀγόρευον,	- - - --u u --- uu--	dactylic hexameter	feminine penthemimeral, trithemimeral
δύσετο δ’ἠέλιος, τετέλεστο δὲ ἔργον Ἀχαιῶν,	-uu -uu- uu-u u -u u--	dactylic hexameter	masculine penthemimeral
βουφόνεον δὲ κατὰ κλισίας καὶ δόρπον ἕλοντο.	-uu- u u- uu- - -u u--	dactylic hexameter	masculine penthemimeral, hepthemimeral, trithemimeral
νῆες δ’ἐκ Λήμνοιο παρέσταν οἶνον ἄγουσαι	-- - --u u-- -u u--	dactylic hexameter	feminine penthemimeral, trithemimeral
πολλαί, τὰς προέηκεν Ἰησονίδης Εὔνηος,	-- - uu-u u-uu- ---	dactylic hexameter	feminine penthemimeral, trithemimeral
τόν ῥ’ἔτεχ’ Ὑψιπύλη ὑπ’ Ἰήσονι ποιμένι λαῶν.	- uu -uu- u u-uu -uu --	dactylic hexameter	masculine penthemimeral
χωρὶς δ’Ἀτρεΐδῃς Ἀγαμέμνονι καὶ Μενελάῳ	-- -uu- uu-uu - uu--	dactylic hexameter	masculine penthemimeral
δῶκεν Ἰησονίδης ἀγέμεν μέθυ χίλια μέτρα.	-u u-uu- uu- uu -uu --	dactylic hexameter	masculine penthemimeral, hepthemimeral
ἔνθεν οἰνίζοντο κάρη κομόωντες Ἀχαιοί,	-- ---u u- uu-u u--	dactylic hexameter	feminine penthemimeral, hepthemimeral
ἄλλοι μὲν χαλκῷ, ἄλλοι δ’αἴθωνι σιδήρῳ,	-- - -- -- --u u--	dactylic hexameter	masculine penthemimeral, hepthemimeral, trithemimeral
ἄλλοι δὲ ῥινοῖς, ἄλλοι δ’αὐτῇσι βόεσσιν,	-- - -- -- --u u--	dactylic hexameter	masculine penthemimeral, hepthemimeral, trithemimeral
ἄλλοι δ’ἀνδραπόδεσσι· τίθεντο δὲ δαῖτα θάλειαν.	-- -uu-u u-u u -u u--	dactylic hexameter	feminine penthemimeral
παννύχιοι μὲν ἔπειτα κάρη κομόωντες Ἀχαιοὶ	-uu- u u-u u- uu-u u--	dactylic hexameter	feminine penthemimeral, hepthemimeral, trithemimeral
δαίνυντο, Τρῶες δὲ κατὰ πτόλιν ἠδ’ ἐπίκουροι·	--- -- u u- uu - uu--	dactylic hexameter	masculine penthemimeral, hepthemimeral, trithemimeral
παννύχιος δέ σφιν κακὰ μήδετο μητίετα Ζεὺς	-uu- - - uu -uu -uu- -	dactylic hexameter	masculine penthemimeral, trithemimeral
σμερδαλέα κτυπέων· τοὺς δὲ χλωρὸν δέος ᾕρει·	-uu- uu- - - -- uu --	dactylic hexameter	masculine penthemimeral, hepthemimeral, trithemimeral
οἶνον δ’ἐκ δεπάων χαμάδις χέον, οὐδέ τις ἔτλη	-- - uu- uu- uu -u u --	dactylic hexameter	masculine penthemimeral, hepthemimeral, trithemimeral
πρὶν πιέειν πρὶν λεῖψαι ὑπερμενέϊ Κρονίωνι.	- uu- - -u u-uu- uu--	dactylic hexameter	feminine penthemimeral, trithemimeral
κοιμήσαντ’ ἄρ’ ἔπειτα καὶ ὕπνου δῶρον ἕλοντο.	--- u u-u u -- -u u--	dactylic hexameter	feminine penthemimeral, trithemimeral
