Νέστορα δ’οὐκ ἔλαθεν ἰαχὴ πίνοντά περ ἔμπης,	-uu - uu- uu- --u u --	dactylic hexameter	masculine penthemimeral, hepthemimeral, trithemimeral
ἀλλ’ Ἀσκληπιάδην ἔπεα πτερόεντα προσηύδα·	- --uu- uu- uu-u u--	dactylic hexameter	masculine penthemimeral, hepthemimeral
φράζεο δῖε Μαχᾶον ὅπως ἔσται τάδε ἔργα·	-uu -u u-u u- -- uu --	dactylic hexameter	feminine penthemimeral, hepthemimeral
μείζων δὴ παρὰ νηυσὶ βοὴ θαλερῶν αἰζηῶν.	-- - uu -u u- uu- ---	dactylic hexameter	feminine penthemimeral, hepthemimeral, trithemimeral
ἀλλὰ σὺ μὲν νῦν πῖνε καθήμενος αἴθοπα οἶνον	-u u - - -u u-uu -uu --	dactylic hexameter	feminine penthemimeral, trithemimeral
εἰς ὅ κε θερμὰ λοετρὰ ἐϋπλόκαμος Ἑκαμήδη	- u u -u u-u u-uu- uu--	dactylic hexameter	feminine penthemimeral
θερμήνῃ καὶ λούσῃ ἄπο βρότον αἱματόεντα·	--- - -u u- uu -uu--	dactylic hexameter	feminine penthemimeral, hepthemimeral, trithemimeral
αὐτὰρ ἐγὼν ἐλθὼν τάχα εἴσομαι ἐς περιωπήν.	-u u- -- uu -uu - uu--	dactylic hexameter	masculine penthemimeral, trithemimeral
ὣς εἰπὼν σάκος εἷλε τετυγμένον υἷος ἑοῖο	- -- uu -u u-uu -u u--	dactylic hexameter	feminine penthemimeral, trithemimeral
κείμενον ἐν κλισίῃ Θρασυμήδεος ἱπποδάμοιο	-uu - uu- uu-uu -uu--	dactylic hexameter	masculine penthemimeral, trithemimeral
χαλκῷ παμφαῖνον· ὃ δ’ἔχ’ ἀσπίδα πατρὸς ἑοῖο.	-- --- u u -uu -u u--	dactylic hexameter	masculine penthemimeral
εἵλετο δ’ἄλκιμον ἔγχος ἀκαχμένον ὀξέϊ χαλκῷ,	-uu -uu -u u-uu -uu --	dactylic hexameter	feminine penthemimeral
στῆ δ’ἐκτὸς κλισίης, τάχα δ’εἴσιδεν ἔργον ἀεικὲς	- -- uu- uu -uu -u u--	dactylic hexameter	masculine penthemimeral, trithemimeral
τοὺς μὲν ὀρινομένους, τοὺς δὲ κλονέοντας ὄπισθε	- u u-uu- - - uu-u u--	dactylic hexameter	masculine penthemimeral, hepthemimeral
Τρῶας ὑπερθύμους· ἐρέριπτο δὲ τεῖχος Ἀχαιῶν.	-u u--- uu-u u -u u--	dactylic hexameter	masculine penthemimeral
ὡς δ’ὅτε πορφύρῃ πέλαγος μέγα κύματι κωφῷ	- uu --- uu- uu -uu --	dactylic hexameter	masculine penthemimeral, hepthemimeral
ὀσσόμενον λιγέων ἀνέμων λαιψηρὰ κέλευθα	-uu- uu- uu- --u u--	dactylic hexameter	masculine penthemimeral, hepthemimeral, trithemimeral
αὔτως, οὐδ’ ἄρα τε προκυλίνδεται οὐδετέρωσε,	-- - uu - uu-uu -uu--	dactylic hexameter	masculine penthemimeral, trithemimeral
πρίν τινα κεκριμένον καταβήμεναι ἐκ Διὸς οὖρον,	- uu -uu- uu-uu - uu --	dactylic hexameter	masculine penthemimeral
ὣς ὃ γέρων ὅρμαινε δαϊζόμενος κατὰ θυμὸν	- u u- --u u-uu- uu --	dactylic hexameter	feminine penthemimeral, trithemimeral
διχθάδι’, ἢ μεθ’ ὅμιλον ἴοι Δαναῶν ταχυπώλων,	-uu - u u-u u- uu- uu--	dactylic hexameter	feminine penthemimeral, hepthemimeral, trithemimeral
ἦε μετ’ Ἀτρεΐδην Ἀγαμέμνονα ποιμένα λαῶν.	-u u -uu- uu-uu -uu --	dactylic hexameter	masculine penthemimeral
ὧδε δέ οἱ φρονέοντι δοάσσατο κέρδιον εἶναι	-u u - uu-u u-uu -uu --	dactylic hexameter	feminine penthemimeral, trithemimeral
βῆναι ἐπ’ Ἀτρεΐδην. οἳ δ’ἀλλήλους ἐνάριζον	-u u -uu- - --- uu--	dactylic hexameter	masculine penthemimeral
μαρνάμενοι· λάκε δέ σφι περὶ χροῒ χαλκὸς ἀτειρὴς	-uu- uu - u u- uu -u u--	dactylic hexameter	masculine penthemimeral, hepthemimeral, trithemimeral
νυσσομένων ξίφεσίν τε καὶ ἔγχεσιν ἀμφιγύοισι.	-uu- uu- u u -uu -uu--	dactylic hexameter	masculine penthemimeral, trithemimeral
Νέστορι δὲ ξύμβληντο διοτρεφέες βασιλῆες	-uu - --u u-uu- uu--	dactylic hexameter	feminine penthemimeral, trithemimeral
πὰρ νηῶν ἀνιόντες ὅσοι βεβλήατο χαλκῷ	- -- uu-u u- --uu --	dactylic hexameter	feminine penthemimeral, hepthemimeral, trithemimeral
Τυδεΐδης Ὀδυσεύς τε καὶ Ἀτρεΐδης Ἀγαμέμνων.	-uu- uu- u u -uu- uu--	dactylic hexameter	masculine penthemimeral, trithemimeral
πολλὸν γάρ ῥ’ἀπάνευθε μάχης εἰρύατο νῆες	-- - uu-u u- --uu --	dactylic hexameter	feminine penthemimeral, hepthemimeral, trithemimeral
θῖν’ ἔφ’ ἁλὸς πολιῆς· τὰς γὰρ πρώτας πεδίον δὲ	- u u- uu- - - -- uu- -	dactylic hexameter	masculine penthemimeral, hepthemimeral, trithemimeral
εἴρυσαν, αὐτὰρ τεῖχος ἐπὶ πρύμνῃσιν ἔδειμαν.	-uu -- -u u- --u u--	dactylic hexameter	feminine penthemimeral, hepthemimeral
οὐδὲ γὰρ οὐδ’ εὐρύς περ ἐὼν ἐδυνήσατο πάσας	-u u - -- u u- uu-uu --	dactylic hexameter	masculine penthemimeral, hepthemimeral, trithemimeral
αἰγιαλὸς νῆας χαδέειν, στείνοντο δὲ λαοί·	-uu- -- uu- --u u --	dactylic hexameter	masculine penthemimeral, hepthemimeral, trithemimeral
τώ ῥα προκρόσσας ἔρυσαν, καὶ πλῆσαν ἁπάσης	- - --- uu- - -u u--	dactylic hexameter	masculine penthemimeral, hepthemimeral
ἠϊόνος στόμα μακρόν, ὅσον συνεέργαθον ἄκραι.	-uu- uu -u u- uu-uu --	dactylic hexameter	feminine penthemimeral, hepthemimeral, trithemimeral
τώ ῥ’οἵ γ’ὀψείοντες ἀϋτῆς καὶ πολέμοιο	- - ---u u-- - uu--	dactylic hexameter	feminine penthemimeral
ἔγχει ἐρειδόμενοι κίον ἀθρόοι· ἄχνυτο δέ σφι	-u u-uu- uu -uu -uu - -	dactylic hexameter	masculine penthemimeral
θυμὸς ἐνὶ στήθεσσιν. ὃ δὲ ξύμβλητο γεραιὸς	-u u- --u u - --u u--	dactylic hexameter	feminine penthemimeral, hepthemimeral, trithemimeral
Νέστωρ, πτῆξε δὲ θυμὸν ἐνὶ στήθεσσιν Ἀχαιῶν.	-- -u u -u u- --u u--	dactylic hexameter	feminine penthemimeral, hepthemimeral
τὸν καὶ φωνήσας προσέφη κρείων Ἀγαμέμνων·	- - --- uu- -- uu--	dactylic hexameter	masculine penthemimeral, hepthemimeral
ὦ Νέστορ Νηληϊάδη μέγα κῦδος Ἀχαιῶν	- -- --uu- uu -u u--	dactylic hexameter	hepthemimeral, trithemimeral
τίπτε λιπὼν πόλεμον φθισήνορα δεῦρ’ ἀφικάνεις;	-u u- uu- --uu - uu--	dactylic hexameter	masculine penthemimeral, trithemimeral
δείδω μὴ δή μοι τελέσῃ ἔπος ὄβριμος Ἕκτωρ,	-- - - - uu- uu -uu --	dactylic hexameter	masculine penthemimeral, hepthemimeral, trithemimeral
ὥς ποτ’ ἐπηπείλησεν ἐνὶ Τρώεσσ’ ἀγορεύων	- u u---u u- -- uu--	dactylic hexameter	feminine penthemimeral, hepthemimeral
μὴ πρὶν πὰρ νηῶν προτὶ Ἴλιον ἀπονέεσθαι	- - - -- uu -uu -uu--	dactylic hexameter	masculine penthemimeral, trithemimeral
πρὶν πυρὶ νῆας ἐνιπρῆσαι, κτεῖναι δὲ καὶ αὐτούς.	- uu -u u--- -- u u --	dactylic hexameter	hepthemimeral
κεῖνος τὼς ἀγόρευε· τὰ δὴ νῦν πάντα τελεῖται.	-- - uu-u u - - -u u--	dactylic hexameter	feminine penthemimeral, hepthemimeral, trithemimeral
ὢ πόποι ἦ ῥα καὶ ἄλλοι ἐϋκνήμιδες Ἀχαιοὶ	- uu - u u -u u---u u--	dactylic hexameter	feminine penthemimeral, trithemimeral
ἐν θυμῷ βάλλονται ἐμοὶ χόλον ὥς περ Ἀχιλλεὺς	- -- --u u- uu - u u--	dactylic hexameter	feminine penthemimeral, hepthemimeral, trithemimeral
οὐδ’ ἐθέλουσι μάχεσθαι ἐπὶ πρυμνῇσι νέεσσι.	- uu-u u-u u- --u u--	dactylic hexameter	feminine penthemimeral, hepthemimeral
τὸν δ’ἠμείβετ’ ἔπειτα Γερήνιος ἱππότα Νέστωρ·	- --u u-u u-uu -uu --	dactylic hexameter	feminine penthemimeral
ἦ δὴ ταῦτά γ’ἑτοῖμα τετεύχαται, οὐδέ κεν ἄλλως	- - -u u-u u-uu -u u --	dactylic hexameter	feminine penthemimeral
Ζεὺς ὑψιβρεμέτης αὐτὸς παρατεκτήναιτο.	- --uu- -- uu----	dactylic hexameter	masculine penthemimeral, hepthemimeral
τεῖχος μὲν γὰρ δὴ κατερήριπεν, ᾧ ἐπέπιθμεν	-- - - - uu-uu - uu--	dactylic hexameter	masculine penthemimeral, trithemimeral
ἄρρηκτον νηῶν τε καὶ αὐτῶν εἶλαρ ἔσεσθαι·	--- -- u u -- -u u--	dactylic hexameter	masculine penthemimeral, trithemimeral
οἳ δ’ἐπὶ νηυσὶ θοῇσι μάχην ἀλίαστον ἔχουσι	- uu -u u-u u- uu-u u--	dactylic hexameter	feminine penthemimeral, hepthemimeral
νωλεμές· οὐδ’ ἂν ἔτι γνοίης μάλα περ σκοπιάζων	-uu - u u- -- uu - uu--	dactylic hexameter	masculine penthemimeral, hepthemimeral, trithemimeral
ὁπποτέρωθεν Ἀχαιοὶ ὀρινόμενοι κλονέονται,	-uu-u u-u u-uu- uu--	dactylic hexameter	feminine penthemimeral
ὡς ἐπιμὶξ κτείνονται, ἀϋτὴ δ’οὐρανὸν ἵκει.	- uu- --u u-- -uu --	dactylic hexameter	feminine penthemimeral, trithemimeral
ἡμεῖς δὲ φραζώμεθ’ ὅπως ἔσται τάδε ἔργα	-- - --u u- -- uu --	dactylic hexameter	feminine penthemimeral, hepthemimeral, trithemimeral
εἴ τι νόος ῥέξει· πόλεμον δ’οὐκ ἄμμε κελεύω	- u u- -- uu- - -u u--	dactylic hexameter	masculine penthemimeral, hepthemimeral, trithemimeral
δύμεναι· οὐ γάρ πως βεβλημένον ἐστὶ μάχεσθαι.	-uu - - - --uu -u u--	dactylic hexameter	masculine penthemimeral, trithemimeral
τὸν δ’αὖτε προσέειπεν ἄναξ ἀνδρῶν Ἀγαμέμνων·	- -- uu-u u- -- uu--	dactylic hexameter	feminine penthemimeral, hepthemimeral, trithemimeral
Νέστορ ἐπεὶ δὴ νηυσὶν ἔπι πρυμνῇσι μάχονται,	-u u- - -u u- --u u--	dactylic hexameter	feminine penthemimeral, hepthemimeral, trithemimeral
τεῖχος δ’οὐκ ἔχραισμε τετυγμένον, οὐδέ τι τάφρος,	-- - --u u-uu -u u --	dactylic hexameter	feminine penthemimeral, trithemimeral
ᾗ ἔπι πολλὰ πάθον Δαναοί, ἔλποντο δὲ θυμῷ	- uu -u u- uu- --u u --	dactylic hexameter	masculine penthemimeral, hepthemimeral
ἄρρηκτον νηῶν τε καὶ αὐτῶν εἶλαρ ἔσεσθαι·	--- -- u u -- -u u--	dactylic hexameter	masculine penthemimeral, trithemimeral
οὕτω που Διὶ μέλλει ὑπερμενέϊ φίλον εἶναι	-- - uu -u u-uu- uu --	dactylic hexameter	feminine penthemimeral, trithemimeral
νωνύμνους ἀπολέσθαι ἀπ’ Ἄργεος ἐνθάδ’ Ἀχαιούς.	--- uu-u u -uu -u u--	dactylic hexameter	feminine penthemimeral, trithemimeral
ᾔδεα μὲν γὰρ ὅτε πρόφρων Δαναοῖσιν ἄμυνεν,	-uu - u u- -- uu-u u--	dactylic hexameter	masculine penthemimeral, hepthemimeral, trithemimeral
οἶδα δὲ νῦν ὅτε τοὺς μὲν ὁμῶς μακάρεσσι θεοῖσι	-u u - uu - u u- uu-u u--	dactylic hexameter	masculine penthemimeral, hepthemimeral, trithemimeral
κυδάνει, ἡμέτερον δὲ μένος καὶ χεῖρας ἔδησεν.	-uu -uu- u u- - -u u--	dactylic hexameter	masculine penthemimeral, hepthemimeral
ἀλλ’ ἄγεθ’ ὡς ἂν ἐγὼν εἴπω πειθώμεθα πάντες.	- uu - u u- -- --uu --	dactylic hexameter	masculine penthemimeral, hepthemimeral, trithemimeral
νῆες ὅσαι πρῶται εἰρύαται ἄγχι θαλάσσης	-u u- -- --uu -u u--	dactylic hexameter	masculine penthemimeral, trithemimeral
ἕλκωμεν, πάσας δὲ ἐρύσσομεν εἰς ἅλα δῖαν,	--- -- u u-uu - uu --	dactylic hexameter	masculine penthemimeral, trithemimeral
ὕψι δ’ἐπ’ εὐνάων ὁρμίσσομεν, εἰς ὅ κεν ἔλθῃ	-u u --- --uu - u u --	dactylic hexameter	masculine penthemimeral
νὺξ ἀβρότη, ἢν καὶ τῇ ἀπόσχωνται πολέμοιο	- uu- - - u u--- uu--	dactylic hexameter	masculine penthemimeral, trithemimeral
Τρῶες· ἔπειτα δέ κεν ἐρυσαίμεθα νῆας ἁπάσας.	-u u-u u - uu-uu -u u--	dactylic hexameter	masculine penthemimeral
οὐ γάρ τις νέμεσις φυγέειν κακόν, οὐδ’ ἀνὰ νύκτα.	- - - uu- uu- uu - uu --	dactylic hexameter	masculine penthemimeral, hepthemimeral, trithemimeral
βέλτερον ὃς φεύγων προφύγῃ κακὸν ἠὲ ἁλώῃ.	-uu - -- uu- uu -u u--	dactylic hexameter	masculine penthemimeral, hepthemimeral, trithemimeral
τὸν δ’ἄρ’ ὑπόδρα ἰδὼν προσέφη πολύμητις Ὀδυσσεύς·	- u u-u u- uu- uu-u u--	dactylic hexameter	masculine penthemimeral, hepthemimeral
Ἀτρεΐδη ποῖόν σε ἔπος φύγεν ἕρκος ὀδόντων·	-uu- -- u u- uu -u u--	dactylic hexameter	masculine penthemimeral, hepthemimeral, trithemimeral
οὐλόμεν’ αἴθ’ ὤφελλες ἀεικελίου στρατοῦ ἄλλου	-uu - --u u-uu- uu --	dactylic hexameter	feminine penthemimeral, trithemimeral
σημαίνειν, μὴ δ’ἄμμιν ἀνασσέμεν, οἷσιν ἄρα Ζεὺς	--- - -u u-uu -u u- -	dactylic hexameter	feminine penthemimeral, trithemimeral
ἐκ νεότητος ἔδωκε καὶ ἐς γῆρας τολυπεύειν	- uu-u u-u u - -- uu--	dactylic hexameter	feminine penthemimeral, hepthemimeral
ἀργαλέους πολέμους, ὄφρα φθιόμεσθα ἕκαστος.	-uu- uu- -- uu-u u--	dactylic hexameter	masculine penthemimeral, hepthemimeral, trithemimeral
οὕτω δὴ μέμονας Τρώων πόλιν εὐρυάγυιαν	-- - uu- -- uu -uu--	dactylic hexameter	masculine penthemimeral, hepthemimeral, trithemimeral
καλλείψειν, ἧς εἵνεκ’ ὀϊζύομεν κακὰ πολλά;	--- - -u u-uu- uu --	dactylic hexameter	feminine penthemimeral, trithemimeral
σίγα, μή τίς τ’ἄλλος Ἀχαιῶν τοῦτον ἀκούσῃ	-- - - -u u-- -u u--	dactylic hexameter	feminine penthemimeral, trithemimeral
μῦθον, ὃν οὔ κεν ἀνήρ γε διὰ στόμα πάμπαν ἄγοιτο	-u u - u u- u u- uu -u u--	dactylic hexameter	masculine penthemimeral, hepthemimeral, trithemimeral
ὅς τις ἐπίσταιτο ᾗσι φρεσὶν ἄρτια βάζειν	- u u--- -- uu -uu --	dactylic hexameter	masculine penthemimeral, hepthemimeral
σκηπτοῦχός τ’εἴη, καί οἱ πειθοίατο λαοὶ	--- -- - - --uu --	dactylic hexameter	masculine penthemimeral, hepthemimeral, trithemimeral
τοσσοίδ’ ὅσσοισιν σὺ μετ’ Ἀργείοισιν ἀνάσσεις·	-- --- u u ---u u--	dactylic hexameter	masculine penthemimeral
νῦν δέ σευ ὠνοσάμην πάγχυ φρένας, οἷον ἔειπες·	- u u -uu- -- uu -u u--	dactylic hexameter	masculine penthemimeral, hepthemimeral
ὃς κέλεαι πολέμοιο συνεσταότος καὶ ἀϋτῆς	- uu- uu-u u-uu- u u--	dactylic hexameter	feminine penthemimeral, trithemimeral
νῆας ἐϋσσέλμους ἅλαδ’ ἑλκέμεν, ὄφρ’ ἔτι μᾶλλον	-u u--- uu -uu - uu --	dactylic hexameter	masculine penthemimeral
Τρωσὶ μὲν εὐκτὰ γένηται ἐπικρατέουσί περ ἔμπης,	-u u -u u-u u-uu-u u --	dactylic hexameter	feminine penthemimeral
ἡμῖν δ’αἰπὺς ὄλεθρος ἐπιρρέπῃ. οὐ γὰρ Ἀχαιοὶ	-- -u u-u u-uu - u u--	dactylic hexameter	feminine penthemimeral
σχήσουσιν πόλεμον νηῶν ἅλα δ’ἑλκομενάων,	--- uu- -- uu -uu--	dactylic hexameter	masculine penthemimeral, hepthemimeral, trithemimeral
ἀλλ’ ἀποπαπτανέουσιν, ἐρωήσουσι δὲ χάρμης.	- uu-uu-u u---u u --	dactylic hexameter	feminine penthemimeral
ἔνθά κε σὴ βουλὴ δηλήσεται ὄρχαμε λαῶν.	-u u - -- --uu -uu --	dactylic hexameter	masculine penthemimeral, trithemimeral
τὸν δ’ἠμείβετ’ ἔπειτα ἄναξ ἀνδρῶν Ἀγαμέμνων·	- --u u-u u- -- uu--	dactylic hexameter	feminine penthemimeral, hepthemimeral
ὦ Ὀδυσεῦ μάλα πώς με καθίκεο θυμὸν ἐνιπῇ	- uu- uu - u u-uu -u u--	dactylic hexameter	masculine penthemimeral, trithemimeral
ἀργαλέῃ· ἀτὰρ οὐ μὲν ἐγὼν ἀέκοντας ἄνωγα	-uu- uu - u u- uu-u u--	dactylic hexameter	masculine penthemimeral, hepthemimeral, trithemimeral
νῆας ἐϋσσέλμους ἅλα δ’ἑλκέμεν υἷας Ἀχαιῶν.	-u u--- uu -uu -u u--	dactylic hexameter	masculine penthemimeral
νῦν δ’εἴη ὃς τῆσδέ γ’ἀμείνονα μῆτιν ἐνίσποι	- -- - -u u-uu -u u--	dactylic hexameter	feminine penthemimeral, trithemimeral
ἢ νέος ἠὲ παλαιός· ἐμοὶ δέ κεν ἀσμένῳ εἴη.	- uu -u u-u u- u u -uu --	dactylic hexameter	feminine penthemimeral, hepthemimeral
τοῖσι δὲ καὶ μετέειπε βοὴν ἀγαθὸς Διομήδης·	-u u - uu-u u- uu- uu--	dactylic hexameter	feminine penthemimeral, hepthemimeral, trithemimeral
ἐγγὺς ἀνήρ· οὐ δηθὰ ματεύσομεν· αἴ κ’ἐθέλητε	-u u- - -u u-uu - uu--	dactylic hexameter	feminine penthemimeral, trithemimeral
πείθεσθαι, καὶ μή τι κότῳ ἀγάσησθε ἕκαστος	--- - - u u- uu-u u--	dactylic hexameter	masculine penthemimeral, hepthemimeral, trithemimeral
οὕνεκα δὴ γενεῆφι νεώτατός εἰμι μεθ’ ὑμῖν·	-uu - uu-u u-uu -u u --	dactylic hexameter	feminine penthemimeral, trithemimeral
πατρὸς δ’ἐξ ἀγαθοῦ καὶ ἐγὼ γένος εὔχομαι εἶναι	-- - uu- u u- uu -uu --	dactylic hexameter	masculine penthemimeral, hepthemimeral, trithemimeral
Τυδέος, ὃν Θήβῃσι χυτὴ κατὰ γαῖα καλύπτει.	-uu - --u u- uu -u u--	dactylic hexameter	feminine penthemimeral, hepthemimeral, trithemimeral
πορθεῖ γὰρ τρεῖς παῖδες ἀμύμονες ἐξεγένοντο,	-- - - -u u-uu -uu--	dactylic hexameter	feminine penthemimeral, trithemimeral
οἴκεον δ’ἐν Πλευρῶνι καὶ αἰπεινῇ Καλυδῶνι	-- - --u u --- uu--	dactylic hexameter	feminine penthemimeral, trithemimeral
Ἄγριος ἠδὲ Μέλας, τρίτατος δ’ἦν ἱππότα Οἰνεὺς	-uu -u u- uu- - -uu --	dactylic hexameter	masculine penthemimeral, hepthemimeral
πατρὸς ἐμοῖο πατήρ· ἀρετῇ δ’ἦν ἔξοχος αὐτῶν.	-u u-u u- uu- - -uu --	dactylic hexameter	masculine penthemimeral, hepthemimeral
ἀλλ’ ὃ μὲν αὐτόθι μεῖνε, πατὴρ δ’ἐμὸς Ἄργεϊ νάσθη	- u u -uu -u u- uu -uu --	dactylic hexameter	feminine penthemimeral, hepthemimeral
πλαγχθείς· ὡς γάρ που Ζεὺς ἤθελε καὶ θεοὶ ἄλλοι.	-- - - - - -uu - uu --	dactylic hexameter	masculine penthemimeral, trithemimeral
Ἀδρήστοιο δ’ἔγημε θυγατρῶν, ναῖε δὲ δῶμα	---u u-u u-- -u u --	dactylic hexameter	feminine penthemimeral
ἀφνειὸν βιότοιο, ἅλις δέ οἱ ἦσαν ἄρουραι	--- uu-u u- u u -u u--	dactylic hexameter	feminine penthemimeral, hepthemimeral, trithemimeral
πυροφόροι, πολλοὶ δὲ φυτῶν ἔσαν ὄρχατοι ἀμφίς,	-uu- -- u u- uu -uu --	dactylic hexameter	masculine penthemimeral, hepthemimeral, trithemimeral
πολλὰ δέ οἱ πρόβατ’ ἔσκε· κέκαστο δὲ πάντας Ἀχαιοὺς	-u u - uu -u u-u u -u u--	dactylic hexameter	feminine penthemimeral, trithemimeral
ἐγχείῃ· τὰ δὲ μέλλετ’ ἀκουέμεν, εἰ ἐτεόν περ.	--- u u -u u-uu - uu- -	dactylic hexameter	feminine penthemimeral, trithemimeral
τὼ οὐκ ἄν με γένος γε κακὸν καὶ ἀνάλκιδα φάντες	- - - u u- u u- u u-uu --	dactylic hexameter	masculine penthemimeral, hepthemimeral, trithemimeral
μῦθον ἀτιμήσαιτε πεφασμένον ὅν κ’ἐῢ εἴπω.	-u u---u u-uu - uu --	dactylic hexameter	feminine penthemimeral
δεῦτ’ ἴομεν πόλεμον δὲ καὶ οὐτάμενοί περ ἀνάγκῃ.	- uu- uu- u u -uu- u u--	dactylic hexameter	masculine penthemimeral, trithemimeral
ἔνθα δ’ἔπειτ’ αὐτοὶ μὲν ἐχώμεθα δηϊοτῆτος	-u u- -- u u-uu -uu--	dactylic hexameter	masculine penthemimeral, trithemimeral
ἐκ βελέων, μή πού τις ἐφ’ ἕλκεϊ ἕλκος ἄρηται·	- uu- - - u u -uu -u u--	dactylic hexameter	masculine penthemimeral, trithemimeral
ἄλλους δ’ὀτρύνοντες ἐνήσομεν, οἳ τὸ πάρος περ	-- ---u u-uu - u u- -	dactylic hexameter	feminine penthemimeral
θυμῷ ἦρα φέροντες ἀφεστᾶσ’ οὐδὲ μάχονται.	-- -u u-u u-- -u u--	dactylic hexameter	feminine penthemimeral
ὣς ἔφαθ’, οἳ δ’ἄρα τοῦ μάλα μὲν κλύον ἠδὲ πίθοντο·	- uu - uu - uu - uu -u u--	dactylic hexameter	masculine penthemimeral, hepthemimeral, trithemimeral
βὰν δ’ἴμεν, ἦρχε δ’ἄρά σφιν ἄναξ ἀνδρῶν Ἀγαμέμνων.	- uu -u u- u u- -- uu--	dactylic hexameter	masculine penthemimeral, hepthemimeral
οὐδ’ ἀλαοσκοπιὴν εἶχε κλυτὸς ἐννοσίγαιος,	- uu-uu- -- uu -uu--	dactylic hexameter	masculine penthemimeral, hepthemimeral
ἀλλὰ μετ’ αὐτοὺς ἦλθε παλαιῷ φωτὶ ἐοικώς,	-u u -- -u u-- -u u--	dactylic hexameter	feminine penthemimeral
δεξιτερὴν δ’ἕλε χεῖρ’ Ἀγαμέμνονος Ἀτρεΐδαο,	-uu- uu - uu-uu -uu--	dactylic hexameter	masculine penthemimeral, trithemimeral
καί μιν φωνήσας ἔπεα πτερόεντα προσηύδα·	- - --- uu- uu-u u--	dactylic hexameter	masculine penthemimeral, hepthemimeral
Ἀτρεΐδη νῦν δή που Ἀχιλλῆος ὀλοὸν κῆρ	-uu- - - u u--- uu- -	dactylic hexameter	masculine penthemimeral, trithemimeral
γηθεῖ ἐνὶ στήθεσσι φόνον καὶ φύζαν Ἀχαιῶν	-u u- --u u- - -u u--	dactylic hexameter	feminine penthemimeral, hepthemimeral, trithemimeral
δερκομένῳ, ἐπεὶ οὔ οἱ ἔνι φρένες οὐδ’ ἠβαιαί.	-uu- uu - u u- uu - ---	dactylic hexameter	masculine penthemimeral, hepthemimeral, trithemimeral
ἀλλ’ ὃ μὲν ὣς ἀπόλοιτο, θεὸς δέ ἑ σιφλώσειε·	- u u - uu-u u- u u ----	dactylic hexameter	feminine penthemimeral, hepthemimeral, trithemimeral
σοὶ δ’οὔ πω μάλα πάγχυ θεοὶ μάκαρες κοτέουσιν,	- - - uu -u u- uu- uu--	dactylic hexameter	feminine penthemimeral, hepthemimeral, trithemimeral
ἀλλ’ ἔτι που Τρώων ἡγήτορες ἠδὲ μέδοντες	- uu - -- --uu -u u--	dactylic hexameter	masculine penthemimeral, trithemimeral
εὐρὺ κονίσουσιν πεδίον, σὺ δ’ἐπόψεαι αὐτὸς	-u u--- uu- u u-uu --	dactylic hexameter	masculine penthemimeral, hepthemimeral
φεύγοντας προτὶ ἄστυ νεῶν ἄπο καὶ κλισιάων.	--- uu -u u- uu - uu--	dactylic hexameter	feminine penthemimeral, hepthemimeral, trithemimeral
ὣς εἰπὼν μέγ’ ἄϋσεν ἐπεσσύμενος πεδίοιο.	- -- u u-u u-uu- uu--	dactylic hexameter	feminine penthemimeral, trithemimeral
ὅσσόν τ’ἐννεάχιλοι ἐπίαχον ἢ δεκάχιλοι	-- -uu-u u-uu - uu--	dactylic hexameter	feminine penthemimeral
ἀνέρες ἐν πολέμῳ ἔριδα ξυνάγοντες Ἄρηος,	-uu - uu- uu- uu-u u--	dactylic hexameter	masculine penthemimeral, hepthemimeral, trithemimeral
τόσσην ἐκ στήθεσφιν ὄπα κρείων ἐνοσίχθων	-- - --u u- -- uu--	dactylic hexameter	feminine penthemimeral, hepthemimeral, trithemimeral
ἧκεν· Ἀχαιοῖσιν δὲ μέγα σθένος ἔμβαλ’ ἑκάστῳ	-u u--- u u- uu -u u--	dactylic hexameter	masculine penthemimeral, hepthemimeral
καρδίῃ, ἄληκτον πολεμίζειν ἠδὲ μάχεσθαι.	-uu --- uu-- -u u--	dactylic hexameter	masculine penthemimeral
Ἥρη δ’εἰσεῖδε χρυσόθρονος ὀφθαλμοῖσι	-- --- --uu ----	dactylic hexameter	masculine penthemimeral
στᾶσ’ ἐξ Οὐλύμποιο ἀπὸ ῥίου· αὐτίκα δ’ἔγνω	- - ---u u- uu -uu --	dactylic hexameter	feminine penthemimeral, hepthemimeral
τὸν μὲν ποιπνύοντα μάχην ἀνὰ κυδιάνειραν	- - ---u u- uu -uu--	dactylic hexameter	feminine penthemimeral, hepthemimeral
αὐτοκασίγνητον καὶ δαέρα, χαῖρε δὲ θυμῷ·	-uu--- - -uu -u u --	dactylic hexameter	masculine penthemimeral
Ζῆνα δ’ἐπ’ ἀκροτάτης κορυφῆς πολυπίδακος Ἴδης	-u u -uu- uu- uu-uu --	dactylic hexameter	masculine penthemimeral, hepthemimeral
ἥμενον εἰσεῖδε, στυγερὸς δέ οἱ ἔπλετο θυμῷ.	-uu --- uu- u u -uu --	dactylic hexameter	masculine penthemimeral, hepthemimeral
μερμήριξε δ’ἔπειτα βοῶπις πότνια Ἥρη	---u u-u u-- -uu --	dactylic hexameter	feminine penthemimeral
ὅππως ἐξαπάφοιτο Διὸς νόον αἰγιόχοιο·	-- -uu-u u- uu -uu--	dactylic hexameter	feminine penthemimeral, hepthemimeral
ἥδε δέ οἱ κατὰ θυμὸν ἀρίστη φαίνετο βουλὴ	-u u - uu -u u-- -uu --	dactylic hexameter	feminine penthemimeral, trithemimeral
ἐλθεῖν εἰς Ἴδην εὖ ἐντύνασαν ἓ αὐτήν,	-- - -- - ---u u --	dactylic hexameter	masculine penthemimeral, trithemimeral
εἴ πως ἱμείραιτο παραδραθέειν φιλότητι	- - ---u u-uu- uu--	dactylic hexameter	feminine penthemimeral
ᾗ χροιῇ, τῷ δ’ὕπνον ἀπήμονά τε λιαρόν τε	- -- - -u u-uu - uu- -	dactylic hexameter	feminine penthemimeral, trithemimeral
χεύῃ ἐπὶ βλεφάροισιν ἰδὲ φρεσὶ πευκαλίμῃσι.	-u u- uu-u u- uu -uu--	dactylic hexameter	feminine penthemimeral, hepthemimeral, trithemimeral
βῆ δ’ἴμεν ἐς θάλαμον, τόν οἱ φίλος υἱὸς ἔτευξεν	- uu - uu- - - uu -u u--	dactylic hexameter	masculine penthemimeral, hepthemimeral, trithemimeral
Ἥφαιστος, πυκινὰς δὲ θύρας σταθμοῖσιν ἐπῆρσε	--- uu- u u- --u u--	dactylic hexameter	masculine penthemimeral, hepthemimeral, trithemimeral
κληῖδι κρυπτῇ, τὴν δ’οὐ θεὸς ἄλλος ἀνῷγεν·	--- -- - - uu -u u--	dactylic hexameter	masculine penthemimeral, hepthemimeral, trithemimeral
ἔνθ’ ἥ γ’εἰσελθοῦσα θύρας ἐπέθηκε φαεινάς.	- - ---u u- uu-u u--	dactylic hexameter	feminine penthemimeral, hepthemimeral
ἀμβροσίῃ μὲν πρῶτον ἀπὸ χροὸς ἱμερόεντος	-uu- - -u u- uu -uu--	dactylic hexameter	feminine penthemimeral, hepthemimeral, trithemimeral
λύματα πάντα κάθηρεν, ἀλείψατο δὲ λίπ’ ἐλαίῳ	-uu -u u-u u-uu - u u--	dactylic hexameter	feminine penthemimeral
ἀμβροσίῳ ἑδανῷ, τό ῥά οἱ τεθυωμένον ἦεν·	-uu- uu- u u - uu-uu --	dactylic hexameter	masculine penthemimeral, hepthemimeral, trithemimeral
τοῦ καὶ κινυμένοιο Διὸς κατὰ χαλκοβατὲς δῶ	- - -uu-u u- uu -uu- -	dactylic hexameter	feminine penthemimeral, hepthemimeral
ἔμπης ἐς γαῖάν τε καὶ οὐρανὸν ἵκετ’ ἀϋτμή.	-- - -- u u -uu -u u--	dactylic hexameter	masculine penthemimeral, trithemimeral
τῷ ῥ’ἥ γε χρόα καλὸν ἀλειψαμένη ἰδὲ χαίτας	- - - uu -u u-uu- uu --	dactylic hexameter	feminine penthemimeral, trithemimeral
πεξαμένη χερσὶ πλοκάμους ἔπλεξε φαεινοὺς	-uu- -- uu- --u u--	dactylic hexameter	masculine penthemimeral, hepthemimeral, trithemimeral
καλοὺς ἀμβροσίους ἐκ κράατος ἀθανάτοιο.	-- -uu- - -uu -uu--	dactylic hexameter	masculine penthemimeral
ἀμφὶ δ’ἄρ’ ἀμβρόσιον ἑανὸν ἕσαθ’, ὅν οἱ Ἀθήνη	-u u -uu- uu- uu - u u--	dactylic hexameter	masculine penthemimeral, hepthemimeral
ἔξυσ’ ἀσκήσασα, τίθει δ’ἐνὶ δαίδαλα πολλά·	-- ---u u- uu -uu --	dactylic hexameter	feminine penthemimeral, hepthemimeral
χρυσείῃς δ’ἐνετῇσι κατὰ στῆθος περονᾶτο.	--- uu-u u- -- uu--	dactylic hexameter	feminine penthemimeral, hepthemimeral, trithemimeral
ζώσατο δὲ ζώνῃ ἑκατὸν θυσάνοις ἀραρυίῃ,	-uu - -- uu- uu- uu--	dactylic hexameter	masculine penthemimeral, hepthemimeral, trithemimeral
ἐν δ’ἄρα ἕρματα ἧκεν ἐϋτρήτοισι λοβοῖσι	- uu -uu -u u---u u--	dactylic hexameter	feminine penthemimeral
τρίγληνα μορόεντα· χάρις δ’ἀπελάμπετο πολλή.	--- uu-u u- uu-uu --	dactylic hexameter	feminine penthemimeral, hepthemimeral, trithemimeral
κρηδέμνῳ δ’ἐφύπερθε καλύψατο δῖα θεάων	--- uu-u u-uu -u u--	dactylic hexameter	feminine penthemimeral, trithemimeral
καλῷ νηγατέῳ· λευκὸν δ’ἦν ἠέλιος ὥς·	-- -uu- -- - -uu- -	dactylic hexameter	masculine penthemimeral, hepthemimeral
ποσσὶ δ’ὑπὸ λιπαροῖσιν ἐδήσατο καλὰ πέδιλα.	-u u- uu-u u-uu -u u--	dactylic hexameter	feminine penthemimeral, trithemimeral
αὐτὰρ ἐπεὶ δὴ πάντα περὶ χροῒ θήκατο κόσμον	-u u- - -u u- uu -uu --	dactylic hexameter	feminine penthemimeral, hepthemimeral, trithemimeral
βῆ ῥ’ἴμεν ἐκ θαλάμοιο, καλεσσαμένη δ’Ἀφροδίτην	- uu - uu-u u-uu- uu--	dactylic hexameter	feminine penthemimeral, trithemimeral
τῶν ἄλλων ἀπάνευθε θεῶν πρὸς μῦθον ἔειπε·	- -- uu-u u- - -u u--	dactylic hexameter	feminine penthemimeral, hepthemimeral, trithemimeral
ἦ ῥά νύ μοί τι πίθοιο φίλον τέκος ὅττί κεν εἴπω,	- u u - u u-u u- uu -u u --	dactylic hexameter	feminine penthemimeral, hepthemimeral, trithemimeral
ἦέ κεν ἀρνήσαιο κοτεσσαμένη τό γε θυμῷ,	-u u ---u u-uu- u u --	dactylic hexameter	feminine penthemimeral
οὕνεκ’ ἐγὼ Δαναοῖσι, σὺ δὲ Τρώεσσιν ἀρήγεις;	-u u- uu-u u - --u u--	dactylic hexameter	feminine penthemimeral, hepthemimeral, trithemimeral
τὴν δ’ἠμείβετ’ ἔπειτα Διὸς θυγάτηρ Ἀφροδίτη·	- --u u-u u- uu- uu--	dactylic hexameter	feminine penthemimeral, hepthemimeral
Ἥρη πρέσβα θεὰ θύγατερ μεγάλοιο Κρόνοιο	-- -u u- uu- uu-u u--	dactylic hexameter	masculine penthemimeral, hepthemimeral
αὔδα ὅ τι φρονέεις· τελέσαι δέ με θυμὸς ἄνωγεν,	-u u - uu- uu- u u -u u--	dactylic hexameter	masculine penthemimeral, hepthemimeral, trithemimeral
εἰ δύναμαι τελέσαι γε καὶ εἰ τετελεσμένον ἐστίν.	- uu- uu- u u - uu-uu --	dactylic hexameter	masculine penthemimeral, hepthemimeral, trithemimeral
τὴν δὲ δολοφρονέουσα προσηύδα πότνια Ἥρη·	- u u-uu-u u-- -uu --	dactylic hexameter	feminine penthemimeral
δὸς νῦν μοι φιλότητα καὶ ἵμερον, ᾧ τε σὺ πάντας	- - - uu-u u -uu - u u --	dactylic hexameter	feminine penthemimeral, trithemimeral
δαμνᾷ ἀθανάτους ἠδὲ θνητοὺς ἀνθρώπους.	-- -uu- -- -- ---	dactylic hexameter	masculine penthemimeral, hepthemimeral
εἶμι γὰρ ὀψομένη πολυφόρβου πείρατα γαίης,	-u u -uu- uu-- -uu --	dactylic hexameter	masculine penthemimeral
Ὠκεανόν τε θεῶν γένεσιν καὶ μητέρα Τηθύν,	-uu- u u- uu- - -uu --	dactylic hexameter	masculine penthemimeral, hepthemimeral, trithemimeral
οἵ μ’ἐν σφοῖσι δόμοισιν ἐῢ τρέφον ἠδ’ ἀτίταλλον	- - -u u-u u- uu - uu--	dactylic hexameter	feminine penthemimeral, hepthemimeral
δεξάμενοι ’Ρείας, ὅτε τε Κρόνον εὐρύοπα Ζεὺς	-uu- -- uu - uu -uu- -	dactylic hexameter	masculine penthemimeral, hepthemimeral, trithemimeral
γαίης νέρθε καθεῖσε καὶ ἀτρυγέτοιο θαλάσσης·	-- -u u-u u -uu-u u--	dactylic hexameter	feminine penthemimeral
τοὺς εἶμ’ ὀψομένη, καί σφ’ἄκριτα νείκεα λύσω·	- - -uu- - -uu -uu --	dactylic hexameter	masculine penthemimeral
ἤδη γὰρ δηρὸν χρόνον ἀλλήλων ἀπέχονται	-- - -- uu --- uu--	dactylic hexameter	masculine penthemimeral, trithemimeral
εὐνῆς καὶ φιλότητος, ἐπεὶ χόλος ἔμπεσε θυμῷ.	-- - uu-u u- uu -uu --	dactylic hexameter	feminine penthemimeral, hepthemimeral, trithemimeral
εἰ κείνω ἐπέεσσι παραιπεπιθοῦσα φίλον κῆρ	- -- uu-u u-uu-u u- -	dactylic hexameter	feminine penthemimeral, trithemimeral
εἰς εὐνὴν ἀνέσαιμι ὁμωθῆναι φιλότητι,	- -- uu-u u--- uu--	dactylic hexameter	feminine penthemimeral, trithemimeral
αἰεί κέ σφι φίλη τε καὶ αἰδοίη καλεοίμην.	-- - u u- u u --- uu--	dactylic hexameter	masculine penthemimeral, trithemimeral
τὴν δ’αὖτε προσέειπε φιλομειδὴς Ἀφροδίτη·	- -- uu-u u--- uu--	dactylic hexameter	feminine penthemimeral, trithemimeral
οὐκ ἔστ’ οὐδὲ ἔοικε τεὸν ἔπος ἀρνήσασθαι·	- - -u u-u u- uu ----	dactylic hexameter	feminine penthemimeral, hepthemimeral
Ζηνὸς γὰρ τοῦ ἀρίστου ἐν ἀγκοίνῃσιν ἰαύεις.	-- - u u-u u ---u u--	dactylic hexameter	feminine penthemimeral, trithemimeral
ἦ, καὶ ἀπὸ στήθεσφιν ἐλύσατο κεστὸν ἱμάντα	- u u- --u u-uu -u u--	dactylic hexameter	feminine penthemimeral, trithemimeral
ποικίλον, ἔνθα δέ οἱ θελκτήρια πάντα τέτυκτο·	-uu -u u - --uu -u u--	dactylic hexameter	masculine penthemimeral
ἔνθ’ ἔνι μὲν φιλότης, ἐν δ’ἵμερος, ἐν δ’ὀαριστὺς	- uu - uu- - -uu - uu--	dactylic hexameter	masculine penthemimeral, trithemimeral
πάρφασις, ἥ τ’ἔκλεψε νόον πύκα περ φρονεόντων.	-uu - --u u- uu - uu--	dactylic hexameter	feminine penthemimeral, hepthemimeral, trithemimeral
τόν ῥά οἱ ἔμβαλε χερσὶν ἔπος τ’ἔφατ’ ἔκ τ’ὀνόμαζε·	- u u -uu -u u- uu - uu--	dactylic hexameter	feminine penthemimeral, hepthemimeral
τῆ νῦν τοῦτον ἱμάντα τεῷ ἐγκάτθεο κόλπῳ	- - -u u-u u- --uu --	dactylic hexameter	feminine penthemimeral, hepthemimeral
ποικίλον, ᾧ ἔνι πάντα τετεύχαται· οὐδέ σέ φημι	-uu - uu -u u-uu -u u --	dactylic hexameter	feminine penthemimeral, trithemimeral
ἄπρηκτόν γε νέεσθαι, ὅ τι φρεσὶ σῇσι μενοινᾷς.	--- u u-u u - uu -u u--	dactylic hexameter	feminine penthemimeral, hepthemimeral, trithemimeral
ὣς φάτο, μείδησεν δὲ βοῶπις πότνια Ἥρη,	- uu --- u u-- -uu --	dactylic hexameter	masculine penthemimeral
μειδήσασα δ’ἔπειτα ἑῷ ἐγκάτθετο κόλπῳ.	---u u-u u- --uu --	dactylic hexameter	feminine penthemimeral, hepthemimeral
ἣ μὲν ἔβη πρὸς δῶμα Διὸς θυγάτηρ Ἀφροδίτη,	- u u- - -u u- uu- uu--	dactylic hexameter	feminine penthemimeral, hepthemimeral, trithemimeral
Ἥρη δ’ἀΐξασα λίπεν ῥίον Οὐλύμποιο,	-- ---u u- uu ----	dactylic hexameter	feminine penthemimeral, hepthemimeral
Πιερίην δ’ἐπιβᾶσα καὶ Ἠμαθίην ἐρατεινὴν	-uu- uu-u u -uu- uu--	dactylic hexameter	feminine penthemimeral, trithemimeral
σεύατ’ ἐφ’ ἱπποπόλων Θρῃκῶν ὄρεα νιφόεντα	-u u -uu- -- uu- uu--	dactylic hexameter	masculine penthemimeral, hepthemimeral
ἀκροτάτας κορυφάς· οὐδὲ χθόνα μάρπτε ποδοῖιν·	-uu- uu- -- uu -u u--	dactylic hexameter	masculine penthemimeral, hepthemimeral, trithemimeral
ἐξ Ἀθόω δ’ἐπὶ πόντον ἐβήσετο κυμαίνοντα,	- uu- uu -u u-uu ----	dactylic hexameter	feminine penthemimeral, trithemimeral
Λῆμνον δ’εἰσαφίκανε πόλιν θείοιο Θόαντος.	-- -uu-u u- --u u--	dactylic hexameter	feminine penthemimeral, hepthemimeral
ἔνθ’ Ὕπνῳ ξύμβλητο κασιγνήτῳ Θανάτοιο,	- -- --u u--- uu--	dactylic hexameter	feminine penthemimeral, trithemimeral
ἔν τ’ἄρα οἱ φῦ χειρὶ ἔπος τ’ἔφατ’ ἔκ τ’ὀνόμαζεν·	- uu - - -u u- uu - uu--	dactylic hexameter	feminine penthemimeral, hepthemimeral, trithemimeral
Ὕπνε ἄναξ πάντων τε θεῶν πάντων τ’ἀνθρώπων,	-u u- -- u u- -- ---	dactylic hexameter	masculine penthemimeral, hepthemimeral, trithemimeral
ἠμὲν δή ποτ’ ἐμὸν ἔπος ἔκλυες, ἠδ’ ἔτι καὶ νῦν	-- - u u- uu -uu - uu - -	dactylic hexameter	masculine penthemimeral, trithemimeral
πείθευ· ἐγὼ δέ κέ τοι ἰδέω χάριν ἤματα πάντα.	-u u- u u - uu- uu -uu --	dactylic hexameter	masculine penthemimeral, hepthemimeral, trithemimeral
κοίμησόν μοι Ζηνὸς ὑπ’ ὀφρύσιν ὄσσε φαεινὼ	--- - -u u -uu -u u--	dactylic hexameter	feminine penthemimeral, trithemimeral
αὐτίκ’ ἐπεί κεν ἐγὼ παραλέξομαι ἐν φιλότητι.	-u u- u u- uu-uu - uu--	dactylic hexameter	masculine penthemimeral, trithemimeral
δῶρα δέ τοι δώσω καλὸν θρόνον ἄφθιτον αἰεὶ	-u u - -- -- uu -uu --	dactylic hexameter	masculine penthemimeral, hepthemimeral, trithemimeral
χρύσεον· Ἥφαιστος δέ κ’ἐμὸς πάϊς ἀμφιγυήεις	-uu --- u u- uu -uu--	dactylic hexameter	masculine penthemimeral, hepthemimeral
τεύξει’ ἀσκήσας, ὑπὸ δὲ θρῆνυν ποσὶν ἥσει,	-- --- uu - -- uu --	dactylic hexameter	masculine penthemimeral, hepthemimeral
τῷ κεν ἐπισχοίης λιπαροὺς πόδας εἰλαπινάζων.	- u u--- uu- uu -uu--	dactylic hexameter	masculine penthemimeral, hepthemimeral
τὴν δ’ἀπαμειβόμενος προσεφώνεε νήδυμος Ὕπνος·	- uu-uu- uu-uu -uu --	dactylic hexameter	masculine penthemimeral
Ἥρη πρέσβα θεὰ θύγατερ μεγάλοιο Κρόνοιο	-- -u u- uu- uu-u u--	dactylic hexameter	masculine penthemimeral, hepthemimeral
ἄλλον μέν κεν ἔγωγε θεῶν αἰειγενετάων	-- - u u-u u- --uu--	dactylic hexameter	feminine penthemimeral, hepthemimeral, trithemimeral
ῥεῖα κατευνήσαιμι, καὶ ἂν ποταμοῖο ῥέεθρα	-u u---u u - uu-u u--	dactylic hexameter	feminine penthemimeral, hepthemimeral
Ὠκεανοῦ, ὅς περ γένεσις πάντεσσι τέτυκται·	-uu- - - uu- --u u--	dactylic hexameter	masculine penthemimeral, hepthemimeral, trithemimeral
Ζηνὸς δ’οὐκ ἂν ἔγωγε Κρονίονος ἆσσον ἱκοίμην	-- - u u-u u-uu -u u--	dactylic hexameter	feminine penthemimeral, trithemimeral
οὐδὲ κατευνήσαιμ’, ὅτε μὴ αὐτός γε κελεύοι.	-u u--- uu - -- u u--	dactylic hexameter	masculine penthemimeral, hepthemimeral
ἤδη γάρ με καὶ ἄλλο τεὴ ἐπίνυσσεν ἐφετμὴ	-- - u u -u u- uu-u u--	dactylic hexameter	feminine penthemimeral, hepthemimeral, trithemimeral
ἤματι τῷ ὅτε κεῖνος ὑπέρθυμος Διὸς υἱὸς	-uu - uu -u u--- uu --	dactylic hexameter	feminine penthemimeral, trithemimeral
ἔπλεεν Ἰλιόθεν Τρώων πόλιν ἐξαλαπάξας.	-uu -uu- -- uu -uu--	dactylic hexameter	masculine penthemimeral, hepthemimeral
ἤτοι ἐγὼ μὲν ἔλεξα Διὸς νόον αἰγιόχοιο	-u u- u u-u u- uu -uu--	dactylic hexameter	feminine penthemimeral, hepthemimeral, trithemimeral
νήδυμος ἀμφιχυθείς· σὺ δέ οἱ κακὰ μήσαο θυμῷ	-uu -uu- u u - uu -uu --	dactylic hexameter	masculine penthemimeral, hepthemimeral
ὄρσασ’ ἀργαλέων ἀνέμων ἐπὶ πόντον ἀήτας,	-- -uu- uu- uu -u u--	dactylic hexameter	masculine penthemimeral, hepthemimeral
καί μιν ἔπειτα Κόων δ’εὖ ναιομένην ἀπένεικας	- u u-u u- - -uu- uu--	dactylic hexameter	masculine penthemimeral
νόσφι φίλων πάντων. ὃ δ’ἐπεγρόμενος χαλέπαινε	-u u- -- u u-uu- uu--	dactylic hexameter	masculine penthemimeral, trithemimeral
ῥιπτάζων κατὰ δῶμα θεούς, ἐμὲ δ’ἔξοχα πάντων	--- uu -u u- uu -uu --	dactylic hexameter	feminine penthemimeral, hepthemimeral, trithemimeral
ζήτει· καί κέ μ’ἄϊστον ἀπ’ αἰθέρος ἔμβαλε πόντῳ,	-- - u u-u u -uu -uu --	dactylic hexameter	feminine penthemimeral, trithemimeral
εἰ μὴ Νὺξ δμήτειρα θεῶν ἐσάωσε καὶ ἀνδρῶν·	- - - --u u- uu-u u --	dactylic hexameter	feminine penthemimeral, hepthemimeral, trithemimeral
τὴν ἱκόμην φεύγων, ὃ δ’ἐπαύσατο χωόμενός περ.	- uu- -- u u-uu -uu- -	dactylic hexameter	masculine penthemimeral, trithemimeral
ἅζετο γὰρ μὴ Νυκτὶ θοῇ ἀποθύμια ἕρδοι.	-uu - - -u u- uu-uu --	dactylic hexameter	feminine penthemimeral, hepthemimeral, trithemimeral
νῦν αὖ τοῦτό μ’ἄνωγας ἀμήχανον ἄλλο τελέσσαι.	- - -u u-u u-uu -u u--	dactylic hexameter	feminine penthemimeral
τὸν δ’αὖτε προσέειπε βοῶπις πότνια Ἥρη·	- -- uu-u u-- -uu --	dactylic hexameter	feminine penthemimeral, trithemimeral
Ὕπνε τί ἢ δὲ σὺ ταῦτα μετὰ φρεσὶ σῇσι μενοινᾷς;	-u u - u u -u u- uu -u u--	dactylic hexameter	feminine penthemimeral, hepthemimeral, trithemimeral
ἦ φῂς ὣς Τρώεσσιν ἀρηξέμεν εὐρύοπα Ζῆν	- - - --u u-uu -uu- -	dactylic hexameter	feminine penthemimeral, trithemimeral
ὡς Ἡρακλῆος περιχώσατο παῖδος ἑοῖο;	- ---- uu-uu -u u--	dactylic hexameter	masculine penthemimeral
ἀλλ’ ἴθ’, ἐγὼ δέ κέ τοι Χαρίτων μίαν ὁπλοτεράων	- u u- u u - uu- uu -uu--	dactylic hexameter	masculine penthemimeral, hepthemimeral, trithemimeral
δώσω ὀπυιέμεναι καὶ σὴν κεκλῆσθαι ἄκοιτιν.	-u u-uu- - - --u u--	dactylic hexameter	masculine penthemimeral, hepthemimeral
ὣς φάτο, χήρατο δ’Ὕπνος, ἀμειβόμενος δὲ προσηύδα·	- uu -uu -u u-uu- u u--	dactylic hexameter	feminine penthemimeral
ἄγρει νῦν μοι ὄμοσσον ἀάατον Στυγὸς ὕδωρ,	-- - u u-u u--- uu --	dactylic hexameter	feminine penthemimeral, trithemimeral
χειρὶ δὲ τῇ ἑτέρῃ μὲν ἕλε χθόνα πουλυβότειραν,	-u u - uu- u u- uu -uu--	dactylic hexameter	masculine penthemimeral, hepthemimeral, trithemimeral
τῇ δ’ἑτέρῃ ἅλα μαρμαρέην, ἵνα νῶϊν ἅπαντες	- uu- uu -uu- uu -u u--	dactylic hexameter	hepthemimeral, trithemimeral
μάρτυροι ὦσ’ οἳ ἔνερθε θεοὶ Κρόνον ἀμφὶς ἐόντες,	-uu - u u-u u- uu -u u--	dactylic hexameter	feminine penthemimeral, hepthemimeral, trithemimeral
ἦ μὲν ἐμοὶ δώσειν Χαρίτων μίαν ὁπλοτεράων	- u u- -- uu- uu -uu--	dactylic hexameter	masculine penthemimeral, hepthemimeral, trithemimeral
Πασιθέην, ἧς τ’αὐτὸς ἐέλδομαι ἤματα πάντα.	-uu- - -u u-uu -uu --	dactylic hexameter	feminine penthemimeral, trithemimeral
ὣς ἔφατ’, οὐδ’ ἀπίθησε θεὰ λευκώλενος Ἥρη,	- uu - uu-u u- --uu --	dactylic hexameter	feminine penthemimeral, hepthemimeral, trithemimeral
ὄμνυε δ’ὡς ἐκέλευε, θεοὺς δ’ὀνόμηνεν ἅπαντας	-uu - uu-u u- uu-u u--	dactylic hexameter	feminine penthemimeral, hepthemimeral, trithemimeral
τοὺς ὑποταρταρίους οἳ Τιτῆνες καλέονται.	- uu-uu- - --- uu--	dactylic hexameter	masculine penthemimeral
αὐτὰρ ἐπεί ῥ’ὄμοσέν τε τελεύτησέν τε τὸν ὅρκον,	-u u- uu- u u--- u u --	dactylic hexameter	masculine penthemimeral, trithemimeral
τὼ βήτην Λήμνου τε καὶ Ἴμβρου ἄστυ λιπόντε	- -- -- u u -- -u u--	dactylic hexameter	masculine penthemimeral, trithemimeral
ἠέρα ἑσσαμένω ῥίμφα πρήσσοντε κέλευθον.	-uu -uu- -- --u u--	dactylic hexameter	masculine penthemimeral, hepthemimeral
Ἴδην δ’ἱκέσθην πολυπίδακα μητέρα θηρῶν	-- --- uu-uu -uu --	dactylic hexameter	masculine penthemimeral
Λεκτόν, ὅθι πρῶτον λιπέτην ἅλα· τὼ δ’ἐπὶ χέρσου	-u u- -- uu- uu - uu --	dactylic hexameter	masculine penthemimeral, hepthemimeral, trithemimeral
βήτην, ἀκροτάτη δὲ ποδῶν ὕπο σείετο ὕλη.	-- -uu- u u- uu -uu --	dactylic hexameter	masculine penthemimeral, hepthemimeral
ἔνθ’ Ὕπνος μὲν ἔμεινε πάρος Διὸς ὄσσε ἰδέσθαι	- -- u u-u u- uu -u u--	dactylic hexameter	feminine penthemimeral, hepthemimeral, trithemimeral
εἰς ἐλάτην ἀναβὰς περιμήκετον, ἣ τότ’ ἐν Ἴδῃ	- uu- uu- uu-uu - u u --	dactylic hexameter	masculine penthemimeral, trithemimeral
μακροτάτη πεφυυῖα δι’ ἠέρος αἰθέρ’ ἵκανεν·	-uu- uu-u u -uu -u u--	dactylic hexameter	feminine penthemimeral, trithemimeral
ἔνθ’ ἧστ’ ὄζοισιν πεπυκασμένος εἰλατίνοισιν	- - --- uu-uu -uu--	dactylic hexameter	masculine penthemimeral
ὄρνιθι λιγυρῇ ἐναλίγκιος, ἥν τ’ἐν ὄρεσσι	-uu --- uu-uu - u u--	dactylic hexameter	masculine penthemimeral
χαλκίδα κικλήσκουσι θεοί, ἄνδρες δὲ κύμινδιν.	-uu ---u u- -- u u--	dactylic hexameter	feminine penthemimeral, hepthemimeral
Ἥρη δὲ κραιπνῶς προσεβήσετο Γάργαρον ἄκρον	-- - -- uu-uu -uu --	dactylic hexameter	masculine penthemimeral, trithemimeral
Ἴδης ὑψηλῆς· ἴδε δὲ νεφεληγερέτα Ζεύς.	-- --- uu - uu-uu- -	dactylic hexameter	masculine penthemimeral, hepthemimeral
ὡς δ’ἴδεν, ὥς μιν ἔρως πυκινὰς φρένας ἀμφεκάλυψεν,	- uu - u u- uu- uu -uu--	dactylic hexameter	masculine penthemimeral, hepthemimeral, trithemimeral
οἷον ὅτε πρῶτόν περ ἐμισγέσθην φιλότητι	-u u- -- u u--- uu--	dactylic hexameter	masculine penthemimeral, trithemimeral
εἰς εὐνὴν φοιτῶντε, φίλους λήθοντε τοκῆας.	- -- --u u- --u u--	dactylic hexameter	feminine penthemimeral, hepthemimeral, trithemimeral
στῆ δ’αὐτῆς προπάροιθεν ἔπος τ’ἔφατ’ ἔκ τ’ὀνόμαζεν·	- -- uu-u u- uu - uu--	dactylic hexameter	feminine penthemimeral, hepthemimeral, trithemimeral
Ἥρη πῇ μεμαυῖα κατ’ Οὐλύμπου τόδ’ ἱκάνεις;	-- - uu-u u --- u u--	dactylic hexameter	feminine penthemimeral, trithemimeral
ἵπποι δ’οὐ παρέασι καὶ ἅρματα τῶν κ’ἐπιβαίης.	-- - uu-u u -uu - uu--	dactylic hexameter	feminine penthemimeral, trithemimeral
τὸν δὲ δολοφρονέουσα προσηύδα πότνια Ἥρη·	- u u-uu-u u-- -uu --	dactylic hexameter	feminine penthemimeral
ἔρχομαι ὀψομένη πολυφόρβου πείρατα γαίης,	-uu -uu- uu-- -uu --	dactylic hexameter	masculine penthemimeral
Ὠκεανόν τε θεῶν γένεσιν καὶ μητέρα Τηθύν,	-uu- u u- uu- - -uu --	dactylic hexameter	masculine penthemimeral, hepthemimeral, trithemimeral
οἵ με σφοῖσι δόμοισιν ἐῢ τρέφον ἠδ’ ἀτίταλλον·	- - -u u-u u- uu - uu--	dactylic hexameter	feminine penthemimeral, hepthemimeral
τοὺς εἶμ’ ὀψομένη, καί σφ’ἄκριτα νείκεα λύσω·	- - -uu- - -uu -uu --	dactylic hexameter	masculine penthemimeral
ἤδη γὰρ δηρὸν χρόνον ἀλλήλων ἀπέχονται	-- - -- uu --- uu--	dactylic hexameter	masculine penthemimeral, trithemimeral
εὐνῆς καὶ φιλότητος, ἐπεὶ χόλος ἔμπεσε θυμῷ.	-- - uu-u u- uu -uu --	dactylic hexameter	feminine penthemimeral, hepthemimeral, trithemimeral
ἵπποι δ’ἐν πρυμνωρείῃ πολυπίδακος Ἴδης	-- - ---- uu-uu --	dactylic hexameter	hepthemimeral, trithemimeral
ἑστᾶσ’, οἵ μ’οἴσουσιν ἐπὶ τραφερήν τε καὶ ὑγρήν.	-- - --u u- uu- u u --	dactylic hexameter	feminine penthemimeral, hepthemimeral, trithemimeral
νῦν δὲ σεῦ εἵνεκα δεῦρο κατ’ Οὐλύμπου τόδ’ ἱκάνω,	- u u -uu -u u --- u u--	dactylic hexameter	feminine penthemimeral
μή πώς μοι μετέπειτα χολώσεαι, αἴ κε σιωπῇ	- - - uu-u u-uu - u u--	dactylic hexameter	feminine penthemimeral, trithemimeral
οἴχωμαι πρὸς δῶμα βαθυρρόου Ὠκεανοῖο.	--- - -u u-uu -uu--	dactylic hexameter	feminine penthemimeral, trithemimeral
τὴν δ’ἀπαμειβόμενος προσέφη νεφεληγερέτα Ζεύς·	- uu-uu- uu- uu-uu- -	dactylic hexameter	masculine penthemimeral, hepthemimeral
Ἥρη κεῖσε μὲν ἔστι καὶ ὕστερον ὁρμηθῆναι,	-- -u u -u u -uu ----	dactylic hexameter	feminine penthemimeral
νῶϊ δ’ἄγ’ ἐν φιλότητι τραπείομεν εὐνηθέντε.	-u u - uu-u u-uu ----	dactylic hexameter	feminine penthemimeral, trithemimeral
οὐ γάρ πώ ποτέ μ’ὧδε θεᾶς ἔρος οὐδὲ γυναικὸς	- - - uu -u u- uu -u u--	dactylic hexameter	feminine penthemimeral, hepthemimeral, trithemimeral
θυμὸν ἐνὶ στήθεσσι περιπροχυθεὶς ἐδάμασσεν,	-u u- --u u-uu- uu--	dactylic hexameter	feminine penthemimeral, trithemimeral
οὐδ’ ὁπότ’ ἠρασάμην Ἰξιονίης ἀλόχοιο,	- uu -uu- --uu- uu--	dactylic hexameter	masculine penthemimeral
ἣ τέκε Πειρίθοον θεόφιν μήστωρ’ ἀτάλαντον·	- uu -uu- uu- -- uu--	dactylic hexameter	masculine penthemimeral, hepthemimeral
οὐδ’ ὅτε περ Δανάης καλλισφύρου Ἀκρισιώνης,	- uu - uu- --uu -uu--	dactylic hexameter	masculine penthemimeral, trithemimeral
ἣ τέκε Περσῆα πάντων ἀριδείκετον ἀνδρῶν·	- uu --- -- uu-uu --	dactylic hexameter	masculine penthemimeral, hepthemimeral
οὐδ’ ὅτε Φοίνικος κούρης τηλεκλειτοῖο,	- uu --- -- -----	dactylic hexameter	masculine penthemimeral, hepthemimeral
ἣ τέκε μοι Μίνων τε καὶ ἀντίθεον ’Ραδάμανθυν·	- uu - -- u u -uu- uu--	dactylic hexameter	masculine penthemimeral, trithemimeral
οὐδ’ ὅτε περ Σεμέλης οὐδ’ Ἀλκμήνης ἐνὶ Θήβῃ,	- uu - uu- - --- uu --	dactylic hexameter	masculine penthemimeral, trithemimeral
ἥ ῥ’Ἡρακλῆα κρατερόφρονα γείνατο παῖδα·	- ---- uu-uu -uu --	dactylic hexameter	masculine penthemimeral
ἣ δὲ Διώνυσον Σεμέλη τέκε χάρμα βροτοῖσιν·	- u u--- uu- uu -u u--	dactylic hexameter	masculine penthemimeral, hepthemimeral
οὐδ’ ὅτε Δήμητρος καλλιπλοκάμοιο ἀνάσσης,	- uu --- --uu-u u--	dactylic hexameter	masculine penthemimeral
οὐδ’ ὁπότε Λητοῦς ἐρικυδέος, οὐδὲ σεῦ αὐτῆς,	- uu- -- uu-uu -u u --	dactylic hexameter	masculine penthemimeral, trithemimeral
ὡς σέο νῦν ἔραμαι καί με γλυκὺς ἵμερος αἱρεῖ.	- uu - uu- - - uu -uu --	dactylic hexameter	masculine penthemimeral, hepthemimeral, trithemimeral
τὸν δὲ δολοφρονέουσα προσηύδα πότνια Ἥρη·	- u u-uu-u u-- -uu --	dactylic hexameter	feminine penthemimeral
αἰνότατε Κρονίδη ποῖον τὸν μῦθον ἔειπες.	-uu- uu- -- - -u u--	dactylic hexameter	masculine penthemimeral, hepthemimeral, trithemimeral
εἰ νῦν ἐν φιλότητι λιλαίεαι εὐνηθῆναι	- - - uu-u u-uu ----	dactylic hexameter	feminine penthemimeral, trithemimeral
Ἴδης ἐν κορυφῇσι, τὰ δὲ προπέφανται ἅπαντα·	-- - uu-u u - uu-u u--	dactylic hexameter	feminine penthemimeral, hepthemimeral, trithemimeral
πῶς κ’ἔοι εἴ τις νῶϊ θεῶν αἰειγενετάων	- uu - - -u u- --uu--	dactylic hexameter	feminine penthemimeral, hepthemimeral, trithemimeral
εὕδοντ’ ἀθρήσειε, θεοῖσι δὲ πᾶσι μετελθὼν	-- ---u u-u u -u u--	dactylic hexameter	feminine penthemimeral
πεφράδοι; οὐκ ἂν ἔγωγε τεὸν πρὸς δῶμα νεοίμην	-uu - u u-u u- - -u u--	dactylic hexameter	feminine penthemimeral, hepthemimeral, trithemimeral
ἐξ εὐνῆς ἀνστᾶσα, νεμεσσητὸν δέ κεν εἴη.	- -- --u u--- u u --	dactylic hexameter	feminine penthemimeral, trithemimeral
ἀλλ’ εἰ δή ῥ’ἐθέλεις καί τοι φίλον ἔπλετο θυμῷ,	- - - uu- - - uu -uu --	dactylic hexameter	masculine penthemimeral, hepthemimeral, trithemimeral
ἔστιν τοι θάλαμος, τόν τοι φίλος υἱὸς ἔτευξεν	-- - uu- - - uu -u u--	dactylic hexameter	masculine penthemimeral, hepthemimeral, trithemimeral
Ἥφαιστος, πυκινὰς δὲ θύρας σταθμοῖσιν ἐπῆρσεν·	--- uu- u u- --u u--	dactylic hexameter	masculine penthemimeral, hepthemimeral, trithemimeral
ἔνθ’ ἴομεν κείοντες, ἐπεί νύ τοι εὔαδεν εὐνή.	- uu- --u u- u u -uu --	dactylic hexameter	feminine penthemimeral, hepthemimeral, trithemimeral
τὴν δ’ἀπαμειβόμενος προσέφη νεφεληγερέτα Ζεύς·	- uu-uu- uu- uu-uu- -	dactylic hexameter	masculine penthemimeral, hepthemimeral
Ἥρη μήτε θεῶν τό γε δείδιθι μήτέ τιν’ ἀνδρῶν	-- -u u- u u -uu -u u --	dactylic hexameter	masculine penthemimeral
ὄψεσθαι· τοῖόν τοι ἐγὼ νέφος ἀμφικαλύψω	--- -- u u- uu -uu--	dactylic hexameter	masculine penthemimeral, hepthemimeral, trithemimeral
χρύσεον· οὐδ’ ἂν νῶϊ διαδράκοι Ἠέλιός περ,	-uu - - -u u-uu -uu- -	dactylic hexameter	feminine penthemimeral, trithemimeral
οὗ τε καὶ ὀξύτατον πέλεται φάος εἰσοράασθαι.	- u u -uu- uu- uu -uu--	dactylic hexameter	masculine penthemimeral, hepthemimeral
ἦ ῥα καὶ ἀγκὰς ἔμαρπτε Κρόνου παῖς ἣν παράκοιτιν·	- u u -u u-u u- - - uu--	dactylic hexameter	feminine penthemimeral, hepthemimeral
τοῖσι δ’ὑπὸ χθὼν δῖα φύεν νεοθηλέα ποίην,	-u u- - -u u- uu-uu --	dactylic hexameter	feminine penthemimeral, hepthemimeral, trithemimeral
λωτόν θ’ἑρσήεντα ἰδὲ κρόκον ἠδ’ ὑάκινθον	-- ---u u- uu - uu--	dactylic hexameter	feminine penthemimeral, hepthemimeral
πυκνὸν καὶ μαλακόν, ὃς ἀπὸ χθονὸς ὑψόσ’ ἔεργε.	-- - uu- u u- uu -u u--	dactylic hexameter	masculine penthemimeral, hepthemimeral, trithemimeral
τῷ ἔνι λεξάσθην, ἐπὶ δὲ νεφέλην ἕσσαντο	- uu --- uu - uu- ---	dactylic hexameter	masculine penthemimeral, hepthemimeral
καλὴν χρυσείην· στιλπναὶ δ’ἀπέπιπτον ἔερσαι.	-- --- -- uu-u u--	dactylic hexameter	masculine penthemimeral, hepthemimeral
ὣς ὃ μὲν ἀτρέμας εὗδε πατὴρ ἀνὰ Γαργάρῳ ἄκρῳ,	- u u -uu -u u- uu -uu --	dactylic hexameter	feminine penthemimeral, hepthemimeral
ὕπνῳ καὶ φιλότητι δαμείς, ἔχε δ’ἀγκὰς ἄκοιτιν·	-- - uu-u u- uu -u u--	dactylic hexameter	feminine penthemimeral, hepthemimeral, trithemimeral
βῆ δὲ θέειν ἐπὶ νῆας Ἀχαιῶν νήδυμος Ὕπνος	- u u- uu -u u-- -uu --	dactylic hexameter	feminine penthemimeral, trithemimeral
ἀγγελίην ἐρέων γαιηόχῳ ἐννοσιγαίῳ·	-uu- uu- --uu -uu--	dactylic hexameter	masculine penthemimeral, trithemimeral
ἀγχοῦ δ’ἱστάμενος ἔπεα πτερόεντα προσηύδα·	-- -uu- uu- uu-u u--	dactylic hexameter	masculine penthemimeral, hepthemimeral
πρόφρων νῦν Δαναοῖσι Ποσείδαον ἐπάμυνε,	-- - uu-u u--- uu--	dactylic hexameter	feminine penthemimeral, trithemimeral
καί σφιν κῦδος ὄπαζε μίνυνθά περ, ὄφρ’ ἔτι εὕδει	- - -u u-u u-u u - uu --	dactylic hexameter	feminine penthemimeral
Ζεύς, ἐπεὶ αὐτῷ ἐγὼ μαλακὸν περὶ κῶμ’ ἐκάλυψα·	- uu -u u- uu- uu - uu--	dactylic hexameter	masculine penthemimeral, hepthemimeral
Ἥρη δ’ἐν φιλότητι παρήπαφεν εὐνηθῆναι.	-- - uu-u u-uu ----	dactylic hexameter	feminine penthemimeral, trithemimeral
ὣς εἰπὼν ὃ μὲν ᾤχετ’ ἐπὶ κλυτὰ φῦλ’ ἀνθρώπων,	- -- u u -u u- uu - ---	dactylic hexameter	feminine penthemimeral, hepthemimeral, trithemimeral
τὸν δ’ἔτι μᾶλλον ἀνῆκεν ἀμυνέμεναι Δαναοῖσιν.	- uu -u u-u u-uu- uu--	dactylic hexameter	feminine penthemimeral
αὐτίκα δ’ἐν πρώτοισι μέγα προθορὼν ἐκέλευσεν·	-uu - --u u- uu- uu--	dactylic hexameter	feminine penthemimeral, hepthemimeral, trithemimeral
Ἀργεῖοι καὶ δ’αὖτε μεθίεμεν Ἕκτορι νίκην	--- - -u u-uu -uu --	dactylic hexameter	feminine penthemimeral, trithemimeral
Πριαμίδῃ, ἵνα νῆας ἕλῃ καὶ κῦδος ἄρηται;	-uu- uu -u u- - -u u--	dactylic hexameter	feminine penthemimeral, hepthemimeral, trithemimeral
ἀλλ’ ὃ μὲν οὕτω φησὶ καὶ εὔχεται οὕνεκ’ Ἀχιλλεὺς	- u u -- -u u -uu -u u--	dactylic hexameter	feminine penthemimeral
νηυσὶν ἔπι γλαφυρῇσι μένει κεχολωμένος ἦτορ·	-u u- uu-u u- uu-uu --	dactylic hexameter	feminine penthemimeral, hepthemimeral, trithemimeral
κείνου δ’οὔ τι λίην ποθὴ ἔσσεται, εἴ κεν οἳ ἄλλοι	-- - u u- uu -uu - u u --	dactylic hexameter	masculine penthemimeral, trithemimeral
ἡμεῖς ὀτρυνώμεθ’ ἀμυνέμεν ἀλλήλοισιν.	-- ---u u-uu ----	dactylic hexameter	feminine penthemimeral
ἀλλ’ ἄγεθ’ ὡς ἂν ἐγὼ εἴπω πειθώμεθα πάντες·	- uu - u u- -- --uu --	dactylic hexameter	masculine penthemimeral, hepthemimeral, trithemimeral
ἀσπίδες ὅσσαι ἄρισται ἐνὶ στρατῷ ἠδὲ μέγισται	-uu -u u-u u- uu -u u--	dactylic hexameter	feminine penthemimeral, hepthemimeral
ἑσσάμενοι, κεφαλὰς δὲ παναίθῃσιν κορύθεσσι	-uu- uu- u u--- uu--	dactylic hexameter	masculine penthemimeral, trithemimeral
κρύψαντες, χερσίν τε τὰ μακρότατ’ ἔγχε’ ἑλόντες	--- -- u u -uu -u u--	dactylic hexameter	masculine penthemimeral, trithemimeral
ἴομεν· αὐτὰρ ἐγὼν ἡγήσομαι, οὐδ’ ἔτι φημὶ	-uu -u u- --uu - uu --	dactylic hexameter	masculine penthemimeral
Ἕκτορα Πριαμίδην μενέειν μάλα περ μεμαῶτα.	-uu -uu- uu- uu - uu--	dactylic hexameter	masculine penthemimeral, hepthemimeral
ὃς δέ κ’ἀνὴρ μενέχαρμος, ἔχει δ’ὀλίγον σάκος ὤμῳ,	- u u- uu-u u- uu- uu --	dactylic hexameter	feminine penthemimeral, hepthemimeral, trithemimeral
χείρονι φωτὶ δότω, ὃ δ’ἐν ἀσπίδι μείζονι δύτω.	-uu -u u- u u -uu -uu --	dactylic hexameter	masculine penthemimeral
ὣς ἔφαθ’, οἳ δ’ἄρα τοῦ μάλα μὲν κλύον ἠδὲ πίθοντο·	- uu - uu - uu - uu -u u--	dactylic hexameter	masculine penthemimeral, hepthemimeral, trithemimeral
τοὺς δ’αὐτοὶ βασιλῆες ἐκόσμεον οὐτάμενοί περ	- -- uu-u u-uu -uu- -	dactylic hexameter	feminine penthemimeral, trithemimeral
Τυδεΐδης Ὀδυσεύς τε καὶ Ἀτρεΐδης Ἀγαμέμνων·	-uu- uu- u u -uu- uu--	dactylic hexameter	masculine penthemimeral, trithemimeral
οἰχόμενοι δ’ἐπὶ πάντας ἀρήϊα τεύχε’ ἄμειβον·	-uu- uu -u u-uu -u u--	dactylic hexameter	feminine penthemimeral, trithemimeral
ἐσθλὰ μὲν ἐσθλὸς ἔδυνε, χέρεια δὲ χείρονι δόσκεν.	-u u -u u-u u-u u -uu --	dactylic hexameter	feminine penthemimeral
αὐτὰρ ἐπεί ῥ’ἕσσαντο περὶ χροῒ νώροπα χαλκὸν	-u u- --u u- uu -uu --	dactylic hexameter	feminine penthemimeral, hepthemimeral, trithemimeral
βάν ῥ’ἴμεν· ἦρχε δ’ἄρά σφι Ποσειδάων ἐνοσίχθων	- uu -u u- u u--- uu--	dactylic hexameter	masculine penthemimeral
δεινὸν ἄορ τανύηκες ἔχων ἐν χειρὶ παχείῃ	-u u- uu-u u- - -u u--	dactylic hexameter	feminine penthemimeral, hepthemimeral, trithemimeral
εἴκελον ἀστεροπῇ· τῷ δ’οὐ θέμις ἐστὶ μιγῆναι	-uu -uu- - - uu -u u--	dactylic hexameter	masculine penthemimeral, hepthemimeral
ἐν δαῒ λευγαλέῃ, ἀλλὰ δέος ἰσχάνει ἄνδρας.	- uu -uu- -- uu -uu --	dactylic hexameter	masculine penthemimeral, hepthemimeral
Τρῶας δ’αὖθ’ ἑτέρωθεν ἐκόσμει φαίδιμος Ἕκτωρ.	-- - uu-u u-- -uu --	dactylic hexameter	feminine penthemimeral, trithemimeral
δή ῥα τότ’ αἰνοτάτην ἔριδα πτολέμοιο τάνυσσαν	- u u -uu- uu- uu-u u--	dactylic hexameter	masculine penthemimeral, hepthemimeral
κυανοχαῖτα Ποσειδάων καὶ φαίδιμος Ἕκτωρ,	-uu-u u--- - -uu --	dactylic hexameter	hepthemimeral
ἤτοι ὃ μὲν Τρώεσσιν, ὃ δ’Ἀργείοισιν ἀρήγων.	-u u - --u u ---u u--	dactylic hexameter	feminine penthemimeral, trithemimeral
ἐκλύσθη δὲ θάλασσα ποτὶ κλισίας τε νέας τε	--- u u-u u- uu- u u- -	dactylic hexameter	feminine penthemimeral, hepthemimeral, trithemimeral
Ἀργείων· οἳ δὲ ξύνισαν μεγάλῳ ἀλαλητῷ.	--- - - uu- uu- uu--	dactylic hexameter	masculine penthemimeral, hepthemimeral, trithemimeral
οὔτε θαλάσσης κῦμα τόσον βοάᾳ ποτὶ χέρσον	-u u-- -u u- uu- uu --	dactylic hexameter	feminine penthemimeral, hepthemimeral
ποντόθεν ὀρνύμενον πνοιῇ Βορέω ἀλεγεινῇ·	-uu -uu- -- -- uu--	dactylic hexameter	masculine penthemimeral, hepthemimeral
οὔτε πυρὸς τόσσός γε ποτὶ βρόμος αἰθομένοιο	-u u- -- u u- uu -uu--	dactylic hexameter	masculine penthemimeral, hepthemimeral, trithemimeral
οὔρεος ἐν βήσσῃς, ὅτε τ’ὤρετο καιέμεν ὕλην·	-uu - -- uu -uu -uu --	dactylic hexameter	masculine penthemimeral, trithemimeral
οὔτ’ἄνεμος τόσσόν γε περὶ δρυσὶν ὑψικόμοισι	-uu- -- u u- uu -uu--	dactylic hexameter	masculine penthemimeral, hepthemimeral, trithemimeral
ἠπύει, ὅς τε μάλιστα μέγα βρέμεται χαλεπαίνων,	-uu - u u-u u- uu- uu--	dactylic hexameter	feminine penthemimeral, hepthemimeral, trithemimeral
ὅσση ἄρα Τρώων καὶ Ἀχαιῶν ἔπλετο φωνὴ	-u u- -- u u-- -uu --	dactylic hexameter	masculine penthemimeral, trithemimeral
δεινὸν ἀϋσάντων, ὅτ’ ἐπ’ ἀλλήλοισιν ὄρουσαν.	-u u--- u u ---u u--	dactylic hexameter	masculine penthemimeral
Αἴαντος δὲ πρῶτος ἀκόντισε φαίδιμος Ἕκτωρ	--- - -u u-uu -uu --	dactylic hexameter	feminine penthemimeral, trithemimeral
ἔγχει, ἐπεὶ τέτραπτο πρὸς ἰθύ οἱ, οὐδ’ ἀφάμαρτε,	-u u- --u u -u u - uu--	dactylic hexameter	feminine penthemimeral, trithemimeral
τῇ ῥα δύω τελαμῶνε περὶ στήθεσσι τετάσθην,	- u u- uu-u u- --u u--	dactylic hexameter	feminine penthemimeral, hepthemimeral, trithemimeral
ἤτοι ὃ μὲν σάκεος, ὃ δὲ φασγάνου ἀργυροήλου·	-u u - uu- u u -uu -uu--	dactylic hexameter	masculine penthemimeral, trithemimeral
τώ οἱ ῥυσάσθην τέρενα χρόα. χώσατο δ’Ἕκτωρ,	- - --- uu- uu -uu --	dactylic hexameter	masculine penthemimeral, hepthemimeral
ὅττί ῥά οἱ βέλος ὠκὺ ἐτώσιον ἔκφυγε χειρός,	-u u - uu -u u-uu -uu --	dactylic hexameter	feminine penthemimeral, trithemimeral
ἂψ δ’ἑτάρων εἰς ἔθνος ἐχάζετο κῆρ’ ἀλεείνων.	- uu- - -u u-uu - uu--	dactylic hexameter	feminine penthemimeral, trithemimeral
τὸν μὲν ἔπειτ’ ἀπιόντα μέγας Τελαμώνιος Αἴας	- u u- uu-u u- uu-uu --	dactylic hexameter	feminine penthemimeral, hepthemimeral, trithemimeral
χερμαδίῳ, τά ῥα πολλὰ θοάων ἔχματα νηῶν	-uu- u u -u u-- -uu --	dactylic hexameter	feminine penthemimeral, trithemimeral
πὰρ ποσὶ μαρναμένων ἐκυλίνδετο, τῶν ἓν ἀείρας	- uu -uu- uu-uu - u u--	dactylic hexameter	masculine penthemimeral
στῆθος βεβλήκει ὑπὲρ ἄντυγος ἀγχόθι δειρῆς,	-- --- uu -uu -uu --	dactylic hexameter	masculine penthemimeral
στρόμβον δ’ὣς ἔσσευε βαλών, περὶ δ’ἔδραμε πάντῃ.	-- - --u u- uu -uu --	dactylic hexameter	feminine penthemimeral, hepthemimeral, trithemimeral
ὡς δ’ὅθ’ ὑπὸ πληγῆς πατρὸς Διὸς ἐξερίπῃ δρῦς	- u u- -- -- uu -uu- -	dactylic hexameter	masculine penthemimeral, hepthemimeral, trithemimeral
πρόρριζος, δεινὴ δὲ θεείου γίγνεται ὀδμὴ	--- -- u u-- -uu --	dactylic hexameter	masculine penthemimeral, trithemimeral
ἐξ αὐτῆς, τὸν δ’οὔ περ ἔχει θράσος ὅς κεν ἴδηται	- -- - - u u- uu - u u--	dactylic hexameter	masculine penthemimeral, hepthemimeral, trithemimeral
ἐγγὺς ἐών, χαλεπὸς δὲ Διὸς μεγάλοιο κεραυνός,	-u u- uu- u u- uu-u u--	dactylic hexameter	masculine penthemimeral, hepthemimeral, trithemimeral
ὣς ἔπεσ’ Ἕκτορος ὦκα χαμαὶ μένος ἐν κονίῃσι·	- uu -uu -u u- uu - uu--	dactylic hexameter	feminine penthemimeral, hepthemimeral
χειρὸς δ’ἔκβαλεν ἔγχος, ἐπ’ αὐτῷ δ’ἀσπὶς ἑάφθη	-- -uu -u u -- -u u--	dactylic hexameter	feminine penthemimeral
καὶ κόρυς, ἀμφὶ δέ οἱ βράχε τεύχεα ποικίλα χαλκῷ.	- uu -u u - uu -uu -uu --	dactylic hexameter	masculine penthemimeral
οἳ δὲ μέγα ἰάχοντες ἐπέδραμον υἷες Ἀχαιῶν	- u u- uu-u u-uu -u u--	dactylic hexameter	feminine penthemimeral, trithemimeral
ἐλπόμενοι ἐρύεσθαι, ἀκόντιζον δὲ θαμειὰς	-uu- uu-u u--- u u--	dactylic hexameter	feminine penthemimeral, trithemimeral
αἰχμάς· ἀλλ’ οὔ τις ἐδυνήσατο ποιμένα λαῶν	-- - - - uu-uu -uu --	dactylic hexameter	masculine penthemimeral, trithemimeral
οὐτάσαι οὐδὲ βαλεῖν· πρὶν γὰρ περίβησαν ἄριστοι	-uu -u u- - - uu-u u--	dactylic hexameter	masculine penthemimeral, hepthemimeral
Πουλυδάμας τε καὶ Αἰνείας καὶ δῖος Ἀγήνωρ	-uu- u u --- - -u u--	dactylic hexameter	hepthemimeral, trithemimeral
Σαρπηδών τ’ἀρχὸς Λυκίων καὶ Γλαῦκος ἀμύμων.	--- -- uu- - -u u--	dactylic hexameter	masculine penthemimeral, hepthemimeral, trithemimeral
τῶν δ’ἄλλων οὔ τίς εὑ ἀκήδεσεν, ἀλλὰ πάροιθεν	- -- - - u u-uu -u u--	dactylic hexameter	masculine penthemimeral, trithemimeral
ἀσπίδας εὐκύκλους σχέθον αὐτοῦ. τὸν δ’ἄρ’ ἑταῖροι	-uu --- uu -- - u u--	dactylic hexameter	masculine penthemimeral
χερσὶν ἀείραντες φέρον ἐκ πόνου, ὄφρ’ ἵκεθ’ ἵππους	-u u--- uu - uu - uu --	dactylic hexameter	masculine penthemimeral, hepthemimeral
ὠκέας, οἵ οἱ ὄπισθε μάχης ἠδὲ πτολέμοιο	-uu - u u-u u- -- uu--	dactylic hexameter	feminine penthemimeral, hepthemimeral, trithemimeral
ἕστασαν ἡνίοχόν τε καὶ ἅρματα ποικίλ’ ἔχοντες·	-uu -uu- u u -uu -u u--	dactylic hexameter	masculine penthemimeral
οἳ τόν γε προτὶ ἄστυ φέρον βαρέα στενάχοντα.	- - - uu -u u- uu- uu--	dactylic hexameter	feminine penthemimeral, hepthemimeral, trithemimeral
ἀλλ’ ὅτε δὴ πόρον ἷξον ἐϋρρεῖος ποταμοῖο	- uu - uu -u u--- uu--	dactylic hexameter	feminine penthemimeral, trithemimeral
Ξάνθου δινήεντος, ὃν ἀθάνατος τέκετο Ζεύς,	-- ---u u -uu- uu- -	dactylic hexameter	feminine penthemimeral
ἔνθά μιν ἐξ ἵππων πέλασαν χθονί, κὰδ δέ οἱ ὕδωρ	-u u - -- uu- uu - u u --	dactylic hexameter	masculine penthemimeral, hepthemimeral, trithemimeral
χεῦαν· ὃ δ’ἀμπνύνθη καὶ ἀνέδρακεν ὀφθαλμοῖσιν,	-u u --- u u-uu ----	dactylic hexameter	masculine penthemimeral
ἑζόμενος δ’ἐπὶ γοῦνα κελαινεφὲς αἷμ’ ἀπέμεσσεν·	-uu- uu -u u-uu - uu--	dactylic hexameter	feminine penthemimeral, trithemimeral
αὖτις δ’ἐξοπίσω πλῆτο χθονί, τὼ δέ οἱ ὄσσε	-- -uu- -- uu - u u --	dactylic hexameter	masculine penthemimeral, hepthemimeral
νὺξ ἐκάλυψε μέλαινα· βέλος δ’ἔτι θυμὸν ἐδάμνα.	- uu-u u-u u- uu -u u--	dactylic hexameter	feminine penthemimeral, hepthemimeral
Ἀργεῖοι δ’ὡς οὖν ἴδον Ἕκτορα νόσφι κιόντα	--- - - uu -uu -u u--	dactylic hexameter	masculine penthemimeral, trithemimeral
μᾶλλον ἐπὶ Τρώεσσι θόρον, μνήσαντο δὲ χάρμης.	-u u- --u u- --u u --	dactylic hexameter	feminine penthemimeral, hepthemimeral, trithemimeral
ἔνθα πολὺ πρώτιστος Ὀϊλῆος ταχὺς Αἴας	-u u- --u u--- uu --	dactylic hexameter	feminine penthemimeral, trithemimeral
Σάτνιον οὔτασε δουρὶ μετάλμενος ὀξυόεντι	-uu -uu -u u-uu -uu--	dactylic hexameter	feminine penthemimeral
Ἠνοπίδην, ὃν ἄρα νύμφη τέκε νηῒς ἀμύμων	-uu- u u- -- uu -u u--	dactylic hexameter	masculine penthemimeral, hepthemimeral, trithemimeral
Ἤνοπι βουκολέοντι παρ’ ὄχθας Σατνιόεντος.	-uu -uu-u u -- -uu--	dactylic hexameter	feminine penthemimeral
τὸν μὲν Ὀϊλιάδης δουρὶ κλυτὸς ἐγγύθεν ἐλθὼν	- u u-uu- -- uu -uu --	dactylic hexameter	masculine penthemimeral, hepthemimeral
οὖτα κατὰ λαπάρην· ὃ δ’ἀνετράπετ’, ἀμφὶ δ’ἄρ’ αὐτῷ	-u u- uu- u u-uu -u u --	dactylic hexameter	masculine penthemimeral, trithemimeral
Τρῶες καὶ Δαναοὶ σύναγον κρατερὴν ὑσμίνην.	-- - uu- uu- uu- ---	dactylic hexameter	masculine penthemimeral, hepthemimeral, trithemimeral
τῷ δ’ἐπὶ Πουλυδάμας ἐγχέσπαλος ἦλθεν ἀμύντωρ	- uu -uu- --uu -u u--	dactylic hexameter	masculine penthemimeral
Πανθοΐδης, βάλε δὲ Προθοήνορα δεξιὸν ὦμον	-uu- uu - uu-uu -uu --	dactylic hexameter	masculine penthemimeral, trithemimeral
υἱὸν Ἀρηϊλύκοιο, δι’ ὤμου δ’ὄβριμον ἔγχος	-u u-uu-u u -- -uu --	dactylic hexameter	feminine penthemimeral
ἔσχεν, ὃ δ’ἐν κονίῃσι πεσὼν ἕλε γαῖαν ἀγοστῷ.	-u u - uu-u u- uu -u u--	dactylic hexameter	feminine penthemimeral, hepthemimeral, trithemimeral
Πουλυδάμας δ’ἔκπαγλον ἐπεύξατο μακρὸν ἀΰσας·	-uu- --u u-uu -u u--	dactylic hexameter	feminine penthemimeral, trithemimeral
οὐ μὰν αὖτ’ ὀΐω μεγαθύμου Πανθοΐδαο	- - - uu- uu-- -uu--	dactylic hexameter	masculine penthemimeral, trithemimeral
χειρὸς ἄπο στιβαρῆς ἅλιον πηδῆσαι ἄκοντα,	-u u- uu- uu- --u u--	dactylic hexameter	masculine penthemimeral, hepthemimeral, trithemimeral
ἀλλά τις Ἀργείων κόμισε χροΐ, καί μιν ὀΐω	-u u --- uu- uu - u u--	dactylic hexameter	masculine penthemimeral, hepthemimeral
αὐτῷ σκηπτόμενον κατίμεν δόμον Ἄϊδος εἴσω.	-- -uu- uu- uu -uu --	dactylic hexameter	masculine penthemimeral, hepthemimeral
ὣς ἔφατ’, Ἀργείοισι δ’ἄχος γένετ’ εὐξαμένοιο·	- uu ---u u- uu -uu--	dactylic hexameter	feminine penthemimeral, hepthemimeral
Αἴαντι δὲ μάλιστα δαΐφρονι θυμὸν ὄρινε	--- u u-u u-uu -u u--	dactylic hexameter	feminine penthemimeral, trithemimeral
τῷ Τελαμωνιάδῃ· τοῦ γὰρ πέσεν ἄγχι μάλιστα.	- uu-uu- - - uu -u u--	dactylic hexameter	masculine penthemimeral, hepthemimeral
καρπαλίμως δ’ἀπιόντος ἀκόντισε δουρὶ φαεινῷ.	-uu- uu-u u-uu -u u--	dactylic hexameter	feminine penthemimeral, trithemimeral
Πουλυδάμας δ’αὐτὸς μὲν ἀλεύατο κῆρα μέλαιναν	-uu- -- u u-uu -u u--	dactylic hexameter	masculine penthemimeral, trithemimeral
λικριφὶς ἀΐξας, κόμισεν δ’Ἀντήνορος υἱὸς	-uu --- uu- --uu --	dactylic hexameter	masculine penthemimeral, hepthemimeral
Ἀρχέλοχος· τῷ γάρ ῥα θεοὶ βούλευσαν ὄλεθρον.	-uu- - - u u- --u u--	dactylic hexameter	masculine penthemimeral, hepthemimeral, trithemimeral
τόν ῥ’ἔβαλεν κεφαλῆς τε καὶ αὐχένος ἐν συνεοχμῷ,	- uu- uu- u u -uu - uu--	dactylic hexameter	masculine penthemimeral, trithemimeral
νείατον ἀστράγαλον, ἀπὸ δ’ἄμφω κέρσε τένοντε·	-uu -uu- uu -- -u u--	dactylic hexameter	masculine penthemimeral
τοῦ δὲ πολὺ προτέρη κεφαλὴ στόμα τε ῥῖνές τε	- u u- uu- uu- uu - -- -	dactylic hexameter	masculine penthemimeral, hepthemimeral, trithemimeral
οὔδεϊ πλῆντ’ ἤ περ κνῆμαι καὶ γοῦνα πεσόντος.	-uu - - - -- - -u u--	dactylic hexameter	masculine penthemimeral, hepthemimeral, trithemimeral
Αἴας δ’αὖτ’ ἐγέγωνεν ἀμύμονι Πουλυδάμαντι·	-- - uu-u u-uu -uu--	dactylic hexameter	feminine penthemimeral, trithemimeral
φράζεο Πουλυδάμα καί μοι νημερτὲς ἐνίσπες	-uu -uu- - - --u u--	dactylic hexameter	masculine penthemimeral, hepthemimeral
ἦ ῥ’οὐχ οὗτος ἀνὴρ Προθοήνορος ἀντὶ πεφάσθαι	- - -u u- uu-uu -u u--	dactylic hexameter	masculine penthemimeral
ἄξιος; οὐ μέν μοι κακὸς εἴδεται οὐδὲ κακῶν ἔξ,	-uu - - - uu -uu -u u- -	dactylic hexameter	masculine penthemimeral, trithemimeral
ἀλλὰ κασίγνητος Ἀντήνορος ἱπποδάμοιο	-u u--- --uu -uu--	dactylic hexameter	masculine penthemimeral
ἢ πάϊς· αὐτῷ γὰρ γενεὴν ἄγχιστα ἐῴκει.	- uu -- - uu- --u u--	dactylic hexameter	masculine penthemimeral, hepthemimeral
ἦ ῥ’εὖ γιγνώσκων, Τρῶας δ’ἄχος ἔλλαβε θυμόν.	- - --- -- uu -uu --	dactylic hexameter	masculine penthemimeral, hepthemimeral
ἔνθ’ Ἀκάμας Πρόμαχον Βοιώτιον οὔτασε δουρὶ	- uu- uu- --uu -uu --	dactylic hexameter	masculine penthemimeral, trithemimeral
ἀμφὶ κασιγνήτῳ βεβαώς· ὃ δ’ὕφελκε ποδοῖιν.	-u u--- uu- u u-u u--	dactylic hexameter	masculine penthemimeral, hepthemimeral
τῷ δ’Ἀκάμας ἔκπαγλον ἐπεύξατο μακρὸν ἀΰσας·	- uu- --u u-uu -u u--	dactylic hexameter	feminine penthemimeral, trithemimeral
Ἀργεῖοι ἰόμωροι ἀπειλάων ἀκόρητοι	--- uu-u u--- uu--	dactylic hexameter	feminine penthemimeral, trithemimeral
οὔ θην οἴοισίν γε πόνος τ’ἔσεται καὶ ὀϊζὺς	- - --- u u- uu- u u--	dactylic hexameter	masculine penthemimeral, hepthemimeral
ἡμῖν, ἀλλά ποθ’ ὧδε κατακτενέεσθε καὶ ὔμμες.	-- -u u -u u-uu-u u --	dactylic hexameter	feminine penthemimeral
φράζεσθ’ ὡς ὑμῖν Πρόμαχος δεδμημένος εὕδει	-- - -- uu- --uu --	dactylic hexameter	masculine penthemimeral, hepthemimeral, trithemimeral
ἔγχει ἐμῷ, ἵνα μή τι κασιγνήτοιό γε ποινὴ	-u u- uu - u u---u u --	dactylic hexameter	masculine penthemimeral, trithemimeral
δηρὸν ἄτιτος ἔῃ· τὼ καί κέ τις εὔχεται ἀνὴρ	-u u-u u- - - u u -uu --	dactylic hexameter	masculine penthemimeral, hepthemimeral
γνωτὸν ἐνὶ μεγάροισιν ἀρῆς ἀλκτῆρα λιπέσθαι.	-u u- uu-u u- --u u--	dactylic hexameter	feminine penthemimeral, hepthemimeral, trithemimeral
ὣς ἔφατ’, Ἀργείοισι δ’ἄχος γένετ’ εὐξαμένοιο·	- uu ---u u- uu -uu--	dactylic hexameter	feminine penthemimeral, hepthemimeral
Πηνέλεῳ δὲ μάλιστα δαΐφρονι θυμὸν ὄρινεν·	-uu- u u-u u-uu -u u--	dactylic hexameter	feminine penthemimeral, trithemimeral
ὁρμήθη δ’Ἀκάμαντος· ὃ δ’οὐχ ὑπέμεινεν ἐρωὴν	--- uu-u u - uu-u u--	dactylic hexameter	feminine penthemimeral, hepthemimeral, trithemimeral
Πηνελέωο ἄνακτος· ὃ δ’οὔτασεν Ἰλιονῆα	-uu-u u-u u -uu -uu--	dactylic hexameter	feminine penthemimeral
υἱὸν Φόρβαντος πολυμήλου, τόν ῥα μάλιστα	-- --- uu-- - u u--	dactylic hexameter	masculine penthemimeral
Ἑρμείας Τρώων ἐφίλει καὶ κτῆσιν ὄπασσε·	--- -- uu- - -u u--	dactylic hexameter	masculine penthemimeral, hepthemimeral, trithemimeral
τῷ δ’ἄρ’ ὑπὸ μήτηρ μοῦνον τέκεν Ἰλιονῆα.	- u u- -- -- uu -uu--	dactylic hexameter	masculine penthemimeral, hepthemimeral, trithemimeral
τὸν τόθ’ ὑπ’ ὀφρύος οὖτα κατ’ ὀφθαλμοῖο θέμεθλα,	- u u -uu -u u ---u u--	dactylic hexameter	feminine penthemimeral
ἐκ δ’ὦσε γλήνην· δόρυ δ’ὀφθαλμοῖο διὰ πρὸ	- -- -- uu ---u u- -	dactylic hexameter	masculine penthemimeral, trithemimeral
καὶ διὰ ἰνίου ἦλθεν, ὃ δ’ἕζετο χεῖρε πετάσσας	- uu -uu -u u -uu -u u--	dactylic hexameter	feminine penthemimeral
ἄμφω· Πηνέλεως δὲ ἐρυσσάμενος ξίφος ὀξὺ	-- -uu- u u-uu- uu --	dactylic hexameter	masculine penthemimeral
αὐχένα μέσσον ἔλασσεν, ἀπήραξεν δὲ χαμᾶζε	-uu -u u-u u--- u u--	dactylic hexameter	feminine penthemimeral
αὐτῇ σὺν πήληκι κάρη· ἔτι δ’ὄβριμον ἔγχος	-- - --u u- uu -uu --	dactylic hexameter	feminine penthemimeral, hepthemimeral, trithemimeral
ἦεν ἐν ὀφθαλμῷ· ὃ δὲ φὴ κώδειαν ἀνασχὼν	-u u --- u u - --u u--	dactylic hexameter	masculine penthemimeral, hepthemimeral
πέφραδέ τε Τρώεσσι καὶ εὐχόμενος ἔπος ηὔδα·	-uu - --u u -uu- uu --	dactylic hexameter	feminine penthemimeral, trithemimeral
εἰπέμεναί μοι Τρῶες ἀγαυοῦ Ἰλιονῆος	-uu- - -u u-- -uu--	dactylic hexameter	feminine penthemimeral, trithemimeral
πατρὶ φίλῳ καὶ μητρὶ γοήμεναι ἐν μεγάροισιν·	-u u- - -u u-uu - uu--	dactylic hexameter	feminine penthemimeral, trithemimeral
οὐδὲ γὰρ ἣ Προμάχοιο δάμαρ Ἀλεγηνορίδαο	-u u - uu-u u- uu-uu--	dactylic hexameter	feminine penthemimeral, hepthemimeral, trithemimeral
ἀνδρὶ φίλῳ ἐλθόντι γανύσσεται, ὁππότε κεν δὴ	-u u- --u u-uu -uu - -	dactylic hexameter	feminine penthemimeral, trithemimeral
ἐκ Τροίης σὺν νηυσὶ νεώμεθα κοῦροι Ἀχαιῶν.	- -- - -u u-uu -u u--	dactylic hexameter	feminine penthemimeral, trithemimeral
ὣς φάτο, τοὺς δ’ἄρα πάντας ὑπὸ τρόμος ἔλλαβε γυῖα,	- uu - uu -u u- uu -uu --	dactylic hexameter	feminine penthemimeral, hepthemimeral, trithemimeral
πάπτηνεν δὲ ἕκαστος ὅπῃ φύγοι αἰπὺν ὄλεθρον.	--- u u-u u- uu -u u--	dactylic hexameter	feminine penthemimeral, hepthemimeral, trithemimeral
ἔσπετε νῦν μοι Μοῦσαι Ὀλύμπια δώματ’ ἔχουσαι	-uu - - -u u-uu -u u--	dactylic hexameter	feminine penthemimeral, trithemimeral
ὅς τις δὴ πρῶτος βροτόεντ’ ἀνδράγρι’ Ἀχαιῶν	- - - -- uu- --u u--	dactylic hexameter	masculine penthemimeral, hepthemimeral, trithemimeral
ἤρατ’, ἐπεί ῥ’ἔκλινε μάχην κλυτὸς ἐννοσίγαιος.	-u u- --u u- uu -uu--	dactylic hexameter	feminine penthemimeral, hepthemimeral, trithemimeral
Αἴας ῥα πρῶτος Τελαμώνιος Ὕρτιον οὖτα	-- - -- uu-uu -uu --	dactylic hexameter	masculine penthemimeral, trithemimeral
Γυρτιάδην Μυσῶν ἡγήτορα καρτεροθύμων·	-uu- -- --uu -uu--	dactylic hexameter	masculine penthemimeral, trithemimeral
Φάλκην δ’Ἀντίλοχος καὶ Μέρμερον ἐξενάριξε·	-- -uu- - -uu -uu--	dactylic hexameter	masculine penthemimeral
Μηριόνης δὲ Μόρυν τε καὶ Ἱπποτίωνα κατέκτα,	-uu- u u- u u -uu-u u--	dactylic hexameter	masculine penthemimeral, trithemimeral
Τεῦκρος δὲ Προθόωνά τ’ἐνήρατο καὶ Περιφήτην·	-- - uu-u u-uu - uu--	dactylic hexameter	feminine penthemimeral, trithemimeral
Ἀτρεΐδης δ’ἄρ’ ἔπειθ’ Ὑπερήνορα ποιμένα λαῶν	-uu- u u- uu-uu -uu --	dactylic hexameter	masculine penthemimeral, trithemimeral
οὖτα κατὰ λαπάρην, διὰ δ’ἔντερα χαλκὸς ἄφυσσε	-u u- uu- uu -uu -u u--	dactylic hexameter	masculine penthemimeral, trithemimeral
δῃώσας· ψυχὴ δὲ κατ’ οὐταμένην ὠτειλὴν	--- -- u u -uu- ---	dactylic hexameter	masculine penthemimeral, trithemimeral
ἔσσυτ’ ἐπειγομένη, τὸν δὲ σκότος ὄσσε κάλυψε.	-u u-uu- - - uu -u u--	dactylic hexameter	masculine penthemimeral, hepthemimeral
πλείστους δ’Αἴας εἷλεν Ὀϊλῆος ταχὺς υἱός·	-- -- -u u--- uu --	dactylic hexameter	feminine penthemimeral
οὐ γάρ οἵ τις ὁμοῖος ἐπισπέσθαι ποσὶν ἦεν	- - - u u-u u--- uu --	dactylic hexameter	feminine penthemimeral, trithemimeral
ἀνδρῶν τρεσσάντων, ὅτε τε Ζεὺς ἐν φόβον ὄρσῃ.	-- --- uu - - - uu --	dactylic hexameter	masculine penthemimeral, hepthemimeral
