Ἠὼς μὲν κροκόπεπλος ἀπ’ Ὠκεανοῖο ῥοάων	-- - uu-u u -uu-u u--	dactylic hexameter	feminine penthemimeral, trithemimeral
ὄρνυθ’, ἵν’ ἀθανάτοισι φόως φέροι ἠδὲ βροτοῖσιν·	-u u -uu-u u- uu -u u--	dactylic hexameter	feminine penthemimeral, hepthemimeral
ἣ δ’ἐς νῆας ἵκανε θεοῦ πάρα δῶρα φέρουσα.	- - -u u-u u- uu -u u--	dactylic hexameter	feminine penthemimeral, hepthemimeral
εὗρε δὲ Πατρόκλῳ περικείμενον ὃν φίλον υἱὸν	-u u --- uu-uu - uu --	dactylic hexameter	masculine penthemimeral
κλαίοντα λιγέως· πολέες δ’ἀμφ’ αὐτὸν ἑταῖροι	--- uu- uu- - -u u--	dactylic hexameter	masculine penthemimeral, hepthemimeral, trithemimeral
μύρονθ’· ἣ δ’ἐν τοῖσι παρίστατο δῖα θεάων,	-- - - -u u-uu -u u--	dactylic hexameter	feminine penthemimeral, trithemimeral
ἔν τ’ἄρα οἱ φῦ χειρὶ ἔπος τ’ἔφατ’ ἔκ τ’ὀνόμαζε·	- uu - - -u u- uu - uu--	dactylic hexameter	feminine penthemimeral, hepthemimeral, trithemimeral
τέκνον ἐμὸν τοῦτον μὲν ἐάσομεν ἀχνύμενοί περ	-u u- -- u u-uu -uu- -	dactylic hexameter	masculine penthemimeral, trithemimeral
κεῖσθαι, ἐπεὶ δὴ πρῶτα θεῶν ἰότητι δαμάσθη·	-u u- - -u u- uu-u u--	dactylic hexameter	feminine penthemimeral, hepthemimeral, trithemimeral
τύνη δ’Ἡφαίστοιο πάρα κλυτὰ τεύχεα δέξο	-- ---u u- uu -uu --	dactylic hexameter	feminine penthemimeral, hepthemimeral
καλὰ μάλ’, οἷ’ οὔ πώ τις ἀνὴρ ὤμοισι φόρησεν.	-u u - - - u u- --u u--	dactylic hexameter	masculine penthemimeral, hepthemimeral, trithemimeral
ὡς ἄρα φωνήσασα θεὰ κατὰ τεύχε’ ἔθηκε	- uu ---u u- uu -u u--	dactylic hexameter	feminine penthemimeral, hepthemimeral
πρόσθεν Ἀχιλλῆος· τὰ δ’ἀνέβραχε δαίδαλα πάντα.	-u u--- u u-uu -uu --	dactylic hexameter	masculine penthemimeral
Μυρμιδόνας δ’ἄρα πάντας ἕλε τρόμος, οὐδέ τις ἔτλη	-uu- uu -u u- uu -u u --	dactylic hexameter	feminine penthemimeral, hepthemimeral, trithemimeral
ἄντην εἰσιδέειν, ἀλλ’ ἔτρεσαν. αὐτὰρ Ἀχιλλεὺς	-- -uu- - -uu -u u--	dactylic hexameter	masculine penthemimeral
ὡς εἶδ’, ὥς μιν μᾶλλον ἔδυ χόλος, ἐν δέ οἱ ὄσσε	- - - - -u u- uu - u u --	dactylic hexameter	feminine penthemimeral, hepthemimeral, trithemimeral
δεινὸν ὑπὸ βλεφάρων ὡς εἰ σέλας ἐξεφάανθεν·	-u u- uu- - - uu -uu--	dactylic hexameter	masculine penthemimeral, hepthemimeral, trithemimeral
τέρπετο δ’ἐν χείρεσσιν ἔχων θεοῦ ἀγλαὰ δῶρα.	-uu - --u u- uu -uu --	dactylic hexameter	feminine penthemimeral, hepthemimeral, trithemimeral
αὐτὰρ ἐπεὶ φρεσὶν ᾗσι τετάρπετο δαίδαλα λεύσσων	-u u- uu -u u-uu -uu --	dactylic hexameter	feminine penthemimeral, trithemimeral
αὐτίκα μητέρα ἣν ἔπεα πτερόεντα προσηύδα·	-uu -uu - uu- uu-u u--	dactylic hexameter	masculine penthemimeral, hepthemimeral
μῆτερ ἐμὴ τὰ μὲν ὅπλα θεὸς πόρεν οἷ’ ἐπιεικὲς	-u u- u u -u u- uu - uu--	dactylic hexameter	feminine penthemimeral, hepthemimeral, trithemimeral
ἔργ’ ἔμεν ἀθανάτων, μὴ δὲ βροτὸν ἄνδρα τελέσσαι.	- uu -uu- - - uu -u u--	dactylic hexameter	masculine penthemimeral, hepthemimeral
νῦν δ’ἤτοι μὲν ἐγὼ θωρήξομαι· ἀλλὰ μάλ’ αἰνῶς	- -- u u- --uu -u u --	dactylic hexameter	masculine penthemimeral, trithemimeral
δείδω μή μοι τόφρα Μενοιτίου ἄλκιμον υἱὸν	-- - - -u u-uu -uu --	dactylic hexameter	feminine penthemimeral, trithemimeral
μυῖαι καδδῦσαι κατὰ χαλκοτύπους ὠτειλὰς	-- --- uu -uu- ---	dactylic hexameter	masculine penthemimeral
εὐλὰς ἐγγείνωνται, ἀεικίσσωσι δὲ νεκρόν,	-- ---u u---u u --	dactylic hexameter	feminine penthemimeral
ἐκ δ’αἰὼν πέφαται, κατὰ δὲ χρόα πάντα σαπήῃ.	- -- uu- uu - uu -u u--	dactylic hexameter	masculine penthemimeral, hepthemimeral, trithemimeral
τὸν δ’ἠμείβετ’ ἔπειτα θεὰ Θέτις ἀργυρόπεζα·	- --u u-u u- uu -uu--	dactylic hexameter	feminine penthemimeral, hepthemimeral
τέκνον μή τοι ταῦτα μετὰ φρεσὶ σῇσι μελόντων.	-- - - -u u- uu -u u--	dactylic hexameter	feminine penthemimeral, hepthemimeral, trithemimeral
τῷ μὲν ἐγὼ πειρήσω ἀλαλκεῖν ἄγρια φῦλα	- u u- --u u-- -uu --	dactylic hexameter	feminine penthemimeral, trithemimeral
μυίας, αἵ ῥά τε φῶτας ἀρηϊφάτους κατέδουσιν·	-- - u u -u u-uu- uu--	dactylic hexameter	feminine penthemimeral, trithemimeral
ἤν περ γὰρ κεῖταί γε τελεσφόρον εἰς ἐνιαυτόν,	- - - -- u u-uu - uu--	dactylic hexameter	masculine penthemimeral, trithemimeral
αἰεὶ τῷ γ’ἔσται χρὼς ἔμπεδος, ἢ καὶ ἀρείων.	-- - -- - -uu - u u--	dactylic hexameter	masculine penthemimeral, trithemimeral
ἀλλὰ σύ γ’εἰς ἀγορὴν καλέσας ἥρωας Ἀχαιοὺς	-u u - uu- uu- --u u--	dactylic hexameter	masculine penthemimeral, hepthemimeral, trithemimeral
μῆνιν ἀποειπὼν Ἀγαμέμνονι ποιμένι λαῶν	-u u--- uu-uu -uu --	dactylic hexameter	masculine penthemimeral
αἶψα μάλ’ ἐς πόλεμον θωρήσσεο, δύσεο δ’ἀλκήν.	-u u - uu- --uu -uu --	dactylic hexameter	masculine penthemimeral, trithemimeral
ὣς ἄρα φωνήσασα μένος πολυθαρσὲς ἐνῆκε,	- uu ---u u- uu-u u--	dactylic hexameter	feminine penthemimeral, hepthemimeral
Πατρόκλῳ δ’αὖτ’ ἀμβροσίην καὶ νέκταρ ἐρυθρὸν	--- - -uu- - -u u--	dactylic hexameter	hepthemimeral, trithemimeral
στάξε κατὰ ῥινῶν, ἵνα οἱ χρὼς ἔμπεδος εἴη.	-u u- -- uu - - -uu --	dactylic hexameter	masculine penthemimeral, hepthemimeral, trithemimeral
αὐτὰρ ὃ βῆ παρὰ θῖνα θαλάσσης δῖος Ἀχιλλεὺς	-u u - uu -u u-- -u u--	dactylic hexameter	feminine penthemimeral, trithemimeral
σμερδαλέα ἰάχων, ὦρσεν δ’ἥρωας Ἀχαιούς.	-uu- uu- -- --u u--	dactylic hexameter	masculine penthemimeral, hepthemimeral, trithemimeral
καί ῥ’οἵ περ τὸ πάρος γε νεῶν ἐν ἀγῶνι μένεσκον	- - - u u- u u- u u-u u--	dactylic hexameter	masculine penthemimeral, hepthemimeral, trithemimeral
οἵ τε κυβερνῆται καὶ ἔχον οἰήϊα νηῶν	- u u--- u u- --uu --	dactylic hexameter	masculine penthemimeral, hepthemimeral
καὶ ταμίαι παρὰ νηυσὶν ἔσαν σίτοιο δοτῆρες,	- uu- uu -u u- --u u--	dactylic hexameter	feminine penthemimeral, hepthemimeral, trithemimeral
καὶ μὴν οἳ τότε γ’εἰς ἀγορὴν ἴσαν, οὕνεκ’ Ἀχιλλεὺς	- - - uu - uu- uu -u u--	dactylic hexameter	masculine penthemimeral, hepthemimeral, trithemimeral
ἐξεφάνη, δηρὸν δὲ μάχης ἐπέπαυτ’ ἀλεγεινῆς.	-uu- -- u u- uu- uu--	dactylic hexameter	masculine penthemimeral, hepthemimeral, trithemimeral
τὼ δὲ δύω σκάζοντε βάτην Ἄρεος θεράποντε	- u u- --u u- uu- uu--	dactylic hexameter	feminine penthemimeral, hepthemimeral, trithemimeral
Τυδεΐδης τε μενεπτόλεμος καὶ δῖος Ὀδυσσεὺς	-uu- u u-uu- - -u u--	dactylic hexameter	hepthemimeral, trithemimeral
ἔγχει ἐρειδομένω· ἔτι γὰρ ἔχον ἕλκεα λυγρά·	-u u-uu- uu - uu -uu --	dactylic hexameter	masculine penthemimeral, hepthemimeral
κὰδ δὲ μετὰ πρώτῃ ἀγορῇ ἵζοντο κιόντες.	- u u- -- uu- --u u--	dactylic hexameter	masculine penthemimeral, hepthemimeral, trithemimeral
αὐτὰρ ὃ δεύτατος ἦλθεν ἄναξ ἀνδρῶν Ἀγαμέμνων	-u u -uu -u u- -- uu--	dactylic hexameter	feminine penthemimeral, hepthemimeral
ἕλκος ἔχων· καὶ γὰρ τὸν ἐνὶ κρατερῇ ὑσμίνῃ	-u u- - - u u- uu- ---	dactylic hexameter	masculine penthemimeral, hepthemimeral, trithemimeral
οὖτα Κόων Ἀντηνορίδης χαλκήρεϊ δουρί.	-u u- --uu- --uu --	dactylic hexameter	hepthemimeral, trithemimeral
αὐτὰρ ἐπεὶ δὴ πάντες ἀολλίσθησαν Ἀχαιοί,	-u u- - -u u---u u--	dactylic hexameter	feminine penthemimeral, trithemimeral
τοῖσι δ’ἀνιστάμενος μετέφη πόδας ὠκὺς Ἀχιλλεύς·	-u u-uu- uu- uu -u u--	dactylic hexameter	masculine penthemimeral, hepthemimeral
Ἀτρεΐδη ἦ ἄρ τι τόδ’ ἀμφοτέροισιν ἄρειον	-uu- - - u u -uu-u u--	dactylic hexameter	masculine penthemimeral, trithemimeral
ἔπλετο σοὶ καὶ ἐμοί, ὅ τε νῶΐ περ ἀχνυμένω κῆρ	-uu - u u- u u -u u -uu- -	dactylic hexameter	masculine penthemimeral, trithemimeral
θυμοβόρῳ ἔριδι μενεήναμεν εἵνεκα κούρης;	-uu- uu- uu-uu -uu --	dactylic hexameter	masculine penthemimeral, trithemimeral
τὴν ὄφελ’ ἐν νήεσσι κατακτάμεν Ἄρτεμις ἰῷ	- uu - --u u-uu -uu --	dactylic hexameter	feminine penthemimeral, trithemimeral
ἤματι τῷ ὅτ’ ἐγὼν ἑλόμην Λυρνησσὸν ὀλέσσας·	-uu - u u- uu- --u u--	dactylic hexameter	masculine penthemimeral, hepthemimeral, trithemimeral
τώ κ’οὐ τόσσοι Ἀχαιοὶ ὀδὰξ ἕλον ἄσπετον οὖδας	- - -u u-u u- uu -uu --	dactylic hexameter	feminine penthemimeral, hepthemimeral
δυσμενέων ὑπὸ χερσὶν ἐμεῦ ἀπομηνίσαντος.	-uu- uu -u u- uu----	dactylic hexameter	feminine penthemimeral, hepthemimeral, trithemimeral
Ἕκτορι μὲν καὶ Τρωσὶ τὸ κέρδιον· αὐτὰρ Ἀχαιοὺς	-uu - - -u u -uu -u u--	dactylic hexameter	feminine penthemimeral, trithemimeral
δηρὸν ἐμῆς καὶ σῆς ἔριδος μνήσεσθαι ὀΐω.	-u u- - - uu- --u u--	dactylic hexameter	masculine penthemimeral, hepthemimeral, trithemimeral
ἀλλὰ τὰ μὲν προτετύχθαι ἐάσομεν ἀχνύμενοί περ	-u u - uu-u u-uu -uu- -	dactylic hexameter	feminine penthemimeral, trithemimeral
θυμὸν ἐνὶ στήθεσσι φίλον δαμάσαντες ἀνάγκῃ·	-u u- --u u- uu-u u--	dactylic hexameter	feminine penthemimeral, hepthemimeral, trithemimeral
νῦν δ’ἤτοι μὲν ἐγὼ παύω χόλον, οὐδέ τί με χρὴ	- -- u u- -- uu -u u - -	dactylic hexameter	masculine penthemimeral, hepthemimeral, trithemimeral
ἀσκελέως αἰεὶ μενεαινέμεν· ἀλλ’ ἄγε θᾶσσον	-uu- -- uu-uu - uu --	dactylic hexameter	masculine penthemimeral, trithemimeral
ὄτρυνον πόλεμον δὲ κάρη κομόωντας Ἀχαιούς,	--- uu- u u- uu-u u--	dactylic hexameter	masculine penthemimeral, hepthemimeral, trithemimeral
ὄφρ’ ἔτι καὶ Τρώων πειρήσομαι ἀντίον ἐλθὼν	- uu - -- --uu -uu --	dactylic hexameter	masculine penthemimeral, trithemimeral
αἴ κ’ἐθέλωσ’ ἐπὶ νηυσὶν ἰαύειν· ἀλλά τιν’ οἴω	- uu- uu -u u-- -u u --	dactylic hexameter	feminine penthemimeral, trithemimeral
ἀσπασίως αὐτῶν γόνυ κάμψειν, ὅς κε φύγῃσι	-uu- -- uu -- - u u--	dactylic hexameter	masculine penthemimeral, trithemimeral
δηΐου ἐκ πολέμοιο ὑπ’ ἔγχεος ἡμετέροιο.	-uu - uu-u u -uu -uu--	dactylic hexameter	feminine penthemimeral, trithemimeral
ὣς ἔφαθ’, οἳ δ’ἐχάρησαν ἐϋκνήμιδες Ἀχαιοὶ	- uu - uu-u u---u u--	dactylic hexameter	feminine penthemimeral, trithemimeral
μῆνιν ἀπειπόντος μεγαθύμου Πηλεΐωνος.	-u u--- uu-- -uu--	dactylic hexameter	masculine penthemimeral
τοῖσι δὲ καὶ μετέειπεν ἄναξ ἀνδρῶν Ἀγαμέμνων	-u u - uu-u u- -- uu--	dactylic hexameter	feminine penthemimeral, hepthemimeral, trithemimeral
αὐτόθεν ἐξ ἕδρης, οὐδ’ ἐν μέσσοισιν ἀναστάς·	-uu - -- - - --u u--	dactylic hexameter	masculine penthemimeral, hepthemimeral, trithemimeral
ὦ φίλοι ἥρωες Δαναοὶ θεράποντες Ἄρηος	- uu --- uu- uu-u u--	dactylic hexameter	masculine penthemimeral, hepthemimeral
ἑσταότος μὲν καλὸν ἀκούειν, οὐδὲ ἔοικεν	-uu- - -u u-- -u u--	dactylic hexameter	feminine penthemimeral, trithemimeral
ὑββάλλειν· χαλεπὸν γὰρ ἐπισταμένῳ περ ἐόντι.	--- uu- u u-uu- u u--	dactylic hexameter	masculine penthemimeral, trithemimeral
ἀνδρῶν δ’ἐν πολλῷ ὁμάδῳ πῶς κέν τις ἀκούσαι	-- - -- uu- - - u u--	dactylic hexameter	masculine penthemimeral, hepthemimeral, trithemimeral
ἢ εἴποι; βλάβεται δὲ λιγύς περ ἐὼν ἀγορητής.	- -- uu- u u- u u- uu--	dactylic hexameter	masculine penthemimeral, hepthemimeral, trithemimeral
Πηλεΐδῃ μὲν ἐγὼν ἐνδείξομαι· αὐτὰρ οἱ ἄλλοι	-uu- u u- --uu -u u --	dactylic hexameter	masculine penthemimeral, trithemimeral
σύνθεσθ’ Ἀργεῖοι, μῦθόν τ’εὖ γνῶτε ἕκαστος.	-- --- -- - -u u--	dactylic hexameter	masculine penthemimeral, hepthemimeral
πολλάκι δή μοι τοῦτον Ἀχαιοὶ μῦθον ἔειπον	-uu - - -u u-- -u u--	dactylic hexameter	feminine penthemimeral, trithemimeral
καί τέ με νεικείεσκον· ἐγὼ δ’οὐκ αἴτιός εἰμι,	- u u ---u u- - -uu --	dactylic hexameter	feminine penthemimeral, hepthemimeral
ἀλλὰ Ζεὺς καὶ Μοῖρα καὶ ἠεροφοῖτις Ἐρινύς,	-- - - -u u -uu-u u--	dactylic hexameter	feminine penthemimeral, trithemimeral
οἵ τέ μοι εἰν ἀγορῇ φρεσὶν ἔμβαλον ἄγριον ἄτην,	- u u - uu- uu -uu -uu --	dactylic hexameter	masculine penthemimeral, trithemimeral
ἤματι τῷ ὅτ’ Ἀχιλλῆος γέρας αὐτὸς ἀπηύρων.	-uu - u u--- uu -u u--	dactylic hexameter	hepthemimeral, trithemimeral
ἀλλὰ τί κεν ῥέξαιμι; θεὸς διὰ πάντα τελευτᾷ.	-u u - --u u- uu -u u--	dactylic hexameter	feminine penthemimeral, hepthemimeral, trithemimeral
πρέσβα Διὸς θυγάτηρ Ἄτη, ἣ πάντας ἀᾶται,	-u u- uu- -- - -u u--	dactylic hexameter	masculine penthemimeral, hepthemimeral, trithemimeral
οὐλομένη· τῇ μέν θ’ἁπαλοὶ πόδες· οὐ γὰρ ἐπ’ οὔδει	-uu- - - uu- uu - u u --	dactylic hexameter	masculine penthemimeral, hepthemimeral, trithemimeral
πίλναται, ἀλλ’ ἄρα ἥ γε κατ’ ἀνδρῶν κράατα βαίνει	-uu - uu - u u -- -uu --	dactylic hexameter	masculine penthemimeral, trithemimeral
βλάπτουσ’ ἀνθρώπους· κατὰ δ’οὖν ἕτερόν γε πέδησε.	-- --- uu - uu- u u--	dactylic hexameter	masculine penthemimeral, hepthemimeral
καὶ γὰρ δή νύ ποτε Ζεὺς ἄσατο, τόν περ ἄριστον	- - - u u- - -uu - u u--	dactylic hexameter	masculine penthemimeral, trithemimeral
ἀνδρῶν ἠδὲ θεῶν φασ’ ἔμμεναι· ἀλλ’ ἄρα καὶ τὸν	-- -u u- - -uu - uu - -	dactylic hexameter	masculine penthemimeral
Ἥρη θῆλυς ἐοῦσα δολοφροσύνῃς ἀπάτησεν,	-- -u u-u u-uu- uu--	dactylic hexameter	feminine penthemimeral
ἤματι τῷ ὅτ’ ἔμελλε βίην Ἡρακληείην	-uu - u u-u u- -----	dactylic hexameter	feminine penthemimeral, hepthemimeral, trithemimeral
Ἀλκμήνη τέξεσθαι ἐϋστεφάνῳ ἐνὶ Θήβῃ.	--- --u u-uu- uu --	dactylic hexameter	feminine penthemimeral, trithemimeral
ἤτοι ὅ γ’εὐχόμενος μετέφη πάντεσσι θεοῖσι·	-u u -uu- uu- --u u--	dactylic hexameter	masculine penthemimeral, hepthemimeral
κέκλυτέ μευ πάντές τε θεοὶ πᾶσαί τε θέαιναι,	-uu - -- u u- -- u u--	dactylic hexameter	masculine penthemimeral, hepthemimeral, trithemimeral
ὄφρ’ εἴπω τά με θυμὸς ἐνὶ στήθεσσιν ἀνώγει.	- -- u u -u u- --u u--	dactylic hexameter	feminine penthemimeral, hepthemimeral, trithemimeral
σήμερον ἄνδρα φόως δὲ μογοστόκος Εἰλείθυια	-uu -u u- u u-uu ----	dactylic hexameter	masculine penthemimeral
ἐκφανεῖ, ὃς πάντεσσι περικτιόνεσσιν ἀνάξει,	-uu - --u u-uu-u u--	dactylic hexameter	feminine penthemimeral, trithemimeral
τῶν ἀνδρῶν γενεῆς οἵ θ’αἵματος ἐξ ἐμεῦ εἰσί.	- -- uu- - -uu - uu --	dactylic hexameter	masculine penthemimeral, trithemimeral
τὸν δὲ δολοφρονέουσα προσηύδα πότνια Ἥρη·	- u u-uu-u u-- -uu --	dactylic hexameter	feminine penthemimeral
ψευστήσεις, οὐδ’ αὖτε τέλος μύθῳ ἐπιθήσεις.	--- - -u u- -- uu--	dactylic hexameter	feminine penthemimeral, hepthemimeral, trithemimeral
εἰ δ’ἄγε νῦν μοι ὄμοσσον Ὀλύμπιε καρτερὸν ὅρκον,	- uu - u u-u u-uu -uu --	dactylic hexameter	feminine penthemimeral, trithemimeral
ἦ μὲν τὸν πάντεσσι περικτιόνεσσιν ἀνάξειν	- - - --u u-uu-u u--	dactylic hexameter	feminine penthemimeral, trithemimeral
ὅς κεν ἐπ’ ἤματι τῷδε πέσῃ μετὰ ποσσὶ γυναικὸς	- u u -uu -u u- uu -u u--	dactylic hexameter	feminine penthemimeral, hepthemimeral
τῶν ἀνδρῶν οἳ σῆς ἐξ αἵματός εἰσι γενέθλης.	- -- - - - -uu -u u--	dactylic hexameter	masculine penthemimeral, trithemimeral
ὣς ἔφατο· Ζεὺς δ’οὔ τι δολοφροσύνην ἐνόησεν,	- uu- - - u u-uu- uu--	dactylic hexameter	masculine penthemimeral, trithemimeral
ἀλλ’ ὄμοσεν μέγαν ὅρκον, ἔπειτα δὲ πολλὸν ἀάσθη.	- uu- uu -u u-u u -u u--	dactylic hexameter	feminine penthemimeral, trithemimeral
Ἥρη δ’ἀΐξασα λίπεν ῥίον Οὐλύμποιο,	-- ---u u- uu ----	dactylic hexameter	feminine penthemimeral, hepthemimeral
καρπαλίμως δ’ἵκετ’ Ἄργος Ἀχαιικόν, ἔνθ’ ἄρα ᾔδη	-uu- uu -u u-uu - uu --	dactylic hexameter	feminine penthemimeral, trithemimeral
ἰφθίμην ἄλοχον Σθενέλου Περσηϊάδαο.	--- uu- uu- --uu--	dactylic hexameter	masculine penthemimeral, hepthemimeral, trithemimeral
ἣ δ’ἐκύει φίλον υἱόν, ὃ δ’ἕβδομος ἑστήκει μείς·	- uu- uu -u u -uu --- -	dactylic hexameter	feminine penthemimeral, trithemimeral
ἐκ δ’ἄγαγε πρὸ φόως δὲ καὶ ἠλιτόμηνον ἐόντα,	- uu- u u- u u -uu-u u--	dactylic hexameter	masculine penthemimeral, trithemimeral
Ἀλκμήνης δ’ἀπέπαυσε τόκον, σχέθε δ’Εἰλειθυίας.	--- uu-u u- uu ----	dactylic hexameter	feminine penthemimeral, hepthemimeral, trithemimeral
αὐτὴ δ’ἀγγελέουσα Δία Κρονίωνα προσηύδα·	-- -uu-u u- uu-u u--	dactylic hexameter	feminine penthemimeral, hepthemimeral
Ζεῦ πάτερ ἀργικέραυνε ἔπος τί τοι ἐν φρεσὶ θήσω·	- uu -uu-u u- u u - uu --	dactylic hexameter	feminine penthemimeral, hepthemimeral
ἤδη ἀνὴρ γέγον’ ἐσθλὸς ὃς Ἀργείοισιν ἀνάξει	-u u- uu -u u ---u u--	dactylic hexameter	feminine penthemimeral, trithemimeral
Εὐρυσθεὺς Σθενέλοιο πάϊς Περσηϊάδαο	--- uu-u u- --uu--	dactylic hexameter	feminine penthemimeral, hepthemimeral, trithemimeral
σὸν γένος· οὔ οἱ ἀεικὲς ἀνασσέμεν Ἀργείοισιν.	- uu - u u-u u-uu ----	dactylic hexameter	feminine penthemimeral, trithemimeral
ὣς φάτο, τὸν δ’ἄχος ὀξὺ κατὰ φρένα τύψε βαθεῖαν·	- uu - uu -u u- uu -u u--	dactylic hexameter	feminine penthemimeral, hepthemimeral, trithemimeral
αὐτίκα δ’εἷλ’ Ἄτην κεφαλῆς λιπαροπλοκάμοιο	-uu - -- uu- uu-uu--	dactylic hexameter	masculine penthemimeral, hepthemimeral, trithemimeral
χωόμενος φρεσὶν ᾗσι, καὶ ὤμοσε καρτερὸν ὅρκον	-uu- uu -u u -uu -uu --	dactylic hexameter	feminine penthemimeral, trithemimeral
μή ποτ’ ἐς Οὔλυμπόν τε καὶ οὐρανὸν ἀστερόεντα	- u u --- u u -uu -uu--	dactylic hexameter	masculine penthemimeral
αὖτις ἐλεύσεσθαι Ἄτην, ἣ πάντας ἀᾶται.	-u u--- -- - -u u--	dactylic hexameter	masculine penthemimeral, hepthemimeral
ὣς εἰπὼν ἔρριψεν ἀπ’ οὐρανοῦ ἀστερόεντος	- -- --u u -uu -uu--	dactylic hexameter	feminine penthemimeral, trithemimeral
χειρὶ περιστρέψας· τάχα δ’ἵκετο ἔργ’ ἀνθρώπων.	-u u--- uu -uu - ---	dactylic hexameter	masculine penthemimeral
τὴν αἰεὶ στενάχεσχ’ ὅθ’ ἑὸν φίλον υἱὸν ὁρῷτο	- -- uu- u u- uu -u u--	dactylic hexameter	masculine penthemimeral, hepthemimeral, trithemimeral
ἔργον ἀεικὲς ἔχοντα ὑπ’ Εὐρυσθῆος ἀέθλων.	-u u-u u-u u ---u u--	dactylic hexameter	feminine penthemimeral
ὣς καὶ ἐγών, ὅτε δ’αὖτε μέγας κορυθαίολος Ἕκτωρ	- u u- uu -u u- uu-uu --	dactylic hexameter	feminine penthemimeral, hepthemimeral, trithemimeral
Ἀργείους ὀλέκεσκεν ἐπὶ πρυμνῇσι νέεσσιν,	--- uu-u u- --u u--	dactylic hexameter	feminine penthemimeral, hepthemimeral, trithemimeral
οὐ δυνάμην λελαθέσθ’ Ἄτης ᾗ πρῶτον ἀάσθην.	- uu- uu- -- - -u u--	dactylic hexameter	masculine penthemimeral, hepthemimeral, trithemimeral
ἀλλ’ ἐπεὶ ἀασάμην καί μευ φρένας ἐξέλετο Ζεύς,	- uu -uu- - - uu -uu- -	dactylic hexameter	masculine penthemimeral, hepthemimeral
ἂψ ἐθέλω ἀρέσαι, δόμεναί τ’ἀπερείσι’ ἄποινα·	- uu- uu- uu- uu-u u--	dactylic hexameter	masculine penthemimeral, hepthemimeral, trithemimeral
ἀλλ’ ὄρσευ πόλεμον δὲ καὶ ἄλλους ὄρνυθι λαούς.	- -- uu- u u -- -uu --	dactylic hexameter	masculine penthemimeral, trithemimeral
δῶρα δ’ἐγὼν ὅδε πάντα παρασχέμεν ὅσσά τοι ἐλθὼν	-u u- uu -u u-uu -u u --	dactylic hexameter	feminine penthemimeral, trithemimeral
χθιζὸς ἐνὶ κλισίῃσιν ὑπέσχετο δῖος Ὀδυσσεύς.	-u u- uu-u u-uu -u u--	dactylic hexameter	feminine penthemimeral, trithemimeral
εἰ δ’ἐθέλεις, ἐπίμεινον ἐπειγόμενός περ Ἄρηος,	- uu- uu-u u-uu- u u--	dactylic hexameter	feminine penthemimeral, trithemimeral
δῶρα δέ τοι θεράποντες ἐμῆς παρὰ νηὸς ἑλόντες	-u u - uu-u u- uu -u u--	dactylic hexameter	feminine penthemimeral, hepthemimeral, trithemimeral
οἴσουσ’, ὄφρα ἴδηαι ὅ τοι μενοεικέα δώσω.	-- -u u-u u - uu-uu --	dactylic hexameter	feminine penthemimeral, hepthemimeral
τὸν δ’ἀπαμειβόμενος προσέφη πόδας ὠκὺς Ἀχιλλεύς·	- uu-uu- uu- uu -u u--	dactylic hexameter	masculine penthemimeral, hepthemimeral
Ἀτρεΐδη κύδιστε ἄναξ ἀνδρῶν Ἀγάμεμνον	-uu- --u u- -- uu--	dactylic hexameter	feminine penthemimeral, hepthemimeral, trithemimeral
δῶρα μὲν αἴ κ’ἐθέλῃσθα παρασχέμεν, ὡς ἐπιεικές,	-u u - uu-u u-uu - uu--	dactylic hexameter	feminine penthemimeral, trithemimeral
ἤ τ’ἐχέμεν παρὰ σοί· νῦν δὲ μνησώμεθα χάρμης	- uu- uu - - - --uu --	dactylic hexameter	masculine penthemimeral, hepthemimeral, trithemimeral
αἶψα μάλ’· οὐ γὰρ χρὴ κλοτοπεύειν ἐνθάδ’ ἐόντας	-u u - - - uu-- -u u--	dactylic hexameter	masculine penthemimeral, trithemimeral
οὐδὲ διατρίβειν· ἔτι γὰρ μέγα ἔργον ἄρεκτον·	-u u--- uu - uu -u u--	dactylic hexameter	masculine penthemimeral, hepthemimeral
ὥς κέ τις αὖτ’ Ἀχιλῆα μετὰ πρώτοισιν ἴδηται	- u u - uu-u u- --u u--	dactylic hexameter	feminine penthemimeral, hepthemimeral, trithemimeral
ἔγχεϊ χαλκείῳ Τρώων ὀλέκοντα φάλαγγας.	-uu --- -- uu-u u--	dactylic hexameter	masculine penthemimeral, hepthemimeral
ὧδέ τις ὑμείων μεμνημένος ἀνδρὶ μαχέσθω.	-u u --- --uu -u u--	dactylic hexameter	masculine penthemimeral
τὸν δ’ἀπαμειβόμενος προσέφη πολύμητις Ὀδυσσεύς·	- uu-uu- uu- uu-u u--	dactylic hexameter	masculine penthemimeral, hepthemimeral
μὴ δ’οὕτως, ἀγαθός περ ἐών, θεοείκελ’ Ἀχιλλεῦ	- -- uu- u u- uu-u u--	dactylic hexameter	masculine penthemimeral, hepthemimeral, trithemimeral
νήστιας ὄτρυνε προτὶ Ἴλιον υἷας Ἀχαιῶν	-uu --- uu -uu -u u--	dactylic hexameter	masculine penthemimeral
Τρωσὶ μαχησομένους, ἐπεὶ οὐκ ὀλίγον χρόνον ἔσται	-u u-uu- uu - uu- uu --	dactylic hexameter	masculine penthemimeral, hepthemimeral
φύλοπις, εὖτ’ ἂν πρῶτον ὁμιλήσωσι φάλαγγες	-uu - - -u u---u u--	dactylic hexameter	feminine penthemimeral, trithemimeral
ἀνδρῶν, ἐν δὲ θεὸς πνεύσῃ μένος ἀμφοτέροισιν.	-- - u u- -- uu -uu--	dactylic hexameter	masculine penthemimeral, hepthemimeral, trithemimeral
ἀλλὰ πάσασθαι ἄνωχθι θοῇς ἐπὶ νηυσὶν Ἀχαιοὺς	-u u-u u-u u- uu -u u--	dactylic hexameter	feminine penthemimeral, hepthemimeral
σίτου καὶ οἴνοιο· τὸ γὰρ μένος ἐστὶ καὶ ἀλκή.	-- - --u u - uu -u u --	dactylic hexameter	feminine penthemimeral, hepthemimeral, trithemimeral
οὐ γὰρ ἀνὴρ πρόπαν ἦμαρ ἐς ἠέλιον καταδύντα	- u u- uu -u u -uu- uu--	dactylic hexameter	feminine penthemimeral, trithemimeral
ἄκμηνος σίτοιο δυνήσεται ἄντα μάχεσθαι·	--- --u u-uu -u u--	dactylic hexameter	feminine penthemimeral, trithemimeral
εἴ περ γὰρ θυμῷ γε μενοινάᾳ πολεμίζειν,	- - - -- u u--- uu--	dactylic hexameter	masculine penthemimeral, trithemimeral
ἀλλά τε λάθρῃ γυῖα βαρύνεται, ἠδὲ κιχάνει	-u u -- -u u-uu -u u--	dactylic hexameter	feminine penthemimeral
δίψά τε καὶ λιμός, βλάβεται δέ τε γούνατ’ ἰόντι.	-u u - -- uu- u u -u u--	dactylic hexameter	masculine penthemimeral, hepthemimeral, trithemimeral
ὃς δέ κ’ἀνὴρ οἴνοιο κορεσσάμενος καὶ ἐδωδῆς	- u u- --u u-uu- u u--	dactylic hexameter	feminine penthemimeral, trithemimeral
ἀνδράσι δυσμενέεσσι πανημέριος πολεμίζῃ,	-uu -uu-u u-uu- uu--	dactylic hexameter	feminine penthemimeral
θαρσαλέον νύ οἱ ἦτορ ἐνὶ φρεσίν, οὐδέ τι γυῖα	-uu- u u -u u- uu -u u --	dactylic hexameter	feminine penthemimeral, hepthemimeral, trithemimeral
πρὶν κάμνει πρὶν πάντας ἐρωῆσαι πολέμοιο.	- -- - -u u--- uu--	dactylic hexameter	feminine penthemimeral, trithemimeral
ἀλλ’ ἄγε λαὸν μὲν σκέδασον καὶ δεῖπνον ἄνωχθι	- uu -- - uu- - -u u--	dactylic hexameter	masculine penthemimeral, hepthemimeral
ὅπλεσθαι· τὰ δὲ δῶρα ἄναξ ἀνδρῶν Ἀγαμέμνων	--- u u -u u- -- uu--	dactylic hexameter	feminine penthemimeral, hepthemimeral, trithemimeral
οἰσέτω ἐς μέσσην ἀγορήν, ἵνα πάντες Ἀχαιοὶ	-uu - -- uu- uu -u u--	dactylic hexameter	masculine penthemimeral, hepthemimeral, trithemimeral
ὀφθαλμοῖσιν ἴδωσι, σὺ δὲ φρεσὶ σῇσιν ἰανθῇς.	---u u-u u - uu -u u--	dactylic hexameter	feminine penthemimeral, hepthemimeral
ὀμνυέτω δέ τοι ὅρκον ἐν Ἀργείοισιν ἀναστὰς	-uu- u u -u u ---u u--	dactylic hexameter	feminine penthemimeral, trithemimeral
μή ποτε τῆς εὐνῆς ἐπιβήμεναι ἠδὲ μιγῆναι·	- uu - -- uu-uu -u u--	dactylic hexameter	masculine penthemimeral, trithemimeral
ἣ θέμις ἐστὶν ἄναξ ἤ τ’ἀνδρῶν ἤ τε γυναικῶν·	- uu -u u- - -- - u u--	dactylic hexameter	masculine penthemimeral
καὶ δὲ σοὶ αὐτῷ θυμὸς ἐνὶ φρεσὶν ἵλαος ἔστω.	- u u -- -u u- uu -uu --	dactylic hexameter	feminine penthemimeral, hepthemimeral
αὐτὰρ ἔπειτά σε δαιτὶ ἐνὶ κλισίῃς ἀρεσάσθω	-u u-u u -u u- uu- uu--	dactylic hexameter	feminine penthemimeral, hepthemimeral
πιείρῃ, ἵνα μή τι δίκης ἐπιδευὲς ἔχῃσθα.	--- uu - u u- uu-u u--	dactylic hexameter	masculine penthemimeral, hepthemimeral, trithemimeral
Ἀτρεΐδη σὺ δ’ἔπειτα δικαιότερος καὶ ἐπ’ ἄλλῳ	-uu- u u-u u-uu- u u --	dactylic hexameter	feminine penthemimeral, trithemimeral
ἔσσεαι. οὐ μὲν γάρ τι νεμεσσητὸν βασιλῆα	-uu - - - u u--- uu--	dactylic hexameter	masculine penthemimeral, trithemimeral
ἄνδρ’ ἀπαρέσσασθαι ὅτε τις πρότερος χαλεπήνῃ.	- uu--- uu - uu- uu--	dactylic hexameter	masculine penthemimeral, hepthemimeral
τὸν δ’αὖτε προσέειπεν ἄναξ ἀνδρῶν Ἀγαμέμνων·	- -- uu-u u- -- uu--	dactylic hexameter	feminine penthemimeral, hepthemimeral, trithemimeral
χαίρω σεῦ Λαερτιάδη τὸν μῦθον ἀκούσας·	-- - --uu- - -u u--	dactylic hexameter	hepthemimeral, trithemimeral
ἐν μοίρῃ γὰρ πάντα διίκεο καὶ κατέλεξας.	- -- - -u u-uu - uu--	dactylic hexameter	feminine penthemimeral, trithemimeral
ταῦτα δ’ἐγὼν ἐθέλω ὀμόσαι, κέλεται δέ με θυμός,	-u u- uu- uu- uu- u u --	dactylic hexameter	masculine penthemimeral, hepthemimeral, trithemimeral
οὐδ’ ἐπιορκήσω πρὸς δαίμονος. αὐτὰρ Ἀχιλλεὺς	- uu--- - -uu -u u--	dactylic hexameter	masculine penthemimeral
μιμνέτω αὐτόθι τεῖος ἐπειγόμενός περ Ἄρηος·	-uu -uu -u u-uu- u u--	dactylic hexameter	feminine penthemimeral
μίμνετε δ’ἄλλοι πάντες ἀολλέες, ὄφρά κε δῶρα	-uu -- -u u-uu -u u --	dactylic hexameter	feminine penthemimeral
ἐκ κλισίης ἔλθῃσι καὶ ὅρκια πιστὰ τάμωμεν.	- uu- --u u -uu -u u--	dactylic hexameter	feminine penthemimeral, trithemimeral
σοὶ δ’αὐτῷ τόδ’ ἐγὼν ἐπιτέλλομαι ἠδὲ κελεύω·	- -- u u- uu-uu -u u--	dactylic hexameter	masculine penthemimeral, trithemimeral
κρινάμενος κούρητας ἀριστῆας Παναχαιῶν	-uu- --u u--- uu--	dactylic hexameter	feminine penthemimeral, trithemimeral
δῶρα ἐμῆς παρὰ νηὸς ἐνεικέμεν, ὅσσ’ Ἀχιλῆϊ	-u u- uu -u u-uu - uu--	dactylic hexameter	feminine penthemimeral, trithemimeral
χθιζὸν ὑπέστημεν δώσειν, ἀγέμεν τε γυναῖκας.	-u u--- -- uu- u u--	dactylic hexameter	masculine penthemimeral, hepthemimeral
Ταλθύβιος δέ μοι ὦκα κατὰ στρατὸν εὐρὺν Ἀχαιῶν	-uu- u u -u u- uu -u u--	dactylic hexameter	feminine penthemimeral, hepthemimeral, trithemimeral
κάπρον ἑτοιμασάτω ταμέειν Διί τ’Ἠελίῳ τε.	-u u-uu- uu- uu -uu- -	dactylic hexameter	masculine penthemimeral, hepthemimeral
τὸν δ’ἀπαμειβόμενος προσέφη πόδας ὠκὺς Ἀχιλλεύς·	- uu-uu- uu- uu -u u--	dactylic hexameter	masculine penthemimeral, hepthemimeral
Ἀτρεΐδη κύδιστε ἄναξ ἀνδρῶν Ἀγάμεμνον	-uu- --u u- -- uu--	dactylic hexameter	feminine penthemimeral, hepthemimeral, trithemimeral
ἄλλοτέ περ καὶ μᾶλλον ὀφέλλετε ταῦτα πένεσθαι,	-uu - - -u u-uu -u u--	dactylic hexameter	feminine penthemimeral, trithemimeral
ὁππότε τις μεταπαυσωλὴ πολέμοιο γένηται	-uu - uu--- uu-u u--	dactylic hexameter	hepthemimeral, trithemimeral
καὶ μένος οὐ τόσον ᾖσιν ἐνὶ στήθεσσιν ἐμοῖσι.	- uu - uu -u u- --u u--	dactylic hexameter	feminine penthemimeral, hepthemimeral, trithemimeral
νῦν δ’οἳ μὲν κέαται δεδαϊγμένοι, οὓς ἐδάμασσεν	- - - uu- uu-uu - uu--	dactylic hexameter	masculine penthemimeral, trithemimeral
Ἕκτωρ Πριαμίδης, ὅτε οἱ Ζεὺς κῦδος ἔδωκεν,	-- -uu- uu - - -u u--	dactylic hexameter	masculine penthemimeral, hepthemimeral
ὑμεῖς δ’ἐς βρωτὺν ὀτρύνετον· ἦ τ’ἂν ἔγωγε	-- - -- --uu - u u--	dactylic hexameter	masculine penthemimeral, trithemimeral
νῦν μὲν ἀνώγοιμι πτολεμίζειν υἷας Ἀχαιῶν	- u u--- uu-- -u u--	dactylic hexameter	masculine penthemimeral
νήστιας ἀκμήνους, ἅμα δ’ἠελίῳ καταδύντι	-uu --- uu -uu- uu--	dactylic hexameter	masculine penthemimeral
τεύξεσθαι μέγα δόρπον, ἐπὴν τεισαίμεθα λώβην.	--- uu -u u- --uu --	dactylic hexameter	feminine penthemimeral, hepthemimeral, trithemimeral
πρὶν δ’οὔ πως ἂν ἔμοιγε φίλον κατὰ λαιμὸν ἰείη	- - - u u-u u- uu -u u--	dactylic hexameter	feminine penthemimeral, hepthemimeral, trithemimeral
οὐ πόσις οὐδὲ βρῶσις ἑταίρου τεθνηῶτος	- uu -- -u u-- ----	dactylic hexameter	feminine penthemimeral
ὅς μοι ἐνὶ κλισίῃ δεδαϊγμένος ὀξέϊ χαλκῷ	- u u- uu- uu-uu -uu --	dactylic hexameter	masculine penthemimeral, trithemimeral
κεῖται ἀνὰ πρόθυρον τετραμμένος, ἀμφὶ δ’ἑταῖροι	-u u- uu- --uu -u u--	dactylic hexameter	masculine penthemimeral, trithemimeral
μύρονται· τό μοι οὔ τι μετὰ φρεσὶ ταῦτα μέμηλεν,	--- u u - u u- uu -u u--	dactylic hexameter	masculine penthemimeral, hepthemimeral, trithemimeral
ἀλλὰ φόνος τε καὶ αἷμα καὶ ἀργαλέος στόνος ἀνδρῶν.	-u u- u u -u u -uu- uu --	dactylic hexameter	feminine penthemimeral, trithemimeral
τὸν δ’ἀπαμειβόμενος προσέφη πολύμητις Ὀδυσσεύς·	- uu-uu- uu- uu-u u--	dactylic hexameter	masculine penthemimeral, hepthemimeral
ὦ Ἀχιλεῦ Πηλῆος υἱὲ μέγα φέρτατ’ Ἀχαιῶν,	- uu- -- -- uu -u u--	dactylic hexameter	masculine penthemimeral, hepthemimeral, trithemimeral
κρείσσων εἰς ἐμέθεν καὶ φέρτερος οὐκ ὀλίγον περ	-- - uu- - -uu - uu- -	dactylic hexameter	masculine penthemimeral, trithemimeral
ἔγχει, ἐγὼ δέ κε σεῖο νοήματί γε προβαλοίμην	-u u- u u -u u-uu - uu--	dactylic hexameter	feminine penthemimeral, trithemimeral
πολλόν, ἐπεὶ πρότερος γενόμην καὶ πλείονα οἶδα.	-u u- uu- uu- - -uu --	dactylic hexameter	masculine penthemimeral, hepthemimeral, trithemimeral
τώ τοι ἐπιτλήτω κραδίη μύθοισιν ἐμοῖσιν.	- u u--- uu- --u u--	dactylic hexameter	masculine penthemimeral, hepthemimeral
αἶψά τε φυλόπιδος πέλεται κόρος ἀνθρώποισιν,	-u u -uu- uu- uu ----	dactylic hexameter	masculine penthemimeral, hepthemimeral
ἧς τε πλείστην μὲν καλάμην χθονὶ χαλκὸς ἔχευεν,	- - -- - uu- uu -u u--	dactylic hexameter	masculine penthemimeral, hepthemimeral
ἄμητος δ’ὀλίγιστος, ἐπὴν κλίνῃσι τάλαντα	--- uu-u u- --u u--	dactylic hexameter	feminine penthemimeral, hepthemimeral, trithemimeral
Ζεύς, ὅς τ’ἀνθρώπων ταμίης πολέμοιο τέτυκται.	- - --- uu- uu-u u--	dactylic hexameter	masculine penthemimeral, hepthemimeral
γαστέρι δ’οὔ πως ἔστι νέκυν πενθῆσαι Ἀχαιούς·	-uu - - -u u- --u u--	dactylic hexameter	feminine penthemimeral, hepthemimeral, trithemimeral
λίην γὰρ πολλοὶ καὶ ἐπήτριμοι ἤματα πάντα	-- - -- u u-uu -uu --	dactylic hexameter	masculine penthemimeral, trithemimeral
πίπτουσιν· πότε κέν τις ἀναπνεύσειε πόνοιο;	--- uu - u u---u u--	dactylic hexameter	masculine penthemimeral, trithemimeral
ἀλλὰ χρὴ τὸν μὲν καταθάπτειν ὅς κε θάνῃσι	-- - - - uu-- - u u--	dactylic hexameter	masculine penthemimeral, trithemimeral
νηλέα θυμὸν ἔχοντας ἐπ’ ἤματι δακρύσαντας·	-uu -u u-u u -uu ----	dactylic hexameter	feminine penthemimeral
ὅσσοι δ’ἂν πολέμοιο περὶ στυγεροῖο λίπωνται	-- - uu-u u- uu-u u--	dactylic hexameter	feminine penthemimeral, hepthemimeral, trithemimeral
μεμνῆσθαι πόσιος καὶ ἐδητύος, ὄφρ’ ἔτι μᾶλλον	--- uu- u u-uu - uu --	dactylic hexameter	masculine penthemimeral, trithemimeral
ἀνδράσι δυσμενέεσσι μαχώμεθα νωλεμὲς αἰεὶ	-uu -uu-u u-uu -uu --	dactylic hexameter	feminine penthemimeral
ἑσσάμενοι χροῒ χαλκὸν ἀτειρέα. μηδέ τις ἄλλην	-uu- uu -u u-uu -u u --	dactylic hexameter	feminine penthemimeral, trithemimeral
λαῶν ὀτρυντὺν ποτιδέγμενος ἰσχαναάσθω·	-- --- uu-uu -uu--	dactylic hexameter	masculine penthemimeral
ἥδε γὰρ ὀτρυντὺς κακὸν ἔσσεται ὅς κε λίπηται	-u u --- uu -uu - u u--	dactylic hexameter	masculine penthemimeral
νηυσὶν ἐπ’ Ἀργείων· ἀλλ’ ἀθρόοι ὁρμηθέντες	-u u --- - -uu ----	dactylic hexameter	masculine penthemimeral
Τρωσὶν ἐφ’ ἱπποδάμοισιν ἐγείρομεν ὀξὺν Ἄρηα.	-u u -uu-u u-uu -u u--	dactylic hexameter	feminine penthemimeral
ἦ, καὶ Νέστορος υἷας ὀπάσσατο κυδαλίμοιο	- - -uu -u u-uu -uu--	dactylic hexameter	feminine penthemimeral
Φυλεΐδην τε Μέγητα Θόαντά τε Μηριόνην τε	-uu- u u-u u-u u -uu- -	dactylic hexameter	feminine penthemimeral, trithemimeral
καὶ Κρειοντιάδην Λυκομήδεα καὶ Μελάνιππον·	- --uu- uu-uu - uu--	dactylic hexameter	masculine penthemimeral
βὰν δ’ἴμεν ἐς κλισίην Ἀγαμέμνονος Ἀτρεΐδαο.	- uu - uu- uu-uu -uu--	dactylic hexameter	masculine penthemimeral, trithemimeral
αὐτίκ’ ἔπειθ’ ἅμα μῦθος ἔην, τετέλεστο δὲ ἔργον·	-u u- uu -u u- uu-u u --	dactylic hexameter	feminine penthemimeral, hepthemimeral, trithemimeral
ἑπτὰ μὲν ἐκ κλισίης τρίποδας φέρον, οὕς οἱ ὑπέστη,	-u u - uu- uu- uu - u u--	dactylic hexameter	masculine penthemimeral, hepthemimeral, trithemimeral
αἴθωνας δὲ λέβητας ἐείκοσι, δώδεκα δ’ἵππους·	--- u u-u u-uu -uu --	dactylic hexameter	feminine penthemimeral, trithemimeral
ἐκ δ’ἄγον αἶψα γυναῖκας ἀμύμονα ἔργα ἰδυίας	- uu -u u-u u-uu -u u--	dactylic hexameter	feminine penthemimeral
ἕπτ’, ἀτὰρ ὀγδοάτην Βρισηΐδα καλλιπάρῃον.	- uu -uu- --uu -uu--	dactylic hexameter	masculine penthemimeral
χρυσοῦ δὲ στήσας Ὀδυσεὺς δέκα πάντα τάλαντα	-- - -- uu- uu -u u--	dactylic hexameter	masculine penthemimeral, hepthemimeral, trithemimeral
ἦρχ’, ἅμα δ’ἄλλοι δῶρα φέρον κούρητες Ἀχαιῶν.	- uu -- -u u- --u u--	dactylic hexameter	feminine penthemimeral, hepthemimeral
καὶ τὰ μὲν ἐν μέσσῃ ἀγορῇ θέσαν, ἂν δ’Ἀγαμέμνων	- u u - -- uu- uu - uu--	dactylic hexameter	masculine penthemimeral, hepthemimeral, trithemimeral
ἵστατο· Ταλθύβιος δὲ θεῷ ἐναλίγκιος αὐδὴν	-uu -uu- u u- uu-uu --	dactylic hexameter	masculine penthemimeral, hepthemimeral
κάπρον ἔχων ἐν χερσὶ παρίστατο ποιμένι λαῶν.	-u u- - -u u-uu -uu --	dactylic hexameter	feminine penthemimeral, trithemimeral
Ἀτρεΐδης δὲ ἐρυσσάμενος χείρεσσι μάχαιραν,	-uu- u u-uu- --u u--	dactylic hexameter	hepthemimeral, trithemimeral
ἥ οἱ πὰρ ξίφεος μέγα κουλεὸν αἰὲν ἄωρτο,	- - - uu- uu -uu -u u--	dactylic hexameter	masculine penthemimeral, trithemimeral
κάπρου ἀπὸ τρίχας ἀρξάμενος Διὶ χεῖρας ἀνασχὼν	-u u- uu -uu- uu -u u--	dactylic hexameter	hepthemimeral, trithemimeral
εὔχετο· τοὶ δ’ἄρα πάντες ἐπ’ αὐτόφιν εἵατο σιγῇ	-uu - uu -u u -uu -uu --	dactylic hexameter	feminine penthemimeral, trithemimeral
Ἀργεῖοι κατὰ μοῖραν ἀκούοντες βασιλῆος.	--- uu -u u--- uu--	dactylic hexameter	feminine penthemimeral, trithemimeral
εὐξάμενος δ’ἄρα εἶπεν ἰδὼν εἰς οὐρανὸν εὐρύν·	-uu- uu -u u- - -uu --	dactylic hexameter	feminine penthemimeral, hepthemimeral, trithemimeral
ἴστω νῦν Ζεὺς πρῶτα θεῶν ὕπατος καὶ ἄριστος	-- - - -u u- uu- u u--	dactylic hexameter	feminine penthemimeral, hepthemimeral, trithemimeral
Γῆ τε καὶ Ἠέλιος καὶ Ἐρινύες, αἵ θ’ὑπὸ γαῖαν	- u u -uu- u u-uu - uu --	dactylic hexameter	masculine penthemimeral
ἀνθρώπους τίνυνται, ὅτις κ’ἐπίορκον ὀμόσσῃ,	--- --u u- uu-u u--	dactylic hexameter	feminine penthemimeral, hepthemimeral, trithemimeral
μὴ μὲν ἐγὼ κούρῃ Βρισηΐδι χεῖρ’ ἐπένεικα,	- u u- -- --uu - uu--	dactylic hexameter	masculine penthemimeral, trithemimeral
οὔτ’ εὐνῆς πρόφασιν κεχρημένος οὔτέ τευ ἄλλου.	- -- uu- --uu -u u --	dactylic hexameter	masculine penthemimeral, trithemimeral
ἀλλ’ ἔμεν’ ἀπροτίμαστος ἐνὶ κλισίῃσιν ἐμῇσιν.	- uu -uu-u u- uu-u u--	dactylic hexameter	feminine penthemimeral, hepthemimeral
εἰ δέ τι τῶνδ’ ἐπίορκον ἐμοὶ θεοὶ ἄλγεα δοῖεν	- u u - uu-u u- uu -uu --	dactylic hexameter	feminine penthemimeral, hepthemimeral, trithemimeral
πολλὰ μάλ’, ὅσσα διδοῦσιν ὅτίς σφ’ἀλίτηται ὀμόσσας.	-u u -u u-u u- uu-u u--	dactylic hexameter	feminine penthemimeral, hepthemimeral
ἦ, καὶ ἀπὸ στόμαχον κάπρου τάμε νηλέϊ χαλκῷ.	- u u- uu- -- uu -uu --	dactylic hexameter	masculine penthemimeral, hepthemimeral, trithemimeral
τὸν μὲν Ταλθύβιος πολιῆς ἁλὸς ἐς μέγα λαῖτμα	- - -uu- uu- uu - uu --	dactylic hexameter	masculine penthemimeral, hepthemimeral
ῥῖψ’ ἐπιδινήσας βόσιν ἰχθύσιν· αὐτὰρ Ἀχιλλεὺς	- uu--- uu -uu -u u--	dactylic hexameter	masculine penthemimeral
ἀνστὰς Ἀργείοισι φιλοπτολέμοισι μετηύδα·	-- ---u u-uu-u u--	dactylic hexameter	feminine penthemimeral
Ζεῦ πάτερ ἦ μεγάλας ἄτας ἄνδρεσσι διδοῖσθα·	- uu - uu- -- --u u--	dactylic hexameter	masculine penthemimeral, hepthemimeral, trithemimeral
οὐκ ἂν δή ποτε θυμὸν ἐνὶ στήθεσσιν ἐμοῖσιν	- - - uu -u u- --u u--	dactylic hexameter	feminine penthemimeral, hepthemimeral, trithemimeral
Ἀτρεΐδης ὤρινε διαμπερές, οὐδέ κε κούρην	-uu- --u u-uu -u u --	dactylic hexameter	feminine penthemimeral, trithemimeral
ἦγεν ἐμεῦ ἀέκοντος ἀμήχανος· ἀλλά ποθι Ζεὺς	-u u- uu-u u-uu -u u- -	dactylic hexameter	feminine penthemimeral, trithemimeral
ἤθελ’ Ἀχαιοῖσιν θάνατον πολέεσσι γενέσθαι.	-u u--- uu- uu-u u--	dactylic hexameter	masculine penthemimeral, hepthemimeral
νῦν δ’ἔρχεσθ’ ἐπὶ δεῖπνον, ἵνα ξυνάγωμεν Ἄρηα.	- -- uu -u u- uu-u u--	dactylic hexameter	feminine penthemimeral, hepthemimeral, trithemimeral
ὣς ἄρ’ ἐφώνησεν, λῦσεν δ’ἀγορὴν αἰψηρήν.	- u u--- -- uu- ---	dactylic hexameter	masculine penthemimeral, hepthemimeral
οἳ μὲν ἄρ’ ἐσκίδναντο ἑὴν ἐπὶ νῆα ἕκαστος,	- u u ---u u- uu -u u--	dactylic hexameter	feminine penthemimeral, hepthemimeral
δῶρα δὲ Μυρμιδόνες μεγαλήτορες ἀμφεπένοντο,	-u u -uu- uu-uu -uu--	dactylic hexameter	masculine penthemimeral
βὰν δ’ἐπὶ νῆα φέροντες Ἀχιλλῆος θείοιο.	- uu -u u-u u--- ---	dactylic hexameter	feminine penthemimeral
καὶ τὰ μὲν ἐν κλισίῃσι θέσαν, κάθισαν δὲ γυναῖκας,	- u u - uu-u u- uu- u u--	dactylic hexameter	feminine penthemimeral, hepthemimeral, trithemimeral
ἵππους δ’εἰς ἀγέλην ἔλασαν θεράποντες ἀγαυοί.	-- - uu- uu- uu-u u--	dactylic hexameter	masculine penthemimeral, hepthemimeral, trithemimeral
Βρισηῒς δ’ἄρ’ ἔπειτ’ ἰκέλη χρυσέῃ Ἀφροδίτῃ	--- u u- uu- uu- uu--	dactylic hexameter	masculine penthemimeral, hepthemimeral, trithemimeral
ὡς ἴδε Πάτροκλον δεδαϊγμένον ὀξέϊ χαλκῷ,	- uu --- uu-uu -uu --	dactylic hexameter	masculine penthemimeral
ἀμφ’ αὐτῷ χυμένη λίγ’ ἐκώκυε, χερσὶ δ’ἄμυσσε	- -- uu- u u-uu -u u--	dactylic hexameter	masculine penthemimeral, trithemimeral
στήθεά τ’ἠδ’ ἁπαλὴν δειρὴν ἰδὲ καλὰ πρόσωπα.	-uu - uu- -- uu -u u--	dactylic hexameter	masculine penthemimeral, hepthemimeral, trithemimeral
εἶπε δ’ἄρα κλαίουσα γυνὴ ἐϊκυῖα θεῇσι·	-u u- --u u- uu-u u--	dactylic hexameter	feminine penthemimeral, hepthemimeral, trithemimeral
Πάτροκλέ μοι δειλῇ πλεῖστον κεχαρισμένε θυμῷ	-uu - -- -- uu-uu --	dactylic hexameter	masculine penthemimeral, hepthemimeral, trithemimeral
ζωὸν μέν σε ἔλειπον ἐγὼ κλισίηθεν ἰοῦσα,	-- - u u-u u- uu-u u--	dactylic hexameter	feminine penthemimeral, hepthemimeral, trithemimeral
νῦν δέ σε τεθνηῶτα κιχάνομαι ὄρχαμε λαῶν	- u u ---u u-uu -uu --	dactylic hexameter	feminine penthemimeral
ἂψ ἀνιοῦσ’· ὥς μοι δέχεται κακὸν ἐκ κακοῦ αἰεί.	- uu- - - uu- uu - uu --	dactylic hexameter	masculine penthemimeral, hepthemimeral, trithemimeral
ἄνδρα μὲν ᾧ ἔδοσάν με πατὴρ καὶ πότνια μήτηρ	-u u - uu- u u- - -uu --	dactylic hexameter	masculine penthemimeral, hepthemimeral, trithemimeral
εἶδον πρὸ πτόλιος δεδαϊγμένον ὀξέϊ χαλκῷ,	-- - uu- uu-uu -uu --	dactylic hexameter	masculine penthemimeral, trithemimeral
τρεῖς τε κασιγνήτους, τούς μοι μία γείνατο μήτηρ,	- u u--- - - uu -uu --	dactylic hexameter	masculine penthemimeral, hepthemimeral
κηδείους, οἳ πάντες ὀλέθριον ἦμαρ ἐπέσπον.	--- - -u u-uu -u u--	dactylic hexameter	feminine penthemimeral, trithemimeral
οὐδὲ μὲν οὐδέ μ’ἔασκες, ὅτ’ ἄνδρ’ ἐμὸν ὠκὺς Ἀχιλλεὺς	-u u -u u-u u - uu -u u--	dactylic hexameter	feminine penthemimeral, hepthemimeral
ἔκτεινεν, πέρσεν δὲ πόλιν θείοιο Μύνητος,	--- -- u u- --u u--	dactylic hexameter	masculine penthemimeral, hepthemimeral, trithemimeral
κλαίειν, ἀλλά μ’ἔφασκες Ἀχιλλῆος θείοιο	-- -u u-u u--- ---	dactylic hexameter	feminine penthemimeral
κουριδίην ἄλοχον θήσειν, ἄξειν τ’ἐνὶ νηυσὶν	-uu- uu- -- -- uu --	dactylic hexameter	masculine penthemimeral, hepthemimeral, trithemimeral
ἐς Φθίην, δαίσειν δὲ γάμον μετὰ Μυρμιδόνεσσι.	- -- -- u u- uu -uu--	dactylic hexameter	masculine penthemimeral, hepthemimeral, trithemimeral
τώ σ’ἄμοτον κλαίω τεθνηότα μείλιχον αἰεί.	- uu- -- --uu -uu --	dactylic hexameter	masculine penthemimeral, trithemimeral
ὣς ἔφατο κλαίουσ’, ἐπὶ δὲ στενάχοντο γυναῖκες	- uu- -- uu - uu-u u--	dactylic hexameter	masculine penthemimeral, hepthemimeral, trithemimeral
Πάτροκλον πρόφασιν, σφῶν δ’αὐτῶν κήδε’ ἑκάστη.	--- uu- - -- -u u--	dactylic hexameter	masculine penthemimeral, trithemimeral
αὐτὸν δ’ἀμφὶ γέροντες Ἀχαιῶν ἠγερέθοντο	-- -u u-u u-- -uu--	dactylic hexameter	feminine penthemimeral
λισσόμενοι δειπνῆσαι· ὃ δ’ἠρνεῖτο στεναχίζων·	-uu- --u u --- uu--	dactylic hexameter	feminine penthemimeral, trithemimeral
λίσσομαι, εἴ τις ἔμοιγε φίλων ἐπιπείθεθ’ ἑταίρων,	-uu - u u-u u- uu-u u--	dactylic hexameter	feminine penthemimeral, hepthemimeral, trithemimeral
μή με πρὶν σίτοιο κελεύετε μηδὲ ποτῆτος	- - - --u u-uu -u u--	dactylic hexameter	feminine penthemimeral, trithemimeral
ἄσασθαι φίλον ἦτορ, ἐπεί μ’ἄχος αἰνὸν ἱκάνει·	--- uu -u u- uu -u u--	dactylic hexameter	feminine penthemimeral, hepthemimeral, trithemimeral
δύντα δ’ἐς ἠέλιον μενέω καὶ τλήσομαι ἔμπης.	-u u -uu- uu- - -uu --	dactylic hexameter	masculine penthemimeral, hepthemimeral
ὣς εἰπὼν ἄλλους μὲν ἀπεσκέδασεν βασιλῆας,	- -- -- u u-uu- uu--	dactylic hexameter	masculine penthemimeral, trithemimeral
δοιὼ δ’Ἀτρεΐδα μενέτην καὶ δῖος Ὀδυσσεὺς	-- -uu- uu- - -u u--	dactylic hexameter	masculine penthemimeral, hepthemimeral
Νέστωρ Ἰδομενεύς τε γέρων θ’ἱππηλάτα Φοῖνιξ	-- -uu- u u- --uu --	dactylic hexameter	masculine penthemimeral, hepthemimeral
τέρποντες πυκινῶς ἀκαχήμενον· οὐδέ τι θυμῷ	--- uu- uu-uu -u u --	dactylic hexameter	masculine penthemimeral, trithemimeral
τέρπετο, πρὶν πολέμου στόμα δύμεναι αἱματόεντος.	-uu - uu- uu -uu -uu--	dactylic hexameter	masculine penthemimeral, trithemimeral
μνησάμενος δ’ἁδινῶς ἀνενείκατο φώνησέν τε·	-uu- uu- uu-uu --- -	dactylic hexameter	masculine penthemimeral, trithemimeral
ἦ ῥά νύ μοί ποτε καὶ σὺ δυσάμμορε φίλταθ’ ἑταίρων	- u u - uu - u u-uu -u u--	dactylic hexameter	masculine penthemimeral, trithemimeral
αὐτὸς ἐνὶ κλισίῃ λαρὸν παρὰ δεῖπνον ἔθηκας	-u u- uu- -- uu -u u--	dactylic hexameter	masculine penthemimeral, hepthemimeral, trithemimeral
αἶψα καὶ ὀτραλέως, ὁπότε σπερχοίατ’ Ἀχαιοὶ	-u u -uu- uu- --u u--	dactylic hexameter	masculine penthemimeral, hepthemimeral
Τρωσὶν ἐφ’ ἱπποδάμοισι φέρειν πολύδακρυν Ἄρηα.	-u u -uu-u u- uu-u u--	dactylic hexameter	feminine penthemimeral, hepthemimeral
νῦν δὲ σὺ μὲν κεῖσαι δεδαϊγμένος, αὐτὰρ ἐμὸν κῆρ	- u u - -- uu-uu -u u- -	dactylic hexameter	masculine penthemimeral, trithemimeral
ἄκμηνον πόσιος καὶ ἐδητύος ἔνδον ἐόντων	--- uu- u u-uu -u u--	dactylic hexameter	masculine penthemimeral, trithemimeral
σῇ ποθῇ· οὐ μὲν γάρ τι κακώτερον ἄλλο πάθοιμι,	- uu - - - u u-uu -u u--	dactylic hexameter	masculine penthemimeral, trithemimeral
οὐδ’ εἴ κεν τοῦ πατρὸς ἀποφθιμένοιο πυθοίμην,	- - - - -u u-uu-u u--	dactylic hexameter	feminine penthemimeral, trithemimeral
ὅς που νῦν Φθίηφι τέρεν κατὰ δάκρυον εἴβει	- - - --u u- uu -uu --	dactylic hexameter	feminine penthemimeral, hepthemimeral, trithemimeral
χήτεϊ τοιοῦδ’ υἷος· ὃ δ’ἀλλοδαπῷ ἐνὶ δήμῳ	-uu -- -u u -uu- uu --	dactylic hexameter	feminine penthemimeral
εἵνεκα ῥιγεδανῆς Ἑλένης Τρωσὶν πολεμίζω·	-uu -uu- uu- -- uu--	dactylic hexameter	masculine penthemimeral, hepthemimeral
ἠὲ τὸν ὃς Σκύρῳ μοι ἔνι τρέφεται φίλος υἱός,	-u u - -- u u- uu- uu --	dactylic hexameter	masculine penthemimeral, hepthemimeral, trithemimeral
εἴ που ἔτι ζώει γε Νεοπτόλεμος θεοειδής.	- u u- -- u u-uu- uu--	dactylic hexameter	masculine penthemimeral, trithemimeral
πρὶν μὲν γάρ μοι θυμὸς ἐνὶ στήθεσσιν ἐώλπει	- - - - -u u- --u u--	dactylic hexameter	feminine penthemimeral, hepthemimeral, trithemimeral
οἶον ἐμὲ φθίσεσθαι ἀπ’ Ἄργεος ἱπποβότοιο	-u u- --u u -uu -uu--	dactylic hexameter	feminine penthemimeral, trithemimeral
αὐτοῦ ἐνὶ Τροίῃ, σὲ δέ τε Φθίην δὲ νέεσθαι,	-u u- -- u u - -- u u--	dactylic hexameter	masculine penthemimeral, hepthemimeral, trithemimeral
ὡς ἄν μοι τὸν παῖδα θοῇ ἐνὶ νηῒ μελαίνῃ	- - - - -u u- uu -u u--	dactylic hexameter	feminine penthemimeral, hepthemimeral, trithemimeral
Σκυρόθεν ἐξαγάγοις καί οἱ δείξειας ἕκαστα	-uu -uu- - - --u u--	dactylic hexameter	masculine penthemimeral, hepthemimeral
κτῆσιν ἐμὴν δμῶάς τε καὶ ὑψερεφὲς μέγα δῶμα.	-u u- -- u u -uu- uu --	dactylic hexameter	masculine penthemimeral, trithemimeral
ἤδη γὰρ Πηλῆά γ’ ὀΐομαι ἢ κατὰ πάμπαν	-- - --u u-uu - uu --	dactylic hexameter	feminine penthemimeral, trithemimeral
τεθνάμεν, ἤ που τυτθὸν ἔτι ζώοντ’ ἀκάχησθαι	-uu - - -u u- -- uu--	dactylic hexameter	feminine penthemimeral, hepthemimeral, trithemimeral
γήραΐ τε στυγερῷ καὶ ἐμὴν ποτιδέγμενον αἰεὶ	-uu - uu- u u- uu-uu --	dactylic hexameter	masculine penthemimeral, hepthemimeral, trithemimeral
λυγρὴν ἀγγελίην, ὅτ’ ἀποφθιμένοιο πύθηται.	-- -uu- u u-uu-u u--	dactylic hexameter	masculine penthemimeral
ὣς ἔφατο κλαίων, ἐπὶ δὲ στενάχοντο γέροντες,	- uu- -- uu - uu-u u--	dactylic hexameter	masculine penthemimeral, hepthemimeral, trithemimeral
μνησάμενοι τὰ ἕκαστος ἐνὶ μεγάροισιν ἔλειπον·	-uu- u u-u u- uu-u u--	dactylic hexameter	feminine penthemimeral, hepthemimeral, trithemimeral
μυρομένους δ’ἄρα τούς γε ἰδὼν ἐλέησε Κρονίων,	-uu- uu - u u- uu-u u--	dactylic hexameter	masculine penthemimeral, hepthemimeral, trithemimeral
αἶψα δ’Ἀθηναίην ἔπεα πτερόεντα προσηύδα·	-u u--- uu- uu-u u--	dactylic hexameter	masculine penthemimeral, hepthemimeral
τέκνον ἐμόν, δὴ πάμπαν ἀποίχεαι ἀνδρὸς ἑῆος.	-u u- - -u u-uu -u u--	dactylic hexameter	feminine penthemimeral, trithemimeral
ἦ νύ τοι οὐκέτι πάγχυ μετὰ φρεσὶ μέμβλετ’ Ἀχιλλεύς;	- u u -uu -u u- uu -u u--	dactylic hexameter	feminine penthemimeral, hepthemimeral
κεῖνος ὅ γε προπάροιθε νεῶν ὀρθοκραιράων	-u u - uu-u u- -----	dactylic hexameter	feminine penthemimeral, hepthemimeral, trithemimeral
ἧσται ὀδυρόμενος ἕταρον φίλον· οἳ δὲ δὴ ἄλλοι	-u u-uu- uu- uu - u u --	dactylic hexameter	masculine penthemimeral, hepthemimeral
οἴχονται μετὰ δεῖπνον, ὃ δ’ἄκμηνος καὶ ἄπαστος.	--- uu -u u --- u u--	dactylic hexameter	feminine penthemimeral, trithemimeral
ἀλλ’ ἴθι οἱ νέκτάρ τε καὶ ἀμβροσίην ἐρατεινὴν	- uu - -- u u -uu- uu--	dactylic hexameter	masculine penthemimeral, trithemimeral
στάξον ἐνὶ στήθεσσ’, ἵνα μή μιν λιμὸς ἵκηται.	-u u- -- uu - - -u u--	dactylic hexameter	masculine penthemimeral, hepthemimeral, trithemimeral
ὣς εἰπὼν ὄτρυνε πάρος μεμαυῖαν Ἀθήνην·	- -- --u u- uu-u u--	dactylic hexameter	feminine penthemimeral, hepthemimeral, trithemimeral
ἣ δ’ἅρπῃ ἐϊκυῖα τανυπτέρυγι λιγυφώνῳ	- -- uu-u u-uu- uu--	dactylic hexameter	feminine penthemimeral, trithemimeral
οὐρανοῦ ἐκκατεπᾶλτο δι’ αἰθέρος. αὐτὰρ Ἀχαιοὶ	-uu -uu-u u -uu -u u--	dactylic hexameter	feminine penthemimeral
αὐτίκα θωρήσσοντο κατὰ στρατόν· ἣ δ’Ἀχιλῆϊ	-uu ---u u- uu - uu--	dactylic hexameter	feminine penthemimeral, hepthemimeral
νέκταρ ἐνὶ στήθεσσι καὶ ἀμβροσίην ἐρατεινὴν	-u u- --u u -uu- uu--	dactylic hexameter	feminine penthemimeral, trithemimeral
στάξ’, ἵνα μή μιν λιμὸς ἀτερπὴς γούναθ’ ἵκοιτο·	- uu - - -u u-- -u u--	dactylic hexameter	feminine penthemimeral, trithemimeral
αὐτὴ δὲ πρὸς πατρὸς ἐρισθενέος πυκινὸν δῶ	-- - - -u u-uu- uu- -	dactylic hexameter	feminine penthemimeral, trithemimeral
ᾤχετο, τοὶ δ’ἀπάνευθε νεῶν ἐχέοντο θοάων.	-uu - uu-u u- uu-u u--	dactylic hexameter	feminine penthemimeral, hepthemimeral, trithemimeral
ὡς δ’ὅτε ταρφειαὶ νιφάδες Διὸς ἐκποτέονται	- uu --- uu- uu -uu--	dactylic hexameter	masculine penthemimeral, hepthemimeral
ψυχραὶ ὑπὸ ῥιπῆς αἰθρηγενέος Βορέαο,	-- -u u- --uu- uu--	dactylic hexameter	masculine penthemimeral
ὣς τότε ταρφειαὶ κόρυθες λαμπρὸν γανόωσαι	- uu --- uu- -- uu--	dactylic hexameter	masculine penthemimeral, hepthemimeral
νηῶν ἐκφορέοντο καὶ ἀσπίδες ὀμφαλόεσσαι	-- -uu-u u -uu -uu--	dactylic hexameter	feminine penthemimeral
θώρηκές τε κραταιγύαλοι καὶ μείλινα δοῦρα.	--- u u-uu- - -uu --	dactylic hexameter	hepthemimeral, trithemimeral
αἴγλη δ’οὐρανὸν ἷκε, γέλασσε δὲ πᾶσα περὶ χθὼν	-- -uu -u u-u u -u u- -	dactylic hexameter	feminine penthemimeral
χαλκοῦ ὑπὸ στεροπῆς· ὑπὸ δὲ κτύπος ὄρνυτο ποσσὶν	-u u- uu- uu - uu -uu --	dactylic hexameter	masculine penthemimeral, hepthemimeral, trithemimeral
ἀνδρῶν· ἐν δὲ μέσοισι κορύσσετο δῖος Ἀχιλλεύς.	-- - u u-u u-uu -u u--	dactylic hexameter	feminine penthemimeral, trithemimeral
τοῦ καὶ ὀδόντων μὲν καναχὴ πέλε, τὼ δέ οἱ ὄσσε	- u u-- - uu- uu - u u --	dactylic hexameter	masculine penthemimeral, hepthemimeral
λαμπέσθην ὡς εἴ τε πυρὸς σέλας, ἐν δέ οἱ ἦτορ	--- - - u u- uu - u u --	dactylic hexameter	masculine penthemimeral, hepthemimeral, trithemimeral
δῦν’ ἄχος ἄτλητον· ὃ δ’ἄρα Τρωσὶν μενεαίνων	- uu --- u u- -- uu--	dactylic hexameter	masculine penthemimeral, hepthemimeral
δύσετο δῶρα θεοῦ, τά οἱ Ἥφαιστος κάμε τεύχων.	-uu -u u- u u --- uu --	dactylic hexameter	masculine penthemimeral
κνημῖδας μὲν πρῶτα περὶ κνήμῃσιν ἔθηκε	--- - -u u- --u u--	dactylic hexameter	feminine penthemimeral, hepthemimeral, trithemimeral
καλὰς ἀργυρέοισιν ἐπισφυρίοις ἀραρυίας·	-- -uu-u u-uu- uu--	dactylic hexameter	feminine penthemimeral
δεύτερον αὖ θώρηκα περὶ στήθεσσιν ἔδυνεν.	-uu - --u u- --u u--	dactylic hexameter	feminine penthemimeral, hepthemimeral, trithemimeral
ἀμφὶ δ’ἄρ’ ὤμοισιν βάλετο ξίφος ἀργυρόηλον	-u u --- uu- uu -uu--	dactylic hexameter	masculine penthemimeral, hepthemimeral
χάλκεον· αὐτὰρ ἔπειτα σάκος μέγα τε στιβαρόν τε	-uu -u u-u u- uu - uu- -	dactylic hexameter	feminine penthemimeral, hepthemimeral
εἵλετο, τοῦ δ’ἀπάνευθε σέλας γένετ’ ἠΰτε μήνης.	-uu - uu-u u- uu -uu --	dactylic hexameter	feminine penthemimeral, hepthemimeral, trithemimeral
ὡς δ’ὅτ’ ἂν ἐκ πόντοιο σέλας ναύτῃσι φανήῃ	- u u - --u u- --u u--	dactylic hexameter	feminine penthemimeral, hepthemimeral, trithemimeral
καιομένοιο πυρός, τό τε καίεται ὑψόθ’ ὄρεσφι	-uu-u u- u u -uu -u u--	dactylic hexameter	masculine penthemimeral
σταθμῷ ἐν οἰοπόλῳ· τοὺς δ’οὐκ ἐθέλοντας ἄελλαι	-u u -uu- - - uu-u u--	dactylic hexameter	masculine penthemimeral, hepthemimeral
πόντον ἐπ’ ἰχθυόεντα φίλων ἀπάνευθε φέρουσιν·	-u u -uu-u u- uu-u u--	dactylic hexameter	feminine penthemimeral, hepthemimeral
ὣς ἀπ’ Ἀχιλλῆος σάκεος σέλας αἰθέρ’ ἵκανε	- u u--- uu- uu -u u--	dactylic hexameter	masculine penthemimeral, hepthemimeral
καλοῦ δαιδαλέου· περὶ δὲ τρυφάλειαν ἀείρας	-- -uu- uu - uu-u u--	dactylic hexameter	masculine penthemimeral, hepthemimeral
κρατὶ θέτο βριαρήν· ἣ δ’ἀστὴρ ὣς ἀπέλαμπεν	-u u- uu- - -- - uu--	dactylic hexameter	masculine penthemimeral, trithemimeral
ἵππουρις τρυφάλεια, περισσείοντο δ’ἔθειραι	--- uu-u u---u u--	dactylic hexameter	feminine penthemimeral, trithemimeral
χρύσεαι, ἃς Ἥφαιστος ἵει λόφον ἀμφὶ θαμειάς.	-uu - --u u- uu -u u--	dactylic hexameter	feminine penthemimeral, hepthemimeral, trithemimeral
πειρήθη δ’ἕο αὐτοῦ ἐν ἔντεσι δῖος Ἀχιλλεύς,	--- - -u u -uu -u u--	dactylic hexameter	feminine penthemimeral, trithemimeral
εἰ οἷ ἐφαρμόσσειε καὶ ἐντρέχοι ἀγλαὰ γυῖα·	- u u---u u -uu -uu --	dactylic hexameter	feminine penthemimeral
τῷ δ’εὖτε πτερὰ γίγνετ’, ἄειρε δὲ ποιμένα λαῶν.	- -- uu -u u-u u -uu --	dactylic hexameter	feminine penthemimeral, trithemimeral
ἐκ δ’ἄρα σύριγγος πατρώϊον ἐσπάσατ’ ἔγχος	- uu --- --uu -uu --	dactylic hexameter	masculine penthemimeral
βριθὺ μέγα στιβαρόν· τὸ μὲν οὐ δύνατ’ ἄλλος Ἀχαιῶν	-u u- uu- u u - uu -u u--	dactylic hexameter	masculine penthemimeral, hepthemimeral, trithemimeral
πάλλειν, ἀλλά μιν οἶος ἐπίστατο πῆλαι Ἀχιλλεύς·	-- -u u -u u-uu -u u--	dactylic hexameter	feminine penthemimeral
Πηλιάδα μελίην, τὴν πατρὶ φίλῳ πόρε Χείρων	-uu- uu- - -u u- uu --	dactylic hexameter	masculine penthemimeral, trithemimeral
Πηλίου ἐκ κορυφῆς φόνον ἔμμεναι ἡρώεσσιν·	-uu - uu- uu -uu ----	dactylic hexameter	masculine penthemimeral, trithemimeral
ἵππους δ’Αὐτομέδων τε καὶ Ἄλκιμος ἀμφιέποντες	-- -uu- u u -uu -uu--	dactylic hexameter	masculine penthemimeral
ζεύγνυον· ἀμφὶ δὲ καλὰ λέπαδν’ ἕσαν, ἐν δὲ χαλινοὺς	-uu -u u -u u- uu - u u--	dactylic hexameter	feminine penthemimeral, hepthemimeral
γαμφηλῇς ἔβαλον, κατὰ δ’ἡνία τεῖναν ὀπίσσω	--- uu- uu -uu -u u--	dactylic hexameter	masculine penthemimeral, trithemimeral
κολλητὸν ποτὶ δίφρον. ὃ δὲ μάστιγα φαεινὴν	--- uu -u u - --u u--	dactylic hexameter	feminine penthemimeral, hepthemimeral, trithemimeral
χειρὶ λαβὼν ἀραρυῖαν ἐφ’ ἵπποιιν ἀνόρουσεν	-u u- uu-u u --- uu--	dactylic hexameter	feminine penthemimeral, trithemimeral
Αὐτομέδων· ὄπιθεν δὲ κορυσσάμενος βῆ Ἀχιλλεὺς	-uu- uu- u u-uu- u u--	dactylic hexameter	masculine penthemimeral, trithemimeral
τεύχεσι παμφαίνων ὥς τ’ἠλέκτωρ Ὑπερίων,	-uu --- - --- uu--	dactylic hexameter	masculine penthemimeral
σμερδαλέον δ’ἵπποισιν ἐκέκλετο πατρὸς ἑοῖο·	-uu- --u u-uu -u u--	dactylic hexameter	feminine penthemimeral, trithemimeral
Ξάνθέ τε καὶ Βαλίε τηλεκλυτὰ τέκνα Ποδάργης	-u u - uu- --uu -u u--	dactylic hexameter	masculine penthemimeral, trithemimeral
ἄλλως δὴ φράζεσθε σαωσέμεν ἡνιοχῆα	-- - --u u-uu -uu--	dactylic hexameter	feminine penthemimeral, trithemimeral
ἂψ Δαναῶν ἐς ὅμιλον ἐπεί χ’ἕωμεν πολέμοιο,	- uu- u u-u u- -- uu--	dactylic hexameter	feminine penthemimeral, hepthemimeral, trithemimeral
μηδ’ ὡς Πάτροκλον λίπετ’ αὐτόθι τεθνηῶτα.	- - --- uu -uu ----	dactylic hexameter	masculine penthemimeral
τὸν δ’ἄρ’ ὑπὸ ζυγόφι προσέφη πόδας αἰόλος ἵππος	- u u- uu- uu- uu -uu --	dactylic hexameter	masculine penthemimeral, hepthemimeral, trithemimeral
Ξάνθος, ἄφαρ δ’ἤμυσε καρήατι· πᾶσα δὲ χαίτη	-u u- --u u-uu -u u --	dactylic hexameter	feminine penthemimeral, trithemimeral
ζεύγλης ἐξεριποῦσα παρὰ ζυγὸν οὖδας ἵκανεν·	-- -uu-u u- uu -u u--	dactylic hexameter	feminine penthemimeral, hepthemimeral
αὐδήεντα δ’ἔθηκε θεὰ λευκώλενος Ἥρη·	---u u-u u- --uu --	dactylic hexameter	feminine penthemimeral, hepthemimeral
καὶ λίην σ’ἔτι νῦν γε σαώσομεν ὄβριμ’ Ἀχιλλεῦ·	- -- uu - u u-uu -u u--	dactylic hexameter	masculine penthemimeral, trithemimeral
ἀλλά τοι ἐγγύθεν ἦμαρ ὀλέθριον· οὐδέ τοι ἡμεῖς	-u u -uu -u u-uu -u u --	dactylic hexameter	feminine penthemimeral
αἴτιοι, ἀλλὰ θεός τε μέγας καὶ Μοῖρα κραταιή.	-uu -u u- u u- - -u u--	dactylic hexameter	masculine penthemimeral, hepthemimeral
οὐδὲ γὰρ ἡμετέρῃ βραδυτῆτί τε νωχελίῃ τε	-u u -uu- uu-u u -uu- -	dactylic hexameter	masculine penthemimeral
Τρῶες ἀπ’ ὤμοιιν Πατρόκλου τεύχε’ ἕλοντο·	-u u --- --- -u u--	dactylic hexameter	masculine penthemimeral
ἀλλὰ θεῶν ὤριστος, ὃν ἠΰκομος τέκε Λητώ,	-u u- --u u -uu- uu --	dactylic hexameter	feminine penthemimeral, trithemimeral
ἔκταν’ ἐνὶ προμάχοισι καὶ Ἕκτορι κῦδος ἔδωκε.	-u u- uu-u u -uu -u u--	dactylic hexameter	feminine penthemimeral, trithemimeral
νῶϊ δὲ καί κεν ἅμα πνοιῇ Ζεφύροιο θέοιμεν,	-u u - u u- -- uu-u u--	dactylic hexameter	masculine penthemimeral, hepthemimeral, trithemimeral
ἥν περ ἐλαφροτάτην φάσ’ ἔμμεναι· ἀλλὰ σοὶ αὐτῷ	- u u-uu- - -uu -u u --	dactylic hexameter	masculine penthemimeral
μόρσιμόν ἐστι θεῷ τε καὶ ἀνέρι ἶφι δαμῆναι.	-uu -u u- u u -uu -u u--	dactylic hexameter	masculine penthemimeral
ὣς ἄρα φωνήσαντος Ἐρινύες ἔσχεθον αὐδήν.	- uu ---u u-uu -uu --	dactylic hexameter	feminine penthemimeral
τὸν δὲ μέγ’ ὀχθήσας προσέφη πόδας ὠκὺς Ἀχιλλεύς·	- u u --- uu- uu -u u--	dactylic hexameter	masculine penthemimeral, hepthemimeral
Ξάνθε τί μοι θάνατον μαντεύεαι; οὐδέ τί σε χρή.	-u u - uu- --uu -u u - -	dactylic hexameter	masculine penthemimeral, trithemimeral
εὖ νυ τὸ οἶδα καὶ αὐτὸς ὅ μοι μόρος ἐνθάδ’ ὀλέσθαι	- u u -u u -u u - uu -u u--	dactylic hexameter	feminine penthemimeral, hepthemimeral
νόσφι φίλου πατρὸς καὶ μητέρος· ἀλλὰ καὶ ἔμπης	-u u- -- - -uu -u u --	dactylic hexameter	masculine penthemimeral, trithemimeral
οὐ λήξω πρὶν Τρῶας ἅδην ἐλάσαι πολέμοιο.	- -- - -u u- uu- uu--	dactylic hexameter	feminine penthemimeral, hepthemimeral, trithemimeral
ἦ ῥα, καὶ ἐν πρώτοις ἰάχων ἔχε μώνυχας ἵππους.	- u u - -- uu- uu -uu --	dactylic hexameter	masculine penthemimeral, hepthemimeral, trithemimeral
