ἄμπνευμα σεμνὸν Ἀλφεοῦ,	--u -u -u-	lyric	
κλεινᾶν Συρακοσσᾶν θάλος Ὀρτυγία,	-- u--- uu -uu-	lyric	
δέμνιον Ἀρτέμιδος,	-uu -uu-	lyric	
Δάλου κασιγνήτα, σέθεν ἁδυεπὴς	-- u--- uu -uu-	lyric	
ὕμνος ὁρμᾶται θέμεν	-u --- u-	lyric	
αἶνον ἀελλοπόδων μέγαν ἵππων, Ζηνὸς Αἰτναίου χάριν·	-u u-uu- uu -- -u --- u-	lyric	
ἅρμα δ᾽ὀτρύνει Χρομίου Νεμέα θʼἔργμασιν νικαφόροις ἐγκώμιον ζεῦξαι μέλος.	-u --- uu- uu- -u- --u- --u- -- u-	lyric	
ἀρχαὶ δὲ βέβληνται θεῶν	-- u --- u-	lyric	
κείνου σὺν ἀνδρὸς δαιμονίαις ἀρεταῖς.	-- u -- -uu- uu-	lyric	
ἔστι δ᾽ἐν εὐτυχίᾳ	-u u -uu-	lyric	
πανδοξίας ἄκρον· μεγάλων δ᾽ἀέθλων	--u- -- uu- uu-	lyric	
Μοῖσα μεμνᾶσθαι φιλεῖ.	-u --- u-	lyric	
σπεῖρέ νυν ἀγλαΐαν τινὰ νάσῳ, τὰν Ὀλύμπου δεσπότας	-u u -uu- uu -- - u-- -u-	lyric	
Ζεὺς ἔδωκεν Φερσεφόνᾳ, κατένευσέν τέ οἱ χαίταις, ἀριστεύοισαν εὐκάρπου χθονὸς	- u-- -uu- uu-- u - -- u---u --- u-	lyric	
Σικελίαν πίειραν ὀρθώσειν κορυφαῖς πολίων ἀφνεαῖς.	uuu- --u --- uu- uu- -u-	lyric	
ὤπασε δὲ Κρονίων πολέμου μναστῆρά οἱ χαλκεντέος	-uu - uu- uu- --u - --u-	lyric	
λαὸν ἵππαιχμον θαμὰ δὴ καὶ Ὀλυμπιάδων φύλλοις ἐλαιᾶν χρυσέοις	-u --- uu - u u-uu- -- u-- -u-	lyric	
μιχθέντα. πολλῶν ἐπέβαν καιρὸν οὐ ψεύδει βαλών.	--u -- uu- -u - -- u-	lyric	
ἔσταν δ᾽ἐπʼ αὐλείαις θύραις	-- u --- u-	lyric	
ἀνδρὸς φιλοξείνου καλὰ μελπόμενος,	-- u--- uu -uu-	lyric	
ἔνθα μοι ἁρμόδιον	-u u -uu-	lyric	
δεῖπνον κεκόσμηται, θαμὰ δ᾽ἀλλοδαπῶν	-- u--- uu -uu-	lyric	
οὐκ ἀπείρατοι δόμοι	- u--- u-	lyric	
ἐντί· λέλογχε δὲ μεμφομένοις ἐσλοὺς ὕδωρ καπνῷ φέρειν	-u u-u u -uu- -- u- -- u-	lyric	
ἀντίον. τέχναι δ᾽ἑτέρων ἕτεραι· χρὴ δ᾽ἐν εὐθείαις ὁδοῖς στείχοντα μάρνασθαι φυᾷ.	-u- -- uu- uu- - u --- u- --u --- u-	lyric	
πράσσει γὰρ ἔργῳ μὲν σθένος,	-- u -- - u-	lyric	
βουλαῖσι δὲ φρήν, ἐσσόμενον προϊδεῖν	--u - - -uu- uu-	lyric	
συγγενὲς οἷς ἕπεται.	-uu - uu-	lyric	
Ἁγησιδάμου παῖ, σέο δ᾽ἀμφὶ τρόπῳ	--u-- - uu -u u-	lyric	
τῶν τε καὶ τῶν χρήσιες.	- u - - -u-	lyric	
οὐκ ἔραμαι πολὺν ἐν μεγάρῳ πλοῦτον κατακρύψαις ἔχειν,	- uu- uu - uu- -- u--- u-	lyric	
ἀλλʼ ἐόντων εὖ τε παθεῖν καὶ ἀκοῦσαι φίλοις ἐξαρκέων. κοιναὶ γὰρ ἔρχοντʼἐλπίδες	- u-- - u u- u u-- u- --u- -- u ---u-	lyric	
πολυπόνων ἀνδρῶν. ἐγὼ δ᾽Ἡρακλέος ἀντέχομαι προφρόνως,	uuu- -- u- --uu -uu- -u-	lyric	
ἐν κορυφαῖς ἀρετᾶν μεγάλαις ἀρχαῖον ὀτρύνων λόγον,	- uu- uu- uu- --u --- u-	lyric	
ὡς, ἐπεὶ σπλάγχνων ὕπο ματέρος αὐτίκα θαητὰν ἐς αἴγλαν παῖς Διὸς	- u- -- uu -uu -uu --- u -- - u-	lyric	
ὠδῖνα φεύγων διδύμῳ σὺν κασιγνήτῳ μόλεν,	--u -- uu- - u--- u-	lyric	
ὡς οὐ λαθὼν χρυσόθρονον	- - u- --u-	lyric	
Ἥραν κροκωτὸν σπάργανον ἐγκατέβα·	-- u-- -uu -uu-	lyric	
ἀλλὰ θεῶν βασιλέα	-u u- uu-	lyric	
σπερχθεῖσα θυμῷ πέμπε δράκοντας ἄφαρ.	--u -- -u u-u u-	lyric	
τοὶ μὲν οἰχθεισᾶν πυλᾶν	- u --- u-	lyric	
ἐς θαλάμου μυχὸν εὐρὺν ἔβαν, τέκνοισιν ὠκείας γνάθους	- uu- uu -u u- --u --- u-	lyric	
ἀμφελίξασθαι μεμαῶτες· ὁ δ᾽ὀρθὸν μὲν ἄντεινεν κάρα, πειρᾶτο δὲ πρῶτον μάχας,	-u--- uu-u u -- u --- u- --u - -- u-	lyric	
δισσαῖσι δοιοὺς αὐχένων	--u -- -u-	lyric	
μάρψαις ἀφύκτοις χερσὶν ἑαῖς ὄφιας·	-- u-- -u u- uu-	lyric	
ἀγχομένοις δὲ χρόνος	-uu- u u-	lyric	
ψυχὰς ἀπέπνευσεν μελέων ἀφάτων.	-- u--- uu- uu-	lyric	
ἐκ δ᾽ἄρʼ ἄτλατον δέος	- u --- u-	lyric	
πλᾶξε γυναῖκας, ὅσαι τύχον Ἀλκμήνας ἀρήγοισαι λέχει·	-u u-u u- uu --- u--- u-	lyric	
καὶ γὰρ αὐτά, ποσσὶν ἄπεπλος ὀρούσαισʼ ἀπὸ στρωμνᾶς, ὅμως ἄμυνεν ὕβριν κνωδάλων.	- u -- -u u-u u-- u- -- u- --u -- -u-	lyric	
ταχὺ δὲ Καδμείων ἀγοὶ χαλκέοις ἀθρόοι σὺν ὅπλοις ἔδραμον·	uu u --- u- -- uu- u u- -u-	lyric	
ἐν χερὶ δ᾽Ἀμφιτρύων κολεοῦ γυμνὸν τινάσσων φάσγανον	- uu -uu- uu- -- u-- -u-	lyric	
ἵκετʼ, ὀξείαις ἀνίαισι τυπείς. τὸ γὰρ οἰκεῖον πιέζει πάνθʼ ὁμῶς·	-u --- uu-u u- u u --- u-- - u-	lyric	
εὐθὺς δ᾽ἀπήμων κραδία κᾶδος ἀμφʼ ἀλλότριον.	-- u-- uu- -u - --u-	lyric	
ἔστα δὲ θάμβει δυσφόρῳ	-- u -- -u-	lyric	
τερπνῷ τε μιχθείς. εἶδε γὰρ ἐκνόμιον	-- u -- -u u -uu-	lyric	
λῆμά τε καὶ δύναμιν	-u u - uu-	lyric	
υἱοῦ παλίγγλωσσον δέ οἱ ἀθάνατοι	-- u--- u u -uu-	lyric	
ἀγγέλων ῥῆσιν θέσαν.	-u- -- u-	lyric	
γείτονα δ᾽ἐκκάλεσεν Διὸς ὑψίστου προφάταν ἔξοχον,	-uu -uu- uu --- u-- -u-	lyric	
ὀρθόμαντιν Τειρεσίαν· ὁ δέ οἱ φράζε καὶ παντὶ στρατῷ, ποίαις ὁμιλήσει τύχαις,	-u-- -uu- u u - -u - -- u- -- u--- u-	lyric	
ὅσσους μὲν ἐν χέρσῳ κτανών,	-- u - -- u-	lyric	
ὅσσους δὲ πόντῳ θῆρας ἀϊδροδίκας·	-- u -- -u u-uu-	lyric	
καί τινα σὺν πλαγίῳ	- uu - uu-	lyric	
ἀνδρῶν κόρῳ στείχοντα τὸν ἐχθρότατον	-- u- --u u -uu-	lyric	
φᾶσέ νιν δώσειν μόρῳ.	-u - -- u-	lyric	
καὶ γὰρ ὅταν θεοὶ ἐν πεδίῳ Φλέγρας Γιγάντεσσιν μάχαν	- u u- uu - uu- -- u--- u-	lyric	
ἀντιάζωσιν, βελέων ὑπὸ ῥιπαῖσι κείνου φαιδίμαν γαίᾳ πεφύρσεσθαι κόμαν	-u--- uu- uu --u -- -u- -- u--- u-	lyric	
ἔνεπεν· αὐτὸν μὰν ἐν εἰράνᾳ καμάτων μεγάλων ἐν σχερῷ	uuu -- - u --- uu- uu- - u-	lyric	
ἁσυχίαν τὸν ἅπαντα χρόνον ποινὰν λαχόντʼ ἐξαίρετον	-uu- u u-u u- -- u- --u-	lyric	
ὀλβίοις ἐν δώμασι, δεξάμενον θαλερὰν Ἥβαν ἄκοιτιν καὶ γάμον	-u- - -uu -uu- uu- -- u-- - u-	lyric	
δαίσαντα, πὰρ Δὶ Κρονίδᾳ σεμνὸν αἰνήσειν νόμον.	--u - - uu- -u --- u-	lyric	
ὅθεν περ καὶ Ὁμηρίδαι	u- - u u-u-	lyric	
ῥαπτῶν ἐπέων τὰ πόλλʼ ἀοιδοὶ	-- uu- u - u--	lyric	
ἄρχονται, Διὸς ἐκ προοιμίου· καὶ ὅδʼ ἀνὴρ	--- uu - u-u- u u --	lyric	
καταβολὰν ἱερῶν ἀγώνων νικαφορίας δέδεκται πρῶτον Νεμεαίου	uuu- uu- u-- --uu- u-- -- uu--	lyric	
ἐν πολυυμνήτῳ Διὸς ἄλσει.	- uu--- uu --	anapaestic	
ὀφείλει δ᾽ἔτι, πατρίαν	u-- uu -u-	lyric	
εἴπερ καθʼ ὁδόν νιν εὐθυπομπὸς	-- u u- u -u--	lyric	
αἰὼν ταῖς μεγάλαις δέδωκε κόσμον Ἀθάναις,	-- - uu- u-u -u u--	lyric	
θαμὰ μὲν Ἰσθμιάδων δρέπεσθαι κάλλιστον ἄωτον, ἐν Πυθίοισί τε νικᾶν	uu u -uu- u-- --u u-u - -u-u u --	lyric	
Τιμονόου παῖδʼ· ἔστι δ᾽ἐοικὸς	-uu- - -u u--	anapaestic	
ὀρειᾶν γε Πελειάδων	u-- u u-u-	lyric	
μὴ τηλόθεν Ὠαρίωνα νεῖσθαι.	- -uu -u-u --	lyric	
καὶ μὰν ἁ Σαλαμίς γε θρέψαι φῶτα μαχατὰν	- - - uu- u -- -u u--	lyric	
δυνατός. ἐν Τρωΐᾳ μὲν Ἕκτωρ Αἴαντος ἄκουσεν· ὦ Τιμόδημε, σὲ δ᾽ἀλκὰ	uuu - uu- u -- --u u-u - -u-u u --	lyric	
παγκρατίου τλάθυμος ἀέξει.	-uu- --u u--	anapaestic	
Ἀχάρναι δὲ παλαίφατοι	u-- u u-u-	lyric	
εὐάνορες· ὅσσα δ᾽ἀμφʼ ἀέθλοις,	--uu -u - u--	lyric	
Τιμοδημίδαι ἐξοχώτατοι προλέγονται.	-u-uu -u-u- uu--	lyric	
παρὰ μὲν ὑψιμέδοντι Παρνασῷ τέσσαρας ἐξ ἀέθλων νίκας ἐκόμιξαν·	uu u -uu-u --- -uu - u-- -- uu--	lyric	
ἀλλὰ Κορινθίων ὑπὸ φωτῶν	-u u-u- uu --	lyric	
ἐν ἐσλοῦ Πέλοπος πτυχαῖς	u -- uu- u-	lyric	
ὀκτὼ στεφάνοις ἔμιχθεν ἤδη·	-- uu- u-u --	lyric	
ἑπτὰ δ᾽ἐν Νεμέᾳ τὰ δ᾽οἴκοι μάσσονʼ ἀριθμοῦ	-u - uu- u -- -u u--	lyric	
Διὸς ἀγῶνι. τόν, ὦ πολῖται, κωμάξατε Τιμοδήμῳ σὺν εὐκλέϊ νόστῳ·	uu u-u u - u-- --uu -u-- u -uu --	lyric	
ἁδυμελεῖ δ᾽ἐξάρχετε φωνᾷ.	-uu- --uu --	anapaestic	
ὦ πότνια Μοῖσα, μᾶτερ ἁμετέρα, λίσσομαι,	- -uu -u -u -uu- -u-	lyric	
τὰν πολυξέναν ἐν ἱερομηνίᾳ Νεμεάδι	- u-u- u uuu-u- uuu-	lyric	
ἵκεο Δωρίδα νᾶσον Αἴγιναν· ὕδατι γὰρ	uuu -uu -u --u uuu -	lyric	
μένοντʼ ἐπʼ Ἀσωπίῳ μελιγαρύων τέκτονες	u- u --u- uu-u- -u-	lyric	
κώμων νεανίαι, σέθεν ὄπα μαιόμενοι.	-- u-u- uu uu -uu-	lyric	
διψῇ δὲ πρᾶγος ἄλλο μὲν ἄλλου·	-- u -u -u u --	lyric	
ἀεθλονικία δὲ μάλιστʼ ἀοιδὰν φιλεῖ,	-u-u- u u- u-- u-	lyric	
στεφάνων ἀρετᾶν τε δεξιωτάταν ὀπαδόν·	uu- uu- u -u-u- u--	lyric	
τᾶς ἀφθονίαν ὄπαζε μήτιος ἀμᾶς ἄπο·	- -uu- u-u -uu -- u-	lyric	
ἄρχε δ᾽οὐρανοῦ πολυνεφέλα κρέοντι, θύγατερ,	-u -u- uuuu- u-u uu-	lyric	
δόκιμον ὕμνον· ἐγὼ δὲ κείνων τέ νιν ὀάροις	uuu -u u- u -- u u uu-	lyric	
λύρᾳ τε κοινάσομαι. χαρίεντα δʼἕξει πόνον	u- u --u- uu-u -- u-	lyric	
χώρας ἄγαλμα, Μυρμιδόνες ἵνα πρότεροι	-- u-u -uuu u- uu-	lyric	
ᾤκησαν, ὧν παλαίφατον ἀγορὰν	--u - u-uu uu-	lyric	
οὐκ ἐλεγχέεσσιν Ἀριστοκλείδας τεὰν	- u-u-u u-u-- u-	lyric	
ἐμίανε κατʼ αἶσαν ἐν περισθενεῖ μαλαχθεὶς	uu-u u -u - u-u- u--	lyric	
παγκρατίου στόλῳ· καματωδέων δὲ πλαγᾶν	-uu- u- uu-u- u --	lyric	
ἄκος ὑγιηρὸν ἐν βαθυπεδίῳ Νεμέᾳτὸ καλλίνικον φέρει.	uu uu-u - uuuu- uu-u -u-- u-	lyric	
εἰ δ᾽ἐὼν καλὸς ἔρδων τ᾽ἐοικότα μορφᾷ	- u- uu -- u-uu --	lyric	
ἀνορέαις ὑπερτάταις ἐπέβα παῖς Ἀριστοφάνεος· οὐκέτι πρόσω	-uu- u-u- uu- - u-uu- -u- u-	lyric	
ἀβάταν ἅλα κιόνων ὑπὲρ Ἡρακλέος περᾶν εὐμαρές,	uu- uu -u- uu -uu- u- -u-	lyric	
ἥρως θεὸς ἃς ἔθηκε ναυτιλίας ἐσχάτας	-- uu - u-u -uu- -u-	lyric	
μάρτυρας κλυτάς· δάμασε δὲ θῆρας ἐν πελάγεσιν	-u- u- uuu u -u - uuu-	lyric	
ὑπέροχος, διά τ᾽ἐξερεύνασε τεναγέων	uuu- uu -u--u uuu-	lyric	
ῥοάς, ὅπα πόμπιμον κατέβαινε νόστου τέλος,	u- u- -u- uu-u -- u-	lyric	
καὶ γᾶν φράδασσε. θυμέ, τίνα πρὸς ἀλλοδαπὰν	- - u-u -u uu u -uu-	lyric	
ἄκραν ἐμὸν πλόον παραμείβεαι;	-- u- u- uu--	lyric	
Αἰακῷ σε φαμὶ γένει τε Μοῖσαν φέρειν,	-u- u -u u- u -- u-	lyric	
ἕπεται δὲ λόγῳ δίκας ἄωτος, "ἐσλὸς αἰνεῖν·"	uu- u u- u- u-u -u --	lyric	
οὐδʼ ἀλλοτρίων ἔρωτες ἀνδρὶ φέρειν κρέσσονες·	- -uu- u-u -u u- -u-	lyric	
οἴκοθεν μάτευε. ποτίφορον δὲ κόσμον ἔλαβες	-u- u-u uuu- u -u uu-	lyric	
γλυκύ τι γαρυέμεν. παλαιαῖσι δ᾽ἐν ἀρεταῖς	uu u -uu- u--u u uu-	lyric	
γέγαθε Πηλεὺς ἄναξ ὑπέραλλον αἰχμὰν ταμών·	u-u -- u- uu-u -- u-	lyric	
ὃς καὶ Ἰωλκὸν εἷλε μόνος ἄνευ στρατιᾶς,	- - u-u -u uu u- uu-	lyric	
καὶ ποντίαν Θέτιν κατέμαρψεν	- -u- u- uu--	lyric	
ἐγκονητί. Λαομέδοντα δ᾽εὐρυσθενὴς	-u-u -uu-u --u-	lyric	
Τελαμὼν Ἰόλᾳ παραστάτας ἐὼν ἔπερσεν·	uu- uu- u-u- u- u--	lyric	
καί ποτε χαλκότοξον Ἀμαζόνων μετʼ ἀλκὰν	- uu -u-u u-u- u --	lyric	
ἕπετό οἱ· οὐδέ νίν ποτε φόβος ἀνδροδάμας ἔπαυσεν ἀκμὰν φρενῶν.	uuu u -u - uu uu -uu- u-u -- u-	lyric	
συγγενεῖ δέ τις εὐδοξίᾳ μέγαβρίθει·	-u- u u --u- uu--	lyric	
ὃς δὲ διδάκτʼ ἔχει, ψεφηνὸς ἀνὴρ ἄλλοτʼ ἄλλα πνέων οὔ ποτʼ ἀτρεκεῖ	- u u- u- u-u u- -u -u u- - u -u-	lyric	
κατέβα ποδί, μυριᾶν δ᾽ἀρετᾶν ἀτελεῖ νόῳ γεύεται.	uu- uu -u- uu- uu- u- -u-	lyric	
ξανθὸς δ᾽Ἀχιλεὺς τὰ μὲν μένων Φιλύρας ἐν δόμοις	-- uu- u - u- uu- - u-	lyric	
παῖς ἐὼν ἄθυρε μεγάλα ἔργα, χερσὶ θαμινὰ	- u- u-u uuu -u -u uu-	lyric	
βραχυσίδαρον ἄκοντα πάλλων, ἴσατʼ ἀνέμοις	uuu-u u-u -- uu uu-	lyric	
μάχᾳ λεόντεσσιν ἀγροτέροις ἔπρασσεν φόνον,	u- u--u -uu- u-- u-	lyric	
κάπρους τ᾽ἔναιρε, σώματα δὲ παρὰ Κρονίδαν	-- u-u -uu u u- uu-	lyric	
Κένταυρον ἀσθμαίνοντα κόμιζεν,	--u ---u u--	lyric	
ἑξέτης τὸ πρῶτον, ὅλον δ᾽ἔπειτʼ ἂν χρόνον·	-u- u -u u- u- - u-	lyric	
τὸν ἐθάμβεον Ἄρτεμίς τε καὶ θρασεῖʼ Ἀθάνα,	u u-uu -u- u - u- u--	lyric	
κτείνοντʼ ἐλάφους ἄνευ κυνῶν δολίων θ᾽ἑρκέων·	-- uu- u- u- uu- -u-	lyric	
ποσσὶ γὰρ κράτεσκε. λεγόμενον δὲ τοῦτο προτέρων	-u - u-u uuu- u -u uu-	lyric	
ἔπος ἔχω· βαθυμῆτα Χείρων τράφε λιθίνῳ	uu u- uu-u -- uu uu-	lyric	
Ἰάσονʼ ἔνδον τέγει, καὶ ἔπειτεν Ἀσκλήπιον,	u-u -- u- u u-u --u-	lyric	
τὸν φαρμάκων δίδαξε μαλακόχειρα νόμον·	- -u- u-u uuu-u u-	lyric	
νύμφευσε δ᾽αὖτις ἀγλαόκαρπον	--u -u -uu--	lyric	
Νηρέος θύγατρα, γόνον τέ οἱ φέρτατον	-u- u-u u- u - -u-	lyric	
ἀτίταλλεν, ἐν ἀρμένοισι πᾶσι θυμὸν αὔξων·	uu-u u -u-u -u -u --	lyric	
ὄφρα θαλασσίαις ἀνέμων ῥιπαῖσι πεμφθεὶς	-u u-u- uu- --u --	lyric	
ὑπὸ Τρωΐαν, δορίκτυπον ἀλαλὰν Λυκίων τε προσμένοι καὶ Φρυγῶν	uu uu- u-uu uu- uu- u -u- - u-	lyric	
Δαρδάνων τε, καὶ ἐγχεσφόροις ἐπιμίξαις	-u- u u --u- uu--	lyric	
Αἰθιόπεσσι χεῖρας, ἐν φρασὶ πάξαιθʼ, ὅπως σφίσι μὴ κοίρανος ὀπίσω	-uu-u -u - uu -- u- uu - -uu uu-	lyric	
πάλιν οἴκαδʼ ἀνεψιὸς ζαμενὴς Ἑλένοιο Μέμνων μόλοι.	uu -u u-u- uu- uu-u -- u-	lyric	
τηλαυγὲς ἄραρε φέγγος Αἰακιδᾶν αὐτόθεν·	--u u-u -u -uu- -u-	lyric	
Ζεῦ, τεὸν γὰρ αἷμα, σέο δ᾽ἀγών, τὸν ὕμνος ἔβαλεν	- u- u -u uu u- u -u uu-	lyric	
ὀπὶ νέων ἐπιχώριον χάρμα κελαδέων.	uu u- uu-u- -u uuu-	lyric	
βοὰ δὲ νικαφόρῳ σὺν Ἀριστοκλείδᾳ πρέπει,	u- u --u- u u-u-- u-	lyric	
ὃς τάνδε νᾶσον εὐκλέϊ προσέθηκε λόγῳ	- -u -u -uu uu-u u-	lyric	
καὶ σεμνὸν ἀγλααῖσι μερίμναις	- -u -u-u u--	lyric	
Πυθίου Θεάριον. ἐν δὲ πείρᾳ τέλος	-u- u-uu - u -- u-	lyric	
διαφαίνεται, ὧν τις ἐξοχώτερος γένηται,	uu-uu - u -u-u- u--	lyric	
ἐν παισὶ νέοισι παῖς, ἐν ἀνδράσιν ἀνήρ, τρίτον	- -u u-u - u -uu -- u-	lyric	
ἐν παλαιτέροισι, μέρος ἕκαστον οἷον ἔχομεν	- u-u-u uu u-u -u uu-	lyric	
βρότεον ἔθνος. ἐλᾷ δὲ καὶ τέσσαρας ἀρετὰς	uuu -u u- u - -uu uu-	lyric	
ὁ θνατὸς αἰών, φρονεῖν δ᾽ἐνέπει τὸ παρκείμενον.	u -u -- u- uu- u --u-	lyric	
τῶν οὐκ ἄπεσσι. χαῖρε, φίλος. ἐγὼ τόδε τοι	- - u-u -u uu u- uu -	lyric	
πέμπω μεμιγμένον μέλι λευκῷ	-- u-u- uu --	lyric	
σὺν γάλακτι, κιρναμένα δ᾽ἔερσʼ ἀμφέπει,	- u-u -uu- u- -u-	lyric	
πόμʼ ἀοίδιμον Αἰολῇσιν ἐν πνοαῖσιν αὐλῶν,	u u-uu -u-u - u-u --	lyric	
ὀψέ περ. ἔστι δ᾽αἰετὸς ὠκὺς ἐνποτανοῖς,	-u u -u -uu -u -u--	lyric	
ὃς ἔλαβεν αἶψα, τηλόθε μεταμαιόμενος, δαφοινὸν ἄγραν ποσίν·	u uuu -u -uu uu-uu- u-u -- u-	lyric	
κραγέται δὲ κολοιοὶ ταπεινὰ νέμονται.	-u- u u-- u-u u--	lyric	
τίν γε μέν, εὐθρόνου Κλεοῦς ἐθελοίσας, ἀεθλοφόρου λήματος ἕνεκεν	- u u -u- u- uu-- u-uu- -uu uu-	lyric	
Νεμέας Ἐπιδαυρόθεν τ᾽ἄπο καὶ Μεγάρων δέδορκεν φάος.	uu- uu-u- uu - uu- u-- u-	lyric	
ἄριστος εὐφροσύνα πόνων κεκριμένων	u-u -uu- u- -uu-	lyric	
ἰατρός· αἱ δὲ σοφαὶ	u-u - u u-	lyric	
Μοισᾶν θύγατρες ἀοιδαὶ θέλξαν νιν ἁπτόμεναι.	-- u-u u-- -- u -uu-	lyric	
οὐδὲ θερμὸν ὕδωρ τόσον γε μαλθακὰ τέγγει	-u -u u- u- u -uu --	lyric	
γυῖα, τόσσον εὐλογία φόρμιγγι συνάορος.	-u -u -uu- --u u-u-	lyric	
ῥῆμα δ᾽ἑργμάτων χρονιώτερον βιοτεύει,	-u -u- uu-u- uu--	lyric	
ὅ τι κε σὺν Χαρίτων τύχᾳ	u u u - uu- u-	lyric	
γλῶσσα φρενὸς ἐξέλοι βαθείας.	-- uu -u- u--	lyric	
τό μοι θέμεν Κρονίδᾳ τε Δὶ καὶ Νεμέᾳ	u - u- uu- u - - uu-	lyric	
Τιμασάρχου τε πάλᾳ	---- u u-	lyric	
ὕμνου προκώμιον εἴη· δέξαιτο δ᾽Αἰακιδᾶν	-- u-uu -- --u -uu-	lyric	
ἠΰπυργον ἕδος, δίκᾳ ξεναρκέϊκοινὸν	-u-u u- u- u-uu--	lyric	
φέγγος. εἰ δ᾽ἔτι ζαμενεῖ Τιμόκριτος ἁλίῳ	-u - u- uu- --uu -u-	lyric	
σὸς πατὴρ ἐθάλπετο, ποικίλον κιθαρίζων	- u- u-uu -u- uu--	lyric	
θαμά κε, τῷδε μέλει κλιθείς,	uu u -u u- u-	lyric	
ὕμνον κελάδησε καλλίνικον	-- uu-u -u--	lyric	
Κλεωναίου τ᾽ἀπʼ ἀγῶνος ὅρμον στεφάνων	u--- u u-u -- uu-	lyric	
πέμψαντα καὶ λιπαρᾶν	--u - uu-	lyric	
εὐωνύμων ἀπʼ Ἀθανᾶν, Θήβαις τ᾽ἐν ἑπταπύλοις,	--u- u u-- -- u -uu-	lyric	
οὕνεκʼ Ἀμφιτρύωνος ἀγλαὸν παρὰ τύμβον	-u -uu-u -u- uu --	lyric	
Καδμεῖοί νιν οὐκ ἀέκοντες ἄνθεσι μίγνυον,	--- u - uu-u -uu -u-	lyric	
Αἰγίνας ἕκατι. φίλοισι γὰρ φίλος ἐλθὼν	-u- u-u u-u - uu --	lyric	
ξένιον ἄστυ κατέδρακεν	uuu -u u-u-	lyric	
Ἡρακλέος ὀλβίαν πρὸς αὐλάν.	--uu -u- u --	lyric	
σὺν ᾧ ποτε Τρωΐαν κραταιὸςΤελαμὼν	u - u- uu- u--uu-	lyric	
πόρθησε καὶ Μέροπας	--u - uu-	lyric	
καὶ τὸν μέγαν πολεμιστὰν ἔκπαγλον Ἀλκυονῆ,	- - u- uu-- --u -uu-	lyric	
οὐ τετραορίας γε πρὶν δυώδεκα πέτρῳ	- u-uu- u - u-uu --	lyric	
ἥροάς τ᾽ἐπεμβεβαῶτας ἱπποδάμους ἕλεν	-u- u-uu-u -uu- u-	lyric	
δὶς τόσους. ἀπειρομάχας ἐών κεφανείη	- u- u-uu- u- uu--	lyric	
λόγον ὁ μὴ συνιείς· ἐπεὶ	uu u - uu- u-	lyric	
"ῥέζοντά τι καὶ παθεῖν ἔοικεν."	--u u - u- u--	lyric	
τὰ μακρὰ δ᾽ἐξενέπειν ἐρύκει με τεθμὸς	u -u -uu- u-- u u-	lyric	
ὧραί τ᾽ἐπειγόμεναι·	-- u-uu-	lyric	
ἴϋγγι δ᾽ἕλκομαι ἦτορ νουμηνίᾳ θιγέμεν.	--u -uu -- --u- uu-	lyric	
ἔμπα, καίπερ ἔχει βαθεῖα ποντιὰς ἅλμα	-u -u u- u-u -uu --	lyric	
μέσσον, ἀντίτεινʼ ἐπιβουλίᾳ· σφόδρα δόξομεν	-u -u- uu-u- uu -u-	lyric	
δαΐων ὑπέρτεροι ἐν φάει καταβαίνειν·	-u- u-uu - u- uu--	lyric	
φθονερὰ δ᾽ἄλλος ἀνὴρ βλέπων	uuu -u u- u-	lyric	
γνώμαν κενεὰν σκότῳ κυλίνδει	-- uu- u- u--	lyric	
χαμαὶ πετοῖσαν· ἐμοὶ δ᾽ὁποίαν ἀρετὰν	u- u-u u- u-- uu-	lyric	
ἔδωκε πότμος ἄναξ,	u-u -u u-	lyric	
εὖ οἶδʼ ὅτι χρόνος ἕρπων πεπρωμέναν τελέσει.	- - u- uu -- --u- uu-	lyric	
ἐξύφαινε, γλυκεῖα, καὶ τόδʼ αὐτίκα, φόρμιγξ,	-u-u u-u - u -uu --	lyric	
Λυδίᾳ σὺν ἁρμονίᾳ μέλος πεφιλημένον	-u- u -uu- u- uu-u-	lyric	
Οἰνώνᾳ τε καὶ Κύπρῳ, ἔνθα Τεῦκρος ἀπάρχει	--- u - uu -u -u u--	lyric	
ὁ Τελαμωνιάδας· ἀτὰρ	u uu-uu- u-	lyric	
Αἴας Σαλαμῖνʼ ἔχει πατρῴαν·	-- uu- u- u--	lyric	
ἐν δ᾽Εὐξείνῳ πελάγει φαεννὰν Ἀχιλεὺς	- --- uu- u-- uu-	lyric	
νᾶσον· Θέτις δὲ κρατεῖ	-- u- u u-	lyric	
Φθίᾳ· Νεοπτόλεμος δ᾽Ἀπείρῳ διαπρυσίᾳ,	-- u-uu- --- u-uu-	lyric	
βουβόται τόθι πρῶνες ἔξοχοι κατάκεινται	-u- uu -u -u- uu--	lyric	
Δωδώναθεν ἀρχόμενοι πρὸς Ἰόνιον πόρον.	---u -uu- u -uu- u-	lyric	
Παλίου δὲ πὰρ ποδὶ λατρίαν Ἰαωλκὸν	-u- u - uu -u- uu--	lyric	
πολεμίᾳ χερὶ προστραπὼν	uuu- uu -u-	lyric	
Πηλεὺς παρέδωκεν Αἱμόνεσσιν	-- uu-u -u--	lyric	
δάμαρτος Ἱππολύτας Ἄκαστος δολίαις	u-u -uu- u-- uu-	lyric	
τέχναισι χρησάμενος·	--u -uu-	lyric	
τᾷ Δαιδάλου τε μαχαίρᾳ φύτευέ οἱ θάνατον	- -u- u u-- u-u - uu-	lyric	
ἐκ λόχου, Πελίαο παῖς· ἄλαλκε δὲ Χείρων,	- u- uu-u - u-u u --	lyric	
καὶ τὸ μόρσιμον Διόθεν πεπρωμένον ἔκφερεν·	- u -u- uu- u-uu -u-	lyric	
πῦρ δὲ παγκρατὲς θρασυμαχάνων τε λεόντων	- u -u- uu-u- u u--	lyric	
ὄνυχας ὀξυτάτους ἀκμὰν	uuu -uu- u-	lyric	
καὶ δεινοτάτων σχάσαις ὀδόντων	- -uu- u- u--	lyric	
ἔγαμεν ὑψιθρόνων μίαν Νηρεΐδων,	u-u -uu- u- -uu-	lyric	
εἶδεν δ᾽εὔκυκλον ἕδραν,	-- --u u-	lyric	
τᾶς οὐρανοῦ βασιλῆες πόντου τ᾽ἐφεζόμενοι	- -u- uu-- -- u-uu-	lyric	
δῶρα καὶ κράτος ἐξέφαναν ἐγγενὲς αὐτῷ.	-u - uu -u-u -uu --	lyric	
Γαδείρων τὸ πρὸς ζόφον οὐ περατόν· ἀπότρεπε	--- u - uu - u-u u-u-	lyric	
αὖτις Εὐρώπαν ποτὶ χέρσον ἔντεα ναός·	-u --- uu -u -uu --	lyric	
ἄπορα γὰρ λόγον Αἰακοῦ	uuu - uu -u-	lyric	
παίδων τὸν ἅπαντά μοι διελθεῖν.	-- u u-u - u--	lyric	
Θεανδρίδαισι δ᾽ἀεξιγυίων ἀέθλων	u-u-u u-u-- uu-	lyric	
κάρυξ ἑτοῖμος ἔβαν	-- u-u u-	lyric	
Οὐλυμπίᾳ τε καὶ Ἰσθμοῖ Νεμέᾳ τε συνθέμενος,	--u- u u -- u- u -uu-	lyric	
ἔνθα πεῖραν ἔχοντες οἴκαδε κλυτοκάρπων	-u -u u-u -u- uu--	lyric	
οὐ νέοντʼ ἄνευ στεφάνων, πάτραν ἵνʼ ἀκούομεν,	- u- u- uu- u- u u-u-	lyric	
Τιμάσαρχε, τεὰν ἐπινικίοισιν ἀοιδαῖς	-u-u - uu-u-u u--	lyric	
πρόπολον ἔμμεναι. εἰ δέ τοι	uuu -uu - u -	lyric	
μάτρῳ μ᾽ἔτι Καλλικλεῖ κελεύεις	-- uu -u- u--	lyric	
στάλαν θέμεν Παρίου λίθου λευκοτέραν·	-- u- uu- u- -uu-	lyric	
ὁ χρυσὸς ἑψόμενος	- -u -uu-	lyric	
αὐγὰς ἔδειξεν ἁπάσας, ὕμνος δὲ τῶν ἀγαθῶν	-- u-u u-- -- u - uu-	lyric	
ἑργμάτων βασιλεῦσιν ἰσοδαίμονα τεύχει	-u- uu-u -u-uu --	lyric	
φῶτα· κεῖνος ἀμφʼ Ἀχέροντι ναιετάων ἐμὰν	-u -u - uu-u -uu- u-	lyric	
γλῶσσαν εὑρέτω κελαδῆτιν, Ὀρσοτριαίνα	-u -u- uu-u -uu--	lyric	
ἵνʼ ἐν ἀγῶνι βαρυκτύπου	u u u-u u-u-	lyric	
θάλησε Κορινθίοις σελίνοις·	--u u-u- u--	lyric	
τὸν Εὐφάνης ἐθέλων γεραιὸς προπάτωρ	u -u- uu- u-- uu-	lyric	
σὸς ἄεισέν ποτε, παῖ.	u --- uu -	lyric	
ἄλλοισι δ᾽ἅλικες ἄλλοι· τὰ δ᾽αὐτὸς ἄν τις ἴδῃ,	--u -uu -- u -u - u u-	lyric	
ἔλπεταί τις ἕκαστος ἐξοχώτατα φάσθαι.	-u- u u-u -u-uu --	lyric	
οἷον αἰνέων κε Μελησίαν ἔριδα στρέφοι,	-u -u- u u-u- uu- u-	lyric	
ῥήματα πλέκων, ἀπάλαιστος ἐν λόγῳ ἕλκειν,	-u- u- uu-u - uu --	lyric	
μαλακὰ μὲν φρονέων ἐσλοῖς,	uuu - uu- u-	lyric	
τραχὺς δὲ παλιγκότοις ἔφεδρος.	-- u u-u- u--	lyric	
οὐκ ἀνδριαντοποιός εἰμʼ, ὥστʼ ἐλινύσοντα ἐργάζεσθαι ἀγάλματʼ ἐπʼ αὐτᾶς βαθμίδος	- -u-u-u - - u---u ---u u-u u -- -u-	lyric	
ἑσταότʼ· ἀλλʼ ἐπὶ πάσας ὁλκάδος ἔν τ᾽ἀκάτῳ, γλυκεῖʼ ἀοιδά,	-uu - uu -- -uu - uu- u- u--	lyric	
στεῖχʼ ἀπʼ Αἰγίνας, διαγγέλλοισʼ, ὅτι	- u --- u--- u-	lyric	
Λάμπωνος υἱὸς Πυθέας εὐρυσθενὴς	--u -- -u- --u-	iambic trimeter (tragic)	
νίκη Νεμείοις παγκρατίου στέφανον,	-- u-- -uu- uu-	lyric	
οὔπω γένυσι φαίνων τέρειναν ματέρʼ οἰνάνθας ὀπώραν,	-- uuu -- u-- -u --- u--	lyric	
ἐκ δὲ Κρόνου καὶ Ζηνὸς ἥρωας αἰχματὰς φυτευθέντας καὶ ἀπὸ χρυσεᾶν Νηρηΐδων	- - u- - -u --u --- u--- u u- uu- --u-	lyric	
Αἰακίδας ἐγέραιρεν ματρόπολίν τε, φίλαν ξένων ἄρουραν·	-uu- uu-- -uu- u u- u- u--	lyric	
τάν ποτʼ εὔανδρόν τε καὶ ναυσικλυτὰν	- u --- u - --u-	lyric	
θέσσαντο πὰρ βωμὸν πατέρος Ἑλλανίου	--u - -- uuu --u-	lyric	
στάντες, πίτναν τ᾽ἐς αἰθέρα χεῖρας ἁμᾷ	-- u- u -uu -u u-	lyric	
Ἐνδαΐδος ἀριγνῶτες υἱοὶ καὶ βία Φώκου κρέοντος,	--uu u--u -- - u- -- u--	lyric	
ὁ τᾶς θεοῦ, ὃν Ψαμάθεια τίκτʼ ἐπὶ ῥηγμῖνι πόντου.	u - uu - uu-u - u- --u --	lyric	
αἰδέομαι μέγα εἰπεῖν ἐν δίκᾳ τε μὴ κεκινδυνευμένον,	-uu- uu -- - u- u - u---u-	lyric	
πῶς δὴ λίπον εὐκλέα νᾶσον, καὶ τίς ἄνδρας ἀλκίμους	- - uu -uu -- - u -- -u-	lyric	
δαίμων ἀπʼ Οἰνώνας ἔλασεν.στάσομαι· οὔ τοι ἅπασα κερδίων	-- u --- uu--uu - u u-u -u-	lyric	
φαίνοισα πρόσωπον ἀλάθειʼ ἀτρεκής·	--u u-u u-- -u-	lyric	
καὶ τὸ σιγᾶν πολλάκις ἐστὶ σοφώτατον ἀνθρώπῳ νοῆσαι.	- u -- -uu -u u-uu --- u--	lyric	
εἰ δ᾽ὄλβον ἢ χειρῶν βίαν ἢ σιδαρίταν ἐπαινῆσαι πόλεμον δεδόκηται, μακρά μοι	- -u - -- u- - u--- u--- uu- uu-- -u -	lyric	
αὐτόθεν ἅλμαθʼ ὑποσκάπτοι τις· ἔχω γονάτων ἐλαφρὸν ὁρμάν·	-uu -u u--- u u- uu- u-u --	lyric	
καὶ πέραν πόντοιο πάλλοντʼαἰετοί.	- u- --u ---u-	lyric	
πρόφρων δὲ καὶ κείνοις ἄειδʼ ἐν Παλίῳ	-- u - -- u- - -u-	iambic trimeter (tragic)	
Μοισᾶν ὁ κάλλιστος χορός, ἐν δὲ μέσαις	-- u --- uu - u u-	lyric	
φόρμιγγʼ Ἀπόλλων ἑπτάγλωσσον χρυσέῳ πλάκτρῳ διώκων	-- u-- -u-- -u- -- u--	lyric	
ἁγεῖτο παντοίων νόμων· αἱ δὲ πρώτιστον μὲν ὕμνησαν Διὸς ἀρχόμεναι σεμνὰν Θέτιν	--u --- u- - u --- u --- uu -uu- -- u-	lyric	
Πηλέα θ᾽,ὥς τέ νιν ἁβρὰ Κρηθεῒς Ἱππολύτα δόλῳ πεδᾶσαι	-uu - u u -- -uu -uu- u- u--	lyric	
ἤθελε ξυνᾶνα Μαγνήτων σκοπὸν	-u- --u --- u-	lyric	
πείσαισʼ ἀκοίταν ποικίλοις βουλεύμασιν,	-- u-- -u- --u-	iambic trimeter (tragic)	
ψεύσταν δὲ ποιητὸν συνέπαξε λόγον,	-- u --- uu-u u-	lyric	
ὡς ἆρα νυμφείας ἐπείρα κεῖνος ἐν λέκτροις Ἀκάστου	- -u --- u-- -u - -- u--	lyric	
εὐνᾶς. τὸ δ᾽ἐναντίον ἔσκεν· πολλὰ γάρ νιν παντὶ θυμῷ	-- u u-uu -- -u - - -u --	lyric	
παρφαμένα λιτάνευεν· τοῦ δὲ ὀργὰν κνίζον αἰπεινοὶ λόγοι·	-uu- uu-- - u -- -u --- u-	lyric	
εὐθὺς δ᾽ἀπανάνατο νύμφαν, ξεινίου πατρὸς χόλον	-- uu-uu -- -u- -- u-	lyric	
δείσαις· ὁ δ᾽ἐφράσθη κατένευσέν τέ οἱ ὀρσινεφὴς ἐξ οὐρανοῦ	-- u --- uu-- u u -uu- - -u-	lyric	
Ζεὺς ἀθανάτων βασιλεύς, ὥστʼ ἐν τάχει	- -uu- uu- - - u-	lyric	
ποντίαν χρυσαλακάτων τινὰ Νηρεΐδων πράξειν ἄκοιτιν,	-u- --uu- uu -uu- -- u--	lyric	
γαμβρὸν Ποσειδάωνα πείσαις, ὃς Αἰγᾶθεν ποτὶ κλειτὰν θαμὰ νίσσεται Ἰσθμὸν Δωρίαν·	-- u---u -- u --- u- -- uu -uu -- -u-	lyric	
ἔνθα μιν εὔφρονες ἶλαι σὺν καλάμοιο βοᾷ θεὸν δέκονται,	-u u -uu -- - uu-u u- u- u--	lyric	
καὶ σθένει γυίων ἐρίζοντι θρασεῖ.	- u- -- u--- u-	lyric	
πότμος δὲ κρίνει συγγενὴς ἔργων περὶ	-- u -- -u- -- u-	iambic trimeter (tragic)	
πάντων. τὺ δ᾽Αἰγίναθε δίς, Εὐθύμενες,	-- u ---u u -uu-	lyric	
Νίκας ἐν ἀγκώνεσσι πίτνων ποικίλων ἔψαυσας ὕμνων.	-- u ---u -- -u- --u --	lyric	
ἤτοι μεταΐξαντα καὶ νῦν τεὸς μάτρως ἀγάλλει κείνου ὁμόσπορον ἔθνος, Πυθέα.	-- u---u - - u- -- u-- -u u-uu -- -u-	lyric	
ἁ Νεμέα μὲν ἄραρεν μείς τ᾽ἐπιχώριος, ὃν φίλησʼ Ἀπόλλων·	- uu- u u-- - uu-uu - u- u--	lyric	
ἅλικας δ᾽ἐλθόντας οἴκοι τ᾽ἐκράτεις	-u- --u -- -u-	lyric	
Νίσου τ᾽ἐν εὐαγκεῖ λόφῳ. χαίρω δ᾽,ὅτι	-- u --- u- -- u-	iambic trimeter (tragic)	
ἐσλοῖσι μάρναται πέρι πᾶσα πόλις.	--u --- uu -u u-	lyric	
ἴσθι, γλυκεῖάν τοι Μενάνδρου σὺν τύχᾳ μόχθων ἀμοιβὰν	-- u-- - u-- - u- -- u--	lyric	
ἐπαύρεο· χρὴ δ᾽ἀπʼ Ἀθανᾶν τέκτονʼ ἀθληταῖσιν ἔμμεν.	u-uu - u u-- -u ---u --	lyric	
εἰ δὲ Θεμίστιον ἵκεις, ὥστʼ ἀείδειν, μηκέτι ῥίγει· δίδοι	- u u-uu -- - u-- -u- -- u-	lyric	
φωνάν, ἀνὰ δ᾽ἱστία τεῖνον πρὸς ζυγὸν καρχασίου,	-- uu -uu -- - u- --u-	lyric	
πύκταν τέ νιν καὶ παγκρατίῳ φθέγξαι ἑλεῖν Ἐπιδαύρῳ διπλόαν	-- u - - -uu- -u u- uu-- -u-	lyric	
νικῶντʼ ἀρετάν, προθύροισιν δ᾽Αἰακοῦ	-- uu- uu-- -u-	lyric	
ἀνθέων ποιάεντα φέρε στεφανώματα σὺν ξανθαῖς Χάρισσιν.	-u- --u u- uu-uu - -- u--	lyric	
ἓν ἀνδρῶν, ἓν θεῶν γένος· ἐκ μιᾶς δὲ πνέομεν	u -- - u- uu - u- u uu-	lyric	
ματρὸς ἀμφότεροι· διείργει δὲ πᾶσα κεκριμένα	-u -uu- u-- u -u -uu-	lyric	
δύναμις, ὡς τὸ μὲν οὐδέν, ὁ δὲ χάλκεος ἀσφαλὲς αἰὲν ἕδος	uuu - u u -u u u -uu -uu -u u-	lyric	
μένει οὐρανός. ἀλλά τι προσφέρομεν ἔμπαν ἢ μέγαν	uu -uu -u u -uuu -u - u-	lyric	
νόον ἤτοι φύσιν ἀθανάτοις,	uu -- uu -uu-	lyric	
καίπερ ἐφαμερίαν οὐκ εἰδότες οὐδὲ μετὰ νύκτας	-u u-uu- - -uu -u uu --	lyric	
ἄμμε πότμος	-u --	lyric	
ἅντινʼ ἔγραψε δραμεῖν ποτὶ στάθμαν.	-u --u u- u- u-	lyric	
τεκμαίρει καί νυν Ἀλκιμίδας τὸ συγγενὲς ἰδεῖν	u-- - u -uu- u -uu u-	lyric	
ἄγχι καρποφόροις ἀρούραισιν, αἵτʼ ἀμειβόμεναι	-u -uu- u--u - u-uu-	lyric	
τόκα μὲν ὦν βίον ἀνδράσιν ἐπηετανὸν πεδίων ἔδοσαν,	uu u - uu -uu u-uu- uu- uu-	lyric	
τόκα δ᾽αὖτʼ ἀναπαυσάμεναι σθένος ἔμαρψαν. ἦλθέ τοι	uu - uu-uu- uu u-u -u -	lyric	
Νεμέας ἐξ ἐρατῶν ἀέθλων	uu- - uu- uu-	lyric	
παῖς ἐναγώνιος, ὃς ταύταν μεθέπων Διόθεν αἶσαν	- uu-uu - -- uu- uuu --	lyric	
νῦν πέφανται	- u--	lyric	
οὐκ ἄμμορος ἀμφὶ πάλᾳ κυναγέτας,	- -uu -u u- u-u-	lyric	
ἴχνεσιν ἐν Πραξιδάμαντος ἑὸν πόδα νέμων	-uu - -uu-u u- uu u-	lyric	
πατροπάτορος ὁμαιμίοις.	-uuuu u-u-	lyric	
κεῖνος γὰρ Ὀλυμπιόνικος ἐὼν Αἰακίδαις	-- u u-uu-u u- -uu-	lyric	
ἔρνεα πρῶτος ἔνεικεν ἀπʼ Ἀλφεοῦ,	-uu -u u-u u -u-	lyric	
καὶ πεντάκις Ἰσθμοῖ στεφανωσάμενος,	- -uu -- uu-uu-	lyric	
νεμέᾳ δὲ τρίς,	uu- u -	lyric	
ἔπαυσε λάθαν	u-u --	lyric	
Σαοκλείδα, ὃς ὑπέρτατος	---- u u-u-	lyric	
Ἁγησιμάχῳ υἱέων γένετο.	--uu- uu- uu-	anapaestic	
ἐπεί οἱ τρεῖς ἀεθλοφόροι πρὸς ἄκρον ἀρετᾶς	u- - - u-uu- u -u uu-	lyric	
ἦλθον, οἵτε πόνων ἐγεύσαντο. σὺνθεοῦ δὲ τύχᾳ	-u -u u- u--u -u- u u-	lyric	
ἕτερον οὔ τινα οἶκον ἀπεφάνατο πυγμαχία πλεόνων	uuu - uu -u uu-uu -uu- uu-	lyric	
ταμίαν στεφάνων μυχῷ Ἑλλάδος ἁπάσας. ἔλπομαι	uu- uu- uu -uu u-- -u-	lyric	
μέγα εἰπὼν σκοποῦ ἄντα τυχεῖν	uu -- uu -u u-	lyric	
ὥτʼ ἀπὸ τόξου ἱείς· εὔθυνʼ ἐπὶ τοῦτον, ἄγε, Μοῖσα,	- uu -u u- -- uu -u uu --	lyric	
οὖρον ἐπέων	-u uu-	lyric	
εὐκλέα. παροιχομένων γὰρ ἀνέρων	-uu u-uu- u -u-	lyric	
ἀοιδαὶ καὶ λόγοι τὰ καλά σφιν ἔργʼ ἐκόμισαν,	u-- - u- u u- u - uuu-	lyric	
Βασσίδαισιν ἅ τ᾽οὐ σπανίζει· παλαίφατος γενεά,	-u-u u - u-- u-u- uu-	lyric	
ἴδια ναυστολέοντες ἐπικώμια, Πιερίδων ἀρόταις	uuu -uu-u uu-uu -uu- uu-	lyric	
δυνατοὶ παρέχειν πολὺν ὕμνον ἀγερώχων ἑργμάτων	uu- uu- uu -u uu-- -u-	lyric	
ἕνεκεν. καὶ γὰρ ἐν ἀγαθέᾳ	uu- - u u -uu-	lyric	
χεῖρας ἱμάντι δεθεὶς Πυθῶνι κράτησεν ἀπὸ ταύτας	-u u-u u- --u u-u uu --	lyric	
αἷμα πάτρας	-u --	lyric	
χρυσαλακάτου ποτὲ Καλλίας ἁδὼν	--uu- uu -u- u-	lyric	
ἔρνεσι Λατοῦς, παρὰ Κασταλίᾳ τε Χαρίτων	-uu -- uu -uu- u uu-	lyric	
ἑσπέριος ὁμάδῳ φλέγεν·	-uuu uu- u-	lyric	
πόντου τε γέφυρʼ ἀκάμαντος ἐν ἀμφικτιόνων	-- u u- uu-u u --uu-	lyric	
ταυροφόνῳ τριετηρίδι Κρεοντίδαν	-uu- uu-uu -u-	lyric	
τίμασε Ποσειδάνιον ἂν τέμενος·	--u u--uu - uu-	lyric	
βοτάνα τέ νιν	uu- u -	lyric	
πόθʼ ἁ λέοντος	u - u--	lyric	
νικάσαντʼ ἤρεφε δασκίοις	--- -uu -u-	lyric	
Φλιοῦντος ὑπʼ ὠγυγίοις ὄρεσιν.	--u u -uu- uu-	anapaestic	
πλατεῖαι πάντοθεν λογίοισιν ἐντὶ πρόσοδοι	u-- -u- uu-u -u uu-	lyric	
νᾶσον εὐκλέα τάνδε κοσμεῖν· ἐπεί σφιν Αἰακίδαι	-u -uu -u -- u- u -uu-	lyric	
ἔπορον ἔξοχον αἶσαν ἀρετὰς ἀποδεικνύμενοι μεγάλας·	uuu -uu -u uu- uu-uu- uu-	lyric	
πέταται δ᾽ἐπί τε χθόνα καὶ διὰ θαλάσσας τηλόθεν	uu- uu - uu - uu u-- -u-	lyric	
ὄνυμʼ αὐτῶν· καὶ ἐς Αἰθίοπας	uu -- u u -uu-	lyric	
Μέμνονος οὐκ ἀπονοστήσαντος ἐπᾶλτο· βαρὺ δέ σφιν	-uu - uu---u u-u uu - -	lyric	
νεῖκος Ἀχιλεὺς	-u uu-	lyric	
ἔμπεσε χαμαὶ καταβὰς ἀφʼ ἁρμάτων,	-uu u- uu- u -u-	lyric	
φαεννᾶς υἱὸν εὖτʼ ἐνάριξεν Ἀόος ἀκμᾷ	u-- -u - uu-u -uu u-	lyric	
ἔγχεος ζακότοιο. καὶ ταύταν μὲν παλαιότεροι	-u- uu-u - -u - u-uu-	lyric	
ὁδὸν ἀμαξιτὸν εὗρον· ἕπομαι δὲ καὶ αὐτὸς ἔχων μελέταν·	uu u-uu -u uu- u u -u u- uu-	lyric	
τὸ δὲ πὰρ ποδὶ ναὸς ἑλισσόμενον αἰεὶ κυμάτων	u u - uu -u u-uuu -- -u-	lyric	
λέγεται παντὶ μάλιστα δονεῖν	uu- -u u-u u-	lyric	
θυμόν. ἑκόντι δ᾽ἐγὼ νώτῳ μεθέπων δίδυμον ἄχθος	-u u-u u- -- uu- uuu --	lyric	
ἄγγελος ἔβαν,	-uu u-	lyric	
πέμπτον ἐπὶ εἴκοσι τοῦτο γαρύων	-u uu -uu -u -u-	lyric	
εὖχος ἀγώνων ἄπο, τοὺς ἐνέποισιν ἱερούς,	-u u-- uu - uu-u uu-	lyric	
Ἀλκιμίδα, τέ γ᾽ἐπαρκέσαι	-uuu u u-u-	lyric	
κλειτᾷ γενεᾷ· δύο μὲν Κρονίου πὰρ τεμένει,	-- uu- uu - uu- - uu-	lyric	
παῖ, σέ τ᾽ἐνόσφισε καὶ Πολυτιμίδαν	- u u-uu - uu-u-	lyric	
κλᾶρος προπετὴς ἄνθεʼ Ὀλυμπιάδος.	-- uu- -u u-uu-	lyric	
δελφῖνί κεν	--u -	lyric	
τάχος διʼ ἅλμας	u- u --	lyric	
ἴσον κ᾽ εἴποιμι Μελησίαν,	-- --u u-u-	lyric	
χειρῶν τε καὶ ἰσχύος ἁνίοχον.	-- u u -uu -uu-	anapaestic	
Ἐλείθυια, πάρεδρε Μοιρᾶν βαθυφρόνων,	u--u u-u -- u-u-	lyric	
παῖ μεγαλοσθενέος, ἄκουσον, Ἥρας, γενέτειρα τέκνων· ἄνευ σέθεν	- uu-uuu u-u -- uu-u -- u- u-	lyric	
οὐ φάος, οὐ μέλαιναν δρακέντες εὐφρόναν	- uu - u-- u-u -u-	lyric	
τεὰν ἀδελφεὰν ἐλάχομεν ἀγλαόγυιον Ἥβαν.	u- u-- uuuu -uu-u --	lyric	
ἀναπνέομεν δ᾽οὐχ ἅπαντες ἐπὶ ἴσα·	u-uu- - u-u uu u-	lyric	
εἴργει δὲ πότμῳ ζυγένθʼ ἕτερον ἕτερα. σὺν δὲ τὶν	-- u u- u- uuu uuu - u -	lyric	
καὶ παῖς ὁ Θεαρίωνος ἀρετᾷ κριθεὶς	- - u u-u-u uu- u-	lyric	
εὔδοξος ἀείδεται Σωγένης μετὰ πενταέθλοις.	--u u-u- -u- uu -u--	lyric	
πόλιν γὰρ φιλόμολπον οἰκεῖ δορικτύπων	u- - uu-u -- u-u-	lyric	
Αἰακιδᾶν· μάλα δ᾽ἐθέλοντι σύμπειρον ἀγωνίᾳ θυμὸν ἀμφέπειν.	-uu- uu uu-u --u u-u- -u -u-	lyric	
εἰ δὲ τύχῃ τις ἔρδων, μελίφρονʼ αἰτίαν	- u u- u -- u-u -u-	lyric	
ῥοαῖσι Μοισᾶν ἐνέβαλε· ταὶ μεγάλαι γὰρ ἀλκαὶ	u-u -- uuuu - uu- u --	lyric	
σκότον πολὺν ὕμνων ἔχοντι δεόμεναι·	u- uu -- u-u uuu-	lyric	
ἔργοις δὲ καλοῖς ἔσοπτρον ἴσαμεν ἑνὶ σὺν τρόπῳ,	-- u u- u-u uuu uu - u-	lyric	
εἰ Μναμοσύνας ἕκατι λιπαράμπυκος	- -uu- u-u uu-u-	lyric	
εὕρηται ἄποινα μόχθων κλυταῖς ἐπέων ἀοιδαῖς.	--u u-u -- u- uu- u--	lyric	
σοφοὶ δὲ μέλλοντα τριταῖον ἄνεμον	u- u --u u-u uu-	lyric	
ἔμαθον, οὐδʼ ὑπὸ κέρδει βλάβεν·	uuu - uu -- u-	lyric	
ἀφνεὸς πενιχρός τε θανάτου πέρας	-u- uu- u uu- u-	lyric	
σᾶμα νέονται. ἐγὼ δὲ πλέονʼ ἔλπομαι	-u -u u- u uu -u-	lyric	
λόγον Ὀδυσσέος ἢ πάθαν διὰ τὸν ἁδυεπῆ γενέσθʼ Ὅμηρον·	uu u-uu - u- uu u -uu- u- u--	lyric	
ἐπεὶ ψεύδεσί οἱ ποτανᾷ τε μαχανᾷ	u- -uu - u-- u -u-	lyric	
σεμνὸν ἔπεστί τι· σοφία δὲ κλέπτει παράγοισα μύθοις· τυφλὸν δ᾽ἔχει	-u u-u u uu- u -- uu-u -- u- u-	lyric	
ἦτορ ὅμιλος ἀνδρῶν ὁ πλεῖστος. εἰ γὰρ ἦν	-u u-u -- u -u - u -	lyric	
ἓ τὰν ἀλάθειαν ἰδέμεν, οὔ κεν ὅπλων χολωθεὶς	u - u--u uuu - u u- u--	lyric	
ὁ καρτερὸς Αἴας ἔπαξε διὰ φρενῶν	u -uu -- u-u uu u-	lyric	
λευρὸν ξίφος· ὃν κράτιστον Ἀχιλέος ἄτερ μάχᾳ	-- uu - u-u uuuu u- u-	lyric	
ξανθῷ Μενέλᾳ δάμαρτα κομίσαι θοαῖς	-- uu- u-u uu- u-	lyric	
ἐν ναυσὶ πόρευσαν εὐθυπνόου Ζεφύροιο πομπαὶ	- -u u-u --u- uu-u --	lyric	
πρὸς Ἴλου πόλιν. ἀλλὰ κοινὸν γὰρ ἔρχεται	u -- uu -u -- u -u-	lyric	
κῦμʼ Ἀΐδα, πέσε δ᾽ἀδόκητον ἐν καὶ δοκέοντα· τιμὰ δὲ γίνεται	- uu- uu uu-u - - uu-u -- u -u-	lyric	
ὧν θεὸς ἁβρὸν αὔξει λόγον τεθνακότων	- uu -u -- u- u-u-	lyric	
βοαθόων, τοὶ παρὰ μέγαν ὀμφαλὸν εὐρυκόλπου	u-u- - uu uu -uu -u--	lyric	
μόλον χθονός· ἐν Πυθίοισι δὲδαπέδοις	u- uu - -u-u uuu-	lyric	
κεῖται, Πριάμου πόλιν Νεοπτόλεμος ἐπεὶ πράθεν,	-- uu- u- uuuuu u- u-	lyric	
τᾷ καὶ Δαναοὶ πόνησαν· ὁ δ᾽ἀποπλέων	- - uu- u-u u u-u-	lyric	
Σκύρου μὲν ἅμαρτε, πλαγχθέντες δ᾽εἰς Ἐφύραν ἵκοντο·	-- u u-u --- - uu- u--	lyric	
Μολοσσίᾳ δ᾽ἐμβασίλευεν ὀλίγον	u-u- -uu-u uu-	lyric	
χρόνον· ἀτὰρ γένος αἰεὶ φέρεν	uu u- uu -- u-	lyric	
τοῦτό οἱ γέρας. ᾤχετο δὲ πρὸς θεόν,	-u - uu -uu u - u-	lyric	
κτέανʼ ἄγων Τρωΐαθεν ἀκροθινίων·	uu u- uu-u uu-u-	lyric	
ἵνα κρεῶν νιν ὑπὲρ μάχας ἔλασεν ἀντιτυχόντʼ ἀνὴρ μαχαίρᾳ.	uu u- u u- u- uuu -uu- u- u--	lyric	
βάρυνθεν δὲ περισσὰ Δελφοὶ ξεναγέται.	u-- u u-u -- u-u-	lyric	
ἀλλὰ τὸ μόρσιμον ἀπέδωκεν· ἐχρῆν δέ τινʼ ἔνδον ἄλσει παλαιτάτῳ	-u u -uu uu-u -- u u -u -- u-u-	lyric	
Αἰακιδᾶν κρεόντων τὸ λοιπὸν ἔμμεναι	-uu- u-- u -u -u-	lyric	
θεοῦ παρʼ εὐτειχέα δόμον, ἡρωΐαις δὲ πομπαῖς	u- u --uu uu -uu- u --	lyric	
θεμισκόπον οἰκεῖν ἐόντα πολυθύτοις.	u-uu -- u-u uuu-	lyric	
εὐώνυμον ἐς δίκαν τρία ἔπεα διαρκέσει·	--uu - u- uu uuu u-u-	lyric	
οὐ ψεῦδις ὁ μάρτυς ἔργμασιν ἐπιστατεῖ,	- -u u -u -uu u-u-	lyric	
Αἴγινα, τεῶν Διός τ᾽ἐκγόνων. θρασύ μοι τόδʼ εἰπεῖν	--u u- u- -u- uu - u --	lyric	
φαενναῖς ἀρεταῖς ὁδὸν κυρίαν λόγων	u-- uu- u- -u- u-	lyric	
οἴκοθεν· ἀλλὰ γὰρ ἀνάπαυσις ἐν παντὶ γλυκεῖα ἔργῳ· κόρον δ᾽ἔχει	-uu -u u uu-u - -u u-u -- u- u-	lyric	
καὶ μέλι καὶ τὰ τέρπνʼ ἄνθεʼ Ἀφροδίσια.	- uu - u - -u -u-u-	lyric	
φυᾷ δ᾽ἕκαστος διαφέρομεν βιοτὰν λαχόντες,	u- u-- uuuu- uu- u--	lyric	
ὁ μὲν τά, τὰ δ᾽ἄλλοι· τυχεῖν δ᾽ἕνʼ ἀδύνατον	u - u u -- u- u uuu-	lyric	
εὐδαιμονίαν ἅπασαν ἀνελόμενον· οὐκ ἔχω	--uu- u-u uuuuu - u-	lyric	
εἰπεῖν, τίνι τοῦτο Μοῖρα τέλος ἔμπεδον	-- uu -u -u uu -u-	lyric	
ὤρεξε. Θεαρίων, τὶν δ᾽ἐοικότα καιρὸν ὄλβου	--u u-u- - u-uu -u --	lyric	
δίδωσι, τόλμαν τε καλῶν ἀρομένῳ	u-u -- u u- uuu-	lyric	
σύνεσιν οὐκ ἀποβλάπτει φρενῶν.	uuu - uu-- u-	lyric	
ξεῖνός εἰμι· σκοτεινὸν ἀπέχων ψόγον,	-u -u u-u uu- u-	lyric	
ὕδατος ὥτε ῥοὰς φίλον ἐς ἄνδρʼ ἄγων	uuu -u u- uu u - u-	lyric	
κλέος ἐτήτυμον αἰνέσω· ποτίφορος δ᾽ἀγαθοῖσι μισθὸς οὗτος.	uu u-uu -u- uuu- uu-u -u --	lyric	
ἐὼν δ᾽ἐγγὺς Ἀχαιὸς οὐ μέμψεταί μ᾽ἀνὴρ	u- -u u-u - -u- u-	lyric	
Ἰονίας ὑπὲρ ἁλὸς οἰκέων καὶ προξενίᾳ πέποιθʼ· ἔν τε δαμόταις	-uu- uu uu -- - -uu- u- - u -u-	lyric	
ὄμματι δέρκομαι λαμπρόν, οὐχ ὑπερβαλών,	-uu -u- -u - u-u-	lyric	
βίαια πάντʼ ἐκ ποδὸς ἐρύσαις, ὁ δὲ λοιπὸς εὔφρων	u-u - - uu uu- u u -u --	lyric	
ποτὶ χρόνος ἕρποι. μαθὼν δέ τις ἀνερεῖ,	u- uu -- u- u u uu-	lyric	
εἰ πὰρ μέλος ἔρχομαι ψάγιον ὄαρον ἐννέπων.	- - uu -u- uuu uuu -u-	lyric	
Εὐξενίδα πάτραθε Σώγενες, ἀπομνύω	-uuu u-u -uu u-u-	lyric	
μὴ τέρμα προβὰς ἄκονθʼ ὥτε χαλκοπάρᾳον ὄρσαι	- -u u- u- -u -uu-u --	lyric	
θοὰν γλῶσσαν, ὃς ἐξέπεμψεν παλαισμάτων	u- -u u -u-- u-u-	lyric	
αὐχένα καὶ σθένος ἀδίαντον, αἴθωνι πρὶν ἁλίῳ γυῖον ἐμπεσεῖν.	-uu - uu uu-u --u u -u- -u -u-	lyric	
εἰ πόνος ἦν, τὸ τερπνὸν πλέον πεδέρχεται.	- uu - u -- u- u-u-	lyric	
ἔα με· νικῶντί γε χάριν, εἴ τι πέραν ἀερθεὶς	u- u --u u uu - u u- u--	lyric	
ἀνέκραγον, οὐ τραχύς εἰμι καταθέμεν.	u-uu - -u -u uuu-	lyric	
εἴρειν στεφάνους ἐλαφρόν· ἀναβάλεο· Μοῖσά τοι	-- uu- u-u uuuuu -u -	lyric	
κολλᾷ χρυσὸν ἔν τε λευκὸν ἐλέφανθʼ ἁμᾷ	-- uu - u -u uu- u-	lyric	
καὶ λείριον ἄνθεμον ποντίας ὑφελοῖσʼ ἐέρσας.	- -uu -u- -u- uu- u--	lyric	
Διὸς δὲ μεμναμένος ἀμφὶ Νεμέᾳ	u- u --uu -u uu-	lyric	
πολύφατον θρόον ὕμνων δόνει	uuu- uu -- u-	lyric	
ἡσυχᾷ. βασιλῆα δὲ θεῶν πρέπει	-u- uu-u u u- u-	lyric	
δάπεδον ἂν τόδε γαρυέμεν ἁμέρᾳ	uuu - uu -uuu -u-	lyric	
ὀπί· λέγοντι γὰρ Αἰακόν νιν ὑπὸ ματροδόκοις γοναῖς φυτεῦσαι,	uu u-u u -u- u uu -uu- u- u--	lyric	
ἐμᾷ μὲν πολίαρχον εὐωνύμῳ πάτρᾳ,	u- - uu-u --u- u-	lyric	
Ἡράκλεες, σέο δὲ προπράονʼ ἔμμεν ξεῖνον ἀδελφεόν τʼ. εἰ δὲ γεύεται	-uu- uu u u- -- -u u-u- - u -u-	lyric	
ἀνδρὸς ἀνήρ τι, φαῖμέν κε γείτονʼ ἔμμεναι	-u u- u -- u -u -u-	lyric	
νόῳ φιλήσαντʼ ἀτενέϊ γείτονιχάρμα πάντων	u- u-- uuuu -uu-u --	lyric	
ἐπάξιον· εἰ δ᾽αὐτὸ καὶ θεὸς ἀνέχοι,	u-uu - -u - uu uu-	lyric	
ἐν τίν κ᾽ἐθέλοι, Γίγαντας ὃς ἐδάμασας, εὐτυχῶς	- - uu- u-u u uuuu -u-	lyric	
ναίειν πατρὶ Σωγένης ἀταλὸν ἀμφέπων	-- uu -u- uuu -u-	lyric	
θυμὸν προγόνων ἐϋκτήμονα ζαθέαν ἀγυιάν·	-- uu- u--u- uu- u--	lyric	
ἐπεὶ τετραόροισιν ὥθʼ ἁρμάτων ζυγοῖς	u- -uu-u - -u- u-	lyric	
ἐν τεμένεσσι δόμον ἔχει τεοῖς, ἀμφοτέρας ἰὼν χειρός. ὦ μάκαρ,	- uu-u uu u- u- -uu- u- -u - u-	lyric	
τὶν δ᾽ἐπέοικεν Ἥρας πόσιν τε πειθέμεν	- uu-u -- u- u -u-	lyric	
κόραν τε Γλαυκώπιδα· δύνασαι δὲ βροτοῖσιν ἀλκὰν	u- u --uu uu- u u-u --	lyric	
ἀμαχανιᾶν δυσβάτων θαμὰ διδόμεν.	u-uu- -u- uu uu-	lyric	
εἰ γάρ σφισιν ἐμπεδοσθενέα βίοτον ἁρμόσαις	- - uu -u-uuu uuu -u-	lyric	
ἥβᾳ λιπαρῷ τε γήραϊ διαπλέκοις	-- uu- u -uu u-u-	lyric	
εὐδαίμονʼ ἐόντα, παίδων δὲ παῖδες ἔχοιεν αἰεὶ	--u u-u -- u -u u-u --	lyric	
γέρας τό περ νῦν καὶ ἄρειον ὄπιθεν.	u- u - - u u-u uu-	lyric	
τὸ δ᾽ἐμὸν οὔ ποτε φάσει κέαρ	u uu - uu -- u-	lyric	
ἀτρόποισι Νεοπτόλεμον ἑλκύσαι	-u-u u-uuu -u-	lyric	
ἔπεσι· ταὐτὰ δὲ τρὶς τετράκι τ᾽ἀμπολεῖν	uuu -u u - uuu -u-	lyric	
ἀπορία τελέθει, τέκνοισιν ἅτε μαψυλάκας, "Διὸς Κόρινθος."	uuu- uu- u-u uu -uu- u- u--	lyric	
ὥρα πότνια, κάρυξ Ἀφροδίτας ἀμβροσιᾶν φιλοτάτων,	-- -uu -- -u-- -uu- uu--	lyric	
ἅτε παρθενηΐοις παίδων τ᾽ἐφίζοισα γλεφάροις,	-u -u-u- -- u--- uu-	lyric	
τὸν μὲν ἁμέροις ἀνάγκας χερσὶ βαστάζεις, ἕτερον δ᾽ἑτέραις.	- u -u- u-- -u --- uu- uu-	lyric	
ἀγαπατὰ δὲ καιροῦ μὴ πλαναθέντα πρὸς ἔργον ἕκαστον	uu-u u -- - u--u u -u u--	lyric	
τῶν ἀρειόνων ἐρώτων ἐπικρατεῖν δύνασθαι.	- u-u- u-- u-u- u--	lyric	
οἷοι καὶ Διὸς Αἰγίνας τε λέκτρον ποιμένες ἀμφεπόλησαν	-- - uu --- u -- -uu -uu--	lyric	
Κυπρίας δώρων· ἔβλαστεν δ᾽υἱὸς Οἰνώνας βασιλεὺς	-u- -- u-- -u --- uu-	lyric	
χειρὶ καὶ βουλαῖς ἄριστος. πολλά νιν πολλοὶ λιτάνευον ἰδεῖν.	-u - -- u-- -u - -- uu-u u-	lyric	
ἀβοατὶ γὰρ ἡρώων ἄωτοι περιναιεταόντων	uu-u u --- u-- uu-uu--	lyric	
ἤθελον κείνου γε πείθεσθʼ ἀναξίαις ἑκόντες,	-u- -- u -- u-u- u--	lyric	
οἵ τε κρανααῖς ἐν Ἀθάναισιν ἅρμοζον στρατόν,	- - uu- u u--u --- u-	lyric	
οἵ τ᾽ἀνὰ Σπάρταν Πελοπηϊάδαι.	- u- -- uu-uu-	lyric	
ἱκέτας Αἰακοῦ σεμνῶν γονάτων πόλιός θ᾽ὑπὲρ φίλας	uu- -u- -- uu- uu- u- u-	lyric	
ἀστῶν θ᾽ὑπὲρ τῶνδʼ ἅπτομαι φέρων	-- u- - -u- u-	lyric	
Λυδίαν μίτραν καναχηδὰ πεποικιλμέναν,	-u- -- uu-u u--u-	lyric	
Δείνιος δισσῶν σταδίων καὶ πατρὸς Μέγα Νεμεαῖον ἄγαλμα.	-u- -- uu- - u- u- uu-u u--	lyric	
σὺν θεῷ γάρ τοι φυτευθεὶς ὄλβος ἀνθρώποισι παρμονώτερος·	- u- - - u-- -u ---u -u-u-	lyric	
ὅσπερ καὶ Κινύραν ἔβρισε πλούτῳ ποντίᾳ ἔν ποτε Κύπρῳ.	-- - uu- --u -- -uu - uu --	lyric	
ἵσταμαι δὴ ποσσὶ κούφοις, ἀμπνέων τε πρίν τι φάμεν.	-u- - -u -- -u- - - u u-	lyric	
πολλὰ γὰρ πολλᾷ λέλεκται· νεαρὰ δʼἐξευρόντα δόμεν βασάνῳ	-u - -- u-- -u ---u u- uu-	lyric	
ἐς ἔλεγχον, ἅπας κίνδυνος· ὄψον δὲ λόγοι φθονεροῖσιν·	u u-u u- --u -- u u- uu--	lyric	
ἅπτεται δ᾽ἐσλῶν ἀεί, χειρόνεσσι δ᾽οὐκ ἐρίζει.	-u- -- u- -u-u - u--	lyric	
κεῖνος καὶ Τελαμῶνος δάψεν υἱὸν φασγάνῳ ἀμφικυλίσαις.	-- - uu-- -u -- -uu -uu--	lyric	
ἦ τινʼ ἄγλωσσον μέν, ἦτορ δ᾽ἄλκιμον, λάθα κατέχει	- u --- u -- -u- -- uu-	lyric	
ἐν λυγρῷ νείκει· μέγιστον δ᾽αἰόλῳ ψεύδει γέρας ἀντέταται.	- u- -- u-- -u- -- uu -uu-	lyric	
κρυφίαισι γὰρ ἐν ψάφοις Ὀδυσσῆ Δαναοὶ θεράπευσαν·	uu-u u - -- u-- uu- uu--	lyric	
χρυσέων δ᾽Αἴας στερηθεὶς ὅπλων φόνῳ πάλαισεν.	-u- -- u-- u- u- u--	lyric	
ἦ μὰν ἀνόμοιά γε δᾴοισιν ἐν θερμῷ χροῒ	- - uu-u u --u - -- u-	lyric	
ἕλκεα ῥῆξαν πελεμιζόμενοι	-u- -- uu-uu-	lyric	
ὑπʼ ἀλεξιμβρότῳ λόγχᾳ, τὰ μὲν ἀμφʼ Ἀχιλεῖ νεοκτόνῳ,	u u--u- -- u u - uu- u-u-	lyric	
ἄλλων τε μόχθων ἐν πολυφθόροις	-- u -- - u-u-	lyric	
ἁμέραις. ἐχθρὰ δ᾽ἄρα πάρφασις ἦν καὶ πάλαι,	-u- -- uu -uu - - u-	lyric	
αἱμύλων μύθων ὁμόφοιτος, δολοφραδής, κακοποιὸν ὄνειδος·	-u- -- uu-- u-u- uu-u u--	lyric	
ἃ τὸ μὲν λαμπρὸν βιᾶται, τῶν δ᾽ἀφάντων κῦδος ἀντείνει σαθρόν.	- u - -- u-- - u-- -u --- u-	lyric	
εἴη μή ποτέ μοι τοιοῦτον ἦθος, Ζεῦ πάτερ, ἀλλὰ κελεύθοις	-- - uu - --u -- - uu -u u--	lyric	
ἁπλόαις ζωᾶς ἐφαπτοίμαν, θανὼν ὡς παισὶ κλέος	-u- -- u--- u- - -u u-	lyric	
μὴ τὸ δύσφαμον προσάψω. χρυσὸν εὔχονται, πεδίον δ᾽ἕτεροι	- u --- u-- -u --- uu- uu-	lyric	
ἀπέραντον· ἐγὼ δ᾽ἀστοῖς ἁδὼν καὶ χθονὶ γυῖα καλύψαιμʼ,	uu-u u- -- u- - uu -u u--	lyric	
αἰνέων αἰνητά, μομφὰν δ᾽ἐπισπείρων ἀλιτροῖς.	-u- --u -- u--- u--	lyric	
αὔξηται δ᾽ἀρετά, χλωραῖς ἐέρσαις ὡς ὅτε δένδρεον ᾁσσει,	--- uu- -- u-- - uu -uu --	lyric	
ἐν σοφοῖς ἀνδρῶν ἀερθεῖσʼ ἐν δικαίοις τε πρὸς ὑγρὸν	- u- -- u-- - u-- - u u-	lyric	
αἰθέρα. χρεῖαι δὲ παντοῖαι φίλων ἀνδρῶν· τὰ μὲν ἀμφὶ πόνοις	-u- -- u --- u- -- u u -u u-	lyric	
ὑπερώτατα· μαστεύει δὲ καὶ τέρψις ἐν ὄμμασι θέσθαι	uu-uu --- u - -u u -uu --	lyric	
πιστόν. ὦ Μέγα, τὸ δ᾽αὖτις τεὰν ψυχὰν κομίξαι	-u - u- u -- u- -- u--	lyric	
οὔ μοι δυνατόν· κενεᾶν δ᾽ἐλπίδων χαῦνον τέλος·	- - uu- uu- -u- -- u-	lyric	
σεῦ δὲ πάτρᾳ Χαριάδαις τ᾽Ἐλαφρὸν	- u -- -uu- uu-	lyric	
ὑπερεῖσαι λίθον Μοισαῖον ἕκατι ποδῶν εὐωνύμων	uu-- u- --u u-u u- --u-	lyric	
δὶς δὴ δυοῖν. χαίρω δὲ πρόσφορον	- - u- -- u -u-	lyric	
ἐν μὲν ἔργῳ κόμπον ἱείς, ἐπαοιδαῖς δ᾽ἀνὴρ	- u -- -u u- uu-- u-	lyric	
νώδυνον καί τις κάματον θῆκεν. ἦν γε μὰν ἐπικώμιος ὕμνος	-u- - - uu- -u - u - uu-uu --	lyric	
δὴ πάλαι καὶ πρὶν γενέσθαι τὰν Ἀδράστου τάν τε Καδμείων ἔριν.	- u- - - u-- - u-- - u --- u-	lyric	
κωμάσομεν παρʼ Ἀπόλλωνος Σικυώνοθε, Μοῖσαι,	-uu- u u--- uu-uu --	dactylic hexameter	hepthemimeral, trithemimeral
τὰν νεοκτίσταν ἐς Αἴτναν, ἔνθʼ ἀναπεπταμέναι ξείνων νενίκανται θύραι,	- u--- u -- - uu-uu- -- u--- u-	lyric	
ὄλβιον ἐς Χρομίου δῶμʼ. ἀλλʼ ἐπέων γλυκὺν ὕμνον πράσσετε.	-uu - uu- - - uu- uu -- -u-	lyric	
τὸ κρατήσιππον γὰρ ἐς ἃρμʼ ἀναβαίνων ματέρι καὶ διδύμοις παίδεσσιν αὐδὰν μανύει	- u--- u u - uu-- -uu - uu- --u -- -u-	lyric	
Πυθῶνος αἰπεινᾶς ὁμοκλάροις ἐπόπταις.	--u --- u--- u--	lyric	
ἔστι δέ τις λόγος ἀνθρώπων, τετελεσμένον ἐσλὸν	-u u - uu --- uu-uu --	dactylic hexameter	hepthemimeral, trithemimeral
μὴ χαμαὶ σιγᾷ καλύψαι· θεσπεσία δ᾽ἐπέων καύχαις ἀοιδὰ πρόσφορος.	- u- -- u-- -uu- uu- -- u-- -u-	lyric	
ἀλλʼ ἀνὰ μὲν βρομίαν φόρμιγγʼ, ἀνὰ δ᾽αὐλὸν ἐπʼ αὐτὰν ὄρσομεν	- uu - uu- -- uu -u u -- -u-	lyric	
ἱππίων ἄθλων κορυφάν, ἅτε Φοίβῳ θῆκεν Ἄδραστος ἐπʼ Ἀσωποῦ ῥεέθροις· ὧν ἐγὼ	-u- -- uu- uu -- -u u-u u --- u-- - u-	lyric	
μνασθεὶς ἐπασκήσω κλυταῖς ἥρωα τιμαῖς,	-- u--- u- --u --	lyric	
ὃς τότε μὲν βασιλεύων κεῖθι νέαισί θ᾽ἑορταῖς	- uu - uu-- -u u-u u--	dactylic hexameter	trithemimeral
ἰσχύος τ᾽ἀνδρῶν ἁμίλλαις ἅρμασί τε γλαφυροῖς ἄμφαινε κυδαίνων πόλιν.	-u- -- u-- -uu - uu- --u --- u-	lyric	
φεῦγε γὰρ Ἀμφιαρῆ ποτε θρασυμήδεα καὶ δεινὰν στάσιν	-u u -uu- u- uu-uu - -- u-	lyric	
πατρίων οἴκων ἀπό τ᾽Ἄργεος· ἀρχοὶ δ᾽οὐκ ἔτʼ ἔσαν Ταλαοῦ παῖδες, βιασθέντες λύᾳ.	-u- -- uu -uu -- - u u- uu- -- u--- u-	lyric	
κρέσσων δὲ καππαύει δίκαν τὰν πρόσθεν ἀνήρ.	-- u --- u- - -u --	lyric	
ἀνδροδάμαντʼ Ἐριφύλαν, ὅρκιον ὡς ὅτε πιστόν,	-uu- uu-- -uu - uu --	dactylic hexameter	trithemimeral
δόντες Οἰκλείδᾳ γυναῖκα, ξανθοκομᾶν Δαναῶν ἔσσαν μέγιστοι καί ποτε	-u --- u-- -uu- uu- -- u-- - u-	lyric	
ἐσλὸν ἐς ἑπταπύλους Θήβας ἄγαγον στρατὸν ἀνδρῶν αἰσιᾶν	-u u -uu- -- uu- uu -- -u-	lyric	
οὐ κατʼ ὀρνίχων ὁδόν· οὐδὲ Κρονίων ἀστεροπὰν ἐλελίξαις οἴκοθεν μαργουμένους	- u --- uu -u u-- -uu- uu-- -u- --u-	lyric	
στείχειν ἐπώτρυνʼ, ἀλλὰ φείσασθαι κελεύθου.	-- u-- -u --- u--	lyric	
φαινομέναν δ᾽ἄρʼ ἐς ἄταν σπεῦδεν ὅμιλος ἱκέσθαι	-uu- u u -- -u u-u u--	dactylic hexameter	trithemimeral
χαλκέοις ὅπλοισιν ἱππείοις τε σὺν ἔντεσιν· Ἰσμηνοῦ δ᾽ἐπʼ ὄχθαισι γλυκὺν	-u- --u --- u u -uu --- u --- u-	lyric	
νόστον ἐρεισάμενοι λευκανθέα σώματʼ ἐπίαναν καπνόν·	-u u-uu- --uu -u u--- u-	lyric	
ἑπτὰ γὰρ δαίσαντο πυραὶ νεογυίους φῶτας· ὁ δ᾽Ἀμφιαρῇ σχίσσεν κεραυνῷ παμβίᾳ	-u - --u u- uu-- -u u -uu- -- u-- -u-	lyric	
Ζεὺς τὰν βαθύστερνον χθόνα, κρύψεν δ᾽ἅμʼ ἵπποις,	- - u--- u- -- u --	lyric	
δουρὶ Περικλυμένου πρὶν νῶτα τυπέντα μαχατὰν	-u u-uu- - -u u-u u--	dactylic hexameter	masculine penthemimeral
θυμὸν αἰσχυνθῆμεν. ἐν γὰρ δαιμονίοισι φόβοις φεύγοντι καὶ παῖδες θεῶν.	-u ---u - - -uu-u u- --u - -- u-	lyric	
εἰ δυνατόν, Κρονίων, πεῖραν μὲν ἀγάνορα Φοινικοστόλων	- uu- uu- -- u u-uu ---u-	lyric	
ἐγχέων ταύταν θανάτου πέρι καὶζωᾶς ἀναβάλλομαι ὡς πόρσιστα, μοῖραν δ᾽εὔνομον	-u- -- uu- uu --- uu-uu - --u -- -u-	lyric	
αἰτέω σε παισὶν δαρὸν Αἰτναίων ὀπάζειν,	-- u -- -u --- u--	lyric	
Ζεῦ πάτερ, ἀγλαΐαισιν δ᾽ἀστυνόμοις ἐπιμῖξαι	- uu -uu-- -uu- uu--	dactylic hexameter	
λαόν. ἐντί τοι φίλιπποί τ᾽αὐτόθι καὶ κτεάνων ψυχὰς ἔχοντες κρέσσονας	-u -u - u-- -uu - uu- -- u-- -u-	lyric	
ἄνδρες. ἄπιστον ἔειπʼ· αἰδὼς γὰρ ὑπὸ κρύφα κέρδει κλέπτεται,	-u u-u u- -- u u- uu -- -u-	lyric	
ἃ φέρει δόξαν. Χρομίῳ κεν ὑπασπίζων παρὰ πεζοβόαις ἵπποις τε ναῶν τ᾽ἐν μάχαις	- u- -- uu- u u--- uu -uu- -- u -- - u-	lyric	
ἔκρινας ἂν κίνδυνον ὀξείας ἀϋτᾶς,	--u - --u --- u--	lyric	
οὕνεκεν ἐν πολέμῳ κείνα θεὸς ἔντυεν αὐτοῦ	-uu - uu- -- uu -uu --	dactylic hexameter	masculine penthemimeral, hepthemimeral, trithemimeral
θυμὸν αἰχματὰν ἀμύνειν λοιγὸν Ἐνυαλίου. παῦροι δὲ βουλεῦσαι φόνου	-u --- u-- -u u-uu- -- u --- u-	lyric	
παρποδίου νεφέλαν τρέψαι ποτὶ δυσμενέων ἀνδρῶν στίχας	-uu- uu- -- uu -uu- -- u-	lyric	
χερσὶ καὶ ψυχᾷ δυνατοί· λέγεται μὰν Ἕκτορι μὲν κλέος ἀνθῆσαι Σκαμάνδρου χεύμασιν	-u - -- uu- uu- - -uu - uu --- u-- -u-	lyric	
ἀγχοῦ, βαθυκρήμνοισι δ᾽ἀμφʼ ἀκταῖς Ἑλώρου,	-- u---u - -- u--	lyric	
ἔνθα Ῥέας πόρον ἄνθρωποι καλέοισι, δέδορκεν	-u u- uu --- uu-u u--	dactylic hexameter	hepthemimeral, trithemimeral
παιδὶ τοῦθʼ Ἁγησιδάμου φέγγος ἐν ἁλικίᾳ πρώτᾳ· τὰ δ᾽ἄλλαις ἁμέραις	-u - --u-- -u u -uu- -- u -- -u-	lyric	
πολλὰ μὲν ἐν κονίᾳ χέρσῳ, τὰ δὲ γείτονι πόντῳ φάσομαι.	-u u - uu- -- u u -uu -- -u-	lyric	
ἐκ πόνων δ᾽,οἳ σὺν νεότατι γένωνται σύν τε δίκᾳ, τελέθει πρὸς γῆρας αἰὼν ἁμέρα.	- u- - - uu-u u-- - u u- uu- - -u -- -u-	lyric	
ἴστω λαχὼν πρὸς δαιμόνων θαυμαστὸν ὄλβον.	-- u- - -u- --u --	lyric	
εἰ γὰρ ἅμα κτεάνοις πολλοῖς ἐπίδοξον ἄρηται	- u u- uu- -- uu-u u--	dactylic hexameter	masculine penthemimeral, hepthemimeral, trithemimeral
κῦδος, οὐκ ἔστι πρόσωθεν θνατὸν ἔτι σκοπιᾶς ἄλλας ἐφάψασθαι ποδοῖν.	-u - -- u-- -u u- uu- -- u--- u-	lyric	
ἡσυχία δὲ φιλεῖ μὲν συμπόσιον· νεοθαλὴς δ᾽αὔξεται	-uu- u u- - -uu- uu-- -u-	lyric	
μαλθακᾷ νικαφορία σὺν ἀοιδᾷ· θαρσαλέα δὲ παρὰ κρητῆρα φωνὰ γίνεται.	-u- --uu- u u-- -uu- u u- --u -- -u-	lyric	
ἐγκιρνάτω τίς νιν, γλυκὺν κώμου προφάταν,	--u- - - u- -- u--	lyric	
ἀργυρέαισι δὲ νωμάτω φιάλαισι βιατὰν	-uu-u u --- uu-u u--	dactylic hexameter	hepthemimeral
ἀμπέλου παῖδʼ, ἅς ποθʼ ἵπποι κτησάμεναι Χρομίῳ πέμψαν θεμιπλέκτοις ἁμᾷ	-u- - - u -- -uu- uu- -- u--- u-	lyric	
Λατοΐδα στεφάνοις ἐκ τᾶς ἱερᾶς Σικυῶνος. Ζεῦ πάτερ,	-uu- uu- - - uu- uu-- - u-	lyric	
εὔχομαι ταύταν ἀρετὰν κελαδῆσαι σὺν Χαρίτεσσιν, ὑπὲρ πολλῶν τε τιμαλφεῖν λόγοις	-u- -- uu- uu-- - uu-u u- -- u --- u-	lyric	
νίκαν, ἀκοντίζων σκοποῖʼ ἄγχιστα Μοισᾶν.	-- u--- u- --u --	lyric	
Δαναοῦ πόλιν ἀγλαοθρόνων τε πεντήκοντα κορᾶν, Χάριτες,	uu- uu -u-u- u ---u u- uu-	lyric	
Ἄργος Ἥρας δῶμα θεοπρεπὲς ὑμνεῖτε· φλέγεται δ᾽ἀρεταῖς	-u -- -u u-uu --- uu- uu-	lyric	
μυρίαις ἔργων θρασέων ἕνεκεν.	-u- -- uu- uu-	lyric	
μακρὰ μὲν τὰ Περσέος ἀμφὶ Μεδοίσας Γοργόνος·	-u - u -uu -u u-- -u-	lyric	
πολλὰ δ᾽Αἰγύπτῳ καταοίκισεν ἄστη ταῖς Ἐπάφου παλάμαις·	-u --- uu-uu -- - uu- uu-	lyric	
οὐδʼ Ὑπερμνήστρα παρεπλάγχθη, μονόψαφον ἐν κολεῷ κατασχοῖσα ξίφος.	- u--- u--- u--u - u- u--- u-	lyric	
Διομήδεα δ᾽ἄμβροτον ξανθά ποτε Γλαυκῶπις ἔθηκε θεόν·	uu-uu -u- -- u- --u u-u u-	lyric	
γαῖα δ᾽ἐν Θήβαις ὑπέδεκτο κεραυνωθεῖσα Διὸς βέλεσιν	-u - -- uu-u u---u u- uu-	lyric	
μάντιν Οἰκλείδαν, πολέμοιο νέφος·	-u --- uu-u u-	lyric	
καὶ γυναιξὶν καλλικόμοισιν ἀριστεύει πάλαι·	- u-- -uu-u u--- u-	lyric	
Ζεὺς ἐπʼ Ἀλκμήναν Δανάαν τε μολὼντοῦτον κατέφανε λόγον·	- u --- uu- u u--- uu-u u-	lyric	
πατρὶ δ᾽Ἀδράστοιο Λυγκεῖ τε φρενῶν καρπὸν εὐθείᾳ συνάρμοξεν δίκᾳ·	-u ---u -- - u- -u --- u--- u-	lyric	
θρέψε δ᾽αἰχμὰν Ἀμφιτρύωνος. ὁ δ᾽ὄλβῳ φέρτατος	-u -- -uu-u u -- -u-	lyric	
ἵκετʼ ἐς κείνου γενεάν, ἐπεὶ ἐν χαλκέοις ὅπλοις	-u - -- uu- uu - -- u-	lyric	
Τηλεβόας ἔναρεν· τῷ ὄψιν ἐειδόμενος	-uu- uu- - -u u-uu-	lyric	
ἀθανάτων βασιλεὺς αὐλὰν ἐσῆλθεν	-uu- uu- -- u--	lyric	
σπέρμʼ ἀδείμαντον φέρων Ἡρακλέος·οὗ κατʼ Ὄλυμπον	- u--- u- --uu- u u--	lyric	
ἄλοχος Ἥβα τελείᾳ παρὰ ματέρι βαίνοισʼ ἔστι, καλλίστα θεῶν.	uuu -- u-- uu -uu -- -u --- u-	lyric	
βραχύ μοι στόμα πάντʼ ἀναγήσασθʼ, ὅσων Ἀργεῖον ἔχει τέμενος	uu - uu - u--- u- --u u- uu-	lyric	
μοῖραν ἐσλῶν· ἔστι δὲ καὶ κόρος ἀνθρώπων βαρὺς ἀντιάσαι·	-u -- -u u - uu --- uu -uu-	lyric	
ἀλλʼ ὅμως εὔχορδον ἔγειρε λύραν,	- u- --u u-u u-	lyric	
καὶ παλαισμάτων λάβε φροντίδʼ· ἀγών τοι χάλκεος	- u-u- uu -u u- - -u-	lyric	
δᾶμον ὀτρύνει ποτὶ βουθυσίαν Ἥρας ἀέθλων τε κρίσιν·	-u --- uu -uu- -- uu- u u-	lyric	
Οὐλία παῖς ἔνθα νικάσαις δὶς ἔσχεν Θεαῖος εὐφόρων λάθαν πόνων.	-u- - -u --- u -- u-u -u- -- u-	lyric	
ἐκράτησε δὲ καί ποθʼ Ἕλλανα στρατὸν Πυθῶνι, τύχᾳ τε μολὼν	uu-u u - u --- u- --u u- u u-	lyric	
καὶ τὸν Ἰσθμοῖ καὶ Νεμέᾳ στέφανον, Μοίσαισί τ᾽ἔδωκʼ ἀρόσαι,	- u -- - uu- uu- --u u- uu-	lyric	
τρὶς μὲν ἐν πόντοιο πύλαισιλαχών,	- u - --u u-uu-	lyric	
τρὶς δὲ καὶ σεμνοῖς δαπέδοις ἐν Ἀδραστείῳ νόμῳ.	- u - -- uu- u u--- u-	lyric	
Ζεῦ πάτερ, τῶν μὰν ἔραται φρενί, σιγᾷ οἱ στόμα· πᾶν δὲ τέλος	- u- - - uu- uu -- - uu - u u-	lyric	
ἐν τὶν ἔργων· οὐδʼ, ἀμόχθῳ καρδίᾳ προσφέρων τόλμαν, παραιτεῖται χάριν·	- u -- - u-- -u- -u- -- u--- u-	lyric	
γνώτʼ ἀείδω οἷ τε καὶ ὅστις ἁμιλλᾶται περὶ	- u-- - u u -u u--- u-	lyric	
ἐσχάτων ἄθλων κορυφαῖς· ὕπατον δʼἔσχεν Πίσα	-u- -- uu- uu- -- u-	lyric	
Ἡρακλέος τεθμόν· ἁδεῖαί γε μὲν ἀμβολάδαν	-uu- uu --- u u -uu-	lyric	
ἐν τελεταῖς δὶς Ἀθαναίων νιν ὀμφαὶ	- uu- u u--- u --	lyric	
κώμασαν· γαίᾳ δὲ καυθείσᾳ πυρὶ καρπὸς ἐλαίας	-u- -- u --- uu -u u--	lyric	
ἔμολεν Ἥρας τὸν εὐάνορα λαὸν ἐν ἀγγέων ἕρκεσιν παμποικίλοις.	uuu -- u --uu -u u -- -u- --u-	lyric	
ἕπεται δέ, Θεαῖε, ματρώων πολύγνωτον γένος ὑμετέρων	uu- u u-u --- u--- uu -uu-	lyric	
εὐάγων τιμὰ Χαρίτεσσί τε καὶ σὺν Τυνδαρίδαις θαμάκις.	-u- -- uu-u u - - -uu- uu-	lyric	
ἀξιωθείην κεν, ἐὼν Θρασύκλου	-u--- u u- uu-	lyric	
Ἀντία τε ξύγγονος, Ἄργει μὴ κρύπτειν φάος	-u- - -uu -uu - -- u-	lyric	
ὀμμάτων. νικαφορίαις γὰρ ὅσαις Προίτοιο τόδʼ ἱπποτρόφον	-u- --uu- u u- --u u -uu-	lyric	
ἄστυ θάλησεν Κορίνθου τ᾽ἐν μυχοῖς καὶ Κλεωναίων πρὸς ἀνδρῶν τετράκις·	-u --- u-- - u- - u--- u -- -u-	lyric	
Σικυωνόθε δ᾽ἀργυρωθέντες σὺν οἰνηραῖς φιάλαις ἐπέβαν,	uu-uu -u--- u --- uu- uu-	lyric	
ἐκ δὲ Πελλάνας ἐπιεσσάμενοι νῶτον μαλακαῖσι κρόκαις·	- u --- uu-uu- -- uu-u u-	lyric	
ἀλλὰ χαλκὸν μυρίον οὐ δυνατὸν	-u -- -uu - uu-	lyric	
ἐξελέγχειν· μακροτέρας γὰρ ἀριθμῆσαι σχολᾶς·	-u-- -uu- u u--- u-	lyric	
ὅντε Κλείτωρ καὶ Τεγέα καὶ Ἀχαιῶν ὑψίβατοι πόλιες	-u -- - uu- u u-- -uu- uu-	lyric	
καὶ Λύκαιον πὰρ Διὸς θῆκε δρόμῳ, σὺν ποδῶν χειρῶν τε νικᾶσαι σθένει.	- u-- - u- -- u- - u- -- u --- u-	lyric	
Κάστορος δ᾽ἐλθόντος ἐπὶ ξενίαν πὰρ Παμφάη	-u- --u u- uu- - -u-	lyric	
καὶ κασιγνήτου Πολυδεύκεος, οὐ θαῦμα σφίσιν	- u--- uu-uu - -- u-	lyric	
ἐγγενὲς ἔμμεν ἀεθληταῖς ἀγαθοῖσιν· ἐπεὶ	-uu -u u--- uu-u u-	lyric	
εὐρυχόρου ταμίαι Σπάρτας ἀγώνων	-uu- uu- -- u--	lyric	
μοῖραν Ἑρμᾷ καὶ σὺν Ἡρακλεῖ διέποντι θάλειαν,	-u -- - u --- uu-u u--	lyric	
μάλα μὲν ἀνδρῶν δικαίων περικαδόμενοι. καὶ μὰν θεῶν πιστὸν γένος.	uu u -- u-- uu-uu- - - u- -- u-	lyric	
μεταμειβόμενοι δ᾽ἐναλλὰξ ἁμέραν τὰν μὲν παρὰ πατρὶ φίλῳ	uu-uu- u-- -u- - - uu -u u-	lyric	
Δὶ νέμονται, τὰν δ᾽ὑπὸ κεύθεσι γαίας ἐν γυάλοις Θεράπνας,	- u-- - uu -uu -- - uu- uu-	lyric	
πότμον ἀμπιπλάντες ὁμοῖον· ἐπεὶ	-u ---u u-u u-	lyric	
τοῦτον, ἢ πάμπαν θεὸς ἔμμεναι οἰκεῖν τ᾽οὐρανῷ,	-u - -- uu -uu -- -u-	lyric	
εἵλετʼ αἰῶνα φθιμένου Πολυδεύκης Κάστορος ἐν πολέμῳ.	-u --- uu- uu-- -uu - uu-	lyric	
τὸν γὰρ Ἴδας ἀμφὶ βουσίν πως χολωθεὶς ἔτρωσεν χαλκέας λόγχας ἀκμᾷ.	- u -- -u -- - u-- u-- -u- -- u-	lyric	
ἀπὸ Ταϋγέτου πεδαυγάζων ἴδεν Λυγκεὺς δρυὸς ἐν στελέχει	uu -uu- u--- u- -- uu - uu-	lyric	
ἡμένους. κείνου γὰρ ἐπιχθονίων πάντων γένετʼ ὀξύτατον	-u- -- u u-uu- -- uu -uu-	lyric	
ὄμμα. λαιψηροῖς δὲ πόδεσσιν ἄφαρ	-u --- u u-u u-	lyric	
ἐξικέσθαν, καὶ μέγα ἔργον ἐμήσαντʼ ὠκέως,	-u-- - uu -u u-- -u-	lyric	
καὶ πάθον δεινὸν παλάμαις Ἀφαρητίδαι Διός. αὐτίκα γὰρ	- u- -- uu- uu-u- uu -uu -	lyric	
ἦλθε Λήδας παῖς διώκων· τοὶ δ᾽ἔναντα στάθεν τύμβῳ σχεδὸν πατρωΐῳ·	-u -- - u-- - u-- u- -- u- --u-	lyric	
ἔνθεν ἁρπάξαντες ἄγαλμʼ Ἀΐδα, ξεστὸν πέτρον,	-u ---u u- uu- -- u-	lyric	
ἔμβαλον στέρνῳ Πολυδεύκεος· ἀλλʼ οὔ νιν φλάσαν,	-u- -- uu-uu - - - u-	lyric	
οὐδʼ ἀνέχασσαν· ἐφορμαθεὶς δʼἄρʼ ἄκοντι θοῷ	- uu-u u--- u u-u u-	lyric	
ἤλασε Λυγκέος ἐν πλευραῖσι χαλκόν.	-uu -uu - --u --	lyric	
Ζεὺς δ᾽ἐπʼ Ἴδᾳ πυρφόρον πλᾶξε ψολόεντα κεραυνόν·	- u -- -u- -- uu-u u--	lyric	
ἅμα δ᾽ἐκαίοντʼ ἔρημοι. χαλεπὰ δ᾽ἔρις ἀνθρώποις ὁμιλεῖν κρεσσόνων.	uu u-- u-- uu- uu --- u-- -u-	lyric	
ταχέως δ᾽ἐπʼ ἀδελφεοῦ βίαν πάλιν χώρησεν ὁ Τυνδαρίδας,	uu- u u-u- -- u- --u u -uu-	lyric	
καί νιν οὔπω τεθναότʼ, ἄσθματι δὲ φρίσσοντα πνοὰς ἔκιχεν.	- u -- -uu -uu - --u u- uu-	lyric	
θερμὰ δὴ τέγγων δάκρυα στοναχαῖς	-u - -- uu- uu-	lyric	
ὄρθιον φώνασε· "πάτερ Κρονίων, τίς δὴ λύσις	-u- --u u- uu- - - u-	lyric	
ἔσσεται πενθέων; καὶ ἐμοὶ θάνατον σὺν τῷδʼ ἐπίτειλον, ἄναξ.	-u- -- u u- uu- - - uu-u u-	lyric	
οἴχεται τιμὰ φίλων τατωμένῳ φωτί· παῦροι δ᾽ἐν πόνῳ πιστοὶ βροτῶν	-u- -- u- --u- -u -- - u- -- u-	lyric	
καμάτου μεταλαμβάνειν." ὣς ἔννεπε· Ζεὺς δ᾽ἀντίος ἤλυθέ οἱ	uu- uu-u- - -u- - -uu -uu -	lyric	
καὶ τόδʼ ἐξαύδασʼ ἔπος· "ἐσσί μοι υἱός· τόνδε δ᾽ἔπειτα πόσις	- u --- uu -u u -- -u u-u u-	lyric	
σπέρμα θνατὸν ματρὶ τεᾷ πελάσαις	-u -- -u u- uu-	lyric	
στάξεν ἥρως. ἀλλʼ ἄγε τῶνδέ τοι ἔμπαν αἵρεσιν	-u -- - uu -u u -u -u-	lyric	
παρδίδωμʼ· εἰ μὲν θάνατόν τε φυγὼν καὶ γῆρας ἀπεχθόμενον	-u- - - uu- u u- - -u u-uu-	lyric	
αὐτὸς Οὔλυμπον θέλεις ναίειν ἐμοὶ σύν τʼἈθαναίᾳ κελαινεγχεῖ τ᾽Ἄρει,	-u --- u- -- u- - u--- u--- u-	lyric	
ἔστι τοι τούτων λάχος· εἰ δὲκασιγνήτου πέρι	-u - -- uu - uu--- u-	lyric	
μάρνασαι, πάντων δὲ νοεῖς ἀποδάσσασθαι ἴσον,	-u- -- u u- uu--- u-	lyric	
ἥμισυ μέν κε πνέοις γαίας ὑπένερθεν ἐών,	-uu - u u- -- uu-u u-	lyric	
ἥμισυ δ᾽οὐρανοῦ ἐν χρυσέοις δόμοισιν."	-uu -uu - -- u--	lyric	
ὣς ἄρʼ αὐδάσαντος οὐ γνώμᾳ διπλόαν θέτο βουλάν.	- u ---u - -- uu- uu --	lyric	
ἀνὰ δ᾽ἔλυσεν μὲν ὀφθαλμόν,ἔπειτα δὲ φωνὰν χαλκομίτρα Κάστορος.	uu u-- u --uu-u u -- -u-- -u-	lyric	
παῖ Ῥέας, ἅ τε πρυτανεῖα λέλογχας, Ἑστία,	- u- - - uu-u u-u -u-	lyric	
Ζηνὸς ὑψίστου κασιγνήτα καὶ ὁμοθρόνου Ἥρας,	-u --- u--- u u-uu --	lyric	
εὖ μὲν Ἀρισταγόραν δέξαι τεὸν ἐς θάλαμον,	- u u-uu- -- uu - uu-	lyric	
εὖ δ᾽ἑταίρους ἀγλαῷ σκάπτῳ πέλας,	- u-- -u- -- u-	lyric	
οἵ σε γεραίροντες ὀρθὰν φυλάσσοισιν Τένεδον,	- u u--u -- u--- uu-	lyric	
πολλὰ μὲν λοιβαῖσιν ἀγαζόμενοι πρώταν θεῶν,	-u - --u u-uu- -- u-	lyric	
πολλὰ δὲ κνίσσᾳ· λύρα δέ σφι βρέμεται καὶ ἀοιδά·	-u - -- u- - - uu- u u--	lyric	
καὶ ξενίου Διὸς ἀσκεῖται Θέμις ἀενάοις	- uu- uu --- uu -uu-	lyric	
ἐν τραπέζαις. ἀλλὰ σὺν δόξᾳ τέλος	- u-- -u - -- u-	lyric	
δωδεκάμηνον περᾶσαι σὺν ἀτρώτῳ κραδίᾳ,	-uu-- u-- u --- uu-	lyric	
ἄνδρα δ᾽ἐγὼ μακαρίζω μὲν πατέρʼ Ἁρκεσίλαν,	-u u- uu-- - uu -uu-	lyric	
καὶ τὸ θαητὸν δέμας ἀτρεμίαν τε ξύγγονον.	- u --- uu -uu- - -u-	lyric	
εἰ δέ τις ὄλβον ἔχων μορφᾷ παραμεύσεται ἄλλους,	- u u -u u- -- uu-uu --	dactylic hexameter	masculine penthemimeral, hepthemimeral
ἔν τ᾽ἀέθλοισιν ἀριστεύων ἐπέδειξεν βίαν,	- uu-u u--- uu-- u-	lyric	
θνατὰ μεμνάσθω περιστέλλων μέλη,	-u --- u--- u-	lyric	
καὶ τελευτὰν ἁπάντων γᾶν ἐπιεσσόμενος·	- u-- u-- - uu-uu-	lyric	
ἐν λόγοις δ᾽ἀστῶν ἀγαθοῖσί νιν αἰνεῖσθαι χρεών,	- u- -- uu-u u --- u-	lyric	
καὶ μελιγδούποισι δαιδαλθέντα μελιζέν ἀοιδαῖς.	- u---u ---u u-u u--	lyric	
ἐκ δὲ περικτιόνων ἑκκαίδεκʼ Ἀρισταγόραν	- u u-uu- --u u-uu-	lyric	
ἀγλααὶ νῖκαι πάτραν τ᾽εὐώνυμον	-u- -- u- --u-	lyric	
ἐστεφάνωσαν πάλᾳ καὶ μεγαυχεῖ παγκρατίῳ.	-uu-- u- - u-- -uu-	lyric	
ἐλπίδες δ᾽ὀκνηρότεραι γονέων παιδὸς βίαν	-u- --uu- uu- -- u-	lyric	
ἔσχον ἐν Πυθῶνι πειρᾶσθαι καὶ Ὀλυμπίᾳ ἄθλων.	-u - --u --- u u-uu --	lyric	
ναὶ μὰ γὰρ ὅρκον, ἐμὰν δόξαν παρὰ Κασταλίᾳ	- u u -u u- -- uu -uu-	lyric	
καὶ παρʼ εὐδένδρῳ μολὼν ὄχθῳ Κρόνου	- u --- u- -- u-	lyric	
κάλλιον ἂν δηριώντων ἐνόστησʼ ἀντιπάλων,	-uu - -u-- u-- -uu-	lyric	
πενταετηρίδʼ ἑορτὰν Ἡρακλέος τέθμιον	-uu-u u-- -uu- uu-	lyric	
κωμάσαις ἀνδησάμενός τε κόμαν ἐν πορφυρέοις	-u- --uu- u u- - -u-	lyric	
ἔρνεσιν. ἀλλὰ βροτῶν τὸν μὲν κενεόφρονες αὖχαι	-uu -u u- - - uu-uu --	dactylic hexameter	masculine penthemimeral, hepthemimeral
ἐξ ἀγαθῶν ἔβαλον· τὸν δ᾽αὖ καταμεμφθέντʼ ἄγαν	- uu- uu- - - uu-- u-	lyric	
ἰσχὺν οἰκείων παρέσφαλεν καλῶν	-u --- u--- u-	lyric	
χειρὸς ἕλκων ὀπίσσω θυμὸς ἄτολμος ἐών.	-u -- u-- -u u-u u-	lyric	
συμβαλεῖν μὰν εὐμαρὲς ἦν τό τε Πεισάνδρου πάλαι	-u- - -uu - u u --- u-	lyric	
αἷμʼ ἀπὸ Σπάρτας· Ἀμύκλαθεν γὰρ ἔβα σὺν Ὀρέστᾳ,	- u- -- u--- u u- u u--	lyric	
Αἰολέων στρατιὰν χαλκεντέα δεῦρʼ ἀνάγων·	-uu- uu- --uu - uu-	lyric	
καὶ παρʼ Ἰσμηνοῦ ῥοὰν κεκραμένον	- u --- u- --u-	lyric	
ἐκ Μελανίπποιο μάτρωος. ἀρχαῖαι δ᾽ἀρεταὶ	- uu--u --u --- uu-	lyric	
ἀμφέροντʼ ἀλλασσόμεναι γενεαῖς ἀνδρῶν σθένος·	-u- --uu- uu- -- u-	lyric	
ἐν σχερῷ δ᾽οὔτʼ ὦν μέλαιναι καρπὸν ἔδωκαν ἄρουραι,	- u- - - u-- -u u-u u--	lyric	
δένδρεά τ᾽οὐκ ἐθέλει πάσαις ἐτέων περόδοις	-uu - uu- -- uu- uu-	lyric	
ἄνθος εὐῶδες φέρειν πλούτῳ ἴσον,	-u --- u- -- u-	lyric	
ἀλλʼ ἐν ἀμείβοντι. καὶ θνατὸν οὕτως ἔθνος ἄγει	- u u--u - -u -- -u u-	lyric	
μοῖρα. τὸ δ᾽ἐκ Διὸς ἀνθρώποις σαφὲς οὐχ ἕπεται	-u u - uu --- uu - uu-	lyric	
τέκμαρ· ἀλλʼ ἔμπαν μεγαλανορίαις ἐμβαίνομεν,	-u - -- uu-uu- --u-	lyric	
ἔργα τε πολλὰ μενοινῶντες· δέδεται γὰρ ἀναιδεῖ	-u u -u u--- uu- u u--	dactylic hexameter	hepthemimeral
ἐλπίδι γυῖα· προμαθείας δʼἀπόκεινται ῥοαί.	-uu -u u--- uu-- u-	lyric	
κερδέων δὲ χρὴ μέτρον θηρευέμεν·	-u- - - u- --u-	lyric	
ἀπροσίκτων δ᾽ἐρώτων ὀξύτεραι μανίαι.	-u-- u-- -uu- uu-	lyric	
