Ῥεῖά κέ τοι μορφάς τε σίνη τ᾽ὀλοφώια θηρῶν	-u u - -- u u- uu-uu --	dactylic hexameter	masculine penthemimeral, hepthemimeral, trithemimeral
ἀπροϊδῆ τύψαντα λύσιν θ᾽ἑτεραλκέα κήδευς,	-uu- --u u- uu-uu --	dactylic hexameter	feminine penthemimeral, hepthemimeral, trithemimeral
φίλ᾽ Ἑρμησιάναξ, πολέων κυδίστατε παῶν,	- --uu- uu- --uu --	dactylic hexameter	masculine penthemimeral, hepthemimeral
ἔμπεδα φωνήσαιμι: σὲ δ᾽ἂν πολύεργος ἀροτρεύς	-uu ---u u - uu-u u--	dactylic hexameter	feminine penthemimeral, hepthemimeral
βουκαῖός τ᾽ἀλέγοι καὶ ὀροιτύπος, εὖτε καθ᾽ ὕλην	--- uu- u u-uu -u u --	dactylic hexameter	masculine penthemimeral, trithemimeral
ἢ καὶ ἀροτρεύοντι βάλῃ ἔπι λοιγὸν ὀδόντα,	- u u---u u- uu -u u--	dactylic hexameter	feminine penthemimeral, hepthemimeral
τοῖα περιφρασθέντος ἀλεξητήρια νούσων.	-u u---u u---uu --	dactylic hexameter	feminine penthemimeral
Ἀλλ᾽ ἤτοι κακοεργὰ φαλάγγια, σὺν καὶ ἀνιγρούς	- -- uu-u u-uu - u u--	dactylic hexameter	feminine penthemimeral, trithemimeral
ἑρπηστὰς ἔχιάς τε καὶ ἄχθεα μυρία γαίης	--- uu- u u -uu -uu --	dactylic hexameter	masculine penthemimeral, trithemimeral
Τιτήνων ἐνέπουσιν ἀφ᾽ αἵματος, εἰ ἐτεόν περ	--- uu-u u -uu - uu- -	dactylic hexameter	feminine penthemimeral, trithemimeral
Ἀσκραῖος μυχάτοιο Μελισσήεντος ἐπ᾽ ὄχθαις	--- uu-u u---u u --	dactylic hexameter	feminine penthemimeral, trithemimeral
Ἡσίοδος κατέλεξε παρ᾽ ὕδασι Περμησσοῖο.	-uu- uu-u u -uu ----	dactylic hexameter	feminine penthemimeral, trithemimeral
τὸν δὲ χαλαζήεντα κόρη Τιτηνὶς ἀνῆκε	- u u---u u- --u u--	dactylic hexameter	feminine penthemimeral, hepthemimeral
σκορπίον, ἐκ κέντροιο τεθηγμένον, ἦμος ἐπέχρα	-uu - --u u-uu -u u--	dactylic hexameter	feminine penthemimeral, trithemimeral
Βοιωτῷ τεύχουσα κακὸν μόρον Ὠαρίωνι,	--- --u u- uu -uu--	dactylic hexameter	feminine penthemimeral, hepthemimeral, trithemimeral
ἀχράντων ὅτε χερσὶ θεῆς ἐδράξατο πέπλων:	--- uu -u u- --uu --	dactylic hexameter	feminine penthemimeral, hepthemimeral, trithemimeral
αὐτὰρ ὅγε στιβαροῖο κατὰ σφυρὸν ἤλασεν ἴχνευς	-u u- uu-u u- uu -uu --	dactylic hexameter	feminine penthemimeral, hepthemimeral, trithemimeral
σκορπίος ἀπροϊδὴς ὀλίγῳ ὑπὸ λᾶι λοχήσας:	-uu -uu- uu- uu - ---	dactylic hexameter	masculine penthemimeral, hepthemimeral
τοῦ δὲ τέρας περίσημον ὑπ᾽ ἀστέρας ἀπλανὲς αὔτως	- u u- uu-u u -uu -uu --	dactylic hexameter	feminine penthemimeral, trithemimeral
οἷα κυνηλατέοντος ἀείδελον ἐστήρικται.	-u u-uu-u u-uu ----	dactylic hexameter	feminine penthemimeral
Ἀλλὰ σύ γε σταθμοῖο καὶ αὐλίου ἑρπετὰ φύγδην	-u u - --u u -uu -uu --	dactylic hexameter	feminine penthemimeral, trithemimeral
ῥηιδίως ἐκ πάντα διώξεαι, ἢ ἀπ᾽ ἐρίπνης,	-uu- - -u u-uu - u u--	dactylic hexameter	feminine penthemimeral, trithemimeral
ἠὲ καὶ αὐτοπόνοιο χαμευνάδος, ἦμος ἀν᾽ ἀγρούς	-u u -uu-u u-uu -u u --	dactylic hexameter	feminine penthemimeral
φεύγων αὐαλέου θέρεος πυρόεσσαν ἀυτμήν	-- -uu- uu- uu-u u--	dactylic hexameter	masculine penthemimeral, hepthemimeral
αἴθριος ἐν καλάμῃ στορέσας ἀκρέσπερος εὕδῃς,	-uu - uu- uu- --uu --	dactylic hexameter	masculine penthemimeral, hepthemimeral, trithemimeral
ἢ καὶ ἀνυλήεντα παρὲκ λόφον, ἢ ἐνὶ βήσσης	- u u---u u- uu - uu --	dactylic hexameter	feminine penthemimeral, hepthemimeral
ἐσχατιῇ ὅθι πλεῖστα κινώπετα βόσκεται ὕλην,	-uu- uu -u u-uu -uu --	dactylic hexameter	feminine penthemimeral, trithemimeral
[δρυμοὺς καὶ λασιῶνας ἀμορβαίους τε χαράδρας:	-- - uu-u u--- u u--	dactylic hexameter	feminine penthemimeral, trithemimeral
καί τε παρὲκ λιστρωτὸν ἅλω δρόμον, ἠδ᾽ ἵνα ποίη	- u u- --u u- uu - uu --	dactylic hexameter	feminine penthemimeral, hepthemimeral, trithemimeral
πρῶτα κυϊσκομένη χνοάει σκιάοντας ἰάμνους,	-u u-uu- uu- uu-u u--	dactylic hexameter	masculine penthemimeral, hepthemimeral
τῆμος ὅτ᾽ ἀζαλέων φολίδων ἀπεδύσατο γῆρας	-u u -uu- uu- uu-uu --	dactylic hexameter	masculine penthemimeral, hepthemimeral
μῶλυς ἐπιστείβων, ὅτε φωλεὸν εἴαρι φεύγων	-u u--- uu -uu -uu --	dactylic hexameter	masculine penthemimeral
ὄμμασιν ἀμβλώσσει, μαράθου δέ ἑ νήχυτος ὄρπηξ	-uu --- uu- u u -uu --	dactylic hexameter	masculine penthemimeral, hepthemimeral
βοσκηθεὶς ὠκύν τε καὶ αὐγήεντα τίθησι.	--- -- u u ---u u--	dactylic hexameter	masculine penthemimeral, trithemimeral
Θιβρὴν δ᾽ἐξελάσεις ὀφίων ἐπιλωβέα κῆρα	-- -uu- uu- uu-uu --	dactylic hexameter	masculine penthemimeral, hepthemimeral
καπνείων ἐλάφοιο πολυγλώχινα κεραίην,	--- uu-u u---u u--	dactylic hexameter	feminine penthemimeral, trithemimeral
ἄλλοτε δ᾽ἀζαλέην δαίων ἐγγαγίδα πέτρην,	-uu -uu- -- --uu --	dactylic hexameter	masculine penthemimeral, hepthemimeral
ἣν οὐδὲ κρατεροῖο πυρὸς περικαίνυται ὁρμή:	- -- uu-u u- uu-uu --	dactylic hexameter	feminine penthemimeral, hepthemimeral, trithemimeral
ἐν δὲ πολυσχιδέος βλήτρου πυρὶ βάλλεο χαίτην,	- u u-uu- -- uu -uu --	dactylic hexameter	masculine penthemimeral, hepthemimeral
ἢ σύ γε καχρυόεσσαν ἑλὼν πυριθαλπέα ῥίζαν	- u u -uu-u u- uu-uu --	dactylic hexameter	feminine penthemimeral, hepthemimeral
καρδάμῳ ἀμμίγδην ἰσοελκέι: μίσγε δ᾽ἔνοδμον	-uu --- uu-uu -u u--	dactylic hexameter	masculine penthemimeral
ζορκὸς ἐνὶ πλάστιγγι νέον κέρας ἀσκελὲς ἱστάς,	-u u- --u u- uu -uu --	dactylic hexameter	feminine penthemimeral, hepthemimeral, trithemimeral
καί τε μελανθείου βαρυαέος, ἄλλοτε θείου,	- u u--- uu-uu -uu --	dactylic hexameter	masculine penthemimeral
ἄλλοτε δ᾽ἀσφάλτοιο φέρων ἰσοαχθέα μοῖραν:	-uu ---u u- uu-uu --	dactylic hexameter	feminine penthemimeral, hepthemimeral
ἠὲ σύ γε Θρήισσαν ἐνιφλέξαις πυρὶ λᾶαν,	-u u - --u u--- uu --	dactylic hexameter	feminine penthemimeral, trithemimeral
ἥ θ᾽ὕδατι βρεχθεῖσα σελάσσεται, ἔσβεσε δ᾽αὐγήν	- uu- --u u-uu -uu --	dactylic hexameter	feminine penthemimeral, trithemimeral
τυτθὸν ὅτ᾽ ὀδμήσαιτο ἐπιρρανθέντος ἐλαίου.	-u u ---u u---u u--	dactylic hexameter	feminine penthemimeral
τὴν ἀπὸ Θρηικίου νομέες ποταμοῖο φέρονται	- uu -uu- uu- uu-u u--	dactylic hexameter	masculine penthemimeral, hepthemimeral
ὃν Πόντον καλέουσι, τόθι Θρήικες ἀμορβοί	- -- uu-u u- --u u--	dactylic hexameter	feminine penthemimeral, hepthemimeral, trithemimeral
κριοφάγοι μήλοισιν ἀεργηλοῖσιν ἕπονται.	-uu- --u u---u u--	dactylic hexameter	feminine penthemimeral, trithemimeral
ναὶ μὴν καὶ βαρύοδμος ἐπὶ φλογὶ ζωγρηθεῖσα	- - - uu-u u- uu ----	dactylic hexameter	feminine penthemimeral, hepthemimeral, trithemimeral
χαλβάνη ἄκνηστίς τε καὶ ἡ πριόνεσσι τομαίη	-uu --- u u - uu-u u--	dactylic hexameter	masculine penthemimeral, hepthemimeral
κέδρος, πουλυόδουσι καταψηχθεῖσα γενείοις,	-- -uu-u u---u u--	dactylic hexameter	feminine penthemimeral
ἐν φλογιῇ καπνηλὸν ἄγει καὶ φύξιον ὀδμήν.	- uu- --u u- - -uu --	dactylic hexameter	feminine penthemimeral, hepthemimeral, trithemimeral
τοῖς δὴ χηραμὰ κοῖλα καὶ ὑληώρεας εὐνάς	- - -uu -u u ---uu --	dactylic hexameter	feminine penthemimeral
κεινώσεις, δαπέδῳ δὲ πεσὼν ὕπνοιο κορέσσῃ.	--- uu- u u- --u u--	dactylic hexameter	masculine penthemimeral, hepthemimeral, trithemimeral
Εἰ δὲ τὰ μὲν καμάτου ἐπιδεύεται, ἄγχι δέ τοι νύξ	- u u - uu- uu-uu -u u - -	dactylic hexameter	masculine penthemimeral, trithemimeral
αὖλιν ἄγει, κοίτου δὲ λιλαίεαι ἔργον ἀνύσσας,	-u u- -- u u-uu -u u--	dactylic hexameter	masculine penthemimeral, trithemimeral
τῆμος δὴ ποταμοῖο πολυρραγέος κατὰ δίνας	-- - uu-u u-uu- uu --	dactylic hexameter	feminine penthemimeral, trithemimeral
ὑδρηλὴν καλάμινθον ὀπάζεο χαιτήεσσαν:	--- uu-u u-uu ----	dactylic hexameter	feminine penthemimeral, trithemimeral
πολλὴ γὰρ λιβάσιν παραέξεται ἀμφί τε χείλη	-- - uu- uu-uu -u u --	dactylic hexameter	masculine penthemimeral, trithemimeral
ἔρσεται ἀγλαύροισιν ἀγαλλομένη ποταμοῖσιν.	-uu ---u u-uu- uu--	dactylic hexameter	feminine penthemimeral
ἢ σύ γ᾽ὑποστορέσαιο λύγον πολυανθέα κόψας	- u u-uu-u u- uu-uu --	dactylic hexameter	feminine penthemimeral, hepthemimeral
ἢ πολιὸν βαρύοδμον, ὃ δὴ ῥίγιστον ὄδωδεν:	- uu- uu-u u - --u u--	dactylic hexameter	feminine penthemimeral, hepthemimeral, trithemimeral
ὣς δ᾽αὔτως ἐχίειον, ὀριγανόεσσά τε χαίτη,	- -- uu-u u-uu-u u --	dactylic hexameter	feminine penthemimeral, trithemimeral
ναὶ μὴν ἁβροτόνοιο τό τ᾽ἄγριον οὔρεσι θάλλει	- - -uu-u u -uu -uu --	dactylic hexameter	feminine penthemimeral
ἀργεννὴν ὑπὸ βῆσσαν, ἢ ἑρπύλλοιο νομαίου,	--- uu -u u ---u u--	dactylic hexameter	feminine penthemimeral, trithemimeral
ὅς τε φιλόζωος νοτερὴν ἐπιβόσκεται αἶαν	- u u--- uu- uu-uu --	dactylic hexameter	masculine penthemimeral, hepthemimeral
ῥιζοβόλος, λασίοισιν ἀεὶ φύλλοισι κατήρης.	-uu- uu-u u- --u u--	dactylic hexameter	feminine penthemimeral, hepthemimeral, trithemimeral
φράζεσθαι δ᾽ἐπέοικε χαμαιζήλοιο κονύζης	--- uu-u u---u u--	dactylic hexameter	feminine penthemimeral, trithemimeral
ἄγνου τε βρύα λευκὰ καὶ ἐμπρίοντ᾽ ὀνόγυρον:	-- - uu -u u --- uu--	dactylic hexameter	feminine penthemimeral, trithemimeral
αὕτως δὲ τρήχοντα ταμὼν ἄπο κλήματα σίδης,	-- - --u u- uu -uu --	dactylic hexameter	feminine penthemimeral, hepthemimeral, trithemimeral
ἠὲ καὶ ἀσφοδέλοιο νέον πολυαυξέα μόσχον,	-u u -uu-u u- uu-uu --	dactylic hexameter	feminine penthemimeral, hepthemimeral
στρύχνον τε σκύρα τ᾽ἐχθρά, τά τ᾽εἴαρι σίνατο βούτην	-- - uu -u u -uu -uu --	dactylic hexameter	feminine penthemimeral, trithemimeral
ἦμος ὅταν σκυρόωσι βόες καυλεῖα φαγοῦσαι.	-u u- uu-u u- --u u--	dactylic hexameter	feminine penthemimeral, hepthemimeral, trithemimeral
ναὶ μὴν πευκεδάνοιο βαρυπνόου, οὗ τε καὶ ὀδμή	- - -uu-u u-uu - u u --	dactylic hexameter	feminine penthemimeral
θηρί᾽ ἀποσσεύει τε καὶ ἀντιόωντα διώκει.	-u u--- u u -uu-u u--	dactylic hexameter	masculine penthemimeral
καὶ τὰ μὲν εἰκαίῃ παράθου ἀγραυλέι κοίτῃ,	- u u --- uu- --uu --	dactylic hexameter	masculine penthemimeral, hepthemimeral
ἄλλα δὲ φωλειοῖς: τὰ δὲ διπλάσσαιο χεείαις.	-u u --- u u ---u u--	dactylic hexameter	masculine penthemimeral
Εἴ γε μέν, ἐς τεῦχος κεραμήιον ἠὲ καὶ ὄλπην	- u u - -- uu-uu -u u --	dactylic hexameter	masculine penthemimeral, trithemimeral
κεδρίδας ἐνθρύπτων λιπάοις εὐήρεα γυῖα,	-uu --- uu- --uu --	dactylic hexameter	masculine penthemimeral, hepthemimeral
ἢ καὶ πευκεδάνοιο βαρυπνόου, ἄλλοτ᾽ ὀρείου	- - -uu-u u-uu -u u--	dactylic hexameter	feminine penthemimeral
αὖα καταψήχοιο λίπει ἔνι φύλλα κονύζης:	-u u---u u- uu -u u--	dactylic hexameter	feminine penthemimeral, hepthemimeral
αὕτως δ᾽ἀλθήεντ᾽ ἐλελίσφακον, ἐν δέ τε ῥίζαν	-- --- uu-uu - u u --	dactylic hexameter	masculine penthemimeral
σιλφίου, ἣν κνηστῆρι κατατρίψειαν ὀδόντες	-uu - --u u---u u--	dactylic hexameter	feminine penthemimeral, trithemimeral
πολλάκι καὶ βροτέην σιάλων ὑποέτρεσαν ὀδμήν.	-uu - uu- uu- uu-uu --	dactylic hexameter	masculine penthemimeral, hepthemimeral, trithemimeral
εἰ δὲ σύ γε τρίψας ὀλίγῳ ἐν βάμματι κάμπην	- u u - -- uu- - -uu --	dactylic hexameter	masculine penthemimeral, hepthemimeral, trithemimeral
κηπαίην δροσόεσσαν ἐπὶ χλωρηίδα νώτῳ,	--- uu-u u- --uu --	dactylic hexameter	feminine penthemimeral, hepthemimeral, trithemimeral
ἠὲ καὶ ἀγριάδος μολόχης ἐγκύμονι κάρφει	-u u -uu- uu- --uu --	dactylic hexameter	masculine penthemimeral, hepthemimeral
γυῖα πέριξ λιπάσειας, ἀναίμακτός κεν ἰαύοις.	-u u- uu-u u--- u u--	dactylic hexameter	feminine penthemimeral, trithemimeral
ψήχεο δ᾽ἐν στέρνῳ προβαλὼν μυλόεντι θυείης	-uu - -- uu- uu-u u--	dactylic hexameter	masculine penthemimeral, hepthemimeral, trithemimeral
ἐν μέν θ᾽ἁβροτόνοιο δύω κομόωντας ὀράμνους	- - -uu-u u- uu-u u--	dactylic hexameter	feminine penthemimeral, hepthemimeral
καρδάμῳ ἀμμίγδηνὀδελοῦ δέ οἱ αἴσιος ὁλκή	-uu ---uu- u u -uu --	dactylic hexameter	hepthemimeral
ἐν δὲ χεροπληθῆ καρπὸν νεοθηλέα δαυχμοῦ	- u u--- -- uu-uu --	dactylic hexameter	masculine penthemimeral, hepthemimeral
λειαίνειν τριπτῆρι: τὰ δὲ τροχοειδέα πλάσσων	--- --u u - uu-uu --	dactylic hexameter	feminine penthemimeral, hepthemimeral, trithemimeral
τέρσαι ὑποσκιόεντι βαλὼν ἀνεμώδεϊ χώρῳ:	-u u-uu-u u- uu-uu --	dactylic hexameter	feminine penthemimeral, hepthemimeral
αὖα δ᾽ἐν ὄλπῃ θρύπτε, καὶ αὐτίκα γυῖα λιπαίνοις.	-u u -- -u u -uu -u u--	dactylic hexameter	feminine penthemimeral
Εἴ γε μὲν ἐκ τριόδοιο μεμιγμένα κνώδαλα χύτρῳ	- u u - uu-u u-uu -uu --	dactylic hexameter	feminine penthemimeral, trithemimeral
ζωὰ νέον θορνύντα καὶ ἐν θρόνα τοιάδε βάλλῃς,	-u u- --u u - uu -uu --	dactylic hexameter	feminine penthemimeral, hepthemimeral, trithemimeral
δήεις οὐλομένῃσιν ἀλεξητήριον ἄταις:	-- -uu-u u---uu --	dactylic hexameter	feminine penthemimeral
ἐν μὲν γὰρ μυελοῖο νεοσφαγέος ἐλάφοιο	- - - uu-u u-uu- uu--	dactylic hexameter	feminine penthemimeral, trithemimeral
δραχμάων τρίφατον δεκάδος καταβάλλεο βρῖθος,	--- uu- uu- uu-uu --	dactylic hexameter	masculine penthemimeral, hepthemimeral, trithemimeral
ἐν δὲ τρίτην ῥοδέου μοῖραν χοός, ἥν τε θυωροί	- u u- uu- -- uu - u u--	dactylic hexameter	masculine penthemimeral, hepthemimeral, trithemimeral
πρώτην μεσσατίην τε πολύτριπτόν τε κλέονται,	-- -uu- u u--- u u--	dactylic hexameter	masculine penthemimeral
ἰσόμορον δ᾽ὠμοῖο χέειν ἀργῆτος ἐλαίου,	-uu- --u u- --u u--	dactylic hexameter	feminine penthemimeral, hepthemimeral, trithemimeral
τετράμορον κηροῖο: τὰ δ᾽ἐν περιηγέι γάστρῃ	-uu- --u u - uu-uu --	dactylic hexameter	feminine penthemimeral, hepthemimeral, trithemimeral
θάλπε κατασπέρχων ἔστ᾽ ἂν περὶ σάρκες ἀκάνθης	-u u--- - - uu -u u--	dactylic hexameter	masculine penthemimeral, hepthemimeral
μελδόμεναι θρύπτωνται: ἔπειτα δὲ λάζεο τυκτήν	-uu- --u u-u u -uu --	dactylic hexameter	feminine penthemimeral, trithemimeral
εὐεργῆ λάκτιν, τὰ δὲ μυρία πάντα ταράσσειν	--- -- u u -uu -u u--	dactylic hexameter	masculine penthemimeral, trithemimeral
συμφύρδην ὀφίεσσιν: ἑκὰς δ᾽ἀπόερσον ἀκάνθας,	--- uu-u u- uu-u u--	dactylic hexameter	feminine penthemimeral, hepthemimeral, trithemimeral
καὶ γὰρ ταῖς κακοεργὸς ὁμῶς ἐνιτέτροφεν ἰός:	- - - uu-u u- uu-uu --	dactylic hexameter	feminine penthemimeral, hepthemimeral, trithemimeral
γυῖα δὲ πάντα λίπαζε καὶ εἰς ὁδόν, ἢ ἐπὶ κοῖτον,	-u u -u u-u u - uu - uu --	dactylic hexameter	feminine penthemimeral, hepthemimeral
ἢ ὅταν αὐαλέου θέρεος μεθ᾽ ἁλώια ἔργα	- uu -uu- uu- u u-uu --	dactylic hexameter	masculine penthemimeral, hepthemimeral
ζωσάμενος θρίναξι βαθὺν διακρίνεαι ἄντλον.	-uu- --u u- uu-uu --	dactylic hexameter	feminine penthemimeral, hepthemimeral, trithemimeral
Εἰ δέ που ἐν δακέεσσιν ἀφαρμάκτῳ χροῒ κύρσῃς	- u u - uu-u u--- uu --	dactylic hexameter	feminine penthemimeral, trithemimeral
ἄκμηνος σίτων, ὅτε δὴ κακὸν ἄνδρας ἰάπτει,	--- -- uu - uu -u u--	dactylic hexameter	masculine penthemimeral, hepthemimeral, trithemimeral
αἶψά κεν ἡμετέρῃσιν ἐρωήσειας ἐφετμαῖς.	-u u -uu-u u---u u--	dactylic hexameter	feminine penthemimeral
τῶν ἤτοι θήλεια παλίγκοτος ἀντομένοισι	- -- --u u-uu -uu--	dactylic hexameter	feminine penthemimeral, trithemimeral
δάχματι, πλειοτέρη δὲ καὶ ὁλκαίην ἐπὶ σειρήν:	-uu -uu- u u --- uu --	dactylic hexameter	masculine penthemimeral
τοὔνεκα καὶ θανάτοιο θοώτερος ἵξεται αἶσα.	-uu - uu-u u-uu -uu --	dactylic hexameter	feminine penthemimeral, trithemimeral
ἀλλ᾽ ἤτοι θέρεος βλαβερὸν δάκος ἐξαλέασθαι	- -- uu- uu- uu -uu--	dactylic hexameter	masculine penthemimeral, hepthemimeral, trithemimeral
Πληιάδων φάσιας δεδοκημένος, αἵ θ᾽ὑπὸ Ταύρου	-uu- uu- uu-uu - uu --	dactylic hexameter	masculine penthemimeral, trithemimeral
ἀλκαίην ψαίρουσαι ὀλίζωνες φορέονται:	--- --u u--- uu--	dactylic hexameter	feminine penthemimeral, trithemimeral
ἢ ὅτε σὺν τέκνοισι θερειομένοισιν ἀβοσκής	- uu - --u u-uu-u u--	dactylic hexameter	feminine penthemimeral, trithemimeral
φωλειοῦ λοχάδην ὑπὸ γωλεὰ διψὰς ἰαύῃ,	--- uu- uu -uu -u u--	dactylic hexameter	masculine penthemimeral, trithemimeral
ἢ ὅτε λίπτῃσιν μεθ᾽ ἑὸν νομόν, ἢ ἐπὶ κοῖτον	- uu --- u u- uu - uu --	dactylic hexameter	masculine penthemimeral, hepthemimeral
ἐκ νομοῦ ὑπνώουσα κίῃ κεκορημένη ὕλης.	- uu ---u u- uu-uu --	dactylic hexameter	feminine penthemimeral, hepthemimeral
μὴ σύ γ᾽ἐνὶ τριόδοισι τύχοις ὅτε δάχμα πεφυζώς	- u u- uu-u u- uu -u u--	dactylic hexameter	feminine penthemimeral, hepthemimeral, trithemimeral
περκνὸς ἔχις θυίῃσι τυπῇ ψολόεντος ἐχίδνης,	-u u- --u u- uu-u u--	dactylic hexameter	feminine penthemimeral, hepthemimeral, trithemimeral
ἡνίκα θορνυμένου ἔχιος θολερῷ κυνόδοντι	-uu -uu- uu- uu- uu--	dactylic hexameter	masculine penthemimeral, hepthemimeral
θουρὰς ἀμὺξ ἐμφῦσα κάρην ἀπέκοψεν ὁμεύνου:	-u u- --u u- uu-u u--	dactylic hexameter	feminine penthemimeral, hepthemimeral, trithemimeral
οἱ δὲ πατρὸς λώβην μετεκίαθον αὐτίκα τυτθοί	- u u- -- uu-uu -uu --	dactylic hexameter	masculine penthemimeral, trithemimeral
γεινόμενοι ἐχιῆες, ἐπεὶ διὰ μητρὸς ἀραιήν	-uu- uu-u u- uu -u u--	dactylic hexameter	feminine penthemimeral, hepthemimeral, trithemimeral
γαστέρ᾽ ἀναβρώσαντες ἀμήτορες ἐξεγένοντο:	-u u---u u-uu -uu--	dactylic hexameter	feminine penthemimeral
οἴη γὰρ βαρύθει ὑπὸ κύματος, οἱ δὲ καθ᾽ ὕλην	-- - uu- uu -uu - u u --	dactylic hexameter	masculine penthemimeral, trithemimeral
ᾠοτόκοι ὄφιες λεπυρὴν θάλπουσι γενέθλην.	-uu- uu- uu- --u u--	dactylic hexameter	masculine penthemimeral, hepthemimeral, trithemimeral
μηδ᾽ ὅτε ῥικνῆεν φολίδων περὶ γῆρας ἀμέρσας	- uu --- uu- uu -u u--	dactylic hexameter	masculine penthemimeral, hepthemimeral
ἂψ ἀναφοιτήσῃ νεαρῇ κεχαρημένος ἥβῃ,	- uu--- uu- uu-uu --	dactylic hexameter	masculine penthemimeral, hepthemimeral
ἢ ὁπότε σκαρθμοὺς ἐλάφων ὀχεῇσιν ἀλύξας	- uu- -- uu- uu-u u--	dactylic hexameter	masculine penthemimeral, hepthemimeral, trithemimeral
ἀνδράς᾽ ἐνισκίμψῃ χολόων γυιοφθόρον ἰόν:	-u u--- uu- --uu --	dactylic hexameter	masculine penthemimeral, hepthemimeral
ἔξοχα γὰρ δολιχοῖσι κινωπησταῖς κοτέουσι	-uu - uu-u u--- uu--	dactylic hexameter	feminine penthemimeral, trithemimeral
νεβροτόκοι καὶ ζόρκες: ἀνιχνεύουσι δὲ πάντη	-uu- - -u u---u u --	dactylic hexameter	feminine penthemimeral, trithemimeral
τρόχμαλά θ᾽αἱμασιάς τε καὶ ἰλυοὺς ἐρέθοντες,	-uu -uu- u u --- uu--	dactylic hexameter	masculine penthemimeral
σμερδαλέῃ μυκτῆρος ἐπισπέρχοντες ἀυτμῇ.	-uu- --u u---u u--	dactylic hexameter	feminine penthemimeral, trithemimeral
Ναὶ μὴν καὶ νιφόεσσα φέρει δυσπαίπαλος Ὄθρυς	- - - uu-u u- --uu --	dactylic hexameter	feminine penthemimeral, hepthemimeral, trithemimeral
φοινὰ δάκη, κοίλη τε φάραγξ καὶ τρηχέες ἀγμοί	-u u- -- u u- - -uu --	dactylic hexameter	masculine penthemimeral, hepthemimeral, trithemimeral
καὶ λέπας ὑλῆεν, τόθι δίψιος ἐμβατέει σήψ.	- uu --- uu -uu -uu- -	dactylic hexameter	masculine penthemimeral
χροιὴν δ᾽ἀλλόφατόν τε καὶ οὐ μίαν οἰαδὸν ἴσχει,	-- -uu- u u - uu -uu --	dactylic hexameter	masculine penthemimeral, hepthemimeral
αἰὲν ἐειδόμενος χώρῳ ἵνα χηραμὰ τεύξῃ.	-u u-uu- -- uu -uu --	dactylic hexameter	masculine penthemimeral, hepthemimeral
τῶν οἱ μὲν λίθακάς τε καὶ ἕρμακας ἐνναίοντες	- - - uu- u u -uu ----	dactylic hexameter	masculine penthemimeral, trithemimeral
παυρότεροι, τρηχεῖς δὲ καὶ ἔκπυροι: οὔ κεν ἐκείνων	-uu- -- u u -uu - u u--	dactylic hexameter	masculine penthemimeral, trithemimeral
ἀνδράσι δάχμα πέλοι μεταμώνιον ἀλλὰ κάκηθες.	-uu -u u- uu-uu -u u--	dactylic hexameter	masculine penthemimeral
ἄλλος δ᾽αὖ κόχλοισι δομὴν ἰνδάλλεται αἴης,	-- - --u u- --uu --	dactylic hexameter	feminine penthemimeral, hepthemimeral, trithemimeral
ἄλλῳ δ᾽ἐγχλοάουσα λοπὶς περιμήκεα κύκλον	-- -uu-u u- uu-uu --	dactylic hexameter	feminine penthemimeral, hepthemimeral
ποικίλον αἰόλλει: πολέες δ᾽ἀμάθοισι μιγέντες	-uu --- uu- uu-u u--	dactylic hexameter	masculine penthemimeral, hepthemimeral
σπείρῃ λεπρύνονται ἀλινδόμενοι ψαμάθοισι.	-- ---u u-uu- uu--	dactylic hexameter	feminine penthemimeral
Φράζεο δ᾽αὐαλέῃσιν ἐπιφρικτὴν φολίδεσσιν	-uu -uu-u u--- uu--	dactylic hexameter	feminine penthemimeral
ἀσπίδα φοινήεσσαν, ἀμυδρότατον δάκος ἄλλων,	-uu ---u u-uu- uu --	dactylic hexameter	feminine penthemimeral
[τῇ μὲν γάρ τε κέλευθος ὁμῶς κατ᾽ ἐναντίον ἕρπει	- - - u u-u u- u u-uu --	dactylic hexameter	feminine penthemimeral, hepthemimeral, trithemimeral
ἀτραπὸν ὁλκαίην δολιχῷ μηρύγματι γαστρός.	-uu --- uu- --uu --	dactylic hexameter	masculine penthemimeral, hepthemimeral
ἣ καὶ σμερδαλέον μὲν ἔχει δέμας, ἐν δὲ κελεύθῳ	- - -uu- u u- uu - u u--	dactylic hexameter	masculine penthemimeral, hepthemimeral
νωχελὲς ἐξ ὁλκοῖο φέρει βάρος, ὑπναλέῳ δέ	-uu - --u u- uu -uu- -	dactylic hexameter	feminine penthemimeral, hepthemimeral, trithemimeral
αἰὲν ἐπιλλίζουσα φαείνεται ἐνδυκὲς ὄσσῳ:	-u u---u u-uu -uu --	dactylic hexameter	feminine penthemimeral
ἀλλ᾽ ὅταν ἢ δοῦπον νέον οὔασιν ἠέ τιν᾽ αὐγήν	- uu - -- uu -uu -u u --	dactylic hexameter	masculine penthemimeral, trithemimeral
ἀθρήσῃ, νωθῆ μὲν ἀπὸ ῥέθεος βάλεν ὕπνον,	--- -- u u- uu- uu --	dactylic hexameter	masculine penthemimeral, hepthemimeral, trithemimeral
ὁλκῷ δὲ τροχόεσσαν ἅλων εἱλίξατο γαίῃ,	-- - uu-u u- --uu --	dactylic hexameter	feminine penthemimeral, hepthemimeral, trithemimeral
λευγαλέον δ᾽ἀνὰ μέσσα κάρη πεφρικὸς ἀείρει.	-uu- uu -u u- uu- ---	dactylic hexameter	feminine penthemimeral, hepthemimeral, trithemimeral
τῆς ἤτοι μῆκος μέν, ὃ κύντατον ἔτρεφεν αἶα,	- -- -- u u -uu -uu --	dactylic hexameter	masculine penthemimeral, trithemimeral
ὀργυιῇ μετρητόν: ἀτὰρ περιφαίνεται εὖρος	--- --u u- uu-uu --	dactylic hexameter	feminine penthemimeral, hepthemimeral, trithemimeral
ὅσσον τ᾽αἰγανέης δορατοξόος ἤνυσε τέκτων	-- -uu- uu-uu -uu --	dactylic hexameter	masculine penthemimeral
εἰς ἐνοπὴν ταύρων τε βαρυφθόγγων τε λεόντων.	- uu- -- u u--- u u--	dactylic hexameter	masculine penthemimeral, trithemimeral
χροιὴ δ᾽ἄλλοτε μὲν ψαφαρὴ ἐπιδέδρομε νώτοις,	-- -uu - uu- uu-uu --	dactylic hexameter	masculine penthemimeral, hepthemimeral
ἄλλοτε μηλινόεσσα καὶ αἰόλος, ἄλλοτε τεφρή,	-uu -uu-u u -uu -uu --	dactylic hexameter	feminine penthemimeral
πολλάκι δ᾽αἰθαλόεσσα μελαινομένη ὑπὸ βώλῳ	-uu -uu-u u-uu- uu --	dactylic hexameter	feminine penthemimeral
Αἰθιόπων, οἵην τε πολύστομος εἰς ἅλα Νεῖλος	-uu- -- u u-uu - uu --	dactylic hexameter	masculine penthemimeral, trithemimeral
πλησάμενος κατέχευεν ἄσιν προὔτυψε δὲ πόντῳ.	-uu- uu-u u- --u u --	dactylic hexameter	feminine penthemimeral, hepthemimeral, trithemimeral
δοιοὶ δ᾽ἐν σκυνίοισιν ὑπερφαίνουσι μέτωπον	-- - uu-u u---u u--	dactylic hexameter	feminine penthemimeral, trithemimeral
οἷα τύλοι, τὸ δ᾽ἔνερθεν ὑπαιφοινίσσεται ὄθμα	-u u- u u-u u---uu --	dactylic hexameter	feminine penthemimeral, trithemimeral
πολλὸν ὑπὲρ σπείρης, ψαφαρὸς δ᾽ἀναπίμπραται αὐχήν	-u u- -- uu- uu-uu --	dactylic hexameter	masculine penthemimeral, hepthemimeral, trithemimeral
ἄκριτα ποιφύσσοντος ὅτ᾽ ἀντομένοισιν ὁδουροῖς	-uu ---u u -uu-u u--	dactylic hexameter	feminine penthemimeral
ἄιδα προσμάξηται ἐπὶ ζαμενὲς κοτέουσα.	-uu ---u u- uu- uu--	dactylic hexameter	feminine penthemimeral, hepthemimeral
τῆς ἤτοι πίσυρες κοῖλοι ὑπένερθεν ὀδόντες	- -- uu- -- uu-u u--	dactylic hexameter	masculine penthemimeral, hepthemimeral, trithemimeral
ἀγκύλοι ἐν γναθμοῖς δολιχήρεες ἐρρίζωνται	-uu - -- uu-uu ----	dactylic hexameter	masculine penthemimeral, trithemimeral
ἰοδόκοι, μύχατος δὲ χιτὼν ὑμένεσσι καλύπτει:	-uu- uu- u u- uu-u u--	dactylic hexameter	masculine penthemimeral, hepthemimeral, trithemimeral
ἔνθεν ἀμείλικτον γυίοις ἐνερεύγεται ἰόν.	-u u--- -- uu-uu --	dactylic hexameter	masculine penthemimeral, hepthemimeral
ἐχθρῶν που τέρα κεῖνα καρήασιν ἐμπελάσειε:	-- - uu -u u-uu -uu--	dactylic hexameter	feminine penthemimeral, trithemimeral
σαρκὶ γὰρ οὔτ᾽ ἐπὶ δάχμα φαείνεται, οὔτε δυσαλθές	-u u - uu -u u-uu -u u--	dactylic hexameter	feminine penthemimeral, trithemimeral
οἶδος ἐπιφλέγεται, καμάτου δ᾽ἄτερ ὄλλυται ἀνήρ,	-u u-uu- uu- uu -uu --	dactylic hexameter	masculine penthemimeral, hepthemimeral
ὑπνηλὸν δ᾽ἐπὶ νῶκαρ ἄγει βιότοιο τελευτήν.	--- uu -u u- uu-u u--	dactylic hexameter	feminine penthemimeral, hepthemimeral, trithemimeral
Ἰχνεύμων δ᾽ἄρα μοῦνος ἀκήριος ἀσπίδος ὁρμήν,	--- uu -u u-uu -uu --	dactylic hexameter	feminine penthemimeral, trithemimeral
ἠμὲν ὅτ᾽ ἐς μόθον εἶσιν, ἀλεύεται, ἠδ᾽ ὅτε λυγρά	-u u - uu -u u-uu - uu --	dactylic hexameter	feminine penthemimeral, trithemimeral
θαλπούσης ὄφιος κηριτρόφου ὤεα γαίῃ	--- uu- --uu -uu --	dactylic hexameter	masculine penthemimeral, trithemimeral
πάντα διεσκήνιψε, καὶ ἐξ ὑμένων ἐτίναξε	-u u---u u - uu- uu--	dactylic hexameter	feminine penthemimeral, hepthemimeral
δαρδάπτων, ὀλοοῖς δὲ συνερραθάγησεν ὀδοῦσι.	--- uu- u u-uu-u u--	dactylic hexameter	masculine penthemimeral, trithemimeral
μορφὴ δ᾽ἰχνευτᾶο κινωπέτου οἷον ἀμυδρῆς	-- ---u u-uu -u u--	dactylic hexameter	feminine penthemimeral
ἴκτιδος ἥ τ᾽ὄρνισι κατοικιδίῃσιν ὄλεθρον	-uu - --u u-uu-u u--	dactylic hexameter	feminine penthemimeral, trithemimeral
μαίεται, ἐξ ὕπνοιο συναρπάζουσα πετεύρων	-uu - --u u---u u--	dactylic hexameter	feminine penthemimeral, trithemimeral
ἔνθα λέχος τεύχονται ἐπίκριοι ἢ καὶ ἀφαυρά	-u u- --u u-uu - u u--	dactylic hexameter	feminine penthemimeral, trithemimeral
τέκνα τιθαιβώσσουσιν ὑπὸ πλευρῇσι θέρουσαι.	-u u---u u- --u u--	dactylic hexameter	feminine penthemimeral, hepthemimeral
ἀλλ᾽ ὅταν Αἰγύπτοιο παρὰ θρυόεντας ἰάμνους	- uu ---u u- uu-u u--	dactylic hexameter	feminine penthemimeral, hepthemimeral
ἀσπίσι μῶλον ἔχωσιν ἀθέσφατον εἱλικοέσσαις,	-uu -u u-u u-uu -uu--	dactylic hexameter	feminine penthemimeral
αὐτίχ᾽ ὁ μὲν ποταμόνδε καθήλατο, τύψε δὲ κώλοις	-u u - uu-u u-uu -u u --	dactylic hexameter	feminine penthemimeral, trithemimeral
τάρταρον ἰλυόεσσαν, ἄφαρ δ᾽ἐφορύξατο γυῖα	-uu -uu-u u- uu-uu --	dactylic hexameter	feminine penthemimeral, hepthemimeral
πηλῷ, ἀλινδηθεὶς ὀλίγον δέμας εἰσόκε λάχνην	-u u--- uu- uu -uu --	dactylic hexameter	masculine penthemimeral, hepthemimeral
Σείριος ἀζήνῃ τεύξῃ δ᾽ἄγναπτον ὀδόντι.	-uu --- -- --u u--	dactylic hexameter	masculine penthemimeral, hepthemimeral
τῆμος δ᾽ἠὲ κάρην λιχμήρεος ἑρπηστᾶο	-- -u u- --uu ----	dactylic hexameter	masculine penthemimeral
σμερδαλέην ἔβρυξεν ἐπάλμενος ἠὲ καὶ οὐρῆς	-uu- --u u-uu -u u --	dactylic hexameter	feminine penthemimeral, trithemimeral
ἁρπάξας βρυόεντος ἔσω ποταμοῖο κύλισεν.	--- uu-u u- uu-u u--	dactylic hexameter	feminine penthemimeral, hepthemimeral, trithemimeral
Εὖ δ᾽ἂν ἐχιδνήεσσαν ἴδοις πολυδευκέα μορφήν,	- u u---u u- uu-uu --	dactylic hexameter	feminine penthemimeral, hepthemimeral
ἄλλοτε μὲν δολιχήν, ὁτὲ παυράδα: τοιάδ᾽ ἀέξει	-uu - uu- uu -uu -u u--	dactylic hexameter	masculine penthemimeral, trithemimeral
Εὐρώπη τ᾽Ἀσίη τε: τὰ δ᾽οὐκ ἐπιείκελα δήεις.	--- uu- u u - uu-uu --	dactylic hexameter	masculine penthemimeral, hepthemimeral, trithemimeral
ἤτοι ἀν᾽ Εὐρώπην μὲν ὀλίζονα, καί θ᾽ὑπὲρ ἄκρους	-u u --- u u-uu - uu --	dactylic hexameter	masculine penthemimeral
ῥώθωνας κεραοί τε καὶ ἀργίλιπες τελέθουσιν,	--- uu- u u -uu- uu--	dactylic hexameter	masculine penthemimeral, trithemimeral
αἱ μὲν ὑπὸ Σκείρωνος ὄρη Παμβώνιά τ᾽αἴπη,	- u u- --u u- --uu --	dactylic hexameter	feminine penthemimeral, hepthemimeral, trithemimeral
Ῥυπαῖον, Κόρακός τε πάγον, πολιόν τ᾽Ἀσέληνον:	--- uu- u u- uu- uu--	dactylic hexameter	masculine penthemimeral, hepthemimeral, trithemimeral
Ἀσὶς δ᾽ὀργυιόεντα καὶ ἐς πλέον ἑρπετὰ βόσκει,	-- -uu-u u - uu -uu --	dactylic hexameter	feminine penthemimeral, hepthemimeral
οἷα περὶ τρηχὺν Βουκάρτερον, ἢ καὶ ἐρυμνός	-u u- -- --uu - u u--	dactylic hexameter	masculine penthemimeral, trithemimeral
Αἰσαγέης πρηὼν καὶ Κέρκαφος ἐντὸς ἐέργει.	-uu- -- - -uu -u u--	dactylic hexameter	masculine penthemimeral, trithemimeral
τῶν ἤτοι βρεχμοῖς μὲν ἐπὶ πλάτος, ἠδ᾽ ὑπὲρ ἄκρον	- -- -- u u- uu - uu --	dactylic hexameter	masculine penthemimeral, hepthemimeral, trithemimeral
ὁλκαῖον σπείρης κολοβὴν ἐπελίσσεται οὐρήν	--- -- uu- uu-uu --	dactylic hexameter	masculine penthemimeral, hepthemimeral, trithemimeral
ἀζαλέαις φρίσσουσαν ἐπηετανὸν φολίδεσσι:	-uu- --u u-uu- uu--	dactylic hexameter	feminine penthemimeral, trithemimeral
νωθεῖ δ᾽ἔνθα καὶ ἔνθα διὰ δρυμὰ νίσσεται ὁλκῷ.	-- -u u -u u- uu -uu --	dactylic hexameter	feminine penthemimeral, hepthemimeral
πᾶς δέ τοι ὀξυκάρηνος ἰδεῖν ἔχις, ἄλλοτε μῆκος	- u u -uu-u u- uu -uu --	dactylic hexameter	feminine penthemimeral, hepthemimeral
μάσσων, ἄλλοτε παῦρος: ἀκιδνότερος δὲ κατ᾽ εὖρος	-- -uu -u u-uu- u u --	dactylic hexameter	feminine penthemimeral
νηδύος, ἡ δὲ μύουρος ὑπ᾽ ἀλκαίη τετάνυσται,	-uu - u u-u u --- uu--	dactylic hexameter	feminine penthemimeral, trithemimeral
ἴσως μὲν πεδανὴ δολιχοῦ ὑπὸ πείρασιν ὁλκοῦ,	-- - uu- uu- uu -uu --	dactylic hexameter	masculine penthemimeral, hepthemimeral, trithemimeral
ἴσως δ᾽ἐκ φολίδων τετρυμένη: αὐτὰρ ἐνωπῆς	-- - uu- uu-- -u u--	dactylic hexameter	masculine penthemimeral, trithemimeral
γλήνεα φοινίσσει τεθοωμένος, ὀξὺ δὲ δικρῇ	-uu --- uu-uu -u u --	dactylic hexameter	masculine penthemimeral
γλώσσῃ λιχμάζων νέατον σκωλύπτεται οὐρήν:	-- --- uu- --uu --	dactylic hexameter	masculine penthemimeral, hepthemimeral
Κωκυτὸν δ᾽ἐχιαῖον ἐπικλείουσιν ὁδῖται.	--- uu-u u---u u--	dactylic hexameter	feminine penthemimeral, trithemimeral
τοῦ μὲν ὑπὲρ κυνόδοντε δύω χροῒ τεκμαίρονται	- u u- uu-u u- uu ----	dactylic hexameter	feminine penthemimeral, hepthemimeral, trithemimeral
ἰὸν ἐρευγόμενοι: πλέονες δέ τοι αἰὲν ἐχίδνης,	-u u-uu- uu- u u -u u--	dactylic hexameter	masculine penthemimeral, hepthemimeral
οὔλῳ γὰρ στομίῳ ἐμφύεται, ἀμφὶ δὲ σαρκί	-- - uu- --uu -u u --	dactylic hexameter	masculine penthemimeral, trithemimeral
ῥεῖά κεν εὐρυνθέντας ἐπιφράσσαιο χαλινούς.	-u u ---u u---u u--	dactylic hexameter	feminine penthemimeral
τῆς καὶ ἀπὸ πληγῆς φέρεται λίπει εἴκελος ἰχώρ,	- u u- -- uu- uu -uu --	dactylic hexameter	masculine penthemimeral, hepthemimeral, trithemimeral
ἄλλοτε δ᾽αἱματόεις, τοτὲ δ᾽ἄχροος: ἡ δ᾽ἐπί οἱ σάρξ	-uu -uu- uu -uu - uu - -	dactylic hexameter	masculine penthemimeral
πολλάκι μὲν χλοάουσα βαρεῖ ἀναδέδρομεν οἴδει,	-uu - uu-u u- uu-uu --	dactylic hexameter	feminine penthemimeral, hepthemimeral, trithemimeral
ἄλλοτε φοινίσσουσα, τότ᾽ εἴδεται ἄντα πελιδνή:	-uu ---u u -uu -u u--	dactylic hexameter	feminine penthemimeral
ἄλλοτε δ᾽ὑδατόεν κυέει βάρος, αἱ δὲ χαμηλαί	-uu -uu- uu- uu - u u--	dactylic hexameter	masculine penthemimeral, hepthemimeral
πομφόλυγες ὡς εἴ τε περὶ φλύκταιναι ἀραιαί	-uu- - - u u- --u u--	dactylic hexameter	masculine penthemimeral, hepthemimeral, trithemimeral
οἷα πυρικμήτοιο χροὸς πλαδόωσιν ὕπερθεν.	-u u---u u- uu-u u--	dactylic hexameter	feminine penthemimeral, hepthemimeral
σηπεδόνες δέ οἱ ἀμφὶς ἐπίδρομοι, αἱ μὲν ἄτερθεν	-uu- u u -u u-uu - u u--	dactylic hexameter	feminine penthemimeral, trithemimeral
αἱ δὲ κατὰ πληγὴν ἰοειδέα λοιγὸν ἱεῖσαι.	- u u- -- uu-uu -u u--	dactylic hexameter	masculine penthemimeral, trithemimeral
πᾶν δ᾽ἐπί οἱ δριμεῖα δέμας καταβόσκεται ἄτη	- uu - --u u- uu-uu --	dactylic hexameter	feminine penthemimeral, hepthemimeral, trithemimeral
ὀξέα πυρπολέουσα: κατ᾽ ἀσφάραγον δέ τε λυγμοί	-uu -uu-u u -uu- u u --	dactylic hexameter	feminine penthemimeral
κίονά τε ξυνιόντες ἐπασσύτεροι κλονέουσιν.	-uu - uu-u u-uu- uu--	dactylic hexameter	feminine penthemimeral, trithemimeral
ἀμφὶ καὶ εἰλίγγοις δέμας ἄχθεται: αἶψα δὲ γυίοις	-u u --- uu -uu -u u --	dactylic hexameter	masculine penthemimeral
ἀδρανίη βαρύθουσα καὶ ἰξύι μέρμερος ἵζει,	-uu- uu-u u -- -uu --	dactylic hexameter	feminine penthemimeral, trithemimeral
ἐν δὲ κάρῃ σκοτόεν βάρος ἵσταται: αὐτὰρ ὁ κάμνων	- u u- uu- uu -uu -u u --	dactylic hexameter	masculine penthemimeral, trithemimeral
ἄλλοτε μὲν δίψῃ φάρυγα ξηραίνεται αὔῃ,	-uu - -- uu- --uu --	dactylic hexameter	masculine penthemimeral, hepthemimeral, trithemimeral
πολλάκι δ᾽ἐξ ὀνύχων ἴσχει κρύος, ἀμφὶ δὲ γυίοις	-uu - uu- -- uu -u u --	dactylic hexameter	masculine penthemimeral, hepthemimeral, trithemimeral
χειμερίη ζαλόωσα πέριξ βέβριθε χάλαζα.	-uu- uu-u u- uu- ---	dactylic hexameter	feminine penthemimeral, hepthemimeral, trithemimeral
πολλάκι δ᾽αὖ χολόεντας ἀπήρυγε νηδύος ὄγκους	-uu - uu-u u-uu -uu --	dactylic hexameter	feminine penthemimeral, trithemimeral
ὠχραίνων δέμας ἀμφίς: ὁ δὲ νοτέων περὶ γυίοις	--- uu -u u - uu- uu --	dactylic hexameter	feminine penthemimeral, hepthemimeral, trithemimeral
ψυχρότερος νιφετοῖο βολῆς περιχεύεται ἱδρώς.	-uu- uu-u u- uu-uu --	dactylic hexameter	feminine penthemimeral, hepthemimeral, trithemimeral
χροιὴν δ᾽ἄλλοτε μὲν μολίβου ζοφοειδέος ἴσχει,	-- -uu - uu- uu-uu --	dactylic hexameter	masculine penthemimeral, hepthemimeral
ἄλλοτε δ᾽ἠερόεσσαν, ὅτ᾽ ἄνθεσιν εἴσατο χαλκοῦ.	-uu -uu-u u -uu -uu --	dactylic hexameter	feminine penthemimeral
Εὖ δ᾽ἂν καὶ δολόεντα μάθοις ἐπιόντα κεράστην	- - - uu-u u- uu-u u--	dactylic hexameter	feminine penthemimeral, hepthemimeral, trithemimeral
ἠύτ᾽ ἔχιν: τῷ γάρ τε δομὴν ἰνδάλλεται ἴσην.	-u u- - - u u- --uu --	dactylic hexameter	masculine penthemimeral, hepthemimeral, trithemimeral
ἤτοι ὁ μὲν κόλος ἐστίν, ὁ δ᾽αὖ κεράεσσι πεποιθώς,	-u u - uu -u u - uu-u u--	dactylic hexameter	feminine penthemimeral, hepthemimeral, trithemimeral
ἄλλοτε μὲν πισύρεσσιν, ὅτ᾽ ἐν δοιοῖσι κεράστης,	-uu - uu-u u - --u u--	dactylic hexameter	feminine penthemimeral, hepthemimeral, trithemimeral
χροιῇ δ᾽ἐν ψαφαρῇ λεπρύνεται, ἐν δ᾽ἀμάθοισιν	-- - uu- uu-- - uu--	dactylic hexameter	masculine penthemimeral, trithemimeral
ἢ καὶ ἁματροχιῇσι κατὰ στίβον ἐνδυκὲς αὔει.	- u u-uu-u u- uu -uu --	dactylic hexameter	feminine penthemimeral, hepthemimeral
τῶν ἤτοι σπείρῃσιν ὁ μὲν θοὸς ἀντία θύνει	- -- --u u - uu -uu --	dactylic hexameter	feminine penthemimeral, hepthemimeral, trithemimeral
ἀτραπὸν ἰθεῖαν δολιχῷ μηρύγματι γαστρός:	-uu --- uu- --uu --	dactylic hexameter	masculine penthemimeral, hepthemimeral
αὐτὰρ ὅγε σκαιὸς μεσάτῳ ἐπαλίνδεται ὁλκῷ	-u u- -- uu- uu-uu --	dactylic hexameter	masculine penthemimeral, hepthemimeral, trithemimeral
οἶμον ὁδοιπλανέων σκολιὴν τετρηχότι νώτῳ,	-u u-uu- uu- --uu --	dactylic hexameter	masculine penthemimeral, hepthemimeral
τράμπιος ὁλκαίης ἀκάτῳ ἴσος ἥ τε δι᾽ ἅλμης	-uu --- uu- uu - u u --	dactylic hexameter	masculine penthemimeral, hepthemimeral
πλευρὸν ὅλον βάπτουσα κακοσταθέοντος ἀήτεω	-u u- --u u-uu-u u--	dactylic hexameter	feminine penthemimeral, trithemimeral
εἰς ἄνεμον βεβίηται ἀπόκρουστος λιβὸς οὔρῳ.	- uu- uu-u u--- uu --	dactylic hexameter	feminine penthemimeral, trithemimeral
τοῦ μέν, ὅτ᾽ ἐμβρύξῃσιν, ἀεικέλιον περὶ νύχμα	- u u ---u u-uu- uu --	dactylic hexameter	feminine penthemimeral
ἥλῳ ἐειδόμενον τυλόεν πέλει: αἱ δὲ πελιδναί	-u u-uu- uu- uu - u u--	dactylic hexameter	masculine penthemimeral, hepthemimeral
φλύκταιναι πέμφιξιν ἐειδόμεναι ὑετοῖο	--- --u u-uu- uu--	dactylic hexameter	feminine penthemimeral, trithemimeral
δάχμα πέρι πλάζονται, ἀμυδρήεσσαι ἐς ὠπήν.	-u u- --u u---u u --	dactylic hexameter	feminine penthemimeral, trithemimeral
ἤτοι ἀφαυρότερον τελέει πόνον, ἐννέα δ᾽αὐγάς	-u u-uu- uu- uu -uu --	dactylic hexameter	masculine penthemimeral, hepthemimeral
ἠελίου μογέων ἐπιόσσεται, οἷσι κεράστης	-uu- uu- uu-uu -u u--	dactylic hexameter	masculine penthemimeral, trithemimeral
οὐλόμενος κακοεργὸν ἐνιχραύσῃ κυνόδοντα.	-uu- uu-u u--- uu--	dactylic hexameter	feminine penthemimeral, trithemimeral
διπλῷ δ᾽ἐν βουβῶνι καὶ ἰγνύσιν ἀσκελὲς αὔτως	-- - --u u -uu -uu --	dactylic hexameter	feminine penthemimeral, trithemimeral
μόχθος ἐνιτρέφεται, πελιὸς δέ οἱ ἐμφέρεται χρώς:	-u u-uu- uu- u u -uu- -	dactylic hexameter	masculine penthemimeral, hepthemimeral
τῶν δέ τε καμνόντων ὀλίγος περὶ ἅψεα θυμός	- u u --- uu- uu -uu --	dactylic hexameter	masculine penthemimeral, hepthemimeral
λείπεται ἐκ καμάτοιο: μόλις γε μὲν ἔκφυγον αἶσαν.	-uu - uu-u u- u u -uu --	dactylic hexameter	feminine penthemimeral, hepthemimeral, trithemimeral
Σῆμα δέ τοι δάκεος αἱμορρόου αὖτις ἐνίψω,	-u u - uu- --uu -u u--	dactylic hexameter	masculine penthemimeral, trithemimeral
ὅς τε κατ᾽ ἀμβαθμοὺς πετρώδεας ἐνδυκὲς αὔει,	- u u --- --uu -uu --	dactylic hexameter	masculine penthemimeral
τρηχὺν ὑπάρπεζον θαλάμην ὀλιγήρεα τεύχων	-u u--- uu- uu-uu --	dactylic hexameter	masculine penthemimeral, hepthemimeral
ἔνθ᾽ εἰλυθμὸν ἔχεσκεν ἐπεί τ᾽ἐκορέσσατο φορβῆς.	- --u u-u u- uu-uu --	dactylic hexameter	feminine penthemimeral, hepthemimeral
μήκει μὲν ποδὸς ἴχνος ἰσάζεται, αὐτὰρ ἐπ᾽ εὖρος	-- - uu -u u-uu -u u --	dactylic hexameter	feminine penthemimeral, trithemimeral
τέτρυται μύουρος ἀπὸ φλογέοιο καρήνου,	--- --u u- uu-u u--	dactylic hexameter	feminine penthemimeral, hepthemimeral, trithemimeral
ἄλλοτε μὲν χροιῇ ψολόεις, ὁτὲ δ᾽ἔμπαλιν αἰθός.	-uu - -- uu- uu -uu --	dactylic hexameter	masculine penthemimeral, hepthemimeral, trithemimeral
δειρὴν δ᾽ἐσφήκωται ἅλις, πεδανὴ δέ οἱ οὐρή	-- ---u u- uu- u u --	dactylic hexameter	feminine penthemimeral, hepthemimeral
ζαχρειὲς θλιφθεῖσα κατομφάλιος τετάνυσται.	--- --u u-uu- uu--	dactylic hexameter	feminine penthemimeral, trithemimeral
τοῦ μὲν ὑπὸ νιφόεντα κεράατα δοιὰ μετώπῳ	- u u- uu-u u-uu -u u--	dactylic hexameter	feminine penthemimeral, trithemimeral
ἔγκειται πάρνοψι φάη λογάδας τι προσεικῆ:	--- --u u- uu- u u--	dactylic hexameter	feminine penthemimeral, hepthemimeral, trithemimeral
σμερδαλέον δ᾽ἐπί οἱ λαμυρὸν πέφρικε κάρηνον.	-uu- uu - uu- uu- ---	dactylic hexameter	masculine penthemimeral, hepthemimeral, trithemimeral
δοχμὰ δ᾽ἐπισκάζων ὀλίγον δέμας οἷα κεράστης	-u u--- uu- uu -u u--	dactylic hexameter	masculine penthemimeral, hepthemimeral
μέσσου ὅγ᾽ ἐκ νώτου βαιὸν πλόον αἰὲν ὀκέλλει,	-u u - -- -- uu -u u--	dactylic hexameter	masculine penthemimeral, hepthemimeral, trithemimeral
γαίῃ ἐπιθλίβων νηδύν, φολίσιν δὲ καὶ ὁλκῷ	-u u--- -- uu- u u --	dactylic hexameter	masculine penthemimeral, hepthemimeral
παῦρον ὑποψοφέων καλάμης χύσιν οἷα διέρπει.	-u u-uu- uu- uu -u u--	dactylic hexameter	masculine penthemimeral, hepthemimeral
νύχματι δ᾽ἀρχομένῳ μὲν ἐπιτρέχει ἄχροον οἶδος	-uu -uu- u u-uu -uu --	dactylic hexameter	masculine penthemimeral
κυάνεον, κραδίην δὲ κακὸν περιτέτροφεν ἄλγος:	-uu- uu- u u- uu-uu --	dactylic hexameter	masculine penthemimeral, hepthemimeral, trithemimeral
γαστὴρ δ᾽ὑδατόεσσα διέσσυτο, νυκτὶ δὲ πρώτῃ	-- -uu-u u-uu -u u --	dactylic hexameter	feminine penthemimeral
αἷμα διὲκ ῥινῶν τε καὶ αὐχένος ἠδὲ δι᾽ ὤτων	-u u- -- u u -uu -u u --	dactylic hexameter	masculine penthemimeral, trithemimeral
πιδύεται χολόεντι νέον πεφορυγμένον ἰῷ,	-uu- uu-u u- uu-uu --	dactylic hexameter	feminine penthemimeral, hepthemimeral, trithemimeral
οὖρα δὲ φοινίσσοντα παρέδραμεν: αἱ δ᾽ἐπὶ γυίοις	-u u ---u u-uu - uu --	dactylic hexameter	feminine penthemimeral
ὠτειλαὶ ῥήγνυνται ἐπειγόμεναι χροὸς ἄτῃ.	--- --u u-uu- uu --	dactylic hexameter	feminine penthemimeral, trithemimeral
μήποτέ τοι θήλει᾽ αἱμορροῒς ἰὸν ἐνείη:	-uu - -- --uu -u u--	dactylic hexameter	masculine penthemimeral, trithemimeral
τῆς γὰρ ὀδαξαμένης τὰ μὲν ἀθρόα πίμπραται οὖλα	- u u-uu- u u -uu -uu --	dactylic hexameter	masculine penthemimeral
ῥιζόθεν, ἐξ ὀνύχων δὲ κατείβεται ἀσταγὲς αἷμα,	-uu - uu- u u-uu -uu --	dactylic hexameter	masculine penthemimeral, trithemimeral
οἱ δὲ φόνῳ μυδόεντες ἀναπλείουσιν ὀδόντες.	- u u- uu-u u---u u--	dactylic hexameter	feminine penthemimeral, trithemimeral
εἰ ἔτυμον, Τροίηθεν ἰοῦς᾽ ἐχαλέψατο φύλοις	- uu- --u u- uu-uu --	dactylic hexameter	feminine penthemimeral, hepthemimeral, trithemimeral
Αἰνελένη, ὅτε νῆα πολύστροιβον παρὰ Νεῖλον	-uu- uu -u u--- uu --	dactylic hexameter	feminine penthemimeral, trithemimeral
ἔστησαν βορέαο κακὴν προφυγόντες ὁμοκλήν,	--- uu-u u- uu-u u--	dactylic hexameter	feminine penthemimeral, hepthemimeral, trithemimeral
ἦμος ἀποψύχοντα κυβερνητῆρα Κάνωβον	-u u---u u---u u--	dactylic hexameter	feminine penthemimeral
Θώνιος ἐν ψαμάθοις ἀθρήσατο: τύψε γὰρ εὐνῇ	-uu - uu- --uu -u u --	dactylic hexameter	masculine penthemimeral, trithemimeral
αὐχέν᾽ ἀποθλιφθεῖσα καὶ ἐν βαρὺν ἤρυγεν ἰόν	-u u---u u - uu -uu --	dactylic hexameter	feminine penthemimeral, hepthemimeral
αἱμοροῒς θήλεια, κακὸν δέ οἱ ἔχραε κοῖτον.	-uu- --u u- u u -uu --	dactylic hexameter	feminine penthemimeral, hepthemimeral, trithemimeral
τῷ δ᾽Ἑλένη μέσον ὁλκὸν ἐνέθλασε, θραῦσε δ᾽ἀκάνθης	- uu- uu -u u-uu -u u--	dactylic hexameter	feminine penthemimeral, trithemimeral
δεσμὰ πέριξ νωταῖα, ῥάχις δ᾽ἐξέδραμε γυίων:	-u u- --u u- --uu --	dactylic hexameter	feminine penthemimeral, hepthemimeral, trithemimeral
ἐξ ὅθεν αἱμορόοι σκολιοπλανέες τε κεράσται	- uu -uu- uu-uu- u u--	dactylic hexameter	masculine penthemimeral
οἶοι χωλεύουσι κακηπελίῃ βαρύθοντες.	-- ---u u-uu- uu--	dactylic hexameter	feminine penthemimeral
Εὖ δ᾽ἂν σηπεδόνος γνοίης δέμας, ἄλλο μὲν εἴδει	- - -uu- -- uu -u u --	dactylic hexameter	masculine penthemimeral, hepthemimeral
αἱμορόῳ σύμμορφον, ἀτὰρ στίβον ἀντί᾽ ὀκέλλει,	-uu- --u u- uu -u u--	dactylic hexameter	feminine penthemimeral, hepthemimeral, trithemimeral
καὶ κεράων δ᾽ἔμπλην δέμας ἄμμορον, ἡ δέ νυ χροιή	- uu- -- uu -uu - u u --	dactylic hexameter	masculine penthemimeral, trithemimeral
οἵη περ τάπιδος λασίῳ ἐπιδέδρομε τέρφει:	-- - uu- uu- uu-uu --	dactylic hexameter	masculine penthemimeral, hepthemimeral, trithemimeral
κράατι δ᾽ἐμβαρύθει, ἐλάχεια δὲ φαίνεται οὐρή	-uu -uu- uu-u u -uu --	dactylic hexameter	masculine penthemimeral
ἐσσυμένῃ: σκολιὴν γὰρ ὁμῶς ἐπιτείνεται ἄκρην.	-uu- uu- u u- uu-uu --	dactylic hexameter	masculine penthemimeral, hepthemimeral, trithemimeral
τῆς δ᾽ἤτοι ὀλοὸν καὶ ἐπώδυνον ἔπλετο ἕλκος	- -- uu- u u-uu -uu --	dactylic hexameter	masculine penthemimeral, trithemimeral
σηπεδόνος, νέμεται δὲ μέλας ὀλοφώιος ἰός	-uu- uu- u u- uu-uu --	dactylic hexameter	masculine penthemimeral, hepthemimeral, trithemimeral
πᾶν δέμας, αὐαλέῃ δὲ περὶ χροῒ καρφομένη θρίξ	- uu -uu- u u- uu -uu- -	dactylic hexameter	masculine penthemimeral, hepthemimeral
σκίδναται ὡς γήρεια καταψηχθέντος ἀκάνθης:	-uu - --u u---u u--	dactylic hexameter	feminine penthemimeral, trithemimeral
ἐκ μὲν γὰρ κεφαλῆς τε καὶ ὀφρύος ἀνδρὶ τυπέντι	- - - uu- u u -uu -u u--	dactylic hexameter	masculine penthemimeral, trithemimeral
ῥαίονται, βλεφάρων δὲ μέλαιν᾽ ἐξέφθιτο λάχνη:	--- uu- u u- --uu --	dactylic hexameter	masculine penthemimeral, hepthemimeral, trithemimeral
ἅψεα δὲ τροχόεντες ἐπιστίζουσι μὲν ἀλφοί,	-uu - uu-u u---u u --	dactylic hexameter	feminine penthemimeral, trithemimeral
λεῦκαί τ᾽ἀργινόεσσαν ἐπισσεύουσιν ἔφηλιν.	-- -uu-u u---u u--	dactylic hexameter	feminine penthemimeral
Ναὶ μὴν διψάδος εἶδος ὁμώσεται αἰὲν ἐχίδνῃ	- - -uu -u u-uu -u u--	dactylic hexameter	feminine penthemimeral
παυροτέρῃ, θανάτου δὲ θοώτερος ἵξεται αἶσα	-uu- uu- u u-uu -uu --	dactylic hexameter	masculine penthemimeral, trithemimeral
οἷσιν ἐνισκίμψῃ βλοσυρὸν δάκος: ἤτοι ἀραιή	-u u--- uu- uu -u u--	dactylic hexameter	masculine penthemimeral, hepthemimeral
αἰὲν ὑποζοφόεσσα μελαίνεται ἄκροθεν οὐρή:	-u u-uu-u u-uu -uu --	dactylic hexameter	feminine penthemimeral
δάχματι δ᾽ἐμφλέγεται κραδίη πρόπαν, ἀμφὶ δὲ καύσῳ	-uu -uu- uu- uu -u u --	dactylic hexameter	masculine penthemimeral, hepthemimeral
χείλε᾽ ὑπ᾽ ἀζαλέης αὐαίνεται ἄβροχα δίψης:	-u u -uu- --uu -uu --	dactylic hexameter	masculine penthemimeral
αὐτὰρ ὅγ᾽, ἠύτε ταῦρος ὑπὲρ ποταμοῖο νενευκώς,	-u u -uu -u u- uu-u u--	dactylic hexameter	feminine penthemimeral, hepthemimeral
χανδὸν ἀμέτρητον δέχεται ποτὸν εἰσόκε νηδύς	-u u--- uu- uu -uu --	dactylic hexameter	masculine penthemimeral, hepthemimeral
ὀμφαλὸν †ἐξξέρρηξε† χέῃ δ᾽ὑπεραχθέα φόρτον.	-uu ---u u- uu-uu --	dactylic hexameter	feminine penthemimeral, hepthemimeral
ὠγύγιος δ᾽ἄρα μῦθος ἐν αἰζηοῖσι φορεῖται,	-uu- uu -u u ---u u--	dactylic hexameter	feminine penthemimeral, trithemimeral
ὡς, ὁπότ᾽ οὐρανὸν ἔσχε Κρόνου πρεσβίστατον αἷμα,	- uu -uu -u u- --uu --	dactylic hexameter	feminine penthemimeral, hepthemimeral
Νειμάμενος κασίεσσιν ἑκὰς περικυδέας ἀρχάς	-uu- uu-u u- uu-uu --	dactylic hexameter	feminine penthemimeral, hepthemimeral, trithemimeral
Ιδμοσύνῃ νεότητα γέρας πόρεν ἡμερίοισι	-uu- uu-u u- uu -uu--	dactylic hexameter	feminine penthemimeral, hepthemimeral, trithemimeral
Κυδαίνων: δὴ γάρ ῥα πυρὸς ληίστορ᾽ ἔνιπτον.	--- - - u u- --u u--	dactylic hexameter	masculine penthemimeral, hepthemimeral, trithemimeral
Αφρονες, οὐ μὲν τῆς γε κακοφραδίης ἀπόνηντο:	-uu - - - u u-uu- uu--	dactylic hexameter	masculine penthemimeral, trithemimeral
Νωθεῖς γὰρ κάμνοντες ἀμορβεύοντο λεπάργῳ	-- - --u u---u u--	dactylic hexameter	feminine penthemimeral, trithemimeral
Δῶρα: πολύσκαρθμος δὲ κεκαυμένος αὐχένα δίψῃ	-u u--- u u-uu -uu --	dactylic hexameter	masculine penthemimeral
Ρώετο, γωλειοῖσι δ᾽ἰδὼν ὁλκήρεα θῆρα	-uu ---u u- --uu --	dactylic hexameter	feminine penthemimeral, hepthemimeral
Οὐλοὸν ἐλλιτάνευε κακῇ ἐπαλαλκέμεν ἄτῃ	-uu -uu-u u- uu-uu --	dactylic hexameter	feminine penthemimeral, hepthemimeral
Σαίνων: αὐτὰρ ὁ βρῖθος ὃ δή ῥ᾽ἀνεδέξατο νώτοις	-- -u u -u u - uu-uu --	dactylic hexameter	feminine penthemimeral, hepthemimeral
ᾔτεεν ἄφρονα δῶρον: ὁ δ᾽οὐκ ἀπανήνατο χρειώ.	-uu -uu -u u - uu-uu --	dactylic hexameter	feminine penthemimeral, hepthemimeral
ἐξότε γηραλέον μὲν ἀεὶ φλόον ἑρπετὰ βάλλει	-uu -uu- u u- uu -uu --	dactylic hexameter	masculine penthemimeral, hepthemimeral
ὁλκήρη, θνητοὺς δὲ κακὸν περὶ γῆρας ὀπάζει:	--- -- u u- uu -u u--	dactylic hexameter	masculine penthemimeral, hepthemimeral, trithemimeral
νοῦσον δ᾽ἀζαλέην βρωμήτορος οὐλομένη θήρ	-- -uu- --uu -uu- -	dactylic hexameter	masculine penthemimeral
δέξατο, καί τε τυπῇσιν ἀμυδροτέρῃσιν ἰάπτει.	-uu - u u-u u-uu-u u--	dactylic hexameter	feminine penthemimeral, trithemimeral
Νῦν δ᾽ἄγε χερσύδροιο καὶ ἀσπίδος εἴρεο μορφάς	- uu ---u u -uu -uu --	dactylic hexameter	feminine penthemimeral
ἰσαίας: πληγῇ δὲ κακήθεα σήμαθ᾽ ὁμαρτεῖ:	--- -- u u-uu -u u--	dactylic hexameter	masculine penthemimeral, trithemimeral
πᾶσα γὰρ αὐαλέη ῥινὸς περὶ σάρκα μυσαχθής	-u u -uu- -- uu -u u--	dactylic hexameter	masculine penthemimeral, hepthemimeral
νειόθι πιτναμένη μυδόεν τεκμήρατο νύχμα,	-uu -uu- uu- --uu --	dactylic hexameter	masculine penthemimeral, hepthemimeral
σηπεδόσι φλιδόωσα: τὰ δ᾽ἄλγεα φῶτα δαμάζει	-uu- uu-u u -uu -u u--	dactylic hexameter	feminine penthemimeral, trithemimeral
μυρία πυρπολέοντα: θοαὶ δ᾽ἐπὶ γυῖα χέονται	-uu -uu-u u- uu -u u--	dactylic hexameter	feminine penthemimeral, hepthemimeral
πρηδόνες ἄλλοθεν ἄλλαι ἐπημοιβοὶ κλονέουσαι.	-uu -uu -u u--- uu--	dactylic hexameter	feminine penthemimeral
ὃς δ᾽ἤτοι τὸ πρὶν μὲν ὑπὸ βροχθώδεϊ λίμνῃ	- -- - - u u- --uu --	dactylic hexameter	masculine penthemimeral, hepthemimeral, trithemimeral
ἄσπειστον βατράχοισι φέρει κότον: ἀλλ᾽ ὅταν ὕδωρ	--- uu-u u- uu - uu --	dactylic hexameter	feminine penthemimeral, hepthemimeral, trithemimeral
Σείριος αὐήνῃσι, τρύγη δ᾽ἐν πυθμένι λίμνης,	-uu ---u u- - -uu --	dactylic hexameter	feminine penthemimeral, hepthemimeral
καὶ τόθ᾽ ὅγ᾽ ἐν χέρσῳ τελέθει ψαφαρός τε καὶ ἄχρους,	- u u - -- uu- uu- u u --	dactylic hexameter	masculine penthemimeral, hepthemimeral, trithemimeral
θάλπων ἠελίῳ βλοσυρὸν δέμας: ἐν δὲ κελεύθοις	-- -uu- uu- uu - u u--	dactylic hexameter	masculine penthemimeral, hepthemimeral
γλώσσῃ ποιφύγδην νέμεται διψήρεας ὄγμους.	-- --- uu- --uu --	dactylic hexameter	masculine penthemimeral, hepthemimeral
Τὸν δὲ μετ᾽ ἀμφίσβαιναν ὀλίζωνα βραδύθουσαν	- u u ---u u--- uu--	dactylic hexameter	feminine penthemimeral
δήεις ἀμφικάρηνον, ἀεὶ γλήνῃσιν ἀμυδρήν:	-- -uu-u u- --u u--	dactylic hexameter	feminine penthemimeral, hepthemimeral
ἀμβλὺ γὰρ ἀμφοτέρωθεν ἐπιπρονένευκε γένειον	-u u -uu-u u-uu-u u--	dactylic hexameter	feminine penthemimeral
νόσφιν ἀπ᾽ ἀλλήλων: χροιή γε μὲν ἠύτε γαίης,	-u u --- -- u u -uu --	dactylic hexameter	masculine penthemimeral, hepthemimeral
ῥωγαλέον φορέουσα περιστιγὲς αἰόλον ἔρφος.	-uu- uu-u u-uu -uu --	dactylic hexameter	feminine penthemimeral, trithemimeral
τὴν μὲν ὅθ᾽ ἁδρύνηται, ὀροιτύποι, οἷα βατῆρα	- u u ---u u-uu -u u--	dactylic hexameter	feminine penthemimeral
κόψαντες ῥάδικα πολυστεφέος κοτίνοιο,	--- uu- --uu- uu--	dactylic hexameter	masculine penthemimeral, trithemimeral
δέρματος ἐσκύλευσαν, ὅτε πρώτιστα πέφανται	-uu ---u u- --u u--	dactylic hexameter	feminine penthemimeral, hepthemimeral
πρόσθε βοῆς κόκκυγος ἐαρτέρου: ἡ δ᾽ὀνίνησι	-u u- --u u-uu - uu--	dactylic hexameter	feminine penthemimeral, trithemimeral
ῥινῷ δυσπαθέοντας ὅτ᾽ ἐν παλάμῃσιν ἀεργοί	-- -uu-u u - uu-u u--	dactylic hexameter	feminine penthemimeral, hepthemimeral
μάλκαι ἐπιπροθέωσιν ὑπὸ κρυμοῖο δαμέντων	-u u-uu-u u- --u u--	dactylic hexameter	feminine penthemimeral, hepthemimeral
ἠδ᾽ ὁπόταν νεύρων ξανάᾳ κεχαλασμένα δεσμά.	- uu- -- uu- uu-uu --	dactylic hexameter	masculine penthemimeral, hepthemimeral, trithemimeral
Δήεις καὶ σκυτάλην ἐναλίγκιον ἀμφισβαίνῃ	-- - uu- uu-uu ----	dactylic hexameter	masculine penthemimeral, trithemimeral
εἶδος ἀτὰρ πάχετόν τε καὶ οὐτιδανὴν ἐπὶ σειρήν	-u u- uu- u u -uu- uu --	dactylic hexameter	masculine penthemimeral, trithemimeral
μάσσον᾽, ἐπεὶ σκυτάλης μὲν ὅσον σμινύοιο τέτυκται	-u u- uu- u u- uu-u u--	dactylic hexameter	masculine penthemimeral, hepthemimeral, trithemimeral
στειλειῆς πάχετος, τῆς δ᾽ἕλμινθος πέλει ὄγκος	--- uu- - --- uu --	dactylic hexameter	masculine penthemimeral, trithemimeral
ἠὲ καὶ ἔντερα γῆς οἷα τρέφει ὄμβριος αἶα.	-u u -uu - -- uu -uu --	dactylic hexameter	masculine penthemimeral, hepthemimeral
οὐδ᾽ ἄρ᾽, ὅταν χαράδρεια λίπῃ καὶ ῥωγάδα κοίλην	- u u- uu-u u- - -uu --	dactylic hexameter	feminine penthemimeral, hepthemimeral, trithemimeral
ἦρος ἀεξομένου ὁπόθ᾽ ἑρπετὰ γαῖα φαείνῃ,	-u u-uu- uu -uu -u u--	dactylic hexameter	masculine penthemimeral
ἀκρεμόνος μαράθοιο χυτὸν περιβόσκεται ἔρνος,	-uu- uu-u u- uu-uu --	dactylic hexameter	feminine penthemimeral, hepthemimeral, trithemimeral
εὖτ᾽ ἂν ὑπ᾽ ἠελίοιο περὶ φλόον ἅψεα βάλλῃ,	- u u -uu-u u- uu -uu --	dactylic hexameter	feminine penthemimeral, hepthemimeral
ἀλλ᾽ ἥγ᾽ ἀρπέζαις τε καὶ ἐν νεμέεσσι πεσοῦσα	- - --- u u - uu-u u--	dactylic hexameter	masculine penthemimeral, hepthemimeral
φωλεύει βαθύυπνος, ἀπ᾽ εἰκαίης δὲ βοτεῖται	--- uu-u u --- u u--	dactylic hexameter	feminine penthemimeral, trithemimeral
γαίης οὐδ᾽ ἀπὸ δίψος ἀλέξεται ἱεμένη περ.	-- - uu -u u-uu -uu- -	dactylic hexameter	feminine penthemimeral, trithemimeral
Τεκμαίρευ δ᾽ὀλίγον μὲν ἀτὰρ προφερέστατον ἄλλων	--- uu- u u- uu-uu --	dactylic hexameter	masculine penthemimeral, hepthemimeral, trithemimeral
ἑρπηστῶν βασιλῆα: τὸ μὲν δέμας ὀξυκάρηνος,	--- uu-u u - uu -uu--	dactylic hexameter	feminine penthemimeral, hepthemimeral, trithemimeral
ξανθός, ἐπὶ τρία δῶρα φέρων μῆκός τε καὶ ἰθύν.	-u u- uu -u u- -- u u --	dactylic hexameter	feminine penthemimeral, hepthemimeral, trithemimeral
οὐκ ἄρα δὴ κείνου σπειραχθέα κνώδαλα γαίης	- uu - -- --uu -uu --	dactylic hexameter	masculine penthemimeral, trithemimeral
ἰυγὴν μίμνουσιν ὅτ᾽ ἐς νομὸν ἠὲ καὶ ὕλην	--- --u u - uu -u u --	dactylic hexameter	feminine penthemimeral, hepthemimeral, trithemimeral
ἠὲ καὶ ἀρδηθμοῖο μεσημβρινὸν ἀίξαντες	-u u ---u u-uu ----	dactylic hexameter	feminine penthemimeral
μείρονται, φύζῃ δὲ παλιντροπέες φορέονται.	--- -- u u-uu- uu--	dactylic hexameter	masculine penthemimeral, trithemimeral
τύμματι δ᾽ἐπρήσθη φωτὸς δέμας, αἱ δ᾽ἀπὸ γυίων	-uu --- -- uu - uu --	dactylic hexameter	masculine penthemimeral, hepthemimeral
σάρκες ἀπορρείουσι πελιδναί τε ζοφεραί τε:	-u u---u u-- - uu- -	dactylic hexameter	feminine penthemimeral
οὐδέ τις οὐδ᾽ οἰωνὸς ὑπὲρ νέκυν ἴχνια τείνας,	-u u - --u u- uu -uu --	dactylic hexameter	feminine penthemimeral, hepthemimeral, trithemimeral
αἰγυπιοὶ γῦπές τε κόραξ τ᾽ὀμβρήρεα κρώζων,	-uu- -- u u- --uu --	dactylic hexameter	masculine penthemimeral, hepthemimeral, trithemimeral
οὐδὲ μὲν ὅσσα τε φῦλα νομάζεται οὔρεσι θηρῶν	-u u -u u -u u-uu -uu --	dactylic hexameter	feminine penthemimeral
δαίνυνται: τοῖόν περ ἀυτμένα δεινὸν ἐφίει.	--- -- u u-uu -u u--	dactylic hexameter	masculine penthemimeral, trithemimeral
εἰ δ᾽ὀλοὴ βούβρωστις ἀιδρείηφι πελάσσῃ,	- uu- --- ---u u--	dactylic hexameter	trithemimeral
αὐτοῦ οἱ θάνατός τε καὶ ὠκέα μοῖρα τέτυκται.	-- - uu- u u -uu -u u--	dactylic hexameter	masculine penthemimeral, trithemimeral
Κῆρα δέ τοι δρυΐναο πιφαύσκεο, τόν τε χέλυδρον	-u u - uu-u u-uu - u u--	dactylic hexameter	feminine penthemimeral, trithemimeral
ἐξέτεροι καλέουσιν: ὁ δ᾽ἐν δρυσὶν οἰκία τεύξας	-uu- uu-u u - uu -uu --	dactylic hexameter	feminine penthemimeral, hepthemimeral, trithemimeral
ἢ ὅγε που φηγοῖσιν ὀρεσκεύει περὶ βήσσας	- uu - --u u--- uu --	dactylic hexameter	feminine penthemimeral, trithemimeral
[ὕδρον μιν καλέουσι, μετεξέτεροι δὲ χέλυδρον	-- - uu-u u-uu- u u--	dactylic hexameter	feminine penthemimeral, trithemimeral
ὅς τε βρύα προλιπὼν καὶ ἕλος καὶ ὁμήθεα λίμνην	- u u- uu- u u- u u-uu --	dactylic hexameter	masculine penthemimeral, hepthemimeral, trithemimeral
ἀγρώσσων λειμῶσι μολουρίδας ἢ βατραχῖδας	--- --u u-uu - uu--	dactylic hexameter	feminine penthemimeral, trithemimeral
σπέρχεται ἐκ μύωπος ἀήθεα δέγμενος ὁρμήν.	-uu - --u u-uu -uu --	dactylic hexameter	feminine penthemimeral, trithemimeral
ἔνθα κατὰ πρέμνον κοίλης ὑπεδύσατο φηγοῦ	-u u- -- -- uu-uu --	dactylic hexameter	masculine penthemimeral, hepthemimeral, trithemimeral
ὀξὺς ἀλείς, κοῖτον δὲ βαθεῖ ἐνεδείματο θάμνῳ.	-u u- -- u u- uu-uu --	dactylic hexameter	masculine penthemimeral, hepthemimeral, trithemimeral
αἰθαλόεις μὲν νῶτα, κάρη γε μὲν ἁρπεδὲς αὔτως	-uu- - -u u- u u -uu --	dactylic hexameter	feminine penthemimeral, hepthemimeral, trithemimeral
ὕδρῳ ἐισκόμενος: τὸ δ᾽ἀπὸ χροὸς ἐχθρὸν ἄηται	-- -uu- u u- uu -u u--	dactylic hexameter	masculine penthemimeral, hepthemimeral
οἷον ὅτε πλαδόωντα περὶ σκύλα καὶ δέρε᾽ ἵππων	-u u- uu-u u- uu - uu --	dactylic hexameter	feminine penthemimeral, hepthemimeral, trithemimeral
γναπτόμενοι μυδόωσιν ὑπ᾽ ἀρβήλοισι λάθαργοι.	-uu- uu-u u ---u u--	dactylic hexameter	feminine penthemimeral, trithemimeral
ἤτοι ὅταν κώληπας ἢ ἐν ποδὸς ἴχνεϊ τύψῃ,	-u u- --u u - uu -uu --	dactylic hexameter	feminine penthemimeral, hepthemimeral, trithemimeral
χρωτὸς ἄπο πνιγόεσσα κεδαιομένη φέρετ᾽ ὀδμή:	-u u- uu-u u-uu- uu --	dactylic hexameter	feminine penthemimeral, trithemimeral
τοῦ δ᾽ἤτοι περὶ τύμμα μέλαν κορθύεται οἶδος,	- -- uu -u u- --uu --	dactylic hexameter	feminine penthemimeral, hepthemimeral, trithemimeral
ἐν δὲ νόον πεδόωσιν ἀλυσθαίνοντος ἀνῖαι	- u u- uu-u u---u u--	dactylic hexameter	feminine penthemimeral, trithemimeral
ἐχθόμεναι, χροιὴ δὲ μόγῳ αὐαίνεται ἀνδρός.	-uu- -- u u- --uu --	dactylic hexameter	masculine penthemimeral, hepthemimeral, trithemimeral
ῥινοὶ δὲ πλαδόωσιν ἐπὶ χροΐ, τοῖά μιν ἰός	-- - uu-u u- uu -u u --	dactylic hexameter	feminine penthemimeral, hepthemimeral, trithemimeral
ὀξὺς ἀεὶ νεμέθων ἐπιβόσκεται: ἀμφὶ καὶ ἀχλύς	-u u- uu- uu-uu -u u --	dactylic hexameter	masculine penthemimeral, trithemimeral
ὄσσε κατακρύπτουσα κακοσταθέοντα δαμάζει:	-u u---u u-uu-u u--	dactylic hexameter	feminine penthemimeral
οἱ δέ τε μηκάζουσι περιπνιγέες τε πέλονται,	- u u ---u u-uu- u u--	dactylic hexameter	feminine penthemimeral
οὖρα δ᾽ἀπέστυπται: τοτὲ δ᾽ἔμπαλιν ὑπνώοντες	-u u--- uu -uu ----	dactylic hexameter	masculine penthemimeral
ῥέγκουσιν, λυγμοῖσι βαρυνόμενοι θαμέεσσιν,	--- --u u-uu- uu--	dactylic hexameter	feminine penthemimeral, trithemimeral
ἢ ἀπερευγόμενοι ἔμετον χολοειδέα δειρῆς,	- uu-uu- uu- uu-uu --	dactylic hexameter	masculine penthemimeral, hepthemimeral
ἄλλοτε δ᾽αἱματόεντα: κακὴ δ᾽ἐπιδίψιος ἄτη	-uu -uu-u u- uu-uu --	dactylic hexameter	feminine penthemimeral, hepthemimeral
ἐσχατίη μογέουσι τρόμον κατεχεύατο γυίοις.	-uu- uu-u u- uu-uu --	dactylic hexameter	feminine penthemimeral, hepthemimeral, trithemimeral
Φράζεο δὲ χλοάοντα δαεὶς κύανόν τε δράκοντα,	-uu - uu-u u- uu- u u--	dactylic hexameter	feminine penthemimeral, hepthemimeral, trithemimeral
ὅν ποτε Παιήων λασίῃ ἐνεθρέψατο φηγῷ	- uu --- uu- uu-uu --	dactylic hexameter	masculine penthemimeral, hepthemimeral
Πηλίῳ ἐν νιφόεντι Πελεθρόνιον κατὰ βῆσσαν.	-uu - uu-u u-uu- uu --	dactylic hexameter	feminine penthemimeral, trithemimeral
ἤτοι ὅγ᾽ ἄγλαυρος μὲν ἐείδεται, ἐν δὲ γενείῳ	-u u --- u u-uu - u u--	dactylic hexameter	masculine penthemimeral
τρίστοιχοι ἑκάτερθε περιστιχόωσιν ὀδόντες:	--- uu-u u-uu-u u--	dactylic hexameter	feminine penthemimeral, trithemimeral
πίονα δ᾽ἐν σκυνίοισιν ὕπ᾽ ὄθματα, νέρθε δὲ πώγων	-uu - uu-u u -uu -u u --	dactylic hexameter	feminine penthemimeral, trithemimeral
αἰὲν ὑπ᾽ ἀνθερεῶνι χολοίβαφος. οὐ μὲν ὅγ᾽ αὕτως	-u u -uu-u u-uu - u u --	dactylic hexameter	feminine penthemimeral
ἐγχρίμψας ἤλγυνε καὶ ἢν ἔκπαγλα χαλεφθῇ:	--- --u u - --u u--	dactylic hexameter	feminine penthemimeral, hepthemimeral, trithemimeral
βληχρὸν γὰρ μυὸς οἷα μυληβόρου ἐν χροῒ νύχμα	-- - uu -u u-uu - uu --	dactylic hexameter	feminine penthemimeral, trithemimeral
εἴδεται αἱμαχθέντος ὑπὸ κραντῆρος ἀραιοῦ.	-uu ---u u- --u u--	dactylic hexameter	feminine penthemimeral, hepthemimeral
τῷ μέν τ᾽ἔκπαγλον κοτέων βασιλήιος ὄρνις	- - --- uu- uu-uu --	dactylic hexameter	masculine penthemimeral, hepthemimeral
αἰετὸς ἐκ παλαχῆς ἐπαέξεται, ἀντία δ᾽ἐχθρήν	-uu - uu- uu-uu -uu --	dactylic hexameter	masculine penthemimeral, trithemimeral
δῆριν ἄγει γενύεσσιν ὅταν βλώσκοντα καθ᾽ ὕλην	-u u- uu-u u- --u u --	dactylic hexameter	feminine penthemimeral, hepthemimeral, trithemimeral
δέρκηται: πάσας γὰρ ὅγ᾽ ἠρήμωσε καλιάς,	--- -- u u ---u u--	dactylic hexameter	masculine penthemimeral, trithemimeral
αὕτως ὀρνίθων τε τόκον κτίλα τ᾽ὤεα βρύκων.	-- --- u u- uu -uu --	dactylic hexameter	masculine penthemimeral, hepthemimeral
αὐτὰρ ὁ τοῦ καὶ ῥῆνα καὶ ἠνεμόεντα λαγωόν	-u u - - -u u -uu-u u--	dactylic hexameter	feminine penthemimeral, trithemimeral
ῥεῖα δράκων ἤμερσε νέον μάρψαντος ὄνυξι	-u u- --u u- --u u--	dactylic hexameter	feminine penthemimeral, hepthemimeral, trithemimeral
θάμνου ὑπαΐξας: ὁ δ᾽ἀλεύεται: ἀμφὶ δὲ δαιτός	-u u--- u u-uu -u u --	dactylic hexameter	masculine penthemimeral
μάρνανθ᾽: ἱπτάμενον δὲ πέριξ ἀτέλεστα διώκει	-- -uu- u u- uu-u u--	dactylic hexameter	masculine penthemimeral, hepthemimeral
σπειρηθεὶς καὶ λοξὸν ὑποδρὰξ ὄμμασι λεύσσων.	--- - -u u-- -uu --	dactylic hexameter	feminine penthemimeral, trithemimeral
Εἴ γε μὲν Ἡφαίστοιο χαλαίποδος ἐν πτυχὶ νήσου	- u u ---u u-uu - uu --	dactylic hexameter	feminine penthemimeral
βήσεαι ἠὲ Σάμον δυσχείμερον, αἵ τ᾽ἐνὶ κόλπῳ	-uu -u u- --uu - uu --	dactylic hexameter	masculine penthemimeral
Θρηικίῳ βέβληνται ἑκάς, Ῥησκυνθίδος Ἥρης	-uu- --u u- --uu --	dactylic hexameter	feminine penthemimeral, hepthemimeral, trithemimeral
Ἕβρος ἵνα Ζωναῖά τ᾽ὄρη χιόνεσσι φάληρα	-u u- --u u- uu-u u--	dactylic hexameter	feminine penthemimeral, hepthemimeral, trithemimeral
καὶ δρύες Οἰαγρίδαο, τόθι Ζηρύνθιον ἄντρον,	- uu -uu-u u- --uu --	dactylic hexameter	feminine penthemimeral, hepthemimeral
δήεις κεγχρίνεω δολιχὸν τέρας, ὅν τε λέοντα	-- -uu- uu- uu - u u--	dactylic hexameter	masculine penthemimeral, hepthemimeral
αἰόλον αὐδάξαντο, περίστικτον φολίδεσσι.	-uu ---u u--- uu--	dactylic hexameter	feminine penthemimeral
τοῦ πάχετος μῆκός τε πολύστροφον, αἶψα δὲ σαρκί	- uu- -- u u-uu -u u --	dactylic hexameter	masculine penthemimeral, trithemimeral
πυθεδόνας κατέχευε δυσαλθέας, αἱ δ᾽ἐπὶ γυίοις	-uu- uu-u u-uu - uu --	dactylic hexameter	feminine penthemimeral, trithemimeral
ἰοβόροι βόσκονται: ἀεὶ δ᾽ὑπὸ νηδύσιν ὕδρωψ	-uu- --u u- uu -uu --	dactylic hexameter	feminine penthemimeral, hepthemimeral, trithemimeral
ἄλγεσιν ἐμβαρύθουσα κατὰ μέσον ὀμφαλὸν ἵζει.	-uu -uu-u u- uu -uu --	dactylic hexameter	feminine penthemimeral, hepthemimeral
ἤτοι ὅτ᾽ ἠελίοιο θερειτάτη ἵσταται ἀκτίς,	-u u -uu-u u-uu -uu --	dactylic hexameter	feminine penthemimeral
οὔρεα μαιμώσσων ἐπινίσσεται ὀκριόεντα	-uu --- uu-uu -uu--	dactylic hexameter	masculine penthemimeral
αἵματος ἰσχανόων καὶ ἐπὶ κτίλα μῆλα δοκεύων,	-uu -uu- u u- uu -u u--	dactylic hexameter	masculine penthemimeral, hepthemimeral
ἢ Σάου ἠὲ Μοσύχλου ὅτ᾽ ἀμφ᾽ ἐλάτῃσι μακεδναῖς	- uu -u u-u u - uu-u u--	dactylic hexameter	feminine penthemimeral, hepthemimeral
ἄγραυλοι ψύχωσι, λελοιπότες ἔργα νομήων.	--- --u u-uu -u u--	dactylic hexameter	feminine penthemimeral, trithemimeral
μὴ σύ γε θαρσαλέος περ ἐὼν θέλε βήμεναι ἄντην	- u u -uu- u u- uu -uu --	dactylic hexameter	masculine penthemimeral, hepthemimeral
μαινομένου, μὴ δή σε καταπλέξῃ καὶ ἀνάγχῃ	-uu- - - u u--- u u--	dactylic hexameter	masculine penthemimeral, trithemimeral
πάντοθι μαστίζων οὐρῇ δέμας, ἐν δὲ καὶ αἷμα	-uu --- -- uu - u u --	dactylic hexameter	masculine penthemimeral, hepthemimeral
λαιφάξῃ κληῖδας ἀναρρήξας ἑκάτερθεν.	--- --u u--- uu--	dactylic hexameter	feminine penthemimeral, trithemimeral
φεῦγε δ᾽ἀεὶ σκολιήν τε καὶ οὐ μίαν ἀτραπὸν ἴλλων,	-u u- uu- u u - uu -uu --	dactylic hexameter	masculine penthemimeral, hepthemimeral, trithemimeral
δοχμὸς ἀνακρούων θηρὸς πάτον: ἦ γὰρ ὁ δεσμούς	-u u--- -- uu - u u --	dactylic hexameter	masculine penthemimeral, hepthemimeral
βλάπτεται ἐν καμπῇσι πολυστρέπτοισιν ἀκάνθης,	-uu - --u u---u u--	dactylic hexameter	feminine penthemimeral, trithemimeral
ἰθεῖαν δ᾽ὤκιστος ἐπιδρομάδην στίβον ἕρπει.	--- --u u-uu- uu --	dactylic hexameter	feminine penthemimeral, trithemimeral
τοῖος Θρηικίῃσιν ὄφις νήσοισι πολάζει.	-- -uu-u u- --u u--	dactylic hexameter	feminine penthemimeral, hepthemimeral
Ἔνθα καὶ οὐτιδανοῦ περ ἀπεχθέα βρύγματ᾽ ἔασιν	-u u -uu- u u-uu -u u--	dactylic hexameter	masculine penthemimeral
ἀσκαλάβου: τὸν μέν τε ῥέει φάτις οὕνεκ᾽ Ἀχαιή	-uu- - - u u- uu -u u--	dactylic hexameter	masculine penthemimeral, hepthemimeral, trithemimeral
Δημήτηρ ἔβλαψεν ὅθ᾽ ἅψεα σίνατο παιδός	--- --u u -uu -uu --	dactylic hexameter	feminine penthemimeral, trithemimeral
Καλλίχορον παρὰ φρεῖαρ, ὅτ᾽ ἐν Κελεοῖο θεράπναις	-uu- uu -u u - uu-u u--	dactylic hexameter	feminine penthemimeral, hepthemimeral, trithemimeral
ἀρχαίη Μετάνειρα θεὴν δείδεκτο περίφρων.	--- uu-u u- --u u--	dactylic hexameter	feminine penthemimeral, hepthemimeral, trithemimeral
Ἄλλα γε μὴν ἄβλαπτα κινώπετα βόσκεται ὕλην,	-u u - --u u-uu -uu --	dactylic hexameter	feminine penthemimeral, trithemimeral
δρυμοὺς καὶ λασιῶνας ἀμορβαίους τε χαράδρας,	-- - uu-u u--- u u--	dactylic hexameter	feminine penthemimeral, trithemimeral
οὓς ἔλοπας λίβυάς τε πολυστεφέας τε μυάγρους	- uu- uu- u u-uu- u u--	dactylic hexameter	masculine penthemimeral, trithemimeral
φράζονται, σὺν δ᾽ὅσσοι ἀκοντίαι ἠδὲ μόλουροι	--- - -u u-uu -u u--	dactylic hexameter	feminine penthemimeral, trithemimeral
ἠδ᾽ ἔτι που τυφλῶπες ἀπήμαντοι φορέονται.	- uu - --u u--- uu--	dactylic hexameter	feminine penthemimeral, trithemimeral
Τῶν μὲν ἐγὼ θρόνα πάντα καὶ ἀλθεστήρια νούσων	- u u- uu -u u ---uu --	dactylic hexameter	feminine penthemimeral, trithemimeral
φύλλα τε ῥιζοτόμον τε διείσομαι ἀνδράσιν ὥρην,	-u u -uu- u u-uu -uu --	dactylic hexameter	masculine penthemimeral
πάντα διαμπερέως καὶ ἀπηλεγές, οἷσιν ἀρήγων	-u u-uu- u u-uu -u u--	dactylic hexameter	masculine penthemimeral
ἀλθήσῃ νούσοιο κατασπέρχουσαν ἀνίην.	--- --u u---u u--	dactylic hexameter	feminine penthemimeral, trithemimeral
τὰς μὲν ἔτι βλύοντι φόνῳ περιαλγέι ποίας	- u u- --u u- uu-uu --	dactylic hexameter	feminine penthemimeral, hepthemimeral, trithemimeral
δρέψασθαι νεοκμῆταςὃ γὰρ προφερέστατον ἄλλων	--- uu-uu - uu-uu --	dactylic hexameter	hepthemimeral, trithemimeral
χώρῳ ἵνα κνῶπες θαλερὴν βόσκονται ἀν᾽ ὕλην.	-u u- -- uu- --u u --	dactylic hexameter	masculine penthemimeral, hepthemimeral, trithemimeral
πρώτην μὲν Χείρωνος ἐπαλθέα ῥίζαν ἑλέσθαι,	-- - --u u-uu -u u--	dactylic hexameter	feminine penthemimeral, trithemimeral
Κενταύρου Κρονίδαο φερώνυμον, ἥν ποτε Χείρων	--- uu-u u-uu - uu --	dactylic hexameter	feminine penthemimeral, trithemimeral
Πηλίου ἐν νιφόεντι κιχὼν ἐφράσσατο δειρῇ.	-uu - uu-u u- --uu --	dactylic hexameter	feminine penthemimeral, hepthemimeral, trithemimeral
τῆς μὲν ἀμαρακόεσσα χυτὴ περιδέδρομε χαίτη,	- u u-uu-u u- uu-uu --	dactylic hexameter	feminine penthemimeral, hepthemimeral
ἄνθεα δὲ χρύσεια φαείνεται: ἡ δ᾽ὑπὲρ αἴης	-uu - --u u-uu - -- --	lyric	
ῥίζα καὶ οὐ βυθόωσα Πελεθρόνιον νάπος ἴσχει.	-u u - uu-u u-uu- uu --	dactylic hexameter	feminine penthemimeral, trithemimeral
ἣν σὺ καὶ αὐαλέην ὁτὲ δ᾽ἔγχλοον ὅλμῳ ἀράξας,	- u u -uu- uu -uu -u u--	dactylic hexameter	masculine penthemimeral
φυρσάμενος κοτύλῃ πιέειν μενοεικέος οἴνης:	-uu- uu- uu- uu-uu --	dactylic hexameter	masculine penthemimeral, hepthemimeral, trithemimeral
παντὶ γὰρ ἄρκιός ἐστι: τό μιν πανάκειον ἔπουσιν.	-u u -uu -u u - uu-u u--	dactylic hexameter	feminine penthemimeral, hepthemimeral
Ἤτοι ἀριστολόχεια παλίσκιος ἐνδατέοιτο,	-u u-uu-u u-uu -uu--	dactylic hexameter	feminine penthemimeral
φύλλ᾽ ἅτε κισσήεντα περικλυμένοιο φέρουσα:	- uu ---u u-uu-u u--	dactylic hexameter	feminine penthemimeral
ἄνθεα δ᾽ὑσγίνῳ ἐνερεύθεται, ἡ δέ οἱ ὀδμή	-uu -uu ---uu - u u --	dactylic hexameter	
σκίδναται ἐμβαρύθουσα, μέσον δ᾽ὡς ἀχράδα καρπόν	-uu -uu-u u- - -uu --	dactylic hexameter	feminine penthemimeral, hepthemimeral
μυρτάδος ἐξ ὄχνης ἐπιόψεαι ἢ σύ γε βάκχης:	-uu - -- uu-uu - u u --	dactylic hexameter	masculine penthemimeral, trithemimeral
ῥίζα δὲ θηλυτέρης μὲν ἐπιστρογγύλλεται ὄγκῳ,	-u u -uu- u u---uu --	dactylic hexameter	masculine penthemimeral
ἄρσενι δ᾽αὖ δολιχή τε καὶ ἂμ πυγόνος βάθος ἴσχει,	-uu - uu- u u - uu- uu --	dactylic hexameter	masculine penthemimeral, hepthemimeral, trithemimeral
πύξου δὲ χροιῇ προσαλίγκιος Ὠρικίοιο.	-- - -- uu-uu -uu--	dactylic hexameter	masculine penthemimeral, trithemimeral
τὴν ἤτοι ἔχιός τε καὶ αἰνοπλῆγος ἐχίδνης	- -- uu- u u ---u u--	dactylic hexameter	masculine penthemimeral, trithemimeral
ἀγρεύσεις ὄφελος περιώσιον: ἔνθεν ἀπορρώξ	--- uu- uu-uu -u u--	dactylic hexameter	masculine penthemimeral, trithemimeral
δραχμαίη μίσγοιτο ποτῷ ἔνι κιρράδος οἴνης.	--- --u u- uu -uu --	dactylic hexameter	feminine penthemimeral, hepthemimeral, trithemimeral
ναὶ μὴν καὶ τρίσφυλλον ὀπάζεο κνωψὶν ἀρωγήν	- - - --u u-uu -u u--	dactylic hexameter	feminine penthemimeral, trithemimeral
ἠέ που ἐν τρήχοντι πάγῳ ἢ ἀποσφάγι βήσσῃ,	-u u - --u u- u u-uu --	dactylic hexameter	feminine penthemimeral, hepthemimeral, trithemimeral
τὴν ἤτοι μινυανθές, ὁ δὲ τριπέτηλον ἐνίσποι,	- -- uu-u u - uu-u u--	dactylic hexameter	feminine penthemimeral, hepthemimeral, trithemimeral
χαίτην μὲν λωτῷ, ῥυτῇ γε μὲν εἴκελον ὀδμήν.	-- - -- -- u u -uu --	dactylic hexameter	masculine penthemimeral, hepthemimeral, trithemimeral
ἤτοι ὅτ᾽ ἄνθεα πάντα καὶ ἐκ πτίλα ποικίλα χεύῃ	-u u -uu -u u - uu -uu --	dactylic hexameter	feminine penthemimeral, hepthemimeral
οἷόν τ᾽ἀσφάλτου ἀπερεύγεται: ἔνθα κολούσας	-- --- uu-uu -u u--	dactylic hexameter	masculine penthemimeral
σπέρμαθ᾽ ὅσον κύμβοιο τραπεζήεντος ἑλέσθαι	-u u- --u u---u u--	dactylic hexameter	feminine penthemimeral, trithemimeral
καρδόπῳ ἐντρίψας πιέειν ὀφίεσσιν ἀρωγήν.	-uu --- uu- uu-u u--	dactylic hexameter	masculine penthemimeral, hepthemimeral
Νῦν δ᾽ἄγε τοι ἐπίμικτα νόσων ἀλκτήρια λέξω.	- uu - uu-u u- --uu --	dactylic hexameter	feminine penthemimeral, hepthemimeral, trithemimeral
Θρινακίην μὲν ῥίζαν ἕλευ γυιαλθέα θάψου	-uu- - -u u- --uu --	dactylic hexameter	feminine penthemimeral, hepthemimeral, trithemimeral
σμώξας, ἐν δὲ σπέρμα χυτὸν λευκανθέος ἄγνου,	-- - - -u u- --uu --	dactylic hexameter	feminine penthemimeral, hepthemimeral, trithemimeral
νῆριν, πηγάνιόν τε περιβρυές, ἐν δέ τε θύμβρης	-- -uu- u u-uu - u u --	dactylic hexameter	masculine penthemimeral
δρεψάμενος βλαστὸν χαμαιευνάδος ἥ τε καθ᾽ ὕλην	-uu- -- uu-uu - u u --	dactylic hexameter	masculine penthemimeral, trithemimeral
οἵας θ᾽ἑρπύλλοιο περὶ ῥάδικας ἀέξει.	-- ---u u- uu- ---	dactylic hexameter	feminine penthemimeral, hepthemimeral
ἄγρει δ᾽ἀσφοδέλοιο διανθέος ἄλλοτε ῥίζαν,	-- -uu-u u-uu -uu --	dactylic hexameter	feminine penthemimeral
ἄλλοτε καὶ καυλεῖον ὑπέρτερον ἀνθερίκοιο,	-uu - --u u-uu -uu--	dactylic hexameter	feminine penthemimeral, trithemimeral
πολλάκι δ᾽ἐν καὶ σπέρμα τό τε λοβὸς ἀμφὶς ἀέξει,	-uu - - -u u - uu -u u--	dactylic hexameter	feminine penthemimeral, hepthemimeral, trithemimeral
ἠὲ καὶ ἑλξίνην, τήν τε κλύβατιν καλέουσιν,	-u u --- - - uu- uu--	dactylic hexameter	masculine penthemimeral, hepthemimeral
ὕδασι τερπομένην καὶ ἀεὶ θάλλουσαν ἰάμνοις:	-uu -uu- u u- --u u--	dactylic hexameter	masculine penthemimeral, hepthemimeral
πῖνε δ᾽ἐνιτρίψας κοτυλήρυτον ὄξος ἀφύσσων	-u u--- uu-uu -u u--	dactylic hexameter	masculine penthemimeral
ἢ οἴνης: ῥέα δ᾽αὖτε καὶ ὕδατι κῆρας ἀλύξαις.	- -- uu -u u -uu -u u--	dactylic hexameter	feminine penthemimeral, trithemimeral
Ἐσθλὴν δ᾽Ἀλκιβίου ἔχιος περιφράζεο ῥίζαν.	-- -uu- uu- uu-uu --	dactylic hexameter	masculine penthemimeral, hepthemimeral
τῆς καὶ ἀκανθοβόλος μὲν ἀεὶ περιτέτροφε χαίτη,	- u u-uu- u u- uu-uu --	dactylic hexameter	masculine penthemimeral, hepthemimeral
λείρια δ᾽ὡς ἴα τοῖα περιτρέφει: ἡ δὲ βαθεῖα	-uu - uu -u u-uu - u u--	dactylic hexameter	feminine penthemimeral, trithemimeral
καὶ ῥαδινὴ ὑπένερθεν ἀέξεται οὔδεϊ ῥίζα.	- uu- uu-u u-uu -uu --	dactylic hexameter	feminine penthemimeral, trithemimeral
τὸν μὲν ἔχις βουβῶνος ὕπερ νεάτοιο χαράξας	- u u- --u u- uu-u u--	dactylic hexameter	feminine penthemimeral, hepthemimeral, trithemimeral
ἄντλῳ ἐνυπνώοντα χυτῆς παρὰ τέλσον ἅλωος	-u u---u u- uu -u u--	dactylic hexameter	feminine penthemimeral, hepthemimeral
εἶθαρ ἀνέπνευσεν καμάτου βίῃ: αὐτὰρ ὁ γαίης	-u u--- uu- uu -u u --	dactylic hexameter	masculine penthemimeral, hepthemimeral
ῥίζαν ἐρυσάμενος τὸ μὲν ἕρκεϊ θρύψεν ὀδόντων	-u u-uu- u u -uu -u u--	dactylic hexameter	masculine penthemimeral
θηλάζων, τὸ δὲ πέσκος ἑῷ περὶ κάββαλεν ἕλκει.	--- u u -u u- uu -uu --	dactylic hexameter	feminine penthemimeral, hepthemimeral, trithemimeral
Ἦ μὴν καὶ πρασίοιο χλοανθέος ἔρνος ὀλόψας	- - - uu-u u-uu -u u--	dactylic hexameter	feminine penthemimeral, trithemimeral
χραισμήσεις ὀφίεσσι πιὼν ἀργῆτι μετ᾽ οἴνῳ,	--- uu-u u- --u u --	dactylic hexameter	feminine penthemimeral, hepthemimeral, trithemimeral
ἥ τε καὶ ἀστόργοιο κατείρυσεν οὔθατα μόσχου	- u u ---u u-uu -uu --	dactylic hexameter	feminine penthemimeral
πρωτογόνου, στέργει δὲ περισφαραγεῦσα γάλακτι:	-uu- -- u u-uu-u u--	dactylic hexameter	masculine penthemimeral, trithemimeral
τὴν ἤτοι μελίφυλλον ἐπικλείουσι βοτῆρες,	- -- uu-u u---u u--	dactylic hexameter	feminine penthemimeral, trithemimeral
οἱ δὲ μελίκταιναν: τῆς γὰρ περὶ φύλλα μέλισσαι	- u u--- - - uu -u u--	dactylic hexameter	masculine penthemimeral, hepthemimeral
ὀδμῇ θελγόμεναι μέλιτος ῥοιζηδὸν ἵενται.	-- -uu- uu- --u u--	dactylic hexameter	masculine penthemimeral, hepthemimeral
Ἠὲ σύ γ᾽ἐγκεφάλοιο περὶ σμήνιγγας ἀραιάς	-u u -uu-u u- --u u--	dactylic hexameter	feminine penthemimeral, hepthemimeral
ὄρνιθος λέψαιο κατοικάδος: ἄλλοτ᾽ ἀμόρξαις	--- --u u-uu -u u--	dactylic hexameter	feminine penthemimeral, trithemimeral
ψηχρὰ πολύκνημον καὶ ὀρίγανον, ἢ ἀπὸ κάπρου	-u u--- u u-uu - uu --	dactylic hexameter	masculine penthemimeral
ἥπατος ἀκρότατον κέρσαι λοβὸν ὅς τε τραπέζης	-uu -uu- -- uu - u u--	dactylic hexameter	masculine penthemimeral, hepthemimeral
ἐκφύεται νεύει δὲ χολῆς σχεδὸν ἠδὲ πυλάων:	-uu- -- u u- uu -u u--	dactylic hexameter	masculine penthemimeral, hepthemimeral, trithemimeral
καὶ τὰ μὲν ἂρ σύμμικτα πιεῖν ἢ ἀπ᾽ ἄνδιχα βάψας	- u u - --u u- u u -uu --	dactylic hexameter	feminine penthemimeral, hepthemimeral, trithemimeral
ὄξεος ἢ οἴνης: πλεῖον δ᾽ἄκος ἕψεται οἴνῃ.	-uu - -- -- uu -uu --	dactylic hexameter	masculine penthemimeral, hepthemimeral, trithemimeral
ἐν δὲ φόβην ἐρύσασθαι ἀειθαλέος κυπαρίσσου	- u u- uu-u u-uu- uu--	dactylic hexameter	feminine penthemimeral, trithemimeral
ἐς ποτόν, ἢ πάνακες, ἢ κάστορος οὐλοὸν ὄρχιν,	- uu - uu- - -uu -uu --	dactylic hexameter	masculine penthemimeral, trithemimeral
ἢ ἵππου τὸν Νεῖλος ὑπὲρ Σάιν αἰθαλόεσσαν	- -- - -u u- uu -uu--	dactylic hexameter	feminine penthemimeral, hepthemimeral, trithemimeral
βόσκει: ἀρούρῃσιν δὲ κακὴν ἐπιβάλλεται ἅρπην,	-u u--- u u- uu-uu --	dactylic hexameter	masculine penthemimeral, hepthemimeral
ὅς τε καὶ ἐκ ποταμοῖο λιπὼν ζάλον ἰλυόεντα,	- u u - uu-u u- uu -uu--	dactylic hexameter	feminine penthemimeral, hepthemimeral, trithemimeral
χιλοὶ ὅτε χλοάουσι νεὸς δ᾽ἀπεχεύατο ποίην,	-u u- uu-u u- uu-uu --	dactylic hexameter	feminine penthemimeral, hepthemimeral, trithemimeral
τόσσον ἐπιστείβων λείπει βυθὸν ὁσσάτιόν περ	-u u--- -- uu -uu- -	dactylic hexameter	masculine penthemimeral, hepthemimeral
ἐκνέμεται γενύεσσι παλίσσυτον ὄγμον ἐλαύνων.	-uu- uu-u u-uu -u u--	dactylic hexameter	feminine penthemimeral, trithemimeral
τοῦ μὲν ἀποπροταμὼν δραχμῆς βάρος ἰσοφαρίζειν,	- u u-uu- -- uu -uu--	dactylic hexameter	masculine penthemimeral, hepthemimeral
ὕδατι δ᾽ἐμπίσαιο κύτει ἐναολλέα κόψας.	-uu ---u u- uu-uu --	dactylic hexameter	feminine penthemimeral, hepthemimeral
Μηδὲ σύ γ᾽ἁβροτόνου ἐπιλήθεο, μηδέ τι δάφνης	-u u -uu- uu-uu -u u --	dactylic hexameter	masculine penthemimeral
καρποῦ ἀραιοτέρης: μάλα δ᾽ἂν καὶ ἀμάρακος εἴη	-u u-uu- uu - u u-uu --	dactylic hexameter	masculine penthemimeral, hepthemimeral
χραισμήεις πρασιῇσι καὶ ἀνδήροισι χλοάζων:	--- uu-u u ---u u--	dactylic hexameter	feminine penthemimeral, trithemimeral
ἐν δὲ τίθει τάμισον σκίνακος νεαροῖο λαγωοῦ	- u u- uu- uu- uu-u u--	dactylic hexameter	masculine penthemimeral, hepthemimeral, trithemimeral
ἢ προκὸς ἠὲ νεβροῖο πάροιθ᾽ ἀπὸ λύματα κόψας,	- uu -u u-u u- uu -uu --	dactylic hexameter	feminine penthemimeral, hepthemimeral
ἠὲ καὶ ἐξ ἐλάφοιο ταμὼν πηρῖνα θοραίην,	-u u - uu-u u- --u u--	dactylic hexameter	feminine penthemimeral, hepthemimeral, trithemimeral
ἢ ἐλάφου νηδύν, τὸ μὲν ἂρ καλέουσιν ἐχῖνον,	- uu- -- u u - uu-u u--	dactylic hexameter	masculine penthemimeral, hepthemimeral, trithemimeral
ἄλλοι δ᾽ἐγκατόεντα κεκρύφαλον: ὧν ἀπερύσας	-- -uu-u u-uu - uu--	dactylic hexameter	feminine penthemimeral
δραχμάων ὅσσον τε δύω καταβάλλεο μοίρας	--- -- u u- uu-uu --	dactylic hexameter	masculine penthemimeral, hepthemimeral, trithemimeral
τέτρασιν ἐν κυάθοις μέθυος πολιοῦ ἐπιμίξας.	-uu - uu- uu- uu- uu--	dactylic hexameter	masculine penthemimeral, hepthemimeral, trithemimeral
Μηδὲ σέ γε χραίσμη πολίου λάθοι ἠὲ κέδροιο,	-u u - -- uu- uu -u u--	dactylic hexameter	masculine penthemimeral, hepthemimeral, trithemimeral
ἀρκευθίς, σφαῖραί τε θερειλεχέος πλατάνοιο,	--- -- u u-uu- uu--	dactylic hexameter	masculine penthemimeral, trithemimeral
σπέρματα βουπλεύρου τε καὶ Ἰδαίης κυπαρίσσου:	-uu --- u u --- uu--	dactylic hexameter	masculine penthemimeral
πάντα γὰρ ἀλθήσει καὶ ἀθέσφατον ἐκ μόγον ὤσει.	-u u --- u u-uu - uu --	dactylic hexameter	masculine penthemimeral
Τὴν δὲ μετ᾽ ἐξετέρην θανάτου φύξιν τε καὶ ἀλκήν	- u u -uu- uu- -- u u --	dactylic hexameter	masculine penthemimeral, hepthemimeral
φράζεο κουλυβάτειαν ἑλών: τροχαλῷ δ᾽ἐνὶ λίγδῳ	-uu -uu-u u- uu- uu --	dactylic hexameter	feminine penthemimeral, hepthemimeral
σώχειν, ἐν δέ τέ οἱ κοτύλην πτισάνοιο χέασθαι,	-- - u u - uu- uu-u u--	dactylic hexameter	masculine penthemimeral, hepthemimeral, trithemimeral
ἐν δὲ δύω κυάθεια παλαισταγέος οἴνοιο,	- u u- uu-u u-uu- ---	dactylic hexameter	feminine penthemimeral, trithemimeral
ἐν δὲ καὶ ἀργέσταο λίπευς ἰσόμοιρον ἐλαίου:	- u u ---u u- uu-u u--	dactylic hexameter	feminine penthemimeral, hepthemimeral
φύρσας δὲ πληγῇσι χολοιβόρον ἰὸν ἐρύξεις.	-- - --u u-uu -u u--	dactylic hexameter	feminine penthemimeral, trithemimeral
Ἄγρει δ᾽ἑξάμορον κοτύλης εὐώδεα πίσσαν,	-- -uu- uu- --uu --	dactylic hexameter	masculine penthemimeral, hepthemimeral
καὶ χλοεροῦ νάρθηκος ἀπὸ μέσον ἦτρον ὀλόψας,	- uu- --u u- uu -u u--	dactylic hexameter	feminine penthemimeral, hepthemimeral, trithemimeral
ἠὲ καὶ ἱππείου μαράθου πολυαυξέα ῥίζαν	-u u --- uu- uu-uu --	dactylic hexameter	masculine penthemimeral, hepthemimeral
κεδρίσιν ἐντρίψας, ἐλεοθρέπτου τε σελίνου	-uu --- uu--- u u--	dactylic hexameter	masculine penthemimeral
σπέρματα: μεστωθὲν δὲ χάδοι βάθος ὀξυβάφοιο.	-uu --- u u- uu -uu--	dactylic hexameter	masculine penthemimeral, hepthemimeral
Ἔνθα καὶ ἱππείου προταμὼν σπερμεῖα σελίνου,	-u u --- uu- --u u--	dactylic hexameter	masculine penthemimeral, hepthemimeral
δραχμάων δὲ δύω σμύρνης ἐχεπευκέος ἄχθη,	--- u u- -- uu-uu --	dactylic hexameter	masculine penthemimeral, hepthemimeral, trithemimeral
ἐν δὲ θερειγενέος καρπὸν κέρσαιο κυμίνου	- u u-uu- -- --u u--	dactylic hexameter	masculine penthemimeral, hepthemimeral
στήσας ἠὲ χύδην τε καὶ ἄστατον ἀμφικυκήσας:	-- -u u- u u -uu -uu--	dactylic hexameter	masculine penthemimeral
πῖνε δὲ μιξάμενος κυάθῳ τρὶς ἀφύξιμον οἴνην.	-u u -uu- uu- u u-uu --	dactylic hexameter	masculine penthemimeral, hepthemimeral
νάρδου δ᾽εὐστάχυος δραχμήιον ἄχθος ἑλέσθαι,	-- -uu- --uu -u u--	dactylic hexameter	masculine penthemimeral
σὺν δὲ καὶ ὀκταπόδην ποταμοῦ ἀποσυληθέντα	- u u -uu- uu- uu----	dactylic hexameter	masculine penthemimeral, hepthemimeral
καρκίνον ἐνθρύψαιο νεοβδάλτοιο γάλακτος,	-uu ---u u---u u--	dactylic hexameter	feminine penthemimeral
ἶρίν θ᾽,ἣν ἔθρεψε Δρίλων καὶ Νάρονος ὄχθαι,	-- - --u u- - -uu --	dactylic hexameter	feminine penthemimeral, hepthemimeral, trithemimeral
Σιδονίου Κάδμοιο θεμείλιον Ἁρμονίης τε	-uu- --u u-uu -uu- -	dactylic hexameter	feminine penthemimeral, trithemimeral
ἔνθα δύω δασπλῆτε νομὸν στείβουσι δράκοντε.	-u u- --u u- --u u--	dactylic hexameter	feminine penthemimeral, hepthemimeral, trithemimeral
λάζεο δ᾽ἀνθεμόεσσαν ἄφαρ τανύφυλλον ἐρείκην,	-uu -uu-u u- uu-u u--	dactylic hexameter	feminine penthemimeral, hepthemimeral
ἥν τε μελισσαῖος περιβόσκεται οὐλαμὸς ἕρπων:	- u u--- uu-uu -uu --	dactylic hexameter	masculine penthemimeral
καὶ μυρίκης λάζοιο νέον πανακαρπέα θάμνον,	- uu- --u u- uu-uu --	dactylic hexameter	feminine penthemimeral, hepthemimeral, trithemimeral
μάντιν ἐνὶ ζωοῖσι γεράσμιον, ᾗ ἐν Ἀπόλλων	-u u- --u u-uu - u u--	dactylic hexameter	feminine penthemimeral, trithemimeral
μαντοσύνας Κοροπαῖος ἐθήκατο καὶ θέμιν ἀνδρῶν:	-uu- uu-u u-uu - uu --	dactylic hexameter	feminine penthemimeral, trithemimeral
μὶξ δὲ κονυζῆεν φυτὸν ἔγχλοον ἠδὲ καὶ ἀκτῆς	- u u--- uu -uu -u u --	dactylic hexameter	masculine penthemimeral
καυλοὺς ἠνεμόεντας ἰδὲ πτερὰ πολλὰ καὶ ἄνθη	-- -uu-u u- uu -u u --	dactylic hexameter	feminine penthemimeral, hepthemimeral
σαμψύχου κύτισόν τε καὶ εὐγλαγέας τιθυμάλλους:	--- uu- u u -uu- uu--	dactylic hexameter	masculine penthemimeral, trithemimeral
πάντα δὲ λίγδῳ θρύπτε, καὶ ἐν σκαφίδεσσι δοχαίαις	-u u -- -u u - uu-u u--	dactylic hexameter	feminine penthemimeral, hepthemimeral
φαρμάσσων μέθυ †κεῖνο† χοὸς δεκάτῃ ἐνὶ μοίρῃ.	--- uu -u u- uu- uu --	dactylic hexameter	feminine penthemimeral, hepthemimeral, trithemimeral
ἀλλ᾽ ἤτοι γερύνων καναχοὶ περίαλλα τοκῆες	- -- uu- uu- uu-u u--	dactylic hexameter	masculine penthemimeral, hepthemimeral, trithemimeral
βάτραχοι ἐν χύτρῃσι καθεψηθέντες ἄριστοι	-uu - --u u---u u--	dactylic hexameter	feminine penthemimeral, trithemimeral
βάμματι: πολλάκι δ᾽ἧπαρ ἐνὶ σχεδίῃ ποθὲν οἴνῃ,	-uu -uu -u u- uu- uu --	dactylic hexameter	feminine penthemimeral, hepthemimeral
ἢ αὐτοῦ σίνταο κάρη κακὸν ἄλλοτε νύμφαις	- -- --u u- uu -uu --	dactylic hexameter	feminine penthemimeral, hepthemimeral, trithemimeral
ἐμπισθέν, τοτὲ δ᾽οἴνου ἐνὶ σταγόνεσσιν ἀρήξει.	--- uu -u u- uu-u u--	dactylic hexameter	feminine penthemimeral, hepthemimeral, trithemimeral
Μὴ σύ γ᾽ἑλιχρύσοιο λιπεῖν πολυδευκέος ἄνθην,	- u u---u u- uu-uu --	dactylic hexameter	feminine penthemimeral, hepthemimeral
κόρκορον ἢ μύωπα, πανάκτειόν τε κονίλην,	-uu - --u u--- u u--	dactylic hexameter	feminine penthemimeral, trithemimeral
ἥν τε καὶ Ἡράκλειον ὀρίγανον ἀμφὶς ἔπουσι:	- u u ---u u-uu -u u--	dactylic hexameter	feminine penthemimeral
σὺν καὶ ὄνου πετάλειον ὀριγάνῳ, αὖά τε θύμβρης	- u u- uu-u u-uu -u u --	dactylic hexameter	feminine penthemimeral, trithemimeral
στρομβεῖα ψώχοιο, κακῆς ἐμφόρβια νούσου.	--- --u u- --uu --	dactylic hexameter	feminine penthemimeral, hepthemimeral, trithemimeral
Ἄγρει μὰν ὀλίγαις μηκωνίσι ῥάμνον ἐίσην	-- - uu- --uu -- --	dactylic hexameter	masculine penthemimeral, trithemimeral
ἐρσομένην, ἀργῆτι δ᾽ἀεὶ περιδέδρομεν ἄνθῃ:	-uu- --u u- uu-uu --	dactylic hexameter	feminine penthemimeral, hepthemimeral, trithemimeral
τὴν ἤτοι φιλέταιριν ἐπίκλησιν καλέουσιν	- -- uu-u u--- uu--	dactylic hexameter	feminine penthemimeral, trithemimeral
ἀνέρες οἳ Τμώλοιο παραὶ Γύγαό τε σῆμα	-uu - --u u- --u u --	dactylic hexameter	feminine penthemimeral, hepthemimeral, trithemimeral
Παρθένιον ναίουσι λέπας, τόθι Κίλβιν ἀεργοί	-uu- --u u- uu -u u--	dactylic hexameter	feminine penthemimeral, hepthemimeral, trithemimeral
ἵπποι χιλεύουσι καὶ ἀντολαί εἰσι Καΰστρου.	-- ---u u -uu -u u--	dactylic hexameter	feminine penthemimeral
Νῦν δ᾽ἄγε τοι ῥίζας ἐρέω ὀφίεσσιν ἀρωγούς.	- uu - -- uu- uu-u u--	dactylic hexameter	masculine penthemimeral, hepthemimeral, trithemimeral
ἔνθα δύω ἐχίεια πιφαύσκεο: τῆς δὲ τὸ μέν που	-u u- uu-u u-uu - u u - -	dactylic hexameter	feminine penthemimeral, trithemimeral
ἀγχούσῃ προσέοικεν ἀκανθῆεν πετάλειον,	--- uu-u u--- uu--	dactylic hexameter	feminine penthemimeral, trithemimeral
παῦρον ἐπεί, τυτθὸν δὲ καὶ ἐν χθονὶ πυθμένα τείνει.	-u u- -- u u - uu -uu --	dactylic hexameter	masculine penthemimeral, hepthemimeral, trithemimeral
ἡ δ᾽ἑτέρη πετάλοισι καὶ ἐν καύλοισι θάλεια,	- uu- uu-u u - --u u--	dactylic hexameter	feminine penthemimeral, hepthemimeral, trithemimeral
ὑψηλή: ὀλίγῳ δὲ πέριξ καλχαίνεται ἄνθει,	--- uu- u u- --uu --	dactylic hexameter	masculine penthemimeral, hepthemimeral, trithemimeral
βλαστεῖ δ᾽ὡς ἔχιος σφεδανὸν δ᾽ἐφύπερθε κάρηαρ:	-- - uu- uu- uu-u u--	dactylic hexameter	masculine penthemimeral, hepthemimeral, trithemimeral
τῶν μὲν ἀπ᾽ ἀνδρακάδα προταμὼν ἰσήρεα χραισμεῖν,	- u u -uu- uu- --uu --	dactylic hexameter	masculine penthemimeral, hepthemimeral
ἢ σφέλᾳ ἢ ὅλμῳ κεάσας ἢ ῥωγάδι πέτρῃ.	- uu - -- uu- - -uu --	dactylic hexameter	masculine penthemimeral, hepthemimeral, trithemimeral
καί τε σύ γ᾽ἠρύγγοιο καὶ ἀνθήεντος ἀκάνθου	- u u ---u u ---u u--	dactylic hexameter	feminine penthemimeral
ῥίζεα λειήναιο, φέροις δ᾽ἰσορρεπὲς ἄχθος	-uu ---u u- --uu --	dactylic hexameter	feminine penthemimeral, hepthemimeral
ἀμφοῖιν κλώθοντος ἐν ἀρπέζῃσιν ἐρίνου:	--- --u u ---u u--	dactylic hexameter	feminine penthemimeral, trithemimeral
λάζεο δ᾽εὐκνήμοιο κόμην βρίθουσαν ὀρείου	-uu ---u u- --u u--	dactylic hexameter	feminine penthemimeral, hepthemimeral
καὶ σπέραδος Νεμεαῖον ἀειφύλλοιο σελίνου,	- uu- uu-u u---u u--	dactylic hexameter	feminine penthemimeral, trithemimeral
σὺν δὲ καὶ ἀννήσοιο τὸ διπλόον ἄχθος ἀείραι	- u u ---u u -uu -u u--	dactylic hexameter	feminine penthemimeral
ῥίζαις ὁλκήεσσαν ὑπὸ πλάστιγγα πεσοῦσαν:	-- ---u u- --u u--	dactylic hexameter	feminine penthemimeral, hepthemimeral
καὶ τὰ μὲν ὀργάζοιο, καὶ εἰν ἑνὶ τεύχεϊ μίξας	- u u ---u u - uu -uu --	dactylic hexameter	feminine penthemimeral, hepthemimeral
ἄλλοτε μέν τ᾽ἐχίων ὀλοὸν σίνος, ἄλλοτε τύμμα	-uu - uu- uu- uu -uu --	dactylic hexameter	masculine penthemimeral, hepthemimeral, trithemimeral
σκορπιόεν, τοτὲ δάχματ᾽ ἐπαλθήσαιο φάλαγγος,	-uu- uu -u u---u u--	dactylic hexameter	feminine penthemimeral, trithemimeral
τριπλόον ἐνθρύπτων ὀδελοῦ βάρος ἔνδοθεν οἴνης.	-uu --- uu- uu -uu --	dactylic hexameter	masculine penthemimeral, hepthemimeral
Φράζεο δ᾽αἰγλήεντα χαμαίλεον ἠδὲ καὶ ὀρφνόν:	-uu ---u u-uu -u u --	dactylic hexameter	feminine penthemimeral
δοιοὶ δ᾽ἀμφὶς ἔασιν: ὁ μὲν ζοφοείδελος ὠπήν	-- -u u-u u - uu-uu --	dactylic hexameter	feminine penthemimeral, hepthemimeral
ἤικται σκολύμῳ, τροχεὴν δ᾽ἀπεχεύατο χαίτην:	--- uu- uu- uu-uu --	dactylic hexameter	masculine penthemimeral, hepthemimeral, trithemimeral
ῥίζα δέ οἱ βριαρή τε καὶ αἴθαλος, ἠδ᾽ ὑπὸ κνημοῖς	-u u - uu- u u -uu - uu --	dactylic hexameter	masculine penthemimeral, trithemimeral
σκοιοῖς ἐντελέθει φυξήλιος ἢ νεμέεσσι.	-- -uu- --uu - uu--	dactylic hexameter	masculine penthemimeral
τὸν δ᾽ἕτερον δήεις αἰεὶ πετάλοισιν ἀγαυρόν,	- uu- -- -- uu-u u--	dactylic hexameter	masculine penthemimeral, hepthemimeral, trithemimeral
μέσση δ᾽ἐν κεφαλὴ δύεται πεδόεσσα μολοβρή,	-- - uu- uu- uu-u u--	dactylic hexameter	masculine penthemimeral, hepthemimeral, trithemimeral
ῥίζα δ᾽ὑπαργήεσσα μελίζωρος δὲ πάσασθαι.	-u u---u u--- u u--	dactylic hexameter	feminine penthemimeral
τῶν δὴ κυανέην μὲν ἀναίνεο, τῆς δ᾽ἀπὸ φάρσος	- - -uu- u u-uu - uu --	dactylic hexameter	masculine penthemimeral
δραχμαῖον ποταμοῖο πιεῖν ὑδάτεσσι ταράξας.	--- uu-u u- uu-u u--	dactylic hexameter	feminine penthemimeral, hepthemimeral, trithemimeral
Ἄλλην δ᾽Ἀλκιβίοιο φερώνυμον ἄγρεο ποίην,	-- -uu-u u-uu -uu --	dactylic hexameter	feminine penthemimeral
δράχμα χερὸς πλήσας, παύρῳ δ᾽ἐν νέκταρι πίνειν.	-u u- -- -- - -uu --	dactylic hexameter	masculine penthemimeral, hepthemimeral, trithemimeral
τὴν μὲν ὑπὸ σκοπέλοισι Φαλακραίοισιν ἐπακτήρ	- u u- uu-u u---u u--	dactylic hexameter	feminine penthemimeral, trithemimeral
Κρύμνης ἂμ πεδίον καὶ ἀνὰ Γράσον ἠδ᾽ ἵνα θ᾽ἵππου	-- - uu- u u- uu - uu --	dactylic hexameter	masculine penthemimeral, hepthemimeral, trithemimeral
λειμῶνες, σκυλάκεσσιν Ἀμυκλαίῃσι κελεύων,	--- uu-u u---u u--	dactylic hexameter	feminine penthemimeral, trithemimeral
κνυζηθμῷ κυνὸς οὔλῳ ἐπήισε θυμολέοντος,	--- uu -u u-uu -uu--	dactylic hexameter	feminine penthemimeral, trithemimeral
ὅς τε μεταλλεύων αἰγὸς ῥόθον ἐν στίβῳ ὕλης	- u u--- -- uu - uu --	dactylic hexameter	masculine penthemimeral, hepthemimeral
κανθῷ ἐνὶ ῥαντῆρι τυπὴν ἀνεδέξατ᾽ ἐχίδνης:	-u u- --u u- uu-u u--	dactylic hexameter	feminine penthemimeral, hepthemimeral, trithemimeral
καὶ τὴν μὲν κλάγξας ἀφ᾽ ἑκὰς βάλε, ῥεῖα δὲ ποίης	- - - -- u u- uu -u u --	dactylic hexameter	masculine penthemimeral, hepthemimeral, trithemimeral
φύλλα κατέβρυξεν, καὶ ἀλεύατο φοινὸν ὄλεθρον.	-u u--- u u-uu -u u--	dactylic hexameter	masculine penthemimeral
Ἆσαι δ᾽ἔγχλοα φλοιὸν ἐλαιήεντα κρότωνος	-- -uu -u u---u u--	dactylic hexameter	feminine penthemimeral
συμμίγδην πετάλοισι μελισσοφύτοιο δασείης,	--- uu-u u-uu-u u--	dactylic hexameter	feminine penthemimeral, trithemimeral
ἠὲ καὶ ἠελίοιο τροπαῖς ἰσώνυμον ἔρνος	-u u -uu-u u- --uu --	dactylic hexameter	feminine penthemimeral, hepthemimeral
ἥ θ᾽Ὑπεριονίδαο παλινστρέπτοιο κελεύθους	- uu-uu-u u---u u--	dactylic hexameter	feminine penthemimeral
τεκμαίρει γλαυκοῖσιν ἴσον πετάλοισιν ἐλαίης.	--- --u u- uu-u u--	dactylic hexameter	feminine penthemimeral, hepthemimeral, trithemimeral
αὕτως δὲ ῥίζαν κοτυληδόνος, ἥ τ᾽ἀνὰ κρυμόν	-- - -- uu-uu - uu --	dactylic hexameter	masculine penthemimeral, trithemimeral
ῥηγνυμένων ὀλοφυδνὰ διήφυσε ποσσὶ χίμετλα.	-uu- uu-u u-uu -u u--	dactylic hexameter	feminine penthemimeral, trithemimeral
δήποτε δ᾽ἢ βλωθροῖο πυρίτιδος ἔγχλοα φύλλα,	-uu - --u u-uu -uu --	dactylic hexameter	feminine penthemimeral, trithemimeral
ἢ σκολοπενδρείοιο φέρειν ἀπὸ καυλὸν ἀμήσας.	- uu---u u- uu -u u--	dactylic hexameter	feminine penthemimeral, hepthemimeral
ἄγρει καὶ πάνακες Φλεγυήιον, ὅ ῥά τε πρῶτος	-- - uu- uu-uu - u u --	dactylic hexameter	masculine penthemimeral, trithemimeral
Παιήων Μέλανος ποταμοῦ παρὰ χεῖλος ἄμερξεν,	--- uu- uu- uu -u u--	dactylic hexameter	masculine penthemimeral, hepthemimeral, trithemimeral
Ἀμφιτρυωνιάδαο θέρων Ἰφικλέος ἕλκος,	-uu-uu-u u- uu-- --	dactylic hexameter	feminine penthemimeral, hepthemimeral
εὖτε σὺν Ἡρακλῆι κακὴν ἐπυράκτεεν Ὕδρην.	-u u ---u u- uu-uu --	dactylic hexameter	feminine penthemimeral, hepthemimeral
Εἰ δέ, σύ γε σκύλακας γαλέης ἢ μητέρα λαιδρήν	- u u - uu- uu- - -uu --	dactylic hexameter	masculine penthemimeral, hepthemimeral, trithemimeral
ἀγρεύσαις πρόσπαιον, ἀποσκύλαιο δὲ λάχνην	--- --u u---u u --	dactylic hexameter	feminine penthemimeral, trithemimeral
καρχαλέου καθύπερθε πυρὸς σελάοντος ἀυτμῆς,	-uu- uu-u u- uu-u u--	dactylic hexameter	feminine penthemimeral, hepthemimeral, trithemimeral
τῆς δ᾽ἐξ ἔγκατα πάντα βαλὼν καὶ ἀφόρδια γαστρός	- - -uu -u u- u u-uu --	dactylic hexameter	feminine penthemimeral, hepthemimeral
φύρσον ἁλὸς δίοιο καὶ ἠελίου δίχα τέρσαι	-u u- --u u -uu- uu --	dactylic hexameter	feminine penthemimeral, trithemimeral
μή τοι ἐνισκήλῃ νεαρὸν σκίναρ ὠκὺς ἀίξας.	- u u--- uu- uu -u u--	dactylic hexameter	masculine penthemimeral, hepthemimeral
ἀλλ᾽ ὁπόταν χρειώ σε κατεμπάζῃ μογέοντα,	- uu- -- u u--- uu--	dactylic hexameter	masculine penthemimeral, trithemimeral
σῶχε διὰ κνήστι σκελετὸν δάκος, οἷά τ᾽ἀφαυρόν	-u u- -- uu- uu -u u--	dactylic hexameter	masculine penthemimeral, hepthemimeral, trithemimeral
σίλφιον ἢ στροφάλιγγα περιξήροιο γάλακτος	-uu - uu-u u---u u--	dactylic hexameter	feminine penthemimeral, trithemimeral
οἴνῳ ἐπικνήθων: τὸ δέ τοι προφερέστατον ἄλκαρ	-u u--- u u - uu-uu --	dactylic hexameter	masculine penthemimeral, hepthemimeral
ἐσσεῖται, πάσας γὰρ ὁμῶς ἀπὸ κῆρας ἐρύξει.	--- -- u u- uu -u u--	dactylic hexameter	masculine penthemimeral, hepthemimeral, trithemimeral
Πεύθεο δ᾽εἰναλίης χέλυος κρατέουσαν ἀρωγήν	-uu -uu- uu- uu-u u--	dactylic hexameter	masculine penthemimeral, hepthemimeral
δάχματος εἶλαρ ἔμεν δολιχῶν ὅσα φῶτας ἀνιγρούς	-uu -u u- uu- uu -u u--	dactylic hexameter	masculine penthemimeral, hepthemimeral
ἑρπετὰ σίνονται: τὸ δέ τοι μέγ᾽ ἀλέξιον εἴη.	-uu --- u u - u u-uu --	dactylic hexameter	masculine penthemimeral, hepthemimeral
ἤτοι ὅταν βροτολοιγὸν ὑπὲκ πόντοιο χελύνην	-u u- uu-u u- --u u--	dactylic hexameter	feminine penthemimeral, hepthemimeral, trithemimeral
αἰγιαλῶν ἐρύσωσιν ἐπὶ ξερὸν ἀσπαλιῆες,	-uu- uu-u u- uu -uu--	dactylic hexameter	feminine penthemimeral, hepthemimeral, trithemimeral
τήνδ᾽ ἀνακυπώσας κεφαλῆς ἀπὸ θυμὸν ἀράξαι	- uu--- uu- uu -u u--	dactylic hexameter	masculine penthemimeral, hepthemimeral
μαύλιδι χαλκείῃ, βλοσυρὸν δ᾽ἐξ αἷμα χέασθαι	-uu --- uu- - -u u--	dactylic hexameter	masculine penthemimeral, hepthemimeral
ἐν κεράμῳ νεοκμῆτι καμινόθεν, ἐκ δὲ πελιδνόν	- uu- uu-u u-uu - u u--	dactylic hexameter	feminine penthemimeral, trithemimeral
οὐρὸν ἀπηθῆσαι πλαδάον εὐεργέι μάκτρῃ:	-u u--- uu- --uu --	dactylic hexameter	masculine penthemimeral, hepthemimeral
ἧς ἔπι δὴ τέρσαιο διατρυφὲς αἷμα κεδάσσας	- uu - --u u-uu -u u--	dactylic hexameter	feminine penthemimeral, trithemimeral
δραχμάων πισύρων μίσγων βάρος: ἐν δὲ κυμίνου	--- uu- -- uu - u u--	dactylic hexameter	masculine penthemimeral, hepthemimeral, trithemimeral
δοιὰς ἀγροτέροιο, καὶ ἐκ ταμίσοιο λαγωοῦ	-u u---u u - uu-u u--	dactylic hexameter	feminine penthemimeral, hepthemimeral
τετράμορον δραχμῇσι δύω καταβάλλεο βρῖθος:	-uu- --u u- uu-uu --	dactylic hexameter	feminine penthemimeral, hepthemimeral, trithemimeral
ἔνθεν ἀποτμήγων πιέειν δραχμαῖον ἐν οἴνῃ.	-u u--- uu- --u u --	dactylic hexameter	masculine penthemimeral, hepthemimeral
Καὶ τάδε μέν τ᾽ὀφίεσσιν ἀλεξητήρια δήεις.	- uu - uu-u u---uu --	dactylic hexameter	feminine penthemimeral, trithemimeral
Ἔργα δέ τοι σίνταο περιφράζοιο φάλαγγος	-u u - --u u---u u--	dactylic hexameter	feminine penthemimeral, trithemimeral
σήματά τ᾽ἐν βρυχμοῖσιν: ἐπεί ῥ᾽ὁ μὲν αἰθαλόεις ῥώξ	-uu - --u u- u u -uu- -	dactylic hexameter	feminine penthemimeral, hepthemimeral, trithemimeral
κέκληται πισσῆεν, ἐπασσυτέροις ποσὶν ἕρπων:	--- --u u-uu- uu --	dactylic hexameter	feminine penthemimeral, trithemimeral
γαστέρι δ᾽ἐν μεσάτῃ ὀλοοῖς ἔσκληκεν ὀδοῦσι.	-uu - uu- uu- --u u--	dactylic hexameter	masculine penthemimeral, hepthemimeral, trithemimeral
τοῦ δὲ καὶ ἐγχρίμψαντος ἀνουτήτῳ ἴκελος χρώς	- u u ---u u--- uu- -	dactylic hexameter	feminine penthemimeral
μίμνει ὅμως, τὰ δ᾽ὕπερθε φάη ὑποφοινίσσονται,	-u u- u u-u u- uu----	dactylic hexameter	feminine penthemimeral, hepthemimeral, trithemimeral
φρίκη δ᾽ἐν ῥέθεϊ σκηρίπτεται: αὐτίκα δὲ χρώς	-- - uu- --uu -uu - -	dactylic hexameter	masculine penthemimeral, trithemimeral
μέζεά τ᾽ἀνδρὸς ἔνερθε τιταίνεται, ἐν δέ τε καυλός	-uu -u u-u u-uu - u u --	dactylic hexameter	feminine penthemimeral
φύρματι μυδαλέος προϊάπτεται: ἰσχία δ᾽αὔτως	-uu -uu- uu-uu -uu --	dactylic hexameter	masculine penthemimeral
μάλκη ἐνισκήπτουσα κατήριπεν ἔχμα τε γούνων.	-u u---u u-uu -u u --	dactylic hexameter	feminine penthemimeral
Ἀστέριον δέ φιν ἄλλο πιφαύσκεο, τεῦ τ᾽ἐπὶ νώτῳ	-uu- u u -u u-uu - uu --	dactylic hexameter	feminine penthemimeral, trithemimeral
λεγνωταὶ στίλβουσι διαυγέες ἐν χροῒ ῥάβδοι:	--- --u u-uu - uu --	dactylic hexameter	feminine penthemimeral, trithemimeral
βρύξαντος δ᾽ἀίδηλος ἐπέδραμεν ἀνέρι φρίκη,	--- uu-u u-uu -uu --	dactylic hexameter	feminine penthemimeral, trithemimeral
ἐν δὲ κάρος κεφαλῇ, γούνων δ᾽ὑποέκλασε δεσμά.	- u u- uu- -- uu-uu --	dactylic hexameter	masculine penthemimeral, hepthemimeral, trithemimeral
Κυάνεον δέ τοι ἄλλο πεδήορον ἀμφὶς ἀίσσει	-uu- u u -u u-uu -u u--	dactylic hexameter	feminine penthemimeral, trithemimeral
λαχνῆεν: δεινὸν δὲ φέρει καὶ ἐπὶ χροῒ νύχμα	--- -- u u- u u- uu --	dactylic hexameter	masculine penthemimeral, hepthemimeral, trithemimeral
ὅντινα γυιώσῃ: κραδίη δέ οἱ ἐν βάρος ἴσχει,	-uu --- uu- u u - uu --	dactylic hexameter	masculine penthemimeral, hepthemimeral
νὺξ δὲ περὶ κροτάφοις, ἔμετον δ᾽ἐξήρυγε δειρῆς	- u u- uu- uu- --uu --	dactylic hexameter	masculine penthemimeral, hepthemimeral, trithemimeral
λοιγὸν ἀραχνήεντα: νέμει δέ οἱ ἐγγὺς ὄλεθρον.	-u u---u u- u u -u u--	dactylic hexameter	feminine penthemimeral, hepthemimeral
Ἀγρώστης γε μὲν ἄλλος, ὃ δὴ λύκου εἴσατο μορφῇ	--- u u -u u - uu -uu --	dactylic hexameter	feminine penthemimeral, hepthemimeral, trithemimeral
μυιάων ὀλετῆρος: ὀπιπτεύει δὲ μελίσσας,	--- uu-u u--- u u--	dactylic hexameter	feminine penthemimeral, trithemimeral
ψῆνας, μύωπάς τε καὶ ὅσς᾽ ἐπὶ δεσμὸν ἵκηται.	-- --- u u - uu -u u--	dactylic hexameter	masculine penthemimeral, hepthemimeral
ἄκμητον δ᾽ἐπὶ τύμμα φέρει μεταμώνιον ἀνδρί.	--- uu -u u- uu-uu --	dactylic hexameter	feminine penthemimeral, hepthemimeral, trithemimeral
Ἄλλο γε μὴν δύσδηρι, τὸ δὴ σφήκειον ἔπουσι,	-u u - --u u - --u u--	dactylic hexameter	feminine penthemimeral, hepthemimeral, trithemimeral
πυρσὸν ἅλις, σφηκὶ προσαλίγκιον ὠμοβορῆι,	-u u- -- uu-uu -uu--	dactylic hexameter	masculine penthemimeral, trithemimeral
ὃς δὴ θαρσαλέην γενεὴν ἐκμάσσεται ἵππου:	- - -uu- uu- --uu --	dactylic hexameter	masculine penthemimeral, hepthemimeral
ἵπποι γὰρ σφηκῶν γένεσις ταῦροι δὲ μελισσῶν	-- - -- uu- -- u u--	dactylic hexameter	masculine penthemimeral, hepthemimeral, trithemimeral
[σκήνεσι πυθομένοισι λυκοσπάδες ἐξεγένοντο	-uu -uu-u u-uu -uu--	dactylic hexameter	feminine penthemimeral
τοῦ δὲ καὶ οὐτήσαντος ἐπὶ κρατερὸν θέει οἶδος,	- u u ---u u- uu- uu --	dactylic hexameter	feminine penthemimeral, hepthemimeral
νοῦσοί τ᾽ἐξέτεραι: μετὰ γούνασι δ᾽ἄλλοτε παλμός,	-- -uu- uu -uu -uu --	dactylic hexameter	masculine penthemimeral
ἄλλοτε δ᾽ἀδρανίη: μινύθοντα δὲ τόνδε δαμάζει	-uu -uu- uu-u u -u u--	dactylic hexameter	masculine penthemimeral
ἐσχάτιον κακοεργὸς ἄγων παυστήριον ὕπνος.	-uu- uu-u u- --uu --	dactylic hexameter	feminine penthemimeral, hepthemimeral, trithemimeral
Εἰ δ᾽ἄγε, μυρμήκειον, ὃ δὴ μύρμηξιν ἔικται,	- uu ---u u - --- --	dactylic hexameter	feminine penthemimeral, hepthemimeral
δειρῇ μὲν πυρόεν, ἄζῃ γε μὲν εἴσατο μορφήν,	-- - uu- -- u u -uu --	dactylic hexameter	masculine penthemimeral, hepthemimeral, trithemimeral
πάντοθεν ἀστερόεντι περιστιγὲς εὐρέι νώτῳ:	-uu -uu-u u-uu -uu --	dactylic hexameter	feminine penthemimeral
αἰθαλέη δ᾽ἐπὶ τυτθὸν ἀείρεται αὐχένι κόρση:	-uu- uu -u u-uu -uu --	dactylic hexameter	feminine penthemimeral, trithemimeral
ἄλγεα δὲ προτέροισιν ἴσα κνώπεσσι πελάζει.	-uu - uu-u u- --u u--	dactylic hexameter	feminine penthemimeral, hepthemimeral, trithemimeral
Χειροδρόποι δ᾽ἵνα φῶτες ἄτερ δρεπάνοιο λέγονται	-uu- uu -u u- uu-u u--	dactylic hexameter	feminine penthemimeral, hepthemimeral, trithemimeral
ὄσπρια χέδροπά τ᾽ἄλλα μεσοχλόου ἐντὸς ἀρούρης,	-uu -uu -u u-uu -u u--	dactylic hexameter	feminine penthemimeral
ἐνθάδ᾽ ἐπασσύτερα φλογερῇ εἰλυμένα χροιῇ	-u u-uu- uu- --uu --	dactylic hexameter	masculine penthemimeral, hepthemimeral
εἴκελα κανθαρίδεσσι φαλάγγια τυτθὰ δίενται.	-uu -uu-u u-uu -u u--	dactylic hexameter	feminine penthemimeral
τοῦ μὲν ὅμως ἔμμοχθον ἀεὶ περὶ δάχμα χέονται	- u u- --u u- uu -u u--	dactylic hexameter	feminine penthemimeral, hepthemimeral, trithemimeral
φλύκταιναι, κραδίη δὲ παραπλάζουσα μέμηνε,	--- uu- u u---u u--	dactylic hexameter	masculine penthemimeral, trithemimeral
γλῶσσα δ᾽ἄτακτα λέληκε, παρέστραπται δὲ καὶ ὄσσε.	-u u-u u-u u--- u u --	dactylic hexameter	feminine penthemimeral
Φράζεο δ᾽Αἰγύπτοιο τά τε τρέφει οὐλοὸς αἶα	-uu ---u u - uu -uu --	dactylic hexameter	feminine penthemimeral, hepthemimeral
κνώδαλα, φαλλαίνῃ ἐναλίγκια τὴν περὶ λύχνους	-uu --- uu-uu - uu --	dactylic hexameter	masculine penthemimeral
ἀκρόνυχος δειπνητὸς ἐπήλασε παιφάσσουσαν:	-uu- --u u-uu ----	dactylic hexameter	feminine penthemimeral, trithemimeral
στεγνὰ δέ οἱ πτερὰ πάντα καὶ ἔγχνοα, τοῖα κονίης	-u u - uu -u u -uu -u u--	dactylic hexameter	feminine penthemimeral, trithemimeral
ἢ καὶ ἀπὸ σπληδοῖο φαείνεται ὅστις ἐπαύρῃ.	- u u- --u u-uu -u u--	dactylic hexameter	feminine penthemimeral, trithemimeral
τῷ ἴκελος Περσεῖος ὑποτρέφεται πετάλοισι,	- uu- --u u-uu- uu--	dactylic hexameter	feminine penthemimeral, trithemimeral
τοῦ καὶ σμερδαλέον νεύει κάρη αἰὲν ὑποδράξ	- - -uu- -- uu -u u--	dactylic hexameter	masculine penthemimeral, hepthemimeral
ἐσκληκός, νηδὺς δὲ βαρύνεται: αὐτὰρ ὁ κέντρον	--- -- u u-uu -u u --	dactylic hexameter	masculine penthemimeral, trithemimeral
αὐχένι τ᾽ἀκροτάτῳ κεφαλῇ τ᾽ἐνεμάξατο φωτός,	-uu -uu- uu- uu-uu --	dactylic hexameter	masculine penthemimeral, hepthemimeral
ῥεῖα δέ κεν θανάτοιο καὶ αὐτίκα μοῖραν ἐφείη.	-u u - uu-u u -uu -u u--	dactylic hexameter	feminine penthemimeral, trithemimeral
Εἰ δ᾽ἄγε, καὶ κέντρῳ κεκορυθμένον ἀλγινόεντι	- uu - -- uu-uu -uu--	dactylic hexameter	masculine penthemimeral, trithemimeral
σκορπίον αὐδήσω καὶ ἀεικέα τοῖο γενέθλην.	-uu --- u u-uu -u u--	dactylic hexameter	masculine penthemimeral
τῶν ἤτοι λευκὸς μὲν ἀκήριος οὐδ᾽ ἐπιλωβής,	- -- -- u u-uu - uu--	dactylic hexameter	masculine penthemimeral, trithemimeral
πυρσὸς δ᾽ἐν γενύεσσι θοὸν προσεμάξατο καῦσον	-- - uu-u u- uu-uu --	dactylic hexameter	feminine penthemimeral, hepthemimeral, trithemimeral
ἀνδράσιν αἰθαλόεντα: περισπαίρουσι δὲ λώβαις	-uu -uu-u u---u u --	dactylic hexameter	feminine penthemimeral
οἷα πυρίβλητοι, κρατερὸν δ᾽ἐπὶ δίψος ὄρωρεν.	-u u--- uu- uu -u u--	dactylic hexameter	masculine penthemimeral, hepthemimeral
αὐτὰρ ὅ γε ζοφόεις ἄραδον κακὸν ὤπασε τύψας	-u u - uu- uu- uu -uu --	dactylic hexameter	masculine penthemimeral, hepthemimeral, trithemimeral
ἀνδρί: παραπλῆγες δὲ καὶ ἄφραστοι γελόωσιν.	-u u--- u u --- uu--	dactylic hexameter	masculine penthemimeral
ἄλλος δὲ χλοάων τε, καὶ ὁππότε γυῖον ἀράξῃ	-- - uu- u u -uu -u u--	dactylic hexameter	masculine penthemimeral, trithemimeral
φρῖκας ἐπιπροΐησι, κακὴ δ᾽ἐπὶ τοῖσι χάλαζα	-u u-uu-u u- uu -u u--	dactylic hexameter	feminine penthemimeral, hepthemimeral
εἴδεται ἐμπλάζουσα καὶ ἢν μέγα Σείριος ἄζῃ:	-uu ---u u - uu -uu --	dactylic hexameter	feminine penthemimeral, hepthemimeral
τοίη οἱ κέντροιο κοπίς, τοιῷ δ᾽ἐπὶ κέντρῳ	-- - --u u- -- uu --	dactylic hexameter	feminine penthemimeral, hepthemimeral, trithemimeral
σφόνδυλοι ἐννεάδεσμοι ὑπερτείνουσι κεραίης.	-uu -uu-u u---u u--	dactylic hexameter	feminine penthemimeral
ἄλλος δ᾽ἐμπέλιοςφορέει δ᾽ὑπὸ βοσκάδα νηδύν	-- -uu-uu- uu -uu --	dactylic hexameter	hepthemimeral
εὐρεῖαν, δὴ γάρ τε ποηφάγος αἰὲν ἄητος,	--- - - u u-uu -u u--	dactylic hexameter	masculine penthemimeral, trithemimeral
γαιοφάγοςβουβῶσι τυπὴν ἀλίαστον ἰάπτει,	-uu---u u- uu-u u--	dactylic hexameter	feminine penthemimeral, hepthemimeral
τοίη οἱ βούβρωστις ἐνέσκληκεν γενύεσσι.	-- - --u u--- uu--	dactylic hexameter	feminine penthemimeral, trithemimeral
τὸν δ᾽ἕτερον δήεις ἐναλίγκιον αἰγιαλῆι	- uu- -- uu-uu -uu--	dactylic hexameter	masculine penthemimeral, trithemimeral
καρκίνῳ ὃς μνία λεπτὰ ῥόθον τ᾽ἐπιβόσκεται ἅλμης.	-uu - uu -u u- uu-uu --	dactylic hexameter	feminine penthemimeral, hepthemimeral, trithemimeral
ἄλλοι δὲ ῥοικοῖσιν ἰσήρεες ἄντα παγούροις	-- - --u u-uu -u u--	dactylic hexameter	feminine penthemimeral, trithemimeral
γυῖα βαρύνονται: βαρέαι δ᾽ἐσκλήκασι χηλαί,	-u u--- uu- --uu --	dactylic hexameter	masculine penthemimeral, hepthemimeral
οἷά τε πετραίοισιν ἐποκριόωσι παγούροις:	-u u ---u u-uu-u u--	dactylic hexameter	feminine penthemimeral
τῶν δὴ καὶ γενεὴν ἐξέμμορον εὖτε λίπωσι	- - - uu- --uu -u u--	dactylic hexameter	masculine penthemimeral, trithemimeral
πέτρας καὶ βρύα λεπτὰ πολυστίοιο θαλάσσης.	-- - uu -u u---u u--	dactylic hexameter	feminine penthemimeral, trithemimeral
τοὺς ἁλὸς ἐξερύουσι δελαστρέες ἰχθυβολῆες,	- uu -uu-u u-uu -uu--	dactylic hexameter	feminine penthemimeral
αὐτίκα δ᾽ἀγρευθέντες ἐνὶ γρώνῃσιν ἔδυσαν	-uu ---u u- --u u--	dactylic hexameter	feminine penthemimeral, hepthemimeral
μυοδόκοις, ἵνα τέκνα κακοφθόρα τῶνδε θανόντων	-uu- uu -u u-uu -u u--	dactylic hexameter	feminine penthemimeral, trithemimeral
σκορπίοι ἐξεγένοντο καθ᾽ ἕρκεα λωβητῆρες.	-uu -uu-u u -uu ----	dactylic hexameter	feminine penthemimeral
τὸν δὲ μελίχλωρον: τοῦ μὲν προμελαίνεται ἄκρη	- u u--- - - uu-uu --	dactylic hexameter	masculine penthemimeral, hepthemimeral
σφόνδυλος, ἄσβεστον δὲ νέμει πολυκήριον ἄτην.	-uu --- u u- uu-uu --	dactylic hexameter	masculine penthemimeral, hepthemimeral
ἔχθιστος δ᾽ὅ τε ῥαιβὰ φέρει φλογὶ εἴκελα γυῖα	--- u u -u u- uu -uu --	dactylic hexameter	feminine penthemimeral, hepthemimeral, trithemimeral
ἀνδράσι, νηπιάχοις δὲ παρασχεδὸν ἤγαγεν αἶσαν:	-uu -uu- u u-uu -uu --	dactylic hexameter	masculine penthemimeral
οἷς δὴ καὶ νώτοισι περὶ πτερὰ λευκὰ χέονται	- - - --u u- uu -u u--	dactylic hexameter	feminine penthemimeral, hepthemimeral, trithemimeral
μάστακι σιτοβόρῳ ἐναλίγκια, τοί θ᾽ὑπὲρ ἄκρων	-uu -uu- uu-uu - uu --	dactylic hexameter	masculine penthemimeral
ἱπτάμενοι ἀθέρων λεπυρὸν στάχυν ἐκβόσκονται	-uu- uu- uu- uu ----	dactylic hexameter	masculine penthemimeral, hepthemimeral, trithemimeral
Πήδασα καὶ Κισσοῖο κατὰ πτύχας ἐμβατέοντες.	-uu - --u u- uu -uu--	dactylic hexameter	feminine penthemimeral, hepthemimeral, trithemimeral
Οἶδά γε μὴν φράσσασθαι ἀλέξια τοῖο βολάων,	-u u - --u u-uu -u u--	dactylic hexameter	feminine penthemimeral, trithemimeral
οἷά περ ἐκ βέμβικος ὀρεστέρου ἠὲ μελίσσης,	-u u - --u u-uu -u u--	dactylic hexameter	feminine penthemimeral, trithemimeral
ᾗ τε καὶ ἐκ κέντρου θάνατος πέλει εὖτε χαράξῃ	- u u - -- uu- uu -u u--	dactylic hexameter	masculine penthemimeral, hepthemimeral, trithemimeral
ἄνδρα πέριξ σίμβλοιο πονεύμενον ἠὲ καὶ ἀγροῖς:	-u u- --u u-uu -u u --	dactylic hexameter	feminine penthemimeral, trithemimeral
κέντρον γὰρ πληγῇ περικάλλιπεν ἐμματέουσα,	-- - -- uu-uu -uu--	dactylic hexameter	masculine penthemimeral, trithemimeral
κέντρον δὲ ζωήν τε φέρει θάνατόν τε μελίσσαις.	-- - -- u u- uu- u u--	dactylic hexameter	masculine penthemimeral, hepthemimeral, trithemimeral
Οἶδά γε μὴν καὶ ἴουλος ἃ μήδεται ἠδ᾽ ὀλοὸς σφήξ,	-u u - u u-u u -uu - uu- -	dactylic hexameter	feminine penthemimeral, trithemimeral
πεμφρηδὼν ὀλίγη τε καὶ ἀμφικαρὴς σκολόπενδρα,	--- uu- u u -uu- uu--	dactylic hexameter	masculine penthemimeral, trithemimeral
ἥ τε καὶ ἀμφοτέρωθεν ὀπάζεται ἀνδράσι κῆρα,	- u u -uu-u u-uu -uu --	dactylic hexameter	feminine penthemimeral
νήιά θ᾽ὡς σπέρχονται ὑπὸ πτερὰ θηρὶ κιούσῃ:	-uu - --u u- uu -u u--	dactylic hexameter	feminine penthemimeral, hepthemimeral, trithemimeral
τυφλήν τε σμερδνήν τε βροτοῖς ἐπὶ λοιγὸν ἄγουσαν	-- - -- u u- uu -u u--	dactylic hexameter	masculine penthemimeral, hepthemimeral, trithemimeral
μυγαλέην, τροχιῇσιν ἐνιθνῄσκουσαν ἁμάξης.	-uu- uu-u u---u u--	dactylic hexameter	feminine penthemimeral, trithemimeral
σῆπά γε μὴν πεδανοῖσιν ὁμὴν σαύροισιν ἀλύξαις,	-u u - uu-u u- --u u--	dactylic hexameter	feminine penthemimeral, hepthemimeral, trithemimeral
καὶ σαλαμάνδρειον δόλιον δάκος αἰὲν ἀπεχθές,	- uu--- uu- uu -u u--	dactylic hexameter	masculine penthemimeral, hepthemimeral
ἥ τε καὶ ἀσβέστοιο διὲκ πυρὸς οἶμον ἔχουσα	- u u ---u u- uu -u u--	dactylic hexameter	feminine penthemimeral, hepthemimeral
ἔσσυται †ἀκμήνης† καὶ ἀνώδυνος: οὐδέ τί οἱ φλόξ	-uu --- u u-uu -u u - -	dactylic hexameter	masculine penthemimeral
σίνεται ἀσβέστη ῥαγόεν δέρος ἄκρα τε γυίων.	-uu --- uu- uu -u u --	dactylic hexameter	masculine penthemimeral, hepthemimeral
ναὶ μὴν οἶδ᾽ ὅσα πόντος ἁλὸς ῥόχθοισιν ἑλίσσει,	- - - uu -u u- --u u--	dactylic hexameter	feminine penthemimeral, hepthemimeral, trithemimeral
σμυραίνης δ᾽ἔκπαγλον: ἐπεὶ μογεροὺς ἁλιῆας	--- --u u- uu- uu--	dactylic hexameter	feminine penthemimeral, hepthemimeral, trithemimeral
πολλάκις ἐμπρήσασα κατεπρήνιξεν ἐπάκτρου	-uu ---u u---u u--	dactylic hexameter	feminine penthemimeral
εἰς ἅλα φυζηθέντας ἐχετλίου ἐξαναδῦσα.	- uu ---u u-uu -uu--	dactylic hexameter	feminine penthemimeral
εἰ ἔτυμον κείνην γε σὺν οὐλοβόροις ἐχίεσσι	- uu- -- u u -uu- uu--	dactylic hexameter	masculine penthemimeral, trithemimeral
θόρνυσθαι προλιποῦσαν ἁλὸς νομὸν ἠπείροισι.	--- uu-u u- uu ----	dactylic hexameter	feminine penthemimeral, hepthemimeral, trithemimeral
τρυγόνα μὴν ὀλοεργὸν ἁλιρραίστην τε δράκοντα	-uu - uu-u u--- u u--	dactylic hexameter	feminine penthemimeral, trithemimeral
οἶδ᾽ ἀπαλέξασθαι: φορέει γε μὲν ἄλγεα τρυγών	- uu--- uu- u u -uu --	dactylic hexameter	masculine penthemimeral, hepthemimeral
ἦμος ἐν ὁλκαίοισι λίνοις μεμογηότα κέντρῳ	-u u ---u u- uu-uu --	dactylic hexameter	feminine penthemimeral, hepthemimeral
ἐργοπόνον τύψῃσιν, ἢ ἐν πρέμνοισι παγείῃ	-uu- --u u - --u u--	dactylic hexameter	feminine penthemimeral, hepthemimeral, trithemimeral
δενδρείου τό τε πολλὸν ἀγαυρότατον θαλέθῃσι:	--- u u -u u-uu- uu--	dactylic hexameter	feminine penthemimeral, trithemimeral
τοῦ μὲν ὑπὸ πληγῇσιν ἅτ᾽ ἠελίοιο δαμέντος	- u u- --u u -uu-u u--	dactylic hexameter	feminine penthemimeral, trithemimeral
ῥίζαι σὺν δέ τε φυλλὰς ἀποφθίνει, ἀνδρὶ δὲ σάρκες	-- - u u -u u-uu -u u --	dactylic hexameter	feminine penthemimeral, trithemimeral
πυθόμεναι μινύθουσι: λόγος γε μὲν ὥς ποτ᾽ Ὀδυσσεύς	-uu- uu-u u- u u - u u--	dactylic hexameter	feminine penthemimeral, hepthemimeral, trithemimeral
ἔφθιτο λευγαλέοιο τυπεὶς ἁλίου ὑπὸ κέντρου.	-uu -uu-u u- uu- uu --	dactylic hexameter	feminine penthemimeral, hepthemimeral
Οἷσιν ἐγὼ τὰ ἕκαστα διείσομαι ἄρκια νούσων.	-u u- u u-u u-uu -uu --	dactylic hexameter	feminine penthemimeral, trithemimeral
δὴ γὰρ ὅτ᾽ ἀγχούσης θριδακηίδα λάζεο χαίτην,	- u u --- uu-uu -uu --	dactylic hexameter	masculine penthemimeral
ἄλλοτε πενταπέτηλον, ὅτ᾽ ἄνθεα φοινὰ βάτοιο,	-uu -uu-u u -uu -u u--	dactylic hexameter	feminine penthemimeral
ἄρκτιον, ὀξαλίδας τε καὶ ὀρμενόεντα λυκαψόν,	-uu -uu- u u -uu-u u--	dactylic hexameter	masculine penthemimeral
κίκαμα τόρδειλόν τε περιβρυές, ἐν δὲ χαμηλήν	-uu --- u u-uu - u u--	dactylic hexameter	masculine penthemimeral
ῥεῖα πίτυν, φηγοῦ τε βαθὺν περὶ φλοιὸν ἀράξας,	-u u- -- u u- uu -u u--	dactylic hexameter	masculine penthemimeral, hepthemimeral, trithemimeral
σὺν δ᾽ἄρα καυκαλίδας τε καὶ ἐκ σταφυλίνου ἀμήσας	- uu -uu- u u - uu-u u--	dactylic hexameter	masculine penthemimeral, hepthemimeral
σπέρματα καὶ τρεμίθοιο νέον πολυειδέα καρπόν:	-uu - uu-u u- uu-uu --	dactylic hexameter	feminine penthemimeral, hepthemimeral, trithemimeral
ἢ ἔτι καὶ φοινίσσον ἁλὸς καταβάλλεο φῦκος,	- uu - --u u- uu-uu --	dactylic hexameter	feminine penthemimeral, hepthemimeral, trithemimeral
ἀχραές τ᾽ἀδίαντον, ἵν᾽ οὐκ ὄμβροιο ῥαγέντος	--- uu-u u - --u u--	dactylic hexameter	feminine penthemimeral, hepthemimeral, trithemimeral
λεπταλέη πίπτουσα νοτὶς πετάλοισιν ἐφίζει.	-uu- --u u- uu-u u--	dactylic hexameter	feminine penthemimeral, hepthemimeral, trithemimeral
εἰ δ᾽ἄγε καὶ σμυρνεῖον ἀειβρυὲς ἢ σύ γε ποίης	- uu - --u u-uu - u u --	dactylic hexameter	feminine penthemimeral, trithemimeral
λευκάδος ἠρύγγου τε τάμοις ἀθερηίδα ῥίζαν	-uu --- u u- uu-uu --	dactylic hexameter	masculine penthemimeral, hepthemimeral
ἄμμιγα καχρυφόρῳ λιβανωτίδι: μηδ᾽ ἀπαρίνη	-uu -uu- uu-uu - uu--	dactylic hexameter	masculine penthemimeral
μηδ᾽ ἔτι κουλυβάτεια περιβρίθουσά τε μήκων	- uu -uu-u u---u u --	dactylic hexameter	feminine penthemimeral
θυλακὶς ἢ ἐπιτηλὶς ἐπὶ χραίσμῃσιν ἀπείη.	-uu - uu-u u- --u u--	dactylic hexameter	feminine penthemimeral, hepthemimeral, trithemimeral
σὺν δὲ κράδης κυέουσαν ἀποτμήξαιο κορύνην,	- u u- uu-u u---u u--	dactylic hexameter	feminine penthemimeral, trithemimeral
ἢ αὐτοὺς κόκκυγας ἐρινάδος, οἵ τε πρὸ ἄλλης	- -- --u u-uu - u u --	dactylic hexameter	feminine penthemimeral, trithemimeral
γογγύλοι ἐκφαίνουσιν ἀνοιδείοντες ὀπώρης.	-uu ---u u---u u--	dactylic hexameter	feminine penthemimeral
λάζεο καὶ πυράκανθαν ἰδὲ φλόμου ἀργέος ἄνθην,	-uu - uu-u u- uu -uu --	dactylic hexameter	feminine penthemimeral, hepthemimeral, trithemimeral
ἄμμιγα δ᾽αἰγίλοπός τε χελιδονίου τε πέτηλα,	-uu -uu- u u-uu- u u--	dactylic hexameter	masculine penthemimeral
δαύκειον, ῥίζαν τε βρυωνίδος, ἣ καὶ ἔφηλιν	--- -- u u-uu - u u--	dactylic hexameter	masculine penthemimeral, trithemimeral
θηλυτέρης ἐχθρήν τε χρόης ὠμόρξατο λεύκην.	-uu- -- u u- --uu --	dactylic hexameter	masculine penthemimeral, hepthemimeral, trithemimeral
ἐν δὲ περιστερόεντα κατασμώξαιο πέτηλα,	- u u-uu-u u---u u--	dactylic hexameter	feminine penthemimeral
ἢ καὶ ἀλεξιάρης πτόρθους ἀπαμέργεο ῥάμνου:	- u u-uu- -- uu-uu --	dactylic hexameter	masculine penthemimeral, hepthemimeral
μούνη γὰρ δρήστειρα βροτῶν ἀπὸ κῆρας ἐρύκει.	-- - --u u- uu -u u--	dactylic hexameter	feminine penthemimeral, hepthemimeral, trithemimeral
ναὶ μὴν παρθενίοιο νεοδρέπτους ὀροδάμνους,	- - -uu-u u--- uu--	dactylic hexameter	feminine penthemimeral
κόρκορον ἢ πεταλῖτιν ἀμέργεο, πολλάκι μίλτου	-uu - uu-u u-uu -uu --	dactylic hexameter	feminine penthemimeral, trithemimeral
Λημνίδος ἣ πάσῃσι πέλει θελκτήριον ἄταις.	-uu - --u u- --uu --	dactylic hexameter	feminine penthemimeral, hepthemimeral, trithemimeral
δήποτε καὶ σικύοιο τάμοις ἐνιπευκέα ῥίζαν	-uu - uu-u u- uu-uu --	dactylic hexameter	feminine penthemimeral, hepthemimeral, trithemimeral
ἀγροτέρου: νηδὺν δὲ καὶ ἐμβρίθουσαν ἀνίης	-uu- -- u u ---u u--	dactylic hexameter	masculine penthemimeral, trithemimeral
ἤμυνεν καὶ καρπὸς ἐυρρήχου παλιούρου:	--- - -u u--- uu--	dactylic hexameter	feminine penthemimeral, trithemimeral
σὺν καὶ ἀκανθοβόλος χαίτη, νεαλεῖς τ᾽ὀρόβακχοι	- u u-uu- -- uu- uu--	dactylic hexameter	masculine penthemimeral, hepthemimeral
σίδης ὑσγινόεντος ἐπιμύοντας ὀλόσχους	-- -uu-u u---u u--	dactylic hexameter	feminine penthemimeral
αὐχενίους ἵνα λεπτὰ πέριξ ἐνερεύθεται ἄνθη:	-uu- uu -u u- uu-uu --	dactylic hexameter	feminine penthemimeral, hepthemimeral, trithemimeral
ἄλλοτε δ᾽ὕσσωπός τε καὶ ἡ πολύγουνος ὄνωνις,	-uu --- u u - uu-u u--	dactylic hexameter	masculine penthemimeral, hepthemimeral
φύλλα τε τηλεφίλοιο, νέον τ᾽ἐν βότρυσι κλῆμα,	-u u -uu-u u- - -uu --	dactylic hexameter	feminine penthemimeral, hepthemimeral
ἀγλῖθες, καὶ καρπὸς ὀρειγενέος κορίοιο,	--- - -u u-uu- uu--	dactylic hexameter	feminine penthemimeral, trithemimeral
ἢ καὶ λεπτοθρίοιο πολύχνοα φύλλα κονύζης.	- - -uu-u u-uu -u u--	dactylic hexameter	feminine penthemimeral
πολλάκι δ᾽ἢ πέπεριν κόψας νέον ἢ ἀπὸ Μήδων	-uu - uu- -- uu - uu --	dactylic hexameter	masculine penthemimeral, hepthemimeral, trithemimeral
κάρδαμον ἐμπίσαιο: σὲ δ᾽ἂν πολυάνθεα γλήχων	-uu ---u u - uu-uu --	dactylic hexameter	feminine penthemimeral, hepthemimeral
στρύχνον τ᾽ἠδὲ σίνηπι κακηπελέοντα σαώσαι.	-- -u u-u u-uu-u u--	dactylic hexameter	feminine penthemimeral
ἄγρει καὶ πρασιῆς χλοερὸν πράσον, ἄλλοτε δ᾽αὐτῆς	-- - uu- uu- uu -uu --	dactylic hexameter	masculine penthemimeral, hepthemimeral, trithemimeral
σπέρμ᾽ ὀλοὸν κνίδης ἥ θ᾽ἑψίη ἔπλετο κούροις:	- uu- -- - -uu -uu --	dactylic hexameter	masculine penthemimeral, trithemimeral
σὺν καί που νιφόεν σκίλλης κάρη, αὖά τε βολβῶν	- - - uu- -- uu -u u --	dactylic hexameter	masculine penthemimeral, hepthemimeral, trithemimeral
σπείρεα, καὶ καυλεῖον ὁμοκλήτοιο δράκοντος,	-uu - --u u---u u--	dactylic hexameter	feminine penthemimeral, trithemimeral
ῥάμνου τ᾽ἀσπαράγους θαμνίτιδος, ἠδ᾽ ὅσα πεῦκαι	-- -uu- --uu - uu --	dactylic hexameter	masculine penthemimeral
ἀγρότεραι στρόμβοισιν ὑπεθρέψαντο ναπαῖαι.	-uu- --u u---u u--	dactylic hexameter	feminine penthemimeral, trithemimeral
εἰ δέ, σύ γ᾽ἐκ ποίης ἀβληχρέος ἔγχλοα ῥίζαν	- u u - -- --uu -uu --	dactylic hexameter	masculine penthemimeral, trithemimeral
θηρὸς ἰσαζομένην τμήξαις ἰοειδέι κέντρῳ	-u u-uu- -- uu-uu --	dactylic hexameter	masculine penthemimeral, hepthemimeral
σκορπίου, ἠὲ σίδας Ψαμαθηίδας, ἅς τε Τράφεια	-uu -u u- uu-uu - u u--	dactylic hexameter	masculine penthemimeral
Κῶπαί τε λιμναῖον ὑπεθρέψαντο παρ᾽ ὕδωρ,	-- - --u u---u u --	dactylic hexameter	feminine penthemimeral, trithemimeral
ᾗπερ Σχοινῆός τε ῥόος Κνώποιό τε βάλλει,	-- --- u u- --u u --	dactylic hexameter	masculine penthemimeral, hepthemimeral
ὅσσα θ᾽ὑπ᾽ Ἰνδὸν χεῦμα πολυφλοίσβοιο Χοάσπεω	-u u -- -u u---u u--	dactylic hexameter	feminine penthemimeral
πιστάκι᾽ ἀκρεμόνεσσιν ἀμυγδαλόεντα πέφανται:	-uu -uu-u u-uu-u u--	dactylic hexameter	feminine penthemimeral
καυκαλίδας, σὺν δ᾽αἰθὰ βάλοις φιμώδεα μύρτα,	-uu- - -u u- --uu --	dactylic hexameter	feminine penthemimeral, hepthemimeral, trithemimeral
κάρφεά θ᾽ὁρμίνοιο καὶ ἐκ μαράθου βρυόεντος,	-uu ---u u - uu- uu--	dactylic hexameter	feminine penthemimeral, hepthemimeral
εἰρύσιμόν τε καὶ ἀγροτέρου σπερμεῖ᾽ ἐρεβίνθου	-uu- u u -uu- -- uu--	dactylic hexameter	hepthemimeral, trithemimeral
σὺν χλοεροῖς θάμνοισι βαλὼν βαρυώδεα ποίην.	- uu- --u u- uu-uu --	dactylic hexameter	feminine penthemimeral, hepthemimeral, trithemimeral
ναὶ μὴν καὶ σίσυμβρα πέλει μειλίγματα νούσων,	- - - --u u- --uu --	dactylic hexameter	feminine penthemimeral, hepthemimeral, trithemimeral
σὺν δὲ μελιλλώτοιο νέον στέφος, ἠδ᾽ ὅσα χαύνης	- u u---u u- uu - uu --	dactylic hexameter	feminine penthemimeral, hepthemimeral
οἰνάνθης βρύα λευκὰ καταψήχουσι νομῆες,	--- uu -u u---u u--	dactylic hexameter	feminine penthemimeral, trithemimeral
ὅσσα τε λυχνὶς ἔνερθεν ἐρευθήεις τε θρυαλλίς	-u u -u u-u u--- u u--	dactylic hexameter	feminine penthemimeral
καὶ ῥόδον ἠδ᾽ ἴα λεπτὸν ὅσον σπερμεῖον ἀέξει.	- uu - uu -u u- --u u--	dactylic hexameter	feminine penthemimeral, hepthemimeral, trithemimeral
ἢ καὶ πουλύγονον λασίων ὑπάμησον ἰάμνων,	- - -uu- uu- uu-u u--	dactylic hexameter	masculine penthemimeral, hepthemimeral
ψίλωθρον, καρπόν τε πολυθρήνου ὑακίνθου,	--- -- u u--- uu--	dactylic hexameter	masculine penthemimeral, trithemimeral
ὃν Φοῖβος θρήνησεν ἐπεί ῥ᾽ἀεκούσιος ἔκτα	- -- --u u- uu-uu --	dactylic hexameter	feminine penthemimeral, hepthemimeral, trithemimeral
παῖδα βαλὼν προπάροιθεν Ἀμυκλαίου ποταμοῖο,	-u u- uu-u u--- uu--	dactylic hexameter	feminine penthemimeral, trithemimeral
πρωθήβην Ὑάκινθον, ἐπεὶ σόλος ἔμπεσε κόρσῃ	--- uu-u u- uu -uu --	dactylic hexameter	feminine penthemimeral, hepthemimeral, trithemimeral
πέτρου ἀφαλλόμενος νέατον δ᾽ἤραξε κάλυμμα.	-u u-uu- uu- --u u--	dactylic hexameter	masculine penthemimeral, hepthemimeral
σὺν δέ τε καὶ τριπέτηλον ὀποῖό τε δάκρυα βάλλοις	- u u - uu-u u-u u -uu --	dactylic hexameter	feminine penthemimeral, trithemimeral
τρισσοῖς ὁλκήεσσιν ἰσοζυγέων ὀδελοῖσιν:	-- ---u u-uu- uu--	dactylic hexameter	feminine penthemimeral
ἠὲ σύ γ᾽ἕρπυλλον κεροειδέα, πολλάκι κρῆθμον,	-u u --- uu-uu -uu --	dactylic hexameter	masculine penthemimeral
ἢ ποίην κυπάρισσον ἀμέργεο, σὺν δὲ καὶ αὐτοῖς	- -- uu-u u-uu - u u --	dactylic hexameter	feminine penthemimeral, trithemimeral
ἄννησον Λιβυκάς τε ποτῷ ἐνικνήθεο ῥίζας:	--- uu- u u- uu-uu --	dactylic hexameter	masculine penthemimeral, hepthemimeral, trithemimeral
ὧν σὺ τότ᾽ ἀμμίγδην, τοτὲ δ᾽ἄνδιχα πίνεο θρύψας	- u u --- uu -uu -uu --	dactylic hexameter	masculine penthemimeral
ἐν κελέβῃ, κεράσαι δὲ σὺν ὄξεϊ, πολλάκι δ᾽οἴνῃ	- uu- uu- u u -uu -uu --	dactylic hexameter	masculine penthemimeral, trithemimeral
ἢ ὕδατι: χραισμεῖ δὲ καὶ ἐνθρυφθέντα γάλακτι.	- uu- -- u u ---u u--	dactylic hexameter	masculine penthemimeral, trithemimeral
Ἢν δέ σ᾽ ὁδοιπλανέοντα καὶ ἐν νεμέεσσιν ἀνύδροις	- u u-uu-u u - uu-u u--	dactylic hexameter	feminine penthemimeral, hepthemimeral
νύχμα κατασπέρχῃ, βεβαρημένος αὐτίκα ῥίζας	-u u--- uu-uu -uu --	dactylic hexameter	masculine penthemimeral
ἢ ποίην ἢ σπέρμα παρ᾽ ἀτραπιτοῖσι χλοάζον	- -- - -u u -uu-u u--	dactylic hexameter	feminine penthemimeral, trithemimeral
μαστάζειν γενύεσσιν, ἀμελγόμενος δ᾽ἀπὸ χυλόν	--- uu-u u-uu- uu --	dactylic hexameter	feminine penthemimeral, trithemimeral
τύμμασιν ἡμίβρωτα βάλοις ἔπι λύματα δαιτός	-uu ---u u- uu -uu --	dactylic hexameter	feminine penthemimeral, hepthemimeral
ὄφρα δύην καὶ κῆρα κατασπέρχουσαν ἀλύξῃς.	-u u- - -u u---u u--	dactylic hexameter	feminine penthemimeral, trithemimeral
Ναὶ μὴν καὶ σικύην χαλκήρεα λοιγέι τύψει	- - - uu- --uu -uu --	dactylic hexameter	masculine penthemimeral, trithemimeral
προσμάξας ἰόν τε καὶ ἀθρόον αἷμα κενώσεις,	--- -- u u -uu -u u--	dactylic hexameter	masculine penthemimeral, trithemimeral
ἠὲ κράδης γλαγόεντα χέας ὀπόν, ἠὲ σίδηρον	-u u- uu-u u- uu -u u--	dactylic hexameter	feminine penthemimeral, hepthemimeral, trithemimeral
καυστείρης θαλφθεῖσαν ὑπὸ στέρνοισι καμίνου.	--- --u u- --u u--	dactylic hexameter	feminine penthemimeral, hepthemimeral, trithemimeral
ἄλλοτε φορβάδος αἰγὸς ἐνίπλειον δέρος οἴνης	-uu -uu -u u--- uu --	dactylic hexameter	feminine penthemimeral
χραισμήσει τημοῦτος ἐπὴν σφυρὸν ἢ χέρα κόψῃ.	--- --u u- uu - uu --	dactylic hexameter	feminine penthemimeral, hepthemimeral, trithemimeral
ἀσκοῦ ἔσω βαρύθοντα μέσον διὰ πῆχυν ἐρείσεις	-u u- uu-u u- uu -u u--	dactylic hexameter	feminine penthemimeral, hepthemimeral, trithemimeral
ἢ σφυρόν, ἀσκοδέταις δὲ πέριξ βουβῶνας ἑλίξεις	- uu -uu- u u- --u u--	dactylic hexameter	masculine penthemimeral, hepthemimeral
εἰσόκε τοι μένος οἴνου ἀπὸ χροὸς ἄλγος ἐρύξῃ.	-uu - uu -u u- uu -u u--	dactylic hexameter	feminine penthemimeral, hepthemimeral, trithemimeral
δήποτε καὶ βδέλλας κορέσαις ἐπὶ τύμμασι βόσκων,	-uu - -- uu- uu -uu --	dactylic hexameter	masculine penthemimeral, hepthemimeral, trithemimeral
ἢ ἀπὸ κρομμυόφι στάζων ὀπόν, ἄλλοτε δ᾽οἴνης	- uu -uu- -- uu -uu --	dactylic hexameter	masculine penthemimeral, hepthemimeral
μίγδην ἐν πυράθοισι χέας τρύγα φυρήσασθαι	-- - uu-u u- uu ----	dactylic hexameter	feminine penthemimeral, hepthemimeral, trithemimeral
ἢ ὄξευς, νεαλεῖ δὲ πάτῳ περὶ τύψιν ἑλίξαις.	- -- uu- u u- uu -u u--	dactylic hexameter	masculine penthemimeral, hepthemimeral, trithemimeral
Ὄφρα δὲ καὶ πάσῃσιν ἀλεξητήριον ἄταις	-u u - --u u---uu --	dactylic hexameter	feminine penthemimeral, trithemimeral
τευξάμενος πεπύθοιο, τό τοι μέγα κρήγυον ἔσται	-uu- uu-u u - uu -uu --	dactylic hexameter	feminine penthemimeral, hepthemimeral, trithemimeral
ἦμος ὅτε θρόνα πάντα μιῇ ὑπὸ χειρὶ ταράξῃς,	-u u- uu -u u- uu -u u--	dactylic hexameter	feminine penthemimeral, hepthemimeral, trithemimeral
ἐν μὲν ἀριστολόχεια, καὶ ἴριδος ἐν δέ τε νάρδου	- u u-uu-u u -uu - u u --	dactylic hexameter	feminine penthemimeral
ῥίζαι, χαλβανίδες τε σὺν αὐαλέοισι πυρέθροις	-- -uu- u u -uu-u u--	dactylic hexameter	masculine penthemimeral
εἶεν, δαυκείου τε παναλθέος, ἐν δὲ βρυώνης,	-- --- u u-uu - u u--	dactylic hexameter	masculine penthemimeral
σὺν δέ τε ῥίζεα χαῦνα νεωρυχέος γλυκυσίδης	- u u -uu -u u-uu- uu--	dactylic hexameter	feminine penthemimeral
κάρφεά τ᾽ἐλλεβόρου μελανόχροος, ἄμμιγα δ᾽ἀφρός	-uu -uu- uu-uu -uu --	dactylic hexameter	masculine penthemimeral
λίτρου: σὺν δὲ κύμινα χέαις βλαστόν τε κονύζης,	-- - u u-u u- -- u u--	dactylic hexameter	feminine penthemimeral, hepthemimeral, trithemimeral
ἄμμιγα δ᾽ἀγροτέρης σταφίδος λέπος: ἶσα δὲ δάφνης	-uu -uu- uu- uu -u u --	dactylic hexameter	masculine penthemimeral, hepthemimeral
σπερμεῖα κύτισόν τε κατακνήθειν τε χαμηλόν	--- uu- u u--- u u--	dactylic hexameter	masculine penthemimeral, trithemimeral
ἱππεῖον λειχῆνα, καὶ ἐν κυκλάμινον ἀγείρας.	--- --u u - uu-u u--	dactylic hexameter	feminine penthemimeral, hepthemimeral, trithemimeral
ἐν καὶ μήκωνος φιαρῆς ὀπόν, ἀμφὶ καὶ ἄγνου	- - --- uu- uu -u u --	dactylic hexameter	masculine penthemimeral, hepthemimeral
σπέρματα βάλσαμόν τε καὶ ἐν κινάμοιο βαλέσθαι,	-uu --- u u - uu-u u--	dactylic hexameter	masculine penthemimeral, hepthemimeral
σὺν καὶ σφονδύλειον ἁλός τ᾽ἐμπληθέα κύμβην,	- - ---u u- --uu --	dactylic hexameter	feminine penthemimeral, hepthemimeral
ἄμμιγα καὶ τάμισον καὶ καρκίνον: ἀλλ᾽ ὁ μὲν εἴη	-uu - uu- - -uu - u u --	dactylic hexameter	masculine penthemimeral, trithemimeral
πτωκός, ὁ δ᾽ἐν ποταμοῖσι πολυστίοισι νομάζων.	-u u - uu-u u---u u--	dactylic hexameter	feminine penthemimeral, trithemimeral
καὶ τὰ μὲν ἐν στύπεϊ προβαλὼν πολυχανδέος ὅλμου	- u u - uu- uu- uu-uu --	dactylic hexameter	masculine penthemimeral, hepthemimeral, trithemimeral
μάξαι λαϊνέοισιν ἐπιπλήσσων ὑπέροισιν:	-- -uu-u u--- uu--	dactylic hexameter	feminine penthemimeral
αἶψα δ᾽ἐπ᾽ αὐαλέοισι χέας ἀπαρινέα χυλόν	-u u -uu-u u- uu-uu --	dactylic hexameter	feminine penthemimeral, hepthemimeral
ἄμμιγα συμφύρσαιο, καταρτίζοιο δὲ κύκλους	-uu ---u u---u u --	dactylic hexameter	feminine penthemimeral
δραχμαίους πλάστιγγι διακριδὸν ἄχθος ἐρύξας,	--- --u u-uu -u u--	dactylic hexameter	feminine penthemimeral, trithemimeral
οἴνης δ᾽ἐν δοιῇσι χαδεῖν κοτύλῃσι ταράξας.	-- - --u u- uu-u u--	dactylic hexameter	feminine penthemimeral, hepthemimeral, trithemimeral
Καί κεν Ὁμηρείοιο καὶ εἰσέτι Νικάνδροιο	- u u---u u -uu ----	dactylic hexameter	feminine penthemimeral
μνῆστιν ἔχοις, τὸν ἔθρεψε Κλάρου νιφόεσσα πολίχνη.	-u u- u u-u u- uu-u u--	dactylic hexameter	feminine penthemimeral, hepthemimeral, trithemimeral
Εἰ καὶ μὴ σύγκληρα κατ᾽ Ἀσίδα τείχεα δῆμοι	- - - --u u -uu -uu --	dactylic hexameter	feminine penthemimeral, trithemimeral
τύρσεσιν ἐστήσαντο τέων ἀνεδέγμεθα βλάστας,	-uu ---u u- uu-uu --	dactylic hexameter	feminine penthemimeral, hepthemimeral
Πρωταγόρη, δολιχὸς δὲ διάπροθι χῶρος ἐέργει,	-uu- uu- u u-uu -u u--	dactylic hexameter	masculine penthemimeral, trithemimeral
ῥεῖά κέ τοι ποσίεσσιν ἀλέξια φαρμακοέσσαις	-u u - uu-u u-uu -uu--	dactylic hexameter	feminine penthemimeral, trithemimeral
αὐδήσαιμ᾽ ἅ τε φῶτας ἐνιχριμφθέντα δαμάζει.	--- u u -u u---u u--	dactylic hexameter	feminine penthemimeral, trithemimeral
ἦ γὰρ δὴ σὺ μὲν ἄγχι πολυστροίβοιο θαλάσσης	- - - u u -u u---u u--	dactylic hexameter	feminine penthemimeral, trithemimeral
Ἄρκτον ὑπ᾽ ὀμφαλόεσσαν ἐνάσσαο ἧχί τε Ῥείης	-u u -uu-u u-uu -u u --	dactylic hexameter	feminine penthemimeral
Λοβρίνης θαλάμαι τε καὶ ὀργαστήριον Ἄττεω:	--- uu- u u ---uu --	dactylic hexameter	masculine penthemimeral, trithemimeral
αὐτὰρ ἐγὼ τόθι παῖδες ἐυζήλοιο Κρεούσης	-u u- uu -u u---u u--	dactylic hexameter	feminine penthemimeral, trithemimeral
πιοτάτην ἐδάσαντο γεωμορίην ἠπείρου	-uu- uu-u u-uu- ---	dactylic hexameter	feminine penthemimeral, trithemimeral
ἑζόμενοι τριπόδεσσι πάρα Κλαρίοις Ἑκάτοιο.	-uu- uu-u u- uu- uu--	dactylic hexameter	feminine penthemimeral, hepthemimeral, trithemimeral
Ἀλλ᾽ ἤτοι χολόεν μὲν ἰδὲ στομίοισι δυσαλθές	- -- uu- u u- uu-u u--	dactylic hexameter	masculine penthemimeral, hepthemimeral, trithemimeral
πνυθείης ἀκόνιτον, ὃ δή ῥ᾽Ἀχερωίδες ὄχθαι	--- uu-u u - uu-uu --	dactylic hexameter	feminine penthemimeral, hepthemimeral, trithemimeral
φύουσιν τόθι χάσμα δυσέκδρομον Εὐβουλῆος	--- uu -u u-uu ----	dactylic hexameter	feminine penthemimeral, trithemimeral
ἄστυρά τε Πριόλαο καταστρεφθέντα δέδουπε.	-uu - uu-u u---u u--	dactylic hexameter	feminine penthemimeral, trithemimeral
τοῖο δὲ πάντα χαλινὰ καὶ οὐρανόεσσαν ὑπήνην	-u u -u u-u u -uu-u u--	dactylic hexameter	feminine penthemimeral
οὖλά θ᾽ὑποστύφει χολόεν ποτόν, ἀμφὶ δὲ πρώτοις	-u u--- uu- uu -u u --	dactylic hexameter	masculine penthemimeral, hepthemimeral
εἰλύεται στέρνοισι κακῇ ἀλάλυγγι βαρῦνον	-uu- --u u- uu-u u--	dactylic hexameter	feminine penthemimeral, hepthemimeral, trithemimeral
φῶτ᾽ ἐπικαρδιόωντα: δύῃ δ᾽ἐπιδάκνεται ἄκρον	- uu-uu-u u- uu-uu --	dactylic hexameter	feminine penthemimeral, hepthemimeral
νειαίρης, ἄκλειστον ἀειρόμενον στόμα γαστρός,	--- --u u-uu- uu --	dactylic hexameter	feminine penthemimeral, trithemimeral
τεύχεος ἣν κραδίην ἐπιδορπίου οἱ δὲ δοχαίην	-uu - uu- uu-uu - u u--	dactylic hexameter	masculine penthemimeral, trithemimeral
κλείουσι στομάχοιο, πύλη δ᾽ἐπικέκλιται ἀρχαῖς	--- uu-u u- uu-uu --	dactylic hexameter	feminine penthemimeral, hepthemimeral, trithemimeral
πρῶτα κόλων ὅθι πᾶσα βροτῶν ἅλις ἐμφέρεται δαίς.	-u u- uu -u u- uu -uu- -	dactylic hexameter	feminine penthemimeral, hepthemimeral, trithemimeral
αἰεὶ δ᾽ἐκ φαέων νοτέων ὑπολείβεται ἱδρώς,	-- - uu- uu- uu-uu --	dactylic hexameter	masculine penthemimeral, hepthemimeral, trithemimeral
ἡ δὲ κυκαομένη τὰ μὲν ἔβρασεν ἤλιθα νηδύς	- u u-uu- u u -uu -uu --	dactylic hexameter	masculine penthemimeral
πνεύματα, πολλὰ δ᾽ἔνερθε κατὰ μέσον ὀμφαλὸν ἵζει:	-uu -u u-u u- uu -uu --	dactylic hexameter	feminine penthemimeral, hepthemimeral
κράατι δ᾽ἐν βάρος ἐχθρόν, ὑπὸ κροτάφοισι δὲ παλμός	-uu - uu -u u- uu-u u --	dactylic hexameter	feminine penthemimeral, hepthemimeral, trithemimeral
πυκνὸς ἐπεμφέρεται, τὰ δὲ διπλόα δέρκεται ὄσσοις	-u u-uu- u u -uu -uu --	dactylic hexameter	masculine penthemimeral
οἷα χαλικραίῃ νύχιος δεδαμασμένος οἴνῃ.	-u u--- uu- uu-uu --	dactylic hexameter	masculine penthemimeral, hepthemimeral
ὡς δ᾽ὁπότ᾽ ἀγριόεσσαν ὑποθλίψαντες ὀπώρην	- uu -uu-u u---u u--	dactylic hexameter	feminine penthemimeral
Σιληνοὶ κεραοῖο Διωνύσοιο τιθηνοί	--- uu-u u---u u--	dactylic hexameter	feminine penthemimeral, trithemimeral
πρῶτον ἐπαφρίζοντι ποτῷ φρένα θωρηχθέντες	-u u---u u- uu ----	dactylic hexameter	feminine penthemimeral, hepthemimeral
ὄθμασι δινήθησαν ἐπισφαλεροῖσι δὲ κώλοις	-uu ---u u-uu-u u --	dactylic hexameter	feminine penthemimeral
Νυσαίην ἀνὰ κλιτὺν ἐπέδραμον ἀφραίνοντες,	--- uu -u u-uu ----	dactylic hexameter	feminine penthemimeral, trithemimeral
ὣς οἵγε σκοτόωσι κακῇ βεβαρηότες ἄτῃ.	- -- uu-u u- uu-uu --	dactylic hexameter	feminine penthemimeral, hepthemimeral, trithemimeral
τὴν μέν τε κλείουσι μυοκτόνον, ἦ γὰρ ἀνιγρούς	- - - --u u-uu - u u--	dactylic hexameter	feminine penthemimeral, trithemimeral
παμπήδην ὕρακας λιχμήμονας ἠρήμωσεν:	--- uu- --uu ----	dactylic hexameter	masculine penthemimeral, trithemimeral
οἱ δέ τε παρδαλιαγχές, ἐπεὶ θήρεσσι πελώροις	- u u -uu-u u- --u u--	dactylic hexameter	feminine penthemimeral, hepthemimeral
πότμον βουπελάται τε καὶ αἰγινομῆες ἔθεντο	-- -uu- u u -uu-u u--	dactylic hexameter	masculine penthemimeral
Ἴδης ἐν νεμέεσσι Φαλακραίῃ ἐνὶ βήσσῃ,	-- - uu-u u--- uu --	dactylic hexameter	feminine penthemimeral, trithemimeral
πολλάκι θηλυφόνον καὶ κάμμαρον: ἐν δ᾽Ἀκοναίοις	-uu -uu- - -uu - uu--	dactylic hexameter	masculine penthemimeral
δηλήειν ἀκόνιτον ἐνεβλάστησεν ὀρόγκοις.	--- uu-u u---u u--	dactylic hexameter	feminine penthemimeral, trithemimeral
τῷ καί που τιτάνοιο χερὸς βάρος ἔσσεται ἄρκος	- - - uu-u u- uu -uu --	dactylic hexameter	feminine penthemimeral, hepthemimeral, trithemimeral
πιμπλαμένης ὅτε νέκταρ ἐύτριβι κιρρὸν ἀφύσσῃς	-uu- uu -u u-uu -u u--	dactylic hexameter	feminine penthemimeral, trithemimeral
μετρήδηνκοτύλη δὲ πέλοι καταμέστιος οἴνης	---uu- u u- uu-uu --	dactylic hexameter	masculine penthemimeral, hepthemimeral
σὺν δὲ καὶ ἁβροτόνοιο ταμὼν ἄπο καυλέα θάμνου	- u u -uu-u u- uu -uu --	dactylic hexameter	feminine penthemimeral, hepthemimeral
ἢ χλοεροῦ πρασίοιο τὸ δὴ μελίφυλλον ὑδεῦσι:	- uu- uu-u u - uu-u u--	dactylic hexameter	feminine penthemimeral, hepthemimeral, trithemimeral
καί τε σὺ ποιήεντος ἀειθαλέος χαμελαίης	- u u ---u u-uu- uu--	dactylic hexameter	feminine penthemimeral
βλάστην πηγάνιόν τε πόροις, ἐν βάμματι σίμβλων	-- -uu- u u- - -uu --	dactylic hexameter	masculine penthemimeral, hepthemimeral
σβεννὺς αἰθαλόεντα μύδρον γενύεσσι πυράγρης,	-- -uu-u u- uu-u u--	dactylic hexameter	feminine penthemimeral, hepthemimeral
ἠὲ σιδηρήεσσαν ἄπο τρύγα τήν τε καμίνων	-u u---u u- uu - u u--	dactylic hexameter	feminine penthemimeral, hepthemimeral
ἔντοσθεν χοάνοιο διχῆ πυρὸς ἤλασε λιγνύς:	--- uu-u u- uu -uu --	dactylic hexameter	feminine penthemimeral, hepthemimeral, trithemimeral
ἄλλοτε δὲ χρυσοῖο νέον βάρος ἐν πυρὶ θάλψας	-uu - --u u- uu - uu --	dactylic hexameter	feminine penthemimeral, hepthemimeral, trithemimeral
ἠὲ καὶ ἀργυρόεν θολερῷ ἐνὶ πώματι βάπτοις.	-u u -uu- uu- uu -uu --	dactylic hexameter	masculine penthemimeral, hepthemimeral
πολλάκι δ᾽ἡμιδαὲς χειρὸς βάρος αἴνυσο θρίων	-uu -uu- -- uu -uu --	dactylic hexameter	masculine penthemimeral, hepthemimeral
παῦρα χαμαιπίτυος, τότ᾽ ὀνίτιδος αὖον ὀρείης	-u u-uu- u u-uu -u u--	dactylic hexameter	masculine penthemimeral
ἠὲ νέον ῥάδικα πολυκνήμοιο κολούσας,	-u u- uu- ----u u--	dactylic hexameter	masculine penthemimeral, trithemimeral
τέτρασιν ἐν κυάθοισι χαδεῖν μελιανθέος οἴνης:	-uu - uu-u u- uu-uu --	dactylic hexameter	feminine penthemimeral, hepthemimeral, trithemimeral
ἢ ἔτι μυελόεντα χαλικρότερον ποτὸν ἴσχοις	- uu -uu-u u-uu- uu --	dactylic hexameter	feminine penthemimeral
ὄρνιθος στρουθοῖο κατοικάδος εὖθ᾽ ὑπὸ χύτρῳ	--- --u u-uu - uu --	dactylic hexameter	feminine penthemimeral, trithemimeral
γυῖα καταθρύπτῃσι βιαζομένη πυρὸς αὐγή:	-u u---u u-uu- uu --	dactylic hexameter	feminine penthemimeral
καί τε βοὸς νέα γέντα περιφλίοντος ἀλοιφῇ	- u u- uu -u u---u u--	dactylic hexameter	feminine penthemimeral, trithemimeral
τηξάμενος κορέσαιο ποτῷ εὐχανδέα νηδύν.	-uu- uu-u u- --uu --	dactylic hexameter	feminine penthemimeral, hepthemimeral, trithemimeral
ναὶ μὴν βαλσάμοιο τότ᾽ ἐν σταγόνεσσι γάλακτος	- - ---u u - uu-u u--	dactylic hexameter	feminine penthemimeral, hepthemimeral
θηλυτέρης πώλοιο χέαις ὀπόν, ἄλλοτε νύμφαις,	-uu- --u u- uu -uu --	dactylic hexameter	feminine penthemimeral, hepthemimeral, trithemimeral
ἔστ᾽ ἂν ὑπὲκ φάρυγος χεύῃ παναεργέα δόρπον.	- u u- uu- -- uu-uu --	dactylic hexameter	masculine penthemimeral, hepthemimeral, trithemimeral
πολλάκι δ᾽ἢ σκίνακος δερκευνέος ἢ ἀπὸ νεβροῦ	-uu - uu- --uu - uu --	dactylic hexameter	masculine penthemimeral, trithemimeral
πυετίην τμήξαιο πόροις δ᾽ἐν νέκταρι φύρσας:	-uu- --u u- - -uu --	dactylic hexameter	feminine penthemimeral, hepthemimeral, trithemimeral
ἄλλοτε καὶ μορέης ἄπο ῥίζεα φοινηέσσης	-uu - uu- uu -uu ----	dactylic hexameter	masculine penthemimeral, trithemimeral
ὅλμου ἐνὶ στύπεϊ προβαλὼν καὶ ὁμήρεα κόψας	-u u- uu- uu- u u-uu --	dactylic hexameter	masculine penthemimeral, hepthemimeral, trithemimeral
οἴνῳ, ἐνεψηθέντα πόροις καμάτοισι μελίσσης:	-u u---u u- uu-u u--	dactylic hexameter	feminine penthemimeral, hepthemimeral
καί κεν ἐπικρατέουσαν ἀπεχθέα νοῦσον ἀλάλκοις	- u u-uu-u u-uu -u u--	dactylic hexameter	feminine penthemimeral
φωτός, ὁ δ᾽ἀσφαλέεσσι πάλιν μετὰ ποσσὶν ὁδεύοι.	-u u -uu-u u- uu -u u--	dactylic hexameter	feminine penthemimeral, hepthemimeral
Δεύτερα δ᾽αἰγλήεντος ἐπιφράζευ πόσιν ἐχθρήν	-uu ---u u--- uu --	dactylic hexameter	feminine penthemimeral
κιρναμένην ὀλοοῦ ψιμυθίου ἥ τε γάλακτι	-uu- uu- uu-- - u u--	dactylic hexameter	masculine penthemimeral, trithemimeral
πάντοθεν ἀφρίζοντι νέην εἰδήνατο χροιήν	-uu ---u u- --uu --	dactylic hexameter	feminine penthemimeral, hepthemimeral
πελλίσιν ἐν γρώνῃσιν ὅτ᾽ εἴαρι πῖον ἀμέλξαις.	-uu - --u u -uu -u u--	dactylic hexameter	feminine penthemimeral, trithemimeral
τοῦ μὲν ὑπὲρ γένυάς τε καὶ ᾗ ῥυσαίνεται οὖλα	- u u- uu- u u - --uu --	dactylic hexameter	masculine penthemimeral, hepthemimeral, trithemimeral
ἀφρὸς ἐπιστύφων ἐμπλάσσεται, ἀμφὶ καὶ ὁλκός	-u u--- --uu -u u --	dactylic hexameter	masculine penthemimeral
τέτρηχε γλώσσης, νέατος δ᾽ὑποκάρφεται ἰσθμός,	--- -- uu- uu-uu --	dactylic hexameter	masculine penthemimeral, hepthemimeral, trithemimeral
ξηρὰ δ᾽ἐπιλλύζων ὀλοῇ χελλύσσεται ἄτῃ,	-u u--- uu- --uu --	dactylic hexameter	masculine penthemimeral, hepthemimeral
ἀβλεμὲς ἦ γὰρ κεῖνο πέλει βάρος: αὐτὰρ ὁ θυμῷ	-uu - - -u u- uu -u u --	dactylic hexameter	feminine penthemimeral, hepthemimeral, trithemimeral
ναυσιόεις ὀλοοῖσιν ὑποτρύει καμάτοισι:	-uu- uu-u u--- uu--	dactylic hexameter	feminine penthemimeral, trithemimeral
πολλάκι δ᾽ἐν φαέεσσιν ἄλην ἑτερειδέα λεύσσων	-uu - uu-u u- uu-uu --	dactylic hexameter	feminine penthemimeral, hepthemimeral, trithemimeral
ἄλλοτε δ᾽ὑπναλέος ψύχει δέμας, οὐδ᾽ ἔτι γυῖα	-uu -uu- -- uu - uu --	dactylic hexameter	masculine penthemimeral, hepthemimeral
ὡς τὸ πάρος δονέει, καμάτῳ δ᾽ὑποδάμναται εἴκων.	- u u- uu- uu- uu-uu --	dactylic hexameter	masculine penthemimeral, hepthemimeral, trithemimeral
τῷ καὶ πρημαδίης ἢ ὀρχάδος εἶαρ ἐλαίης	- - -uu- - -uu -u u--	dactylic hexameter	masculine penthemimeral
ἢ ἔτι μυρτίνης σχεδίην δεπάεσσιν ὀρέξαις	- uu --- uu- uu-u u--	dactylic hexameter	masculine penthemimeral, hepthemimeral
ὄφρ᾽ ἂν ὀλισθήνασα χέῃ κακὰ φάρμακα νηδύς:	- u u---u u- uu -uu --	dactylic hexameter	feminine penthemimeral, hepthemimeral
ἠὲ σύ γ᾽οὐθατόεντα διοιδέα μαζὸν ἀμέλξας	-u u -uu-u u-uu -u u--	dactylic hexameter	feminine penthemimeral
ῥεῖα πόροις, φιαρὴν δὲ ποτοῦ ἀποαίνυσο γρῆυν.	-u u- uu- u u- uu-uu --	dactylic hexameter	masculine penthemimeral, hepthemimeral, trithemimeral
καί τε σύ γ᾽ἢ μαλάχης ῥαδάμους ἢ φυλλάδα τήξας	- u u - uu- uu- - -uu --	dactylic hexameter	masculine penthemimeral, hepthemimeral, trithemimeral
χυλῷ ἔνι κλώθοντι κακηπελέοντα κορέσσαις.	-u u- --u u-uu-u u--	dactylic hexameter	feminine penthemimeral, trithemimeral
πολλάκι σήσαμα κόπτε, πόροις δ᾽ἐν νέκταρι καὶ τά:	-uu -uu -u u- - -uu - -	dactylic hexameter	feminine penthemimeral, hepthemimeral
ἠὲ σὺ κληματόεσσαν ἐν ὕδατι πλύνεο τέφρην	-u u -uu-u u -uu -uu --	dactylic hexameter	feminine penthemimeral
θαλπομένην, τὸ δὲ ῥύμμα νεοπλεκέος καλάθοιο	-uu- u u -u u-uu- uu--	dactylic hexameter	feminine penthemimeral, trithemimeral
κόλποις ἰκμήνειας, ὁ γάρ τ᾽ἀναδέξεται ἰλύν.	-- ---u u - uu-uu --	dactylic hexameter	feminine penthemimeral, hepthemimeral
καί τε κατατριφθέντα μετ᾽ ἀργήεντος ἐλαίου	- u u---u u ---u u--	dactylic hexameter	feminine penthemimeral
σκλήρ᾽ ἀπὸ περσείης κάρυα βλάβος οὖλον ἐρύξει,	- uu --- uu- uu -u u--	dactylic hexameter	masculine penthemimeral, hepthemimeral
Περσεὺς ἥν ποτε ποσσὶ λιπὼν Κηφηίδα γαῖαν,	-- - uu -u u- --uu --	dactylic hexameter	feminine penthemimeral, hepthemimeral, trithemimeral
αὐχέν᾽ ἀποτμήξας ἅρπῃ γονόεντα Μεδούσης,	-u u--- -- uu-u u--	dactylic hexameter	masculine penthemimeral, hepthemimeral
ῥεῖα Μυκηναίῃσιν ἐνηέξησεν ἀρούραις,	-u u---u u---u u--	dactylic hexameter	feminine penthemimeral
Κηφῆος νέα δῶρα, μύκης ὅθι κάππεσεν ἅρπης,	--- uu -u u- uu -uu --	dactylic hexameter	feminine penthemimeral, hepthemimeral, trithemimeral
ἄκρον ὑπὸ πρηῶνα Μελανθίδος ἔνθα τε Νύμφη	-u u- --u u-uu -u u --	dactylic hexameter	feminine penthemimeral, trithemimeral
Λαγγείης πόμα κεῖνο Διὸς τεκμήρατο παιδί.	--- uu -u u- --uu --	dactylic hexameter	feminine penthemimeral, hepthemimeral, trithemimeral
πολλάκι δ᾽ἐνθρύψειας ἐν ὀπταλέῃσιν ἀκοσταῖς	-uu ---u u -uu-u u--	dactylic hexameter	feminine penthemimeral
Γερραίης λιβάνοιο χύσιν περιπηγέα θάμνοις:	--- uu-u u- uu-uu --	dactylic hexameter	feminine penthemimeral, hepthemimeral, trithemimeral
καί τε σύ γ᾽ἢ καρύης ἄπο δάκρυον ἢ ἀταλύμνου,	- u u - uu- uu -uu - uu--	dactylic hexameter	masculine penthemimeral, trithemimeral
ἢ πτελέης ὅ τε πολλὸν ἀεὶ καταλείβεται ὄσχαις,	- uu- u u -u u- uu-uu --	dactylic hexameter	feminine penthemimeral, hepthemimeral, trithemimeral
κόμμινά τε χλιόεντι ποτῷ ἐπαρωγέα τήξαις,	-uu - uu-u u- uu-uu --	dactylic hexameter	feminine penthemimeral, hepthemimeral, trithemimeral
ὄφρα τὰ μέν τ᾽ἐρύγῃσι τὰ δ᾽ἑψητοῖσι δαμασθείς	-u u - uu-u u ---u u--	dactylic hexameter	feminine penthemimeral, trithemimeral
ἀλθήσῃ ὑδάτεσσιν ὅτ᾽ ἰκμήνῃ δέμας ἱδρώς.	--- uu-u u --- uu --	dactylic hexameter	feminine penthemimeral, trithemimeral
καί κεν ὅγ᾽ ἄλλοτε δόρπα δεδεγμένος ἄλλοτε δ᾽οἴνης	- u u -uu -u u-uu -uu --	dactylic hexameter	feminine penthemimeral
πιοτέρης κορέοιτο, καὶ ἀκλέα πότμον ἀλύξαι.	-uu- uu-u u -uu -u u--	dactylic hexameter	feminine penthemimeral, trithemimeral
Μὴ μὲν κανθαρίδος σιτηβόρου εὖτ᾽ ἂν ὀδώδῃ	- - -uu- --uu - u u--	dactylic hexameter	masculine penthemimeral
κεῖνο ποτὸν δέξαιο χυτῇ ἐναλίγκια πίσσῃ:	-u u- --u u- uu-uu --	dactylic hexameter	feminine penthemimeral, hepthemimeral, trithemimeral
πίσσης γὰρ ῥώθωσιν ἄγει βάρος, ἐν δὲ χαλινοῖς	-- - --u u- uu - u u--	dactylic hexameter	feminine penthemimeral, hepthemimeral, trithemimeral
οἷά τε δὴ καρφεῖα νέον βεβρωμένα κέδρου.	-u u - --u u- --uu --	dactylic hexameter	feminine penthemimeral, hepthemimeral, trithemimeral
αἱ δ᾽ὁτὲ μὲν πλαδόωντι ποτῷ ἐπὶ χείλεσι δηχμόν	- uu - uu-u u- uu -uu --	dactylic hexameter	feminine penthemimeral, hepthemimeral, trithemimeral
τεύχουσιν τοτὲ δ᾽αὖτε περὶ στόμα νείατα γαστρός:	--- uu -u u- uu -uu --	dactylic hexameter	feminine penthemimeral, hepthemimeral, trithemimeral
ἄλλοτε καὶ μεσάτη ἐπιδάκνεται ἄλγεσι νηδύς	-uu - uu- uu-uu -uu --	dactylic hexameter	masculine penthemimeral, trithemimeral
ἢ κύστις βρωθεῖσα: περιψαύουσι δ᾽ἀνῖαι	- -- --u u---u u--	dactylic hexameter	feminine penthemimeral, trithemimeral
θώρηκος τόθι χόνδρος ὑπὲρ κύτος ἕζετο γαστρός:	--- uu -u u- uu -uu --	dactylic hexameter	feminine penthemimeral, hepthemimeral, trithemimeral
αὐτοὶ δ᾽ἀσχαλόωσιν, ἄλη δέ φιν ἤθεα φωτός	-- -uu-u u- u u -uu --	dactylic hexameter	feminine penthemimeral, hepthemimeral
ἄψυχος πεδάει, ὁ δ᾽ἀελπέα δάμναται ἄταις,	--- uu- u u-uu -uu --	dactylic hexameter	masculine penthemimeral, trithemimeral
οἷά τε δὴ γήρεια νέον τεθρυμμένα κάκτου	-u u - --u u- --uu --	dactylic hexameter	feminine penthemimeral, hepthemimeral, trithemimeral
ἠέρ᾽ ἐπιπλάζοντα διαψαίρουσι πνοῇσι.	-u u---u u---u u--	dactylic hexameter	feminine penthemimeral
τῷ δὲ σὺ πολλάκι μὲν γληχὼ ποταμηίσι νύμφαις	- u u -uu - -- uu-uu --	dactylic hexameter	masculine penthemimeral, hepthemimeral
ἐμπλήδην κυκεῶνα πόροις ἐν κύμβεϊ τεύξας,	--- uu-u u- - -uu --	dactylic hexameter	feminine penthemimeral, hepthemimeral, trithemimeral
νηστείρης Δηοῦς μορόεν ποτὸν ᾧ ποτε Δηώ	--- -- uu- uu - uu --	dactylic hexameter	masculine penthemimeral, hepthemimeral, trithemimeral
λαυκανίην ἔβρεξεν ἀν᾽ ἄστυρον Ἱπποθόωντος	-uu- --u u -uu -uu--	dactylic hexameter	feminine penthemimeral, trithemimeral
Θρηίσσης ἀθύροισιν ὑπὸ ῥήτρῃσιν Ἰάμβης.	--- uu-u u- --u u--	dactylic hexameter	feminine penthemimeral, hepthemimeral, trithemimeral
δήποτε δ᾽ἢ σιάλοιο καρήατος ἠὲ καὶ ἀμνοῦ	-uu - uu-u u-uu -u u --	dactylic hexameter	feminine penthemimeral, trithemimeral
ἀμμίγδην σπεράδεσσιν ἐυτροχάλοισι λίνοιο,	--- uu-u u-uu-u u--	dactylic hexameter	feminine penthemimeral, trithemimeral
ἠὲ νέον κορσεῖα ταμὼν κερόεντα χιμαίρης,	-u u- --u u- uu-u u--	dactylic hexameter	feminine penthemimeral, hepthemimeral, trithemimeral
ἢ ἔτι που χηνὸς μορόεν ποτὸν αἴνυσο χύτρου,	- uu - -- uu- uu -uu --	dactylic hexameter	masculine penthemimeral, hepthemimeral, trithemimeral
ἐς δ᾽ἔμετον κορέσαιο, τὰ δ᾽ἀθρόα νειόθι βράσσοι	- uu- uu-u u -uu -uu --	dactylic hexameter	feminine penthemimeral, trithemimeral
ἐμματέων ἔτ᾽ ἄπεπτα πύλῃ μεμιασμένα δόρπα.	-uu- u u-u u- uu-uu --	dactylic hexameter	feminine penthemimeral, hepthemimeral, trithemimeral
πολλάκι δ᾽ἐν κλυστῆρι νέον γλάγος οἰὸς ἀμέλξας	-uu - --u u- uu -u u--	dactylic hexameter	feminine penthemimeral, hepthemimeral, trithemimeral
κλύζε, τὰ δ᾽ἤλιθα γαστρὸς ἀφόρδια κεινώσειας:	-u u -uu -u u-uu ----	dactylic hexameter	feminine penthemimeral
ἄλλοτ᾽ ἀλυσθαίνοντι ποθὲν γάλα πῖον ἀρήξει:	-u u---u u- uu -u u--	dactylic hexameter	feminine penthemimeral, hepthemimeral
ἠὲ σύ γ᾽ἀμπελόεντα γλυκεῖ ἔνι καυλέα κόψαις	-u u -uu-u u- uu -uu --	dactylic hexameter	feminine penthemimeral, hepthemimeral
χλωρά, νέον πετάλοισι περιβρίθοντα κολούσας:	-u u- uu-u u---u u--	dactylic hexameter	feminine penthemimeral, trithemimeral
ἠὲ μελισσάων καμάτῳ ἔνι παῦρα μορύξαις	-u u--- uu- uu -u u--	dactylic hexameter	masculine penthemimeral, hepthemimeral
σκορπιόεντα χαδὼν ψαθυρῆς ἐκ ῥίζεα γαίης	-uu-u u- uu- - -uu --	dactylic hexameter	masculine penthemimeral, hepthemimeral
αἰὲν κεντρήεντα: πόη γε μὲν ὕψι τέθηλεν	-- ---u u- u u -u u--	dactylic hexameter	feminine penthemimeral, hepthemimeral
οἵη περ μολόθουρος, ἔνισχνα δὲ καυλέα βάλλει.	-- - uu-u u-u u -uu --	dactylic hexameter	feminine penthemimeral, trithemimeral
καί τε σὺ δραχμάων πισύρων βάρος αἴνυσο γαίης	- u u --- uu- uu -uu --	dactylic hexameter	masculine penthemimeral, hepthemimeral
Παρθενίης τὴν Φυλλὶς ὑπὸ κνημοῖσιν ἀνῆκεν,	-uu- - -u u- --u u--	dactylic hexameter	feminine penthemimeral, hepthemimeral, trithemimeral
Ἰμβρασίδος γαίης χιονώδεος ἥν τε κεράστης	-uu- -- uu-uu - u u--	dactylic hexameter	masculine penthemimeral, trithemimeral
ἀμνὸς Χησιάδεσσι νέον σημήνατο Νύμφαις	-- -uu-u u- --uu --	dactylic hexameter	feminine penthemimeral, hepthemimeral
Κερκέτεω νιφόεντος ὑπὸ σχοινώδεσιν ὄχθαις:	-uu- uu-u u- --uu --	dactylic hexameter	feminine penthemimeral, hepthemimeral, trithemimeral
ἢ καὶ σειραίοιο πόσιν διπλήθεα τεύξαις,	- - ---u u- --uu --	dactylic hexameter	feminine penthemimeral, hepthemimeral
σὺν δέ τε πηγανόεντας ἐνιθρύψειας ὀράμνους	- u u -uu-u u---u u--	dactylic hexameter	feminine penthemimeral
ὀργάζων λίπεϊ ῥοδέῳ θρόνα: πολλάκι χραίνοις	--- uu- uu- uu -uu --	dactylic hexameter	masculine penthemimeral, hepthemimeral, trithemimeral
ἰρινέῳ τό τε πολλὸν ἐπαλθέα νοῦσον ἔτευξεν.	-uu- u u -u u-uu -u u--	dactylic hexameter	feminine penthemimeral, trithemimeral
Ἤν γε μὲν οὐλόμενόν γε ποτὸν κορίοιο δυσαλθές	- u u -uu- u u- uu-u u--	dactylic hexameter	masculine penthemimeral, hepthemimeral
ἀφραδέως δεπάεσσιν ἀπεχθομένοισι πάσηται,	-uu- uu-u u-uu-u u--	dactylic hexameter	feminine penthemimeral, trithemimeral
οἱ μέν τ᾽ἀφροσύνῃ ἐμπληγέες οἷά τε μάργοι	- - -uu- --uu -u u --	dactylic hexameter	masculine penthemimeral
δήμια λαβράζουσι παραπλῆγές θ᾽ἅτε Βάκχαι	-uu ---u u--- uu --	dactylic hexameter	feminine penthemimeral
ὀξὺ μέλος βοόωσιν ἀταρμύκτῳ φρενὸς οἴστρῳ.	-u u- uu-u u--- uu --	dactylic hexameter	feminine penthemimeral, trithemimeral
τῷ μέν τ᾽ἐξ ἑδανοῖο πόροις δέπας ἔμπλεον οἴνης,	- - - uu-u u- uu -uu --	dactylic hexameter	feminine penthemimeral, hepthemimeral, trithemimeral
Πράμνιον αὐτοκρηές, ὅπως ὑπετύψατο ληνοῦ,	-uu ---u u- uu-uu --	dactylic hexameter	feminine penthemimeral, hepthemimeral
ἢ νύμφαις τήξαιο βαλὼν ἁλὸς ἔμπλεα κύμβην,	- -- --u u- uu -uu --	dactylic hexameter	feminine penthemimeral, hepthemimeral, trithemimeral
πολλάκι δ᾽ὀρταλίχων ἁπαλὴν ὠδῖνα κενώσας	-uu -uu- uu- --u u--	dactylic hexameter	masculine penthemimeral, hepthemimeral
ἀφρὸν ἐπεγκεράσαιο, θοοῦ δορπήια κέπφου:	-u u-uu-u u- --uu --	dactylic hexameter	feminine penthemimeral, hepthemimeral
τῷ γὰρ δὴ ζωήν τε σαοῖ, καὶ πότμον ἐπισπεῖ	- - - -- u u- - -u u--	dactylic hexameter	masculine penthemimeral, hepthemimeral, trithemimeral
εὖτε δόλοις νήχοντα κακοφθόρα τέκν᾽ ἁλιήων	-u u- --u u-uu - uu--	dactylic hexameter	feminine penthemimeral, trithemimeral
οἰωνὸν χραίνωσιν, ὁ δ᾽ἐς χέρας ἔμπεσε παίδων	--- --u u - uu -uu --	dactylic hexameter	feminine penthemimeral, hepthemimeral, trithemimeral
θηρεύων ἀφροῖο νέην κλύδα λευκαίνουσαν.	--- --u u- uu ----	dactylic hexameter	feminine penthemimeral, hepthemimeral, trithemimeral
καί τε σύ γ᾽ἀγλεύκην βάψαις ἰόεντα θάλασσαν,	- u u --- -- uu-u u--	dactylic hexameter	masculine penthemimeral, hepthemimeral
ἥν τε καὶ ἀτμεύειν ἀνέμοις πόρεν Ἐννοσίγαιος	- u u --- uu- uu -uu--	dactylic hexameter	masculine penthemimeral, hepthemimeral
σὺν πυρί: καὶ γὰρ δὴ τὸ πνοαῖς συνδάμναται ἐχθραῖς.	- uu - - - u u- --uu --	dactylic hexameter	masculine penthemimeral, hepthemimeral, trithemimeral
πῦρ μὲν ἀείζωον καὶ ἀχύνετον ἔτρεσεν ὕδωρ	- u u--- u u-uu -uu --	dactylic hexameter	masculine penthemimeral
ἀργέστας: καί ῥ᾽ἡ μὲν ἀκοσμήεσσα φιλοργής	--- - - u u---u u--	dactylic hexameter	masculine penthemimeral, trithemimeral
δεσπόζει νηῶν τε καὶ ἐμφθορέων αἰζηῶν,	--- -- u u -uu- ---	dactylic hexameter	masculine penthemimeral, trithemimeral
ὕλη δ᾽ἐχθομένοιο πυρὸς κατὰ θεσμὸν ἀκούει.	-- -uu-u u- uu -u u--	dactylic hexameter	feminine penthemimeral, hepthemimeral
ναὶ μὴν ἀτμένιόν τε κεραιόμενον λίπος οἴνῃ	- - -uu- u u-uu- uu --	dactylic hexameter	masculine penthemimeral
ἢ χιόνι γλυκέος μίγδην πόσις ἄλγος ἐρύξει,	- uu- uu- -- uu -u u--	dactylic hexameter	masculine penthemimeral, hepthemimeral, trithemimeral
ἦμος ὑπὸ ζάγκλῃσι περιβρίθουσαν ὀπώρην	-u u- --u u---u u--	dactylic hexameter	feminine penthemimeral, trithemimeral
ῥυσαλέην ἑδανοῖο καὶ ἐκ ψιθίης ἑλίνοιο	-uu- uu-u u - uu- uu--	dactylic hexameter	feminine penthemimeral, hepthemimeral, trithemimeral
κείροντες θλίβωσιν, ὅτε ῥοιζηδὰ μέλισσαι,	--- --u u- --u u--	dactylic hexameter	feminine penthemimeral, hepthemimeral, trithemimeral
πεμφρηδών, σφῆκές τε καὶ ἐκ βέμβικες ὄρειαι	--- -- u u - --u u--	dactylic hexameter	masculine penthemimeral, hepthemimeral, trithemimeral
γλεῦκος ἅλις δαίνυνται ἐπὶ ῥαγέεσσι πεσοῦσαι,	-u u- --u u- uu-u u--	dactylic hexameter	feminine penthemimeral, hepthemimeral, trithemimeral
πιοτέρην ὅτε βότρυν ἐσίνατο κηκὰς ἀλώπηξ.	-uu- uu -u u-uu -u u--	dactylic hexameter	feminine penthemimeral, trithemimeral
Καί τε σὺ κωνείου βλαβόεν τεκμαίρεο πῶμα:	- u u --- uu- --uu --	dactylic hexameter	masculine penthemimeral, hepthemimeral
κεῖνο ποτὸν δὴ γάρ τε καρήατι φοινὸν ἰάπτει	-u u- - - u u-uu -u u--	dactylic hexameter	masculine penthemimeral, trithemimeral
νύκτα φέρον σκοτόεσσαν: ἐδίνησεν δὲ καὶ ὄσσε,	-u u- uu-u u--- u u --	dactylic hexameter	feminine penthemimeral, trithemimeral
ἴχνεσι δὲ σφαλεροί τε καὶ ἐμπλάζοντες ἀγυιαῖς	-uu - uu- u u ---u u--	dactylic hexameter	masculine penthemimeral, trithemimeral
χερσὶν ἐφερπύζουσι: κακὸς δ᾽ὑπὸ νείατα πνιχμός	-u u---u u- uu -uu --	dactylic hexameter	feminine penthemimeral, hepthemimeral
ἴσθμια καὶ φάρυγος στεινὴν ἐμφράσσεται οἶμον:	-uu - uu- -- --uu --	dactylic hexameter	masculine penthemimeral, hepthemimeral, trithemimeral
ἄκρα δέ τοι ψύχει, περὶ δὲ φλέβες ἔνδοθι γυίων	-u u - -- uu - uu -uu --	dactylic hexameter	masculine penthemimeral, hepthemimeral, trithemimeral
ῥωμαλέαι στέλλονται: ὁ δ᾽ἠέρα παῦρον ἀτύζει	-uu- --u u -uu -u u--	dactylic hexameter	feminine penthemimeral, trithemimeral
οἷα κατηβολέων, ψυχὴ δ᾽Ἀιδωνέα λεύσσει.	-u u-uu- -- uu-uu --	dactylic hexameter	masculine penthemimeral, hepthemimeral
τὸν μέν τ᾽ἢ λίπεος κορέοις ἢ ἀμισγέος οἴνης	- - - uu- uu- u u-uu --	dactylic hexameter	masculine penthemimeral, hepthemimeral, trithemimeral
ὄφρα κεν ἐξερύγῃσι κακὴν καὶ ἐπώδυνον ἄτην,	-u u -uu-u u- u u-uu --	dactylic hexameter	feminine penthemimeral, hepthemimeral
ἠὲ σύ γε κλυστῆρος ἐνεὶς ὁπλίζεο τεῦχος:	-u u - --u u- --uu --	dactylic hexameter	feminine penthemimeral, hepthemimeral, trithemimeral
πολλάκι δ᾽ἢ οἴνης ἀμιγῆ πόσιν, ἢ ἀπὸ δάφνης	-uu - -- uu- uu - uu --	dactylic hexameter	masculine penthemimeral, hepthemimeral, trithemimeral
Τεμπίδος ἢ δαυχμοῖο φέροις ἐκ καυλέα κόψας	-uu - --u u- - -uu --	dactylic hexameter	feminine penthemimeral, hepthemimeral, trithemimeral
ἣ πρώτη Φοίβοιο κατέστεφε Δελφίδα χαίτην,	- -- --u u-uu -uu --	dactylic hexameter	feminine penthemimeral, trithemimeral
ἢ πέπερι κνίδης τε μίγα σπερμεῖα λεήνας	- uu- -- u u- --u u--	dactylic hexameter	masculine penthemimeral, hepthemimeral, trithemimeral
νείμειας, τοτὲ νέκταρ ὀπῷ ἐμπευκέι χράνας:	--- uu -u u- --uu --	dactylic hexameter	feminine penthemimeral, hepthemimeral, trithemimeral
δήποτε δ᾽ἰρινέου θυέος μετρηδὸν ὀρέξαις	-uu -uu- uu- --u u--	dactylic hexameter	masculine penthemimeral, hepthemimeral
σίλφιά τ᾽ἐνθρυφθέντα μετ᾽ ἀργήεντος ἐλαίου:	-uu ---u u ---u u--	dactylic hexameter	feminine penthemimeral
ἐν δὲ μελιζώρου γλυκέος πόσιν, ἐν δὲ γάλακτος	- u u--- uu- uu - u u--	dactylic hexameter	masculine penthemimeral, hepthemimeral
ἀφριόεν νέμε τεῦχος ὑπὲρ πυρὸς ἠρέμα θάλψας.	-uu- uu -u u- uu -uu --	dactylic hexameter	feminine penthemimeral, hepthemimeral, trithemimeral
Καί κεν λοιγήεντι παρασχεδὸν ἄχθος ἀμύνοις	- - ---u u-uu -u u--	dactylic hexameter	feminine penthemimeral
τοξικῷ, εὖτ᾽ ἀχέεσσι βαρύνηται ποτῷ ἀνήρ.	-uu - uu-u u--- uu --	dactylic hexameter	feminine penthemimeral, trithemimeral
τοῦ καὶ ἔνερθε γλῶσσα παχύνεται, ἀμφὶ δὲ χείλη	- u u-- -u u-uu -u u --	dactylic hexameter	feminine penthemimeral
οἰδαλέα βρίθοντα περὶ στομάτεσσι βαρύνει,	-uu- --u u- uu-u u--	dactylic hexameter	feminine penthemimeral, hepthemimeral, trithemimeral
ξηρὰ δ᾽ἀναπτύει, νεόθεν δ᾽ἐκρήγνυται οὖλα:	-u u--- uu- --uu --	dactylic hexameter	masculine penthemimeral, hepthemimeral
πολλάκι δ᾽ἐς κραδίην πτοίην βάλε, πᾶν δὲ νόημα	-uu - uu- -- uu - u u--	dactylic hexameter	masculine penthemimeral, hepthemimeral, trithemimeral
ἔμπληκτον μεμόρηκε κακῇ ἐσφαλμένον ἄτῃ:	--- uu-u u- --uu --	dactylic hexameter	feminine penthemimeral, hepthemimeral, trithemimeral
αὐτὰρ ὁ μηκάζει μανίης ὕπο μυρία φλύζων,	-u u --- uu- uu -uu --	dactylic hexameter	masculine penthemimeral, hepthemimeral
δηθάκι δ᾽ἀχθόμενος βοάᾳ ἅ τις ἐμπελάδην φώς	-uu -uu- uu- u u -uu- -	dactylic hexameter	masculine penthemimeral, hepthemimeral
ἀμφιβρότην κώδειαν ἀπὸ ξιφέεσσιν ἀμηθείς,	-uu- --u u- uu-u u--	dactylic hexameter	feminine penthemimeral, hepthemimeral, trithemimeral
ἢ ἅτε κερνοφόρος ζάκορος βωμίστρια Ῥείης,	- uu -uu- uu- --uu --	dactylic hexameter	masculine penthemimeral, hepthemimeral
εἰνάδι λαοφόροισιν ἐνιχρίμπτουσα κελεύθοις,	-uu -uu-u u---u u--	dactylic hexameter	feminine penthemimeral
μακρὸν ἐπεμβοάᾳ γλώσσῃ θρόον, οἱ δὲ τρέουσιν	-u u-uu- -- uu - u u--	dactylic hexameter	masculine penthemimeral, hepthemimeral
Ἰδαίης ῥιγηλὸν ὅτ᾽ εἰσαΐωσιν ὑλαγμόν:	--- --u u -uu-u u--	dactylic hexameter	feminine penthemimeral, trithemimeral
ὣς ὁ νόου λύσσῃ ἐσφαλμένα βρυχανάαται	- u u- -- --uu -uu--	dactylic hexameter	masculine penthemimeral, trithemimeral
ὠρυδόν, λοξαῖς δὲ κόραις ταυρώδεα λεύσσων	--- -- u u- --uu --	dactylic hexameter	masculine penthemimeral, hepthemimeral, trithemimeral
θήγει λευκὸν ὀδόντα παραφρίζει δὲ χαλινοῖς.	-- -u u-u u--- u u--	dactylic hexameter	feminine penthemimeral
τὸν μὲν καὶ δεσμοῖσι πολυπλέκτοισι πιέξας	- - - --u u---u u--	dactylic hexameter	feminine penthemimeral, trithemimeral
νέκταρι θωρήξαιο, καὶ οὐ χατέοντα κορέσκων	-uu ---u u - uu-u u--	dactylic hexameter	feminine penthemimeral, hepthemimeral
ἦκα βιησάμενος: διὰ δὲ στόμα βρῦκον ὀχλίζοις	-u u-uu- uu - uu -u u--	dactylic hexameter	masculine penthemimeral, hepthemimeral
ὄφρ᾽ ἂν ὑπεξερύγῃσι δαμαζόμενος χερὶ λώβην:	- u u-uu-u u-uu- uu --	dactylic hexameter	feminine penthemimeral
ἠὲ σὺ βοσκαδίης χηνὸς νέον ὀρταλιχῆα	-u u -uu- -- uu -uu--	dactylic hexameter	masculine penthemimeral, hepthemimeral
ὕδασιν ἐντήξαιο πυρὸς μεμορημένον αὐγαῖς:	-uu ---u u- uu-uu --	dactylic hexameter	feminine penthemimeral, hepthemimeral
καί τε σὺ μηλείης ῥηχώδεος ἄγρια κάρφη	- u u --- --uu -uu --	dactylic hexameter	masculine penthemimeral
οὔρεσιν ἐνθρεφθέντα πόροις ἀπὸ σίνεα κόψας,	-uu ---u u- uu -uu --	dactylic hexameter	feminine penthemimeral, hepthemimeral
ἢ ἔτι καὶ κλήροισιν ἐπήβολα τοῖά περ ὧραι	- uu - --u u-uu -u u --	dactylic hexameter	feminine penthemimeral, trithemimeral
εἰαριναὶ φορέουσιν ἐνεψιήματα κούραις,	-uu- uu-u u---uu --	dactylic hexameter	feminine penthemimeral, trithemimeral
ἄλλοτε δὲ στρούθεια, τοτὲ βλοσυροῖο Κύδωνος	-uu - --u u- uu-u u--	dactylic hexameter	feminine penthemimeral, hepthemimeral, trithemimeral
κεῖνο φυτὸν Κρήτηθεν ὃ δή ῥ᾽ἐκόμισσαν ἄναυροι:	-u u- --u u - uu-u u--	dactylic hexameter	feminine penthemimeral, hepthemimeral, trithemimeral
πολλάκι δὴ σφύρῃσιν ἅλις ἐναολλέα κόψας	-uu - --u u- uu-uu --	dactylic hexameter	feminine penthemimeral, hepthemimeral, trithemimeral
ὕδασιν ἐμβρέξαιο, νέην δ᾽ὀσμήρεα γληχώ	-uu ---u u- --uu --	dactylic hexameter	feminine penthemimeral, hepthemimeral
σπέρμασι μηλείοισι βάλοις ἐνομήρεα φύρων:	-uu ---u u- uu-uu --	dactylic hexameter	feminine penthemimeral, hepthemimeral
καί τε σύ γε ῥοδέης θυόεν μαλλοῖσιν ἀφύσσων	- u u - uu- uu- --u u--	dactylic hexameter	masculine penthemimeral, hepthemimeral, trithemimeral
παῦρα λίπος στάξειας ἀνοιγομένοις στομάτεσσιν,	-u u- --u u-uu- uu--	dactylic hexameter	feminine penthemimeral, trithemimeral
ἠὲ καὶ ἰρινέοιο: μόλις δέ κε μυρί᾽ ἐπιτλάς	-u u -uu-u u- u u -u u--	dactylic hexameter	feminine penthemimeral, hepthemimeral
ἤμασιν ἐν πολέεσσιν ἀκροσφαλὲς ἴχνος ἰήλαι	-uu - uu-u u-uu -u u--	dactylic hexameter	feminine penthemimeral, trithemimeral
ἀσφαλέως πτοιητὸν ἔχων ἑτεροπλανὲς ὄθμα.	-uu- --u u- uu-uu --	dactylic hexameter	feminine penthemimeral, hepthemimeral, trithemimeral
τῷ μὲν Γερραῖοι νομάδες χαλκήρεας αἰχμάς	- - --- uu- --uu --	dactylic hexameter	masculine penthemimeral, hepthemimeral
οἵ τε παρ᾽ Εὐφρήταο ῥόον πολέοντες ἀρούρας	- u u ---u u- uu-u u--	dactylic hexameter	feminine penthemimeral, hepthemimeral
χραίνουσιν: τὰ δὲ πολλὸν ἀναλθέα τραύματα τεύχει	--- u u -u u-uu -uu --	dactylic hexameter	feminine penthemimeral, trithemimeral
σάρκα μελαινομένην, πικρὸς δ᾽ὑποβόσκεται Ὕδρης	-u u-uu- -- uu-uu --	dactylic hexameter	masculine penthemimeral, hepthemimeral
ἰός, σηπόμενον δὲ μύδῳ ἐκρήγνυται ἔρφος.	-- -uu- u u- --uu --	dactylic hexameter	masculine penthemimeral, hepthemimeral
Ἢν δὲ τὸ Μηδείης Κολχηίδος ἐχθόμενον πῦρ,	- u u --- --uu -uu- -	dactylic hexameter	masculine penthemimeral
κεῖνό τις ἐνδέξηται ἐφήμερον, οὗ περὶ χείλη	-u u ---u u-uu - uu --	dactylic hexameter	feminine penthemimeral
δευομένου δυσάλυκτος ἰάπτεται ἄμμιγα κνηθμός	-uu- uu-u u-uu -uu --	dactylic hexameter	feminine penthemimeral, trithemimeral
οἷά τ᾽ὀπῷ νιφόεντι κράδης ἢ τρηχέι κνίδῃ	-u u- uu-u u- - -uu --	dactylic hexameter	feminine penthemimeral, hepthemimeral, trithemimeral
χρῶτα μιαινομένοις ἢ καὶ σπειρώδεϊ κόρσῃ	-u u-uu- - - --uu --	dactylic hexameter	masculine penthemimeral, hepthemimeral
σκίλλης ἥ τ᾽ἔκπαγλα νέην φοινίξατο σάρκα.	-- - --u u- --uu --	dactylic hexameter	feminine penthemimeral, hepthemimeral, trithemimeral
τοῦ καὶ ἐπισχομένοιο περὶ στόμαχον βάρος ἵζει	- u u-uu-u u- uu- uu --	dactylic hexameter	feminine penthemimeral, hepthemimeral
πρῶτον ἐρεπτόμενον, μετέπειτα δὲ λοιγέι συρμῷ	-u u-uu- uu-u u -uu --	dactylic hexameter	masculine penthemimeral
ῥιζόθεν ἑλκωθέντα, κακὸν δ᾽ἀποήρυγε δειρῆς,	-uu ---u u- uu-uu --	dactylic hexameter	feminine penthemimeral, hepthemimeral
σὺν δέ τε καὶ νηδὺς μεμιασμένα λύματα βάλλει	- u u - -- uu-uu -uu --	dactylic hexameter	masculine penthemimeral, trithemimeral
ὡς εἴ τε κρεάων θολερὸν πλύμα χεύατο δαιτρός.	- - - uu- uu- uu -uu --	dactylic hexameter	masculine penthemimeral, hepthemimeral, trithemimeral
ἀλλὰ σὺ πολλάκι μὲν χαίτην δρυὸς οὐλάδα κόψας,	-u u -uu - -- uu -uu --	dactylic hexameter	masculine penthemimeral, hepthemimeral
πολλάκι καὶ φηγοῖο πόροις ἀκύλοισιν ὁμαρτῇ,	-uu - --u u- uu-u u--	dactylic hexameter	feminine penthemimeral, hepthemimeral, trithemimeral
ἠὲ σύ γε βδήλαιο νέον γλάγος ἔνδοθι πέλλης:	-u u - --u u- uu -uu --	dactylic hexameter	feminine penthemimeral, hepthemimeral, trithemimeral
αὐτὰρ ὁ τοῦ κορέοιτο καὶ ἐν στομάτεσσιν ἐρύξας.	-u u - uu-u u - uu-u u--	dactylic hexameter	feminine penthemimeral, hepthemimeral, trithemimeral
ἦ μὴν πουλυγόνοιο τοτὲ βλαστήματ᾽ ἀρήξει,	- - -uu-u u- --u u--	dactylic hexameter	feminine penthemimeral, hepthemimeral
ἄλλοτε δὴ ῥιζεῖα καθεψηθέντα γάλακτι.	-uu - --u u---u u--	dactylic hexameter	feminine penthemimeral, trithemimeral
σὺν δὲ καὶ ἀμπελόεις ἕλικας ἐνθρύπτεο νύμφαις,	- u u -uu- uu- --uu --	dactylic hexameter	masculine penthemimeral, hepthemimeral
ἴσως καὶ βατόεντα περὶ πτορθεῖα κολούσας.	-- - uu-u u- --u u--	dactylic hexameter	feminine penthemimeral, hepthemimeral, trithemimeral
καί τε σὺ γυμνώσειας ἐυτρεφέος νέα τέρφη	- u u ---u u-uu- uu --	dactylic hexameter	feminine penthemimeral
καστηνοῦ, καρύοιο λαχυφλοίοιο κάλυμμα,	--- uu-u u---u u--	dactylic hexameter	feminine penthemimeral, trithemimeral
νείαιραν τόθι σάρκα περὶ σκύλος αὖον ὀπάζει	--- uu -u u- uu -u u--	dactylic hexameter	feminine penthemimeral, hepthemimeral, trithemimeral
δυσλεπέος καρύοιο τὸ Καστανὶς ἔτρεφεν αἶα.	-uu- uu-u u -uu -uu --	dactylic hexameter	feminine penthemimeral, trithemimeral
ῥεῖα δὲ νάρθηκος νεάτην ἐξαίνυσο νηδύν	-u u --- uu- --uu --	dactylic hexameter	masculine penthemimeral, hepthemimeral
ὅς τε Προμηθείοιο κλοπὴν ἀνεδέξατο φωρῆς:	- u u---u u- uu-uu --	dactylic hexameter	feminine penthemimeral, hepthemimeral
σὺν δὲ καὶ ἑρπύλλοιο φιλοζώοιο πέτηλα	- u u ---u u---u u--	dactylic hexameter	feminine penthemimeral
εὐφίμου τ᾽ἀπὸ καρπὸν ἅλις καταβάλλεο μύρτου:	--- uu -u u- uu-uu --	dactylic hexameter	feminine penthemimeral, hepthemimeral, trithemimeral
ἢ καί που σιδόεντος ἀποβρέξαιο κάλυμμα	- - - uu-u u---u u--	dactylic hexameter	feminine penthemimeral, trithemimeral
καρπείου, μιγάδην δὲ βαλὼν ἐμπίσεο μήλοις	--- uu- u u- --uu --	dactylic hexameter	masculine penthemimeral, hepthemimeral, trithemimeral
ὄφρ᾽ ἂν ἐπῇ στῦφόν τι ποτῷ, νοῦσον δὲ κεδάσσεις.	- u u- -- u u- -- u u--	dactylic hexameter	masculine penthemimeral, hepthemimeral, trithemimeral
Ἰξιόεν δέ σε μή τι δόλῳ παρὰ χείλεσι πῶμα	-uu- u u - u u- uu -uu --	dactylic hexameter	masculine penthemimeral, hepthemimeral, trithemimeral
οὐλόμενον λήσειεν ὅ τ᾽ὠκιμοειδὲς ὄδωδε.	-uu- --u u -uu-u u--	dactylic hexameter	feminine penthemimeral, trithemimeral
τοῦ μὲν ὑπὸ γλώσσης νέατος τρηχύνεται ὁλκός	- u u- -- uu- --uu --	dactylic hexameter	masculine penthemimeral, hepthemimeral, trithemimeral
νέρθεν ἐπιφλεγέθων, τὸ δέ οἱ ἐμπλάζεται ἦτορ:	-u u-uu- u u - --uu --	dactylic hexameter	masculine penthemimeral, hepthemimeral
λυσσηθεὶς γλῶσσαν δὲ καταπρίει κυνόδοντι,	--- -- u u--- uu--	dactylic hexameter	masculine penthemimeral, trithemimeral
δὴ γὰρ ὅγ᾽ ἔμπληκτος φρένα δάμναται: ἀμφὶ δὲ δοιούς	- u u --- uu -uu -u u --	dactylic hexameter	masculine penthemimeral
εἰκῆ ἐπιφράσσουσα πόρους τυφλώσατο νηδύς	-u u---u u- --uu --	dactylic hexameter	feminine penthemimeral, hepthemimeral
ὑγρῶν τε βρωτῶν τε, καταπνίγουσα δὲ πνεῦμα	-- - -- u u---u u --	dactylic hexameter	masculine penthemimeral, trithemimeral
ἐντὸς ὑποβρομέει, ὀλίγῳ δ᾽ἐνελίσσεται ὄγμῳ	-u u-uu- uu- uu-uu --	dactylic hexameter	masculine penthemimeral, hepthemimeral
πολλάκι δὴ βροντῇσιν ἀνομβρήεντος Ὀλύμπου	-uu - --u u---u u--	dactylic hexameter	feminine penthemimeral, trithemimeral
εἰδόμενον, τοτὲ δ᾽αὖτε κακοῖς ῥόχθοισι θαλάσσης	-uu- uu -u u- --u u--	dactylic hexameter	feminine penthemimeral, hepthemimeral, trithemimeral
οἵοις πετραίῃσιν ὑποβρέμεται σπιλάδεσσι.	-- ---u u-uu- uu--	dactylic hexameter	feminine penthemimeral
τῷ καὶ στρευγομένῳ περ ἀνήλυθεν ἐκ καμάτοιο	- - -uu- u u-uu - uu--	dactylic hexameter	masculine penthemimeral
πνεῦμα μόλις, πόσιες δὲ παραυτίκα λύματ᾽ ἔχευαν	-u u- uu- u u-uu -u u--	dactylic hexameter	masculine penthemimeral, trithemimeral
φαρμακόεις ᾠοῖσιν ἀλίγκια τοῖά τε βοσκάς	-uu- --u u-uu -u u --	dactylic hexameter	feminine penthemimeral, trithemimeral
ὀρταλὶς αἰχμητῇσιν ὑπευνασθεῖσα νεοσσοῖς	-uu ---u u---u u--	dactylic hexameter	feminine penthemimeral
ἄλλοτε μὲν πληγῇσι νέον θρομβήια γαστρός	-uu - --u u- --uu --	dactylic hexameter	feminine penthemimeral, hepthemimeral, trithemimeral
ἔκβαλεν ἐν μήνιγξιν ἀνόστρακα, πολλάκι νούσῳ	-uu - --u u-uu -uu --	dactylic hexameter	feminine penthemimeral, trithemimeral
δαμναμένη δύσποτμον ὑπὲκ γόνον ἔκχεε γαίῃ.	-uu- --u u- uu -uu --	dactylic hexameter	feminine penthemimeral, hepthemimeral, trithemimeral
τῷ μέν τ᾽εὐβραχέος ἀψινθίου ἄλγος ἐρύξει	- - -uu- --uu -u u--	dactylic hexameter	masculine penthemimeral
ἐνστῦφον πόμα κεῖνο νεοθλίπτῳ ὑπὸ γλεύκει:	--- uu -u u--- uu --	dactylic hexameter	feminine penthemimeral, trithemimeral
καί ποτε ῥητίνην τερμινθίδα, πολλάκι πεύκης,	- uu --- --uu -uu --	dactylic hexameter	masculine penthemimeral
πολλάκι καὶ πίτυος γοερῆς ἀπὸ δάκρυα τμήξαις	-uu - uu- uu- uu -uu --	dactylic hexameter	masculine penthemimeral, hepthemimeral, trithemimeral
Μαρσύου ἧχί τε Φοῖβος ἀπὸ φλόα δύσατο γυίων:	-uu -u u -u u- uu -uu --	dactylic hexameter	feminine penthemimeral, hepthemimeral
ἡ δὲ μόρον πολύπυστον ἐπαιάζουσα κατ᾽ ἄγκη	- u u- uu-u u---u u --	dactylic hexameter	feminine penthemimeral, trithemimeral
οἴη συνεχέως ἁδινὴν ἀναβάλλεται ἠχήν.	-- -uu- uu- uu-uu --	dactylic hexameter	masculine penthemimeral, hepthemimeral
ἆσαι δ᾽ἢ πολίοιο μυοκτόνου ἀργέος ἄνθην,	-- - uu-u u-uu -uu --	dactylic hexameter	feminine penthemimeral, trithemimeral
ἢ ἔτι καὶ ῥυτῆς πεδανὰς ἀπαμέργεο βλάστας,	- uu - -- uu- uu-uu --	dactylic hexameter	masculine penthemimeral, hepthemimeral, trithemimeral
νάρδον, λιμναίου τε χαδὼν ἀπὸ κάστορος ὄρχιν:	-- --- u u- uu -uu --	dactylic hexameter	masculine penthemimeral, hepthemimeral
ἢ ὀδελὸν κνηστῆρι κατατρίψαιο χαρακτῷ	- uu- --u u---u u--	dactylic hexameter	feminine penthemimeral, trithemimeral
σιλφίου, ἄλλοτε δ᾽ἶσον ἀποτμήξειας ὀποῖο:	-uu -uu -u u---u u--	dactylic hexameter	feminine penthemimeral
πολλάκι δ᾽ἀγροτέρης τραγοριγάνου ἠὲ γάλακτος	-uu -uu- uu-uu -u u--	dactylic hexameter	masculine penthemimeral
πηγνυμένου κορέοιτο νεημέλκτῃ ἐνὶ πέλλῃ.	-uu- uu-u u--- uu --	dactylic hexameter	feminine penthemimeral, trithemimeral
Ἢν δέ τις ἀφροσύνῃ ταύρου νέον αἷμα πάσηται,	- u u -uu- -- uu -u u--	dactylic hexameter	masculine penthemimeral, hepthemimeral
στρευγεδόνι προδέδουπε δαμαζόμενος καμάτοισιν	-uu- uu-u u-uu- uu--	dactylic hexameter	feminine penthemimeral, trithemimeral
ἦμος πιλνάμενον στέρνοις κρυσταίνεται εἶαρ	-- -uu- -- --uu --	dactylic hexameter	masculine penthemimeral, hepthemimeral
ῥεῖα θρομβοῦται δὲ μέσῳ ἐνὶ τεύχεϊ γαστρός:	-- --- u u- uu -uu --	dactylic hexameter	masculine penthemimeral, hepthemimeral
φράσσονται δὲ πόροι, τὸ δὲ θλίβεται ἔνδοθι πνεῦμα	--- u u- u u -uu -uu --	dactylic hexameter	masculine penthemimeral, trithemimeral
αὐχένος ἐμπλασθέντος, ὁ δὲ σπαδόνεσσιν ἀλύων	-uu ---u u - uu-u u--	dactylic hexameter	feminine penthemimeral, hepthemimeral
δηθάκις ἐν γαίῃ σπαίρει μεμορυχμένος ἀφρῷ.	-uu - -- -- uu-uu --	dactylic hexameter	masculine penthemimeral, hepthemimeral, trithemimeral
τῷ μέν τ᾽ἢ ὀπόεντας ἀποκραδίσειας ἐρινούς	- - - uu-u u-uu-u u--	dactylic hexameter	feminine penthemimeral, trithemimeral
ὄξει δ᾽ἐμπίσαιο, τὸ δ᾽ἀθρόον ὕδατι μίξαις	-- ---u u -uu -uu --	dactylic hexameter	feminine penthemimeral
συγκεράων νύμφας τε καὶ ἐνστῦφον ποτὸν ὄξευς:	-uu- -- u u --- uu --	dactylic hexameter	masculine penthemimeral, trithemimeral
ἠὲ καὶ ἐκβδήλαιο καταχθέος ἕρματα γαστρός.	-u u ---u u-uu -uu --	dactylic hexameter	feminine penthemimeral
καί τε σὺ πυετίην ὀθόνης πολυωπέι κόλπῳ	- u u -uu- uu- uu-uu --	dactylic hexameter	masculine penthemimeral, hepthemimeral
φύρσιμον ἠθήσαιο, τοτὲ προκός, ἄλλοτε νεβροῦ	-uu ---u u- uu -uu --	dactylic hexameter	feminine penthemimeral, hepthemimeral
ἢ ἐρίφου, τοτὲ δ᾽ἂν σὺ καὶ εὐσκάρθμοιο λαγωοῦ	- uu- uu - u u ---u u--	dactylic hexameter	masculine penthemimeral, trithemimeral
αἰνύμενος μογέοντι φέροις εὐαλθέ᾽ ἀρωγήν.	-uu- uu-u u- --u u--	dactylic hexameter	feminine penthemimeral, hepthemimeral, trithemimeral
ἠὲ λίτρου στήδην ὀδελοῦ πόρε τριπλόον ἄχθος	-u u- -- uu- uu -uu --	dactylic hexameter	masculine penthemimeral, hepthemimeral, trithemimeral
εὐτριβέος, κίρνα δὲ ποτῷ ἐν δεύκεϊ Βάκχου,	-uu- -- u u- - -uu --	dactylic hexameter	masculine penthemimeral, hepthemimeral, trithemimeral
ἐν καὶ σιλφιόεσσαν ὀποῖό τε μοιρίδα λίτρην,	- - -uu-u u-u u -uu --	dactylic hexameter	feminine penthemimeral
καὶ σπέραδος κραμβῆεν ἄδην μεμορυχμένον ὄξει:	- uu- --u u- uu-uu --	dactylic hexameter	feminine penthemimeral, hepthemimeral, trithemimeral
ἆσαι δὲ ῥάδικα κακοχλοίοιο κονύζης,	-- - uu- uu--- ---	dactylic hexameter	masculine penthemimeral, trithemimeral
ἢ πέπεριν τά τε βλαστὰ κατασμώξαιο βάτοιο,	- uu- u u -u u---u u--	dactylic hexameter	feminine penthemimeral, trithemimeral
καί κεν πηγνυμένοιο χύσιν διὰ ῥεῖα κεδάσσαις	- - -uu-u u- uu -u u--	dactylic hexameter	feminine penthemimeral, hepthemimeral
ἠὲ διαθρύψειας ἐν ἄγγεσιν ἑστηυῖαν.	-u u---u u -uu ----	dactylic hexameter	feminine penthemimeral
Μὴ μὲν ἐπαλγύνουσα πόσις βουπρήστιδος ἐχθρῆς	- u u---u u- --uu --	dactylic hexameter	feminine penthemimeral, hepthemimeral
λήσειεν, σὺ δὲ φῶτα δαμαζόμενον πεπύθοιο.	--- u u -u u-uu- uu--	dactylic hexameter	feminine penthemimeral, trithemimeral
ἡ δ᾽ἤτοι λίτρῳ μὲν ἐπιχρώζουσα χαλινά	- -- -- u u---u u--	dactylic hexameter	masculine penthemimeral, trithemimeral
εἴδεται ἐμβρυχθεῖσα βαρύπνοος: ἀμφὶ δὲ γαστρός	-uu ---u u-uu -u u --	dactylic hexameter	feminine penthemimeral
ἄλγεα δινεύοντα περὶ στομάτεσσιν ὄρωρεν,	-uu ---u u- uu-u u--	dactylic hexameter	feminine penthemimeral, hepthemimeral
οὖρα δὲ τυφλοῦται, νεάτη δ᾽ὑπὸ κύστις ὀρεχθεῖ,	-u u --- uu- uu -u u--	dactylic hexameter	masculine penthemimeral, hepthemimeral
πᾶσα δέ οἱ νηδὺς διαπίμπραται ὡς ὁπόθ᾽ ὕδρωψ	-u u - -- uu-uu - uu --	dactylic hexameter	masculine penthemimeral, trithemimeral
τυμπανόεις ἀνὰ μέσσον ἀφυσγετὸς ὀμφαλὸν ἵζει,	-uu- uu -u u-uu -uu --	dactylic hexameter	feminine penthemimeral, trithemimeral
ἀμφὶ δέ οἱ γυίοις τετανὸν περιφαίνεται ἔρφος.	-u u - -- uu- uu-uu --	dactylic hexameter	masculine penthemimeral, hepthemimeral, trithemimeral
ἡ καί που δαμάλεις ἐριγάστορας ἄλλοτε μόσχους	- - - uu- uu-uu -uu --	dactylic hexameter	masculine penthemimeral, trithemimeral
πίμπραται ὁππότε θῆρα νομαζόμενοι δατέονται,	-uu -uu -u u-uu- uu--	dactylic hexameter	feminine penthemimeral
τούνεκα τὴν βούπρηστιν ἐπικλείουσι νομῆες.	-uu - --u u---u u--	dactylic hexameter	feminine penthemimeral, trithemimeral
τῷ δὲ καὶ εὐκραδέος τριέτει ἐν νέκταρι μίξαις	- u u -uu- uu- - -uu --	dactylic hexameter	masculine penthemimeral, hepthemimeral
συκέης αὐανθεῖσαν ἅλις πόσιν ὀμφαλόεσσαν,	-- ---u u- uu -uu--	dactylic hexameter	feminine penthemimeral, hepthemimeral
ἢ ἔτι καὶ σφύρῃ μιγάδην τεθλασμένα κόψας	- uu - -- uu- --uu --	dactylic hexameter	masculine penthemimeral, hepthemimeral, trithemimeral
ἐν πυρὶ τηξάμενος πορέειν ἀλκτήρια νούσων.	- uu -uu- uu- --uu --	dactylic hexameter	masculine penthemimeral, hepthemimeral
καί κε μελιζώροιο νέον κορέσαιο ποτοῖο	- u u---u u- uu-u u--	dactylic hexameter	feminine penthemimeral, hepthemimeral
ἀνέρα λαιμάσσοντα, τοτὲ γλάγος εἰν ἑνὶ χεύας:	-uu ---u u- uu - uu --	dactylic hexameter	feminine penthemimeral, hepthemimeral
πολλάκι φοίνικος ψαφαρὸν καταμίσγεο καρπόν,	-uu --- uu- uu-uu --	dactylic hexameter	masculine penthemimeral, hepthemimeral
ἄλλοτε δ᾽αὐαλέας δὴν ἀχράδας, ἢ ἀπὸ βάκχης,	-uu -uu- - -uu - uu --	dactylic hexameter	masculine penthemimeral
ἢ ἀπὸ μυρτίνης, ὁτὲ μυρτίδας οἰνάδι βάλλων.	- uu --- uu -uu -uu --	dactylic hexameter	masculine penthemimeral
ἢ ὅγε καὶ θηλῆς ἅτε δὴ βρέφος ἐμπελάοιτο	- uu - -- uu - uu -uu--	dactylic hexameter	masculine penthemimeral, hepthemimeral, trithemimeral
ἀρτιγενές, μαστοῦ δὲ ποτὸν μοσχηδὸν ἀμέλγοι,	-uu- -- u u- --u u--	dactylic hexameter	masculine penthemimeral, hepthemimeral, trithemimeral
οἵη τ᾽ἐξ ὑμένων νεαλὴς ὑπὸ οὔθατα μόσχος	-- - uu- uu- uu -uu --	dactylic hexameter	masculine penthemimeral, hepthemimeral, trithemimeral
βράσσει ἀνακρούουσα χύσιν μενοεικέα θηλῆς.	-u u---u u- uu-uu --	dactylic hexameter	feminine penthemimeral, hepthemimeral
ἄλλοτε πιαλέης πόσιος χλιαροῖο κορέσκοις,	-uu -uu- uu- uu-u u--	dactylic hexameter	masculine penthemimeral, hepthemimeral
ἐς δ᾽ἔμετον βιάοιο καὶ οὐ ποθέοντά περ ἔμπης	- uu- uu-u u - uu-u u --	dactylic hexameter	feminine penthemimeral, hepthemimeral, trithemimeral
χειρὶ βιαζόμενος ἠὲ πτερῷ, ἢ ἀπὸ βύβλου	-u u-uu- -- uu - uu --	dactylic hexameter	masculine penthemimeral, hepthemimeral
στρεβλὸν ἐπιγνάμψαιο ταμὼν ἐρυτῆρα φάρυγγος.	-u u---u u- uu-u u--	dactylic hexameter	feminine penthemimeral, hepthemimeral
Ἢν δ᾽ἐπιτυρωθῇ νεαρὸν γάλα τεύχεϊ γαστρός,	- uu--- uu- uu -uu --	dactylic hexameter	masculine penthemimeral, hepthemimeral
δὴ τοτὲ τόνδε πνιχμὸς ἀθροιζομένοιο δαμάζει.	- uu -- -u u-uu-u u--	dactylic hexameter	feminine penthemimeral
τῷ δ᾽ἤτοι τρισσὰς πόσιας πόρε, μέσσα μὲν ὄξευς	- -- -- uu- uu -u u --	dactylic hexameter	masculine penthemimeral, hepthemimeral, trithemimeral
δοιὰς δὲ γλυκέος, στεγανὴν δ᾽ὑποσύρεο νηδύν:	-- - uu- uu- uu-uu --	dactylic hexameter	masculine penthemimeral, hepthemimeral, trithemimeral
ἢ ἔτι καὶ Λιβύηθε ποτῷ ἐγκνήθεο ῥίζας	- uu - uu-u u- --uu --	dactylic hexameter	feminine penthemimeral, hepthemimeral, trithemimeral
σιλφίου, ἄλλοτ᾽ ὀποῖο, νέμοις δ᾽ἐν βάμματι τήξας:	-uu -u u-u u- - -uu --	dactylic hexameter	feminine penthemimeral, hepthemimeral
πολλάκι δὲ θρύπτειραν ἐπεγκεράσαιο κονίην,	-uu - --u u-uu-u u--	dactylic hexameter	feminine penthemimeral, trithemimeral
ἠὲ νέον βρυόεντα θύμου στάχυν: ἄλλοτ᾽ ἀμύνει	-u u- uu-u u- uu -u u--	dactylic hexameter	feminine penthemimeral, hepthemimeral, trithemimeral
βότρυς ἐυκνήμοιο μίγα βρεχθέντος ἐν οἴνῃ:	-u u---u u- --u u --	dactylic hexameter	feminine penthemimeral, hepthemimeral
ἐν καί που ταμίσοιο ποτὸν διεχεύατο θρόμβους,	- - - uu-u u- uu-uu --	dactylic hexameter	feminine penthemimeral, hepthemimeral, trithemimeral
καὶ χλοεραὶ μίνθης ἄπο φυλλάδες ἠὲ μελίσσης	- uu- -- uu -uu -u u--	dactylic hexameter	masculine penthemimeral, trithemimeral
ἠὲ καὶ ἐνστύφοντι ποτῷ μεμορυχμέναι ὄξευς.	-u u ---u u- uu-uu --	dactylic hexameter	feminine penthemimeral, hepthemimeral
Ἀλλ᾽ ἄγε δὴ φράζοιο δορύκνιον, οὗ τε γάλακτι	- uu - --u u-uu - u u--	dactylic hexameter	feminine penthemimeral, trithemimeral
ὠπή τε βρῶσίς τε παρὰ στομάτεσσιν ἔικται:	-- - -- u u- uu-- --	dactylic hexameter	masculine penthemimeral, hepthemimeral, trithemimeral
τῷ δ᾽ἤτοι λυγμοὶ μὲν ἀηθέσσοντες ὁμαρτῇ	- -- -- u u---u u--	dactylic hexameter	masculine penthemimeral, trithemimeral
αὐχέν᾽ ἀνακρούουσιν, ὁ δ᾽ἀχθόμενος στόμα γαστρός	-u u---u u -uu- uu --	dactylic hexameter	feminine penthemimeral
πολλάκι μὲν δαίτην ἀπερεύγεται αἱματόεσσαν,	-uu - -- uu-uu -uu--	dactylic hexameter	masculine penthemimeral, trithemimeral
ἄλλοτε νηδυίων θολερὴν μυξώδεα χεύει	-uu --- uu- --uu --	dactylic hexameter	masculine penthemimeral, hepthemimeral
τηνεσμῷ ὡς εἴ τε δυσέντερος ἀχθόμενος φώς:	--- - - u u-uu -uu- -	dactylic hexameter	masculine penthemimeral, trithemimeral
δήποτε τειρόμενος καμάτοις κάρφουσι δέδουπε	-uu -uu- uu- --u u--	dactylic hexameter	masculine penthemimeral, hepthemimeral
γυῖα δαμείς: οὐ μὲν ποθέει ξηρὸν στόμα δεῦσαι.	-u u- - - uu- -- uu --	dactylic hexameter	masculine penthemimeral, hepthemimeral, trithemimeral
τῷ δὲ σὺ πολλάκι μὲν γλάγεος πόσιν, ἄλλοτε μίγδην	- u u -uu - uu- uu -uu --	dactylic hexameter	masculine penthemimeral, hepthemimeral
ῥεῖα γλυκὺ νείμειας ἀλυκρότερον δεπάεσσι:	-u u- --u u-uu- uu--	dactylic hexameter	feminine penthemimeral, trithemimeral
καί τε καὶ ὄρνιθος φιαρῆς πυρὶ τηκομένη σάρξ	- u u --- uu- uu -uu- -	dactylic hexameter	masculine penthemimeral, hepthemimeral
θωρήκων ἤμυνεν ἐυτρεφέων βρωθεῖσα:	--- --u u-uu- ---	dactylic hexameter	feminine penthemimeral, trithemimeral
ἤμυνεν καὶ χυλὸς ἅλις κύμβῃσι ῥοφηθείς,	--- - -u u- --u u--	dactylic hexameter	feminine penthemimeral, hepthemimeral, trithemimeral
ὅσσα τε πετρήεντος ὑπὸ ῥόχθοισι θαλάσσης	-u u ---u u- --u u--	dactylic hexameter	feminine penthemimeral, hepthemimeral
κνώδαλα φυκιόεντας ἀεὶ περιβόσκεται ἀγμούς:	-uu -uu-u u- uu-uu --	dactylic hexameter	feminine penthemimeral, hepthemimeral
ὧν τὰ μὲν ὠμὰ πάσαιτο, τὰ δ᾽ἑφθέα, πολλὰ δὲ θάλψας	- u u -u u-u u -uu -u u --	dactylic hexameter	feminine penthemimeral
ἐν φλογιῇ. στρόμβων δὲ πολὺ πλέον, ἢ ἔτι κάλχης,	- uu- -- u u- uu - uu --	dactylic hexameter	masculine penthemimeral, hepthemimeral, trithemimeral
κηραφίδος, πίνης τε καὶ αἰθήεντος ἐχίνου	-uu- -- u u ---u u--	dactylic hexameter	masculine penthemimeral, trithemimeral
δαῖτες ἐπαλθήσουσιν ἰδὲ κτένες: οὐδέ τι κῆρυξ	-u u---u u- uu -u u --	dactylic hexameter	feminine penthemimeral, hepthemimeral
†δὴν ἔσεται† τήθη τε γεραιρόμενα μνίοισι.	- uu- -- u u-uu- ---	dactylic hexameter	masculine penthemimeral, trithemimeral
Μηδέ σέ γ᾽ἐχθομένη λήθῃ πόσις (οὐ γὰρ ἄιδρις)	-u u -uu- -- uu - u u--	dactylic hexameter	masculine penthemimeral, hepthemimeral
Φαρικοῦ, ἣ γναθμοῖσιν ἔπι βαρὺν ὤπασε μόχθον.	-uu - --u u- uu -uu --	dactylic hexameter	feminine penthemimeral, hepthemimeral, trithemimeral
τὴν ἤτοι γευθμῷ μὲν ἰσαιομένην μάθε νάρδῳ,	- -- -- u u-uu- uu --	dactylic hexameter	masculine penthemimeral, trithemimeral
ἤνυσε δὲ σφαλερούς, ὁτὲ δ᾽ἄφρονας, ἐν δὲ μονήρει	-uu - uu- uu -uu - u u--	dactylic hexameter	masculine penthemimeral, trithemimeral
ῥηιδίως ἀκτῖνι βαρὺν κατεναίρεται ἄνδρα.	-uu- --u u- uu-uu --	dactylic hexameter	feminine penthemimeral, hepthemimeral, trithemimeral
ἀλλὰ σὺ πολλάκι μὲν σταδίην εὐανθέα νάρδου	-u u -uu - uu- --uu --	dactylic hexameter	masculine penthemimeral, hepthemimeral
ῥιζίδα θυλακόεσσαν ὀπάζεο τήν τε Κίλισσαι	-uu -uu-u u-uu - u u--	dactylic hexameter	feminine penthemimeral
πρηόνες ἀλδαίνουσι παρὰ πλημμυρίδα Κέστρου,	-uu ---u u- --uu --	dactylic hexameter	feminine penthemimeral, hepthemimeral
ἄλλοτε δὲ σμυρνεῖον ἐυτριβές. αἴνυσο δ᾽αὐτήν	-uu - --u u-uu -uu --	dactylic hexameter	feminine penthemimeral, trithemimeral
ἴριδα λειριόεν τε κάρη τό τ᾽ἀπέστυγεν Ἀφρώ,	-uu -uu- u u- u u-uu --	dactylic hexameter	masculine penthemimeral, hepthemimeral
οὕνεκ᾽ ἐριδμαίνεσκε χρόης ὕπερ, ἐν δέ νυ θρίοις	-u u---u u- uu - u u --	dactylic hexameter	feminine penthemimeral, hepthemimeral
ἀργαλέην μεσάτοισιν ὀνειδείην ἐπέλασσε	-uu- uu-u u--- uu--	dactylic hexameter	feminine penthemimeral, trithemimeral
δεινὴν βρωμήεντος ἐναλδήνασα κορύνην.	-- ---u u---u u--	dactylic hexameter	feminine penthemimeral
πολλάκι δὲ σκύλαιο κάρη, περὶ δ᾽αἴνυσο λάχνην	-uu - --u u- uu -uu --	dactylic hexameter	feminine penthemimeral, hepthemimeral, trithemimeral
κέρσας εὐήκει νεόθεν ξυρῷ, ἐν δέ νυ θάλψαις	-- --- uu- uu - u u --	dactylic hexameter	masculine penthemimeral, hepthemimeral
ἤια κριθάων νεοθηλέα φυλλάδα τ᾽ἰσχνήν	-uu --- uu-uu -uu --	dactylic hexameter	masculine penthemimeral
πηγάνου ἥν τ᾽ὤκιστα βορῇ ἐπεσίνατο κάμπη,	-uu - --u u- uu-uu --	dactylic hexameter	feminine penthemimeral, hepthemimeral, trithemimeral
βάμματι δ᾽ἐνδεύσαιο καὶ εὖ περὶ κόρσεα πλάσσοις.	-uu ---u u - uu -uu --	dactylic hexameter	feminine penthemimeral, hepthemimeral
Μηδὲ συοσκυάμῳ τις ἀιδρήεντα κορέσκοι	-u u-uu- - ---u u--	dactylic hexameter	masculine penthemimeral
νηδύν, οἷά τε πολλὰ παρασφαλέες τεύχονται,	-- -u u -u u-uu- ---	dactylic hexameter	feminine penthemimeral
ἠὲ νέον σπείρημα καὶ ἀμφίκρηνα κομάων	-u u- --u u ---u u--	dactylic hexameter	feminine penthemimeral, trithemimeral
κοῦροι ἀπειπάμενοι ὀλοήν θ᾽ἑρπηδόνα γυίων,	-u u-uu- uu- --uu --	dactylic hexameter	masculine penthemimeral, hepthemimeral
ὀρθόποδες βαίνοντες ἄνις σμυγεροῖο τιθήνης	-uu- --u u- uu-u u--	dactylic hexameter	feminine penthemimeral, hepthemimeral, trithemimeral
ἠλοσύνῃ βρύκουσι κακανθήεντας ὀράμνους,	-uu- --u u---u u--	dactylic hexameter	feminine penthemimeral, trithemimeral
οἷα νέον βρωτῆρας ὑπὸ γναθμοῖσιν ὀδόντας	-u u- --u u- --u u--	dactylic hexameter	feminine penthemimeral, hepthemimeral, trithemimeral
φαίνοντες τότε κνηθμὸς ἐνοιδέα δάμναται οὖλα.	--- uu -u u-uu -uu --	dactylic hexameter	feminine penthemimeral, trithemimeral
τῷ δ᾽ὁτὲ μὲν καθαρὴν γλάγεος πόσιν ἄλθεα πίσαις,	- uu - uu- uu- uu -uu --	dactylic hexameter	masculine penthemimeral, hepthemimeral, trithemimeral
ἄλλοτε βουκέραος χιληγόνου ὅ ῥα κεραίας	-uu -uu- --uu - u u--	dactylic hexameter	masculine penthemimeral
εὐκαμπεῖς πετάλοισιν ὑπηνεμίοισιν ἀέξει,	--- uu-u u-uu-u u--	dactylic hexameter	feminine penthemimeral, trithemimeral
ἀτμενίῳ μέγ᾽ ὄνειαρ ὅτ᾽ ἐμπλώῃσιν ἐλαίῳ.	-uu- u u-u u ---u u--	dactylic hexameter	feminine penthemimeral, trithemimeral
ἠὲ σύ γ᾽αὐαλέον κνίδης σπόρον, ἄλλοτε δ᾽αὐτήν	-u u -uu- -- uu -uu --	dactylic hexameter	masculine penthemimeral, hepthemimeral
νείμαις ὠμόβρωτον ἄδην ἀνὰ φυλλάδ᾽ ἀμέλξαι,	-- ---u u- uu -u u--	dactylic hexameter	feminine penthemimeral, hepthemimeral
κίχορα καρδαμίδας τε καὶ ἣν Περσεῖον ἔπουσιν,	-uu -uu- u u - --u u--	dactylic hexameter	masculine penthemimeral, hepthemimeral
ἐν δέ τε νάπειον ῥάφανόν θ᾽ἅλις, ἐν δέ τε λεπτάς	- u u --- uu- uu - u u --	dactylic hexameter	masculine penthemimeral, hepthemimeral
ἄμμιγα κρομμύων γηθυλλίδας: ἤρκεσε δ᾽ἄτην	-uu --- --uu -uu --	dactylic hexameter	masculine penthemimeral
εὐάγλις κώδεια νέον σκορόδοιο ποθεῖσα.	--- --u u- uu-u u--	dactylic hexameter	feminine penthemimeral, hepthemimeral, trithemimeral
Καί τε σὺ μήκωνος κεβληγόνου ὁππότε δάκρυ	- u u --- --uu -uu --	dactylic hexameter	masculine penthemimeral
πίνωσιν, πεπύθοιο καθυπνέας: ἀμφὶ γὰρ ἄκρα	--- uu-u u-uu -u u --	dactylic hexameter	feminine penthemimeral, trithemimeral
γυῖα καταψύχουσι, τὰ δ᾽οὐκ ἀναπίτναται ὄσσε	-u u---u u - uu-uu --	dactylic hexameter	feminine penthemimeral, hepthemimeral
ἀλλ᾽ αὔτως βλεφάροισιν ἀκινήεντα δέδηεν:	- -- uu-u u---u u--	dactylic hexameter	feminine penthemimeral, trithemimeral
ἀμφὶ καὶ ὀδμήεις καμάτῳ περιλείβεται ἱδρώς	-u u --- uu- uu-uu --	dactylic hexameter	masculine penthemimeral, hepthemimeral
ἀθρόος, ὠχραίνει δὲ ῥέθος, πίμπρησι δὲ χείλη,	-uu --- u u- --u u --	dactylic hexameter	masculine penthemimeral, hepthemimeral
δεσμὰ δ᾽ἐπεγχαλάουσι γενειάδος, ἐκ δέ τε παῦρον	-u u-uu-u u-uu - u u --	dactylic hexameter	feminine penthemimeral
αὐχένος ἑλκόμενον ψυχρὸν διανίσσεται ἄσθμα:	-uu -uu- -- uu-uu --	dactylic hexameter	masculine penthemimeral, hepthemimeral
πολλάκι δ᾽ἠὲ πελιδνὸς ὄνυξ μόρον ἢ ἔτι μυκτήρ	-uu -u u-u u- uu - uu --	dactylic hexameter	feminine penthemimeral, hepthemimeral
στρεβλὸς ἀπαγγέλλει, ὁτὲ δ᾽αὖ κοιλώπεες αὐγαί.	-u u--- uu - --uu --	dactylic hexameter	masculine penthemimeral, hepthemimeral
ἅσσα σὺ μὴ δείδιχθι, μέλοιο δὲ πάμπαν ἀρωγῆς	-u u - --u u-u u -u u--	dactylic hexameter	feminine penthemimeral, trithemimeral
οἰνάδι καὶ γλυκόεντι ποτῷ κεκαφηότα πιμπλάς	-uu - uu-u u- uu-uu --	dactylic hexameter	feminine penthemimeral, hepthemimeral, trithemimeral
τινθαλέῳ: τοτὲ δ᾽ἔργα διαθρύψαιο μελίσσης	-uu- uu -u u---u u--	dactylic hexameter	feminine penthemimeral, trithemimeral
ἄμμιγα ποιπνύων Ὑμησσίδος αἵ τ᾽ἀπὸ μόσχου	-uu --- --uu - uu --	dactylic hexameter	masculine penthemimeral
σκήνεος ἐξεγένοντο δεδουπότος ἐν νεμέεσσιν:	-uu -uu-u u-uu - uu--	dactylic hexameter	feminine penthemimeral
ἔνθα δὲ καὶ κοίλοιο κατὰ δρυὸς ἐκτίσσαντο	-u u - --u u- uu ----	dactylic hexameter	feminine penthemimeral, hepthemimeral, trithemimeral
πρῶτόν που θαλάμας συνομήρεες, ἀμφὶ καὶ ἔργων	-- - uu- uu-uu -u u --	dactylic hexameter	masculine penthemimeral, trithemimeral
μνησάμεναι Δηοῖ πολυωπέας ἤνυσαν ὄμπας	-uu- -- uu-uu -uu --	dactylic hexameter	masculine penthemimeral, trithemimeral
βοσκόμεναι θύμα ποσσὶ καὶ ἀνθεμόεσσαν ἐρείκην.	-uu- uu -u u -uu-u u--	dactylic hexameter	feminine penthemimeral, trithemimeral
δήποτε δ᾽ἢ ῥοδέοιο νέον θύος εὔτριχι λήνει,	-uu - uu-u u- uu -uu --	dactylic hexameter	feminine penthemimeral, hepthemimeral, trithemimeral
ἠὲ καὶ ἰρινόεν, τοτὲ δ᾽αὖ μορόεντος ἐλαίης,	-u u -uu- uu - uu-u u--	dactylic hexameter	masculine penthemimeral, hepthemimeral
ὀχλίζων κυνόδοντα, τότ᾽ ἠμύουσι χαλινοῖς,	--- uu-u u ---u u--	dactylic hexameter	feminine penthemimeral, trithemimeral
ἐνθλίβοις, μαλλὸν δὲ βαθὺν κεκορημένον ἕλκοι.	--- -- u u- uu-uu --	dactylic hexameter	masculine penthemimeral, hepthemimeral, trithemimeral
αἶψα δὲ τόν γ᾽ἑκάτερθε διὰ ῥέθος ἔγρεο πλήσσων,	-u u - uu-u u- uu -uu --	dactylic hexameter	feminine penthemimeral, hepthemimeral, trithemimeral
ἄλλοτε δ᾽ἐμβοόων, τοτὲ δὲ κνώσσοντα σαλάσσων,	-uu -uu- uu - --u u--	dactylic hexameter	masculine penthemimeral, hepthemimeral
ὄφρα κατηβολέων ὀλοὸν διὰ κῶμα κεδαίῃ,	-u u-uu- uu- uu -u u--	dactylic hexameter	masculine penthemimeral, hepthemimeral
τῆμος δ᾽ἐξερύγῃσιν ἀλεξόμενος κακὸν ἄλγος.	-- -uu-u u-uu- uu --	dactylic hexameter	feminine penthemimeral
σπεῖρα δ᾽ἐνὶ χλιαρῷ λίπεϊ, πρὸ δὲ νέκταρι, βάπτων	-u u- uu- uu- u u -uu --	dactylic hexameter	masculine penthemimeral, hepthemimeral, trithemimeral
τρῖβε καὶ ἐκθέρμαινε ποτῷ ἐψυγμένα γυῖα,	-u u ---u u- --uu --	dactylic hexameter	feminine penthemimeral, hepthemimeral
ἄλλοτε δ᾽ἐν δροίτῃ κεράων ἐμβάπτεο σάρκας,	-uu - -- uu- --uu --	dactylic hexameter	masculine penthemimeral, hepthemimeral, trithemimeral
αἶψα δὲ τινθαλέοισιν ἐπαιονάασθε λοετροῖς	-u u -uu-u u-uu-u u--	dactylic hexameter	feminine penthemimeral
αἷμ᾽ ἀναλυόμενοι τετανόν τ᾽ἐσκληκότα ῥινόν.	- uu-uu- uu- --uu --	dactylic hexameter	masculine penthemimeral, hepthemimeral
Εἰδείης δὲ λαγοῖο κακοφθορέος πόσιν αἰνήν,	--- u u-u u-uu- uu --	dactylic hexameter	feminine penthemimeral, trithemimeral
οὐλομένην, τὸν κῦμα πολυστίου τέκεν ἅλμης.	-uu- - -u u--- uu --	dactylic hexameter	feminine penthemimeral, trithemimeral
τοῦ δ᾽ἤτοι λοπίδων μὲν ἰδὲ πλύματος πέλει ὀδμή,	- -- uu- u u- uu- uu --	dactylic hexameter	masculine penthemimeral, hepthemimeral, trithemimeral
γευθμὸς δ᾽ἰχθυόεις νεπόδων ἅτε σαπρυνθέντων,	-- -uu- uu- uu ----	dactylic hexameter	masculine penthemimeral, hepthemimeral
ἠὲ καὶ ἀρρύπτων ὁπόταν λοπὶς αὐξίδα χραίνῃ.	-u u --- uu- uu -uu --	dactylic hexameter	masculine penthemimeral, hepthemimeral
ὃς δ᾽ἤτοι ῥυπόεις μὲν ὑπ᾽ ὀστλίγγεσσιν ἀραιαῖς	- -- uu- u u ---u u--	dactylic hexameter	masculine penthemimeral, trithemimeral
τευθίδος ἐμφέρεται νεαλὴς γόνος ἢ ἅτε τεύθου,	-uu -uu- uu- uu - uu --	dactylic hexameter	masculine penthemimeral, hepthemimeral
οἷά τε σηπιάδος φυξήλιδος ἥ τε μελαίνει	-u u -uu- --uu - u u--	dactylic hexameter	masculine penthemimeral
οἶδμα χολῇ δολόεντα μαθοῦς᾽ ἀγρώστορος ὁρμήν.	-u u- uu-u u- --uu --	dactylic hexameter	feminine penthemimeral, hepthemimeral, trithemimeral
τῶν ἤτοι ζοφόεις μὲν ἐπὶ χλόος ἔδραμε γυίοις	- -- uu- u u- uu -uu --	dactylic hexameter	masculine penthemimeral, hepthemimeral, trithemimeral
ἰκτερόεις, σάρκες δὲ περισταλάδην μινύθουσι	-uu- -- u u-uu- uu--	dactylic hexameter	masculine penthemimeral, trithemimeral
τηκόμεναι, ὁ δὲ δόρπα κατέστυγεν: ἄλλοτε ῥινός	-uu- u u -u u-uu -uu --	dactylic hexameter	feminine penthemimeral, trithemimeral
ἄκρον ἐποιδαίνων σφυρὰ πίμπραται, ἀμφὶ δὲ μήλοις	-u u--- uu -uu -u u --	dactylic hexameter	masculine penthemimeral
ἄνθε᾽ ἅτε βρυόεντα κυλοιδιόωντος ἐφίζει.	-u u- uu-u u-uu-u u--	dactylic hexameter	feminine penthemimeral, trithemimeral
δὴ γὰρ ἐφωμάρτησεν ὀλιζοτέρη ῥύσις οὔρων,	- u u---u u-uu- uu --	dactylic hexameter	feminine penthemimeral
ἄλλοτε πορφυρέη, τότ᾽ ἐπὶ πλέον αἱμάσσουσα.	-uu -uu- u u- uu ----	dactylic hexameter	masculine penthemimeral, hepthemimeral
πᾶς δὲ παρὰ δρακέεσσι φανεὶς ἐχθαίρεται ἔλλοψ,	- u u- uu-u u- --uu --	dactylic hexameter	feminine penthemimeral, hepthemimeral, trithemimeral
αὐτὰρ ὁ ναυσιόεις ἁλίην ἐμυσάξατο δαῖτα.	-u u -uu- uu- uu-uu --	dactylic hexameter	masculine penthemimeral, hepthemimeral
τῷ μὲν Φωκήεσσαν ἅλις πόσιν ἐλλεβόροιο	- - ---u u- uu -uu--	dactylic hexameter	feminine penthemimeral, hepthemimeral
νείμειας, τοτὲ δάκρυ νεοβλάστοιο κάμωνος,	--- uu -u u---u u--	dactylic hexameter	feminine penthemimeral, trithemimeral
ὄφρα ποτὸν νέποδός τε κακοῦ ἐκ φύρματα χεύῃ:	-u u- uu- u u- - -uu --	dactylic hexameter	masculine penthemimeral, hepthemimeral, trithemimeral
ἄλλοτε βρωμήεντος ἀμελγόμενος γάλα πίνοι,	-uu ---u u-uu- uu --	dactylic hexameter	feminine penthemimeral
ἠὲ χύτρῳ τήξας μαλάχης λιπόωντας ὀράμνους:	-u u- -- uu- uu-u u--	dactylic hexameter	masculine penthemimeral, hepthemimeral, trithemimeral
καί ποτε κεδρινέης πελάνου βάρος ἔμμορε πίσσης,	- uu -uu- uu- uu -uu --	dactylic hexameter	masculine penthemimeral, hepthemimeral
βρύκοι δ᾽ἄλλοτε καρπὸν ἅλις φοινώδεα σίδης	-- -uu -u u- --uu --	dactylic hexameter	feminine penthemimeral, hepthemimeral
Κρησίδος, οἰνωπῆς τε καὶ ἣν Προμένειον ἔπουσι,	-uu --- u u - uu-u u--	dactylic hexameter	masculine penthemimeral, hepthemimeral
σὺν δὲ καὶ Αἰγινῆτιν, ὅσαι τ᾽ἐσκληκότα κάρφη	- u u ---u u- --uu --	dactylic hexameter	feminine penthemimeral, hepthemimeral
φοίνι᾽ ἀραχνήεντι διαφράσσουσι καλύπτρῃ:	-u u---u u---u u--	dactylic hexameter	feminine penthemimeral
ἄλλοτε δ᾽οἰνοβρῶτα βορὴν ἐν κυρτίδι θλίψαις	-uu ---u u- - -uu --	dactylic hexameter	feminine penthemimeral, hepthemimeral
ὡς εἴ περ νοτέουσαν ὑπὸ τριπτῆρσιν ἐλαίην.	- - - uu-u u- --u u--	dactylic hexameter	feminine penthemimeral, hepthemimeral, trithemimeral
Ἢν δέ τις ἀζαλέῃ πεπιεσμένος αὐχένα δίψῃ	- u u -uu- uu-uu -uu --	dactylic hexameter	masculine penthemimeral
ἐκ ποταμοῦ ταυρηδὸν ἐπιπροπεσὼν ποτὸν ἴσχῃ	- uu- --u u-uu- uu --	dactylic hexameter	feminine penthemimeral, trithemimeral
λεπτὰ διαστείλας παλάμῃ μνιώδεα θρῖα,	-u u--- uu- --uu --	dactylic hexameter	masculine penthemimeral, hepthemimeral
τῷ μέν τε ῥοιζηδὰ φιλαίματος ἐμπελάουσα	- - - --u u-uu -uu--	dactylic hexameter	feminine penthemimeral, trithemimeral
ῥύμῃ ἅλις προὔτυψε ποτοῦ μέτα χήτεϊ βρώμης	-u u- --u u- uu -uu --	dactylic hexameter	feminine penthemimeral, hepthemimeral, trithemimeral
βδέλλα πάλαι λαπαρή τε καὶ ἱμείρουσα φόνοιο.	-u u- uu- u u ---u u--	dactylic hexameter	masculine penthemimeral, trithemimeral
ἢ ὅθ᾽ ὑπὸ ζοφερῆς νυκτὸς κεκαλυμμένος αὐγάς	- u u- uu- -- uu-uu --	dactylic hexameter	masculine penthemimeral, hepthemimeral, trithemimeral
ἀφραδέως κρωσσοῖο κατακλίνας ποτὸν ἴσχῃ	-uu- --u u--- uu --	dactylic hexameter	feminine penthemimeral, trithemimeral
χείλεσι πρὸς χείλη πιέσας, τὸ δὲ λαιμὸν ἀμείψῃ	-uu - -- uu- u u -u u--	dactylic hexameter	masculine penthemimeral, hepthemimeral, trithemimeral
κνώδαλον ἀκροτάτοισιν ἐπιπλῶον ὑδάτεσσι,	-uu -uu-u u--- uu--	dactylic hexameter	feminine penthemimeral
ταὶ μὲν ἵνα πρώτιστον ὀχλιζομένας ῥόος ὤσῃ	- u u- --u u-uu- uu --	dactylic hexameter	feminine penthemimeral, trithemimeral
ἀθρόα προσφύονται ἀμελγόμεναι χροὸς αἷμα,	-uu ---u u-uu- uu --	dactylic hexameter	feminine penthemimeral
ἄλλοτε μέν τε πύλῃσιν ἐφήμεναι ἔνθα τε πνεῦμα	-uu - u u-u u-uu -u u --	dactylic hexameter	feminine penthemimeral, trithemimeral
αἰὲν ἀθροιζόμενον στεινοῦ διαχεύεται ἰσθμοῦ,	-u u-uu- -- uu-uu --	dactylic hexameter	masculine penthemimeral, hepthemimeral
ἄλλοτε δὲ στομίοισι πέριξ ἐπενήνοθε γαστρός	-uu - uu-u u- uu-uu --	dactylic hexameter	feminine penthemimeral, hepthemimeral, trithemimeral
ἀνέρα πημαίνουσα, νέην δ᾽ἐπενείματο δαῖτα.	-uu ---u u- uu-uu --	dactylic hexameter	feminine penthemimeral, hepthemimeral
τῷ σὺ τότ᾽ ἐν δεπάεσσι κεραιόμενον ποτὸν ὄξευς	- u u - uu-u u-uu- uu --	dactylic hexameter	feminine penthemimeral, trithemimeral
νείμειας, ποτὲ δαῖτα συνήρεα χιονόεσσαν,	--- uu -u u-uu -uu--	dactylic hexameter	feminine penthemimeral, trithemimeral
πολλάκι κρυστάλλοιο νέον βορέῃσι παγέντος.	-uu ---u u- uu-u u--	dactylic hexameter	feminine penthemimeral, hepthemimeral
ἠὲ σὺ γυρώσαιο καθαλμέα βώλακα γαίης	-u u ---u u-uu -uu --	dactylic hexameter	feminine penthemimeral
ναιομένην, θολερὴν δὲ πόσιν μενοεικέα τεῦχε:	-uu- uu- u u- uu-uu --	dactylic hexameter	masculine penthemimeral, hepthemimeral, trithemimeral
ἢ αὐτὴν ἅλα βάπτε, τότ᾽ ἠελίοισι δαμάζων	- -- uu -u u -uu-u u--	dactylic hexameter	feminine penthemimeral, trithemimeral
εἶθαρ ὀπωρινοῖσι, τότ᾽ ἠνεκὲς ἐν φλογὶ θάλψας.	-u u---u u -uu - uu --	dactylic hexameter	feminine penthemimeral
πολλάκι δ᾽ἢ ἅλα πηκτὸν ὁμιλαδόν, ἢ ἁλὸς ἄχνην	-uu - uu -u u-uu - uu --	dactylic hexameter	feminine penthemimeral, trithemimeral
ἐμπίσαις τήν τ᾽αἰὲν ἀνὴρ ἁλοπηγὸς ἀγείρει	--- - -u u- uu-u u--	dactylic hexameter	feminine penthemimeral, hepthemimeral, trithemimeral
νειόθ᾽ ὑφισταμένην ὁπόθ᾽ ὕδασιν ὕδατα μίξῃ.	-u u-uu- uu -uu -uu --	dactylic hexameter	masculine penthemimeral
Μὴ μὲν δὴ ζύμωμα κακὸν χθονὸς ἀνέρα κήδοι	- - - --u u- uu -uu --	dactylic hexameter	feminine penthemimeral, hepthemimeral, trithemimeral
πολλάκι μὲν στέρνοισιν ἀνοιδέον, ἄλλοτε δ᾽ἄγχον,	-uu - --u u-uu -uu --	dactylic hexameter	feminine penthemimeral, trithemimeral
εὖτ᾽ ἐπὶ φωλεύοντα τραφῇ βαθὺν ὁλκὸν ἐχίδνης	- uu ---u u- uu -u u--	dactylic hexameter	feminine penthemimeral, hepthemimeral
ἰὸν ἀνικμαῖνον στομίων τ᾽ἀποφώλιον ἄσθμα.	-u u--- uu- uu-uu --	dactylic hexameter	masculine penthemimeral, hepthemimeral
κεῖνο κακὸν ζύμωμα τὸ δή ῥ᾽ὑδέουσι μύκητας	-u u- --u u - uu-u u--	dactylic hexameter	feminine penthemimeral, hepthemimeral, trithemimeral
παμπήδην, ἄλλῳ γὰρ ἐπ᾽ οὔνομα κέκριται ἄλλο.	--- -- u u -uu -uu --	dactylic hexameter	masculine penthemimeral, trithemimeral
ἀλλὰ σύ γ᾽ἢ ῥαφάνοιο πόροις σπειρώδεα κόρσην,	-u u - uu-u u- --uu --	dactylic hexameter	feminine penthemimeral, hepthemimeral, trithemimeral
ἢ ῥυτῆς κλώθοντα περὶ σπάδικα κολούσας:	- -- --u u- uu- ---	dactylic hexameter	feminine penthemimeral, hepthemimeral, trithemimeral
πολλάκι καὶ χαλκοῖο πάλαι μεμογηότος ἄνθην,	-uu - --u u- uu-uu --	dactylic hexameter	feminine penthemimeral, hepthemimeral, trithemimeral
ἄλλοτε κληματόεσσαν ἐν ὄξεϊ θρύπτεο τέφρην:	-uu -uu-u u -uu -uu --	dactylic hexameter	feminine penthemimeral
δήποτε ῥιζάδα τρῖβε πυρίτιδα βάμματι χραίνων	-uu -uu -u u-uu -uu --	dactylic hexameter	feminine penthemimeral
ἠὲ λίτρον, τοτὲ φύλλον ἐναλδόμενον πρασιῇσι	-u u- uu -u u-uu- uu--	dactylic hexameter	feminine penthemimeral, trithemimeral
καρδαμίδος, Μῆδόν τε καὶ ἐμπρίοντα σίνηπυν:	-uu- -- u u ---u u--	dactylic hexameter	masculine penthemimeral, trithemimeral
σὺν δὲ καὶ οἰνηρὴν φλογιῇ τρύγα τεφρώσαιο	- u u --- uu- uu ----	dactylic hexameter	masculine penthemimeral, hepthemimeral
ἠὲ πάτον στρουθοῖο κατοικάδος: ἐκ δὲ βαρεῖαν	-u u- --u u-uu - u u--	dactylic hexameter	feminine penthemimeral, trithemimeral
χεῖρα κατεμματέων ἐρύγοι λωβήμονα κῆρα.	-u u-uu- uu- --uu --	dactylic hexameter	masculine penthemimeral, hepthemimeral
Ἢν δὲ λιπορρίνοιο ποτὸν δυσάλυκτον ἰάψῃ	- u u---u u- uu-u u--	dactylic hexameter	feminine penthemimeral, hepthemimeral
φαρμακίδος σαύρης πανακηδέος ἣν σαλαμάνδρην	-uu- -- uu-uu - uu--	dactylic hexameter	masculine penthemimeral, trithemimeral
κλείουσιν, τὴν οὐδὲ πυρὸς λωβήσατο λιγνύς,	--- - -u u- --uu --	dactylic hexameter	feminine penthemimeral, hepthemimeral, trithemimeral
αἶψα μὲν ἐπρήσθη γλώσσης βάθος, ἂψ δ᾽ὑπὸ μάλκης	-u u --- -- uu - uu --	dactylic hexameter	masculine penthemimeral, hepthemimeral
δάμνανται, βαρύθων δὲ κακὸς τρόμος ἅψεα λύει:	--- uu- u u- uu -uu --	dactylic hexameter	masculine penthemimeral, hepthemimeral, trithemimeral
οἱ δὲ περισφαλόωντες ἅτε βρέφος ἑρπύζουσι	- u u-uu-u u- uu ----	dactylic hexameter	feminine penthemimeral, hepthemimeral
τετραποδί: νοεραὶ γὰρ ἀπὸ φρένες ἀμβλύνονται:	-uu- uu- u u- uu ----	dactylic hexameter	masculine penthemimeral, hepthemimeral, trithemimeral
σάρκα δ᾽ἐπιτροχόωσαι ἀολλέες ἄκρα πελιδναί	-u u-uu-u u-uu -u u--	dactylic hexameter	feminine penthemimeral
σμώδιγγες στίζουσι κεδαιομένης κακότητος.	--- --u u-uu- uu--	dactylic hexameter	feminine penthemimeral, trithemimeral
τῷ δὲ σὺ πολλάκι μὲν πεύκης ἀπὸ δάκρυ᾽ ἀμέρξας	- u u -uu - -- uu -u u--	dactylic hexameter	masculine penthemimeral, hepthemimeral
τενθρήνης ἀνάμιγδα πόροις ἐν πίοσιν ἔργοις,	--- uu-u u- - -uu --	dactylic hexameter	feminine penthemimeral, hepthemimeral, trithemimeral
ἠὲ χαμαιπίτυος βλαστήμονος ἄμμιγα κώνοις	-u u-uu- --uu -uu --	dactylic hexameter	masculine penthemimeral
φύλλα καθεψήσειας ὅσους ἐθρέψατο πεύκη:	-u u---u u- --uu --	dactylic hexameter	feminine penthemimeral, hepthemimeral
ἄλλοτε δὲ σπέραδος κνίδης μυλοεργέι μίσγων	-uu - uu- -- uu-uu --	dactylic hexameter	masculine penthemimeral, hepthemimeral, trithemimeral
τερσαίνοις ὀρόβοιο παλήματι: καί ποτε κνίδην	--- uu-u u-uu - uu --	dactylic hexameter	feminine penthemimeral, trithemimeral
ἑψαλέην κρίμνοισι παλυνάμενος ψαθυροῖσιν	-uu- --u u-uu- uu--	dactylic hexameter	feminine penthemimeral, trithemimeral
εὖ λίπεϊ χραίνοιο, βορῆς δ᾽ἀέκοντα κορέσκοις.	- uu- --u u- uu-u u--	dactylic hexameter	feminine penthemimeral, hepthemimeral, trithemimeral
ναὶ μὴν ῥητίνη τε καὶ ἱερὰ ἔργα μελίσσης	- - --- u u -uu -u u--	dactylic hexameter	masculine penthemimeral
ῥίζα τε χαλβανόεσσα καὶ ὤεα θιβρὰ χελύνης	-u u -uu-u u -uu -u u--	dactylic hexameter	feminine penthemimeral
ἀλθαίνει τότε νέρθε πυρὸς ζαφελοῖο κεραίῃς:	--- uu -u u- uu-u u--	dactylic hexameter	feminine penthemimeral, hepthemimeral, trithemimeral
ἀλθαίνει καὶ γέντα συὸς φλιδόωντος ἀλοιφῇ	--- - -u u- uu-u u--	dactylic hexameter	feminine penthemimeral, hepthemimeral, trithemimeral
ἀμμίγδην ἁλίοιο καθεψηθέντα χελύνης	--- uu-u u---u u--	dactylic hexameter	feminine penthemimeral, trithemimeral
γυίοις ἥ τ᾽ἀκιρῇσι διαπλώει πτερύγεσσιν,	-- - uu-u u--- uu--	dactylic hexameter	feminine penthemimeral, trithemimeral
ἄλλοτε δ᾽οὐρείης κυτισηνόμου ἥν τ᾽ἀκάκητα	-uu --- uu-uu - uu--	dactylic hexameter	masculine penthemimeral
αὐδήεσσαν ἔθηκεν ἀναύδητόν περ ἐοῦσαν	---u u-u u--- u u--	dactylic hexameter	feminine penthemimeral
Ἑρμείης: σαρκὸς γὰρ ἀπ᾽ οὖν νόσφισσε χέλειον	--- -- u u - --u u--	dactylic hexameter	masculine penthemimeral, hepthemimeral, trithemimeral
αἰόλον ἀγκῶνας δὲ δύω παρετείνατο πέζαις.	-uu --- u u- uu-uu --	dactylic hexameter	masculine penthemimeral, hepthemimeral
καί τε σύ γ᾽ἢ γερύνων λαιδροὺς δαμάσαιο τοκῆας	- u u - uu- -- uu-u u--	dactylic hexameter	masculine penthemimeral, hepthemimeral, trithemimeral
ἄμμιγα δὲ ῥίζας ἠρυγγίδας, ἢ καὶ ἐπαρκές	-uu - -- --uu - u u--	dactylic hexameter	masculine penthemimeral, trithemimeral
θάλπε βαλὼν χύτρῳ σκαμμώνιον. οἷσι κορέσκων	-u u- -- --uu -u u--	dactylic hexameter	masculine penthemimeral, trithemimeral
ἀνέρα καὶ θανάτοιο πέλας βεβαῶτα σαώσεις.	-uu - uu-u u- uu-u u--	dactylic hexameter	feminine penthemimeral, hepthemimeral, trithemimeral
Ἤν γε μὲν ἐκ φρυνοῖο θερειομένου ποτὸν ἴσχῃ,	- u u - --u u-uu- uu --	dactylic hexameter	feminine penthemimeral, trithemimeral
ἢ ἔτι καὶ κωφοῖο λαχειδέος ὅς τ᾽ἐνὶ θάμνοις	- uu - --u u-uu - uu --	dactylic hexameter	feminine penthemimeral, trithemimeral
εἴαρι προσφύεται μορόεις λιχμώμενος ἔρσην,	-uu -uu- uu- --uu --	dactylic hexameter	masculine penthemimeral, hepthemimeral
τῶν ἤτοι θερόεις μὲν ἄγει χλόον ἠύτε θάψου,	- -- uu- u u- uu -uu --	dactylic hexameter	masculine penthemimeral, hepthemimeral, trithemimeral
γυῖα δὲ πίμπρησιν, τὸ δὲ συνεχὲς ἀθρόον ἄσθμα	-u u --- u u -uu -uu --	dactylic hexameter	masculine penthemimeral
δύσπνοον ἐκφέρεται παρὰ χείλεσι δ᾽ἐχθρὸν ὄδωδεν.	-uu -uu- uu -uu -u u--	dactylic hexameter	masculine penthemimeral
αὐτὰρ ὅ γ᾽ἄφθογγός τε καὶ ἐν δονάκεσσι θαμίζων	-u u --- u u - uu-u u--	dactylic hexameter	masculine penthemimeral, hepthemimeral
πολλάκι μὲν πύξοιο χλόον κατεχεύατο γυίοις,	-uu - --u u- uu-uu --	dactylic hexameter	feminine penthemimeral, hepthemimeral, trithemimeral
ἄλλοτε δ᾽ὑγραίνει χολόεν στόμα: καί ποτε λυγμοί	-uu --- uu- uu - uu --	dactylic hexameter	masculine penthemimeral, hepthemimeral
ἀνέρα καρδιόωντα θαμειότεροι κλονέουσι:	-uu -uu-u u-uu- uu--	dactylic hexameter	feminine penthemimeral
δὴν δὲ κατικμάζων ἄγονον σπόρον ἄλλοτε φωτός,	- u u--- uu- uu -uu --	dactylic hexameter	masculine penthemimeral, hepthemimeral
πολλάκι θηλυτέρης, σκεδάων γυίοισι τέλεσκε.	-uu -uu- uu- --u u--	dactylic hexameter	masculine penthemimeral, hepthemimeral
ἀλλὰ σὺ τῷ βατράχοιο καθεφθέον ἠὲ καὶ ὀπτήν	-u u - uu-u u-uu -u u --	dactylic hexameter	feminine penthemimeral, trithemimeral
σάρκα πόροις, ὁτὲ πίσσαν ἐν ἡδέι μίγμενος οἴνῃ:	-u u- uu -u u -uu -uu --	dactylic hexameter	feminine penthemimeral, trithemimeral
καί τε σπλὴν ὀλοοῖο κακὸν βάρος ἤρκεσε φρύνης,	- - - uu-u u- uu -uu --	dactylic hexameter	feminine penthemimeral, hepthemimeral, trithemimeral
λιμναίης φρύνης πολυηχέος ἥ τ᾽ἐπὶ φύκει	--- -- uu-uu - uu --	dactylic hexameter	masculine penthemimeral, trithemimeral
πρῶτον ἀπαγγελέουσα βοᾷ θυμάρμενον εἶαρ.	-u u-uu-u u- --uu --	dactylic hexameter	feminine penthemimeral, hepthemimeral
ναὶ μὴν τοῖς ὁτὲ νέκταρ ἀφυσγετὸν ἐν δεπάεσσι	- - - uu -u u-uu - uu--	dactylic hexameter	feminine penthemimeral, trithemimeral
χεύαις εἰς ἔμετον δὲ καὶ οὐ χατέοντα πελάζοις,	-- - uu- u u - uu-u u--	dactylic hexameter	masculine penthemimeral, hepthemimeral, trithemimeral
ἠὲ πίθου φλογιῇ θάλψας κύτος αἰὲν ἐναλθῆ	-u u- uu- -- uu -u u--	dactylic hexameter	masculine penthemimeral, hepthemimeral, trithemimeral
ἀνέρα θερμάσσαιο, χέαι δ᾽ἀπὸ νήχυτον ἱδρῶ:	-uu ---u u- uu -uu --	dactylic hexameter	feminine penthemimeral, hepthemimeral
καί τε καὶ αὐξηρῶν δονάκων ἀπὸ ῥιζέα κόψας	- u u --- uu- uu -uu --	dactylic hexameter	masculine penthemimeral, hepthemimeral
οἴνῃ ἐπεγκεράσαιο, τὰ δή ῥ᾽ὑποτέτροφε λίμνη	-u u-uu-u u - uu-uu --	dactylic hexameter	feminine penthemimeral, hepthemimeral
οἰκείη τόθι λεπτὰ διὲκ ποσὶν ἑρπετὰ νήχει,	--- uu -u u- uu -uu --	dactylic hexameter	feminine penthemimeral, hepthemimeral, trithemimeral
ἠὲ φιλοζώοιο κυπείριδος ἠὲ κυπείρου,	-u u---u u-uu -u u--	dactylic hexameter	feminine penthemimeral
αὐτόν τ᾽ἠνεκέεσσι τρίβοις πανάπαστον ἐδωδῆς	-- -uu-u u- uu-u u--	dactylic hexameter	feminine penthemimeral, hepthemimeral
καὶ πόσιος ξήραινε, κατατρύσαιο δὲ γυῖα.	- uu- --u u---u u --	dactylic hexameter	feminine penthemimeral, trithemimeral
Ἐχθραλέον δέ σε μή τι λιθάργυρος ἀλγινόεσσα	-uu- u u - u u-uu -uu--	dactylic hexameter	masculine penthemimeral, trithemimeral
λήσειεν τότε γαστρὶ πέσῃ βάρος, ἀμφὶ δὲ μέσσον	--- uu -u u- uu -u u --	dactylic hexameter	feminine penthemimeral, hepthemimeral, trithemimeral
πνεύματ᾽ ἀνειλίσσοντα κατ᾽ ὀμφάλιον βρομέῃσιν,	-u u---u u -uu- uu--	dactylic hexameter	feminine penthemimeral
οἷά περ εἰλίγγοιο δυσαλθέος ὅς τε δαμάζει	-u u ---u u-uu - u u--	dactylic hexameter	feminine penthemimeral
ἀνέρας ἀπροφάτοισιν ἐνιπλήσσων ὀδύνῃσιν.	-uu -uu-u u--- uu--	dactylic hexameter	feminine penthemimeral
οὐ μὲν τῶν γ᾽οὔρων ἄνυται ῥύσις, ἀμφὶ δὲ γυῖα	- - - -- uu- uu -u u --	dactylic hexameter	masculine penthemimeral, hepthemimeral, trithemimeral
πίμπραται, αὐτάρ που μολίβῳ εἰδήνατο χροιή.	-uu -- - uu- --uu --	dactylic hexameter	masculine penthemimeral, hepthemimeral
τῷ δ᾽ὁτὲ μὲν σμύρνης ὀδελοῦ πόρε διπλόον ἄχθος,	- uu - -- uu- uu -uu --	dactylic hexameter	masculine penthemimeral, hepthemimeral, trithemimeral
ἄλλοτε δ᾽ὁρμίνοιο νέην χύσιν, ἄλλοτε κόψαις	-uu ---u u- uu -uu --	dactylic hexameter	feminine penthemimeral, hepthemimeral
οὐρείην ὑπέρεικον, ὅθ᾽ ὑσσώπου ὀροδάμνους,	--- uu-u u --- uu--	dactylic hexameter	feminine penthemimeral, trithemimeral
πολλάκι δ᾽ἀγριόεντα κράδην, σπέραδός τε σελίνου	-uu -uu-u u- uu- u u--	dactylic hexameter	feminine penthemimeral, hepthemimeral
Ἴσθμιον, ᾧ θ᾽ὑπὸ κοῦρον ἁλίβλαπτον Μελικέρτην	-uu - uu -u u--- uu--	dactylic hexameter	feminine penthemimeral, trithemimeral
Σισυφίδαι κτερίσαντες ἐπηέξησαν ἀέθλους.	-uu- uu-u u---u u--	dactylic hexameter	feminine penthemimeral, trithemimeral
ἠὲ σύ γ᾽ἐν πέπεριν ῥυτῇ συνομήρεα φώξας	-u u - uu- -- uu-uu --	dactylic hexameter	masculine penthemimeral, hepthemimeral, trithemimeral
οἴνῳ ἐνιτρίψαιο, κακῆς δ᾽ἀπερύκεο νούσου:	-u u---u u- uu-uu --	dactylic hexameter	feminine penthemimeral, hepthemimeral
κύπρου τε βλαστεῖα νεανθέα, πολλάκι σίδης	-- - --u u-uu -uu --	dactylic hexameter	feminine penthemimeral, trithemimeral
πρωτόγονον κυτίνοιο πόροις ἀνθήμονα καρπόν.	-uu- uu-u u- --uu --	dactylic hexameter	feminine penthemimeral, hepthemimeral, trithemimeral
[Μὴ μὲν δὴ σμῖλον σὺ κακὴν ἐλατηίδα μάρψαις	- - - -- u u- uu-uu --	dactylic hexameter	masculine penthemimeral, hepthemimeral, trithemimeral
Οἰταίην, θανάτοιο πολυκλαύτοιο δότειραν,	--- uu-u u---u u--	dactylic hexameter	feminine penthemimeral, trithemimeral
ἥν τε καὶ ἐμπλείουσα χαλικροτέρη πόσις οἴνης	- u u ---u u-uu- uu --	dactylic hexameter	feminine penthemimeral
οἴη ἐπαλθήσειε παρὰ χρέος ἡνίκα φωτός	-u u---u u- uu -uu --	dactylic hexameter	feminine penthemimeral, hepthemimeral
ἴσθμια καὶ φάρυγος στεινὴν ἐμφράσσεται οἶμον.	-uu - uu- -- --uu --	dactylic hexameter	masculine penthemimeral, hepthemimeral, trithemimeral
Καὶ τὰ μὲν οὖν Νίκανδρος ἑῇ ἐνικάτθετο βίβλῳ	- u u - --u u- uu-uu --	dactylic hexameter	feminine penthemimeral, hepthemimeral, trithemimeral
μοχθήεντα μύκητα παρ᾽ ἀνέρι φαρμακόοντα.	---u u-u u -uu -uu--	dactylic hexameter	feminine penthemimeral
πρὸς δ᾽ἔτι τοῖς Δίκτυννα τεῆς ἐχθήρατο κλῶνας	- uu - --u u- --uu --	dactylic hexameter	feminine penthemimeral, hepthemimeral, trithemimeral
Ἥρη τ᾽Ἰμβρασίη μούνη στέφος οὐχ ὑπέδεκτο,	-- -uu- -- uu - uu--	dactylic hexameter	masculine penthemimeral, hepthemimeral
κάλλεος, οὕνεκα Κύπριν, ὅτ᾽ εἰς ἔριν ἠέρθησαν	-uu -uu -u u - uu ----	dactylic hexameter	feminine penthemimeral, hepthemimeral
ἀθάναται, κόσμησεν ἐν Ἰδαίοισιν ὄρεσσι	-uu- --u u ---u u--	dactylic hexameter	feminine penthemimeral, trithemimeral
τῆς σύ γ᾽ἀπ᾽ εὐύδροιο νάπης, εὐαλθὲς ὄνειαρ,	- u u ---u u- --u u--	dactylic hexameter	feminine penthemimeral, hepthemimeral
καρπὸν πορφυρόεντα συναλδέα χειμερίῃσιν	-- -uu-u u-uu -uu--	dactylic hexameter	feminine penthemimeral
ἠελίου θαλφθέντα βολαῖς δοίδυκι λεήνας,	-uu- --u u- --u u--	dactylic hexameter	feminine penthemimeral, hepthemimeral, trithemimeral
χυλὸν ὑπὲρ λεπτῆς ὀθόνης ἢ σχοινίδι κύρτῃ	-u u- -- uu- - -uu --	dactylic hexameter	masculine penthemimeral, hepthemimeral, trithemimeral
ἐκθλίψας πορέειν κυάθου κοτυληδόνα πλήρη	--- uu- uu- uu-uu --	dactylic hexameter	masculine penthemimeral, hepthemimeral, trithemimeral
ἢ πλεῖον, πλεῖον γὰρ ὀνήιον: οὐ γὰρ ἀνιγρόν	- -- -- u u-uu - u u--	dactylic hexameter	masculine penthemimeral, trithemimeral
πῶμα βροτοῖςτόδε γάρ τε καὶ ἄρκιον αἴ κε πίῃσθα.	-u u-uu - u u -uu - u u--	dactylic hexameter	masculine penthemimeral
Καί κ᾽ἔνθ᾽ ὑμνοπόλοιο καὶ εἰσέτι Νικάνδροιο	- - -uu-u u -uu ----	dactylic hexameter	feminine penthemimeral
μνῆστιν ἔχοις, θεσμὸν δὲ Διὸς ξενίοιο φυλάσσοις.	-u u- -- u u- uu-u u--	dactylic hexameter	masculine penthemimeral, hepthemimeral, trithemimeral
