ἦμος δ’ἠριγένεια φάνη ῥοδοδάκτυλος Ἠώς,	-- -uu-u u- uu-uu --	dactylic hexameter	feminine penthemimeral, hepthemimeral
ὤρνυτ’ ἄρ’ ἐξ εὐνῆς ἱερὸν μένος Ἀλκινόοιο,	-u u - -- uu- uu -uu--	dactylic hexameter	masculine penthemimeral, hepthemimeral, trithemimeral
ἂν δ’ἄρα διογενὴς ὦρτο πτολίπορθος Ὀδυσσεύς.	- uu -uu- -- uu-u u--	dactylic hexameter	masculine penthemimeral, hepthemimeral
τοῖσιν δ’ἡγεμόνευ’ ἱερὸν μένος Ἀλκινόοιο	-- -uu- uu- uu -uu--	dactylic hexameter	masculine penthemimeral, hepthemimeral
Φαιήκων ἀγορήνδ’, ἥ σφιν παρὰ νηυσὶ τέτυκτο.	--- uu- - - uu -u u--	dactylic hexameter	masculine penthemimeral, hepthemimeral, trithemimeral
ἐλθόντες δὲ καθῖζον ἐπὶ ξεστοῖσι λίθοισι	--- u u-u u- --u u--	dactylic hexameter	feminine penthemimeral, hepthemimeral, trithemimeral
πλησίον. ἡ δ’ἀνὰ ἄστυ μετῴχετο Παλλὰς Ἀθήνη	-uu - uu -u u-uu -u u--	dactylic hexameter	feminine penthemimeral, trithemimeral
εἰδομένη κήρυκι δαΐφρονος Ἀλκινόοιο,	-uu- --u u-uu -uu--	dactylic hexameter	feminine penthemimeral, trithemimeral
νόστον Ὀδυσσῆϊ μεγαλήτορι μητιόωσα,	-u u--- uu-uu -uu--	dactylic hexameter	masculine penthemimeral
καί ῥα ἑκάστῳ φωτὶ παρισταμένη φάτο μῦθον·	- u u-- -u u-uu- uu --	dactylic hexameter	feminine penthemimeral
δεῦτ’ ἄγε, Φαιήκων ἡγήτορες ἠδὲ μέδοντες,	- uu --- --uu -u u--	dactylic hexameter	masculine penthemimeral
εἰς ἀγορὴν ἰέναι, ὄφρα ξείνοιο πύθησθε,	- uu- uu- -- --u u--	dactylic hexameter	masculine penthemimeral, hepthemimeral, trithemimeral
ὃς νέον Ἀλκινόοιο δαΐφρονος ἵκετο δῶμα	- uu -uu-u u-uu -uu --	dactylic hexameter	feminine penthemimeral
πόντον ἐπιπλαγχθείς, δέμας ἀθανάτοισιν ὁμοῖος.	-u u--- uu -uu-u u--	dactylic hexameter	masculine penthemimeral
ὣς εἰποῦσ’ ὤτρυνε μένος καὶ θυμὸν ἑκάστου.	- -- --u u- - -u u--	dactylic hexameter	feminine penthemimeral, hepthemimeral, trithemimeral
καρπαλίμως δ’ἔμπληντο βροτῶν ἀγοραί τε καὶ ἕδραι	-uu- --u u- uu- u u --	dactylic hexameter	feminine penthemimeral, hepthemimeral, trithemimeral
ἀγρομένων· πολλοὶ δ’ἄρ’ ἐθηήσαντο ἰδόντες	-uu- -- u u---u u--	dactylic hexameter	masculine penthemimeral, trithemimeral
υἱὸν Λαέρταο δαΐφρονα· τῷ δ’ἄρ’ Ἀθήνη	-- ---u u-uu - u u--	dactylic hexameter	feminine penthemimeral
θεσπεσίην κατέχευε χάριν κεφαλῇ τε καὶ ὤμοις	-uu- uu-u u- uu- u u --	dactylic hexameter	feminine penthemimeral, hepthemimeral, trithemimeral
καί μιν μακρότερον καὶ πάσσονα θῆκεν ἰδέσθαι,	- - -uu- - -uu -u u--	dactylic hexameter	masculine penthemimeral
ὥς κεν Φαιήκεσσι φίλος πάντεσσι γένοιτο	- - ---u u- --u u--	dactylic hexameter	feminine penthemimeral, hepthemimeral
δεινός τ’αἰδοῖός τε καὶ ἐκτελέσειεν ἀέθλους	-- --- u u -uu-u u--	dactylic hexameter	masculine penthemimeral
πολλούς, τοὺς Φαίηκες ἐπειρήσαντ’ Ὀδυσῆος.	-- - --u u--- uu--	dactylic hexameter	feminine penthemimeral, trithemimeral
αὐτὰρ ἐπεί ῥ’ἤγερθεν ὁμηγερέες τ’ἐγένοντο,	-u u- --u u-uu- uu--	dactylic hexameter	feminine penthemimeral, trithemimeral
τοῖσιν δ’Ἀλκίνοος ἀγορήσατο καὶ μετέειπε·	-- -uu- uu-uu - uu--	dactylic hexameter	masculine penthemimeral
κέκλυτε, Φαιήκων ἡγήτορες ἠδὲ μέδοντες,	-uu --- --uu -u u--	dactylic hexameter	masculine penthemimeral
ὄφρ’ εἴπω τά με θυμὸς ἐνὶ στήθεσσι κελεύει.	- -- u u -u u- --u u--	dactylic hexameter	feminine penthemimeral, hepthemimeral, trithemimeral
ξεῖνος ὅδ’, οὐκ οἶδ’ ὅς τις, ἀλώμενος ἵκετ’ ἐμὸν δῶ,	-u u - - - u u-uu -u u- -	dactylic hexameter	masculine penthemimeral, trithemimeral
ἠὲ πρὸς ἠοίων ἦ ἑσπερίων ἀνθρώπων·	-u u --- - -uu- ---	dactylic hexameter	masculine penthemimeral
πομπὴν δ’ὀτρύνει, καὶ λίσσεται ἔμπεδον εἶναι.	-- --- - -uu -uu --	dactylic hexameter	masculine penthemimeral
ἡμεῖς δ’,ὡς τὸ πάρος περ, ἐποτρυνώμεθα πομπήν.	-- - u u- u u---uu --	dactylic hexameter	masculine penthemimeral, trithemimeral
οὐδὲ γὰρ οὐδέ τις ἄλλος, ὅτις κ’ἐμὰ δώμαθ’ ἵκηται,	-u u -u u -u u- uu -u u--	dactylic hexameter	feminine penthemimeral, hepthemimeral
ἐνθάδ’ ὀδυρόμενος δηρὸν μένει εἵνεκα πομπῆς.	-u u-uu- -- uu -uu --	dactylic hexameter	masculine penthemimeral, hepthemimeral
ἀλλ’ ἄγε νῆα μέλαιναν ἐρύσσομεν εἰς ἅλα δῖαν	- uu -u u-u u-uu - uu --	dactylic hexameter	feminine penthemimeral
πρωτόπλοον, κούρω δὲ δύω καὶ πεντήκοντα	-uu- -- u u- - ----	dactylic hexameter	masculine penthemimeral, hepthemimeral, trithemimeral
κρινάσθων κατὰ δῆμον, ὅσοι πάρος εἰσὶν ἄριστοι.	--- uu -u u- uu -u u--	dactylic hexameter	feminine penthemimeral, hepthemimeral, trithemimeral
δησάμενοι δ’ἐῢ πάντες ἐπὶ κληῗσιν ἐρετμὰ	-uu- uu -u u- --u u--	dactylic hexameter	feminine penthemimeral, hepthemimeral, trithemimeral
ἔκβητ’· αὐτὰρ ἔπειτα θοὴν ἀλεγύνετε δαῖτα	-- -u u-u u- uu-uu --	dactylic hexameter	feminine penthemimeral, hepthemimeral
ἡμέτερόνδ’ ἐλθόντες· ἐγὼ δ’ἐῢ πᾶσι παρέξω.	-uu- --u u- uu -u u--	dactylic hexameter	feminine penthemimeral, hepthemimeral, trithemimeral
κούροισιν μὲν ταῦτ’ ἐπιτέλλομαι· αὐτὰρ οἱ ἄλλοι	--- - - uu-uu -u u --	dactylic hexameter	masculine penthemimeral, trithemimeral
σκηπτοῦχοι βασιλῆες ἐμὰ πρὸς δώματα καλὰ	--- uu-u u- - -uu --	dactylic hexameter	feminine penthemimeral, hepthemimeral, trithemimeral
ἔρχεσθ’, ὄφρα ξεῖνον ἐνὶ μεγάροις φιλέωμεν,	-- -- -u u- uu- uu--	dactylic hexameter	feminine penthemimeral, hepthemimeral
μηδέ τις ἀρνείσθω. καλέσασθε δὲ θεῖον ἀοιδὸν	-u u --- uu-u u -u u--	dactylic hexameter	masculine penthemimeral
Δημόδοκον· τῷ γάρ ῥα θεὸς πέρι δῶκεν ἀοιδὴν	-uu- - - u u- uu -u u--	dactylic hexameter	masculine penthemimeral, hepthemimeral, trithemimeral
τέρπειν, ὅππῃ θυμὸς ἐποτρύνῃσιν ἀείδειν.	-- -- -u u---u u--	dactylic hexameter	feminine penthemimeral
ὣς ἄρα φωνήσας ἡγήσατο, τοὶ δ’ἅμ’ ἕποντο	- uu --- --uu - u u--	dactylic hexameter	masculine penthemimeral
σκηπτοῦχοι· κῆρυξ δὲ μετῴχετο θεῖον ἀοιδόν.	--- -- u u-uu -u u--	dactylic hexameter	masculine penthemimeral, trithemimeral
κούρω δὲ κρινθέντε δύω καὶ πεντήκοντα	-- - --u u- - ----	dactylic hexameter	feminine penthemimeral, hepthemimeral, trithemimeral
βήτην, ὡς ἐκέλευσ’, ἐπὶ θῖν’ ἁλὸς ἀτρυγέτοιο.	-- - uu- uu - uu -uu--	dactylic hexameter	masculine penthemimeral, hepthemimeral, trithemimeral
αὐτὰρ ἐπεί ῥ’ἐπὶ νῆα κατήλυθον ἠδὲ θάλασσαν,	-u u- uu -u u-uu -u u--	dactylic hexameter	feminine penthemimeral, trithemimeral
νῆα μὲν οἵ γε μέλαιναν ἁλὸς βένθοσδε ἔρυσσαν,	-u u - u u-u u- --u u--	dactylic hexameter	feminine penthemimeral, hepthemimeral, trithemimeral
ἐν δ’ἱστόν τ’ἐτίθεντο καὶ ἱστία νηὶ μελαίνῃ,	- -- uu-u u -uu -u u--	dactylic hexameter	feminine penthemimeral, trithemimeral
ἠρτύναντο δ’ἐρετμὰ τροποῖς ἐν δερματίνοισι,	---u u-u u- - -uu--	dactylic hexameter	feminine penthemimeral, hepthemimeral
πάντα κατὰ μοῖραν, παρὰ δ’ἱστία λευκὰ τάνυσσαν.	-u u- -- uu -uu -u u--	dactylic hexameter	masculine penthemimeral, trithemimeral
ὑψοῦ δ’ἐν νοτίῳ τήν γ’ὥρμισαν· αὐτὰρ ἔπειτα	-- - uu- - -uu -u u--	dactylic hexameter	masculine penthemimeral, trithemimeral
βάν ῥ’ἴμεν Ἀλκινόοιο δαΐφρονος ἐς μέγα δῶμα.	- uu -uu-u u-uu - uu --	dactylic hexameter	feminine penthemimeral
πλῆντο δ’ἄρ’ αἴθουσαί τε καὶ ἕρκεα καὶ δόμοι ἀνδρῶν	-u u --- u u -uu - uu --	dactylic hexameter	masculine penthemimeral
ἀγρομένων· πολλοὶ δ’ἄρ’ ἔσαν, νέοι ἠδὲ παλαιοί.	-uu- -- u u- uu -u u--	dactylic hexameter	masculine penthemimeral, hepthemimeral, trithemimeral
τοῖσιν δ’Ἀλκίνοος δυοκαίδεκα μῆλ’ ἱέρευσεν,	-- -uu- uu-uu - uu--	dactylic hexameter	masculine penthemimeral
ὀκτὼ δ’ἀργιόδοντας ὕας, δύο δ’εἰλίποδας βοῦς·	-- -uu-u u- uu -uu- -	dactylic hexameter	feminine penthemimeral, hepthemimeral
τοὺς δέρον ἀμφί θ’ἕπον, τετύκοντό τε δαῖτ’ ἐρατεινήν.	- uu -u u- uu-u u - uu--	dactylic hexameter	masculine penthemimeral
κῆρυξ δ’ἐγγύθεν ἦλθεν ἄγων ἐρίηρον ἀοιδόν,	-- -uu -u u- uu-u u--	dactylic hexameter	feminine penthemimeral, hepthemimeral
τὸν πέρι Μοῦσ’ ἐφίλησε, δίδου δ’ἀγαθόν τε κακόν τε·	- uu - uu-u u- uu- u u- -	dactylic hexameter	feminine penthemimeral, hepthemimeral, trithemimeral
ὀφθαλμῶν μὲν ἄμερσε, δίδου δ’ἡδεῖαν ἀοιδήν.	--- u u-u u- --u u--	dactylic hexameter	feminine penthemimeral, hepthemimeral, trithemimeral
τῷ δ’ἄρα Ποντόνοος θῆκε θρόνον ἀργυρόηλον	- uu -uu- -- uu -uu--	dactylic hexameter	masculine penthemimeral, hepthemimeral
μέσσῳ δαιτυμόνων, πρὸς κίονα μακρὸν ἐρείσας·	-- -uu- - -uu -u u--	dactylic hexameter	masculine penthemimeral
κὰδ δ’ἐκ πασσαλόφιν κρέμασεν φόρμιγγα λίγειαν	- - -uu- uu- --u u--	dactylic hexameter	masculine penthemimeral, hepthemimeral
αὐτοῦ ὑπὲρ κεφαλῆς καὶ ἐπέφραδε χερσὶν ἑλέσθαι	-u u- uu- u u-uu -u u--	dactylic hexameter	masculine penthemimeral, trithemimeral
κῆρυξ· πὰρ δ’ἐτίθει κάνεον καλήν τε τράπεζαν,	-- - uu- uu- -- u u--	dactylic hexameter	masculine penthemimeral, hepthemimeral, trithemimeral
πὰρ δὲ δέπας οἴνοιο, πιεῖν ὅτε θυμὸς ἀνώγοι.	- u u- --u u- uu -u u--	dactylic hexameter	feminine penthemimeral, hepthemimeral, trithemimeral
οἱ δ’ἐπ’ ὀνείαθ’ ἑτοῖμα προκείμενα χεῖρας ἴαλλον.	- u u-u u-u u-uu -u u--	dactylic hexameter	feminine penthemimeral
αὐτὰρ ἐπεὶ πόσιος καὶ ἐδητύος ἐξ ἔρον ἕντο,	-u u- uu- u u-uu - uu --	dactylic hexameter	masculine penthemimeral, trithemimeral
μοῦσ’ ἄρ’ ἀοιδὸν ἀνῆκεν ἀειδέμεναι κλέα ἀνδρῶν,	- u u-u u-u u-uu- uu --	dactylic hexameter	feminine penthemimeral
οἴμης τῆς τότ’ ἄρα κλέος οὐρανὸν εὐρὺν ἵκανε,	-- - u u- uu -uu -u u--	dactylic hexameter	masculine penthemimeral, trithemimeral
νεῖκος Ὀδυσσῆος καὶ Πηλεΐδεω Ἀχιλῆος,	-u u--- - -uu- uu--	dactylic hexameter	masculine penthemimeral
ὥς ποτε δηρίσαντο θεῶν ἐν δαιτὶ θαλείῃ	- uu ---u u- - -u u--	dactylic hexameter	feminine penthemimeral, hepthemimeral
ἐκπάγλοις ἐπέεσσιν, ἄναξ δ’ἀνδρῶν Ἀγαμέμνων	--- uu-u u- -- uu--	dactylic hexameter	feminine penthemimeral, hepthemimeral, trithemimeral
χαῖρε νόῳ, ὅτ’ ἄριστοι Ἀχαιῶν δηριόωντο.	-u u- u u-u u-- -uu--	dactylic hexameter	feminine penthemimeral, trithemimeral
ὣς γάρ οἱ χρείων μυθήσατο Φοῖβος Ἀπόλλων	- - - -- --uu -u u--	dactylic hexameter	masculine penthemimeral, trithemimeral
Πυθοῖ ἐν ἠγαθέῃ, ὅθ’ ὑπέρβη λάϊνον οὐδὸν	-u u -uu- u u-- -uu --	dactylic hexameter	masculine penthemimeral
χρησόμενος· τότε γάρ ῥα κυλίνδετο πήματος ἀρχὴ	-uu- uu - u u-uu -uu --	dactylic hexameter	masculine penthemimeral, trithemimeral
Τρωσί τε καὶ Δαναοῖσι Διὸς μεγάλου διὰ βουλάς.	-u u - uu-u u- uu- uu --	dactylic hexameter	feminine penthemimeral, hepthemimeral, trithemimeral
ταῦτ’ ἄρ’ ἀοιδὸς ἄειδε περικλυτός· αὐτὰρ Ὀδυσσεὺς	- u u-u u-u u-uu -u u--	dactylic hexameter	feminine penthemimeral
πορφύρεον μέγα φᾶρος ἑλὼν χερσὶ στιβαρῇσι	-uu- uu -u u- -- uu--	dactylic hexameter	feminine penthemimeral, hepthemimeral, trithemimeral
κὰκ κεφαλῆς εἴρυσσε, κάλυψε δὲ καλὰ πρόσωπα·	- uu- --u u-u u -u u--	dactylic hexameter	feminine penthemimeral, trithemimeral
αἴδετο γὰρ Φαίηκας ὑπ’ ὀφρύσι δάκρυα λείβων.	-uu - --u u -uu -uu --	dactylic hexameter	feminine penthemimeral, trithemimeral
ἤτοι ὅτε λήξειεν ἀείδων θεῖος ἀοιδός,	-u u- --u u-- -u u--	dactylic hexameter	feminine penthemimeral, trithemimeral
δάκρυ ὀμορξάμενος κεφαλῆς ἄπο φᾶρος ἕλεσκε	-u u-uu- uu- uu -u u--	dactylic hexameter	masculine penthemimeral, hepthemimeral
καὶ δέπας ἀμφικύπελλον ἑλὼν σπείσασκε θεοῖσιν·	- uu -uu-u u- --u u--	dactylic hexameter	feminine penthemimeral, hepthemimeral
αὐτὰρ ὅτ’ ἂψ ἄρχοιτο καὶ ὀτρύνειαν ἀείδειν	-u u - --u u ---u u--	dactylic hexameter	feminine penthemimeral, trithemimeral
Φαιήκων οἱ ἄριστοι, ἐπεὶ τέρποντ’ ἐπέεσσιν,	--- u u-u u- -- uu--	dactylic hexameter	feminine penthemimeral, hepthemimeral, trithemimeral
ἂψ Ὀδυσεὺς κατὰ κρᾶτα καλυψάμενος γοάασκεν.	- uu- uu -u u-uu- uu--	dactylic hexameter	feminine penthemimeral, trithemimeral
ἔνθ’ ἄλλους μὲν πάντας ἐλάνθανε δάκρυα λείβων,	- -- - -u u-uu -uu --	dactylic hexameter	feminine penthemimeral, trithemimeral
Ἀλκίνοος δέ μιν οἶος ἐπεφράσατ’ ἠδ’ ἐνόησεν	-uu- u u -u u-uu - uu--	dactylic hexameter	feminine penthemimeral, trithemimeral
ἥμενος ἄγχ’ αὐτοῦ, βαρὺ δὲ στενάχοντος ἄκουσεν.	-uu - -- uu - uu-u u--	dactylic hexameter	masculine penthemimeral, hepthemimeral, trithemimeral
αἶψα δὲ Φαιήκεσσι φιληρέτμοισι μετηύδα·	-u u ---u u---u u--	dactylic hexameter	feminine penthemimeral
κέκλυτε, Φαιήκων ἡγήτορες ἠδὲ μέδοντες.	-uu --- --uu -u u--	dactylic hexameter	masculine penthemimeral
ἤδη μὲν δαιτὸς κεκορήμεθα θυμὸν ἐΐσης	-- - -- uu-uu -u u--	dactylic hexameter	masculine penthemimeral, trithemimeral
φόρμιγγός θ’,ἣ δαιτὶ συνήορός ἐστι θαλείῃ·	--- - -u u-uu -u u--	dactylic hexameter	feminine penthemimeral, trithemimeral
νῦν δ’ἐξέλθωμεν καὶ ἀέθλων πειρηθῶμεν	- ---- u u-- ----	dactylic hexameter	masculine penthemimeral
πάντων, ὥς χ’ὁ ξεῖνος ἐνίσπῃ οἷσι φίλοισιν	-- - - -u u-- -u u--	dactylic hexameter	feminine penthemimeral, trithemimeral
οἴκαδε νοστήσας, ὅσσον περιγινόμεθ’ ἄλλων	-uu --- -- uu-uu --	dactylic hexameter	masculine penthemimeral, hepthemimeral
πύξ τε παλαισμοσύνῃ τε καὶ ἅλμασιν ἠδὲ πόδεσσιν.	- u u-uu- u u -uu -u u--	dactylic hexameter	masculine penthemimeral
ὣς ἄρα φωνήσας ἡγήσατο, τοὶ δ’ἅμ’ ἕποντο.	- uu --- --uu - u u--	dactylic hexameter	masculine penthemimeral
κὰδ δ’ἐκ πασσαλόφιν κρέμασεν φόρμιγγα λίγειαν,	- - -uu- uu- --u u--	dactylic hexameter	masculine penthemimeral, hepthemimeral
Δημοδόκου δ’ἕλε χεῖρα καὶ ἔξαγεν ἐκ μεγάροιο	-uu- uu -u u -uu - uu--	dactylic hexameter	feminine penthemimeral, trithemimeral
κῆρυξ· ἦρχε δὲ τῷ αὐτὴν ὁδὸν ἥν περ οἱ ἄλλοι	-- -u u - -- uu - u u --	dactylic hexameter	masculine penthemimeral, hepthemimeral
Φαιήκων οἱ ἄριστοι, ἀέθλια θαυμανέοντες.	--- u u-u u-uu -uu--	dactylic hexameter	feminine penthemimeral, trithemimeral
βὰν δ’ἴμεν εἰς ἀγορήν, ἅμα δ’ἕσπετο πουλὺς ὅμιλος,	- uu - uu- uu -uu -u u--	dactylic hexameter	masculine penthemimeral, trithemimeral
μυρίοι· ἂν δ’ἵσταντο νέοι πολλοί τε καὶ ἐσθλοί.	-uu - --u u- -- u u --	dactylic hexameter	feminine penthemimeral, hepthemimeral, trithemimeral
ὦρτο μὲν Ἀκρόνεώς τε καὶ Ὠκύαλος καὶ Ἐλατρεύς,	-u u -uu- u u -uu- u u--	dactylic hexameter	masculine penthemimeral
Ναυτεύς τε Πρυμνεύς τε καὶ Ἀγχίαλος καὶ Ἐρετμεύς,	-- - -- u u -uu- u u--	dactylic hexameter	masculine penthemimeral, trithemimeral
Ποντεύς τε Πρωρεύς τε, Θόων Ἀναβησίνεώς τε	-- - -- u u- uu-uu- -	dactylic hexameter	masculine penthemimeral, hepthemimeral, trithemimeral
Ἀμφίαλός θ’,υἱὸς Πολυνήου Τεκτονίδαο·	-uu- -- uu-- -uu--	dactylic hexameter	masculine penthemimeral, trithemimeral
ἂν δὲ καὶ Εὐρύαλος, βροτολοιγῷ ἶσος Ἄρηϊ,	- u u -uu- uu-- -u u--	dactylic hexameter	masculine penthemimeral
Ναυβολίδης θ’ὃς ἄριστος ἔην εἶδός τε δέμας τε	-uu- u u-u u- -- u u- -	dactylic hexameter	feminine penthemimeral, hepthemimeral, trithemimeral
πάντων Φαιήκων μετ’ ἀμύμονα Λαοδάμαντα.	-- --- u u-uu -uu--	dactylic hexameter	masculine penthemimeral
ἂν δ’ἔσταν τρεῖς παῖδες ἀμύμονος Ἀλκινόοιο,	- -- - -u u-uu -uu--	dactylic hexameter	feminine penthemimeral, trithemimeral
Λαοδάμας θ’Ἅλιός τε καὶ ἀντίθεος Κλυτόνηος.	-uu- uu- u u -uu- uu--	dactylic hexameter	masculine penthemimeral, trithemimeral
οἱ δ’ἤτοι πρῶτον μὲν ἐπειρήσαντο πόδεσσι.	- -- -- u u---u u--	dactylic hexameter	masculine penthemimeral, trithemimeral
τοῖσι δ’ἀπὸ νύσσης τέτατο δρόμος· οἱ δ’ἅμα πάντες	-u u- -- uu- uu - uu --	dactylic hexameter	masculine penthemimeral, hepthemimeral, trithemimeral
καρπαλίμως ἐπέτοντο κονίοντες πεδίοιο·	-uu- uu-u u--- uu--	dactylic hexameter	feminine penthemimeral, trithemimeral
τῶν δὲ θέειν ὄχ’ ἄριστος ἔην Κλυτόνηος ἀμύμων·	- u u- u u-u u- uu-u u--	dactylic hexameter	feminine penthemimeral, hepthemimeral, trithemimeral
ὅσσον τ’ἐν νειῷ οὖρον πέλει ἡμιόνοιϊν,	-- - -- -- uu -uu--	dactylic hexameter	masculine penthemimeral, hepthemimeral, trithemimeral
τόσσον ὑπεκπροθέων λαοὺς ἵκεθ’, οἱ δ’ἐλίποντο.	-u u-uu- -- uu - uu--	dactylic hexameter	masculine penthemimeral, hepthemimeral
οἱ δὲ παλαισμοσύνης ἀλεγεινῆς πειρήσαντο·	- u u-uu- uu-- ----	dactylic hexameter	masculine penthemimeral
τῇ δ’αὖτ’ Εὐρύαλος ἀπεκαίνυτο πάντας ἀρίστους.	- - -uu- uu-uu -u u--	dactylic hexameter	masculine penthemimeral
ἅλματι δ’Ἀμφίαλος πάντων προφερέστατος ἦεν·	-uu -uu- -- uu-uu --	dactylic hexameter	masculine penthemimeral, hepthemimeral
δίσκῳ δ’αὖ πάντων προφερέστατος ἦεν Ἐλατρεύς,	-- - -- uu-uu -u u--	dactylic hexameter	masculine penthemimeral, trithemimeral
πὺξ δ’αὖ Λαοδάμας, ἀγαθὸς πάϊς Ἀλκινόοιο.	- - -uu- uu- uu -uu--	dactylic hexameter	masculine penthemimeral, hepthemimeral
αὐτὰρ ἐπεὶ δὴ πάντες ἐτέρφθησαν φρέν’ ἀέθλοις,	-u u- - -u u--- u u--	dactylic hexameter	feminine penthemimeral, trithemimeral
τοῖς ἄρα Λαοδάμας μετέφη πάϊς Ἀλκινόοιο·	- uu -uu- uu- uu -uu--	dactylic hexameter	masculine penthemimeral, hepthemimeral
δεῦτε, φίλοι, τὸν ξεῖνον ἐρώμεθα εἴ τιν’ ἄεθλον	-u u- - -u u-uu - u u--	dactylic hexameter	feminine penthemimeral, trithemimeral
οἶδέ τε καὶ δεδάηκε. φυήν γε μὲν οὐ κακός ἐστι,	-u u - uu-u u- u u - uu --	dactylic hexameter	feminine penthemimeral, hepthemimeral, trithemimeral
μηρούς τε κνήμας τε καὶ ἄμφω χεῖρας ὕπερθεν	-- - -- u u -- -u u--	dactylic hexameter	masculine penthemimeral, trithemimeral
αὐχένα τε στιβαρὸν μέγα τε σθένος· οὐδέ τι ἥβης	-uu - uu- uu - uu -u u --	dactylic hexameter	masculine penthemimeral, hepthemimeral, trithemimeral
δεύεται, ἀλλὰ κακοῖσι συνέρρηκται πολέεσσιν·	-uu -u u-u u--- uu--	dactylic hexameter	feminine penthemimeral
οὐ γὰρ ἔγωγέ τί φημι κακώτερον ἄλλο θαλάσσης	- u u-u u -u u-uu -u u--	dactylic hexameter	feminine penthemimeral
ἄνδρα γε συγχεῦαι, εἰ καὶ μάλα καρτερὸς εἴη.	-u u --- - - uu -uu --	dactylic hexameter	masculine penthemimeral, hepthemimeral
τὸν δ’αὖτ’ Εὐρύαλος ἀπαμείβετο φώνησέν τε·	- - -uu- uu-uu --- -	dactylic hexameter	masculine penthemimeral
Λαοδάμα, μάλα τοῦτο ἔπος κατὰ μοῖραν ἔειπες.	-uu- uu -u u- uu -u u--	dactylic hexameter	feminine penthemimeral, hepthemimeral, trithemimeral
αὐτὸς νῦν προκάλεσσαι ἰὼν καὶ πέφραδε μῦθον.	-- - uu-u u- - -uu --	dactylic hexameter	feminine penthemimeral, hepthemimeral, trithemimeral
αὐτὰρ ἐπεὶ τό γ’ἄκουσ’ ἀγαθὸς πάϊς Ἀλκινόοιο,	-u u- u u- uu- uu -uu--	dactylic hexameter	masculine penthemimeral, hepthemimeral, trithemimeral
στῆ ῥ’ἐς μέσσον ἰὼν καὶ Ὀδυσσῆα προσέειπε·	- - -u u- u u--- uu--	dactylic hexameter	masculine penthemimeral
δεῦρ’ ἄγε καὶ σύ, ξεῖνε πάτερ, πείρησαι ἀέθλων,	- uu - - -u u- --u u--	dactylic hexameter	feminine penthemimeral, hepthemimeral, trithemimeral
εἴ τινά που δεδάηκας· ἔοικε δέ σ’ἴδμεν ἀέθλους·	- uu - uu-u u-u u -u u--	dactylic hexameter	feminine penthemimeral, trithemimeral
οὐ μὲν γὰρ μεῖζον κλέος ἀνέρος ὄφρα κεν ᾖσιν,	- - - -- uu -uu -u u --	dactylic hexameter	masculine penthemimeral, trithemimeral
ἤ ὅ τι ποσσίν τε ῥέξῃ καὶ χερσὶν ἑῇσιν.	- u u -- - -- - -u u--	dactylic hexameter	masculine penthemimeral, hepthemimeral
ἀλλ’ ἄγε πείρησαι, σκέδασον δ’ἀπὸ κήδεα θυμοῦ.	- uu --- uu- uu -uu --	dactylic hexameter	masculine penthemimeral, hepthemimeral
σοὶ δ’ὁδὸς οὐκέτι δηρὸν ἀπέσσεται, ἀλλά τοι ἤδη	- uu -uu -u u-uu -u u --	dactylic hexameter	feminine penthemimeral
νηῦς τε κατείρυσται καὶ ἐπαρτέες εἰσὶν ἑταῖροι.	- u u--- u u-uu -u u--	dactylic hexameter	masculine penthemimeral
τὸν δ’ἀπαμειβόμενος προσέφη πολύμητις Ὀδυσσεύς·	- uu-uu- uu- uu-u u--	dactylic hexameter	masculine penthemimeral, hepthemimeral
Λαοδάμα, τί με ταῦτα κελεύετε κερτομέοντες;	-uu- u u -u u-uu -uu--	dactylic hexameter	feminine penthemimeral, trithemimeral
κήδεά μοι καὶ μᾶλλον ἐνὶ φρεσὶν ἤ περ ἄεθλοι,	-uu - - -u u- uu - u u--	dactylic hexameter	feminine penthemimeral, hepthemimeral, trithemimeral
ὃς πρὶν μὲν μάλα πόλλ’ ἔπαθον καὶ πόλλ’ ἐμόγησα,	- - - uu - uu- - - uu--	dactylic hexameter	masculine penthemimeral, hepthemimeral, trithemimeral
νῦν δὲ μεθ’ ὑμετέρῃ ἀγορῇ νόστοιο χατίζων	- u u -uu- uu- --u u--	dactylic hexameter	masculine penthemimeral, hepthemimeral
ἧμαι, λισσόμενος βασιλῆά τε πάντα τε δῆμον.	-- -uu- uu-u u -u u --	dactylic hexameter	masculine penthemimeral
τὸν δ’αὖτ’ Εὐρύαλος ἀπαμείβετο νείκεσέ τ’ἄντην·	- - -uu- uu-uu -uu --	dactylic hexameter	masculine penthemimeral
οὐ γάρ σ’οὐδέ, ξεῖνε, δαήμονι φωτὶ ἐΐσκω	- - -- -u u-uu -u u--	dactylic hexameter	feminine penthemimeral
ἄθλων, οἷά τε πολλὰ μετ’ ἀνθρώποισι πέλονται,	-- -u u -u u ---u u--	dactylic hexameter	feminine penthemimeral
ἀλλὰ τῷ, ὅς θ’ἅμα νηὶ πολυκλήϊδι θαμίζων,	-u u - uu -u u---u u--	dactylic hexameter	feminine penthemimeral, trithemimeral
ἀρχὸς ναυτάων οἵ τε πρηκτῆρες ἔασι,	-- --- - - --u u--	dactylic hexameter	masculine penthemimeral, hepthemimeral
φόρτου τε μνήμων καὶ ἐπίσκοπος ᾖσιν ὁδαίων	-- - -- u u-uu -u u--	dactylic hexameter	masculine penthemimeral, trithemimeral
κερδέων θ’ἁρπαλέων· οὐδ’ ἀθλητῆρι ἔοικας.	-- -uu- - ---u u--	dactylic hexameter	masculine penthemimeral
τὸν δ’ἄρ’ ὑπόδρα ἰδὼν προσέφη πολύμητις Ὀδυσσεύς·	- u u-u u- uu- uu-u u--	dactylic hexameter	masculine penthemimeral, hepthemimeral
ξεῖν’, οὐ καλὸν ἔειπες· ἀτασθάλῳ ἀνδρὶ ἔοικας.	- - -u u-u u-uu -u u--	dactylic hexameter	feminine penthemimeral
οὕτως οὐ πάντεσσι θεοὶ χαρίεντα διδοῦσιν	-- - --u u- uu-u u--	dactylic hexameter	feminine penthemimeral, hepthemimeral, trithemimeral
ἀνδράσιν, οὔτε φυὴν οὔτ’ ἂρ φρένας οὔτ’ ἀγορητύν.	-uu -u u- - - uu - uu--	dactylic hexameter	masculine penthemimeral, hepthemimeral
ἄλλος μὲν γάρ τ’εἶδος ἀκιδνότερος πέλει ἀνήρ,	-- - - -u u-uu- uu --	dactylic hexameter	feminine penthemimeral, trithemimeral
ἀλλὰ θεὸς μορφὴν ἔπεσι στέφει, οἱ δέ τ’ἐς αὐτὸν	-u u- -- uu- uu - u u --	dactylic hexameter	masculine penthemimeral, hepthemimeral, trithemimeral
τερπόμενοι λεύσσουσιν· ὁ δ’ἀσφαλέως ἀγορεύει	-uu- --u u -uu- uu--	dactylic hexameter	feminine penthemimeral, trithemimeral
αἰδοῖ μειλιχίῃ, μετὰ δὲ πρέπει ἀγρομένοισιν,	-- -uu- uu - uu -uu--	dactylic hexameter	masculine penthemimeral, hepthemimeral
ἐρχόμενον δ’ἀνὰ ἄστυ θεὸν ὣς εἰσορόωσιν.	-uu- uu -u u- - -uu--	dactylic hexameter	feminine penthemimeral, hepthemimeral, trithemimeral
ἄλλος δ’αὖτ’ εἶδος μὲν ἀλίγκιος ἀθανάτοισιν,	-- - -- u u-uu -uu--	dactylic hexameter	masculine penthemimeral, trithemimeral
ἀλλ’ οὔ οἱ χάρις ἀμφὶ περιστέφεται ἐπέεσσιν,	- - - uu -u u-uu- uu--	dactylic hexameter	feminine penthemimeral, trithemimeral
ὡς καὶ σοὶ εἶδος μὲν ἀριπρεπές, οὐδέ κεν ἄλλως	- - - -- u u-uu -u u --	dactylic hexameter	masculine penthemimeral, trithemimeral
οὐδὲ θεὸς τεύξειε, νόον δ’ἀποφώλιός ἐσσι.	-u u- --u u- uu-uu --	dactylic hexameter	feminine penthemimeral, hepthemimeral, trithemimeral
ὤρινάς μοι θυμὸν ἐνὶ στήθεσσι φίλοισιν	--- - -u u- --u u--	dactylic hexameter	feminine penthemimeral, hepthemimeral, trithemimeral
εἰπὼν οὐ κατὰ κόσμον. ἐγὼ δ’οὐ νῆϊς ἀέθλων,	-- - uu -u u- - -u u--	dactylic hexameter	feminine penthemimeral, hepthemimeral, trithemimeral
ὡς σύ γε μυθεῖαι, ἀλλ’ ἐν πρώτοισιν ὀΐω	- u u --- - - --u u--	dactylic hexameter	masculine penthemimeral, hepthemimeral
ἔμμεναι, ὄφρ’ ἥβῃ τε πεποίθεα χερσί τ’ἐμῇσι.	-uu - -- u u-uu -u u--	dactylic hexameter	masculine penthemimeral, trithemimeral
νῦν δ’ἔχομαι κακότητι καὶ ἄλγεσι· πολλὰ γὰρ ἔτλην	- uu- uu-u u -uu -u u --	dactylic hexameter	feminine penthemimeral, trithemimeral
ἀνδρῶν τε πτολέμους ἀλεγεινά τε κύματα πείρων.	-- - uu- uu-u u -uu --	dactylic hexameter	masculine penthemimeral, trithemimeral
ἀλλὰ καὶ ὥς, κακὰ πολλὰ παθών, πειρήσομ’ ἀέθλων·	-u u - uu -u u- --u u--	dactylic hexameter	feminine penthemimeral, hepthemimeral, trithemimeral
θυμοδακὴς γὰρ μῦθος, ἐπώτρυνας δέ με εἰπών.	-uu- - -u u--- u u --	dactylic hexameter	feminine penthemimeral, trithemimeral
ἦ ῥα καὶ αὐτῷ φάρει ἀναΐξας λάβε δίσκον	- u u -- -u u--- uu --	dactylic hexameter	feminine penthemimeral
μείζονα καὶ πάχετον, στιβαρώτερον οὐκ ὀλίγον περ	-uu - uu- uu-uu - uu- -	dactylic hexameter	masculine penthemimeral, trithemimeral
ἢ οἵῳ Φαίηκες ἐδίσκεον ἀλλήλοισι.	- -- --u u-uu ----	dactylic hexameter	feminine penthemimeral, trithemimeral
τόν ῥα περιστρέψας ἧκε στιβαρῆς ἀπὸ χειρός,	- u u--- -- uu- uu --	dactylic hexameter	masculine penthemimeral, hepthemimeral
βόμβησεν δὲ λίθος· κατὰ δ’ἔπτηξαν ποτὶ γαίῃ	--- u u- uu --- uu --	dactylic hexameter	masculine penthemimeral, trithemimeral
Φαίηκες δολιχήρετμοι, ναυσίκλυτοι ἄνδρες,	--- uu--- --uu --	dactylic hexameter	hepthemimeral, trithemimeral
λᾶος ὑπὸ ῥιπῆς· ὁ δ’ὑπέρπτατο σήματα πάντων	-u u- -- u u-uu -uu --	dactylic hexameter	masculine penthemimeral, trithemimeral
ῥίμφα θέων ἀπὸ χειρός. ἔθηκε δὲ τέρματ’ Ἀθήνη	-u u- uu -u u-u u -u u--	dactylic hexameter	feminine penthemimeral, trithemimeral
ἀνδρὶ δέμας ἐϊκυῖα, ἔπος τ’ἔφατ’ ἔκ τ’ὀνόμαζε·	-u u- uu-u u- uu - uu--	dactylic hexameter	feminine penthemimeral, hepthemimeral, trithemimeral
καί κ’ἀλαός τοι, ξεῖνε, διακρίνειε τὸ σῆμα	- uu- - -u u---u u --	dactylic hexameter	feminine penthemimeral, trithemimeral
ἀμφαφόων, ἐπεὶ οὔ τι μεμιγμένον ἐστὶν ὁμίλῳ,	-uu- uu - u u-uu -u u--	dactylic hexameter	masculine penthemimeral, trithemimeral
ἀλλὰ πολὺ πρῶτον. σὺ δὲ θάρσει τόνδε γ’ἄεθλον·	-u u- -- u u -- -u u--	dactylic hexameter	masculine penthemimeral, trithemimeral
οὔ τις Φαιήκων τόν γ’ἵξεται, οὐδ’ ὑπερήσει.	- - --- - -uu - uu--	dactylic hexameter	masculine penthemimeral
ὣς φάτο, γήθησεν δὲ πολύτλας δῖος Ὀδυσσεύς,	- uu --- u u-- -u u--	dactylic hexameter	masculine penthemimeral
χαὶρων, οὕνεχ’ ἑταῖρον ἐνηέα λεῦσσ’ ἐν ἀγῶνι.	-- -u u-u u-uu - u u--	dactylic hexameter	feminine penthemimeral
καὶ τότε κουφότερον μετεφώνεε Φαιήκεσσι·	- uu -uu- uu-uu ----	dactylic hexameter	masculine penthemimeral
τοῦτον νῦν ἀφίκεσθε, νέοι. τάχα δ’ὕστερον ἄλλον	-- - uu-u u- uu -uu --	dactylic hexameter	feminine penthemimeral, hepthemimeral, trithemimeral
ἥσειν ἢ τοσσοῦτον ὀΐομαι ἢ ἔτι μᾶσσον.	-- - --u u-uu - uu --	dactylic hexameter	feminine penthemimeral, trithemimeral
τῶν δ’ἄλλων ὅτινα κραδίη θυμός τε κελεύει,	- -- uu- uu- -- u u--	dactylic hexameter	masculine penthemimeral, hepthemimeral, trithemimeral
δεῦρ’ ἄγε πειρηθήτω, ἐπεί μ’ἐχολώσατε λίην,	- uu ---u u- uu-uu --	dactylic hexameter	feminine penthemimeral, hepthemimeral
ἢ πὺξ ἠὲ πάλῃ ἢ καὶ ποσίν, οὔ τι μεγαίρω,	- - -u u- - - uu - u u--	dactylic hexameter	masculine penthemimeral, hepthemimeral
πάντων Φαιήκων, πλήν γ’αὐτοῦ Λαοδάμαντος.	-- --- - -- -uu--	dactylic hexameter	masculine penthemimeral
ξεῖνος γάρ μοι ὅδ’ ἐστί· τίς ἂν φιλέοντι μάχοιτο;	-- - u u -u u - uu-u u--	dactylic hexameter	feminine penthemimeral, hepthemimeral, trithemimeral
ἄφρων nbsp;δὴ κεῖνός γε καὶ οὐτιδανὸς πέλει ἀνήρ,	-- - -- u u -uu- uu --	dactylic hexameter	masculine penthemimeral, trithemimeral
ὅς τις ξεινοδόκῳ ἔριδα προφέρηται ἀέθλων	- - -uu- uu- uu-u u--	dactylic hexameter	masculine penthemimeral, hepthemimeral
δήμῳ ἐν ἀλλοδαπῷ· ἕο δ’αὐτοῦ πάντα κολούει.	-u u -uu- - -- -u u--	dactylic hexameter	masculine penthemimeral
τῶν δ’ἄλλων οὔ πέρ τιν’ ἀναίνομαι οὐδ’ ἀθερίζω,	- -- - - u u-uu - uu--	dactylic hexameter	masculine penthemimeral, trithemimeral
ἀλλ’ ἐθέλω ἴδμεν καὶ πειρηθήμεναι ἄντην.	- uu- -- - ---uu --	dactylic hexameter	masculine penthemimeral, trithemimeral
πάντα γὰρ οὐ κακός εἰμι, μετ’ ἀνδράσιν ὅσσοι ἄεθλοι·	-u u - uu -u u -uu -u u--	dactylic hexameter	feminine penthemimeral, trithemimeral
εὖ μὲν τόξον οἶδα ἐΰξοον ἀμφαφάασθαι·	- - -- -u u-uu -uu--	dactylic hexameter	feminine penthemimeral
πρῶτός κ’ἄνδρα βάλοιμι ὀϊστεύσας ἐν ὁμίλῳ	-- -u u-u u--- u u--	dactylic hexameter	feminine penthemimeral
ἀνδρῶν δυσμενέων, εἰ καὶ μάλα πολλοὶ ἑταῖροι	-- -uu- - - uu -u u--	dactylic hexameter	masculine penthemimeral, hepthemimeral
ἄγχι παρασταῖεν καὶ τοξαζοίατο φωτῶν.	-u u--- - ---uu --	dactylic hexameter	masculine penthemimeral
οἶος δή με Φιλοκτήτης ἀπεκαίνυτο τόξῳ	-- - u u--- uu-uu --	dactylic hexameter	hepthemimeral, trithemimeral
δήμῳ ἔνι Τρώων, ὅτε τοξαζοίμεθ’ Ἀχαιοί.	-u u- -- uu ---u u--	dactylic hexameter	masculine penthemimeral, trithemimeral
τῶν δ’ἄλλων ἐμέ φημι πολὺ προφερέστερον εἶναι,	- -- uu -u u- uu-uu --	dactylic hexameter	feminine penthemimeral, hepthemimeral, trithemimeral
ὅσσοι νῦν βροτοί εἰσιν ἐπὶ χθονὶ σῖτον ἔδοντες.	-- - uu -u u- uu -u u--	dactylic hexameter	feminine penthemimeral, hepthemimeral, trithemimeral
ἀνδράσι δὲ προτέροισιν ἐριζέμεν οὐκ ἐθελήσω,	-uu - uu-u u-uu - uu--	dactylic hexameter	feminine penthemimeral, trithemimeral
οὔθ’ Ἡρακλῆι οὔτ’ Εὐρύτῳ Οιχαλιῆι,	- ---- - -uu -uu--	dactylic hexameter	masculine penthemimeral
οἵ ῥα καὶ ἀθανάτοισιν ἐρίζεσκον περὶ τόξων.	- u u -uu-u u--- uu --	dactylic hexameter	feminine penthemimeral
τῶ ῥα καὶ αἶψ’ ἔθανεν μέγας Εὔρυτος, οὐδ’ ἐπὶ γῆρας	- u u - uu- uu -uu - uu --	dactylic hexameter	masculine penthemimeral, trithemimeral
ἵκετ’ ἐνὶ μεγάροισι· χολωσάμενος γὰρ Ἀπόλλων	-u u- uu-u u-uu- u u--	dactylic hexameter	feminine penthemimeral, trithemimeral
ἔκτανεν, οὕνεκά μιν προκαλίζετο τοξάζεσθαι.	-uu -uu - uu-uu ----	dactylic hexameter	masculine penthemimeral
δουρὶ δ’ἀκοντίζω ὅσον οὐκ ἄλλος τις ὀϊστῷ.	-u u--- uu - -- u u--	dactylic hexameter	masculine penthemimeral, hepthemimeral
οἴοισιν δείδοικα ποσὶν μή τίς με παρέλθῃ	--- --u u- - - u u--	dactylic hexameter	feminine penthemimeral, hepthemimeral, trithemimeral
Φαιήκων· λίην γὰρ ἀεικελίως ἐδαμάσθην	--- -- u u-uu- uu--	dactylic hexameter	masculine penthemimeral, trithemimeral
κύμασιν ἐν πολλοῖς, ἐπεὶ οὐ κομιδὴ κατὰ νῆα	-uu - -- uu - uu- uu --	dactylic hexameter	masculine penthemimeral, hepthemimeral, trithemimeral
ἦεν ἐπηετανός· τῶ μοι φίλα γυῖα λέλυνται.	-u u-uu- - - uu -u u--	dactylic hexameter	masculine penthemimeral, hepthemimeral
ὣς ἔφαθ’, οἱ δ’ἄρα πάντες ἀκὴν ἐγένοντο σιωπῇ.	- uu - uu -u u- uu-u u--	dactylic hexameter	feminine penthemimeral, hepthemimeral, trithemimeral
Ἀλκίνοος δέ μιν οἶος ἀμειβόμενος προσέειπε·	-uu- u u -u u-uu- uu--	dactylic hexameter	feminine penthemimeral, trithemimeral
ξεῖν’, ἐπεὶ οὐκ ἀχάριστα μεθ’ ἡμῖν ταῦτ’ ἀγορεύεις,	- uu - uu-u u -- - uu--	dactylic hexameter	feminine penthemimeral, trithemimeral
ἀλλ’ ἐθέλεις ἀρετὴν σὴν φαινέμεν, ἥ τοι ὀπηδεῖ,	- uu- uu- - -uu - u u--	dactylic hexameter	masculine penthemimeral, trithemimeral
χωόμενος ὅτι σ’οὗτος ἀνὴρ ἐν ἀγῶνι παραστὰς	-uu- uu -u u- u u-u u--	dactylic hexameter	feminine penthemimeral, hepthemimeral, trithemimeral
νείκεσεν, ὡς ἂν σὴν ἀρετὴν βροτὸς οὔ τις ὄνοιτο,	-uu - - - uu- uu - u u--	dactylic hexameter	masculine penthemimeral, hepthemimeral, trithemimeral
ὅς τις ἐπίσταιτο ᾗσι φρεσὶν ἄρτια βάζειν·	- u u--- -- uu -uu --	dactylic hexameter	masculine penthemimeral, hepthemimeral
ἀλλ’ ἄγε νῦν ἐμέθεν ξυνίει ἔπος, ὄφρα καὶ ἄλλῳ	- uu - uu- uu- uu -u u --	dactylic hexameter	masculine penthemimeral, hepthemimeral, trithemimeral
εἴπῃς ἡρώων, ὅτε κεν σοῖς ἐν μεγάροισι	-- --- uu - - - uu--	dactylic hexameter	masculine penthemimeral, hepthemimeral
δαινύῃ παρὰ σῇ τ’ἀλόχῳ καὶ σοῖσι τέκεσσιν,	--- uu - uu- - -u u--	dactylic hexameter	masculine penthemimeral, hepthemimeral, trithemimeral
ἡμετέρης ἀρετῆς μεμνημένος, οἷα καὶ ἡμῖν	-uu- uu- --uu -u u --	dactylic hexameter	masculine penthemimeral, trithemimeral
Ζεὺς ἐπὶ ἔργα τίθησι διαμπερὲς ἐξ ἔτι πατρῶν.	- uu -u u-u u-uu - uu --	dactylic hexameter	feminine penthemimeral
οὐ γὰρ πυγμάχοι εἰμὲν ἀμύμονες οὐδὲ παλαισταί,	- - -uu -u u-uu -u u--	dactylic hexameter	feminine penthemimeral
ἀλλὰ ποσὶ κραιπνῶς θέομεν καὶ νηυσὶν ἄριστοι,	-u u- -- uu- - -u u--	dactylic hexameter	masculine penthemimeral, hepthemimeral, trithemimeral
αἰεὶ δ’ἡμῖν δαίς τε φίλη κίθαρις τε χοροί τε	-- -- - u u- uu- u u- -	dactylic hexameter	masculine penthemimeral, hepthemimeral
εἵματά τ’ἐξημοιβὰ λοετρά τε θερμὰ καὶ εὐναί.	-uu ---u u-u u -u u --	dactylic hexameter	feminine penthemimeral
ἀλλ’ ἄγε, Φαιήκων βητάρμονες ὅσσοι ἄριστοι,	- uu --- --uu -u u--	dactylic hexameter	masculine penthemimeral
παίσατε, ὥς χ’ὁ ξεῖνος ἐνίσπῃ οἷσι φίλοισιν	-uu - - -u u-- -u u--	dactylic hexameter	feminine penthemimeral, trithemimeral
οἴκαδε νοστήσας, ὅσσον περιγινόμεθ’ ἄλλων	-uu --- -- uu-uu --	dactylic hexameter	masculine penthemimeral, hepthemimeral
ναυτιλίῃ καὶ ποσσὶ καὶ ὀρχηστυῖ καὶ ἀοιδῇ.	-uu- - -u u --- u u--	dactylic hexameter	feminine penthemimeral, trithemimeral
Δημοδόκῳ δέ τις αἶψα κιὼν φόρμιγγα λίγειαν	-uu- u u -u u- --u u--	dactylic hexameter	feminine penthemimeral, hepthemimeral, trithemimeral
οἰσέτω, ἥ που κεῖται ἐν ἡμετέροισι δόμοισιν.	-uu - - -u u -uu-u u--	dactylic hexameter	feminine penthemimeral, trithemimeral
ὣς ἔφατ’ Ἀλκίνοος θεοείκελος, ὦρτο δὲ κῆρυξ	- uu -uu- uu-uu -u u --	dactylic hexameter	masculine penthemimeral
οἴσων φόρμιγγα γλαφυρὴν δόμου ἐκ βασιλῆος.	-- --- uu- uu - uu--	dactylic hexameter	masculine penthemimeral, hepthemimeral
αἰσυμνῆται δὲ κριτοὶ ἐννέα πάντες ἀνέσταν	---- - uu -uu -u u--	dactylic hexameter	masculine penthemimeral
δήμιοι, οἳ κατ’ ἀγῶνα ἐῢ πρήσσεσκον ἕκαστα,	-uu - u u-u u- --u u--	dactylic hexameter	feminine penthemimeral, hepthemimeral, trithemimeral
λείηναν δὲ χορόν, καλὸν δ’εὔρυναν ἀγῶνα.	--- u u- -- --u u--	dactylic hexameter	masculine penthemimeral, hepthemimeral, trithemimeral
κῆρυξ δ’ἐγγύθεν ἦλθε φέρων φόρμιγγα λίγειαν	-- -uu -u u- --u u--	dactylic hexameter	feminine penthemimeral, hepthemimeral
Δημοδόκῳ· ὁ δ’ἔπειτα κί’ ἐς μέσον· ἀμφὶ δὲ κοῦροι	-uu- u u-u u - uu -u u --	dactylic hexameter	feminine penthemimeral, hepthemimeral, trithemimeral
πρωθῆβαι ἵσταντο, δαήμονες ὀρχηθμοῖο,	--- --u u-uu ----	dactylic hexameter	feminine penthemimeral, trithemimeral
πέπληγον δὲ χορὸν θεῖον ποσίν. αὐτὰρ Ὀδυσσεὺς	--- u u- -- uu -u u--	dactylic hexameter	masculine penthemimeral, hepthemimeral, trithemimeral
μαρμαρυγὰς θηεῖτο ποδῶν, θαύμαζε δὲ θυμῷ.	-uu- --u u- --u u --	dactylic hexameter	feminine penthemimeral, hepthemimeral, trithemimeral
αὐτὰρ ὁ φορμίζων ἀνεβάλλετο καλὸν ἀείδειν	-u u --- uu-uu -u u--	dactylic hexameter	masculine penthemimeral
ἀμφ’ Ἄρεος φιλότητος ἐϋστεφάνου τ’Ἀφροδίτης,	- uu- uu-u u-uu- uu--	dactylic hexameter	feminine penthemimeral, trithemimeral
ὡς τὰ πρῶτ’ ἐμίγησαν ἐν Ἡφαίστοιο δόμοισι	- - - uu-u u ---u u--	dactylic hexameter	feminine penthemimeral, trithemimeral
λάθρῃ, πολλὰ δ’ἔδωκε, λέχος δ’ᾔσχυνε καὶ εὐνὴν	-- -u u-u u- --u u --	dactylic hexameter	feminine penthemimeral, hepthemimeral
Ἡφαίστοιο ἄνακτος. ἄφαρ δέ οἱ ἄγγελος ἦλθεν	---u u-u u- u u -uu --	dactylic hexameter	feminine penthemimeral, hepthemimeral
Ἥλιος, ὅ σφ’ἐνόησε μιγαζομένους φιλότητι.	-uu - uu-u u-uu- uu--	dactylic hexameter	feminine penthemimeral, trithemimeral
Ἥφαιστος δ’ὡς οὖν θυμαλγέα μῦθον ἄκουσε,	--- - - --uu -u u--	dactylic hexameter	masculine penthemimeral, trithemimeral
βῆ ῥ’ἴμεν ἐς χαλκεῶνα κακὰ φρεσὶ βυσσοδομεύων,	- uu - --u u- uu -uu--	dactylic hexameter	feminine penthemimeral, hepthemimeral, trithemimeral
ἐν δ’ἔθετ’ ἀκμοθέτῳ μέγαν ἄκμονα, κόπτε δὲ δεσμοὺς	- uu -uu- uu -uu -u u --	dactylic hexameter	masculine penthemimeral
ἀρρήκτους ἀλύτους, ὄφρ’ ἔμπεδον αὖθι μένοιεν.	--- uu- - -uu -u u--	dactylic hexameter	masculine penthemimeral, trithemimeral
αὐτὰρ ἐπεὶ δὴ τεῦξε δόλον κεχολωμένος Ἄρει,	-u u- - -u u- uu-uu --	dactylic hexameter	feminine penthemimeral, hepthemimeral, trithemimeral
βῆ ῥ’ἴμεν ἐς θάλαμον, ὅθι οἱ φίλα δέμνια κεῖτο,	- uu - uu- uu - uu -uu --	dactylic hexameter	masculine penthemimeral, hepthemimeral, trithemimeral
ἀμφὶ δ’ἄρ’ ἑρμῖσιν χέε δέσματα κύκλῳ ἁπάντῃ·	-u u --- uu -uu -u u--	dactylic hexameter	masculine penthemimeral
πολλὰ δὲ καὶ καθύπερθε μελαθρόφιν ἐξεκέχυντο,	-u u - uu-u u-uu -uu--	dactylic hexameter	feminine penthemimeral, trithemimeral
ἠΰτ’ ἀράχνια λεπτά, τά γ’οὔ κέ τις οὐδὲ ἴδοιτο,	-u u-uu -u u - u u -u u--	dactylic hexameter	feminine penthemimeral, hepthemimeral
οὐδὲ θεῶν μακάρων· πέρι γὰρ δολόεντα τέτυκτο.	-u u- uu- uu - uu-u u--	dactylic hexameter	masculine penthemimeral, hepthemimeral, trithemimeral
αὐτὰρ ἐπεὶ δὴ πάντα δόλον περὶ δέμνια χεῦεν,	-u u- - -u u- uu -uu --	dactylic hexameter	feminine penthemimeral, hepthemimeral, trithemimeral
εἴσατ’ ἴμεν ἐς Λῆμνον, ἐϋκτίμενον πτολίεθρον,	-u u- - -u u-uu- uu--	dactylic hexameter	feminine penthemimeral, trithemimeral
ἥ οἱ γαιάων πολὺ φιλτάτη ἐστὶν ἁπασέων.	- - --- uu -uu -u u--	dactylic hexameter	masculine penthemimeral
οὐδ’ ἀλαοσκοπιὴν εἶχε χρυσήνιος Ἄρης,	- uu-uu- -- --uu --	dactylic hexameter	masculine penthemimeral, hepthemimeral
ὡς ἴδεν Ἥφαιστον κλυτοτέχνην νόσφι κιόντα·	- uu --- uu-- -u u--	dactylic hexameter	masculine penthemimeral
βῆ δ’ἴμεναι πρὸς δῶμα περικλυτοῦ Ἡφαίστοιο	- uu- - -u u-uu ----	dactylic hexameter	feminine penthemimeral, trithemimeral
ἰσχανόων φιλότητος ἐϋστεφάνου Κυθερείης.	-uu- uu-u u-uu- uu--	dactylic hexameter	feminine penthemimeral, trithemimeral
ἡ δὲ νέον παρὰ πατρὸς ἐρισθενέος Κρονίωνος	- u u- uu -u u-uu- uu--	dactylic hexameter	feminine penthemimeral, trithemimeral
ἐρχομένη κατ’ ἄρ’ ἕζεθ’· ὁ δ’εἴσω δώματος ᾔει,	-uu- u u -u u -- -uu --	dactylic hexameter	feminine penthemimeral, trithemimeral
ἔν τ’ἄρα οἱ φῦ χειρί, ἔπος τ’ἔφατ’ ἔκ τ’ὀνόμαζε·	- uu - - -u u- uu - uu--	dactylic hexameter	feminine penthemimeral, hepthemimeral, trithemimeral
δεῦρο, φίλη, λέκτρονδε τραπείομεν εὐνηθέντε·	-u u- --u u-uu ----	dactylic hexameter	feminine penthemimeral, trithemimeral
οὐ γὰρ ἔθ’ Ἥφαιστος μεταδήμιος, ἀλλά που ἤδη	- u u --- uu-uu -u u --	dactylic hexameter	masculine penthemimeral
οἴχεται ἐς Λῆμνον μετὰ Σίντιας ἀγριοφώνους.	-uu - -- uu -uu -uu--	dactylic hexameter	masculine penthemimeral, trithemimeral
ὣς φάτο, τῇ δ’ἀσπαστὸν ἐείσατο κοιμηθῆναι.	- uu - --u u-uu ----	dactylic hexameter	feminine penthemimeral, trithemimeral
τὼ δ’ἐς δέμνια βάντε κατέδραθον· ἀμφὶ δὲ δεσμοὶ	- - -uu -u u-uu -u u --	dactylic hexameter	feminine penthemimeral
τεχνήεντες ἔχυντο πολύφρονος Ἡφαίστοιο,	---u u-u u-uu ----	dactylic hexameter	feminine penthemimeral
οὐδέ τι κινῆσαι μελέων ἦν οὐδ’ ἀναεῖραι.	-u u --- uu- - - uu--	dactylic hexameter	masculine penthemimeral, hepthemimeral
καὶ τότε δὴ γίνωσκον, ὅτ’ οὐκέτι φυκτὰ πέλοντο.	- uu - --u u -uu -u u--	dactylic hexameter	feminine penthemimeral, trithemimeral
ἀγχίμολον δέ σφ’ἦλθε περικλυτὸς ἀμφιγυήεις,	-uu- - -u u-uu -uu--	dactylic hexameter	feminine penthemimeral, trithemimeral
αὖτις ὑποστρέψας πρὶν Λήμνου γαῖαν ἱκέσθαι·	-u u--- - -- -u u--	dactylic hexameter	masculine penthemimeral
Ἠέλιος γάρ οἱ σκοπιὴν ἔχεν εἶπέ τε μῦθον.	-uu- - - uu- uu -u u --	dactylic hexameter	masculine penthemimeral, hepthemimeral, trithemimeral
βῆ δ’ἴμεναι πρὸς δῶμα φίλον τετιημένος ἦτορ·	- uu- - -u u- uu-uu --	dactylic hexameter	feminine penthemimeral, hepthemimeral, trithemimeral
ἔστη δ’ἐν προθύροισι, χόλος δέ μιν ἄγριος ᾕρει·	-- - uu-u u- u u -uu --	dactylic hexameter	feminine penthemimeral, hepthemimeral, trithemimeral
σμερδαλέον δ’ἐβόησε, γέγωνέ τε πᾶσι θεοῖσι·	-uu- uu-u u-u u -u u--	dactylic hexameter	feminine penthemimeral, trithemimeral
Ζεῦ πάτερ ἠδ’ ἄλλοι μάκαρες θεοὶ αἰὲν ἐόντες,	- uu - -- uu- uu -u u--	dactylic hexameter	masculine penthemimeral, hepthemimeral, trithemimeral
δεῦθ’, ἵνα ἔργα γελαστὰ καὶ οὐκ ἐπιεικτὰ ἴδησθε,	- uu -u u-u u - uu-u u--	dactylic hexameter	feminine penthemimeral, hepthemimeral
ὡς ἐμὲ χωλὸν ἐόντα Διὸς θυγάτηρ Ἀφροδίτη	- uu -u u-u u- uu- uu--	dactylic hexameter	feminine penthemimeral, hepthemimeral
αἰὲν ἀτιμάζει, φιλέει δ’ἀΐδηλον Ἄρηα,	-u u--- uu- uu-u u--	dactylic hexameter	masculine penthemimeral, hepthemimeral
οὕνεχ’ ὁ μὲν καλός τε καὶ ἀρτίπος, αὐτὰρ ἔγωγε	-u u - -- u u -uu -u u--	dactylic hexameter	masculine penthemimeral, trithemimeral
ἠπεδανὸς γενόμην. ἀτὰρ οὔ τί μοι αἴτιος ἄλλος,	-uu- uu- uu - u u -uu --	dactylic hexameter	masculine penthemimeral, hepthemimeral, trithemimeral
ἀλλὰ τοκῆε δύω, τὼ μὴ γείνασθαι ὄφελλον.	-u u-u u- - - --u u--	dactylic hexameter	masculine penthemimeral, hepthemimeral
ἀλλ’ ὄψεσθ’, ἵνα τώ γε καθεύδετον ἐν φιλότητι	- -- uu - u u-uu - uu--	dactylic hexameter	masculine penthemimeral, trithemimeral
εἰς ἐμὰ δέμνια βάντες, ἐγὼ δ’ὁρόων ἀκάχημαι.	- uu -uu -u u- uu- uu--	dactylic hexameter	feminine penthemimeral, hepthemimeral
οὐ μέν σφεας ἔτ’ ἔολπα μίνυνθά γε κειέμεν οὕτω	- - - u u-u u-u u -uu --	dactylic hexameter	feminine penthemimeral, trithemimeral
καὶ μάλα περ φιλέοντε· τάχ’ οὐκ ἐθελήσετον ἄμφω	- uu - uu-u u - uu-uu --	dactylic hexameter	feminine penthemimeral, hepthemimeral, trithemimeral
εὕδειν· ἀλλά σφωε δόλος καὶ δεσμὸς ἐρύξει,	-- -- -u u- - -u u--	dactylic hexameter	feminine penthemimeral, hepthemimeral
εἰς ὅ κέ μοι μάλα πάντα πατὴρ ἀποδῷσιν ἔεδνα,	- u u - uu -u u- uu-u u--	dactylic hexameter	feminine penthemimeral, hepthemimeral, trithemimeral
ὅσσα οἱ ἐγγυάλιξα κυνώπιδος εἵνεκα κούρης,	-u u -uu-u u-uu -uu --	dactylic hexameter	feminine penthemimeral
οὕνεκά οἱ καλὴ θυγάτηρ, ἀτὰρ οὐκ ἐχέθυμος.	-uu - -- uu- uu - uu--	dactylic hexameter	masculine penthemimeral, hepthemimeral, trithemimeral
ὣς ἔφαθ’, οἱ δ’ἀγέροντο θεοὶ ποτὶ χαλκοβατὲς δῶ·	- uu - uu-u u- uu -uu- -	dactylic hexameter	feminine penthemimeral, hepthemimeral, trithemimeral
ἦλθε Ποσειδάων γαιήοχος, ἦλθ’ ἐριούνης	-u u--- --uu - uu--	dactylic hexameter	masculine penthemimeral
Ἑρμείας, ἦλθεν δὲ ἄναξ ἑκάεργος Ἀπόλλων.	--- -- u u- uu-u u--	dactylic hexameter	masculine penthemimeral, hepthemimeral, trithemimeral
θηλύτεραι δὲ θεαὶ μένον αἰδοῖ οἴκοι ἑκάστη.	-uu- u u- uu -- -u u--	dactylic hexameter	masculine penthemimeral, trithemimeral
ἔσταν δ’ἐν προθύροισι θεοί, δωτῆρες ἑάων·	-- - uu-u u- --u u--	dactylic hexameter	feminine penthemimeral, hepthemimeral, trithemimeral
ἄσβεστος δ’ἄρ’ ἐνῶρτο γέλως μακάρεσσι θεοῖσι	--- u u-u u- uu-u u--	dactylic hexameter	feminine penthemimeral, hepthemimeral, trithemimeral
τέχνας εἰσορόωσι πολύφρονος Ἡφαίστοιο.	-- -uu-u u-uu ----	dactylic hexameter	feminine penthemimeral
ὧδε δέ τις εἴπεσκεν ἰδὼν ἐς πλησίον ἄλλον·	-u u - --u u- - -uu --	dactylic hexameter	feminine penthemimeral, hepthemimeral, trithemimeral
οὐκ ἀρετᾷ κακὰ ἔργα· κιχάνει τοι βραδὺς ὠκύν,	- uu- uu -u u-- - uu --	dactylic hexameter	feminine penthemimeral, trithemimeral
ὡς καὶ νῦν Ἥφαιστος ἐὼν βραδὺς εἷλεν Ἄρηα	- - - --u u- uu -u u--	dactylic hexameter	feminine penthemimeral, hepthemimeral, trithemimeral
ὠκύτατόν περ ἐόντα θεῶν οἳ Ὄλυμπον ἔχουσι,	-uu- u u-u u- u u-u u--	dactylic hexameter	feminine penthemimeral, hepthemimeral, trithemimeral
χωλὸς ἐὼν τέχνῃσι· τὸ καὶ μοιχάγρι’ ὀφέλλει.	-u u- --u u - --u u--	dactylic hexameter	feminine penthemimeral, hepthemimeral, trithemimeral
ὣς οἱ μὲν τοιαῦτα πρὸς ἀλλήλους ἀγόρευον·	- - - --u u --- uu--	dactylic hexameter	feminine penthemimeral, trithemimeral
Ἑρμῆν δὲ προσέειπεν ἄναξ Διὸς υἱὸς Ἀπόλλων·	-- - uu-u u- uu -u u--	dactylic hexameter	feminine penthemimeral, hepthemimeral, trithemimeral
Ἑρμεία, Διὸς υἱέ, διάκτορε, δῶτορ ἑάων,	--- uu -u u-uu -u u--	dactylic hexameter	feminine penthemimeral, trithemimeral
ἦ ῥά κεν ἐν δεσμοῖς ἐθέλοις κρατεροῖσι πιεσθεὶς	- u u - -- uu- uu-u u--	dactylic hexameter	masculine penthemimeral, hepthemimeral, trithemimeral
εὕδειν ἐν λέκτροισι παρὰ χρυσῇ Ἀφροδίτῃ;	-- - --u u- -- uu--	dactylic hexameter	feminine penthemimeral, hepthemimeral, trithemimeral
τὸν δ’ἠμείβετ’ ἔπειτα διάκτορος ἀργεϊφόντης·	- --u u-u u-uu -uu--	dactylic hexameter	feminine penthemimeral
αἲ γὰρ τοῦτο γένοιτο, ἄναξ ἑκατηβόλ’ Ἄπολλον·	- - -u u-u u- uu-u u--	dactylic hexameter	feminine penthemimeral, hepthemimeral
δεσμοὶ μὲν τρὶς τόσσοι ἀπείρονες ἀμφὶς ἔχοιεν,	-- - - -u u-uu -u u--	dactylic hexameter	feminine penthemimeral, trithemimeral
ὑμεῖς δ’εἰσορόῳτε θεοὶ πᾶσαί τε θέαιναι,	-- -uu-u u- -- u u--	dactylic hexameter	feminine penthemimeral, hepthemimeral
αὐτὰρ ἐγὼν εὕδοιμι παρὰ χρυσῇ Ἀφροδίτῃ.	-u u- --u u- -- uu--	dactylic hexameter	feminine penthemimeral, hepthemimeral, trithemimeral
ὣς ἔφατ’, ἐν δὲ γέλως ὦρτ’ ἀθανάτοισι θεοῖσιν.	- uu - u u- - -uu-u u--	dactylic hexameter	masculine penthemimeral, trithemimeral
οὐδὲ Ποσειδάωνα γέλως ἔχε, λίσσετο δ’αἰεὶ	-u u---u u- uu -uu --	dactylic hexameter	feminine penthemimeral, hepthemimeral
Ἥφαιστον κλυτοεργὸν ὅπως λύσειεν Ἄρηα.	--- uu-u u- --u u--	dactylic hexameter	feminine penthemimeral, hepthemimeral, trithemimeral
καί μιν φωνήσας ἔπεα πτερόεντα προσηύδα·	- - --- uu- uu-u u--	dactylic hexameter	masculine penthemimeral, hepthemimeral
λῦσον· ἐγὼ δέ τοι αὐτὸν ὑπίσχομαι, ὡς σὺ κελεύεις,	-u u- u u -u u-uu - u u--	dactylic hexameter	feminine penthemimeral, trithemimeral
τίσειν αἴσιμα πάντα μετ’ ἀθανάτοισι θεοῖσι.	-- -uu -u u -uu-u u--	dactylic hexameter	feminine penthemimeral
τὸν δ’αὖτε προσέειπε περικλυτὸς ἀμφιγυήεις·	- -- uu-u u-uu -uu--	dactylic hexameter	feminine penthemimeral, trithemimeral
μή με, Ποσείδαον γαιήοχε, ταῦτα κέλευε·	- u u--- --uu -u u--	dactylic hexameter	masculine penthemimeral
δειλαί τοι δειλῶν γε καὶ ἐγγύαι ἐγγυάασθαι.	-- - -- u u -uu -uu--	dactylic hexameter	masculine penthemimeral, trithemimeral
πῶς ἂν ἐγώ σε δέοιμι μετ’ ἀθανάτοισι θεοῖσιν,	- u u- u u-u u -uu-u u--	dactylic hexameter	feminine penthemimeral, trithemimeral
εἴ κεν Ἄρης οἴχοιτο χρέος καὶ δεσμὸν ἀλύξας;	- u u- --u u- - -u u--	dactylic hexameter	feminine penthemimeral, hepthemimeral, trithemimeral
τὸν δ’αὖτε προσέειπε Ποσειδάων ἐνοσίχθων·	- -- uu-u u--- uu--	dactylic hexameter	feminine penthemimeral, trithemimeral
Ἥφαιστ’, εἴ περ γάρ κεν Ἄρης χρεῖος ὑπαλύξας	-- - - - u u- -- uu--	dactylic hexameter	masculine penthemimeral, hepthemimeral, trithemimeral
οἴχηται φεύγων, αὐτός τοι ἐγὼ τάδε τίσω.	--- -- -- u u- uu --	dactylic hexameter	masculine penthemimeral, hepthemimeral, trithemimeral
τὸν δ’ἠμείβετ’ ἔπειτα περικλυτὸς ἀμφιγυήεις·	- --u u-u u-uu -uu--	dactylic hexameter	feminine penthemimeral
οὐκ ἔστ’ οὐδὲ ἔοικε τεὸν ἔπος ἀρνήσασθαι.	- - -u u-u u- uu ----	dactylic hexameter	feminine penthemimeral, hepthemimeral
ὣς εἰπὼν δεσμὸν ἀνίει μένος Ἡφαίστοιο.	- -- -- uu- uu ----	dactylic hexameter	masculine penthemimeral, hepthemimeral, trithemimeral
τὼ δ’ἐπεὶ ἐκ δεσμοῖο λύθεν, κρατεροῦ περ ἐόντος,	- uu - --u u- uu- u u--	dactylic hexameter	feminine penthemimeral, hepthemimeral, trithemimeral
αὐτίκ’ ἀναΐξαντε ὁ μὲν Θρῄκηνδε βεβήκει,	-u u---u u - --u u--	dactylic hexameter	feminine penthemimeral, hepthemimeral
ἡ δ’ἄρα Κύπρον ἵκανε φιλομμειδὴς Ἀφροδίτη,	- uu -u u-u u--- uu--	dactylic hexameter	feminine penthemimeral
ἐς Πάφον· ἔνθα δέ οἱ τέμενος βωμός τε θυήεις.	- uu -u u - uu- -- u u--	dactylic hexameter	masculine penthemimeral, hepthemimeral
ἔνθα δέ μιν Χάριτες λοῦσαν καὶ χρῖσαν ἐλαίῳ	-u u - uu- -- - -u u--	dactylic hexameter	masculine penthemimeral, hepthemimeral, trithemimeral
ἀμβρότῳ, οἷα θεοὺς ἐπενήνοθεν αἰὲν ἐόντας,	-uu -u u- uu-uu -u u--	dactylic hexameter	masculine penthemimeral
ἀμφὶ δὲ εἵματα ἕσσαν ἐπήρατα, θαῦμα ἰδέσθαι.	-u u -uu -u u-uu -u u--	dactylic hexameter	feminine penthemimeral
ταῦτ’ ἄρ’ ἀοιδὸς ἄειδε περικλυτός· αὐτὰρ Ὀδυσσεὺς	- u u-u u-u u-uu -u u--	dactylic hexameter	feminine penthemimeral
τέρπετ’ ἐνὶ φρεσὶν ᾗσιν ἀκούων ἠδὲ καὶ ἄλλοι	-u u- uu -u u-- -u u --	dactylic hexameter	feminine penthemimeral, trithemimeral
Φαίηκες δολιχήρετμοι, ναυσίκλυτοι ἄνδρες.	--- uu--- --uu --	dactylic hexameter	hepthemimeral, trithemimeral
Ἀλκίνοος δ’Ἅλιον καὶ Λαοδάμαντα κέλευσε	-uu- uu- - -uu-u u--	dactylic hexameter	masculine penthemimeral, trithemimeral
μουνὰξ ὀρχήσασθαι, ἐπεί σφισιν οὔ τις ἔριζεν.	-- ---u u- uu - u u--	dactylic hexameter	feminine penthemimeral, hepthemimeral
οἱ δ’ἐπεὶ οὖν σφαῖραν καλὴν μετὰ χερσὶν ἕλοντο,	- uu - -- -- uu -u u--	dactylic hexameter	masculine penthemimeral, hepthemimeral, trithemimeral
πορφυρέην, τήν σφιν Πόλυβος ποίησε δαΐφρων,	-uu- - - uu- --u u--	dactylic hexameter	masculine penthemimeral, hepthemimeral, trithemimeral
τὴν ἕτερος ῥίπτασκε ποτὶ νέφεα σκιόεντα	- uu- --u u- uu- uu--	dactylic hexameter	feminine penthemimeral, hepthemimeral, trithemimeral
ἰδνωθεὶς ὀπίσω, ὁ δ’ἀπὸ χθονὸς ὑψόσ’ ἀερθεὶς	--- uu- u u- uu -u u--	dactylic hexameter	masculine penthemimeral, hepthemimeral, trithemimeral
ῥηϊδίως μεθέλεσκε, πάρος ποσὶν οὖδας ἱκέσθαι.	-uu- uu-u u- uu -u u--	dactylic hexameter	feminine penthemimeral, hepthemimeral, trithemimeral
αὐτὰρ ἐπεὶ δὴ σφαίρῃ ἀν’ ἰθὺν πειρήσαντο,	-u u- - -u u -- ----	dactylic hexameter	feminine penthemimeral, trithemimeral
ὀρχείσθην δὴ ἔπειτα ποτὶ χθονὶ πουλυβοτείρῃ	--- u u-u u- uu -uu--	dactylic hexameter	feminine penthemimeral, hepthemimeral, trithemimeral
ταρφέ’ ἀμειβομένω· κοῦροι δ’ἐπελήκεον ἄλλοι	-u u-uu- -- uu-uu --	dactylic hexameter	masculine penthemimeral, hepthemimeral
ἑσταότες κατ’ ἀγῶνα, πολὺς δ’ὑπὸ κόμπος ὀρώρει.	-uu- u u-u u- uu -u u--	dactylic hexameter	feminine penthemimeral, hepthemimeral, trithemimeral
δὴ τότ’ ἄρ’ Ἀλκίνοον προσεφώνεε δῖος Ὀδυσσεύς·	- u u -uu- uu-uu -u u--	dactylic hexameter	masculine penthemimeral
Ἀλκίνοε κρεῖον, πάντων ἀριδείκετε λαῶν,	-uu- -- -- uu-uu --	dactylic hexameter	masculine penthemimeral, hepthemimeral, trithemimeral
ἠμὲν ἀπείλησας βητάρμονας εἶναι ἀρίστους,	-u u--- --uu -u u--	dactylic hexameter	masculine penthemimeral
ἠδ’ ἄρ’ ἑτοῖμα τέτυκτο· σέβας μ’ἔχει εἰσορόωντα.	- u u-u u-u u- uu -uu--	dactylic hexameter	feminine penthemimeral, hepthemimeral
ὣς φάτο, γήθησεν δ’ἱερὸν μένος Ἀλκινόοιο,	- uu --- uu- uu -uu--	dactylic hexameter	masculine penthemimeral, hepthemimeral
αἶψα δὲ Φαιήκεσσι φιληρέτμοισι μετηύδα·	-u u ---u u---u u--	dactylic hexameter	feminine penthemimeral
κέκλυτε, Φαιήκων ἡγήτορες ἠδὲ μέδοντες.	-uu --- --uu -u u--	dactylic hexameter	masculine penthemimeral
ὁ ξεῖνος μάλα μοι δοκέει πεπνυμένος εἶναι.	- -- uu - uu- --uu --	dactylic hexameter	masculine penthemimeral, hepthemimeral, trithemimeral
ἀλλ’ ἄγε οἱ δῶμεν ξεινήϊον, ὡς ἐπιεικές.	- uu - -- --uu - uu--	dactylic hexameter	masculine penthemimeral, trithemimeral
δώδεκα γὰρ κατὰ δῆμον ἀριπρεπέες βασιλῆες	-uu - uu -u u-uu- uu--	dactylic hexameter	feminine penthemimeral, trithemimeral
ἀρχοὶ κραίνουσι, τρισκαιδέκατος δ’ἐγὼ αὐτός·	-- --- --uu- uu --	dactylic hexameter	masculine penthemimeral
τῶν οἱ ἕκαστος φᾶρος ἐϋπλυνὲς ἠδὲ χιτῶνα	- u u-- -u u-uu -u u--	dactylic hexameter	feminine penthemimeral
καὶ χρυσοῖο τάλαντον ἐνείκατε τιμήεντος.	- --u u-u u-uu ----	dactylic hexameter	feminine penthemimeral
αἶψα δὲ πάντα φέρωμεν ἀολλέα, ὄφρ’ ἐνὶ χερσὶ	-u u -u u-u u-uu - uu --	dactylic hexameter	feminine penthemimeral
ξεῖνος ἔχων ἐπὶ δόρπον ἴῃ χαίρων ἐνὶ θυμῷ.	-u u- uu -u u- -- uu --	dactylic hexameter	feminine penthemimeral, hepthemimeral, trithemimeral
Εὐρύαλος δέ ἑ αὐτὸν ἀρεσσάσθω ἐπέεσσι	-uu- u u -u u--- uu--	dactylic hexameter	feminine penthemimeral, trithemimeral
καὶ δώρῳ, ἐπεὶ οὔ τι ἔπος κατὰ μοῖραν ἔειπεν.	- -- uu - u u- uu -u u--	dactylic hexameter	masculine penthemimeral, hepthemimeral, trithemimeral
ὣς ἔφαθ’, οἱ δ’ἄρα πάντες ἐπῄνεον ἠδ’ ἐκέλευον,	- uu - uu -u u-uu - uu--	dactylic hexameter	feminine penthemimeral, trithemimeral
δῶρα δ’ἄρ’ οἰσέμεναι πρόεσαν κήρυκα ἕκαστος.	-u u -uu- uu- --u u--	dactylic hexameter	masculine penthemimeral, hepthemimeral
τὸν δ’αὖτ’ Εὐρύαλος ἀπαμείβετο φώνησέν τε·	- - -uu- uu-uu --- -	dactylic hexameter	masculine penthemimeral
Ἀλκίνοε κρεῖον, πάντων ἀριδείκετε λαῶν,	-uu- -- -- uu-uu --	dactylic hexameter	masculine penthemimeral, hepthemimeral, trithemimeral
τοιγὰρ ἐγὼ τὸν ξεῖνον ἀρέσσομαι, ὡς σὺ κελεύεις.	-u u- - -u u-uu - u u--	dactylic hexameter	feminine penthemimeral, trithemimeral
δώσω οἱ τόδ’ ἄορ παγχάλκεον, ᾧ ἔπι κώπη	-- - u u- --uu - uu --	dactylic hexameter	masculine penthemimeral, trithemimeral
ἀργυρέη, κολεὸν δὲ νεοπρίστου ἐλέφαντος	-uu- uu- u u--- uu--	dactylic hexameter	masculine penthemimeral, trithemimeral
ἀμφιδεδίνηται· πολέος δέ οἱ ἄξιον ἔσται.	-uu--- uu- u u -uu --	dactylic hexameter	masculine penthemimeral, hepthemimeral
ὣς εἰπὼν ἐν χερσὶ τίθει ξίφος ἀργυρόηλον	- -- - -u u- uu -uu--	dactylic hexameter	feminine penthemimeral, hepthemimeral, trithemimeral
καί μιν φωνήσας ἔπεα πτερόεντα προσηύδα·	- - --- uu- uu-u u--	dactylic hexameter	masculine penthemimeral, hepthemimeral
χαῖρε, πάτερ ὦ ξεῖνε· ἔπος δ’εἴ πέρ τι βέβακται	-u u- - -u u- - - u u--	dactylic hexameter	feminine penthemimeral, hepthemimeral, trithemimeral
δεινόν, ἄφαρ τὸ φέροιεν ἀναρπάξασαι ἄελλαι.	-u u- u u-u u---u u--	dactylic hexameter	feminine penthemimeral, trithemimeral
σοὶ δὲ θεοὶ ἄλοχόν τ’ἰδέειν καὶ πατρίδ’ ἱκέσθαι	- u u- uu- uu- - -u u--	dactylic hexameter	masculine penthemimeral, hepthemimeral, trithemimeral
δοῖεν, ἐπεὶ δὴ δηθὰ φίλων ἄπο πήματα πάσχεις.	-u u- - -u u- uu -uu --	dactylic hexameter	feminine penthemimeral, hepthemimeral, trithemimeral
τὸν δ’ἀπαμειβόμενος προσέφη πολύμητις Ὀδυσσεύς·	- uu-uu- uu- uu-u u--	dactylic hexameter	masculine penthemimeral, hepthemimeral
καὶ σὺ φίλος μάλα χαῖρε, θεοὶ δέ τοι ὄλβια δοῖεν.	- u u- uu -u u- u u -uu --	dactylic hexameter	feminine penthemimeral, hepthemimeral, trithemimeral
μηδέ τι τοι ξίφεός γε ποθὴ μετόπισθε γένοιτο	-u u - uu- u u- uu-u u--	dactylic hexameter	masculine penthemimeral, hepthemimeral, trithemimeral
τούτου, ὃ δή μοι δῶκας ἀρεσσάμενος ἐπέεσσιν.	-u u - - -u u-uu- uu--	dactylic hexameter	feminine penthemimeral, trithemimeral
ἦ ῥα καὶ ἀμφ’ ὤμοισι θέτο ξίφος ἀργυρόηλον.	- u u - --u u- uu -uu--	dactylic hexameter	feminine penthemimeral, hepthemimeral, trithemimeral
δύσετό τ’ἠέλιος, καὶ τῷ κλυτὰ δῶρα παρῆεν.	-uu -uu- - - uu -u u--	dactylic hexameter	masculine penthemimeral, hepthemimeral
καὶ τά γ’ἐς Ἀλκινόοιο φέρον κήρυκες ἀγαυοί·	- u u -uu-u u- --u u--	dactylic hexameter	feminine penthemimeral, hepthemimeral
δεξάμενοι δ’ἄρα παῖδες ἀμύμονος Ἀλκινόοιο	-uu- uu -u u-uu -uu--	dactylic hexameter	feminine penthemimeral, trithemimeral
μητρὶ παρ’ αἰδοίῃ ἔθεσαν περικαλλέα δῶρα.	-u u --- uu- uu-uu --	dactylic hexameter	masculine penthemimeral, hepthemimeral
τοῖσιν δ’ἡγεμόνευ’ ἱερὸν μένος Ἀλκινόοιο,	-- -uu- uu- uu -uu--	dactylic hexameter	masculine penthemimeral, hepthemimeral
ἐλθόντες δὲ καθῖζον ἐν ὑψηλοῖσι θρόνοισι.	--- u u-u u ---u u--	dactylic hexameter	feminine penthemimeral, trithemimeral
δή ῥα τότ’ Ἀρήτην προσέφη μένος Ἀλκινόοιο·	- u u --- uu- uu -uu--	dactylic hexameter	masculine penthemimeral, hepthemimeral
δεῦρο, γύναι, φέρε χηλὸν ἀριπρεπέ’, ἥ τις ἀρίστη·	-u u- uu -u u-uu - u u--	dactylic hexameter	feminine penthemimeral, trithemimeral
ἐν δ’αὐτὴ θὲς φᾶρος ἐϋπλυνὲς ἠδὲ χιτῶνα.	- -- - -u u-uu -u u--	dactylic hexameter	feminine penthemimeral, trithemimeral
ἀμφὶ δέ οἱ πυρὶ χαλκὸν ἰήνατε, θέρμετε δ’ὕδωρ,	-u u - uu -u u-uu -uu --	dactylic hexameter	feminine penthemimeral, trithemimeral
ὄφρα λοεσσάμενός τε ἰδών τ’ἐῢ κείμενα πάντα	-u u-uu- u u- uu -uu --	dactylic hexameter	masculine penthemimeral, hepthemimeral
δῶρα, τά οἱ Φαίηκες ἀμύμονες ἐνθάδ’ ἔνεικαν,	-u u - --u u-uu -u u--	dactylic hexameter	feminine penthemimeral, trithemimeral
δαιτί τε τέρπηται καὶ ἀοιδῆς ὕμνον ἀκούων.	-u u --- u u-- -u u--	dactylic hexameter	masculine penthemimeral
καί οἱ ἐγὼ τόδ’ ἄλεισον ἐμὸν περικαλλὲς ὀπάσσω,	- u u- u u-u u- uu-u u--	dactylic hexameter	feminine penthemimeral, hepthemimeral, trithemimeral
χρύσεον, ὄφρ’ ἐμέθεν μεμνημένος ἤματα πάντα	-uu - uu- --uu -uu --	dactylic hexameter	masculine penthemimeral, trithemimeral
σπένδῃ ἐνὶ μεγάρῳ Διΐ τ’ἄλλοισίν τε θεοῖσιν.	-u u- uu- uu --- u u--	dactylic hexameter	masculine penthemimeral, trithemimeral
ὣς ἔφατ’, Ἀρήτη δὲ μετὰ δμῳῇσιν ἔειπεν	- uu --- u u- --u u--	dactylic hexameter	masculine penthemimeral, hepthemimeral
ἀμφὶ πυρὶ στῆσαι τρίποδα μέγαν ὅττι τάχιστα.	-u u- -- uu- uu -u u--	dactylic hexameter	masculine penthemimeral, hepthemimeral, trithemimeral
αἱ δὲ λοετροχόον τρίποδ’ ἵστασαν ἐν πυρὶ κηλέῳ,	- u u-uu- uu -uu - uu --	dactylic hexameter	masculine penthemimeral
ἔν δ’ἄρ’ ὕδωρ ἔχεον, ὑπὸ δὲ ξύλα δαῖον ἑλοῦσαι.	- u u- uu- uu - uu -u u--	dactylic hexameter	masculine penthemimeral, hepthemimeral, trithemimeral
γάστρην μὲν τρίποδος πῦρ ἄμφεπε, θέρμετο δ’ὕδωρ·	-- - uu- - -uu -uu --	dactylic hexameter	masculine penthemimeral, trithemimeral
τόφρα δ’ἄρ’ Ἀρήτη ξείνῳ περικαλλέα χηλὸν	-u u --- -- uu-uu --	dactylic hexameter	masculine penthemimeral, hepthemimeral
ἐξέφερεν θαλάμοιο, τίθει δ’ἐνὶ κάλλιμα δῶρα,	-uu- uu-u u- uu -uu --	dactylic hexameter	feminine penthemimeral, hepthemimeral, trithemimeral
ἐσθῆτα χρυσόν τε, τά οἱ Φαίηκες ἔδωκαν·	--- -- u u - --u u--	dactylic hexameter	masculine penthemimeral, hepthemimeral, trithemimeral
ἐν δ’αὐτὴ φᾶρος θῆκεν καλόν τε χιτῶνα,	- -- -- -- -- u u--	dactylic hexameter	masculine penthemimeral, hepthemimeral, trithemimeral
καί μιν φωνήσασ’ ἔπεα πτερόεντα προσηύδα·	- - --- uu- uu-u u--	dactylic hexameter	masculine penthemimeral, hepthemimeral
αὐτὸς νῦν ἴδε πῶμα, θοῶς δ’ἐπὶ δεσμὸν ἴηλον,	-- - uu -u u- uu -u u--	dactylic hexameter	feminine penthemimeral, hepthemimeral, trithemimeral
μή τίς τοι καθ’ ὁδὸν δηλήσεται, ὁππότ’ ἂν αὖτε	- - - u u- --uu -u u --	dactylic hexameter	masculine penthemimeral, trithemimeral
εὕδῃσθα γλυκὺν ὕπνον ἰὼν ἐν νηὶ μελαίνῃ.	--- uu -u u- - -u u--	dactylic hexameter	feminine penthemimeral, hepthemimeral, trithemimeral
αὐτὰρ ἐπεὶ τό γ’ἄκουσε πολύτλας δῖος Ὀδυσσεύς,	-u u- u u-u u-- -u u--	dactylic hexameter	feminine penthemimeral, trithemimeral
αὐτίκ’ ἐπήρτυε πῶμα, θοῶς δ’ἐπὶ δεσμὸν ἴηλε	-u u-uu -u u- uu -u u--	dactylic hexameter	feminine penthemimeral, hepthemimeral
ποικίλον, ὅν ποτέ μιν δέδαε φρεσὶ πότνια Κίρκη·	-uu - uu - uu- uu -uu --	dactylic hexameter	masculine penthemimeral, hepthemimeral, trithemimeral
αὐτόδιον δ’ἄρα μιν ταμίη λούσασθαι ἀνώγει	-uu- uu - uu- --u u--	dactylic hexameter	masculine penthemimeral, hepthemimeral, trithemimeral
ἔς ῥ’ἀσάμινθον βάνθ’· ὁ δ’ἄρ’ ἀσπασίως ἴδε θυμῷ	- uu-- - u u -uu- uu --	dactylic hexameter	masculine penthemimeral
θερμὰ λοέτρ’, ἐπεὶ οὔ τι κομιζόμενός γε θάμιζεν,	-u u- uu - u u-uu- u u--	dactylic hexameter	masculine penthemimeral, trithemimeral
ἐπεὶ δὴ λίπε δῶμα Καλυψοῦς ἠϋκόμοιο.	-- - uu -u u-- -uu--	dactylic hexameter	feminine penthemimeral, trithemimeral
τόφρα δέ οἱ κομιδή γε θεῷ ὣς ἔμπεδος ἦεν.	-u u - uu- u u- - -uu --	dactylic hexameter	masculine penthemimeral, hepthemimeral, trithemimeral
τὸν δ’ἐπεὶ οὖν δμῳαὶ λοῦσαν καὶ χρῖσαν ἐλαίῳ,	- uu - -- -- - -u u--	dactylic hexameter	masculine penthemimeral, hepthemimeral, trithemimeral
ἀμφὶ δέ μιν χλαῖναν καλὴν βάλον ἠδὲ χιτῶνα,	-u u - -- -- uu -u u--	dactylic hexameter	masculine penthemimeral, hepthemimeral, trithemimeral
ἔκ ῥ’ἀσαμίνθου βὰς ἄνδρας μέτα οἰνοποτῆρας	- uu-- - -- uu -uu--	dactylic hexameter	masculine penthemimeral, hepthemimeral
ἤϊε· Ναυσικάα δὲ θεῶν ἄπο κάλλος ἔχουσα	-uu -uu- u u- uu -u u--	dactylic hexameter	masculine penthemimeral, hepthemimeral
στῆ ῥα παρὰ σταθμὸν τέγεος πύκα ποιητοῖο,	- u u- -- uu- uu ----	dactylic hexameter	masculine penthemimeral, hepthemimeral, trithemimeral
θαύμαζεν δ’Ὀδυσῆα ἐν ὀφθαλμοῖσιν ὁρῶσα,	--- uu-u u ---u u--	dactylic hexameter	feminine penthemimeral, trithemimeral
καί μιν φωνήσασ’ ἔπεα πτερόεντα προσηύδα·	- - --- uu- uu-u u--	dactylic hexameter	masculine penthemimeral, hepthemimeral
χαῖρε, ξεῖν’, ἵνα καί ποτ’ ἐὼν ἐν πατρίδι γαίῃ	-- - uu - u u- - -uu --	dactylic hexameter	masculine penthemimeral, hepthemimeral, trithemimeral
μνήσῃ ἐμεῖ’, ὅτι μοι πρώτῃ ζωάγρι’ ὀφέλλεις.	-u u- uu - -- --u u--	dactylic hexameter	masculine penthemimeral, hepthemimeral, trithemimeral
τὴν δ’ἀπαμειβόμενος προσέφη πολύμητις Ὀδυσσεύς·	- uu-uu- uu- uu-u u--	dactylic hexameter	masculine penthemimeral, hepthemimeral
Ναυσικάα θύγατερ μεγαλήτορος Ἀλκινόοιο,	-uu- uu- uu-uu -uu--	dactylic hexameter	masculine penthemimeral, trithemimeral
οὕτω νῦν Ζεὺς θείη, ἐρίγδουπος πόσις Ἥρης,	-- - - -u u--- uu --	dactylic hexameter	feminine penthemimeral, trithemimeral
οἴκαδέ τ’ἐλθέμεναι καὶ νόστιμον ἦμαρ ἰδέσθαι·	-uu -uu- - -uu -u u--	dactylic hexameter	masculine penthemimeral
τῶ κέν τοι καὶ κεῖθι θεῷ ὣς εὐχετοῴμην	- - - - -u u- - -uu--	dactylic hexameter	feminine penthemimeral, hepthemimeral, trithemimeral
αἰεὶ ἤματα πάντα· σὺ γάρ μ’ἐβιώσαο, κούρη.	-- -uu -u u - uu-uu --	dactylic hexameter	feminine penthemimeral, hepthemimeral
ἦ ῥα καὶ ἐς θρόνον ἷζε παρ’ Ἀλκίνοον βασιλῆα·	- u u - uu -u u -uu- uu--	dactylic hexameter	feminine penthemimeral, trithemimeral
οἱ δ’ἤδη μοίρας τ’ἔνεμον κερόωντό τε οἶνον.	- -- -- uu- uu-u u --	dactylic hexameter	masculine penthemimeral, hepthemimeral, trithemimeral
κῆρυξ δ’ἐγγύθεν ἦλθεν ἄγων ἐρίηρον ἀοιδόν,	-- -uu -u u- uu-u u--	dactylic hexameter	feminine penthemimeral, hepthemimeral
Δημόδοκον λαοῖσι τετιμένον· εἷσε δ’ἄρ’ αὐτὸν	-uu- --u u-uu -u u --	dactylic hexameter	feminine penthemimeral, trithemimeral
μέσσῳ δαιτυμόνων, πρὸς κίονα μακρὸν ἐρείσας.	-- -uu- - -uu -u u--	dactylic hexameter	masculine penthemimeral
δὴ τότε κήρυκα προσέφη πολύμητις Ὀδυσσεύς,	- uu --- uu- uu-u u--	dactylic hexameter	masculine penthemimeral, hepthemimeral
νώτου ἀποπροταμών, ἐπὶ δὲ πλεῖον ἐλέλειπτο,	-u u-uu- uu - -- uu--	dactylic hexameter	masculine penthemimeral, hepthemimeral
ἀργιόδοντος ὑός, θαλερὴ δ’ἦν ἀμφὶς ἀλοιφή·	-uu-u u- uu- - -u u--	dactylic hexameter	masculine penthemimeral, hepthemimeral
κῆρυξ, τῆ δή, τοῦτο πόρε κρέας, ὄφρα φάγῃσι,	-- - - -u u- uu -u u--	dactylic hexameter	feminine penthemimeral, hepthemimeral, trithemimeral
Δημοδόκῳ· καί μιν προσπτύξομαι ἀχνύμενός περ·	-uu- - - --uu -uu- -	dactylic hexameter	masculine penthemimeral, trithemimeral
πᾶσι γὰρ ἀνθρώποισιν ἐπιχθονίοισιν ἀοιδοὶ	-u u ---u u-uu-u u--	dactylic hexameter	feminine penthemimeral
τιμῆς ἔμμοροί εἰσι καὶ αἰδοῦς, οὕνεκ’ ἄρα σφέας	-- -uu -u u -- -u u- -	dactylic hexameter	feminine penthemimeral
οἴμας Μοῦσ’ ἐδίδαξε, φίλησε δὲ φῦλον ἀοιδῶν.	-- - uu-u u-u u -u u--	dactylic hexameter	feminine penthemimeral, trithemimeral
ὣς ἄρ’ ἔφη, κῆρυξ δὲ φέρων ἐν χερσὶν ἔθηκεν	- u u- -- u u- - -u u--	dactylic hexameter	masculine penthemimeral, hepthemimeral, trithemimeral
ἥρῳ Δημοδόκῳ· ὁ δ’ἐδέξατο, χαῖρε δὲ θυμῷ.	-- -uu- u u-uu -u u --	dactylic hexameter	masculine penthemimeral
οἱ δ’ἐπ’ ὀνείαθ’ ἑτοῖμα προκείμενα χεῖρας ἴαλλον.	- u u-u u-u u-uu -u u--	dactylic hexameter	feminine penthemimeral
αὐτὰρ ἐπεὶ πόσιος καὶ ἐδητύος ἐξ ἔρον ἕντο,	-u u- uu- u u-uu - uu --	dactylic hexameter	masculine penthemimeral, trithemimeral
δὴ τότε Δημόδοκον προσέφη πολύμητις Ὀδυσσεύς·	- uu -uu- uu- uu-u u--	dactylic hexameter	masculine penthemimeral, hepthemimeral
Δημόδοκ’, ἔξοχα δή σε βροτῶν αἰνίζομ’ ἁπάντων.	-uu -uu - u u- --u u--	dactylic hexameter	masculine penthemimeral, hepthemimeral
ἢ σέ γε Μοῦσ’ ἐδίδαξε, Διὸς πάϊς, ἢ σέ γ’Ἀπόλλων·	- u u - uu-u u- uu - u u--	dactylic hexameter	feminine penthemimeral, hepthemimeral, trithemimeral
λίην γὰρ κατὰ κόσμον Ἀχαιῶν οἶτον ἀείδεις,	-- - uu -u u-- -u u--	dactylic hexameter	feminine penthemimeral, trithemimeral
ὅσσ’ ἔρξαν τ’ἔπαθόν τε καὶ ὅσσ’ ἐμόγησαν Ἀχαιοί,	- -- uu- u u - uu-u u--	dactylic hexameter	masculine penthemimeral, hepthemimeral, trithemimeral
ὥς τέ που ἢ αὐτὸς παρεὼν ἢ ἄλλου ἀκούσας.	- u u - -- uu- - -u u--	dactylic hexameter	masculine penthemimeral, hepthemimeral, trithemimeral
ἀλλ’ ἄγε δὴ μετάβηθι καὶ ἵππου κόσμον ἄεισον	- uu - uu-u u -- -u u--	dactylic hexameter	feminine penthemimeral, trithemimeral
δουρατέου, τὸν Ἐπειὸς ἐποίησεν σὺν Ἀθήνῃ,	-uu- u u-u u--- u u--	dactylic hexameter	feminine penthemimeral, trithemimeral
ὅν ποτ’ ἐς ἀκρόπολιν δόλον ἤγαγε δῖος Ὀδυσσεὺς	- u u -uu- uu -uu -u u--	dactylic hexameter	masculine penthemimeral
ἀνδρῶν ἐμπλήσας οἵ ῥ’Ἴλιον ἐξαλάπαξαν.	-- --- - -uu -uu--	dactylic hexameter	masculine penthemimeral
αἴ κεν δή μοι ταῦτα κατὰ μοῖραν καταλέξῃς,	- - - - -u u- -- uu--	dactylic hexameter	feminine penthemimeral, hepthemimeral, trithemimeral
αὐτίκα καὶ πᾶσιν μυθήσομαι ἀνθρώποισιν,	-uu - -- --uu ----	dactylic hexameter	masculine penthemimeral, trithemimeral
ὡς ἄρα τοι πρόφρων θεὸς ὤπασε θέσπιν ἀοιδήν.	- uu - -- uu -uu -u u--	dactylic hexameter	masculine penthemimeral, trithemimeral
ὣς φάθ’, ὁ δ’ὁρμηθεὶς θεοῦ ἤρχετο, φαῖνε δ’ἀοιδήν,	- u u --- uu -uu -u u--	dactylic hexameter	masculine penthemimeral
ἔνθεν ἑλὼν ὡς οἱ μὲν ἐϋσσέλμων ἐπὶ νηῶν	-u u- - - u u--- uu --	dactylic hexameter	masculine penthemimeral, trithemimeral
βάντες ἀπέπλειον, πῦρ ἐν κλισίῃσι βαλόντες,	-u u--- - - uu-u u--	dactylic hexameter	masculine penthemimeral, hepthemimeral
Ἀργεῖοι, τοὶ δ’ἤδη ἀγακλυτὸν ἀμφ’ Ὀδυσῆα	--- - -u u-uu - uu--	dactylic hexameter	feminine penthemimeral, trithemimeral
εἵατ’ ἐνὶ Τρώων ἀγορῇ κεκαλυμμένοι ἵππῳ·	-u u- -- uu- uu-uu --	dactylic hexameter	masculine penthemimeral, hepthemimeral, trithemimeral
αὐτοὶ γάρ μιν Τρῶες ἐς ἀκρόπολιν ἐρύσαντο.	-- - - -u u -uu- uu--	dactylic hexameter	feminine penthemimeral, trithemimeral
ὣς ὁ μὲν εἱστήκει, τοὶ δ’ἄκριτα πόλλ’ ἀγόρευον	- u u --- - -uu - uu--	dactylic hexameter	masculine penthemimeral
ἥμενοι ἀμφ’ αὐτόν· τρίχα δέ σφισιν ἥνδανε βουλή,	-uu - -- uu - uu -uu --	dactylic hexameter	masculine penthemimeral, hepthemimeral, trithemimeral
ἠὲ διατμῆξαι κοῖλον δόρυ νηλέϊ χαλκῷ,	-u u--- -- uu -uu --	dactylic hexameter	masculine penthemimeral, hepthemimeral
ἢ κατὰ πετράων βαλέειν ἐρύσαντας ἐπ’ ἄκρης,	- uu --- uu- uu-u u --	dactylic hexameter	masculine penthemimeral, hepthemimeral
ἠὲ ἐᾶν μέγ’ ἄγαλμα θεῶν θελκτήριον εἶναι,	-u u- u u-u u- --uu --	dactylic hexameter	feminine penthemimeral, hepthemimeral, trithemimeral
τῇ περ δὴ καὶ ἔπειτα τελευτήσεσθαι ἔμελλεν·	- - - u u-u u---u u--	dactylic hexameter	feminine penthemimeral, trithemimeral
αἶσα γὰρ ἦν ἀπολέσθαι, ἐπὴν πόλις ἀμφικαλύψῃ	-u u - uu-u u- uu -uu--	dactylic hexameter	feminine penthemimeral, hepthemimeral, trithemimeral
δουράτεον μέγαν ἵππον, ὅθ’ εἵατο πάντες ἄριστοι	-uu- uu -u u -uu -u u--	dactylic hexameter	feminine penthemimeral, trithemimeral
Ἀργεῖοι Τρώεσσι φόνον καὶ κῆρα φέροντες.	--- --u u- - -u u--	dactylic hexameter	feminine penthemimeral, hepthemimeral, trithemimeral
ἤειδεν δ’ὡς ἄστυ διέπραθον υἷες Ἀχαιῶν	--- - -u u-uu -u u--	dactylic hexameter	feminine penthemimeral, trithemimeral
ἱππόθεν ἐκχύμενοι, κοῖλον λόχον ἐκπρολιπόντες.	-uu -uu- -- uu -uu--	dactylic hexameter	masculine penthemimeral, hepthemimeral
ἄλλον δ’ἄλλῃ ἄειδε πόλιν κεραϊζέμεν αἰπήν,	-- -u u-u u- uu-uu --	dactylic hexameter	feminine penthemimeral, hepthemimeral
αὐτὰρ Ὀδυσσῆα προτὶ δώματα Δηϊφόβοιο	-u u--- uu -uu -uu--	dactylic hexameter	masculine penthemimeral
βήμεναι, ἠΰτ’ Ἄρηα σὺν ἀντιθέῳ Μενελάῳ.	-uu -u u-u u -uu- uu--	dactylic hexameter	feminine penthemimeral
κεῖθι δὴ αἰνότατον πόλεμον φάτο τολμήσαντα	-u u -uu- uu- uu ----	dactylic hexameter	masculine penthemimeral, hepthemimeral
νικῆσαι καὶ ἔπειτα διὰ μεγάθυμον Ἀθήνην.	--- u u-u u- uu-u u--	dactylic hexameter	feminine penthemimeral, hepthemimeral, trithemimeral
ταῦτ’ ἄρ’ ἀοιδὸς ἄειδε περικλυτός· αὐτὰρ Ὀδυσσεὺς	- u u-u u-u u-uu -u u--	dactylic hexameter	feminine penthemimeral
τήκετο, δάκρυ δ’ἔδευεν ὑπὸ βλεφάροισι παρειάς.	-uu -u u-u u- uu-u u--	dactylic hexameter	feminine penthemimeral, hepthemimeral
ὡς δὲ γυνὴ κλαίῃσι φίλον πόσιν ἀμφιπεσοῦσα,	- u u- --u u- uu -uu--	dactylic hexameter	feminine penthemimeral, hepthemimeral, trithemimeral
ὅς τε ἑῆς πρόσθεν πόλιος λαῶν τε πέσῃσιν,	- u u- -- uu- -- u u--	dactylic hexameter	masculine penthemimeral, hepthemimeral, trithemimeral
ἄστεϊ καὶ τεκέεσσιν ἀμύνων νηλεὲς ἦμαρ·	-uu - uu-u u-- -uu --	dactylic hexameter	feminine penthemimeral, trithemimeral
ἡ μὲν τὸν θνήσκοντα καὶ ἀσπαίροντ’ ἐσιδοῦσα	- - - --u u --- uu--	dactylic hexameter	feminine penthemimeral, trithemimeral
ἀμφ’ αὐτῷ χυμένη λίγα κωκύει· οἱ δέ τ’ὄπισθε	- -- uu- uu -uu - u u--	dactylic hexameter	masculine penthemimeral, trithemimeral
κόπτοντες δούρεσσι μετάφρενον ἠδὲ καὶ ὤμους	--- --u u-uu -u u --	dactylic hexameter	feminine penthemimeral, trithemimeral
εἴρερον εἰσανάγουσι, πόνον τ’ἐχέμεν καὶ ὀϊζύν·	-uu -uu-u u- uu- u u--	dactylic hexameter	feminine penthemimeral, hepthemimeral
τῆς δ’ἐλεεινοτάτῳ ἄχεϊ φθινύθουσι παρειαί·	- uu-uu- uu- uu-u u--	dactylic hexameter	masculine penthemimeral, hepthemimeral
ὣς Ὀδυσεὺς ἐλεεινὸν ὑπ’ ὀφρύσι δάκρυον εἶβεν.	- uu- uu-u u -uu -uu --	dactylic hexameter	feminine penthemimeral, trithemimeral
ἔνθ’ ἄλλους μὲν πάντας ἐλάνθανε δάκρυα λείβων,	- -- - -u u-uu -uu --	dactylic hexameter	feminine penthemimeral, trithemimeral
Ἀλκίνοος δέ μιν οἶος ἐπεφράσατ’ ἠδ’ ἐνόησεν,	-uu- u u -u u-uu - uu--	dactylic hexameter	feminine penthemimeral, trithemimeral
ἥμενος ἄγχ’ αὐτοῦ, βαρὺ δὲ στενάχοντος ἄκουσεν.	-uu - -- uu - uu-u u--	dactylic hexameter	masculine penthemimeral, hepthemimeral, trithemimeral
αἶψα δὲ Φαιήκεσσι φιληρέτμοισι μετηύδα·	-u u ---u u---u u--	dactylic hexameter	feminine penthemimeral
κέκλυτε, Φαιήκων ἡγήτορες ἠδὲ μέδοντες,	-uu --- --uu -u u--	dactylic hexameter	masculine penthemimeral
Δημόδοκος δ’ἤδη σχεθέτω φόρμιγγα λίγειαν·	-uu- -- uu- --u u--	dactylic hexameter	masculine penthemimeral, hepthemimeral, trithemimeral
οὐ γάρ πως πάντεσσι χαριζόμενος τάδ’ ἀείδει.	- - - --u u-uu- u u--	dactylic hexameter	feminine penthemimeral, trithemimeral
ἐξ οὗ δορπέομέν τε καὶ ὤρορε θεῖος ἀοιδός,	- - -uu- u u -uu -u u--	dactylic hexameter	masculine penthemimeral
ἐκ τοῦδ’ οὔ πω παύσατ’ ὀϊζυροῖο γόοιο	- - - - -u u---u u--	dactylic hexameter	feminine penthemimeral, trithemimeral
ὁ ξεῖνος· μάλα πού μιν ἄχος φρένας ἀμφιβέβηκεν.	- -- uu - u u- uu -uu--	dactylic hexameter	masculine penthemimeral, hepthemimeral, trithemimeral
ἀλλ’ ἄγ’ ὁ μὲν σχεθέτω, ἵν’ ὁμῶς τερπώμεθα πάντες,	- u u - uu- u u- --uu --	dactylic hexameter	masculine penthemimeral, hepthemimeral, trithemimeral
ξεινοδόκοι καὶ ξεῖνος, ἐπεὶ πολὺ κάλλιον οὕτω·	-uu- - -u u- uu -uu --	dactylic hexameter	feminine penthemimeral, hepthemimeral, trithemimeral
εἵνεκα γὰρ ξείνοιο τάδ’ αἰδοίοιο τέτυκται,	-uu - --u u ---u u--	dactylic hexameter	feminine penthemimeral, trithemimeral
πομπὴ καὶ φίλα δῶρα, τά οἱ δίδομεν φιλέοντες.	-- - uu -u u - uu- uu--	dactylic hexameter	feminine penthemimeral, hepthemimeral, trithemimeral
ἀντὶ κασιγνήτου ξεῖνός θ’ἱκέτης τε τέτυκται	-u u--- -- uu- u u--	dactylic hexameter	masculine penthemimeral, hepthemimeral
ἀνέρι, ὅς τ’ὀλίγον περ ἐπιψαύῃ πραπίδεσσι.	-uu - uu- u u--- uu--	dactylic hexameter	masculine penthemimeral, trithemimeral
τῶ νῦν μηδὲ σὺ κεῦθε νοήμασι κερδαλέοισιν	- - -u u -u u-uu -uu--	dactylic hexameter	feminine penthemimeral
ὅττι κέ σ’εἴρωμαι· φάσθαι δέ σε κάλλιόν ἐστιν.	-u u --- -- u u -uu --	dactylic hexameter	masculine penthemimeral, hepthemimeral
εἴπ’ ὄνομ’ ὅττι σε κεῖθι κάλεον μήτηρ τε πατήρ τε	- uu -u u -u u- -- u u- -	dactylic hexameter	feminine penthemimeral, hepthemimeral
ἄλλοι θ’οἳ κατὰ ἄστυ καὶ οἳ περιναιετάουσιν.	-- - uu -u u - uu-uu--	dactylic hexameter	feminine penthemimeral, hepthemimeral, trithemimeral
οὐ μὲν γάρ τις πάμπαν ἀνώνυμός ἐστ’ ἀνθρώπων,	- - - - -u u-uu - ---	dactylic hexameter	feminine penthemimeral, trithemimeral
οὐ κακὸς οὐδὲ μὲν ἐσθλός, ἐπὴν τὰ πρῶτα γένηται,	- uu -u u -u u- - -u u--	dactylic hexameter	feminine penthemimeral, hepthemimeral
ἀλλ’ ἐπὶ πᾶσι τίθενται, ἐπεί κε τέκωσι, τοκῆες.	- uu -u u-u u- u u-u u--	dactylic hexameter	feminine penthemimeral, hepthemimeral
εἰπὲ δέ μοι γαῖάν τε· τεὴν δῆμόν τε πόλιν τε,	-u u - -- u u- -- u u- -	dactylic hexameter	masculine penthemimeral, hepthemimeral, trithemimeral
ὄφρα σε τῇ πέμπωσι τιτυσκόμεναι φρεσὶ νῆες·	-u u - --u u-uu- uu --	dactylic hexameter	feminine penthemimeral, trithemimeral
οὐ γὰρ Φαιήκεσσι κυβερνητῆρες ἔασιν,	- - ---u u---u u--	dactylic hexameter	feminine penthemimeral
οὐδέ τι πηδάλι’ ἔστι, τά τ’ἄλλαι νῆες ἔχουσιν·	-u u -uu -u u -- -u u--	dactylic hexameter	feminine penthemimeral
ἀλλ’ αὐταὶ ἴσασι νοήματα καὶ φρένας ἀνδρῶν,	- -- --u u-uu - uu --	dactylic hexameter	feminine penthemimeral, trithemimeral
καὶ πάντων ἴσασι πόλιας καὶ πίονας ἀγροὺς	- -- --u u- - -uu --	dactylic hexameter	feminine penthemimeral, hepthemimeral, trithemimeral
ἀνθρώπων, καὶ λαῖτμα τάχισθ’ ἁλὸς ἐκπερόωσιν	--- - -u u- uu -uu--	dactylic hexameter	feminine penthemimeral, hepthemimeral, trithemimeral
ἠέρι καὶ νεφέλῃ κεκαλυμμέναι· οὐδέ ποτέ σφιν	-uu - uu- uu-uu -u u- -	dactylic hexameter	masculine penthemimeral, trithemimeral
οὔτε τι πημανθῆναι ἔπι δέος οὔτ’ ἀπολέσθαι.	-u u ---u u- uu - uu--	dactylic hexameter	feminine penthemimeral, hepthemimeral
ἀλλὰ τόδ’ ὥς ποτε πατρὸς ἐγὼν εἰπόντος ἄκουσα	-u u - uu -u u- --u u--	dactylic hexameter	feminine penthemimeral, hepthemimeral, trithemimeral
Ναυσιθόου, ὃς ἔφασκε Ποσειδάων’ ἀγάσασθαι	-uu- u u-u u--- uu--	dactylic hexameter	feminine penthemimeral, trithemimeral
ἡμῖν, οὕνεκα πομποὶ ἀπήμονές εἰμεν ἁπάντων.	-- -uu -u u-uu -u u--	dactylic hexameter	feminine penthemimeral
φῆ ποτὲ Φαιήκων ἀνδρῶν εὐεργέα νῆα	- uu --- -- --uu --	dactylic hexameter	masculine penthemimeral, hepthemimeral
ἐκ πομπῆς ἀνιοῦσαν ἐν ἠεροειδέϊ πόντῳ	- -- uu-u u -uu-uu --	dactylic hexameter	feminine penthemimeral, trithemimeral
ῥαίσεσθαι, μέγα δ’ἧμιν ὄρος πόλει ἀμφικαλύψειν.	--- uu -u u- uu -uu--	dactylic hexameter	feminine penthemimeral, hepthemimeral, trithemimeral
ὣς ἀγόρευ’ ὁ γέρων· τὰ δέ κεν θεὸς ἢ τελέσειεν	- uu- u u- u u - uu - uu--	dactylic hexameter	masculine penthemimeral, hepthemimeral, trithemimeral
ἤ κ’ἀτέλεστ’ εἴη, ὥς οἱ φίλον ἔπλετο θυμῷ·	- uu- -- - - uu -uu --	dactylic hexameter	masculine penthemimeral, hepthemimeral, trithemimeral
ἀλλ’ ἄγε μοι τόδε εἰπὲ καὶ ἀτρεκέως κατάλεξον,	- uu - uu -u u -uu- uu--	dactylic hexameter	feminine penthemimeral, trithemimeral
ὅππῃ ἀπεπλάγχθης τε καὶ ἅς τινας ἵκεο χώρας	-u u--- u u - uu -uu --	dactylic hexameter	masculine penthemimeral, hepthemimeral
ἀνθρώπων, αὐτούς τε πόλιάς τ’ἐῢ ναιεταώσας,	--- -- u u- uu -uu--	dactylic hexameter	masculine penthemimeral, hepthemimeral, trithemimeral
ἠμὲν ὅσοι χαλεποί τε καὶ ἄγριοι οὐδὲ δίκαιοι,	-u u- uu- u u -uu -u u--	dactylic hexameter	masculine penthemimeral, trithemimeral
οἵ τε φιλόξεινοι, καί σφιν νόος ἐστὶ θεουδής.	- u u--- - - uu -u u--	dactylic hexameter	masculine penthemimeral, hepthemimeral
εἰπὲ δ’ὅ τι κλαίεις καὶ ὀδύρεαι ἔνδοθι θυμῷ	-u u - -- u u-uu -uu --	dactylic hexameter	masculine penthemimeral, trithemimeral
Ἀργείων Δαναῶν ἠδ’ Ἰλίου οἶτον ἀκούων.	--- uu- - -uu -u u--	dactylic hexameter	masculine penthemimeral, trithemimeral
τὸν δὲ θεοὶ μὲν τεῦξαν, ἐπεκλώσαντο δ’ὄλεθρον	- u u- - -u u---u u--	dactylic hexameter	feminine penthemimeral, trithemimeral
ἀνθρώποις, ἵνα ᾖσι καὶ ἐσσομένοισιν ἀοιδή.	--- uu -u u -uu-u u--	dactylic hexameter	feminine penthemimeral, trithemimeral
ἦ τίς τοι καὶ πηὸς ἀπέφθιτο Ἰλιόθι πρὸ	- - - - -u u-uu -uu- -	dactylic hexameter	feminine penthemimeral, trithemimeral
ἐσθλὸς ἐών, γαμβρὸς ἢ πενθερός, οἵ τε μάλιστα	-u u- -- - -uu - u u--	dactylic hexameter	masculine penthemimeral, trithemimeral
κήδιστοι τελέθουσι μεθ’ αἷμά τε καὶ γένος αὐτῶν;	--- uu-u u -u u - uu --	dactylic hexameter	feminine penthemimeral, trithemimeral
ἦ τίς που καὶ ἑταῖρος ἀνὴρ κεχαρισμένα εἰδώς,	- - - u u-u u- uu-uu --	dactylic hexameter	feminine penthemimeral, hepthemimeral, trithemimeral
ἐσθλός; ἐπεὶ οὐ μέν τι κασιγνήτοιο χερείων	-u u- - - u u---u u--	dactylic hexameter	masculine penthemimeral, trithemimeral
γίνεται, ὅς κεν ἑταῖρος ἐὼν πεπνυμένα εἰδῇ.	-uu - u u-u u- --uu --	dactylic hexameter	feminine penthemimeral, hepthemimeral, trithemimeral
