ἦμος δ’ἠριγένεια φάνη ῥοδοδάκτυλος Ἠώς,	-- -uu-u u- uu-uu --	dactylic hexameter	feminine penthemimeral, hepthemimeral
δὴ τότ’ ἔπειθ’ ὑπὸ ποσσὶν ἐδήσατο καλὰ πέδιλα	- u u- uu -u u-uu -u u--	dactylic hexameter	feminine penthemimeral, trithemimeral
Τηλέμαχος, φίλος υἱὸς Ὀδυσσῆος θείοιο,	-uu- uu -u u--- ---	dactylic hexameter	feminine penthemimeral, trithemimeral
εἵλετο δ’ἄλκιμον ἔγχος, ὅ οἱ παλάμηφιν ἀρήρει,	-uu -uu -u u - uu-u u--	dactylic hexameter	feminine penthemimeral, hepthemimeral
ἄστυδε ἱέμενος, καὶ ἑὸν προσέειπε συβώτην·	-uu -uu- u u- uu-u u--	dactylic hexameter	masculine penthemimeral, hepthemimeral
ἄττ’, ἤτοι μὲν ἐγὼν εἶμ’ ἐς πόλιν, ὄφρα με μήτηρ	- -- u u- - - uu -u u --	dactylic hexameter	masculine penthemimeral, hepthemimeral, trithemimeral
ὄψεται· οὐ γάρ μιν πρόσθεν παύσεσθαι ὀΐω	-uu - - - -- --u u--	dactylic hexameter	masculine penthemimeral, hepthemimeral, trithemimeral
κλαυθμοῦ τε στυγεροῖο γόοιό τε δακρυόεντος,	-- - uu-u u-u u -uu--	dactylic hexameter	feminine penthemimeral, trithemimeral
πρίν γ’αὐτόν με ἴδηται· ἀτὰρ σοί γ’ὦδ’ ἐπιτέλλω.	- -- u u-u u- - - uu--	dactylic hexameter	feminine penthemimeral, hepthemimeral, trithemimeral
τὸν ξεῖνον δύστηνον ἄγ’ ἐς πόλιν, ὄφρ’ ἂν ἐκεῖθι	- -- --u u - uu - u u--	dactylic hexameter	feminine penthemimeral, hepthemimeral, trithemimeral
δαῖτα πτωχεύῃ· δώσει δέ οἱ ὅς κ’ἐθέλῃσι	-- --- -- u u - uu--	dactylic hexameter	masculine penthemimeral, hepthemimeral
πύρνον καὶ κοτύλην· ἐμὲ δ’οὔ πως ἔστιν ἅπαντας	-- - uu- uu - - -u u--	dactylic hexameter	masculine penthemimeral, hepthemimeral, trithemimeral
ἀνθρώπους ἀνέχεσθαι, ἔχοντά περ ἄλγεα θυμῷ·	--- uu-u u-u u -uu --	dactylic hexameter	feminine penthemimeral, trithemimeral
ὁ ξεῖνος δ’εἴ περ μάλα μηνίει, ἄλγιον αὐτῷ	- -- - - uu -uu -uu --	dactylic hexameter	masculine penthemimeral, trithemimeral
ἔσσεται· ἦ γὰρ ἐμοὶ φίλ’ ἀληθέα μυθήσασθαι.	-uu - u u- u u-uu ----	dactylic hexameter	masculine penthemimeral, trithemimeral
τὸν δ’ἀπαμειβόμενος προσέφη πολύμητις Ὀδυσσεύς·	- uu-uu- uu- uu-u u--	dactylic hexameter	masculine penthemimeral, hepthemimeral
ὧ φίλος, οὐδέ τοι αὐτὸς ἐρύκεσθαι μενεαίνω·	- uu -u u -u u--- uu--	dactylic hexameter	feminine penthemimeral
πτωχῷ βέλτερόν ἐστι κατὰ πτόλιν ἠὲ κατ’ ἀγροὺς	-- -uu -u u- uu -u u --	dactylic hexameter	feminine penthemimeral, hepthemimeral
δαῖτα πτωχεύειν· δώσει δέ μοι ὅς κ’ἐθέλῃσιν.	-- --- -- u u - uu--	dactylic hexameter	masculine penthemimeral, hepthemimeral
οὐ γὰρ ἐπὶ σταθμοῖσι μένειν ἔτι τηλίκος εἰμί,	- u u- --u u- uu -uu --	dactylic hexameter	feminine penthemimeral, hepthemimeral, trithemimeral
ὥς τ’ἐπιτειλαμένῳ σημάντορι πάντα πιθέσθαι.	- uu-uu- --uu -u u--	dactylic hexameter	masculine penthemimeral
ἀλλ’ ἔρχευ· ἐμὲ δ’ἄξει ἀνὴρ ὅδε, τὸν σὺ κελεύεις,	- -- uu -u u- uu - u u--	dactylic hexameter	feminine penthemimeral, hepthemimeral, trithemimeral
αὐτίκ’ ἐπεί κε πυρὸς θερέω ἀλέη τε γένηται.	-u u- u u- uu- uu- u u--	dactylic hexameter	masculine penthemimeral, hepthemimeral, trithemimeral
αἰνῶς γὰρ τάδε εἵματ’ ἔχω κακά· μή με δαμάσσῃ	-- - uu -u u- uu - u u--	dactylic hexameter	feminine penthemimeral, hepthemimeral, trithemimeral
στίβη ὑπηοίη· ἕκαθεν δέ τε ἄστυ φάτ’ εἶναι.	-u u--- uu- u u -u u --	dactylic hexameter	masculine penthemimeral, hepthemimeral
ὣς φάτο, Τηλέμαχος δὲ διὰ σταθμοῖο βεβήκει,	- uu -uu- u u- --u u--	dactylic hexameter	masculine penthemimeral, hepthemimeral
κραιπνὰ ποσὶ προβιβάς, κακὰ δὲ μνηστῆρσι φύτευεν.	-u u- uu- uu - --u u--	dactylic hexameter	masculine penthemimeral, hepthemimeral, trithemimeral
αὐτὰρ ἐπεί ῥ’ἵκανε δόμους εὖ ναιετάοντας,	-u u- --u u- - -uu--	dactylic hexameter	feminine penthemimeral, hepthemimeral, trithemimeral
ἔγχος μέν ῥ’ἔστησε φέρων πρὸς κίονα μακρήν,	-- - --u u- - -uu --	dactylic hexameter	feminine penthemimeral, hepthemimeral, trithemimeral
αὐτὸς δ’εἴσω ἴεν καὶ ὑπέρβη λάϊνον οὐδόν.	-- -u u- u u-- -uu --	dactylic hexameter	masculine penthemimeral
τὸν δὲ πολὺ πρώτη εἶδε τροφὸς Εὐρύκλεια,	- u u- -- -- uu ----	dactylic hexameter	masculine penthemimeral, hepthemimeral, trithemimeral
κώεα καστορνῦσα θρόνοις ἔνι δαιδαλέοισι,	-uu ---u u- uu -uu--	dactylic hexameter	feminine penthemimeral, hepthemimeral
δακρύσασα δ’ἔπειτ’ ἰθὺς κίεν· ἀμφὶ δ’ἄρ’ ἄλλαι	---u u- -- uu -u u --	dactylic hexameter	masculine penthemimeral, hepthemimeral
δμῳαὶ Ὀδυσσῆος ταλασίφρονος ἠγερέθοντο,	-u u--- uu-uu -uu--	dactylic hexameter	masculine penthemimeral
καὶ κύνεον ἀγαπαζόμεναι κεφαλήν τε καὶ ὤμους.	- uu- uu-uu- uu- u u --	dactylic hexameter	hepthemimeral, trithemimeral
ἡ δ’ἴεν ἐκ θαλάμοιο περίφρων Πηνελόπεια,	- uu - uu-u u-- -uu--	dactylic hexameter	feminine penthemimeral, trithemimeral
Ἀρτέμιδι ἰκέλη ἠὲ χρυσῇ Ἀφροδίτῃ,	-uu- uu- -- -- uu--	dactylic hexameter	masculine penthemimeral, hepthemimeral, trithemimeral
ἀμφὶ δὲ παιδὶ φίλῳ βάλε πήχεε δακρύσασα,	-u u -u u- uu -uu ----	dactylic hexameter	masculine penthemimeral
κύσσε δέ μιν κεφαλήν τε καὶ ἄμφω φάεα καλά,	-u u - uu- u u -- -uu --	dactylic hexameter	masculine penthemimeral, trithemimeral
καί ῥ’ὀλοφυρομένη ἔπεα πτερόεντα προσηύδα·	- uu-uu- uu- uu-u u--	dactylic hexameter	masculine penthemimeral, hepthemimeral
ἦλθες, Τηλέμαχε, γλυκερὸν φάος. οὔ σ’ἔτ’ ἔγωγε	-- -uu- uu- uu - u u--	dactylic hexameter	masculine penthemimeral, hepthemimeral
ὄψεσθαι ἐφάμην, ἐπεὶ ᾤχεο νηῒ Πύλονδε	--- uu- uu -uu -u u--	dactylic hexameter	masculine penthemimeral, trithemimeral
λάθρῃ, ἐμεῦ ἀέκητι, φίλου μετὰ πατρὸς ἀκουήν.	-u u- uu-u u- uu -u u--	dactylic hexameter	feminine penthemimeral, hepthemimeral, trithemimeral
ἀλλ’ ἄγε μοι κατάλεξον ὅπως ἤντησας ὀπωπῆς.	- uu - uu-u u- --u u--	dactylic hexameter	feminine penthemimeral, hepthemimeral, trithemimeral
τὴν δ’αὖ Τηλέμαχος πεπνυμένος ἀντίον ηὔδα·	- - -uu- --uu -uu --	dactylic hexameter	masculine penthemimeral
μῆτερ ἐμή, μή μοι γόον ὄρνυθι μηδέ μοι ἦτορ	-u u- - - uu -uu -u u --	dactylic hexameter	masculine penthemimeral, trithemimeral
ἐν στήθεσσιν ὄρινε φυγόντι περ αἰπὺν ὄλεθρον·	- --u u-u u-u u -u u--	dactylic hexameter	feminine penthemimeral
ἀλλ’ ὑδρηναμένη, καθαρὰ χροῒ εἵμαθ’ ἑλοῦσα,	- --uu- uu- uu -u u--	dactylic hexameter	masculine penthemimeral, hepthemimeral
εἰς ὑπερῷ’ ἀναβᾶσα σὺν ἀμφιπόλοισι γυναιξὶν	- uu- uu-u u -uu-u u--	dactylic hexameter	feminine penthemimeral, trithemimeral
εὔχεο πᾶσι θεοῖσι τεληέσσας ἑκατόμβας	-uu -u u-u u--- uu--	dactylic hexameter	feminine penthemimeral
ῥέξειν, αἴ κέ ποθι Ζεὺς ἄντιτα ἔργα τελέσσῃ.	-- - u u- - -uu -u u--	dactylic hexameter	masculine penthemimeral, trithemimeral
αὐτὰρ ἐγὼν ἀγορὴν ἐσελεύσομαι, ὄφρα καλέσσω	-u u- uu- uu-uu -u u--	dactylic hexameter	masculine penthemimeral, trithemimeral
ξεῖνον, ὅτις μοι κεῖθεν ἅμ’ ἕσπετο δεῦρο κιόντι.	-u u- - -u u -uu -u u--	dactylic hexameter	feminine penthemimeral, trithemimeral
τὸν μὲν ἐγὼ προὔπεμψα σὺν ἀντιθέοις ἑτάροισι,	- u u- --u u -uu- uu--	dactylic hexameter	feminine penthemimeral, trithemimeral
Πείραιον δέ μιν ἠνώγεα προτὶ οἶκον ἄγοντα	--- u u --- uu -u u--	dactylic hexameter	hepthemimeral, trithemimeral
ἐνδυκέως φιλέειν καὶ τιέμεν, εἰς ὅ κεν ἔλθω.	-uu- uu- - -uu - u u --	dactylic hexameter	masculine penthemimeral, trithemimeral
ὣς ἄρ’ ἐφώνησεν, τῇ δ’ἄπτερος ἔπλετο μῦθος.	- u u--- - -uu -uu --	dactylic hexameter	masculine penthemimeral
ἡ δ’ὑδρηναμένη, καθαρὰ χροῒ εἵμαθ’ ἑλοῦσα,	- --uu- uu- uu -u u--	dactylic hexameter	masculine penthemimeral, hepthemimeral
εὔχετο πᾶσι θεοῖσι τεληέσσας ἑκατόμβας	-uu -u u-u u--- uu--	dactylic hexameter	feminine penthemimeral
ῥέξειν, αἴ κέ ποθι Ζεὺς ἄντιτα ἔργα τελέσσῃ.	-- - u u- - -uu -u u--	dactylic hexameter	masculine penthemimeral, trithemimeral
Τηλέμαχος δ’ἄρ’ ἔπειτα διὲκ μεγάροιο βεβήκει	-uu- u u-u u- uu-u u--	dactylic hexameter	feminine penthemimeral, hepthemimeral, trithemimeral
ἔγχος ἔχων· ἅμα τῷ γε κύνες πόδας ἀργοὶ ἕποντο.	-u u- uu - u u- uu -u u--	dactylic hexameter	masculine penthemimeral, hepthemimeral, trithemimeral
θεσπεσίην δ’ἄρα τῷ γε χάριν κατέχευεν Ἀθήνη·	-uu- uu - u u- uu-u u--	dactylic hexameter	masculine penthemimeral, hepthemimeral, trithemimeral
τὸν δ’ἄρα πάντες λαοὶ ἐπερχόμενον θηεῦντο.	- uu -- -u u-uu- ---	dactylic hexameter	feminine penthemimeral
ἀμφὶ δέ μιν μνηστῆρες ἀγήνορες ἠγερέθοντο	-u u - --u u-uu -uu--	dactylic hexameter	feminine penthemimeral, trithemimeral
ἔσθλ’ ἀγορεύοντες, κακὰ δὲ φρεσὶ βυσσοδόμευον.	- uu--- uu - uu -uu--	dactylic hexameter	masculine penthemimeral, hepthemimeral
αὐτὰρ ὁ τῶν μὲν ἔπειτα ἀλεύατο πουλὺν ὅμιλον,	-u u - u u-u u-uu -u u--	dactylic hexameter	feminine penthemimeral, trithemimeral
ἀλλ’ ἵνα Μέντωρ ἧστο καὶ Ἄντιφος ἠδ’ Ἁλιθέρσης,	- uu -- -u u -uu - uu--	dactylic hexameter	feminine penthemimeral
οἵ τε οἱ ἐξ ἀρχῆς πατρώϊοι ἦσαν ἑταῖροι,	- u u - -- --uu -u u--	dactylic hexameter	masculine penthemimeral, trithemimeral
ἔνθα καθέζετ’ ἰών· τοὶ δ’ἐξερέεινον ἕκαστα.	-u u-u u- - -uu-u u--	dactylic hexameter	masculine penthemimeral
τοῖσι δὲ Πείραιος δουρικλυτὸς ἐγγύθεν ἦλθε	-u u --- --uu -uu --	dactylic hexameter	masculine penthemimeral
ξεῖνον ἄγων ἀγορήνδε διὰ πτόλιν· οὐδ’ ἄρ’ ἔτι δὴν	-u u- uu-u u- uu - u u- -	dactylic hexameter	feminine penthemimeral, hepthemimeral, trithemimeral
Τηλέμαχος ξείνοιο ἑκὰς τράπετ’, ἀλλὰ παρέστη.	-uu- --u u- uu -u u--	dactylic hexameter	feminine penthemimeral, hepthemimeral, trithemimeral
τὸν καὶ Πείραιος πρότερος πρὸς μῦθον ἔειπε·	- - --- uu- - -u u--	dactylic hexameter	masculine penthemimeral, hepthemimeral
Τηλέμαχ’, αἶψ’ ὄτρυνον ἐμὸν ποτὶ δῶμα γυναῖκας,	-uu - --u u- uu -u u--	dactylic hexameter	feminine penthemimeral, hepthemimeral, trithemimeral
ὥς τοι δῶρ’ ἀποπέμψω, ἅ τοι Μενέλαος ἔδωκε.	- - - uu-u u - uu-u u--	dactylic hexameter	feminine penthemimeral, hepthemimeral, trithemimeral
τὸν δ’αὖ Τηλέμαχος πεπνυμένος ἀντίον ηὔδα·	- - -uu- --uu -uu --	dactylic hexameter	masculine penthemimeral
Πείραι’, οὐ γάρ τ’ἴδμεν ὅπως ἔσται τάδε ἔργα.	-- - - -u u- -- uu --	dactylic hexameter	feminine penthemimeral, hepthemimeral, trithemimeral
εἴ κεν ἐμὲ μνηστῆρες ἀγήνορες ἐν μεγάροισι	- u u- --u u-uu - uu--	dactylic hexameter	feminine penthemimeral, trithemimeral
λάθρῃ κτείναντες πατρώϊα πάντα δάσωνται,	-- --- --uu -u u--	dactylic hexameter	masculine penthemimeral
αὐτὸν ἔχοντά σε βούλομ’ ἐπαυρέμεν, ἤ τινα τῶνδε·	-u u-u u -u u-uu - uu --	dactylic hexameter	feminine penthemimeral
εἰ δέ κ’ἐγὼ τούτοισι φόνον καὶ κῆρα φυτεύσω,	- u u- --u u- - -u u--	dactylic hexameter	feminine penthemimeral, hepthemimeral, trithemimeral
δὴ τότε μοι χαίροντι φέρειν πρὸς δώματα χαίρων.	- uu - --u u- - -uu --	dactylic hexameter	feminine penthemimeral, hepthemimeral, trithemimeral
ὣς εἰπὼν ξεῖνον ταλαπείριον ἦγεν ἐς οἶκον.	- -- -- uu-uu -u u --	dactylic hexameter	masculine penthemimeral, trithemimeral
αὐτὰρ ἐπεί ῥ’ἵκοντο δόμους εὖ ναιετάοντας,	-u u- --u u- - -uu--	dactylic hexameter	feminine penthemimeral, hepthemimeral, trithemimeral
χλαίνας μὲν κατέθεντο κατὰ κλισμούς τε θρόνους τε,	-- - uu-u u- -- u u- -	dactylic hexameter	feminine penthemimeral, hepthemimeral, trithemimeral
ἐς δ’ἀσαμίνθους βάντες ἐϋξέστας λούσαντο.	- uu-- -u u--- ---	dactylic hexameter	feminine penthemimeral
τοὺς δ’ἐπεὶ οὖν δμῳαὶ λοῦσαν καὶ χρῖσαν ἐλαίῳ,	- uu - -- -- - -u u--	dactylic hexameter	masculine penthemimeral, hepthemimeral, trithemimeral
ἀμφὶ δ’ἄρα χλαίνας οὔλας βάλον ἠδὲ χιτῶνας,	-u u- -- -- uu -u u--	dactylic hexameter	masculine penthemimeral, hepthemimeral, trithemimeral
ἔκ ῥ’ἀσαμίνθου βάντες ἐπὶ κλισμοῖσι καθῖζον.	- uu-- -u u- --u u--	dactylic hexameter	feminine penthemimeral, hepthemimeral
χέρνιβα δ’ἀμφίπολος προχόῳ ἐπέχευε φέρουσα	-uu -uu- uu- uu-u u--	dactylic hexameter	masculine penthemimeral, hepthemimeral
καλῇ χρυσείῃ, ὑπὲρ ἀργυρέοιο λέβητος,	-- --- uu -uu-u u--	dactylic hexameter	masculine penthemimeral
νίψασθαι· παρὰ δὲ ξεστὴν ἐτάνυσσε τράπεζαν.	--- uu - -- uu-u u--	dactylic hexameter	masculine penthemimeral, hepthemimeral, trithemimeral
σῖτον δ’αἰδοίη ταμίη παρέθηκε φέρουσα,	-- --- uu- uu-u u--	dactylic hexameter	masculine penthemimeral, hepthemimeral
εἴδατα πόλλ’ ἐπιθεῖσα, χαριζομένη παρεόντων.	-uu - uu-u u-uu- uu--	dactylic hexameter	feminine penthemimeral, trithemimeral
μήτηρ δ’ἀντίον ἷζε παρὰ σταθμὸν μεγάροιο	-- -uu -u u- -- uu--	dactylic hexameter	feminine penthemimeral, hepthemimeral
κλισμῷ κεκλιμένη, λέπτ’ ἠλάκατα στρωφῶσα.	-- -uu- - -uu- ---	dactylic hexameter	masculine penthemimeral
οἱ δ’ἐπ’ ὀνείαθ’ ἑτοῖμα προκείμενα χεῖρας ἴαλλον,	- u u-u u-u u-uu -u u--	dactylic hexameter	feminine penthemimeral
αὐτὰρ ἐπεὶ πόσιος καὶ ἐδητύος ἐξ ἔρον ἕντο,	-u u- uu- u u-uu - uu --	dactylic hexameter	masculine penthemimeral, trithemimeral
τοῖσι δὲ μύθων ἦρχε περίφρων Πηνελόπεια·	-u u -- -u u-- -uu--	dactylic hexameter	feminine penthemimeral
Τηλέμαχ’, ἤτοι ἐγὼν ὑπερώϊον εἰσαναβᾶσα	-uu -u u- uu-uu -uu--	dactylic hexameter	masculine penthemimeral
λέξομαι εἰς εὐνήν, ἥ μοι στονόεσσα τέτυκται,	-uu - -- - - uu-u u--	dactylic hexameter	masculine penthemimeral, hepthemimeral, trithemimeral
αἰεὶ δάκρυσ’ ἐμοῖσι πεφυρμένη, ἐξ οὗ Ὀδυσσεὺς	-- -u u-u u-uu - u u--	dactylic hexameter	feminine penthemimeral
ᾤχεθ’ ἅμ’ Ἀτρεΐδῃσιν ἐς Ἴλιον· οὐδέ μοι ἔτλης,	-u u -uu-u u -uu -u u --	dactylic hexameter	feminine penthemimeral
πρὶν ἐλθεῖν μνηστῆρας ἀγήνορας ἐς τόδε δῶμα,	- -- --u u-uu - uu --	dactylic hexameter	feminine penthemimeral, trithemimeral
νόστον σοῦ πατρὸς σάφα εἰπέμεν, εἴ που ἄκουσας.	-- - -- uu -uu - u u--	dactylic hexameter	masculine penthemimeral, trithemimeral
τὴν δ’αὖ Τηλέμαχος πεπνυμένος ἀντίον ηὔδα·	- - -uu- --uu -uu --	dactylic hexameter	masculine penthemimeral
τοιγὰρ ἐγώ τοι, μῆτερ, ἀληθείην καταλέξω.	-u u- - -u u--- uu--	dactylic hexameter	feminine penthemimeral, trithemimeral
ᾠχόμεθ’ ἔς τε Πύλον καὶ Νέστορα, ποιμένα λαῶν·	-uu - u u- - -uu -uu --	dactylic hexameter	masculine penthemimeral, trithemimeral
δεξάμενος δέ μ’ἐκεῖνος ἐν ὑψηλοῖσι δόμοισιν	-uu- u u-u u ---u u--	dactylic hexameter	feminine penthemimeral, trithemimeral
ἐνδυκέως ἐφίλει, ὡς εἴ τε πατὴρ ἑὸν υἷα	-uu- uu- - - u u- uu --	dactylic hexameter	masculine penthemimeral, hepthemimeral, trithemimeral
ἐλθόντα χρόνιον νέον ἄλλοθεν· ὣς ἐμὲ κεῖνος	--- uu- uu -uu - uu --	dactylic hexameter	masculine penthemimeral, trithemimeral
ἐνδυκέως ἐκόμιζε σὺν υἱάσι κυδαλίμοισιν.	-uu- uu-u u -uu -uu--	dactylic hexameter	feminine penthemimeral, trithemimeral
αὐτὰρ Ὀδυσσῆος ταλασίφρονος οὔ ποτ’ ἔφασκε,	-u u--- uu-uu - u u--	dactylic hexameter	masculine penthemimeral
ζωοῦ οὐδὲ θανόντος, ἐπιχθονίων τευ ἀκοῦσαι·	-- -u u-u u-uu- u u--	dactylic hexameter	feminine penthemimeral
ἀλλά μ’ἐς Ἀτρεΐδην, δουρικλειτὸν Μενέλαον,	-u u -uu- ---- uu--	dactylic hexameter	masculine penthemimeral
ἵπποισι προὔπεμψε καὶ ἅρμασι κολλητοῖσιν.	--- --u u -uu ----	dactylic hexameter	feminine penthemimeral, trithemimeral
ἔνθ’ ἴδον Ἀργείην Ἑλένην, ἧς εἵνεκα πολλὰ	- uu --- uu- - -uu --	dactylic hexameter	masculine penthemimeral, hepthemimeral
Ἀργεῖοι Τρῶές τε θεῶν ἰότητι μόγησαν.	--- -- u u- uu-u u--	dactylic hexameter	masculine penthemimeral, hepthemimeral, trithemimeral
εἴρετο δ’αὐτίκ’ ἔπειτα βοὴν ἀγαθὸς Μενέλαος	-uu -u u-u u- uu- uu--	dactylic hexameter	feminine penthemimeral, hepthemimeral
ὅττευ χρηΐζων ἱκόμην Λακεδαίμονα δῖαν·	-- --- uu- uu-uu --	dactylic hexameter	masculine penthemimeral, hepthemimeral
αὐτὰρ ἐγὼ τῷ πᾶσαν ἀληθείην κατέλεξα·	-u u- - -u u--- uu--	dactylic hexameter	feminine penthemimeral, trithemimeral
καὶ τότε δή μ’ἐπέεσσιν ἀμειβόμενος προσέειπεν·	- uu - uu-u u-uu- uu--	dactylic hexameter	feminine penthemimeral, trithemimeral
ὢ πόποι, ἦ μάλα δὴ κρατερόφρονος ἀνδρὸς ἐν εὐνῇ	- uu - uu - uu-uu -u u --	dactylic hexameter	masculine penthemimeral, trithemimeral
ἤθελον εὐνηθῆναι, ἀνάλκιδες αὐτοὶ ἐόντες.	-uu ---u u-uu -u u--	dactylic hexameter	feminine penthemimeral
ὡς δ’ὁπότ’ ἐν ξυλόχῳ ἔλαφος κρατεροῖο λέοντος	- uu - uu- uu- uu-u u--	dactylic hexameter	masculine penthemimeral, hepthemimeral, trithemimeral
νεβροὺς κοιμήσασα νεηγενέας γαλαθηνοὺς	-- ---u u-uu- uu--	dactylic hexameter	feminine penthemimeral
κνημοὺς ἐξερέῃσι καὶ ἄγκεα ποιήεντα	-- -uu-u u -uu ----	dactylic hexameter	feminine penthemimeral
βοσκομένη, ὁ δ’ἔπειτα ἑὴν εἰσήλυθεν εὐνήν,	-uu- u u-u u- --uu --	dactylic hexameter	feminine penthemimeral, hepthemimeral, trithemimeral
ἀμφοτέροισι δὲ τοῖσιν ἀεικέα πότμον ἐφῆκεν,	-uu-u u -u u-uu -u u--	dactylic hexameter	feminine penthemimeral
ὣς Ὀδυσεὺς κείνοισιν ἀεικέα πότμον ἐφήσει.	- uu- --u u-uu -u u--	dactylic hexameter	feminine penthemimeral, trithemimeral
αἲ γάρ, Ζεῦ τε πάτερ καὶ Ἀθηναίη καὶ Ἄπολλον,	- - - u u- u u--- u u--	dactylic hexameter	masculine penthemimeral, trithemimeral
τοῖος ἐὼν οἷός ποτ’ ἐϋκτιμένῃ ἐνὶ Λέσβῳ	-u u- -- u u-uu- uu --	dactylic hexameter	masculine penthemimeral, trithemimeral
ἐξ ἔριδος Φιλομηλεΐδῃ ἐπάλαισεν ἀναστάς,	- uu- uu-uu- uu-u u--	dactylic hexameter	hepthemimeral, trithemimeral
κὰδ δ’ἔβαλε κρατερῶς, κεχάροντο δὲ πάντες Ἀχαιοί,	- uu- uu- uu-u u -u u--	dactylic hexameter	masculine penthemimeral, trithemimeral
τοῖος ἐὼν μνηστῆρσιν ὁμιλήσειεν Ὀδυσσεύς·	-u u- --u u---u u--	dactylic hexameter	feminine penthemimeral, trithemimeral
πάντες κ’ὠκύμοροί τε γενοίατο πικρόγαμοί τε.	-- -uu- u u-uu -uu- -	dactylic hexameter	masculine penthemimeral
ταῦτα δ’ἅ μ’εἰρωτᾷς καὶ λίσσεαι, οὐκ ἂν ἔγωγε	-u u --- - -uu - u u--	dactylic hexameter	masculine penthemimeral
ἄλλα παρὲξ εἴποιμι παρακλιδὸν οὐδ’ ἀπατήσω,	-u u- --u u-uu - uu--	dactylic hexameter	feminine penthemimeral, trithemimeral
ἀλλὰ τὰ μέν μοι ἔειπε γέρων ἅλιος νημερτής,	-u u - u u-u u- uu- ---	dactylic hexameter	feminine penthemimeral, hepthemimeral, trithemimeral
τῶν οὐδέν τοι ἐγὼ κρύψω ἔπος οὐδ’ ἐπικεύσω.	- -- u u- -- uu - uu--	dactylic hexameter	masculine penthemimeral, hepthemimeral, trithemimeral
φῆ μιν ὅ γ’ἐν νήσῳ ἰδέειν κρατέρ’ ἄλγε’ ἔχοντα,	- u u - -- uu- uu -u u--	dactylic hexameter	masculine penthemimeral, hepthemimeral, trithemimeral
νύμφης ἐν μεγάροισι Καλυψοῦς, ἥ μιν ἀνάγκῃ	-- - uu-u u-- - u u--	dactylic hexameter	feminine penthemimeral, trithemimeral
ἴσχει· ὁ δ’οὐ δύναται ἣν πατρίδα γαῖαν ἱκέσθαι.	-u u - uu- - -uu -u u--	dactylic hexameter	masculine penthemimeral, trithemimeral
οὐ γάρ οἱ πάρα νῆες ἐπήρετμοι καὶ ἑταῖροι,	- - - uu -u u--- u u--	dactylic hexameter	feminine penthemimeral, trithemimeral
οἵ κέν μιν πέμποιεν ἐπ’ εὐρέα νῶτα θαλάσσης	- - - --u u -uu -u u--	dactylic hexameter	feminine penthemimeral, trithemimeral
ὣς ἔφατ’ Ἀτρεΐδης, δουρικλειτὸς Μενέλαος.	- uu -uu- ---- uu--	dactylic hexameter	masculine penthemimeral
ταῦτα τελευτήσας νεόμην· ἔδοσαν δέ μοι οὖρον	-u u--- uu- uu- u u --	dactylic hexameter	masculine penthemimeral, hepthemimeral
ἀθάνατοι, τοί μ’ὧκα φίλην ἐς πατρίδ’ ἔπεμψαν.	-uu- - -u u- - -u u--	dactylic hexameter	feminine penthemimeral, hepthemimeral, trithemimeral
ὣς φάτο, τῇ δ’ἄρα θυμὸν ἐνὶ στήθεσσιν ὄρινε.	- uu - uu -u u- --u u--	dactylic hexameter	feminine penthemimeral, hepthemimeral, trithemimeral
τοῖσι δὲ καὶ μετέειπε Θεοκλύμενος θεοειδής·	-u u - uu-u u-uu- uu--	dactylic hexameter	feminine penthemimeral, trithemimeral
ὧ γύναι αἰδοίη Λαερτιάδεω Ὀδυσῆος,	- uu --- --uu- uu--	dactylic hexameter	masculine penthemimeral
ἤτοι ὅ γ’οὐ σάφα οἶδεν, ἐμεῖο δὲ σύνθεο μῦθον·	-u u - uu -u u-u u -uu --	dactylic hexameter	feminine penthemimeral, trithemimeral
ἀτρεκέως γάρ τοι μαντεύσομαι οὐδ’ ἐπικεύσω·	-uu- - - --uu - uu--	dactylic hexameter	masculine penthemimeral, trithemimeral
ἴστω νῦν Ζεὺς πρῶτα θεῶν, ξενίη τε τράπεζα	-- - - -u u- uu- u u--	dactylic hexameter	feminine penthemimeral, hepthemimeral, trithemimeral
ἱστίη τ’Ὀδυσῆος ἀμύμονος, ἣν ἀφικάνω,	--- uu-u u-uu - uu--	dactylic hexameter	feminine penthemimeral, trithemimeral
ὡς ἤτοι Ὀδυσεὺς ἤδη ἐν πατρίδι γαίῃ,	- -- uu- -- - -uu --	dactylic hexameter	masculine penthemimeral, hepthemimeral, trithemimeral
ἥμενος ἢ ἕρπων, τάδε πευθόμενος κακὰ ἔργα,	-uu - -- uu -uu- uu --	dactylic hexameter	masculine penthemimeral, trithemimeral
ἔστιν, ἀτὰρ μνηστῆρσι κακὸν πάντεσσι φυτεύει·	-u u- --u u- --u u--	dactylic hexameter	feminine penthemimeral, hepthemimeral, trithemimeral
οἷον ἐγὼν οἰωνὸν ἐϋσσέλμου ἐπὶ νηὸς	-u u- --u u--- uu --	dactylic hexameter	feminine penthemimeral, trithemimeral
ἥμενος ἐφρασάμην καὶ Τηλεμάχῳ ἐγεγώνευν.	-uu -uu- - -uu- uu--	dactylic hexameter	masculine penthemimeral
τὸν δ’αὖτε προσέειπε περίφρων Πηνελόπεια·	- -- uu-u u-- -uu--	dactylic hexameter	feminine penthemimeral, trithemimeral
αἲ γὰρ τοῦτο, ξεῖνε, ἔπος τετελεσμένον εἴη·	- - -- -u u- uu-uu --	dactylic hexameter	feminine penthemimeral, hepthemimeral
τῶ κε τάχα γνοίης φιλότητά τε πολλά τε δῶρα	- u u- -- uu-u u -u u --	dactylic hexameter	masculine penthemimeral, trithemimeral
ἐξ ἐμεῦ, ὡς ἄν τίς σε συναντόμενος μακαρίζοι.	- uu - - - u u-uu- uu--	dactylic hexameter	masculine penthemimeral, trithemimeral
ὣς οἱ μὲν τοιαῦτα πρὸς ἀλλήλους ἀγόρευον,	- - - --u u --- uu--	dactylic hexameter	feminine penthemimeral, trithemimeral
μνηστῆρες δὲ πάροιθεν Ὀδυσσῆος μεγάροιο	--- u u-u u--- uu--	dactylic hexameter	feminine penthemimeral, trithemimeral
δίσκοισιν τέρποντο καὶ αἰγανέῃσιν ἱέντες,	--- --u u -uu-u u--	dactylic hexameter	feminine penthemimeral, trithemimeral
ἐν τυκτῷ δαπέδῳ, ὅθι περ πάρος ὕβριν ἔχεσκον.	- -- uu- uu - uu -u u--	dactylic hexameter	masculine penthemimeral, hepthemimeral, trithemimeral
ἀλλ’ ὅτε δὴ δείπνηστος ἔην καὶ ἐπήλυθε μῆλα	- uu - --u u- u u-uu --	dactylic hexameter	feminine penthemimeral, hepthemimeral, trithemimeral
πάντοθεν ἐξ ἀγρῶν, οἱ δ’ἤγαγον οἳ τὸ πάρος περ,	-uu - -- - -uu - u u- -	dactylic hexameter	masculine penthemimeral, trithemimeral
καὶ τότε δή σφιν ἔειπε Μέδων· ὃς γάρ ῥα μάλιστα	- uu - u u-u u- - - u u--	dactylic hexameter	feminine penthemimeral, hepthemimeral, trithemimeral
ἥνδανε κηρύκων, καὶ σφιν παρεγίνετο δαιτί·	-uu --- - - uu-uu --	dactylic hexameter	masculine penthemimeral, hepthemimeral
κοῦροι, ἐπεὶ δὴ πάντες ἐτέρφθητε φρέν’ ἀέθλοις,	-u u- - -u u--- u u--	dactylic hexameter	feminine penthemimeral, trithemimeral
ἔρχεσθε πρὸς δώμαθ’, ἵν’ ἐντυνώμεθα δαῖτα·	--- - -u u ---uu --	dactylic hexameter	feminine penthemimeral, trithemimeral
οὐ μὲν γάρ τι χέρειον ἐν ὥρῃ δεῖπνον ἑλέσθαι.	- - - u u-u u -- -u u--	dactylic hexameter	feminine penthemimeral, trithemimeral
ὣς ἔφαθ’, οἱ δ’ἀνστάντες ἔβαν πείθοντό τε μύθῳ.	- uu - --u u- --u u --	dactylic hexameter	feminine penthemimeral, hepthemimeral, trithemimeral
αὐτὰρ ἐπεί ῥ’ἵκοντο δόμους εὖ ναιετάοντας,	-u u- --u u- - -uu--	dactylic hexameter	feminine penthemimeral, hepthemimeral, trithemimeral
χλαίνας μὲν κατέθεντο κατὰ κλισμούς τε θρόνους τε,	-- - uu-u u- -- u u- -	dactylic hexameter	feminine penthemimeral, hepthemimeral, trithemimeral
οἱ δ’ἱέρευον ὄϊς μεγάλους καὶ πίονας αἶγας,	- uu-u u- uu- - -uu --	dactylic hexameter	masculine penthemimeral, hepthemimeral
ἵρευον δὲ σύας σιάλους καὶ βοῦν ἀγελαίην,	--- u u- uu- - - uu--	dactylic hexameter	masculine penthemimeral, hepthemimeral, trithemimeral
δαῖτ’ ἐντυνόμενοι. τοὶ δ’ἐξ ἀγροῖο πόλινδε	- --uu- - - --u u--	dactylic hexameter	masculine penthemimeral, hepthemimeral
ὀτρύνοντ’ Ὀδυσεύς τ’ἰέναι καὶ δῖος ὑφορβός.	--- uu- uu- - -u u--	dactylic hexameter	masculine penthemimeral, hepthemimeral, trithemimeral
τοῖσι δὲ μύθων ἦρχε συβώτης, ὄρχαμος ἀνδρῶν·	-u u -- -u u-- -uu --	dactylic hexameter	feminine penthemimeral
ξεῖν’, ἐπεὶ ἂρ δὴ ἔπειτα πόλινδ’ ἴμεναι μενεαίνεις	- uu - u u-u u- uu- uu--	dactylic hexameter	feminine penthemimeral, hepthemimeral, trithemimeral
σήμερον, ὡς ἐπέτελλεν ἄναξ ἐμός ἦ σ’ἂν ἔγωγε	-uu - uu-u u- uu - u u--	dactylic hexameter	feminine penthemimeral, hepthemimeral, trithemimeral
αὐτοῦ βουλοίμην σταθμῶν ῥυτῆρα λιπέσθαι·	-- --- -- --u u--	dactylic hexameter	masculine penthemimeral, hepthemimeral
ἀλλὰ τὸν αἰδέομαι καὶ δείδια, μή μοι ὀπίσσω	-u u -uu- - -uu - u u--	dactylic hexameter	masculine penthemimeral
νεικείῃ· χαλεπαὶ δέ τ’ἀνάκτων εἰσὶν ὁμοκλαί	--- uu- u u-- -u u--	dactylic hexameter	masculine penthemimeral, trithemimeral
ἀλλ’ ἄγε νῦν ἴομεν· δὴ γὰρ μέμβλωκε μάλιστα	- uu - uu- - - --u u--	dactylic hexameter	masculine penthemimeral, hepthemimeral, trithemimeral
ἦμαρ, ἀτὰρ τάχα τοι ποτὶ ἕσπερα ῥίγιον ἔσται.	-u u- uu - uu -uu -uu --	dactylic hexameter	masculine penthemimeral, trithemimeral
τὸν δ’ἀπαμειβόμενος προσέφη πολύμητις Ὀδυσσεύς·	- uu-uu- uu- uu-u u--	dactylic hexameter	masculine penthemimeral, hepthemimeral
γινώσκω, φρονέω· τά γε δὴ νοέοντι κελεύεις.	--- uu- u u - uu-u u--	dactylic hexameter	masculine penthemimeral, hepthemimeral, trithemimeral
ἀλλ’ ἴομεν, σὺ δ’ἔπειτα διαμπερὲς ἡγεμόνευε.	- uu- u u-u u-uu -uu--	dactylic hexameter	feminine penthemimeral, trithemimeral
δὸς δέ μοι, εἴ ποθί τοι ῥόπαλον τετμημένον ἐστί,	- u u - uu - uu- --uu --	dactylic hexameter	masculine penthemimeral, hepthemimeral, trithemimeral
σκηρίπτεσθ’, ἐπεὶ ἦ φατ’ ἀρισφαλέ’ ἔμμεναι οὐδόν.	--- uu - u u-uu -uu --	dactylic hexameter	masculine penthemimeral, trithemimeral
ἦ ῥα καὶ ἀμφ’ ὤμοισιν ἀεικέα βάλλετο πήρην,	- u u - --u u-uu -uu --	dactylic hexameter	feminine penthemimeral, trithemimeral
πυκνὰ ῥωγαλέην· ἐν δὲ στρόφος ἦεν ἀορτήρ·	-- -uu- - - uu -u u--	dactylic hexameter	masculine penthemimeral, hepthemimeral
Εὔμαιος δ’ἄρα οἱ σκῆπτρον θυμαρὲς ἔδωκε.	--- uu - -- --u u--	dactylic hexameter	masculine penthemimeral, hepthemimeral, trithemimeral
τὼ βήτην, σταθμὸν δὲ κύνες καὶ βώτορες ἄνδρες	- -- -- u u- - -uu --	dactylic hexameter	masculine penthemimeral, hepthemimeral, trithemimeral
ῥύατ’ ὄπισθε μένοντες· ὁ δ’ἐς πόλιν ἦγεν ἄνακτα	-u u-u u-u u - uu -u u--	dactylic hexameter	feminine penthemimeral, hepthemimeral
πτωχῷ λευγαλέῳ ἐναλίγκιον ἠδὲ γέροντι,	-- -uu- uu-uu -u u--	dactylic hexameter	masculine penthemimeral
σκηπτόμενον· τὰ δὲ λυγρὰ περὶ χροῒ εἵματα ἕστο.	-uu- u u -u u- uu -uu --	dactylic hexameter	feminine penthemimeral, hepthemimeral, trithemimeral
ἀλλ’ ὅτε δὴ στείχοντες ὁδὸν κάτα παιπαλόεσσαν	- uu - --u u- uu -uu--	dactylic hexameter	feminine penthemimeral, hepthemimeral, trithemimeral
ἄστεος ἐγγὺς ἔσαν καὶ ἐπὶ κρήνην ἀφίκοντο	-uu -u u- u u- -- uu--	dactylic hexameter	masculine penthemimeral, hepthemimeral
τυκτὴν καλλίροον, ὅθεν ὑδρεύοντο πολῖται,	-- -uu- uu ---u u--	dactylic hexameter	masculine penthemimeral
τὴν ποίησ’ Ἴθακος καὶ Νήριτος ἠδὲ Πολύκτωρ·	- -- uu- - -uu -u u--	dactylic hexameter	masculine penthemimeral, trithemimeral
ἀμφὶ δ’ἄρ’ αἰγείρων ὑδατοτρεφέων ἦν ἄλσος,	-u u --- uu-uu- - --	dactylic hexameter	masculine penthemimeral
πάντοσε κυκλοτερές, κατὰ δὲ ψυχρὸν ῥέεν ὕδωρ	-uu -uu- uu - -- uu --	dactylic hexameter	masculine penthemimeral, hepthemimeral
ὑψόθεν ἐκ πέτρης· βωμὸς δ’ἐφύπερθε τέτυκτο	-uu - -- -- uu-u u--	dactylic hexameter	masculine penthemimeral, hepthemimeral, trithemimeral
νυμφάων, ὅθι πάντες ἐπιρρέζεσκον ὁδῖται·	--- uu -u u---u u--	dactylic hexameter	feminine penthemimeral, trithemimeral
ἔνθα σφέας ἐκίχανεν υἱὸς Δολίοιο Μελανθεὺς	-- - uu-u u- uu-u u--	dactylic hexameter	feminine penthemimeral, hepthemimeral, trithemimeral
αἶγας ἄγων, αἳ πᾶσι μετέπρεπον αἰπολίοισι,	-u u- - -u u-uu -uu--	dactylic hexameter	feminine penthemimeral, trithemimeral
δεῖπνον μνηστήρεσσι· δύω δ’ἅμ’ ἕποντο νομῆες.	-- ---u u- u u-u u--	dactylic hexameter	feminine penthemimeral, hepthemimeral
τοὺς δὲ ἰδὼν νείκεσσεν ἔπος τ’ἔφατ’ ἔκ τ’ὀνόμαζεν,	- u u- --u u- uu - uu--	dactylic hexameter	feminine penthemimeral, hepthemimeral, trithemimeral
ἔκπαγλον καὶ ἀεικές· ὄρινε δὲ κῆρ Ὀδυσῆος·	--- u u-u u-u u - uu--	dactylic hexameter	feminine penthemimeral, trithemimeral
νῦν μὲν δὴ μάλα πάγχυ κακὸς κακὸν ἡγηλάζει,	- - - uu -u u- uu ----	dactylic hexameter	feminine penthemimeral, hepthemimeral, trithemimeral
ὡς αἰεὶ τὸν ὁμοῖον ἄγει θεὸς ὡς τὸν ὁμοῖον.	- -- u u-u u- uu - u u--	dactylic hexameter	feminine penthemimeral, hepthemimeral, trithemimeral
πῇ δὴ τόνδε μολοβρὸν ἄγεις, ἀμέγαρτε συβῶτα,	- - -u u-u u- uu-u u--	dactylic hexameter	feminine penthemimeral, hepthemimeral
πτωχὸν ἀνιηρόν δαιτῶν ἀπολυμαντῆρα;	-u u--- -- uu----	dactylic hexameter	masculine penthemimeral, hepthemimeral
ὃς πολλῇς φλιῇσι παραστὰς φλίψεται ὤμους,	- -- --u u-- -uu --	dactylic hexameter	feminine penthemimeral, trithemimeral
αἰτίζων ἀκόλους, οὐκ ἄορας οὐδὲ λέβητας·	--- uu- - -uu -u u--	dactylic hexameter	masculine penthemimeral, trithemimeral
τόν κ’εἴ μοι δοίης σταθμῶν ῥυτῆρα γενέσθαι	- - - -- -- --u u--	dactylic hexameter	masculine penthemimeral, hepthemimeral, trithemimeral
σηκοκόρον τ’ἔμεναι θαλλόν τ’ἐρίφοισι φορῆναι,	-uu- uu- -- uu-u u--	dactylic hexameter	masculine penthemimeral, hepthemimeral, trithemimeral
καί κεν ὀρὸν πίνων μεγάλην ἐπιγουνίδα θεῖτο.	- u u- -- uu- uu-uu --	dactylic hexameter	masculine penthemimeral, hepthemimeral, trithemimeral
ἀλλ’ ἐπεὶ οὖν δὴ ἔργα κάκ’ ἔμμαθεν, οὐκ ἐθελήσει	- uu - - -u u -uu - uu--	dactylic hexameter	feminine penthemimeral, trithemimeral
ἔργον ἐποίχεσθαι, ἀλλὰ πτώσσων κατὰ δῆμον	-u u--- -- -- uu --	dactylic hexameter	masculine penthemimeral, hepthemimeral
βούλεται αἰτίζων βόσκειν ἣν γαστέρ’ ἄναλτον.	-uu --- -- - -u u--	dactylic hexameter	masculine penthemimeral, hepthemimeral
ἀλλ’ ἔκ τοι ἐρέω, τὸ δὲ καὶ τετελεσμένον ἔσται·	- - - uu- u u - uu-uu --	dactylic hexameter	masculine penthemimeral, hepthemimeral, trithemimeral
αἴ κ’ἔλθῃ πρὸς δώματ’ Ὀδυσσῆος θείοιο,	- -- - -u u--- ---	dactylic hexameter	feminine penthemimeral, trithemimeral
πολλά οἱ ἀμφὶ&nnbsp;κάρη σφέλα ἀνδρῶν ἐκ παλαμάων	-u u -uu- uu -- - uu--	dactylic hexameter	masculine penthemimeral
πλευραὶ ἀποτρίψουσι δόμον κάτα βαλλομένοιο.	-u u---u u- uu -uu--	dactylic hexameter	feminine penthemimeral, hepthemimeral
ὣς φάτο, καὶ παριὼν λὰξ ἔνθορεν ἀφραδίῃσιν	- uu - uu- - -uu -uu--	dactylic hexameter	masculine penthemimeral, trithemimeral
ἰσχίῳ· οὐδέ μιν ἐκτὸς ἀταρπιτοῦ ἐστυφέλιξεν,	-uu -u u -u u-uu -uu--	dactylic hexameter	feminine penthemimeral
ἀλλ’ ἔμεν’ ἀσφαλέως· ὁ δὲ μερμήριξεν Ὀδυσσεὺς	- uu -uu- u u ---u u--	dactylic hexameter	masculine penthemimeral
ἠὲ μεταΐξας ῥοπάλῳ ἐκ θυμὸν ἕλοιτο,	-u u--- uu- - -u u--	dactylic hexameter	masculine penthemimeral, hepthemimeral
ἦ πρὸς γῆν ἐλάσειε κάρη ἀμφουδὶς ἀείρας.	- - - uu-u u- --u u--	dactylic hexameter	feminine penthemimeral, hepthemimeral, trithemimeral
ἀλλ’ ἐπετόλμησε, φρεσὶ δ’ἔσχετο· τὸν δὲ συβώτης	- uu--- uu -uu - u u--	dactylic hexameter	masculine penthemimeral
νείκεσ’ ἐσάντα ἰδών, μέγα δ’εὔξατο χεῖρας ἀνασχών·	-u u-u u- uu -uu -u u--	dactylic hexameter	masculine penthemimeral
νύμφαι κρηναῖαι, κοῦραι Διός, εἴ ποτ’ Ὀδυσσεὺς	-- --- -- uu - u u--	dactylic hexameter	masculine penthemimeral, hepthemimeral
ὔμμ’ ἐπὶ μηρί’ ἔκηε, καλύψας πίονι δημῷ,	- uu -u u-u u-- -uu --	dactylic hexameter	feminine penthemimeral
ἀρνῶν ἠδ’ ἐρίφων, τόδε μοι κρηήνατ’ ἐέλδωρ,	-- - uu- uu - --u u--	dactylic hexameter	masculine penthemimeral, hepthemimeral, trithemimeral
ὡς ἔλθοι μὲν κεῖνος ἀνήρ, ἀγάγοι δέ ἑ δαίμων·	- -- - -u u- uu- u u --	dactylic hexameter	feminine penthemimeral, hepthemimeral, trithemimeral
τῶ κέ τοι ἀγλαΐας γε διασκεδάσειεν ἁπάσας,	- u u -uu- u u-uu-u u--	dactylic hexameter	masculine penthemimeral
τὰς νῦν ὑβρίζων φορέεις, ἀλαλήμενος αἰεὶ	- - --- uu- uu-uu --	dactylic hexameter	masculine penthemimeral, hepthemimeral
ἄστυ κάτ’· αὐτὰρ μῆλα κακοὶ φθείρουσι νομῆες.	-u u -- -u u- --u u--	dactylic hexameter	feminine penthemimeral, hepthemimeral
τὸν δ’αὖτε προσέειπε Μελάνθιος, αἰπόλος αἰγῶν·	- -- uu-u u-uu -uu --	dactylic hexameter	feminine penthemimeral, trithemimeral
ὢ πόποι, οἶον ἔειπε κύων ὀλοφώϊα εἰδώς,	- uu -u u-u u- uu-uu --	dactylic hexameter	feminine penthemimeral, hepthemimeral
τόν ποτ’ ἐγὼν ἐπὶ νηὸς ἐϋσσέλμοιο μελαίνης	- u u- uu -u u---u u--	dactylic hexameter	feminine penthemimeral, trithemimeral
ἄξω τῆλ’ Ἰθάκης, ἵνα μοι βίοτον πολὺν ἄλφοι.	-- - uu- uu - uu- uu --	dactylic hexameter	masculine penthemimeral, hepthemimeral, trithemimeral
αἲ γὰρ Τηλέμαχον βάλοι ἀργυρότοξος Ἀπόλλων	- - -uu- uu -uu-u u--	dactylic hexameter	masculine penthemimeral
σήμερον ἐν μεγάροις, ἢ ὑπὸ μνηστῆρσι δαμείη,	-uu - uu- u u- --u u--	dactylic hexameter	masculine penthemimeral, hepthemimeral, trithemimeral
ὡς Ὀδυσῆΐ γε τηλοῦ ἀπώλετο νόστιμον ἦμαρ.	- uu-u u -u u-uu -uu --	dactylic hexameter	feminine penthemimeral
ὣς εἰπὼν τοὺς μὲν λίπεν αὐτόθι ἦκα κιόντας,	- -- - - uu -uu -u u--	dactylic hexameter	masculine penthemimeral, trithemimeral
αὐτὰρ ὁ βῆ, μάλα δ’ὧκα δόμους ἵκανεν ἄνακτος.	-u u - uu -u u- --u u--	dactylic hexameter	feminine penthemimeral, hepthemimeral, trithemimeral
αὐτίκα δ’εἴσω ἴεν, μετὰ δὲ μνηστῆρσι καθῖζεν,	-uu -u u- uu - --u u--	dactylic hexameter	masculine penthemimeral, hepthemimeral
ἀντίον Εὐρυμάχου· τὸν γὰρ φιλέεσκε μάλιστα.	-uu -uu- - - uu-u u--	dactylic hexameter	masculine penthemimeral, hepthemimeral
τῷ πάρα μὲν κρειῶν μοῖραν θέσαν οἳ πονέοντο,	- uu - -- -- uu - uu--	dactylic hexameter	masculine penthemimeral, hepthemimeral, trithemimeral
σῖτον δ’αἰδοίη ταμίη παρέθηκε φέρουσα	-- --- uu- uu-u u--	dactylic hexameter	masculine penthemimeral, hepthemimeral
ἔδμεναι. ἀγχίμολον δ’Ὀδυσεὺς καὶ δῖος ὑφορβὸς	-uu -uu- uu- - -u u--	dactylic hexameter	masculine penthemimeral, hepthemimeral
στήτην ἐρχομένω, περὶ δέ σφεας ἤλυθ’ nbsp;ἰωὴ	-- -uu- uu - uu -u u--	dactylic hexameter	masculine penthemimeral, hepthemimeral
φόρμιγγος γλαφυρῆς· ἀνὰ γάρ σφισι βάλλετ’ ἀείδειν	--- uu- uu - uu -u u--	dactylic hexameter	masculine penthemimeral, hepthemimeral, trithemimeral
Φήμιος· αὐτὰρ ὁ χειρὸς ἑλὼν προσέειπε συβώτην·	-uu -u u -u u- uu-u u--	dactylic hexameter	feminine penthemimeral, hepthemimeral
Εὔμαι’, ἦ μάλα δὴ τάδε δώματα κάλ’ Ὀδυσῆος,	-- - uu - uu -uu - uu--	dactylic hexameter	masculine penthemimeral, trithemimeral
ῥεῖα δ’ἀρίγνωτ’ ἐστὶ καὶ ἐν πολλοῖσιν ἰδέσθαι.	-u u-- -u u - --u u--	dactylic hexameter	feminine penthemimeral, hepthemimeral
ἐξ ἑτέρων ἕτερ’ ἐστίν, ἐπήσκηται δέ οἱ αὐλὴ	- uu- uu -u u--- u u --	dactylic hexameter	feminine penthemimeral, trithemimeral
τοίχῳ καὶ θριγκοῖσι, θύραι δ’εὐερκέες εἰσὶ	-- - --u u- --uu --	dactylic hexameter	feminine penthemimeral, hepthemimeral, trithemimeral
δικλίδες· οὐκ ἄν τίς μιν ἀνὴρ ὑπεροπλίσσαιτο.	-uu - - - u u- uu----	dactylic hexameter	masculine penthemimeral, hepthemimeral, trithemimeral
γινώσκω δ’ὅτι πολλοὶ ἐν αὐτῷ δαῖτα τίθενται	--- uu -u u -- -u u--	dactylic hexameter	feminine penthemimeral, trithemimeral
ἄνδρες, ἐπεὶ κνίση μὲν ἀνήνοθεν, ἐν δέ τε φόρμιγξ	-u u- -- u u-uu - u u --	dactylic hexameter	masculine penthemimeral, trithemimeral
ἠπύει, ἣν ἄρα δαιτὶ θεοὶ ποίησαν ἑταίρην.	-uu - uu -u u- --u u--	dactylic hexameter	feminine penthemimeral, hepthemimeral, trithemimeral
τὸν δ’ἀπαμειβόμενος προσέφης, Εὔμαιε συβῶτα·	- uu-uu- uu- --u u--	dactylic hexameter	masculine penthemimeral, hepthemimeral
ῥεῖ’ ἔγνως, ἐπεὶ οὐδὲ τά τ’ἄλλα πέρ ἐσσ’ ἀνοήμων.	- -- uu -u u -u u - uu--	dactylic hexameter	feminine penthemimeral, trithemimeral
ἀλλ’ ἄγε δὴ φραζώμεθ’ ὅπως ἔσται τάδε ἔργα.	- uu - --u u- -- uu --	dactylic hexameter	feminine penthemimeral, hepthemimeral, trithemimeral
ἠὲ σὺ πρῶτος ἔσελθε δόμους εὖ ναιετάοντας,	-u u -u u-u u- - -uu--	dactylic hexameter	feminine penthemimeral, hepthemimeral
δύσεο δὲ μνηστῆρας, ἐγὼ δ’ὑπολείψομαι αὐτοῦ·	-uu - --u u- uu-uu --	dactylic hexameter	feminine penthemimeral, hepthemimeral, trithemimeral
εἰ δ’ἐθέλεις, ἐπίμεινον, ἐγὼ δ’εἶμι προπάροιθεν·	- uu- uu-u u- -- uu--	dactylic hexameter	feminine penthemimeral, hepthemimeral, trithemimeral
μηδὲ σὺ δηθύνειν, μή τίς σ’ἔκτοσθε νοήσας	-u u --- - - --u u--	dactylic hexameter	masculine penthemimeral, hepthemimeral
ἢ βάλῃ ἢ ἐλάσῃ· τὰ δέ σε φράζεσθαι ἄνωγα.	- uu - uu- u u - --u u--	dactylic hexameter	masculine penthemimeral, hepthemimeral, trithemimeral
τὸν δ’ἠμείβετ’ ἔπειτα πολύτλας δῖος Ὀδυσσεύς·	- --u u-u u-- -u u--	dactylic hexameter	feminine penthemimeral
γινώσκω, φρονέω· τά γε δὴ νοέοντι κελεύεις.	--- uu- u u - uu-u u--	dactylic hexameter	masculine penthemimeral, hepthemimeral, trithemimeral
ἀλλ’ ἔρχευ προπάροιθεν, ἐγὼ δ’ὑπολείψομαι αὐτοῦ.	- -- uu-u u- uu-uu --	dactylic hexameter	feminine penthemimeral, hepthemimeral, trithemimeral
οὐ γάρ τι πληγέων ἀδαήμων οὐδὲ βολάων·	- - - -- uu-- -u u--	dactylic hexameter	masculine penthemimeral, trithemimeral
τολμήεις μοι θυμός, ἐπεὶ κακὰ πολλὰ πέπονθα	--- - -u u- uu -u u--	dactylic hexameter	feminine penthemimeral, hepthemimeral, trithemimeral
κύμασι καὶ πολέμῳ· μετὰ καὶ τόδε τοῖσι γενέσθω·	-uu - uu- uu - uu -u u--	dactylic hexameter	masculine penthemimeral, hepthemimeral, trithemimeral
γαστέρα δ’οὔ πως ἔστιν ἀποκρύψαι μεμαυῖαν,	-uu - - -u u--- uu--	dactylic hexameter	feminine penthemimeral, trithemimeral
οὐλομένην, ἣ πολλὰ κάκ’ ἀνθρώποισι δίδωσι,	-uu- - -u u ---u u--	dactylic hexameter	feminine penthemimeral, trithemimeral
τῆς ἕνεκεν καὶ νῆες ἐΰζυγοι ὁπλίζονται	- uu- - -u u-uu ----	dactylic hexameter	feminine penthemimeral, trithemimeral
πόντον ἐπ’ ἀτρύγετον, κακὰ δυσμενέεσσι φέρουσαι.	-u u -uu- uu -uu-u u--	dactylic hexameter	masculine penthemimeral
ὣς οἱ μὲν τοιαῦτα πρὸς ἀλλήλους ἀγόρευον·	- - - --u u --- uu--	dactylic hexameter	feminine penthemimeral, trithemimeral
ἂν δὲ κύων κεφαλήν τε καὶ οὔατα κείμενος ἔσχεν,	- u u- uu- u u -uu -uu --	dactylic hexameter	masculine penthemimeral, trithemimeral
Ἄργος, Ὀδυσσῆος ταλασίφρονος, ὅν ῥά ποτ’ αὐτὸς	-u u--- uu-uu - u u --	dactylic hexameter	masculine penthemimeral
θρέψε μέν, οὐδ’ ἀπόνητο, πάρος δ’εἰς Ἴλιον ἱρὴν	-u u - uu-u u- - -uu --	dactylic hexameter	feminine penthemimeral, hepthemimeral, trithemimeral
ᾤχετο. τὸν δὲ πάροιθεν ἀγίνεσκον νέοι ἄνδρες	-uu - u u-u u--- uu --	dactylic hexameter	feminine penthemimeral, trithemimeral
αἶγας ἐπ’ ἀγροτέρας ἠδὲ πρόκας ἠδὲ λαγωούς·	-u u -uu- -- uu -u u--	dactylic hexameter	masculine penthemimeral, hepthemimeral
δὴ τότε κεῖτ’ ἀπόθεστος ἀποιχομένου Ὀδυσῆος,	- uu - uu-u u-uu- uu--	dactylic hexameter	feminine penthemimeral, trithemimeral
ἐν πολλῇ κόπρῳ, ἥ οἱ προπάροιθε θυράων	- -- -- - - uu-u u--	dactylic hexameter	masculine penthemimeral, hepthemimeral, trithemimeral
ἡμιόνων τε βοῶν τε ἅλις κέχυτ’, ὄφρ’ ἂν ἄγοιεν	-uu- u u- u u- uu - u u--	dactylic hexameter	masculine penthemimeral, hepthemimeral, trithemimeral
δμῶες Ὀδυσσῆος τέμενος μέγα κοπρήσοντες·	-u u--- uu- uu ----	dactylic hexameter	masculine penthemimeral, hepthemimeral
ἔνθα κύων κεῖτ’ Ἄργος, ἐνίπλειος κυνοραιστέων.	-u u- - -u u--- uu--	dactylic hexameter	feminine penthemimeral, trithemimeral
δὴ τότε γ’,ὡς ἐνόησεν Ὀδυσσέα ἐγγὺς ἐόντα,	- uu - uu-u u-uu -u u--	dactylic hexameter	feminine penthemimeral, trithemimeral
οὐρῇ μέν ῥ’ὅ γ’ἔσηνε καὶ οὔατα κάββαλεν ἄμφω,	-- - u u-u u -uu -uu --	dactylic hexameter	feminine penthemimeral, trithemimeral
ἆσσον δ’οὐκέτ’ ἔπειτα δυνήσατο οἷο ἄνακτος	-- -u u-u u-uu -u u--	dactylic hexameter	feminine penthemimeral
ἐλθέμεν· αὐτὰρ ὁ νόσφιν ἰδὼν ἀπομόρξατο δάκρυ,	-uu -u u -u u- uu-uu --	dactylic hexameter	feminine penthemimeral, hepthemimeral
ῥεῖα λαθὼν Εὔμαιον, ἄφαρ δ’ἐρεείνετο μύθῳ·	-u u- --u u- uu-uu --	dactylic hexameter	feminine penthemimeral, hepthemimeral, trithemimeral
Εὔμαι’, ἦ μάλα θαῦμα, κύων ὅδε κεῖτ’ ἐνὶ κόπρῳ.	-- - uu -u u- uu - uu --	dactylic hexameter	feminine penthemimeral, hepthemimeral, trithemimeral
καλὸς μὲν δέμας ἐστίν, ἀτὰρ τόδε γ’οὐ σάφα οἶδα,	-- - uu -u u- uu - uu --	dactylic hexameter	feminine penthemimeral, hepthemimeral, trithemimeral
εἰ δὴ καὶ ταχὺς ἔσκε θέειν ἐπὶ εἴδεϊ τῷδε,	- - - uu -u u- uu -uu --	dactylic hexameter	feminine penthemimeral, hepthemimeral, trithemimeral
ἦ αὔτως οἷοί τε τραπεζῆες κύνες ἀνδρῶν	- -- -- u u--- uu --	dactylic hexameter	masculine penthemimeral, trithemimeral
γίνοντ’· ἀγλαΐης δ’ἕνεκεν κομέουσιν ἄνακτες.	-- -uu- uu- uu-u u--	dactylic hexameter	masculine penthemimeral, hepthemimeral
τὸν δ’ἀπαμειβόμενος προσέφης, Εὔμαιε συβῶτα·	- uu-uu- uu- --u u--	dactylic hexameter	masculine penthemimeral, hepthemimeral
καὶ λίην ἀνδρός γε κύων ὅδε τῆλε θανόντος.	- -- -- u u- uu -u u--	dactylic hexameter	masculine penthemimeral, hepthemimeral, trithemimeral
εἰ τοιόσδ’ εἴη ἠμὲν δέμας ἠδὲ καὶ ἔργα,	- -- -- -- uu -u u --	dactylic hexameter	masculine penthemimeral, hepthemimeral, trithemimeral
οἷόν μιν Τροίηνδε κιὼν κατέλειπεν Ὀδυσσεύς,	-- - --u u- uu-u u--	dactylic hexameter	feminine penthemimeral, hepthemimeral, trithemimeral
αἶψά κε θηήσαιο ἰδὼν ταχυτῆτα καὶ ἀλκήν.	-u u ---u u- uu-u u --	dactylic hexameter	feminine penthemimeral, hepthemimeral
οὐ μὲν γάρ τι φύγεσκε βαθείης βένθεσιν ὕλης	- - - u u-u u-- -uu --	dactylic hexameter	feminine penthemimeral, trithemimeral
κνώδαλον, ὅττι δίοιτο· καὶ ἴχνεσι γὰρ περιῄδη·	-uu -u u-u u -uu - uu--	dactylic hexameter	feminine penthemimeral
νῦν δ’ἔχεται κακότητι, ἄναξ δέ οἱ ἄλλοθι πάτρης	- uu- uu-u u- u u -uu --	dactylic hexameter	feminine penthemimeral, hepthemimeral, trithemimeral
ὤλετο, τὸν δὲ γυναῖκες ἀκηδέες οὐ κομέουσι.	-uu - u u-u u-uu - uu--	dactylic hexameter	feminine penthemimeral, trithemimeral
δμῶες δ’,εὖτ’ ἂν μηκέτ’ ἐπικρατέωσιν ἄνακτες,	-- - - -u u-uu-u u--	dactylic hexameter	feminine penthemimeral, trithemimeral
οὐκέτ’ ἔπειτ’ ἐθέλουσιν ἐναίσιμα ἐργάζεσθαι·	-u u- uu-u u-uu ----	dactylic hexameter	feminine penthemimeral, trithemimeral
ἥμισυ γάρ τ’ἀρετῆς ἀποαίνυται εὐρύοπα Ζεὺς	-uu - uu- uu-uu -uu- -	dactylic hexameter	masculine penthemimeral, trithemimeral
ἀνέρος, εὖτ’ ἄν μιν κατὰ δούλιον ἦμαρ ἕλῃσιν.	-uu - - - uu -uu -u u--	dactylic hexameter	masculine penthemimeral, trithemimeral
ὣς εἰπὼν εἰσῆλθε δόμους εὖ ναιετάοντας,	- -- --u u- - -uu--	dactylic hexameter	feminine penthemimeral, hepthemimeral, trithemimeral
βῆ δ’ἰθὺς μεγάροιο μετὰ μνηστῆρας ἀγαυούς.	- -- uu-u u- --u u--	dactylic hexameter	feminine penthemimeral, hepthemimeral, trithemimeral
Ἄργον δ’αὖ κατὰ μοῖρ’ ἔλαβεν μέλανος θανάτοιο,	-- - uu - uu- uu- uu--	dactylic hexameter	masculine penthemimeral, hepthemimeral, trithemimeral
αὐτίκ’ ἰδόντ’ Ὀδυσῆα ἐεικοστῷ ἐνιαυτῷ.	-u u- uu-u u--- uu--	dactylic hexameter	feminine penthemimeral, trithemimeral
τὸν δὲ πολὺ πρῶτος ἴδε Τηλέμαχος θεοειδὴς	- u u- -- uu -uu- uu--	dactylic hexameter	masculine penthemimeral, trithemimeral
ἐρχόμενον κατὰ δῶμα συβώτην, ὧκα δ’ἔπειτα	-uu- uu -u u-- -u u--	dactylic hexameter	feminine penthemimeral, trithemimeral
νεῦσ’ ἐπὶ οἷ καλέσας· ὁ δὲ παπτήνας ἕλε δίφρον	- uu - uu- u u --- uu --	dactylic hexameter	masculine penthemimeral, trithemimeral
κείμενον, ἔνθα δὲ δαιτρὸς ἐφίζεσκε κρέα πολλὰ	-uu -u u -u u--- uu --	dactylic hexameter	feminine penthemimeral
δαιόμενος μνηστῆρσι δόμον κάτα δαινυμένοισι·	-uu- --u u- uu -uu--	dactylic hexameter	feminine penthemimeral, hepthemimeral, trithemimeral
τὸν κατέθηκε φέρων πρὸς Τηλεμάχοιο τράπεζαν	- uu-u u- - -uu-u u--	dactylic hexameter	masculine penthemimeral
ἀντίον, ἔνθα δ’ἄρ’ αὐτὸς ἐφέζετο· τῷ δ’ἄρα κῆρυξ	-uu -u u -u u-uu - uu --	dactylic hexameter	feminine penthemimeral
μοῖραν ἑλὼν ἐτίθει κανέου τ’ἐκ σῖτον ἀείρας.	-u u- uu- uu- - -u u--	dactylic hexameter	masculine penthemimeral, hepthemimeral, trithemimeral
ἀγχίμολον δὲ μετ’ αὐτὸν ἐδύσετο δώματ’ Ὀδυσσεύς,	-uu- u u -u u-uu -u u--	dactylic hexameter	feminine penthemimeral, trithemimeral
πτωχῷ λευγαλέῳ ἐναλίγκιος ἠδὲ γέροντι,	-- -uu- uu-uu -u u--	dactylic hexameter	masculine penthemimeral
σκηπτόμενος· τὰ δὲ λυγρὰ περὶ χροΐ εἵματα ἕστο.	-uu- u u -u u- uu -uu --	dactylic hexameter	feminine penthemimeral, hepthemimeral, trithemimeral
ἷζε δ’ἐπὶ μελίνου οὐδοῦ ἔντοσθε θυράων,	-u u- uu- -- --u u--	dactylic hexameter	masculine penthemimeral, hepthemimeral, trithemimeral
κλινάμενος σταθμῷ κυπαρισσίνῳ, ὅν ποτε τέκτων	-uu- -- uu-uu - uu --	dactylic hexameter	masculine penthemimeral, trithemimeral
ξέσσεν ἐπισταμένως καὶ ἐπὶ στάθμην ἴθυνε.	-u u-uu- u u- -- ---	dactylic hexameter	masculine penthemimeral, hepthemimeral
Τηλέμαχος δ’ἐπὶ οἷ καλέσας προσέειπε συβώτην,	-uu- uu - uu- uu-u u--	dactylic hexameter	masculine penthemimeral, hepthemimeral, trithemimeral
ἄρτον τ’οὖλον ἑλὼν περικαλλέος ἐκ κανέοιο	-- -u u- uu-uu - uu--	dactylic hexameter	masculine penthemimeral
καὶ κρέας, ὥς οἱ χεῖρες ἐχάνδανον ἀμφιβαλόντι·	- uu - - -u u-uu -uu--	dactylic hexameter	feminine penthemimeral, trithemimeral
δὸς τῷ ξείνῳ ταῦτα φέρων αὐτόν τε κέλευε	- - -- -u u- -- u u--	dactylic hexameter	feminine penthemimeral, hepthemimeral
αἰτίζειν μάλα πάντας ἐποιχόμενον μνηστῆρας·	--- uu -u u-uu- ---	dactylic hexameter	feminine penthemimeral, trithemimeral
αἰδὼς δ’οὐκ ἀγαθὴ κεχρημένῳ ἀνδρὶ παρεῖναι.	-- - uu- --uu -u u--	dactylic hexameter	masculine penthemimeral, trithemimeral
ὣς φάτο, βῆ δὲ συφορβός, ἐπεὶ τὸν μῦθον ἄκουσεν,	- uu - u u-u u- - -u u--	dactylic hexameter	feminine penthemimeral, hepthemimeral, trithemimeral
ἀγχοῦ δ’ἱστάμενος ἔπεα πτερόεντ’ ἀγόρευε·	-- -uu- uu- uu- uu--	dactylic hexameter	masculine penthemimeral, hepthemimeral
Τηλέμαχός τοι, ξεῖνε, διδοῖ τάδε, καί σε κελεύει	-uu- - -u u- uu - u u--	dactylic hexameter	feminine penthemimeral, hepthemimeral, trithemimeral
αἰτίζειν μάλα πάντας ἐποιχόμενον μνηστῆρας·	--- uu -u u-uu- ---	dactylic hexameter	feminine penthemimeral, trithemimeral
αἰδῶ δ’οὐκ ἀγαθήν φησ’ ἔμμεναι ἀνδρὶ προΐκτῃ.	-- - uu- - -uu -u u--	dactylic hexameter	masculine penthemimeral, trithemimeral
τὸν δ’ἀπαμειβόμενος προσέφη πολύμητις Ὀδυσσεύς·	- uu-uu- uu- uu-u u--	dactylic hexameter	masculine penthemimeral, hepthemimeral
Ζεῦ ἄνα, Τηλέμαχόν μοι ἐν ἀνδράσιν ὄλβιον εἶναι,	- uu -uu- u u -uu -uu --	dactylic hexameter	masculine penthemimeral
καί οἱ πάντα γένοιτο ὅσα φρεσὶν ᾗσι μενοινᾷ.	- - -u u-u u- uu -u u--	dactylic hexameter	feminine penthemimeral, hepthemimeral
ἦ ῥα καὶ ἀμφοτέρῃσιν ἐδέξατο καὶ κατέθηκεν	- u u -uu-u u-uu - uu--	dactylic hexameter	feminine penthemimeral
αὖθι ποδῶν προπάροιθεν, ἀεικελίης ἐπὶ πήρης,	-u u- uu-u u-uu- uu --	dactylic hexameter	feminine penthemimeral, trithemimeral
ἤσθιε δ’ἕως ὅτ’ ἀοιδὸς ἐνὶ μεγάροισιν ἄειδεν·	-uu - u u-u u- uu-u u--	dactylic hexameter	feminine penthemimeral, hepthemimeral, trithemimeral
εὖθ’ ὁ δεδειπνήκειν, ὁ δ’ἐπαύετο θεῖος ἀοιδός.	- u u--- u u-uu -u u--	dactylic hexameter	masculine penthemimeral
μνηστῆρες δ’ὁμάδησαν ἀνὰ μέγαρ’. αὐτὰρ Ἀθήνη,	--- uu-u u- uu -u u--	dactylic hexameter	feminine penthemimeral, hepthemimeral, trithemimeral
ἄγχι παρισταμένη Λαερτιάδην Ὀδυσῆα	-u u-uu- --uu- uu--	dactylic hexameter	masculine penthemimeral
ὤτρυν’, ὡς ἂν πύρνα κατὰ μνηστῆρας ἀγείροι,	-- - - -u u- --u u--	dactylic hexameter	feminine penthemimeral, hepthemimeral, trithemimeral
γνοίη θ’οἵ τινές εἰσιν ἐναίσιμοι οἵ τ’ἀθέμιστοι·	-- - uu -u u-uu - uu--	dactylic hexameter	feminine penthemimeral, trithemimeral
ἀλλ’ οὐδ’ ὥς τιν’ ἔμελλ’ ἀπαλεξήσειν κακότητος.	- - - u u- uu--- uu--	dactylic hexameter	masculine penthemimeral, trithemimeral
βῆ δ’ἴμεν αἰτήσων ἐνδέξια φῶτα ἕκαστον,	- uu --- --uu -u u--	dactylic hexameter	masculine penthemimeral
πάντοσε χεῖρ’ ὀρέγων, ὡς εἰ πτωχὸς πάλαι εἴη.	-uu - uu- - - -- uu --	dactylic hexameter	masculine penthemimeral, hepthemimeral, trithemimeral
οἱ δ’ἐλεαίροντες δίδοσαν, καὶ ἐθάμβεον αὐτόν,	- uu--- uu- u u-uu --	dactylic hexameter	masculine penthemimeral, hepthemimeral
ἀλλήλους τ’εἴροντο τίς εἴη καὶ πόθεν ἔλθοι.	--- --u u -- - uu --	dactylic hexameter	feminine penthemimeral, trithemimeral
τοῖσι δὲ καὶ μετέειπε Μελάνθιος, αἰπόλος αἰγῶν·	-u u - uu-u u-uu -uu --	dactylic hexameter	feminine penthemimeral, trithemimeral
κέκλυτέ μευ, μνηστῆρες ἀγακλειτῆς βασιλείης,	-uu - --u u--- uu--	dactylic hexameter	feminine penthemimeral, trithemimeral
τοῦδε περὶ ξείνου· ἦ γάρ πρόσθεν μιν ὄπωπα.	-u u- -- - - -- u u--	dactylic hexameter	masculine penthemimeral, hepthemimeral, trithemimeral
ἤτοι μέν οἱ δεῦρο συβώτης ἡγεμόνευεν,	-- - - -u u-- -uu--	dactylic hexameter	feminine penthemimeral, trithemimeral
αὐτὸν δ’οὐ σάφα οἶδα, πόθεν γένος εὔχεται εἶναι.	-- - uu -u u- uu -uu --	dactylic hexameter	feminine penthemimeral, hepthemimeral, trithemimeral
ὣς ἔφατ’, Ἀντίνοος δ’ἔπεσιν νείκεσσε συβώτην·	- uu -uu- uu- --u u--	dactylic hexameter	masculine penthemimeral, hepthemimeral
ὠρίγνωτε συβῶτα, τίη δὲ σὺ τόνδε πόλινδε	---u u-u u- u u -u u--	dactylic hexameter	feminine penthemimeral, hepthemimeral
ἤγαγες; ἦ οὐχ ἅλις ἧμιν ἀλήμονές εἰσι καὶ ἄλλοι,	-uu - uu -u u-uu -u u --	dactylic hexameter	feminine penthemimeral, trithemimeral
πτωχοὶ ἀνιηροί, δαιτῶν ἀπολυμαντῆρες;	-u u--- -- uu----	dactylic hexameter	masculine penthemimeral, hepthemimeral
ἦ ὄνοσαι ὅτι τοι βίοτον κατέδουσιν ἄνακτος	- uu- uu - uu- uu-u u--	dactylic hexameter	masculine penthemimeral, hepthemimeral, trithemimeral
ἐνθάδ’ ἀγειρόμενοι, σὺ δὲ καὶ ποθὶ τόνδ’ ἐκάλεσσας;	-u u-uu- u u - uu - uu--	dactylic hexameter	masculine penthemimeral, hepthemimeral
τὸν δ’ἀπαμειβόμενος προσέφης, Εὔμαιε συβῶτα·	- uu-uu- uu- --u u--	dactylic hexameter	masculine penthemimeral, hepthemimeral
Ἀντίνο’, οὐ μὲν καλὰ καὶ ἐσθλὸς ἐὼν ἀγορεύεις·	-uu - - -u u -u u- uu--	dactylic hexameter	feminine penthemimeral, trithemimeral
τίς γὰρ δὴ ξεῖνον καλεῖ ἄλλοθεν αὐτὸς ἐπελθὼν	- - - -- uu -uu -u u--	dactylic hexameter	masculine penthemimeral, trithemimeral
ἄλλον γ’,εἰ μὴ τῶν οἳ δημιοεργοὶ ἔασι,	-- - - - - -uu-u u--	dactylic hexameter	masculine penthemimeral, trithemimeral
μάντιν ἢ ἰητῆρα κακῶν ἢ τέκτονα δούρων,	-u u ---u u- - -uu --	dactylic hexameter	feminine penthemimeral, hepthemimeral
ἢ καὶ θέσπιν ἀοιδόν, ὅ κεν τέρπῃσιν ἀείδων;	- - -u u-u u - --u u--	dactylic hexameter	feminine penthemimeral, hepthemimeral
οὗτοι γὰρ κλητοί γε βροτῶν ἐπ’ ἀπείρονα γαῖαν·	-- - -- u u- u u-uu --	dactylic hexameter	masculine penthemimeral, hepthemimeral, trithemimeral
πτωχὸν δ’οὐκ ἄν τις καλέοι τρύξοντα ἓ αὐτόν.	-- - - - uu- --u u --	dactylic hexameter	masculine penthemimeral, hepthemimeral, trithemimeral
ἀλλ’ αἰεὶ χαλεπὸς περὶ πάντων εἶς μνηστήρων	- -- uu- uu -- - ---	dactylic hexameter	masculine penthemimeral, trithemimeral
δμωσὶν Ὀδυσσῆος, πέρι δ’αὖτ’ ἐμοί· αὐτὰρ ἔγωγε	-u u--- uu - uu -u u--	dactylic hexameter	masculine penthemimeral, hepthemimeral
οὐκ ἀλέγω, εἵως μοι ἐχέφρων Πηνελόπεια	- uu- -- u u-- -uu--	dactylic hexameter	masculine penthemimeral, trithemimeral
ζώει ἐνὶ μεγάροις καὶ Τηλέμαχος θεοειδής.	-u u- uu- - -uu- uu--	dactylic hexameter	masculine penthemimeral, trithemimeral
τὸν δ’αὖ Τηλέμαχος πεπνυμένος ἀντίον ηὔδα·	- - -uu- --uu -uu --	dactylic hexameter	masculine penthemimeral
σίγα, μή μοι τοῦτον ἀμείβεο πόλλ’ ἐπέεσσιν·	-- - - -u u-uu - uu--	dactylic hexameter	feminine penthemimeral, trithemimeral
Ἀντίνοος δ’εἴωθε κακῶς ἐρεθιζέμεν αἰεὶ	-uu- --u u- uu-uu --	dactylic hexameter	feminine penthemimeral, hepthemimeral, trithemimeral
μύθοισιν χαλεποῖσιν, ἐποτρύνει δὲ καὶ ἄλλους.	--- uu-u u--- u u --	dactylic hexameter	feminine penthemimeral, trithemimeral
ἦ ῥα καὶ Ἀντίνοον ἔπεα πτερόεντα προσηύδα·	- u u -uu- uu- uu-u u--	dactylic hexameter	masculine penthemimeral, hepthemimeral
Ἀντίνο’, ἦ μευ καλὰ πατὴρ ὣς κήδεαι υἷος,	-uu - - -u u- - -uu --	dactylic hexameter	feminine penthemimeral, hepthemimeral, trithemimeral
ὃς τὸν ξεῖνον ἄνωγας ἀπὸ μεγάροιο διέσθαι	- - -u u-u u- uu-u u--	dactylic hexameter	feminine penthemimeral, hepthemimeral
μύθῳ ἀναγκαίῳ· μὴ τοῦτο θεὸς τελέσειε.	-u u--- - -u u- uu--	dactylic hexameter	masculine penthemimeral
δός οἱ ἑλών· οὔ τοι φθονέω· κέλομαι γὰρ ἔγωγε·	- u u- - - uu- uu- u u--	dactylic hexameter	masculine penthemimeral, hepthemimeral, trithemimeral
μήτ’ οὖν μητέρ’ ἐμὴν ἅζευ τό γε μήτε τιν’ ἄλλον	- - -u u- -- u u -u u --	dactylic hexameter	masculine penthemimeral, hepthemimeral
δμώων, οἳ κατὰ δώματ’ Ὀδυσσῆος θείοιο.	-- - uu -u u--- ---	dactylic hexameter	feminine penthemimeral, trithemimeral
ἀλλ’ οὔ τοι τοιοῦτον ἐνὶ στήθεσσι νόημα·	- - - --u u- --u u--	dactylic hexameter	feminine penthemimeral, hepthemimeral, trithemimeral
αὐτὸς γὰρ φαγέμεν πολὺ βούλεαι ἢ δόμεν ἄλλῳ.	-- - uu- uu -uu - uu --	dactylic hexameter	masculine penthemimeral, trithemimeral
τὸν δ’αὖτ’ Ἀντίνοος ἀπαμειβόμενος προσέειπε·	- - -uu- uu-uu- uu--	dactylic hexameter	masculine penthemimeral
Τηλέμαχ’ ὑψαγόρη, μένος ἄσχετε, ποῖον ἔειπες.	-uu -uu- uu -uu -u u--	dactylic hexameter	masculine penthemimeral
εἴ οἱ τόσσον πάντες ὀρέξειαν μνηστῆρες,	- - -- -u u--- ---	dactylic hexameter	feminine penthemimeral
καί κέν μιν τρεῖς μῆνας ἀπόπροθεν οἶκος ἐρύκοι.	- - - - -u u-uu -u u--	dactylic hexameter	feminine penthemimeral, trithemimeral
ὣς ἄρ’ ἔφη, καὶ θρῆνυν ἑλὼν ὑπέφηνε τραπέζης	- u u- - -u u- uu-u u--	dactylic hexameter	feminine penthemimeral, hepthemimeral, trithemimeral
κείμενον, ᾧ ῥ’ἔπεχεν λιπαροὺς πόδας εἰλαπινάζων·	-uu - uu- uu- uu -uu--	dactylic hexameter	masculine penthemimeral, hepthemimeral, trithemimeral
οἱ δ’ἄλλοι πάντες δίδοσαν, πλῆσαν δ’ἄρα πήρην	- -- -- uu- -- uu --	dactylic hexameter	masculine penthemimeral, hepthemimeral, trithemimeral
σίτου καὶ κρειῶν· τάχα δὴ καὶ ἔμελλεν Ὀδυσσεὺς	-- - -- uu - u u-u u--	dactylic hexameter	masculine penthemimeral, hepthemimeral, trithemimeral
αὖτις ἐπ’ οὐδὸν ἰὼν προικὸς γεύσασθαι Ἀχαιῶν·	-u u -u u- -- --u u--	dactylic hexameter	masculine penthemimeral, hepthemimeral
στῆ δὲ παρ’ Ἀντίνοον, καί μιν πρὸς μῦθον ἔειπε·	- u u -uu- - - - -u u--	dactylic hexameter	masculine penthemimeral, hepthemimeral
δός, φίλος· οὐ μέν μοι δοκέεις ὁ κάκιστος Ἀχαιῶν	- uu - - - uu- u u-u u--	dactylic hexameter	masculine penthemimeral, hepthemimeral, trithemimeral
ἔμμεναι, ἀλλ’ ὤριστος, ἐπεὶ βασιλῆϊ ἔοικας.	-uu - --u u- uu-u u--	dactylic hexameter	feminine penthemimeral, hepthemimeral, trithemimeral
τῶ σε χρὴ δόμεναι καὶ λώϊον ἠέ περ ἄλλοι	- - - uu- - -uu -u u --	dactylic hexameter	masculine penthemimeral, trithemimeral
σίτου· ἐγὼ δέ κέ σε κλείω κατ’ ἀπείρονα γαῖαν.	-u u- u u - -- u u-uu --	dactylic hexameter	masculine penthemimeral, hepthemimeral, trithemimeral
καὶ γὰρ ἐγώ ποτε οἶκον ἐν ἀνθρώποισιν ἔναιον	- u u- uu -u u ---u u--	dactylic hexameter	feminine penthemimeral, trithemimeral
ὄλβιος ἀφνειὸν καὶ πολλάκι δόσκον ἀλήτῃ,	-uu --- - -uu -u u--	dactylic hexameter	masculine penthemimeral
τοίῳ ὁποῖος ἔοι καὶ ὅτευ κεχρημένος ἔλθοι·	-u u-u u- u u- --uu --	dactylic hexameter	masculine penthemimeral, hepthemimeral
ἦσαν δὲ δμῶες μάλα μυρίοι ἄλλα τε πολλὰ	-- - -- uu -uu -u u --	dactylic hexameter	masculine penthemimeral, trithemimeral
οἷσίν τ’εὖ ζώουσι καὶ ἀφνειοὶ καλέονται.	-- - --u u --- uu--	dactylic hexameter	feminine penthemimeral, trithemimeral
ἀλλὰ Ζεὺς ἀλάπαξε Κρονίων ἤθελε γάρ που	-- - uu-u u-- -uu - -	dactylic hexameter	feminine penthemimeral, trithemimeral
ὅς μ’ἅμα ληϊστῆρσι πολυπλάγκτοισιν ἀνῆκεν	- uu ---u u---u u--	dactylic hexameter	feminine penthemimeral
Αἴγυπτόνδ’ ἰέναι, δολιχὴν ὁδόν, ὄφρ’ ἀπολοίμην.	--- uu- uu- uu - uu--	dactylic hexameter	masculine penthemimeral, hepthemimeral, trithemimeral
στῆσα δ’ἐν Αἰγύπτῳ ποταμῷ νέας ἀμφιελίσσας.	-u u --- uu- uu -uu--	dactylic hexameter	masculine penthemimeral, hepthemimeral
ἔνθ’ ἤτοι μὲν ἐγὼ κελόμην ἐρίηρας ἑταίρους	- -- u u- uu- uu-u u--	dactylic hexameter	masculine penthemimeral, hepthemimeral, trithemimeral
αὐτοῦ πὰρ νήεσσι μένειν καὶ νῆας ἔρυσθαι,	-- - --u u- - -u u--	dactylic hexameter	feminine penthemimeral, hepthemimeral, trithemimeral
ὀπτῆρας δὲ κατὰ σκοπιὰς ὤτρυνα νέεσθαι.	--- u u- uu- --u u--	dactylic hexameter	masculine penthemimeral, hepthemimeral, trithemimeral
οἱ δ’ὕβρει εἴξαντες, ἐπισπόμενοι μένεϊ σφῷ,	- -- --u u-uu- uu- -	dactylic hexameter	feminine penthemimeral, trithemimeral
αἶψα μάλ’ Αἰγυπτίων ἀνδρῶν περικαλλέας ἀγροὺς	-u u --- -- uu-uu --	dactylic hexameter	masculine penthemimeral, hepthemimeral
πόρθεον, ἐκ δὲ γυναῖκας ἄγον καὶ νήπια τέκνα,	-uu - u u-u u- - -uu --	dactylic hexameter	feminine penthemimeral, hepthemimeral, trithemimeral
αὐτούς τ’ἔκτεινον· τάχα δ’ἐς πόλιν ἵκετ’ ἀϋτή.	-- --- uu - uu -u u--	dactylic hexameter	masculine penthemimeral, hepthemimeral
οἱ δὲ βοῆς ἀΐοντες ἅμ’ ἠοῖ φαινομένηφι	- u u- uu-u u -- -uu--	dactylic hexameter	feminine penthemimeral, trithemimeral
ἦλθον· πλῆτο δὲ πᾶν πεδίον πεζῶν τε καὶ ἵππων	-- -u u - uu- -- u u --	dactylic hexameter	masculine penthemimeral, hepthemimeral
χαλκοῦ τε στεροπῆς· ἐν δὲ Ζεὺς τερπικέραυνος	-- - uu- - - - -uu--	dactylic hexameter	masculine penthemimeral, hepthemimeral, trithemimeral
φύζαν ἐμοῖς ἑτάροισι κακὴν βάλεν, οὐδέ τις ἔτλη	-u u- uu-u u- uu -u u --	dactylic hexameter	feminine penthemimeral, hepthemimeral, trithemimeral
στῆναι ἐναντίβιον· περὶ γὰρ κακὰ πάντοθεν ἔστη.	-u u-uu- uu - uu -uu --	dactylic hexameter	masculine penthemimeral, hepthemimeral
ἔνθ’ ἡμέων πολλοὺς μὲν ἀπέκτανον ὀξέϊ χαλκῷ,	- -- -- u u-uu -uu --	dactylic hexameter	masculine penthemimeral, trithemimeral
τοὺς δ’ἄναγον ζωούς, σφίσιν ἐργάζεσθαι ἀνάγκῃ.	- uu- -- uu ---u u--	dactylic hexameter	masculine penthemimeral, trithemimeral
αὐτὰρ ἔμ’ ἐς Κύπρον ξείνῳ δόσαν ἀντιάσαντι,	-u u - -- -- uu -uu--	dactylic hexameter	masculine penthemimeral, hepthemimeral, trithemimeral
Δμήτορι Ἰασίδῃ, ὃς Κύπρου ἶφι ἄνασσεν·	-uu -uu- - -- -u u--	dactylic hexameter	masculine penthemimeral
ἔνθεν δὴ νῦν δεῦρο τόδ’ ἵκω πήματα πάσχων.	-- - - -u u -- -uu --	dactylic hexameter	feminine penthemimeral, trithemimeral
τὸν δ’αὖτ’ Ἀντίνοος ἀπαμείβετο φώνησέν τε·	- - -uu- uu-uu --- -	dactylic hexameter	masculine penthemimeral
τίς δαίμων τόδε πῆμα προσήγαγε, δαιτὸς ἀνίην;	- -- uu -u u-uu -u u--	dactylic hexameter	feminine penthemimeral, trithemimeral
στῆθ’ οὕτως ἐς μέσσον, ἐμῆς ἀπάνευθε τραπέζης,	- -- - -u u- uu-u u--	dactylic hexameter	feminine penthemimeral, hepthemimeral, trithemimeral
μὴ τάχα πικρὴν Αἴγυπτον καὶ Κύπρον ἴδηαι·	- uu -- --- - -u u--	dactylic hexameter	hepthemimeral
ὥς τις θαρσαλέος καὶ ἀναιδής ἐσσι προΐκτης.	- - -uu- u u-- -u u--	dactylic hexameter	masculine penthemimeral
ἑξείης πάντεσσι παρίστασαι· οἱ δὲ διδοῦσι	--- --u u-uu - u u--	dactylic hexameter	feminine penthemimeral, trithemimeral
μαψιδίως, ἐπεὶ οὔ τις ἐπίσχεσις οὐδ’ ἐλεητὺς	-uu- uu - u u-uu - uu--	dactylic hexameter	masculine penthemimeral, trithemimeral
ἀλλοτρίων χαρίσασθαι, ἐπεὶ πάρα πολλὰ ἑκάστῳ.	-uu- uu-u u- uu -u u--	dactylic hexameter	feminine penthemimeral, hepthemimeral, trithemimeral
τὸν δ’ἀναχωρήσας προσέφη πολύμητις Ὀδυσσεύς·	- uu--- uu- uu-u u--	dactylic hexameter	masculine penthemimeral, hepthemimeral
ὢ πόποι, οὐκ ἄρα σοί γ’ἐπὶ εἴδεϊ καὶ φρένες ἦσαν·	- uu - uu - uu -uu - uu --	dactylic hexameter	masculine penthemimeral, trithemimeral
οὐ σύ γ’ἂν ἐξ οἴκου σῷ ἐπιστάτῃ οὐδ’ ἅλα δοίης,	- u u - -- u u-uu - uu --	dactylic hexameter	masculine penthemimeral, trithemimeral
ὃς νῦν ἀλλοτρίοισι παρήμενος οὔ τί μοι ἔτλης	- - -uu-u u-uu - u u --	dactylic hexameter	feminine penthemimeral
σίτου ἀποπροελὼν δόμεναι· τὰ δὲ πολλὰ πάρεστιν.	-u u-uu- uu- u u -u u--	dactylic hexameter	masculine penthemimeral, hepthemimeral
ὣς ἔφατ’, Ἀντίνοος δὲ χολώσατο κηρόθι μᾶλλον,	- uu -uu- u u-uu -uu --	dactylic hexameter	masculine penthemimeral
καί μιν ὑπόδρα ἰδὼν ἔπεα πτερόεντα προσηύδα·	- u u-u u- uu- uu-u u--	dactylic hexameter	masculine penthemimeral, hepthemimeral
νῦν δή σ’οὐκέτι καλὰ διὲκ μεγάροιό γ’ὀΐω	- - -uu -u u- uu-u u--	dactylic hexameter	feminine penthemimeral, hepthemimeral
ἂψ ἀναχωρήσειν, ὅτε δὴ καὶ ὀνείδεα βάζεις.	- uu--- uu - u u-uu --	dactylic hexameter	masculine penthemimeral, hepthemimeral
ὣς ἄρ’ ἔφη, καὶ θρῆνυν ἑλὼν βάλε δεξιὸν ὧμον,	- u u- - -u u- uu -uu --	dactylic hexameter	feminine penthemimeral, hepthemimeral, trithemimeral
πρυμνότατον κατὰ νῶτον· ὁ δ’ἐστάθη ἠΰτε πέτρη	-uu- uu -u u -uu -uu --	dactylic hexameter	feminine penthemimeral, trithemimeral
ἔμπεδον, οὐδ’ ἄρα μιν σφῆλεν βέλος Ἀντινόοιο,	-uu - uu - -- uu -uu--	dactylic hexameter	masculine penthemimeral, hepthemimeral, trithemimeral
ἀλλ’ ἀκέων κίνησε κάρη, κακὰ βυσσοδομεύων.	- uu- --u u- uu -uu--	dactylic hexameter	feminine penthemimeral, hepthemimeral, trithemimeral
ἂψ δ’ὅ γ’ἐπ’ οὐδὸν ἰὼν κατ’ ἄρ’ ἕζετο, κὰδ δ’ἄρα πήρην	- u u -u u- u u -uu - uu --	dactylic hexameter	masculine penthemimeral
θῆκεν ἐϋπλείην, μετὰ δὲ μνηστῆρσιν ἔειπε·	-u u--- uu - --u u--	dactylic hexameter	masculine penthemimeral, hepthemimeral
κέκλυτέ μευ, μνηστῆρες ἀγακλειτῆς βασιλείης,	-uu - --u u--- uu--	dactylic hexameter	feminine penthemimeral, trithemimeral
ὄφρ’ εἴπω τά με θυμὸς ἐνὶ στήθεσσι κελεύει.	- -- u u -u u- --u u--	dactylic hexameter	feminine penthemimeral, hepthemimeral, trithemimeral
οὐ μὰν οὔτ’ ἄχος ἐστὶ μετὰ φρεσὶν οὔτε τι πένθος,	- - - uu -u u- uu -u u --	dactylic hexameter	feminine penthemimeral, hepthemimeral, trithemimeral
ὁππότ’ ἀνὴρ περὶ οἷσι μαχειόμενος κτεάτεσσι	-u u- uu -u u-uu- uu--	dactylic hexameter	feminine penthemimeral, trithemimeral
βλήεται, ἢ περὶ βουσὶν ἢ ἀργεννῇς ὀΐεσσιν·	-uu - uu -u u --- uu--	dactylic hexameter	feminine penthemimeral, trithemimeral
αὐτὰρ ἔμ’ Ἀντίνοος βάλε γαστέρος εἵνεκα λυγρῆς,	-u u -uu- uu -uu -uu --	dactylic hexameter	masculine penthemimeral
οὐλομένης, ἣ πολλὰ κάκ’ ἀνθρώποισι δίδωσιν.	-uu- - -u u ---u u--	dactylic hexameter	feminine penthemimeral, trithemimeral
ἀλλ’ εἴ που πτωχῶν γε θεοὶ καὶ Ἐρινύες εἰσίν,	- - - -- u u- u u-uu --	dactylic hexameter	masculine penthemimeral, hepthemimeral, trithemimeral
Ἀντίνοον πρὸ γάμοιο τέλος θανάτοιο κιχείη.	-uu- u u-u u- uu-u u--	dactylic hexameter	feminine penthemimeral, hepthemimeral, trithemimeral
τὸν δ’αὖτ’ Ἀντίνοος προσέφη, Εὐπείθεος υἱός·	- - -uu- uu- --uu --	dactylic hexameter	masculine penthemimeral, hepthemimeral
ἔσθι’ ἕκηλος, ξεῖνε, καθήμενος, ἢ ἄπιθ’ ἄλλῃ,	-u u-- -u u-uu - uu --	dactylic hexameter	feminine penthemimeral
μή σε νέοι διὰ δώματ’ ἐρύσσωσ’, οἷ’ ἀγορεύεις,	- u u- uu -u u-- - uu--	dactylic hexameter	feminine penthemimeral, trithemimeral
ἢ ποδὸς ἢ καὶ χειρός, ἀποδρύψωσι δὲ πάντα.	- uu - - -u u---u u --	dactylic hexameter	feminine penthemimeral, trithemimeral
ὣς ἔφαθ’, οἱ δ’ἄρα πάντες ὑπερφιάλως νεμέσησαν·	- uu - uu -u u-uu- uu--	dactylic hexameter	feminine penthemimeral, trithemimeral
ὦδε δέ τις εἴπεσκε νέων ὑπερηνορεόντων·	-u u - --u u- uu-uu--	dactylic hexameter	feminine penthemimeral, hepthemimeral, trithemimeral
Ἀντίνο’, οὐ μὲν κάλ’ ἔβαλες δύστηνον ἀλήτην,	-uu - - - uu- --u u--	dactylic hexameter	masculine penthemimeral, hepthemimeral, trithemimeral
οὐλόμεν’, εἰ δή πού τις ἐπουράνιος θεός ἐστι.	-uu - - - u u-uu- uu --	dactylic hexameter	masculine penthemimeral, trithemimeral
καί τε θεοὶ ξείνοισιν ἐοικότες ἀλλοδαποῖσι,	- u u- --u u-uu -uu--	dactylic hexameter	feminine penthemimeral, trithemimeral
παντοῖοι τελέθοντες, ἐπιστρωφῶσι πόληας,	--- uu-u u---u u--	dactylic hexameter	feminine penthemimeral, trithemimeral
ἀνθρώπων ὕβριν τε καὶ εὐνομίην ἐφορῶντες.	--- -- u u -uu- uu--	dactylic hexameter	masculine penthemimeral, trithemimeral
ὣς ἄρ’ ἔφαν μνηστῆρες, ὁ δ’οὐκ ἐμπάζετο μύθων.	- u u- --u u - --uu --	dactylic hexameter	feminine penthemimeral, hepthemimeral, trithemimeral
Τηλέμαχος δ’ἐν μὲν κραδίῃ μέγα πένθος ἄεξε	-uu- - - uu- uu -u u--	dactylic hexameter	masculine penthemimeral, hepthemimeral, trithemimeral
βλημένου, οὐδ’ ἄρα δάκρυ χαμαὶ βάλεν ἐκ βλεφάροιϊν,	-uu - uu -u u- uu - uu--	dactylic hexameter	feminine penthemimeral, hepthemimeral, trithemimeral
ἀλλ’ ἀκέων κίνησε κάρη, κακὰ βυσσοδομεύων.	- uu- --u u- uu -uu--	dactylic hexameter	feminine penthemimeral, hepthemimeral, trithemimeral
τοῦ δ’ὡς οὖν ἤκουσε περίφρων Πηνελόπεια	- - - --u u-- -uu--	dactylic hexameter	feminine penthemimeral, trithemimeral
βλημένου ἐν μεγάρῳ, μετ’ ἄρα δμῳῇσιν ἔειπεν·	-uu - uu- u u- --u u--	dactylic hexameter	masculine penthemimeral, hepthemimeral, trithemimeral
αἴθ’ οὕτως αὐτόν σε βάλοι κλυτότοξος Ἀπόλλων.	- -- -- u u- uu-u u--	dactylic hexameter	masculine penthemimeral, hepthemimeral, trithemimeral
τὴν δ’αὖτ’ Εὐρυνόμη ταμίη πρὸς μῦθον ἔειπεν·	- - -uu- uu- - -u u--	dactylic hexameter	masculine penthemimeral, hepthemimeral
εἰ γὰρ ἐπ’ ἀρῇσιν τέλος ἡμετέρῃσι γένοιτο·	- u u --- uu -uu-u u--	dactylic hexameter	masculine penthemimeral
οὐκ ἄν τις τούτων γε ἐΰθρονον Ἠῶ ἵκοιτο.	- - - -- u u-uu -u u--	dactylic hexameter	masculine penthemimeral, trithemimeral
τὴν δ’αὖτε προσέειπε περίφρων Πηνελόπεια·	- -- uu-u u-- -uu--	dactylic hexameter	feminine penthemimeral, trithemimeral
μαῖ’, ἐχθροὶ μὲν πάντες, ἐπεὶ κακὰ μηχανόωνται·	- -- - -u u- uu -uu--	dactylic hexameter	feminine penthemimeral, hepthemimeral, trithemimeral
Ἀντίνοος δὲ μάλιστα μελαίνῃ κηρὶ ἔοικε.	-uu- u u-u u-- -u u--	dactylic hexameter	feminine penthemimeral, trithemimeral
ξεῖνός τις δύστηνος ἀλητεύει κατὰ δῶμα	-- - --u u--- uu --	dactylic hexameter	feminine penthemimeral, trithemimeral
ἀνέρας αἰτίζων· ἀχρημοσύνη γὰρ ἀνώγει·	-uu --- --uu- u u--	dactylic hexameter	masculine penthemimeral
ἔνθ’ ἄλλοι μὲν πάντες ἐνέπλησάν τ’ἔδοσάν τε,	- -- - -u u--- uu- -	dactylic hexameter	feminine penthemimeral, trithemimeral
οὗτος δὲ θρήνυι πρυμνὸν βάλε δεξιὸν ὧμον.	-- - -- -- uu -uu --	dactylic hexameter	masculine penthemimeral, hepthemimeral, trithemimeral
ἡ μὲν ἄρ’ ὣς ἀγόρευε μετὰ δμῳῇσι γυναιξίν,	- u u - uu-u u- --u u--	dactylic hexameter	feminine penthemimeral, hepthemimeral, trithemimeral
ἡμένη ἐν θαλάμῳ· ὁ δ’ἐδείπνει δῖος Ὀδυσσεύς·	-uu - uu- u u-- -u u--	dactylic hexameter	masculine penthemimeral, trithemimeral
ἡ δ’ἐπὶ οἷ καλέσασα προσηύδα δῖον ὑφορβόν·	- uu - uu-u u-- -u u--	dactylic hexameter	feminine penthemimeral, trithemimeral
ἔρχεο, δῖ’ Εὔμαιε, κιὼν τὸν ξεῖνον ἄνωχθι	-uu - --u u- - -u u--	dactylic hexameter	feminine penthemimeral, hepthemimeral, trithemimeral
ἐλθέμεν, ὄφρα τί μιν προσπτύξομαι ἠδ’ ἐρέωμαι	-uu -u u - --uu - uu--	dactylic hexameter	masculine penthemimeral
εἴ που Ὀδυσσῆος ταλασίφρονος ἠὲ πέπυσται	- u u--- uu-uu -u u--	dactylic hexameter	masculine penthemimeral
ἢ ἴδεν ὀφθαλμοῖσι· πολυπλάγκτῳ γὰρ ἔοικε.	- uu ---u u--- u u--	dactylic hexameter	feminine penthemimeral
τὴν δ’ἀπαμειβόμενος προσέφης, Εὔμαιε συβῶτα·	- uu-uu- uu- --u u--	dactylic hexameter	masculine penthemimeral, hepthemimeral
εἰ γάρ τοι, βασίλεια, σιωπήσειαν Ἀχαιοί·	- - - uu-u u---u u--	dactylic hexameter	feminine penthemimeral, trithemimeral
οἷ’ ὅ γε μυθεῖται, θέλγοιτό κέ τοι φίλον ἦτορ.	- u u --- --u u - uu --	dactylic hexameter	masculine penthemimeral
τρεῖς γὰρ δή μιν νύκτας ἔχον, τρία δ’ἤματ’ ἔρυξα	- - - - -u u- uu -u u--	dactylic hexameter	feminine penthemimeral, hepthemimeral, trithemimeral
ἐν κλισίῃ· πρῶτον γὰρ ἔμ’ ἵκετο νηὸς ἀποδράς·	- uu- -- u u -uu -u u--	dactylic hexameter	masculine penthemimeral, trithemimeral
ἀλλ’ οὔ πω κακότητα διήνυσεν ἣν ἀγορεύων.	- - - uu-u u-uu - uu--	dactylic hexameter	feminine penthemimeral, trithemimeral
ὡς δ’ὅτ’ ἀοιδὸν ἀνὴρ ποτιδέρκεται, ὅς τε θεῶν ἒξ	- u u-u u- uu-uu - u u- -	dactylic hexameter	masculine penthemimeral
ἀείδῃ δεδαὼς ἔπε’ ἱμερόεντα βροτοῖσι,	--- uu- uu -uu-u u--	dactylic hexameter	masculine penthemimeral, trithemimeral
τοῦ δ’ἄμοτον μεμάασιν ἀκουέμεν, ὁππότ’ ἀείδῃ·	- uu- uu-u u-uu -u u--	dactylic hexameter	feminine penthemimeral, trithemimeral
ὣς ἐμὲ κεῖνος ἔθελγε παρήμενος ἐν μεγάροισι.	- uu -u u-u u-uu - uu--	dactylic hexameter	feminine penthemimeral
φησὶ δ’Ὀδυσσῆος ξεῖνος πατρώϊος εἶναι,	-u u--- -- --uu --	dactylic hexameter	masculine penthemimeral, hepthemimeral
Κρήτῃ ναιετάων, ὅθι Μίνωος γένος ἐστίν.	-- -uu- uu --- uu --	dactylic hexameter	masculine penthemimeral
ἔνθεν δὴ νῦν δεῦρο τόδ’ ἵκετο πήματα πάσχων,	-- - - -u u -uu -uu --	dactylic hexameter	feminine penthemimeral, trithemimeral
προπροκυλινδόμενος· στεῦται δ’Ὀδυσῆος ἀκοῦσαι,	-uu-uu- -- uu-u u--	dactylic hexameter	masculine penthemimeral, hepthemimeral
ἀγχοῦ, Θεσπρωτῶν ἀνδρῶν ἐν πίονι δήμῳ,	-- --- -- - -uu --	dactylic hexameter	masculine penthemimeral, hepthemimeral
ζωοῦ· πολλὰ δ’ἄγει κειμήλια ὅνδε δόμονδε.	-- -u u- --uu -u u--	dactylic hexameter	masculine penthemimeral
τὸν δ’αὖτε προσέειπε περίφρων Πηνελόπεια·	- -- uu-u u-- -uu--	dactylic hexameter	feminine penthemimeral, trithemimeral
ἔρχεο, δεῦρο κάλεσσον, ἵν’ ἀντίον αὐτὸς ἐνίσπῃ.	-uu -u u-u u -uu -u u--	dactylic hexameter	feminine penthemimeral
οὗτοι δ’ἠὲ θύρῃσι καθήμενοι ἑψιαάσθων.	-- -u u-u u-uu -uu--	dactylic hexameter	feminine penthemimeral
ἢ αὐτοῦ κατὰ δώματ’, ἐπεί σφισι θυμὸς ἐΰφρων.	- -- uu -u u- uu -u u--	dactylic hexameter	feminine penthemimeral, hepthemimeral, trithemimeral
αὐτῶν μὲν γὰρ κτήματ’ ἀκήρατα κεῖτ’ ἐνὶ οἴκῳ,	-- - - -u u-uu - uu --	dactylic hexameter	feminine penthemimeral, trithemimeral
σῖτος καὶ μέθυ ἡδύ· τὰ μέν τ’οἰκῆες ἔδουσιν,	-- - uu -u u - --u u--	dactylic hexameter	feminine penthemimeral, hepthemimeral, trithemimeral
οἱ δ’εἰς ἡμετέρου πωλεύμενοι ἤματα πάντα,	- - -uu- --uu -uu --	dactylic hexameter	masculine penthemimeral
βοῦς ἱερεύοντες καὶ ὄϊς καὶ πίονας αἶγας,	- uu--- u u- - -uu --	dactylic hexameter	masculine penthemimeral, hepthemimeral
εἰλαπινάζουσιν πίνουσί τε αἴθοπα οἶνον,	-uu--- --u u -uu --	dactylic hexameter	masculine penthemimeral
μαψιδίως· τὰ δὲ πολλὰ κατάνεται. οὐ γὰρ ἔπ’ ἀνήρ,	-uu- u u -u u-uu - u u --	dactylic hexameter	feminine penthemimeral, trithemimeral
οἷος Ὀδυσσεὺς ἔσκεν, ἀρὴν ἀπὸ οἴκου ἀμῦναι.	-u u-- -u u- uu -u u--	dactylic hexameter	feminine penthemimeral, hepthemimeral
εἰ δ’Ὀδυσεὺς ἔλθοι καὶ ἵκοιτ’ ἐς πατρίδα γαῖαν,	- uu- -- u u- - -uu --	dactylic hexameter	masculine penthemimeral, hepthemimeral, trithemimeral
αἶψά κε σὺν ᾧ παιδὶ βίας ἀποτίσεται ἀνδρῶν.	-u u - - -u u- uu-uu --	dactylic hexameter	feminine penthemimeral, hepthemimeral, trithemimeral
ὣς φάτο, Τηλέμαχος δὲ μέγ’ ἔπταρεν, ἀμφὶ δὲ δῶμα	- uu -uu- u u -uu -u u --	dactylic hexameter	masculine penthemimeral
σμερδαλέον κονάβησε· γέλασσε δὲ Πηνελόπεια,	-uu- uu-u u-u u -uu--	dactylic hexameter	feminine penthemimeral, trithemimeral
αἶψα δ’ἄρ’ Εὔμαιον ἔπεα πτερόεντα προσηύδα·	-u u --- uu- uu-u u--	dactylic hexameter	masculine penthemimeral, hepthemimeral
ἔρχεό μοι, τὸν ξεῖνον ἐναντίον ὦδε κάλεσσον.	-uu - - -u u-uu -u u--	dactylic hexameter	feminine penthemimeral, trithemimeral
οὐχ ὁράᾳς ὅ μοι υἱὸς ἐπέπταρε πᾶσιν ἔπεσσι;	- uu- u u -u u-uu -u u--	dactylic hexameter	feminine penthemimeral, trithemimeral
τῶ κε καὶ οὐκ ἀτελὴς θάνατος μνηστῆρσι γένοιτο	- u u - uu- uu- --u u--	dactylic hexameter	masculine penthemimeral, hepthemimeral, trithemimeral
πᾶσι μάλ’, οὐδέ κέ τις θάνατον καὶ κῆρας ἀλύξει.	-u u -u u - uu- - -u u--	dactylic hexameter	masculine penthemimeral, hepthemimeral
ἄλλο δέ τοι ἐρέω, σὺ δ’ἐνὶ φρεσὶ βάλλεο σῇσιν·	-u u - uu- u u- uu -uu --	dactylic hexameter	masculine penthemimeral, hepthemimeral, trithemimeral
αἴ κ’αὐτὸν γνώω νημερτέα πάντ’ ἐνέποντα,	- -- -- --uu - uu--	dactylic hexameter	masculine penthemimeral, trithemimeral
ἕσσω μιν χλαῖνάν τε χιτῶνά τε, εἵματα καλά.	-- - -- u u-u u -uu --	dactylic hexameter	masculine penthemimeral, trithemimeral
ὣς φάτο, βῆ δὲ συφορβός, ἐπεὶ τὸν μῦθον ἄκουσεν·	- uu - u u-u u- - -u u--	dactylic hexameter	feminine penthemimeral, hepthemimeral, trithemimeral
ἀγχοῦ δ’ἱστάμενος ἔπεα πτερόεντα προσηύδα·	-- -uu- uu- uu-u u--	dactylic hexameter	masculine penthemimeral, hepthemimeral
ξεῖνε πάτερ, καλέει σε περίφρων Πηνελόπεια,	-u u- uu- u u-- -uu--	dactylic hexameter	masculine penthemimeral, trithemimeral
μήτηρ Τηλεμάχοιο· μεταλλῆσαί τί ἑ θυμὸς	-- -uu-u u--- u u --	dactylic hexameter	feminine penthemimeral
ἀμφὶ πόσει κέλεται, καὶ κήδεά περ πεπαθυίῃ.	-u u- uu- - -uu - uu--	dactylic hexameter	masculine penthemimeral, trithemimeral
εἰ δέ κέ σε γνώῃ νημερτέα πάντ’ ἐνέποντα,	- u u - -- --uu - uu--	dactylic hexameter	masculine penthemimeral, trithemimeral
ἕσσει σε χλαῖνάν τε χιτῶνά τε, τῶν σὺ μάλιστα	-- - -- u u-u u - u u--	dactylic hexameter	masculine penthemimeral, trithemimeral
χρηΐζεις· σῖτον δὲ καὶ αἰτίζων κατὰ δῆμον	--- -- u u --- uu --	dactylic hexameter	masculine penthemimeral, trithemimeral
γαστέρα βοσκήσεις· δώσει δέ τοι ὅς κ’ἐθέλῃσι.	-uu --- -- u u - uu--	dactylic hexameter	masculine penthemimeral, hepthemimeral
τὸν δ’αὖτε προσέειπε πολύτλας δῖος Ὀδυσσεύς·	- -- uu-u u-- -u u--	dactylic hexameter	feminine penthemimeral, trithemimeral
Εὔμαι’, αἶψά κ’ἐγὼ νημερτέα πάντ’ ἐνέποιμι	-- -u u- --uu - uu--	dactylic hexameter	masculine penthemimeral
κούρῃ Ἰκαρίοιο, περίφρονι Πηνελοπείῃ·	-- -uu-u u-uu -uu--	dactylic hexameter	feminine penthemimeral
οἶδα γὰρ εὖ περὶ κείνου, ὁμὴν δ’ἀνεδέγμεθ’ ὀϊζύν.	-u u - uu -u u- uu-u u--	dactylic hexameter	feminine penthemimeral, hepthemimeral, trithemimeral
ἀλλὰ μνηστήρων χαλεπῶν ὑποδείδι’ ὅμιλον,	-- --- uu- uu-u u--	dactylic hexameter	masculine penthemimeral, hepthemimeral
τῶν ὕβρις τε βίη τε σιδήρεον οὐρανὸν ἵκει.	- -- u u- u u-uu -uu --	dactylic hexameter	masculine penthemimeral, trithemimeral
καὶ γὰρ νῦν, ὅτε μ’οὗτος ἀνὴρ κατὰ δῶμα κιόντα	- - - uu -u u- uu -u u--	dactylic hexameter	feminine penthemimeral, hepthemimeral, trithemimeral
οὔ τι κακὸν ῥέξαντα βαλὼν ὀδύνῃσιν ἔδωκεν,	- u u- --u u- uu-u u--	dactylic hexameter	feminine penthemimeral, hepthemimeral, trithemimeral
οὔτε τι Τηλέμαχος τό γ’ἐπήρκεσεν οὔτε τις ἄλλος.	-u u -uu- u u-uu -u u --	dactylic hexameter	masculine penthemimeral
τῶ νῦν Πηνελόπειαν ἐνὶ μεγάροισιν ἄνωχθι	- - -uu-u u- uu-u u--	dactylic hexameter	feminine penthemimeral, hepthemimeral
μεῖναι, ἐπειγομένην περ, ἐς ἠέλιον καταδύντα·	-u u-uu- u u -uu- uu--	dactylic hexameter	masculine penthemimeral
καὶ τότε μ’εἰρέσθω πόσιος πέρι νόστιμον ἦμαρ,	- uu --- uu- uu -uu --	dactylic hexameter	masculine penthemimeral, hepthemimeral
ἀσσοτέρω καθίσασα παραὶ πυρί· εἵματα γάρ τοι	-uu- uu-u u- uu -uu - -	dactylic hexameter	feminine penthemimeral, hepthemimeral, trithemimeral
λύγρ’ ἔχω· οἶσθα καὶ αὐτός, ἐπεί σε πρῶθ’ ἱκέτευσα.	- uu -u u -u u- - - uu--	dactylic hexameter	feminine penthemimeral, hepthemimeral
ὣς φάτο, βῆ δὲ συφορβός, ἐπεὶ τὸν μῦθον ἄκουσε.	- uu - u u-u u- - -u u--	dactylic hexameter	feminine penthemimeral, hepthemimeral, trithemimeral
τὸν δ’ὑπὲρ οὐδοῦ βάντα προσηύδα Πηνελόπεια·	- uu -- -u u-- -uu--	dactylic hexameter	feminine penthemimeral
οὐ σύ γ’ἄγεις, Εὔμαιε· τί τοῦτ’ ἐνόησεν ἀλήτης;	- u u- --u u - uu-u u--	dactylic hexameter	feminine penthemimeral, hepthemimeral, trithemimeral
ἦ τινά που δείσας ἐξαίσιον ἦε καὶ ἄλλως	- uu - -- --uu -u u --	dactylic hexameter	masculine penthemimeral, trithemimeral
αἰδεῖται κατὰ δῶμα; κακὸς δ’αἰδοῖος; ἀλήτης.	--- uu -u u- --u u--	dactylic hexameter	feminine penthemimeral, hepthemimeral, trithemimeral
τὴν δ’ἀπαμειβόμενος προσέφης, Εὔμαιε συβῶτα·	- uu-uu- uu- --u u--	dactylic hexameter	masculine penthemimeral, hepthemimeral
μυθεῖται κατὰ μοῖραν, ἅ πέρ κ’οἴοιτο καὶ ἄλλος,	--- uu -u u - --u u --	dactylic hexameter	feminine penthemimeral, hepthemimeral, trithemimeral
ὕβριν ἀλυσκάζων ἀνδρῶν ὑπερηνορεόντων.	-u u--- -- uu-uu--	dactylic hexameter	masculine penthemimeral, hepthemimeral
ἀλλά σε μεῖναι ἄνωγεν ἐς ἠέλιον καταδύντα.	-u u -u u-u u -uu- uu--	dactylic hexameter	feminine penthemimeral
καὶ δὲ σοὶ ὦδ’ αὐτῇ πολὺ κάλλιον, ὧ βασίλεια,	- u u - -- uu -uu - uu--	dactylic hexameter	masculine penthemimeral, trithemimeral
οἴην πρὸς ξεῖνον φάσθαι ἔπος ἠδ’ ἐπακοῦσαι.	-- - -- -- uu - uu--	dactylic hexameter	masculine penthemimeral, hepthemimeral, trithemimeral
τὸν δ’αὖτε προσέειπε περίφρων Πηνελόπεια·	- -- uu-u u-- -uu--	dactylic hexameter	feminine penthemimeral, trithemimeral
οὐκ ἄφρων ὁ ξεῖνος· ὀΐεται, ὥς περ ἂν εἴη·	- -- - -u u-uu - u u --	dactylic hexameter	feminine penthemimeral, trithemimeral
οὐ γάρ πώ τινες ὦδε καταθνητῶν ἀνθρώπων	- - - uu -u u--- ---	dactylic hexameter	feminine penthemimeral, trithemimeral
ἀνέρες ὑβρίζοντες ἀτάσθαλα μηχανόωνται.	-uu ---u u-uu -uu--	dactylic hexameter	feminine penthemimeral
ἡ μὲν ἄρ’ ὣς ἀγόρευεν, ὁ δ’ᾤχετο δῖος ὑφορβὸς	- u u - uu-u u -uu -u u--	dactylic hexameter	feminine penthemimeral, trithemimeral
μνηστήρων ἐς ὅμιλον, ἐπεὶ διεπέφραδε πάντα.	--- u u-u u- uu-uu --	dactylic hexameter	feminine penthemimeral, hepthemimeral, trithemimeral
αἶψα δὲ Τηλέμαχον ἔπεα πτερόεντα προσηύδα,	-u u -uu- uu- uu-u u--	dactylic hexameter	masculine penthemimeral, hepthemimeral
ἄγχι σχὼν κεφαλήν, ἵνα μὴ πευθοίαθ’ οἱ ἄλλοι·	-- - uu- uu - --u u --	dactylic hexameter	masculine penthemimeral, hepthemimeral, trithemimeral
ὧ φίλ’, ἐγὼ μὲν ἄπειμι, σύας καὶ κεῖνα φυλάξων,	- u u- u u-u u- - -u u--	dactylic hexameter	feminine penthemimeral, hepthemimeral, trithemimeral
σὸν καὶ ἐμὸν βίοτον· σοὶ δ’ἐνθάδε πάντα μελόντων.	- u u- uu- - -uu -u u--	dactylic hexameter	masculine penthemimeral, trithemimeral
αὐτὸν μέν σε πρῶτα σάω, καὶ φράζεο θυμῷ	-- - - -u u- - -uu --	dactylic hexameter	feminine penthemimeral, hepthemimeral, trithemimeral
μή τι πάθῃς· πολλοὶ δὲ κακὰ φρονέουσιν Ἀχαιῶν,	- u u- -- u u- uu-u u--	dactylic hexameter	masculine penthemimeral, hepthemimeral, trithemimeral
τοὺς Ζεὺς ἐξολέσειε πρὶν ἡμῖν πῆμα γενέσθαι.	- - -uu-u u -- -u u--	dactylic hexameter	feminine penthemimeral
τὸν δ’αὖ Τηλέμαχος πεπνυμένος ἀντίον ηὔδα·	- - -uu- --uu -uu --	dactylic hexameter	masculine penthemimeral
ἔσσεται οὕτως, ἄττα· σὺ δ’ἔρχεο δειελιήσας·	-uu -- -u u -uu -uu--	dactylic hexameter	feminine penthemimeral
ἠῶθεν δ’ἰέναι καὶ ἄγειν ἱερήϊα καλά·	--- uu- u u- uu-uu --	dactylic hexameter	masculine penthemimeral, hepthemimeral, trithemimeral
αὐτὰρ ἐμοὶ τάδε πάντα καὶ ἀθανάτοισι μελήσει.	-u u- uu -u u -uu-u u--	dactylic hexameter	feminine penthemimeral, trithemimeral
ὣς φάθ’, ὁ δ’αὖτις ἄρ’ ἕζετ’ ἐϋξέστου ἐπὶ δίφρου,	- u u -u u -u u--- uu --	dactylic hexameter	feminine penthemimeral
πλησάμενος δ’ἄρα θυμὸν ἐδητύος ἠδὲ ποτῆτος	-uu- uu -u u-uu -u u--	dactylic hexameter	feminine penthemimeral, trithemimeral
βῆ ῥ’ἴμεναι μεθ’ ὕας, λίπε δ’ἕρκεά τε μέγαρόν τε,	- uu- u u- uu -uu - uu- -	dactylic hexameter	masculine penthemimeral, trithemimeral
πλεῖον δαιτυμόνων· οἱ δ’ὀρχηστυῖ καὶ ἀοιδῇ	-- -uu- - --- u u--	dactylic hexameter	masculine penthemimeral
τέρποντ’· ἤδη γὰρ καὶ ἐπήλυθε δείελον ἦμαρ.	-- -- - u u-uu -uu --	dactylic hexameter	masculine penthemimeral
