τῇ δ’ἄρ’ ἐπὶ φρεσὶ θῆκε θεὰ γλαυκῶπις Ἀθήνη,	- u u- uu -u u- --u u--	dactylic hexameter	feminine penthemimeral, hepthemimeral, trithemimeral
κούρῃ Ἰκαρίοιο, περίφρονι Πηνελοπείῃ,	-- -uu-u u-uu -uu--	dactylic hexameter	feminine penthemimeral
τόξον μνηστήρεσσι θέμεν πολιόν τε σίδηρον	-- ---u u- uu- u u--	dactylic hexameter	feminine penthemimeral, hepthemimeral
ἐν μεγάροις Ὀδυσῆος, ἀέθλια καὶ φόνου ἀρχήν.	- uu- uu-u u-uu - uu --	dactylic hexameter	feminine penthemimeral, trithemimeral
κλίμακα δ’ὑψηλὴν προσεβήσετο οἷο δόμοιο,	-uu --- uu-uu -u u--	dactylic hexameter	masculine penthemimeral
εἵλετο δὲ κληῗδ’ εὐκαμπέα χειρὶ παχείῃ	-uu - -- --uu -u u--	dactylic hexameter	masculine penthemimeral, trithemimeral
καλὴν χρυσείην· κώπη δ’ἐλέφαντος ἐπῆεν.	-- --- -- uu-u u--	dactylic hexameter	masculine penthemimeral, hepthemimeral
βῆ δ’ἴμεναι θάλαμόνδε σὺν ἀμφιπόλοισι γυναιξὶν	- uu- uu-u u -uu-u u--	dactylic hexameter	feminine penthemimeral, trithemimeral
ἔσχατον· ἔνθα δέ οἱ κειμήλια κεῖτο ἄνακτος,	-uu -u u - --uu -u u--	dactylic hexameter	masculine penthemimeral
χαλκός τε χρυσός τε πολύκμητός τε σίδηρος.	-- - -- u u--- u u--	dactylic hexameter	masculine penthemimeral, trithemimeral
ἔνθα δὲ τόξον κεῖτο παλίντονον ἠδὲ φαρέτρη	-u u -- -u u-uu -u u--	dactylic hexameter	feminine penthemimeral
ἰοδόκος, πολλοὶ δ’ἔνεσαν στονόεντες ὀϊστοί,	-uu- -- uu- uu-u u--	dactylic hexameter	masculine penthemimeral, hepthemimeral, trithemimeral
δῶρα τά οἱ ξεῖνος Λακεδαίμονι δῶκε τυχήσας	-u u - -- uu-uu -u u--	dactylic hexameter	masculine penthemimeral, trithemimeral
Ἴφιτος Εὐρυτίδης, ἐπιείκελος ἀθανάτοισι.	-uu -uu- uu-uu -uu--	dactylic hexameter	masculine penthemimeral
τὼ δ’ἐν Μεσσήνῃ ξυμβλήτην ἀλλήλοιϊν	- - --- --- ----	dactylic hexameter	masculine penthemimeral
οἴκῳ ἐν Ὀρτιλόχοιο δαΐφρονος. ἤτοι Ὀδυσσεὺς	-u u -uu-u u-uu -u u--	dactylic hexameter	feminine penthemimeral
ἦλθε μετὰ χρεῖος, τό ῥά οἱ πᾶς δῆμος ὄφελλε·	-u u- -- u u - - -u u--	dactylic hexameter	masculine penthemimeral, hepthemimeral, trithemimeral
μῆλα γὰρ ἐξ Ἰθάκης Μεσσήνιοι ἄνδρες ἄειραν	-u u - uu- --uu -u u--	dactylic hexameter	masculine penthemimeral, trithemimeral
νηυσὶ πολυκλήϊσι τριηκόσι’ ἠδὲ νομῆας.	-u u---u u-uu -u u--	dactylic hexameter	feminine penthemimeral
τῶν ἕνεκ’ ἐξεσίην πολλὴν ὁδὸν ἦλθεν Ὀδυσσεὺς	- uu -uu- -- uu -u u--	dactylic hexameter	masculine penthemimeral, hepthemimeral
παιδνὸς ἐών· πρὸ γὰρ ἧκε πατὴρ ἄλλοι τε γέροντες.	-u u- u u -u u- -- u u--	dactylic hexameter	feminine penthemimeral, hepthemimeral, trithemimeral
Ἴφιτος αὖθ’ ἵππους διζήμενος, αἵ οἱ ὄλοντο	-uu - -- --uu - u u--	dactylic hexameter	masculine penthemimeral, trithemimeral
δώδεκα θήλειαι, ὑπὸ δ’ἡμίονοι ταλαεργοί·	-uu --- uu -uu- uu--	dactylic hexameter	masculine penthemimeral
αἳ δή οἱ καὶ ἔπειτα φόνος καὶ μοῖρα γένοντο,	- - - u u-u u- - -u u--	dactylic hexameter	feminine penthemimeral, hepthemimeral, trithemimeral
ἐπεὶ δὴ Διὸς υἱὸν ἀφίκετο καρτερόθυμον,	-- - uu -u u-uu -uu--	dactylic hexameter	feminine penthemimeral, trithemimeral
φῶθ’ Ἡρακλῆα, μεγάλων ἐπιίστορα ἔργων,	- ---- uu- uu-uu --	dactylic hexameter	masculine penthemimeral, hepthemimeral
ὅς μιν ξεῖνον ἐόντα κατέκτανεν ᾧ ἐνὶ οἴκῳ,	- - -u u-u u-uu - uu --	dactylic hexameter	feminine penthemimeral
σχέτλιος, οὐδὲ θεῶν ὄπιν ᾐδέσατ’ οὐδὲ τράπεζαν,	-uu -u u- uu -uu -u u--	dactylic hexameter	masculine penthemimeral
τὴν ἥν οἱ παρέθηκεν· ἔπειτα δὲ πέφνε καὶ αὐτόν,	- - - uu-u u-u u -u u --	dactylic hexameter	feminine penthemimeral, trithemimeral
ἵππους δ’αὐτὸς ἔχε κρατερώνυχας ἐν μεγάροισι.	-- -u u- uu-uu - uu--	dactylic hexameter	masculine penthemimeral
τὰς ἐρέων Ὀδυσῆϊ συνήντετο, δῶκε δὲ τόξον,	- uu- uu-u u-uu -u u --	dactylic hexameter	feminine penthemimeral, trithemimeral
τὸ πρὶν μέν ἐφόρει μέγας Εὔρυτος, αὐτὰρ ὁ παιδὶ	- - - uu- uu -uu -u u --	dactylic hexameter	masculine penthemimeral, trithemimeral
κάλλιπ’ ἀποθνήσκων ἐν δώμασιν ὑψηλοῖσι.	-u u--- - -uu ----	dactylic hexameter	masculine penthemimeral
τῷ δ’Ὀδυσεὺς ξίφος ὀξὺ καὶ ἄλκιμον ἔγχος ἔδωκεν,	- uu- uu -u u -uu -u u--	dactylic hexameter	feminine penthemimeral, trithemimeral
ἀρχὴν ξεινοσύνης προσκηδέος· οὐδὲ τραπέζῃ	-- -uu- --uu -u u--	dactylic hexameter	masculine penthemimeral
γνώτην ἀλλήλων· πρὶν γὰρ Διὸς υἱὸς ἔπεφνεν	-- --- - - uu -u u--	dactylic hexameter	masculine penthemimeral, hepthemimeral
Ἴφιτον Εὐρυτίδην, ἐπιείκελον ἀθανάτοισιν,	-uu -uu- uu-uu -uu--	dactylic hexameter	masculine penthemimeral
ὅς οἱ τόξον ἔδωκε. τὸ δ’οὔ ποτε δῖος Ὀδυσσεὺς	- - -u u-u u - uu -u u--	dactylic hexameter	feminine penthemimeral, hepthemimeral
ἐρχόμενος πόλεμόνδε μελαινάων ἐπὶ νηῶν	-uu- uu-u u--- uu --	dactylic hexameter	feminine penthemimeral, trithemimeral
ᾑρεῖτ’, ἀλλ’ αὐτοῦ μνῆμα ξείνοιο φίλοιο	-- - -- -- --u u--	dactylic hexameter	masculine penthemimeral, hepthemimeral, trithemimeral
κέσκετ’ ἐνὶ μεγάροισι, φόρει δέ μιν ἧς ἐπὶ γαίης.	-u u- uu-u u- u u - uu --	dactylic hexameter	feminine penthemimeral, hepthemimeral, trithemimeral
ἡ δ’ὅτε δὴ θάλαμον τὸν ἀφίκετο δῖα γυναικῶν	- uu - uu- u u-uu -u u--	dactylic hexameter	masculine penthemimeral, trithemimeral
οὐδόν τε δρύϊνον προσεβήσετο, τόν ποτε τέκτων	-- - uu- uu-uu - uu --	dactylic hexameter	masculine penthemimeral, trithemimeral
ξέσσεν ἐπισταμένως καὶ ἐπὶ στάθμην ἴθυνεν,	-u u-uu- u u- -- ---	dactylic hexameter	masculine penthemimeral, hepthemimeral
ἐν δὲ σταθμοὺς ἄρσε, θύρας δ’ἐπέθηκε φαεινάς,	- - -- -u u- uu-u u--	dactylic hexameter	feminine penthemimeral, hepthemimeral
αὐτίκ’ ἄρ’ ἥ γ’ἱμάντα θοῶς ἀπέλυσε κορώνης,	-u u - --u u- uu-u u--	dactylic hexameter	feminine penthemimeral, hepthemimeral, trithemimeral
ἐν δὲ κληῗδ’ ἧκε, θυρέων δ’ἀνέκοπτεν ὀχῆας	- - -- -u u- uu-u u--	dactylic hexameter	feminine penthemimeral, hepthemimeral
ἄντα τιτυσκομένη· τὰ δ’ἀνέβραχεν ἠΰτε ταῦρος	-u u-uu- u u-uu -uu --	dactylic hexameter	masculine penthemimeral
βοσκόμενος λειμῶνι· τόσ’ ἔβραχε καλὰ θύρετρα	-uu- --u u -uu -u u--	dactylic hexameter	feminine penthemimeral, trithemimeral
πληγέντα κληΐδι, πετάσθησαν δέ οἱ ὧκα.	--- --u u--- u u --	dactylic hexameter	feminine penthemimeral, trithemimeral
ἡ δ’ἄρ’ ἐφ’ ὑψηλῆς σανίδος βῆ· ἔνθα δὲ χηλοὶ	- u u --- uu- - -u u --	dactylic hexameter	masculine penthemimeral, hepthemimeral
ἕστασαν, ἐν δ’ἄρα τῇσι θυώδεα εἵματ’ ἔκειτο.	-uu - uu -u u-uu -u u--	dactylic hexameter	feminine penthemimeral, trithemimeral
ἔνθεν ὀρεξαμένη ἀπὸ πασσάλου αἴνυτο τόξον	-u u-uu- uu -uu -uu --	dactylic hexameter	masculine penthemimeral
αὐτῷ γωρυτῷ, ὅς οἱ περίκειτο φαεινός.	-- --- - - uu-u u--	dactylic hexameter	masculine penthemimeral, hepthemimeral
ἑζομένη δὲ κατ’ αὖθι, φίλοις ἐπὶ γούνασι θεῖσα,	-uu- u u -u u- uu -uu --	dactylic hexameter	feminine penthemimeral, hepthemimeral, trithemimeral
κλαῖε μάλα λιγέως, ἐκ δ’ᾕρεε τόξον ἄνακτος.	-u u- uu- - -uu -u u--	dactylic hexameter	masculine penthemimeral, trithemimeral
ἡ δ’ἐπεὶ οὖν τάρφθη πολυδακρύτοιο γόοιο,	- uu - -- uu---u u--	dactylic hexameter	masculine penthemimeral, trithemimeral
βῆ ῥ’ἴμεναι μέγαρόνδε μετὰ μνηστῆρας ἀγαυοὺς	- uu- uu-u u- --u u--	dactylic hexameter	feminine penthemimeral, hepthemimeral, trithemimeral
τόξον ἔχουσ’ ἐν χειρὶ παλίντονον ἠδὲ φαρέτρην	-u u- - -u u-uu -u u--	dactylic hexameter	feminine penthemimeral, trithemimeral
ἰοδόκον· πολλοὶ δ’ἔνεσαν στονόεντες ὀϊστοί.	-uu- -- uu- uu-u u--	dactylic hexameter	masculine penthemimeral, hepthemimeral, trithemimeral
τῇ δ’ἄρ’ ἅμ’ ἀμφίπολοι φέρον ὄγκιον, ἔνθα σίδηρος	- u u -uu- uu -uu -u u--	dactylic hexameter	masculine penthemimeral
κεῖτο πολὺς καὶ χαλκός, ἀέθλια τοῖο ἄνακτος.	-u u- - -u u-uu -u u--	dactylic hexameter	feminine penthemimeral, trithemimeral
ἡ δ’ὅτε δὴ μνηστῆρας ἀφίκετο δῖα γυναικῶν,	- uu - --u u-uu -u u--	dactylic hexameter	feminine penthemimeral, trithemimeral
στῆ ῥα παρὰ σταθμὸν τέγεος πύκα ποιητοῖο,	- u u- -- uu- uu ----	dactylic hexameter	masculine penthemimeral, hepthemimeral, trithemimeral
ἄντα παρειάων σχομένη λιπαρὰ κρήδεμνα.	-u u--- uu- uu- ---	dactylic hexameter	masculine penthemimeral, hepthemimeral
ἀμφίπολος δ’ἄρα οἱ κεδνὴ ἑκάτερθε παρέστη.	-uu- uu - -- uu-u u--	dactylic hexameter	masculine penthemimeral, hepthemimeral, trithemimeral
αὐτίκα δὲ μνηστῆρσι μετηύδα καὶ φάτο μῦθον·	-uu - --u u-- - uu --	dactylic hexameter	feminine penthemimeral, trithemimeral
κέκλυτέ μευ, μνηστῆρες ἀγήνορες, οἳ τόδε δῶμα	-uu - --u u-uu - uu --	dactylic hexameter	feminine penthemimeral, trithemimeral
ἐχράετ’ ἐσθιέμεν καὶ πινέμεν ἐμμενὲς αἰεὶ	-uu -uu- - -uu -uu --	dactylic hexameter	masculine penthemimeral
ἀνδρὸς ἀποιχομένοιο πολὺν χρόνον· οὐδέ τιν’ ἄλλην	-u u-uu-u u- uu -u u --	dactylic hexameter	feminine penthemimeral, hepthemimeral
μύθου ποιήσασθαι ἐπισχεσίην ἐδύνασθε,	-- ---u u-uu- uu--	dactylic hexameter	feminine penthemimeral
ἀλλ’ ἐμὲ ἱέμενοι γῆμαι θέσθαι τε γυναῖκα.	- uu -uu- -- -- u u--	dactylic hexameter	masculine penthemimeral, hepthemimeral
ἀλλ’ ἄγετε, μνηστῆρες, ἐπεὶ τόδε φαίνετ’ ἄεθλον.	- uu- --u u- uu -u u--	dactylic hexameter	feminine penthemimeral, hepthemimeral, trithemimeral
θήσω γὰρ μέγα τόξον Ὀδυσσῆος θείοιο·	-- - uu -u u--- ---	dactylic hexameter	feminine penthemimeral, trithemimeral
ὃς δέ κε ῥηΐτατ’ ἐντανύσῃ βιὸν ἐν παλάμῃσι	- u u -uu -uu- uu - uu--	dactylic hexameter	hepthemimeral
καὶ διοϊστεύσῃ πελέκεων δυοκαίδεκα πάντων,	- uu--- uu- uu-uu --	dactylic hexameter	masculine penthemimeral, hepthemimeral
τῷ κεν ἅμ’ ἑσποίμην, νοσφισσαμένη τόδε δῶμα	- u u --- --uu- uu --	dactylic hexameter	masculine penthemimeral
κουρίδιον, μάλα καλόν, ἐνίπλειον βιότοιο,	-uu- uu -u u--- uu--	dactylic hexameter	feminine penthemimeral, trithemimeral
τοῦ ποτὲ μεμνήσεσθαι ὀΐομαι ἔν περ ὀνείρῳ.	- uu ---u u-uu - u u--	dactylic hexameter	feminine penthemimeral
ὣς φάτο, καί ῥ’Εὔμαιον ἀνώγει, δῖον ὑφορβόν,	- uu - --u u-- -u u--	dactylic hexameter	feminine penthemimeral, trithemimeral
τόξον μνηστήρεσσι θέμεν πολιόν τε σίδηρον.	-- ---u u- uu- u u--	dactylic hexameter	feminine penthemimeral, hepthemimeral
δακρύσας δ’Εὔμαιος ἐδέξατο καὶ κατέθηκε·	--- --u u-uu - uu--	dactylic hexameter	feminine penthemimeral, trithemimeral
κλαῖε δὲ βουκόλος ἄλλοθ’, ἐπεὶ ἴδε τόξον ἄνακτος.	-u u -uu -u u- uu -u u--	dactylic hexameter	feminine penthemimeral, hepthemimeral
Ἀντίνοος δ’ἐνένιπεν ἔπος τ’ἔφατ’ ἔκ τ’ὀνόμαζε·	-uu- uu-u u- uu - uu--	dactylic hexameter	feminine penthemimeral, hepthemimeral, trithemimeral
νήπιοι ἀγροιῶται, ἐφημέρια φρονέοντες,	-uu ---u u-uu- uu--	dactylic hexameter	feminine penthemimeral
ἆ δειλώ, τί νυ δάκρυ κατείβετον ἠδὲ γυναικὶ	- -- u u -u u-uu -u u--	dactylic hexameter	feminine penthemimeral, trithemimeral
θυμὸν ἐνὶ στήθεσσιν ὀρίνετον; ᾗ τε καὶ ἄλλως	-u u- --u u-uu - u u --	dactylic hexameter	feminine penthemimeral, trithemimeral
κεῖται ἐν ἄλγεσι θυμός, ἐπεὶ φίλον ὤλεσ’ ἀκοίτην.	-u u -uu -u u- uu -u u--	dactylic hexameter	feminine penthemimeral, hepthemimeral
ἀλλ’ ἀκέων δαίνυσθε καθήμενοι, ἠὲ θύραζε	- uu- --u u-uu -u u--	dactylic hexameter	feminine penthemimeral, trithemimeral
κλαίετον ἐξελθόντε, κατ’ αὐτόθι τόξα λιπόντε,	-uu ---u u -uu -u u--	dactylic hexameter	feminine penthemimeral
μνηστήρεσσιν ἄεθλον ἀάατον· οὐ γὰρ ὀΐω	---u u-u u-uu - u u--	dactylic hexameter	feminine penthemimeral
ῥηϊδίως τόδε τόξον ἐΰξοον ἐντανύεσθαι.	-uu- uu -u u-uu -uu--	dactylic hexameter	feminine penthemimeral, trithemimeral
οὐ γάρ τις μέτα τοῖος ἀνὴρ ἐν τοίσδεσι πᾶσιν	- - - uu -u u- - -uu --	dactylic hexameter	feminine penthemimeral, hepthemimeral, trithemimeral
οἷος Ὀδυσσεὺς ἔσκεν· ἐγὼ δέ μιν αὐτὸς ὄπωπα,	-u u-- -u u- u u -u u--	dactylic hexameter	feminine penthemimeral, hepthemimeral
καὶ γὰρ μνήμων εἰμί, πάϊς δ’ἔτι νήπιος ἦα.	- - -- -u u- uu -uu --	dactylic hexameter	feminine penthemimeral, hepthemimeral
ὣς φάτο, τῷ δ’ἄρα θυμὸς ἐνὶ στήθεσσιν ἐώλπει	- uu - uu -u u- --u u--	dactylic hexameter	feminine penthemimeral, hepthemimeral, trithemimeral
νευρὴν ἐντανύειν διοϊστεύσειν τε σιδήρου.	-- -uu- uu--- u u--	dactylic hexameter	masculine penthemimeral
ἤτοι ὀϊστοῦ γε πρῶτος γεύσεσθαι ἔμελλεν	-u u-- - -- --u u--	dactylic hexameter	masculine penthemimeral, hepthemimeral
ἐκ χειρῶν Ὀδυσῆος ἀμύμονος, ὃν τότ’ ἀτίμα	- -- uu-u u-uu - u u--	dactylic hexameter	feminine penthemimeral, trithemimeral
ἥμενος ἐν μεγάροις, ἐπὶ δ’ὤρνυε πάντας ἑταίρους.	-uu - uu- uu -uu -u u--	dactylic hexameter	masculine penthemimeral, trithemimeral
τοῖσι δὲ καὶ μετέειφ’ ἱερὴ ἲς Τηλεμάχοιο·	-u u - uu- uu- - -uu--	dactylic hexameter	masculine penthemimeral, hepthemimeral, trithemimeral
ὢ πόποι, ἦ μάλα με Ζεὺς ἄφρονα θῆκε Κρονίων·	- uu - uu - - -uu -u u--	dactylic hexameter	masculine penthemimeral, trithemimeral
μήτηρ μέν μοί φησι φίλη, πινυτή περ ἐοῦσα,	-- - - -u u- uu- u u--	dactylic hexameter	feminine penthemimeral, hepthemimeral, trithemimeral
ἄλλῳ ἅμ’ ἕψεσθαι νοσφισσαμένη τόδε δῶμα·	-u u --- --uu- uu --	dactylic hexameter	masculine penthemimeral
αὐτὰρ ἐγὼ γελόω καὶ τέρπομαι ἄφρονι θυμῷ.	-u u- uu- - -uu -uu --	dactylic hexameter	masculine penthemimeral, trithemimeral
ἀλλ’ ἄγετε, μνηστῆρες, ἐπεὶ τόδε φαίνετ’ ἄεθλον,	- uu- --u u- uu -u u--	dactylic hexameter	feminine penthemimeral, hepthemimeral, trithemimeral
οἵη νῦν οὐκ ἔστι γυνὴ κατ’ Ἀχαιΐδα γαῖαν,	-- - - -u u- u u-uu --	dactylic hexameter	feminine penthemimeral, hepthemimeral, trithemimeral
οὔτε Πύλου ἱερῆς οὔτ’ Ἄργεος οὔτε Μυκήνης·	-u u- uu- - -uu -u u--	dactylic hexameter	masculine penthemimeral, trithemimeral
οὔτ’ αὐτῆς Ἰθάκης οὔτ’ ἠπείροιο μελαίνης·	- -- uu- - ---u u--	dactylic hexameter	masculine penthemimeral, trithemimeral
καὶ δ’αὐτοὶ τόδε γ’ἴστε· τί με χρὴ μητέρος αἴνου;	- -- uu -u u - - -uu --	dactylic hexameter	feminine penthemimeral, hepthemimeral, trithemimeral
ἀλλ’ ἄγε μὴ μύνῃσι παρέλκετε μηδ’ ἔτι τόξου	- uu - --u u-uu - uu --	dactylic hexameter	feminine penthemimeral, trithemimeral
δηρὸν ἀποτρωπᾶσθε τανυστύος, ὄφρα ἴδωμεν.	-u u---u u-uu -u u--	dactylic hexameter	feminine penthemimeral
καὶ δέ κεν αὐτὸς ἐγὼ τοῦ τόξου πειρησαίμην·	- u u -u u- - -- ----	dactylic hexameter	masculine penthemimeral
εἰ δέ κεν ἐντανύσω nbsp;διοϊστεύσω τε σιδήρου,	- u u -uu-uu--- u u--	dactylic hexameter	
οὔ κέ μοι ἀχνυμένῳ τάδε δώματα πότνια μήτηρ	- u u -uu- uu -uu -uu --	dactylic hexameter	masculine penthemimeral
λείποι ἅμ’ ἄλλῳ ἰοῦσ’, ὅτ’ ἐγὼ κατόπισθε λιποίμην	-u u -u u- u u- uu-u u--	dactylic hexameter	masculine penthemimeral, hepthemimeral
οἷός τ’ἤδη πατρὸς ἀέθλια κάλ’ ἀνελέσθαι.	-- -- -u u-uu - uu--	dactylic hexameter	feminine penthemimeral
ἦ καὶ ἀπ’ ὤμοιϊν χλαῖναν θέτο φοινικόεσσαν	- u u --- -- uu -uu--	dactylic hexameter	masculine penthemimeral, hepthemimeral
ὀρθὸς ἀναΐξας, ἀπὸ δὲ ξίφος ὀξὺ θέτ’ ὤμων.	-u u--- uu - uu -u u --	dactylic hexameter	masculine penthemimeral, hepthemimeral
πρῶτον μὲν πελέκεας στῆσεν, διὰ τάφρον ὀρύξας	-- - uu- -- uu -u u--	dactylic hexameter	masculine penthemimeral, hepthemimeral, trithemimeral
πᾶσι μίαν μακρήν, καὶ ἐπὶ στάθμην ἴθυνεν,	-u u- -- u u- -- ---	dactylic hexameter	masculine penthemimeral, hepthemimeral, trithemimeral
ἀμφὶ δὲ γαῖαν ἔναξε· τάφος δ’ἕλε πάντας ἰδόντας,	-u u -u u-u u- uu -u u--	dactylic hexameter	feminine penthemimeral, hepthemimeral
ὡς εὐκόσμως στῆσε· πάρος δ’οὐ πώ ποτ’ ὀπώπει.	- --- -u u- - - u u--	dactylic hexameter	feminine penthemimeral, hepthemimeral
στῆ δ’ἄρ’ ἐπ’ οὐδὸν ἰὼν καὶ τόξου πειρήτιζε.	- u u -u u- - -- ----	dactylic hexameter	masculine penthemimeral
τρὶς μέν μιν πελέμιξεν ἐρύσσεσθαι μενεαίνων,	- - - uu-u u--- uu--	dactylic hexameter	feminine penthemimeral, trithemimeral
τρὶς δὲ μεθῆκε βίης, ἐπιελπόμενος τό γε θυμῷ,	- u u-u u- uu-uu- u u --	dactylic hexameter	masculine penthemimeral
νευρὴν ἐντανύειν διοϊστεύσειν τε σιδήρου.	-- -uu- uu--- u u--	dactylic hexameter	masculine penthemimeral
καί νύ κε δή ἐτάνυσσε βίῃ τὸ τέταρτον ἀνέλκων,	- u u - uu-u u- u u-u u--	dactylic hexameter	feminine penthemimeral, hepthemimeral, trithemimeral
ἀλλ’ Ὀδυσεὺς ἀνένευε καὶ ἔσχεθεν ἱέμενόν περ.	- uu- uu-u u -uu -uu- -	dactylic hexameter	feminine penthemimeral, trithemimeral
τοῖς δ’αὖτις μετέειφ’ ἱερὴ ἲς Τηλεμάχοιο·	- -- uu- uu- - -uu--	dactylic hexameter	masculine penthemimeral, hepthemimeral, trithemimeral
ὢ πόποι, ἦ καὶ ἔπειτα κακός τ’ἔσομαι καὶ ἄκικυς,	- uu - u u-u u- uu- u u--	dactylic hexameter	feminine penthemimeral, hepthemimeral, trithemimeral
ἠὲ νεώτερός εἰμι καὶ οὔ πω χερσὶ πέποιθα	-u u-uu -u u - - -u u--	dactylic hexameter	feminine penthemimeral, hepthemimeral
ἄνδρ’ ἀπαμύνασθαι, ὅτε τις πρότερος χαλεπήνῃ.	- uu--- uu - uu- uu--	dactylic hexameter	masculine penthemimeral, hepthemimeral
ἀλλ’ ἄγεθ’, οἵ περ ἐμεῖο βίῃ προφερέστεροί ἐστε,	- uu - u u-u u- uu-uu --	dactylic hexameter	feminine penthemimeral, hepthemimeral, trithemimeral
τόξου πειρήσασθε, καὶ ἐκτελέωμεν ἄεθλον.	-- ---u u -uu-u u--	dactylic hexameter	feminine penthemimeral
ὣς εἰπὼν τόξον μὲν ἀπὸ ἕο θῆκε χαμᾶζε,	- -- -- u u- uu -u u--	dactylic hexameter	masculine penthemimeral, hepthemimeral, trithemimeral
κλίνας κολλητῇσιν ἐϋξέστῃς σανίδεσσιν,	-- ---u u--- uu--	dactylic hexameter	feminine penthemimeral
αὐτοῦ δ’ὠκὺ βέλος καλῇ προσέκλινε κορώνῃ,	-- -u u- -- uu-u u--	dactylic hexameter	masculine penthemimeral, hepthemimeral
ἂψ δ’αὖτις κατ’ ἄρ’ ἕζετ’ ἐπὶ θρόνου ἔνθεν ἀνέστη.	- -- u u -u u- uu -u u--	dactylic hexameter	feminine penthemimeral, hepthemimeral, trithemimeral
τοῖσιν δ’Ἀντίνοος μετέφη, Εὐπείθεος υἱός·	-- -uu- uu- --uu --	dactylic hexameter	masculine penthemimeral, hepthemimeral
ὄρνυσθ’ ἑξείης ἐπιδέξια πάντες ἑταῖροι,	-- --- uu-uu -u u--	dactylic hexameter	masculine penthemimeral
ἀρξάμενοι τοῦ χώρου ὅθεν τέ περ οἰνοχοεύει.	-uu- - -u u- u u -uu--	dactylic hexameter	feminine penthemimeral, hepthemimeral, trithemimeral
ὣς ἔφατ’ Ἀντίνοος, τοῖσιν δ’ἐπιήνδανε μῦθος.	- uu -uu- -- uu-uu --	dactylic hexameter	masculine penthemimeral, hepthemimeral
Λειώδης δὲ πρῶτος ἀνίστατο, Ἤνοπος υἱός,	--- - -u u-uu -uu --	dactylic hexameter	feminine penthemimeral, trithemimeral
ὅ σφι θυοσκόος ἔσκε, παρὰ κρητῆρα δὲ καλὸν	- u u-uu -u u- --u u --	dactylic hexameter	feminine penthemimeral, hepthemimeral
ἷζε μυχοίτατος αἰεί· ἀτασθαλίαι δέ οἱ οἴῳ	-u u-uu -u u-uu- u u --	dactylic hexameter	feminine penthemimeral
ἐχθραὶ ἔσαν, πᾶσιν δὲ νεμέσσα μνηστήρεσσιν·	-u u- -- u u-- ----	dactylic hexameter	masculine penthemimeral, trithemimeral
ὅς ῥα τότε πρῶτος τόξον λάβε καὶ βέλος ὠκύ.	- u u- -- -- uu - uu --	dactylic hexameter	masculine penthemimeral, hepthemimeral, trithemimeral
στῆ δ’ἄρ’ ἐπ’ οὐδὸν ἰὼν καὶ τόξου πειρήτιζεν,	- u u -u u- - -- ----	dactylic hexameter	masculine penthemimeral
οὐδέ μιν ἐντάνυσε· πρὶν γὰρ κάμε χεῖρας ἀνέλκων	-u u -uu- - - uu -u u--	dactylic hexameter	masculine penthemimeral, hepthemimeral
ἀτρίπτους ἁπαλάς· μετὰ δὲ μνηστῆρσιν ἔειπεν·	--- uu- uu - --u u--	dactylic hexameter	masculine penthemimeral, hepthemimeral, trithemimeral
ὧ φίλοι, οὐ μὲν ἐγὼ τανύω, λαβέτω δὲ καὶ ἄλλος.	- uu - u u- uu- uu- u u --	dactylic hexameter	masculine penthemimeral, hepthemimeral, trithemimeral
πολλοὺς γὰρ τόδε τόξον ἀριστῆας κεκαδήσει	-- - uu -u u--- uu--	dactylic hexameter	feminine penthemimeral, trithemimeral
θυμοῦ καὶ ψυχῆς, ἐπεὶ ἦ πολὺ φέρτερόν ἐστι	-- - -- uu - uu -uu --	dactylic hexameter	masculine penthemimeral, hepthemimeral, trithemimeral
τεθνάμεν ἢ ζώοντας ἁμαρτεῖν, οὗ θ’ἕνεκ’ αἰεὶ	-uu - --u u-- - uu --	dactylic hexameter	feminine penthemimeral, trithemimeral
ἐνθάδ’ ὁμιλέομεν, ποτιδέγμενοι ἤματα πάντα.	-u u-uu- uu-uu -uu --	dactylic hexameter	masculine penthemimeral
νῦν μέν τις καὶ ἔλπετ’ ἐνὶ φρεσὶν ἠδὲ μενοινᾷ	- - - - -u u- uu -u u--	dactylic hexameter	feminine penthemimeral, hepthemimeral, trithemimeral
γῆμαι Πηνελόπειαν, Ὀδυσσῆος παράκοιτιν.	-- -uu-u u--- uu--	dactylic hexameter	feminine penthemimeral
αὐτὰρ ἐπὴν τόξου πειρήσεται ἠδὲ ἴδηται,	-u u- -- --uu -u u--	dactylic hexameter	masculine penthemimeral, trithemimeral
ἄλλην δή τιν’ ἔπειτα Ἀχαιϊάδων ἐϋπέπλων	-- - u u-u u-uu- uu--	dactylic hexameter	feminine penthemimeral, trithemimeral
μνάσθω ἐέδνοισιν διζήμενος· ἡ δέ κ’ἔπειτα	-u u--- --uu - u u--	dactylic hexameter	masculine penthemimeral
γήμαιθ’ ὅς κε πλεῖστα πόροι καὶ μόρσιμος ἔλθοι.	-- - - -u u- - -uu --	dactylic hexameter	feminine penthemimeral, hepthemimeral, trithemimeral
ὣς ἄρ’ ἐφώνησεν καὶ ἀπὸ ἕο τόξον ἔθηκε,	- u u--- u u- uu -u u--	dactylic hexameter	masculine penthemimeral, hepthemimeral
κλίνας κολλητῇσιν ἐϋξέστῃς σανίδεσσιν,	-- ---u u--- uu--	dactylic hexameter	feminine penthemimeral
αὐτοῦ δ’ὠκὺ βέλος καλῇ προσέκλινε κορώνῃ,	-- -u u- -- uu-u u--	dactylic hexameter	masculine penthemimeral, hepthemimeral
ἂψ δ’αὖτις κατ’ ἄρ ἕζετ’ ἐπὶ θρόνου ἔνθεν ἀνέστη.	- -- u u -u u- uu -u u--	dactylic hexameter	feminine penthemimeral, hepthemimeral, trithemimeral
Ἀντίνοος δ’ἐνένιπεν ἔπος τ’ἔφατ’ ἔκ τ’ὀνόμαζε·	-uu- uu-u u- uu - uu--	dactylic hexameter	feminine penthemimeral, hepthemimeral, trithemimeral
Λειῶδες, ποῖόν σε ἔπος φύγεν ἕρκος ὀδόντων,	--- -- u u- uu -u u--	dactylic hexameter	masculine penthemimeral, hepthemimeral, trithemimeral
δεινόν τ’ἀργαλέον τε, νεμεσσῶμαι δέ τ’ἀκούων	-- -uu- u u--- u u--	dactylic hexameter	masculine penthemimeral
εἰ δὴ τοῦτό γε τόξον ἀριστῆας κεκαδήσει	- - -u u -u u--- uu--	dactylic hexameter	feminine penthemimeral
θυμοῦ καὶ ψυχῆς, ἐπεὶ οὐ δύνασαι σὺ τανύσσαι.	-- - -- uu - uu- u u--	dactylic hexameter	masculine penthemimeral, hepthemimeral, trithemimeral
οὐ γάρ τοί σέ γε τοῖον ἐγείνατο πότνια μήτηρ	- - - u u -u u-uu -uu --	dactylic hexameter	feminine penthemimeral, trithemimeral
οἷόν τε ῥυτῆρα βιοῦ τ’ἔμεναι καὶ ὀϊστῶν·	-- - --u u- uu- u u--	dactylic hexameter	feminine penthemimeral, hepthemimeral, trithemimeral
ἀλλ’ ἄλλοι τανύουσι τάχα μνηστῆρες ἀγαυοί.	- -- uu-u u- --u u--	dactylic hexameter	feminine penthemimeral, hepthemimeral, trithemimeral
ὣς φάτο, καί ῥ’ἐκέλευσε Μελάνθιον, αἰπόλον αἰγῶν·	- uu - uu-u u-uu -uu --	dactylic hexameter	feminine penthemimeral, trithemimeral
ἄγρει δή, πῦρ κεῖον ἐνὶ μεγάροισι, Μελανθεῦ,	-- - - -u u- uu-u u--	dactylic hexameter	feminine penthemimeral, hepthemimeral, trithemimeral
πὰρ δὲ τίθει δίφρον τε μέγαν καὶ κῶας ἐπ’ αὐτοῦ,	- u u- -- u u- - -u u --	dactylic hexameter	masculine penthemimeral, hepthemimeral, trithemimeral
ἐκ δὲ στέατος ἔνεικε μέγαν τροχὸν ἔνδον ἐόντος,	- - -u u-u u- uu -u u--	dactylic hexameter	feminine penthemimeral, hepthemimeral
ὄφρα νέοι θάλποντες, ἐπιχρίοντες ἀλοιφῇ,	-u u- --u u---u u--	dactylic hexameter	feminine penthemimeral, trithemimeral
τόξου πειρώμεσθα καὶ ἐκτελέωμεν ἄεθλον.	-- ---u u -uu-u u--	dactylic hexameter	feminine penthemimeral
ὣς φάθ’, ὁ δ’αἶψ’ ἀνέκαιε Μελάνθιος ἀκάματον πῦρ,	- u u - uu-u u-uu -uu- -	dactylic hexameter	feminine penthemimeral, trithemimeral
πὰρ δὲ φέρων δίφρον θῆκεν καὶ κῶας ἐπ’ αὐτοῦ,	- u u- -- -- - -u u --	dactylic hexameter	masculine penthemimeral, hepthemimeral, trithemimeral
ἐκ δὲ στέατος ἔνεικε μέγαν τροχὸν ἔνδον ἐόντος·	- - -u u-u u- uu -u u--	dactylic hexameter	feminine penthemimeral, hepthemimeral
τῷ ῥα νέοι θάλποντες ἐπειρῶντ’· οὐδ’ ἐδύναντο	- u u- --u u-- - uu--	dactylic hexameter	feminine penthemimeral, trithemimeral
ἐντανύσαι, πολλὸν δὲ βίης ἐπιδευέες ἦσαν.	-uu- -- u u- uu-uu --	dactylic hexameter	masculine penthemimeral, hepthemimeral, trithemimeral
Ἀντίνοος δ’ἔτ’ ἐπεῖχε καὶ Εὐρύμαχος θεοειδής,	-uu- u u-u u -uu- uu--	dactylic hexameter	feminine penthemimeral, trithemimeral
ἀρχοὶ μνηστήρων· ἀρετῇ δ’ἔσαν ἔξοχ’ ἄριστοι.	-- --- uu- uu -u u--	dactylic hexameter	masculine penthemimeral, hepthemimeral
τὼ δ’ἐξ οἴκου βῆσαν ὁμαρτήσαντες ἅμ’ ἄμφω	- - -- -u u---u u --	dactylic hexameter	feminine penthemimeral
βουκόλος ἠδὲ συφορβὸς Ὀδυσσῆος θείοιο·	-uu -u u-u u--- ---	dactylic hexameter	feminine penthemimeral
ἐκ δ’αὐτὸς μετὰ τοὺς δόμου ἤλυθε δῖος Ὀδυσσεύς.	- -- uu - uu -uu -u u--	dactylic hexameter	masculine penthemimeral, trithemimeral
ἀλλ’ ὅτε δή ῥ’ἐκτὸς θυρέων ἔσαν ἠδὲ καὶ αὐλῆς,	- uu - -- uu- uu -u u --	dactylic hexameter	masculine penthemimeral, hepthemimeral, trithemimeral
φθεγξάμενός σφ’ἐπέεσσι προσηύδα μειλιχίοισι·	-uu- uu-u u-- -uu--	dactylic hexameter	feminine penthemimeral, trithemimeral
βουκόλε καὶ σύ, συφορβέ, ἔπος τί κε μυθησαίμην,	-uu - u u-u u- u u ----	dactylic hexameter	feminine penthemimeral, hepthemimeral, trithemimeral
ἦ αὐτὸς κεύθω; φάσθαι δέ με θυμὸς ἀνώγει.	- -- -- -- u u -u u--	dactylic hexameter	masculine penthemimeral, hepthemimeral, trithemimeral
ποῖοί κ’εἶτ’ Ὀδυσῆϊ ἀμυνέμεν, εἴ ποθεν ἔλθοι	-- - uu-u u-uu - uu --	dactylic hexameter	feminine penthemimeral, trithemimeral
ὦδε μάλ’ ἐξαπίνης καί τις θεὸς αὐτὸν ἐνείκαι;	-u u -uu- - - uu -u u--	dactylic hexameter	masculine penthemimeral, hepthemimeral
ἤ κε μνηστήρεσσιν ἀμύνοιτ’ ἦ Ὀδυσῆϊ;	- - ---u u-- - uu--	dactylic hexameter	feminine penthemimeral
εἴπαθ’ ὅπως ὑμέας κραδίη θυμός τε κελεύει.	-u u- uu- uu- -- u u--	dactylic hexameter	masculine penthemimeral, hepthemimeral, trithemimeral
τὸν δ’αὖτε προσέειπε βοῶν ἐπιβουκόλος ἀνήρ·	- -- uu-u u- uu-uu --	dactylic hexameter	feminine penthemimeral, hepthemimeral, trithemimeral
Ζεῦ πάτερ, αἲ γὰρ τοῦτο τελευτήσειας ἐέλδωρ,	- uu - - -u u---u u--	dactylic hexameter	feminine penthemimeral, trithemimeral
ὡς ἔλθοι μὲν κεῖνος ἀνήρ, ἀγάγοι δέ ἑ δαίμων·	- -- - -u u- uu- u u --	dactylic hexameter	feminine penthemimeral, hepthemimeral, trithemimeral
γνοίης χ’οἵη ἐμὴ δύναμις καὶ χεῖρες ἕπονται.	-- -u u- uu- - -u u--	dactylic hexameter	masculine penthemimeral, hepthemimeral
ὣς δ’αὔτως Εὔμαιος ἐπεύχετο πᾶσι θεοῖσι	- -- --u u-uu -u u--	dactylic hexameter	feminine penthemimeral, trithemimeral
νοστῆσαι Ὀδυσῆα πολύφρονα ὅνδε δόμονδε.	--- uu-u u-uu -u u--	dactylic hexameter	feminine penthemimeral, trithemimeral
αὐτὰρ ἐπεὶ δὴ τῶν γε νόον νημερτέ’ ἀνέγνω,	-u u- - - u u- --u u--	dactylic hexameter	masculine penthemimeral, hepthemimeral, trithemimeral
ἐξαῦτίς σφ’ἐπέεσσιν ἀμειβόμενος προσέειπεν·	--- uu-u u-uu- uu--	dactylic hexameter	feminine penthemimeral, trithemimeral
ἔνδον μὲν δὴ ὅδ’ αὐτὸς ἐγώ, κακὰ πολλὰ μογήσας	-- - u u -u u- uu -u u--	dactylic hexameter	feminine penthemimeral, hepthemimeral, trithemimeral
ἤλυθον εἰκοστῷ ἔτεϊ ἐς πατρίδα γαῖαν.	-uu --- uu- - -uu --	dactylic hexameter	masculine penthemimeral, hepthemimeral
γινώσκω δ’ὡς σφῶϊν ἐελδομένοισιν ἱκάνω	--- - -u u-uu-u u--	dactylic hexameter	feminine penthemimeral, trithemimeral
οἴοισι δμώων· τῶν δ’ἄλλων οὔ τευ ἄκουσα	--- -- - -- - u u--	dactylic hexameter	masculine penthemimeral, trithemimeral
εὐξαμένου ἐμὲ αὖτις ὑπότροπον οἴκαδ’ ἱκέσθαι.	-uu- uu -u u-uu -u u--	dactylic hexameter	feminine penthemimeral, trithemimeral
σφῶϊν δ’,ὡς ἔσεταί περ, ἀληθείην καταλέξω.	-- - uu- u u--- uu--	dactylic hexameter	masculine penthemimeral, trithemimeral
εἴ χ’ὑπ’ ἔμοιγε θεὸς δαμάσῃ μνηστῆρας ἀγαυούς,	- u u-u u- uu- --u u--	dactylic hexameter	masculine penthemimeral, hepthemimeral
ἄξομαι ἀμφοτέροις ἀλόχους καὶ κτήματ’ ὀπάσσω	-uu -uu- uu- - -u u--	dactylic hexameter	masculine penthemimeral, hepthemimeral
οἰκία τ’ἐγγὺς ἐμεῖο τετυγμένα· καί μοι ἔπειτα	-uu -u u-u u-uu - u u--	dactylic hexameter	feminine penthemimeral
Τηλεμάχου ἑτάρω τε κασιγνήτω τε ἔσεσθον.	-uu- uu- u u--- u u--	dactylic hexameter	masculine penthemimeral, trithemimeral
εἰ δ’ἄγε δή, καὶ σῆμα ἀριφραδὲς ἄλλο τι δείξω,	- uu - - -u u-uu -u u --	dactylic hexameter	feminine penthemimeral, trithemimeral
ὄφρα μ’ἐῢ γνῶτον πιστωθῆτόν τ’ἐνὶ θυμῷ,	-u u- -- ---- uu --	dactylic hexameter	masculine penthemimeral, trithemimeral
οὐλήν, τήν ποτέ με σῦς ἤλασε λευκῷ ὀδόντι	-- - uu - - -uu -u u--	dactylic hexameter	masculine penthemimeral, trithemimeral
Παρνησόνδ’ ἐλθόντα σὺν υἱάσιν Αὐτολύκοιο.	--- --u u -uu -uu--	dactylic hexameter	feminine penthemimeral, trithemimeral
ὣς εἰπὼν ῥάκεα μεγάλης ἀποέργαθεν οὐλῆς.	- -- uu- uu- uu-uu --	dactylic hexameter	masculine penthemimeral, hepthemimeral, trithemimeral
τὼ δ’ἐπεὶ εἰσιδέτην εὖ τ’ἐφράσσαντο ἕκαστα,	- uu -uu- - ---u u--	dactylic hexameter	masculine penthemimeral
κλαῖον ἄρ’ ἀμφ’ Ὀδυσῆϊ δαΐφρονι χεῖρε βαλόντε,	-u u - uu-u u-uu -u u--	dactylic hexameter	feminine penthemimeral, trithemimeral
καὶ κύνεον ἀγαπαζόμενοι κεφαλήν τε καὶ ὤμους	- -- uu-uu- uu- u u --	dactylic hexameter	hepthemimeral, trithemimeral
ὣς δ’αὔτως Ὀδυσεὺς κεφαλὰς καὶ χεῖρας ἔκυσσε.	- -- uu- uu- - -u u--	dactylic hexameter	masculine penthemimeral, hepthemimeral, trithemimeral
καί νύ κ’ὀδυρομένοισιν ἔδυ φάος ἠελίοιο,	- u u-uu-u u- uu -uu--	dactylic hexameter	feminine penthemimeral, hepthemimeral
εἰ μὴ Ὀδυσσεὺς αὐτὸς ἐρύκακε φώνησέν τε·	- u u-- -u u-uu --- -	dactylic hexameter	feminine penthemimeral
παύεσθον κλαυθμοῖο γόοιό τε, μή τις ἴδηται	--- --u u-u u - u u--	dactylic hexameter	feminine penthemimeral, trithemimeral
ἐξελθὼν μεγάροιο, ἀτὰρ εἴπῃσι καὶ εἴσω.	--- uu-u u- --u u --	dactylic hexameter	feminine penthemimeral, hepthemimeral, trithemimeral
ἀλλὰ προμνηστῖνοι ἐσέλθετε, μηδ’ ἅμα πάντες,	-- ---u u-uu - uu --	dactylic hexameter	feminine penthemimeral
πρῶτος ἐγώ, μετὰ δ’ὔμμες· ἀτὰρ τόδε σῆμα τετύχθω·	-u u- uu -u u- uu -u u--	dactylic hexameter	feminine penthemimeral, hepthemimeral, trithemimeral
ἄλλοι μὲν γὰρ πάντες, ὅσοι μνηστῆρες ἀγαυοί,	-- - - -u u- --u u--	dactylic hexameter	feminine penthemimeral, hepthemimeral, trithemimeral
οὐκ ἐάσουσιν ἐμοὶ δόμεναι βιὸν ἠδὲ φαρέτρην·	- uu-u u- uu- uu -u u--	dactylic hexameter	masculine penthemimeral, hepthemimeral
ἀλλὰ σύ, δῖ’ Εὔμαιε, φέρων ἀνὰ δώματα τόξον	-u u - --u u- uu -uu --	dactylic hexameter	feminine penthemimeral, hepthemimeral, trithemimeral
ἐν χείρεσσιν ἐμοὶ θέμεναι, εἰπεῖν δὲ γυναιξὶ	- --u u- uu- -- u u--	dactylic hexameter	masculine penthemimeral, hepthemimeral
κληῗσαι μεγάροιο θύρας πυκινῶς ἀραρυίας,	--- uu-u u- uu- uu--	dactylic hexameter	feminine penthemimeral, hepthemimeral, trithemimeral
ἢν δέ τις ἢ στοναχῆς ἠὲ κτύπου ἔνδον ἀκούσῃ	- u u - uu- -- uu -u u--	dactylic hexameter	masculine penthemimeral, hepthemimeral, trithemimeral
ἀνδρῶν ἡμετέροισιν ἐν ἕρκεσι, μή τι θύραζε	-- -uu-u u -uu - u u--	dactylic hexameter	feminine penthemimeral
προβλώσκειν, ἀλλ’ αὐτοῦ ἀκὴν ἔμεναι παρὰ ἔργῳ.	--- - -u u- uu- uu --	dactylic hexameter	feminine penthemimeral, hepthemimeral, trithemimeral
σοὶ δέ, Φιλοίτιε δῖε, θύρας ἐπιτέλλομαι αὐλῆς	- u u-uu -u u- uu-uu --	dactylic hexameter	feminine penthemimeral, hepthemimeral
κληῗσαι κληῗδι, θοῶς δ’ἐπὶ δεσμὸν ἰῆλαι.	--- --u u- uu -u u--	dactylic hexameter	feminine penthemimeral, hepthemimeral, trithemimeral
ὣς εἰπὼν εἰσῆλθε δόμους εὖ ναιετάοντας·	- -- --u u- - -uu--	dactylic hexameter	feminine penthemimeral, hepthemimeral, trithemimeral
ἕζετ’ ἔπειτ’ ἐπὶ δίφρον ἰών, ἔνθεν περ ἀνέστη·	-u u- uu -u u- -- u u--	dactylic hexameter	feminine penthemimeral, hepthemimeral, trithemimeral
ἐς δ’ἄρα καὶ τὼ δμῶε ἴτην θείου Ὀδυσῆος.	- uu - - -u u- -- uu--	dactylic hexameter	feminine penthemimeral, hepthemimeral, trithemimeral
Εὐρύμαχος δ’ἤδη τόξον μετὰ χερσὶν ἐνώμα,	-uu- -- -- uu -u u--	dactylic hexameter	masculine penthemimeral, hepthemimeral, trithemimeral
θάλπων ἔνθα καὶ ἔνθα σέλᾳ πυρός· ἀλλά μιν οὐδ’ ὣς	-- -u u -u u- uu -u u - -	dactylic hexameter	feminine penthemimeral, hepthemimeral
ἐντανύσαι δύνατο, μέγα δ’ἔστενε κυδάλιμον κῆρ·	-uu- uu- uu -uu -uu- -	dactylic hexameter	masculine penthemimeral, trithemimeral
ὀχθήσας δ’ἄρα εἶπεν ἔπος τ’ἔφατ’ ἔκ τ’ὀνόμαζεν·	--- uu -u u- uu - uu--	dactylic hexameter	feminine penthemimeral, hepthemimeral, trithemimeral
ὢ πόποι, ἦ μοι ἄχος περί τ’αὐτοῦ καὶ περὶ πάντων·	- uu - u u- uu -- - uu --	dactylic hexameter	masculine penthemimeral, trithemimeral
οὔ τι γάμου τοσσοῦτον ὀδύρομαι, ἀχνύμενός περ·	- u u- --u u-uu -uu- -	dactylic hexameter	feminine penthemimeral, trithemimeral
εἰσὶ καὶ ἄλλαι πολλαὶ Ἀχαιΐδες, αἱ μὲν ἐν αὐτῇ	-u u -- -u u-uu - u u --	dactylic hexameter	feminine penthemimeral
ἀμφιάλῳ Ἰθάκῃ, αἱ δ’ἄλλῃσιν πολίεσσιν·	-uu- uu- - --- uu--	dactylic hexameter	masculine penthemimeral, trithemimeral
ἀλλ’ εἰ δὴ τοσσόνδε βίης ἐπιδευέες εἰμὲν	- - - --u u- uu-uu --	dactylic hexameter	feminine penthemimeral, hepthemimeral, trithemimeral
ἀντιθέου Ὀδυσῆος, ὅτ’ οὐ δυνάμεσθα τανύσσαι	-uu- uu-u u - uu-u u--	dactylic hexameter	feminine penthemimeral, hepthemimeral, trithemimeral
τόξον· ἐλεγχείη δὲ καὶ ἐσσομένοισι πυθέσθαι.	-u u--- u u -uu-u u--	dactylic hexameter	masculine penthemimeral
τὸν δ’αὖτ’ Ἀντίνοος προσέφη, Εὐπείθεος υἱός·	- - -uu- uu- --uu --	dactylic hexameter	masculine penthemimeral, hepthemimeral
Εὐρύμαχ’, οὐχ οὕτως ἔσται· νοέεις δὲ καὶ αὐτός.	-uu - -- -- uu- u u --	dactylic hexameter	masculine penthemimeral, hepthemimeral, trithemimeral
νῦν μὲν γὰρ κατὰ δῆμον ἑορτὴ τοῖο θεοῖο	- - - uu -u u-- -u u--	dactylic hexameter	feminine penthemimeral, trithemimeral
ἁγνή· τίς δέ κε τόξα τιταίνοιτ’; ἀλλὰ ἕκηλοι	-- - u u -u u-- -u u--	dactylic hexameter	feminine penthemimeral, trithemimeral
κάτθετ’· ἀτὰρ πελέκεάς γε καὶ εἴ κ’εἰῶμεν ἅπαντας	-u u- uu- u u - --u u--	dactylic hexameter	masculine penthemimeral, hepthemimeral, trithemimeral
ἑστάμεν· οὐ μὲν γάρ τιν’ ἀναιρήσεσθαι ὀΐω,	-uu - - - u u---u u--	dactylic hexameter	masculine penthemimeral, trithemimeral
ἐλθόντ’ ἐς μέγαρον Λαερτιάδεω Ὀδυσῆος.	-- - uu- --uu- uu--	dactylic hexameter	masculine penthemimeral, trithemimeral
ἀλλ’ ἄγετ’, οἰνοχόος μὲν ἐπαρξάσθω δεπάεσσιν,	- uu -uu- u u--- uu--	dactylic hexameter	masculine penthemimeral
ὄφρα σπείσαντες καταθείομεν ἀγκύλα τόξα·	-- --- uu-uu -uu --	dactylic hexameter	masculine penthemimeral
ἠῶθεν δὲ κέλεσθε Μελάνθιον, αἰπόλον αἰγῶν,	--- u u-u u-uu -uu --	dactylic hexameter	feminine penthemimeral, trithemimeral
αἶγας ἄγειν, αἳ πᾶσι μέγ’ ἔξοχοι αἰπολίοισιν,	-u u- - -u u -uu -uu--	dactylic hexameter	feminine penthemimeral, trithemimeral
ὄφρ’ ἐπὶ μηρία θέντες Ἀπόλλωνι κλυτοτόξῳ	- uu -uu -u u--- uu--	dactylic hexameter	feminine penthemimeral
τόξου πειρώμεσθα καὶ ἐκτελέωμεν ἄεθλον.	-- ---u u -uu-u u--	dactylic hexameter	feminine penthemimeral
ὣς ἔφατ’ Ἀντίνοος, τοῖσιν δ’ἐπιήνδανε μῦθος.	- uu -uu- -- uu-uu --	dactylic hexameter	masculine penthemimeral, hepthemimeral
τοῖσι δὲ κήρυκες μὲν ὕδωρ ἐπὶ χεῖρας ἔχευαν,	-u u --- u u- uu -u u--	dactylic hexameter	masculine penthemimeral, hepthemimeral
κοῦροι δὲ κρητῆρας ἐπεστέψαντο ποτοῖο,	-- - --u u---u u--	dactylic hexameter	feminine penthemimeral, trithemimeral
νώμησαν δ’ἄρα πᾶσιν ἐπαρξάμενοι δεπάεσσιν.	--- uu -u u-uu- uu--	dactylic hexameter	feminine penthemimeral, trithemimeral
οἱ δ’ἐπεὶ οὖν σπεῖσάν τ’ἔπιόν θ’ὅσον ἤθελε θυμός,	- uu - -- uu- uu -uu --	dactylic hexameter	masculine penthemimeral, hepthemimeral, trithemimeral
τοῖς δὲ δολοφρονέων μετέφη πολύμητις Ὀδυσσεύς·	- u u-uu- uu- uu-u u--	dactylic hexameter	masculine penthemimeral, hepthemimeral
κέκλυτέ μευ, μνηστῆρες ἀγακλειτῆς βασιλείης·	-uu - --u u--- uu--	dactylic hexameter	feminine penthemimeral, trithemimeral
ὄφρ’ εἴπω τά με θυμὸς ἐνὶ στήθεσσι κελεύει·	- -- u u -u u- --u u--	dactylic hexameter	feminine penthemimeral, hepthemimeral, trithemimeral
Εὐρύμαχον δὲ μάλιστα καὶ Ἀντίνοον θεοειδέα	-uu- u u-u u -uu- uu--	dactylic hexameter	feminine penthemimeral, trithemimeral
λίσσομ’, ἐπεὶ καὶ τοῦτο ἔπος κατὰ μοῖραν ἔειπε,	-u u- - -u u- uu -u u--	dactylic hexameter	feminine penthemimeral, hepthemimeral, trithemimeral
νῦν μὲν παῦσαι τόξον, ἐπιτρέψαι δὲ θεοῖσιν·	- - -- -u u--- u u--	dactylic hexameter	feminine penthemimeral
ἠῶθεν δὲ θεὸς δώσει κράτος ᾧ κ’ἐθέλῃσιν.	--- u u- -- uu - uu--	dactylic hexameter	masculine penthemimeral, hepthemimeral, trithemimeral
ἀλλ’ ἄγε μοι δότε τόξον ἐΰξοον, ὄφρα μεθ’ ὑμῖν	- uu - uu -u u-uu -u u --	dactylic hexameter	feminine penthemimeral, trithemimeral
χειρῶν καὶ σθένεος πειρήσομαι, εἴ μοι ἔτ’ ἐστὶν	-- - uu- --uu - u u --	dactylic hexameter	masculine penthemimeral, trithemimeral
ἴς, οἵη πάρος ἔσκεν ἐνὶ γναμπτοῖσι μέλεσσιν,	- -- uu -u u- --u u--	dactylic hexameter	feminine penthemimeral, hepthemimeral, trithemimeral
ἦ ἤδη μοι ὄλεσσεν ἄλη τ’ἀκομιστίη τε.	- -- u u-u u- uu--- -	dactylic hexameter	feminine penthemimeral, hepthemimeral, trithemimeral
ὣς ἔφαθ’, οἱ δ’ἄρα πάντες ὑπερφιάλως νεμέσησαν,	- uu - uu -u u-uu- uu--	dactylic hexameter	feminine penthemimeral, trithemimeral
δείσαντες μὴ τόξον ἐΰξοον ἐντανύσειεν.	--- - -u u-uu -uu--	dactylic hexameter	feminine penthemimeral, trithemimeral
Ἀντίνοος δ’ἐνένιπεν ἔπος τ’ἔφατ’ ἔκ τ’ὀνόμαζεν·	-uu- uu-u u- uu - uu--	dactylic hexameter	feminine penthemimeral, hepthemimeral, trithemimeral
ἆ δειλὲ ξείνων, ἔνι τοι φρένες οὐδ’ ἠβαιαί·	- -- -- uu - uu - ---	dactylic hexameter	masculine penthemimeral, hepthemimeral, trithemimeral
οὐκ ἀγαπᾷς ὃ ἕκηλος ὑπερφιάλοισι μεθ’ ἡμῖν	- uu- u u-u u-uu-u u --	dactylic hexameter	feminine penthemimeral, trithemimeral
δαίνυσαι, οὐδέ τι δαιτὸς ἀμέρδεαι, αὐτὰρ ἀκούεις	-uu -u u -u u-uu -u u--	dactylic hexameter	feminine penthemimeral
μύθων ἡμετέρων καὶ ῥήσιος; οὐδέ τις ἄλλος	-- -uu- - -uu -u u --	dactylic hexameter	masculine penthemimeral
ἡμετέρων μύθων ξεῖνος καὶ πτωχὸς ἀκούει.	-uu- -- -- - -u u--	dactylic hexameter	masculine penthemimeral, hepthemimeral, trithemimeral
οἶνός σε τρώει μελιηδής, ὅς τε καὶ ἄλλους	-- - -- uu-- - u u --	dactylic hexameter	masculine penthemimeral, trithemimeral
βλάπτει, ὃς ἄν μιν χανδὸν ἕλῃ μηδ’ αἴσιμα πίνῃ.	-u u - - -u u- - -uu --	dactylic hexameter	feminine penthemimeral, hepthemimeral, trithemimeral
οἶνος καὶ Κένταυρον, ἀγακλυτὸν Εὐρυτίωνα,	-- - --u u-uu -uu--	dactylic hexameter	feminine penthemimeral, trithemimeral
ἄασ’ ἐνὶ μεγάρῳ μεγαθύμου Πειριθόοιο,	-u u- uu- uu-- -uu--	dactylic hexameter	masculine penthemimeral, trithemimeral
ἐς Λαπίθας ἐλθόνθ’· ὁ δ’ἐπεὶ φρένας ἄασεν οἴνῳ,	- uu- -- u u- uu -uu --	dactylic hexameter	masculine penthemimeral, hepthemimeral, trithemimeral
μαινόμενος κάκ’ ἔρεξε δόμον κάτα Πειριθόοιο·	-uu- u u-u u- uu -uu--	dactylic hexameter	feminine penthemimeral, hepthemimeral, trithemimeral
ἥρωας δ’ἄχος εἷλε, διὲκ προθύρου δὲ θύραζε	--- uu -u u- uu- u u--	dactylic hexameter	feminine penthemimeral, hepthemimeral, trithemimeral
ἕλκον ἀναΐξαντες, ἀπ’ οὔατα νηλέϊ χαλκῷ	-u u---u u -uu -uu --	dactylic hexameter	feminine penthemimeral
ῥῖνάς τ’ἀμήσαντες· ὁ δὲ φρεσὶν ᾗσιν ἀασθεὶς	-- ---u u - uu -u u--	dactylic hexameter	feminine penthemimeral, hepthemimeral
ἤϊεν ἣν ἄτην ὀχέων ἀεσίφρονι θυμῷ.	-uu - -- uu- uu-uu --	dactylic hexameter	masculine penthemimeral, hepthemimeral, trithemimeral
ἐξ οὗ Κενταύροισι καὶ ἀνδράσι νεῖκος ἐτύχθη,	- - ---u u -uu -u u--	dactylic hexameter	feminine penthemimeral
οἷ δ’αὐτῷ πρώτῳ κακὸν εὕρετο οἰνοβαρείων.	- -- -- uu -uu -uu--	dactylic hexameter	masculine penthemimeral, trithemimeral
ὣς καὶ σοὶ μέγα πῆμα πιφαύσκομαι, αἴ κε τὸ τόξον	- - - uu -u u-uu - u u --	dactylic hexameter	feminine penthemimeral, trithemimeral
ἐντανύσῃς· οὐ γάρ τευ ἐπητύος ἀντιβολήσεις	-uu- - - u u-uu -uu--	dactylic hexameter	masculine penthemimeral, trithemimeral
ἡμετέρῳ ἐνὶ δήμῳ, ἄφαρ δέ σε νηῒ μελαίνῃ	-uu- uu -u u- u u -u u--	dactylic hexameter	feminine penthemimeral, hepthemimeral, trithemimeral
εἰς Ἔχετον βασιλῆα, βροτῶν δηλήμονα πάντων,	- uu- uu-u u- --uu --	dactylic hexameter	feminine penthemimeral, hepthemimeral, trithemimeral
πέμψομεν· ἔνθεν δ’οὔ τι σαώσεαι· ἀλλὰ ἕκηλος	-uu -- - u u-uu -u u--	dactylic hexameter	masculine penthemimeral
πῖνέ τε, μηδ’ ἐρίδαινε μετ’ ἀνδράσι κουροτέροισι.	-u u - uu-u u -uu -uu--	dactylic hexameter	feminine penthemimeral, trithemimeral
τὸν δ’αὖτε προσέειπε περίφρων Πηνελόπεια·	- -- uu-u u-- -uu--	dactylic hexameter	feminine penthemimeral, trithemimeral
Ἀντίνο’, οὐ μὲν καλὸν ἀτέμβειν οὐδὲ δίκαιον	-uu - - -u u-- -u u--	dactylic hexameter	feminine penthemimeral, trithemimeral
ξείνους Τηλεμάχου, ὅς κεν τάδε δώμαθ’ ἵκηται·	-- -uu- - - uu -u u--	dactylic hexameter	masculine penthemimeral, hepthemimeral
ἔλπεαι, αἴ χ’ὁ ξεῖνος Ὀδυσσῆος μέγα τόξον	-uu - - -u u--- uu --	dactylic hexameter	feminine penthemimeral, trithemimeral
ἐντανύσῃ χερσίν τε βίηφί τε ἧφι πιθήσας,	-uu- -- u u-u u -u u--	dactylic hexameter	masculine penthemimeral, trithemimeral
οἴκαδέ μ’ἄξεσθαι καὶ ἑὴν θήσεσθαι ἄκοιτιν;	-uu --- u u- --u u--	dactylic hexameter	masculine penthemimeral, hepthemimeral
οὐδ’ αὐτός που τοῦτό γ’ ἐνὶ στήθεσσιν ἔολπε·	- -- - -u u- --u u--	dactylic hexameter	feminine penthemimeral, hepthemimeral, trithemimeral
μηδέ τις ὑμείων τοῦ γ’εἵνεκα θυμὸν ἀχεύων	-u u --- - -uu -u u--	dactylic hexameter	masculine penthemimeral
ἐνθάδε δαινύσθω, ἐπεὶ οὐδὲ μὲν οὐδὲ ἔοικε.	-uu --- uu -u u -u u--	dactylic hexameter	masculine penthemimeral
τὴν δ’αὖτ’ Εὐρύμαχος, Πολύβου πάϊς, ἀντίον ηὔδα·	- - -uu- uu- uu -uu --	dactylic hexameter	masculine penthemimeral, hepthemimeral
κούρη Ἰκαρίοιο, περίφρων Πηνελόπεια,	-- -uu-u u-- -uu--	dactylic hexameter	feminine penthemimeral
οὔ τί σε τόνδ’ ἄξεσθαι ὀϊόμεθ’· οὐδὲ ἔοικεν·	- u u - --u u-uu -u u--	dactylic hexameter	feminine penthemimeral, trithemimeral
ἀλλ’ αἰσχυνόμενοι φάτιν ἀνδρῶν ἠδὲ γυναικῶν,	- --uu- uu -- -u u--	dactylic hexameter	masculine penthemimeral
μή ποτέ τις εἴπῃσι κακώτερος ἄλλος Ἀχαιῶν	- uu - --u u-uu -u u--	dactylic hexameter	feminine penthemimeral, trithemimeral
ἦ πολὺ χείρονες ἄνδρες ἀμύμονος ἀνδρὸς ἄκοιτιν	- uu -uu -u u-uu -u u--	dactylic hexameter	feminine penthemimeral
μνῶνται, οὐδέ τι τόξον ἐΰξοον ἐντανύουσιν·	-- -u u -u u-uu -uu--	dactylic hexameter	feminine penthemimeral
ἀλλ’ ἄλλος τις πτωχὸς ἀνὴρ ἀλαλήμενος ἐλθὼν	- -- - -u u- uu-uu --	dactylic hexameter	feminine penthemimeral, hepthemimeral, trithemimeral
ῥηϊδίως ἐτάνυσσε βιόν, διὰ δ’ἧκε σιδήρου.	-uu- uu-u u- uu -u u--	dactylic hexameter	feminine penthemimeral, hepthemimeral, trithemimeral
ὣς ἐρέουσ’, ἡμῖν δ’ἂν ἐλέγχεα ταῦτα γένοιτο.	- uu- -- u u-uu -u u--	dactylic hexameter	masculine penthemimeral, trithemimeral
τὸν δ’αὖτε προσέειπε περίφρων Πηνελόπεια·	- -- uu-u u-- -uu--	dactylic hexameter	feminine penthemimeral, trithemimeral
Εὐρύμαχ’, οὔ πως ἔστιν ἐϋκλεῖας κατὰ δῆμον	-uu - - -u u--- uu --	dactylic hexameter	feminine penthemimeral, trithemimeral
ἔμμεναι οἳ δὴ οἶκον ἀτιμάζοντες ἔδουσιν	-uu - - -u u---u u--	dactylic hexameter	feminine penthemimeral, trithemimeral
ἀνδρὸς ἀριστῆος· τί δ’ἐλέγχεα ταῦτα τίθεσθε;	-u u--- u u-uu -u u--	dactylic hexameter	masculine penthemimeral
οὗτος δὲ ξεῖνος μάλα μὲν μέγας ἠδ’ εὐπηγής,	-- - -- uu - uu - ---	dactylic hexameter	masculine penthemimeral, hepthemimeral, trithemimeral
πατρὸς δ’ἐξ ἀγαθοῦ γένος εὔχεται ἔμμεναι υἱός.	-- - uu- uu -uu -uu --	dactylic hexameter	masculine penthemimeral, trithemimeral
ἀλλ’ ἄγε οἱ δότε τόξον ἐΰξοον, ὄφρα ἴδωμεν.	- uu - uu -u u-uu -u u--	dactylic hexameter	feminine penthemimeral, trithemimeral
ὦδε γὰρ ἐξερέω, τὸ δὲ καὶ τετελεσμένον ἔσται·	-u u -uu- u u - uu-uu --	dactylic hexameter	masculine penthemimeral, hepthemimeral
εἴ κέ μιν ἐντανύσῃ, δώῃ δέ οἱ εὖχος Ἀπόλλων,	- u u -uu- -- u u -u u--	dactylic hexameter	masculine penthemimeral, hepthemimeral
ἕσσω μιν χλαῖνάν τε χιτῶνά τε, εἵματα καλά,	-- - -- u u-u u -uu --	dactylic hexameter	masculine penthemimeral, trithemimeral
δώσω δ’ὀξὺν ἄκοντα, κυνῶν ἀλκτῆρα καὶ ἀνδρῶν,	-- -u u-u u- --u u --	dactylic hexameter	feminine penthemimeral, hepthemimeral
καὶ ξίφος ἄμφηκες· δώσω δ’ὑπὸ ποσσὶ πέδιλα,	- uu --- -- uu -u u--	dactylic hexameter	masculine penthemimeral, hepthemimeral
πέμψω δ’ὅππῃ μιν κραδίη θυμός τε κελεύει.	-- -- - uu- -- u u--	dactylic hexameter	masculine penthemimeral, hepthemimeral
τὴν δ’αὖ Τηλέμαχος πεπνυμένος ἀντίον ηὔδα·	- - -uu- --uu -uu --	dactylic hexameter	masculine penthemimeral
μῆτερ ἐμή, τόξον μὲν Ἀχαιῶν οὔ τις ἐμεῖο	-u u- -- u u-- - u u--	dactylic hexameter	masculine penthemimeral, trithemimeral
κρείσσων, ᾧ κ’ἐθέλω, δόμεναί τε καὶ ἀρνήσασθαι,	-- - uu- uu- u u ----	dactylic hexameter	masculine penthemimeral, hepthemimeral, trithemimeral
οὔθ’ ὅσσοι κραναὴν Ἰθάκην κάτα κοιρανέουσιν,	- -- uu- uu- uu -uu--	dactylic hexameter	masculine penthemimeral, hepthemimeral, trithemimeral
οὔθ’ ὅσσοι νήσοισι πρὸς Ἤλιδος ἱπποβότοιο·	- -- --u u -uu -uu--	dactylic hexameter	feminine penthemimeral, trithemimeral
τῶν οὔ τίς μ’ἀέκοντα βιήσεται, αἴ κ’ἐθέλωμι	- - - uu-u u-uu - uu--	dactylic hexameter	feminine penthemimeral, trithemimeral
καὶ καθάπαξ ξείνῳ δόμεναι τάδε τόξα φέρεσθαι.	- uu- -- uu- uu -u u--	dactylic hexameter	masculine penthemimeral, hepthemimeral, trithemimeral
ἀλλ’ εἰς οἶκον ἰοῦσα τὰ σ’αὐτῆς ἔργα κόμιζε,	- - -u u-u u -- -u u--	dactylic hexameter	feminine penthemimeral
ἱστόν τ’ἠλακάτην τε, καὶ ἀμφιπόλοισι κέλευε	-- -uu- u u -uu-u u--	dactylic hexameter	masculine penthemimeral
ἔργον ἐποίχεσθαι· τόξον δ’ἄνδρεσσι μελήσει	-u u--- -- --u u--	dactylic hexameter	masculine penthemimeral, hepthemimeral
πᾶσι, μάλιστα δ’ἐμοί· τοῦ γὰρ κράτος ἔστ’ ἐνὶ οἴκῳ.	-u u-u u- - - uu - uu --	dactylic hexameter	masculine penthemimeral, hepthemimeral
ἡ μὲν θαμβήσασα πάλιν οἶκόνδε βεβήκει·	- - ---u u- --u u--	dactylic hexameter	feminine penthemimeral, hepthemimeral
παιδὸς γὰρ μῦθον πεπνυμένον ἔνθετο θυμῷ.	-- - -- --uu -uu --	dactylic hexameter	masculine penthemimeral, trithemimeral
ἐς δ’ὑπερῷ’ ἀναβᾶσα σὺν ἀμφιπόλοισι γυναιξὶ	- uu- uu-u u -uu-u u--	dactylic hexameter	feminine penthemimeral, trithemimeral
κλαῖεν ἔπειτ’ Ὀδυσῆα, φίλον πόσιν, ὄφρα οἱ ὕπνον	-u u- uu-u u- uu -u u --	dactylic hexameter	feminine penthemimeral, hepthemimeral, trithemimeral
ἡδὺν ἐπὶ βλεφάροισι βάλε γλαυκῶπις Ἀθήνη.	-u u- uu-u u- --u u--	dactylic hexameter	feminine penthemimeral, hepthemimeral, trithemimeral
αὐτὰρ ὁ τόξα λαβὼν φέρε καμπύλα δῖος ὑφορβός·	-u u -u u- uu -uu -u u--	dactylic hexameter	masculine penthemimeral
μνηστῆρες δ’ἄρα πάντες ὁμόκλεον ἐν μεγάροισιν·	--- uu -u u-uu - uu--	dactylic hexameter	feminine penthemimeral, trithemimeral
ὦδε δέ τις εἴπεσκε νέων ὑπερηνορεόντων·	-u u - --u u- uu-uu--	dactylic hexameter	feminine penthemimeral, hepthemimeral, trithemimeral
πῇ δὴ καμπύλα τόξα φέρεις, ἀμέγαρτε συβῶτα,	- - -uu -u u- uu-u u--	dactylic hexameter	feminine penthemimeral, hepthemimeral
πλαγκτέ; τάχ’ αὖ σ’ἐφ’ ὕεσσι κύνες ταχέες κατέδονται	-u u - u u-u u- uu- uu--	dactylic hexameter	feminine penthemimeral, hepthemimeral, trithemimeral
οἶον ἀπ’ ἀνθρώπων, οὓς ἔτρεφες, εἴ κεν Ἀπόλλων	-u u --- - -uu - u u--	dactylic hexameter	masculine penthemimeral
ἡμῖν ἱλήκῃσι καὶ ἀθάνατοι θεοὶ ἄλλοι.	-- ---u u -uu- uu --	dactylic hexameter	feminine penthemimeral
ὣς φάσαν, αὐτὰρ, ὁ θῆκε φέρων αὐτῇ ἐνὶ χώρῃ,	- uu -u u -u u- -- uu --	dactylic hexameter	feminine penthemimeral, hepthemimeral
δείσας, οὕνεκα πολλοὶ ὁμόκλεον ἐν μεγάροισι.	-- -uu -u u-uu - uu--	dactylic hexameter	feminine penthemimeral
Τηλέμαχος δ’ἑτέρωθεν ἀπειλήσας ἐγεγώνει·	-uu- uu-u u--- uu--	dactylic hexameter	feminine penthemimeral, trithemimeral
ἄττα, πρόσω φέρε τόξα· τάχ’ οὐκ εὖ πᾶσι πιθήσεις	-u u- uu -u u - - -u u--	dactylic hexameter	feminine penthemimeral, hepthemimeral, trithemimeral
μή σε καὶ ὁπλότερός περ ἐὼν ἀγρόνδε δίωμαι,	- u u -uu- u u- --u u--	dactylic hexameter	masculine penthemimeral, hepthemimeral
βάλλων χερμαδίοισι· βίηφι δὲ φέρτερός εἰμι.	-- -uu-u u-u u -uu --	dactylic hexameter	feminine penthemimeral
αἲ γὰρ πάντων τόσσον, ὅσοι κατὰ δώματ’ ἔασι,	- - -- -u u- uu -u u--	dactylic hexameter	feminine penthemimeral, hepthemimeral
μνηστήρων χερσίν τε βίηφί τε φέρτερος εἴην·	--- -- u u-u u -uu --	dactylic hexameter	masculine penthemimeral, trithemimeral
τῶ κε τάχα στυγερῶς τιν’ ἐγὼ πέμψαιμι νέεσθαι	- u u- uu- u u- --u u--	dactylic hexameter	masculine penthemimeral, hepthemimeral, trithemimeral
ἡμετέρου ἐξ οἴκου, ἐπεὶ κακὰ μηχανόωνται.	-uu- - -u u- uu -uu--	dactylic hexameter	feminine penthemimeral, hepthemimeral, trithemimeral
ὣς ἔφαθ’, οἱ δ’ἄρα πάντες ἐπ’ αὐτῷ ἡδὺ γέλασσαν	- uu - uu -u u -- -u u--	dactylic hexameter	feminine penthemimeral, trithemimeral
μνηστῆρες, καὶ δὴ μέθιεν χαλεποῖο χόλοιο	--- - - uu- uu-u u--	dactylic hexameter	masculine penthemimeral, hepthemimeral, trithemimeral
Τηλεμάχῳ· τὰ δὲ τόξα φέρων ἀνὰ δῶμα συβώτης	-uu- u u -u u- uu -u u--	dactylic hexameter	feminine penthemimeral, hepthemimeral, trithemimeral
ἐν χείρεσσ’ Ὀδυσῆϊ δαΐφρονι θῆκε παραστάς.	- -- uu-u u-uu -u u--	dactylic hexameter	feminine penthemimeral, trithemimeral
ἐκ δὲ καλεσσάμενος προσέφη τροφὸν Εὐρύκλειαν·	- u u-uu- uu- uu ----	dactylic hexameter	masculine penthemimeral, hepthemimeral
Τηλέμαχος κέλεταί σε, περίφρων Εὐρύκλεια,	-uu- uu- u u-- ----	dactylic hexameter	masculine penthemimeral, trithemimeral
κληῗσαι μεγάροιο θύρας πυκινῶς ἀραρυίας.	--- uu-u u- uu- uu--	dactylic hexameter	feminine penthemimeral, hepthemimeral, trithemimeral
ἢν δέ τις ἤ στοναχῆς ἠὲ κτύπου ἔνδον ἀκούσῃ	- u u - uu- -- uu -u u--	dactylic hexameter	masculine penthemimeral, hepthemimeral, trithemimeral
ἀνδρῶν ἡμετέροισιν ἐν ἕρκεσι, μή τι θύραζε	-- -uu-u u -uu - u u--	dactylic hexameter	feminine penthemimeral
προβλώσκειν, ἀλλ’ αὐτοῦ ἀκὴν ἔμεναι παρὰ ἔργῳ.	--- - -u u- uu- uu --	dactylic hexameter	feminine penthemimeral, hepthemimeral, trithemimeral
ὣς ἄρ’ ἐφώνησεν, τῇ δ’ἄπτερος ἔπλετο μῦθος,	- u u--- - -uu -uu --	dactylic hexameter	masculine penthemimeral
κλήϊσεν δὲ θύρας μεγάρων εὖ ναιεταόντων.	--- u u- uu- - -uu--	dactylic hexameter	masculine penthemimeral, hepthemimeral, trithemimeral
σιγῇ δ’ἐξ οἴκοιο Φιλοίτιος ἆλτο θύραζε,	-- - --u u-uu -u u--	dactylic hexameter	feminine penthemimeral, trithemimeral
κλήϊσεν δ’ἄρ’ ἔπειτα θύρας εὐερκέος αὐλῆς.	--- u u-u u- --uu --	dactylic hexameter	feminine penthemimeral, hepthemimeral, trithemimeral
κεῖτο δ’ὑπ’ αἰθούσῃ ὅπλον νεὸς ἀμφιελίσσης	-u u --- -- uu -uu--	dactylic hexameter	masculine penthemimeral, hepthemimeral
βύβλινον, ᾧ ῥ’ἐπέδησε θύρας, ἐς δ’ἤϊεν αὐτός·	-uu - uu-u u- - -uu --	dactylic hexameter	feminine penthemimeral, hepthemimeral, trithemimeral
ἕζετ’ ἔπειτ’ ἐπὶ δίφρον ἰών, ἔνθεν περ ἀνέστη,	-u u- uu -u u- -- u u--	dactylic hexameter	feminine penthemimeral, hepthemimeral, trithemimeral
εἰσορόων Ὀδυσῆα. ὁ δ’ἤδη τόξον ἐνώμα	-uu- uu-u u -- -u u--	dactylic hexameter	feminine penthemimeral, trithemimeral
πάντῃ ἀναστρωφῶν, πειρώμενος ἔνθα καὶ ἔνθα,	-u u--- --uu -u u --	dactylic hexameter	masculine penthemimeral
μὴ κέρα ἶπες ἔδοιεν ἀποιχομένοιο ἄνακτος.	- uu -u u-u u-uu-u u--	dactylic hexameter	feminine penthemimeral
ὦδε δέ τις εἴπεσκεν ἰδὼν ἐς πλησίον ἄλλον·	-u u - --u u- - -uu --	dactylic hexameter	feminine penthemimeral, hepthemimeral, trithemimeral
ἦ τις θηητὴρ καὶ ἐπίκλοπος ἔπλετο τόξων·	- - --- u u-uu -uu --	dactylic hexameter	masculine penthemimeral
ἤ ῥά νύ που τοιαῦτα καὶ αὐτῷ οἴκοθι κεῖται	- u u - --u u -- -uu --	dactylic hexameter	feminine penthemimeral, trithemimeral
ἢ ὅ γ’ἐφορμᾶται ποιησέμεν, ὡς ἐνὶ χερσὶ	- u u--- --uu - uu --	dactylic hexameter	masculine penthemimeral
νωμᾷ ἔνθα καὶ ἔνθα κακῶν ἔμπαιος ἀλήτης.	-- -u u -u u- --u u--	dactylic hexameter	feminine penthemimeral, hepthemimeral
ἄλλος δ’αὖτ’ εἴπεσκε νέων ὑπερηνορεόντων·	-- - --u u- uu-uu--	dactylic hexameter	feminine penthemimeral, hepthemimeral, trithemimeral
αἲ γὰρ δὴ τοσσοῦτον ὀνήσιος ἀντιάσειεν	- - - --u u-uu -uu--	dactylic hexameter	feminine penthemimeral, trithemimeral
ὡς οὗτός ποτε τοῦτο δυνήσεται ἐντανύσασθαι.	- -- uu -u u-uu -uu--	dactylic hexameter	feminine penthemimeral, trithemimeral
ὣς ἄρ’ ἔφαν μνηστῆρες· ἀτὰρ πολύμητις Ὀδυσσεύς,	- u u- --u u- uu-u u--	dactylic hexameter	feminine penthemimeral, hepthemimeral, trithemimeral
αὐτίκ’ ἐπεὶ μέγα τόξον ἐβάστασε καὶ ἴδε πάντῃ,	-u u- uu -u u-uu - uu --	dactylic hexameter	feminine penthemimeral, trithemimeral
ὡς ὅτ’ ἀνὴρ φόρμιγγος ἐπιστάμενος καὶ ἀοιδῆς	- u u- --u u-uu- u u--	dactylic hexameter	feminine penthemimeral, trithemimeral
ῥηϊδίως ἐτάνυσσε νέῳ περὶ κόλλοπι χορδήν,	-uu- uu-u u- uu -uu --	dactylic hexameter	feminine penthemimeral, hepthemimeral, trithemimeral
ἅψας ἀμφοτέρωθεν ἐϋστρεφὲς ἔντερον οἰός,	-- -uu-u u-uu -uu --	dactylic hexameter	feminine penthemimeral
ὣς ἄρ’ ἄτερ σπουδῆς τάνυσεν μέγα τόξον Ὀδυσσεύς.	- u u- -- uu- uu -u u--	dactylic hexameter	masculine penthemimeral, hepthemimeral, trithemimeral
δεξιτερῇ δ’ἄρα χειρὶ λαβὼν πειρήσατο νευρῆς·	-uu- uu -u u- --uu --	dactylic hexameter	feminine penthemimeral, hepthemimeral, trithemimeral
ἡ δ’ὑπὸ καλὸν ἄεισε, χελιδόνι εἰκέλη αὐδήν.	- uu -u u-u u-uu -uu --	dactylic hexameter	feminine penthemimeral
μνηστῆρσιν δ’ἄρ’ ἄχος γένετο μέγα, πᾶσι δ’ἄρα χρὼς	--- u u- uu- uu -u u- -	dactylic hexameter	masculine penthemimeral, hepthemimeral, trithemimeral
ἐτράπετο· Ζεὺς δὲ μεγάλ’ ἔκτυπε σήματα φαίνων·	-uu- - - uu -uu -uu --	dactylic hexameter	masculine penthemimeral, trithemimeral
γήθησέν τ’ἄρ’ ἔπειτα πολύτλας δῖος Ὀδυσσεύς.	--- u u-u u-- -u u--	dactylic hexameter	feminine penthemimeral, trithemimeral
ὅττι ῥά οἱ τέρας ἧκε Κρόνου πάϊς ἀγκυλομήτεω·	-u u - uu -u u- uu -uu--	dactylic hexameter	feminine penthemimeral, hepthemimeral, trithemimeral
εἵλετο δ’ὠκὺν ὀϊστόν, ὅς οἱ παρέκειτο τραπέζῃ	-uu -u u-u u - uu-u u--	dactylic hexameter	feminine penthemimeral, hepthemimeral
γυμνός· τοὶ δ’ἄλλοι κοίλης ἔντοσθε φαρέτρης	-- - -- -- --u u--	dactylic hexameter	masculine penthemimeral, hepthemimeral, trithemimeral
κείατο, τῶν τάχ’ ἔμελλον Ἀχαιοὶ πειρήσεσθαι.	-uu - u u-u u-- ----	dactylic hexameter	feminine penthemimeral, trithemimeral
τόν ῥ’ἐπὶ πήχει ἑλὼν εἷλκεν νευρὴν γλυφίδας τε,	- uu -u u- -- -- uu- -	dactylic hexameter	masculine penthemimeral, hepthemimeral
αὐτόθεν ἐκ δίφροιο καθήμενος, ἧκε δ’ὀϊστὸν	-uu - --u u-uu -u u--	dactylic hexameter	feminine penthemimeral, trithemimeral
ἄντα τιτυσκόμενος, πελέκεων δ’οὐκ ἤμβροτε πάντων	-u u-uu- uu- - -uu --	dactylic hexameter	masculine penthemimeral, hepthemimeral
πρώτης στειλειῆς, διὰ δ’ἀμπερὲς ἦλθε θύραζε	-- --- uu -uu -u u--	dactylic hexameter	masculine penthemimeral
ἰὸς χαλκοβαρής· ὁ δὲ Τηλέμαχον προσέειπε·	-- -uu- u u -uu- uu--	dactylic hexameter	masculine penthemimeral
Τηλέμαχ’, οὔ σ’ὁ ξεῖνος ἐνὶ μεγάροισιν ἐλέγχει	-uu - - -u u- uu-u u--	dactylic hexameter	feminine penthemimeral, hepthemimeral, trithemimeral
ἥμενος, οὐδέ τι τοῦ σκοποῦ ἤμβροτον οὐδέ τι τόξον	-uu -u u - uu -uu -u u --	dactylic hexameter	masculine penthemimeral
δὴν ἔκαμον τανύων· ἔτι μοι μένος ἔμπεδόν ἐστιν,	- uu- uu- uu - uu -uu --	dactylic hexameter	masculine penthemimeral, hepthemimeral, trithemimeral
οὐχ ὥς με μνηστῆρες ἀτιμάζοντες ὄνονται.	- - - --u u---u u--	dactylic hexameter	feminine penthemimeral, trithemimeral
νῦν δ’ὥρη καὶ δόρπον Ἀχαιοῖσιν τετυκέσθαι	- -- - -u u--- uu--	dactylic hexameter	feminine penthemimeral, trithemimeral
ἐν φάει, αὐτὰρ ἔπειτα καὶ ἄλλως ἑψιάασθαι	- uu -u u-u u -- -uu--	dactylic hexameter	feminine penthemimeral
μολπῇ καὶ φόρμιγγι· τὰ γάρ τ’ἀναθήματα δαιτός.	-- - --u u - uu-uu --	dactylic hexameter	feminine penthemimeral, hepthemimeral, trithemimeral
ἦ καὶ ἐπ’ ὀφρύσι νεῦσεν· ὁ δ’ἀμφέθετο ξίφος ὀξὺ	- u u -uu -u u -uu- uu --	dactylic hexameter	feminine penthemimeral
Τηλέμαχος, φίλος υἱὸς Ὀδυσσῆος θείοιο,	-uu- uu -u u--- ---	dactylic hexameter	feminine penthemimeral, trithemimeral
ἀμφὶ δὲ χεῖρα φίλην βάλεν ἔγχεϊ, ἄγχι δ’ἄρ’ αὐτοῦ	-u u -u u- uu -uu -u u --	dactylic hexameter	masculine penthemimeral
πὰρ θρόνον εἱστήκει κεκορυθμένος αἴθοπι χαλκῷ.	- uu --- uu-uu -uu --	dactylic hexameter	masculine penthemimeral
