αὐτὰρ ὁ γυμνώθη ῥακέων πολύμητις Ὀδυσσεύς,	-u u --- uu- uu-u u--	dactylic hexameter	masculine penthemimeral, hepthemimeral
ἆλτο δ’ἐπὶ μέγαν οὐδόν, ἔχων βιὸν ἠδὲ φαρέτρην	-u u- uu -u u- uu -u u--	dactylic hexameter	feminine penthemimeral, hepthemimeral, trithemimeral
ἰῶν ἐμπλείην, ταχέας δ’ἐκχεύατ’ ὀϊστοὺς	-- --- uu- --u u--	dactylic hexameter	masculine penthemimeral, hepthemimeral
αὐτοῦ πρόσθε ποδῶν, μετὰ δὲ μνηστῆρσιν ἔειπεν·	-- -u u- uu - --u u--	dactylic hexameter	masculine penthemimeral, hepthemimeral
οὗτος μὲν δὴ ἄεθλος ἀάατος ἐκτετέλεσται·	-- - u u-u u-uu -uu--	dactylic hexameter	feminine penthemimeral, trithemimeral
νῦν αὖτε σκοπὸν ἄλλον, ὃν οὔ πώ τις βάλεν ἀνήρ,	- -- uu -u u - - - uu --	dactylic hexameter	feminine penthemimeral, hepthemimeral, trithemimeral
εἴσομαι, αἴ κε τύχωμι, πόρῃ δέ μοι εὖχος Ἀπόλλων.	-uu - u u-u u- u u -u u--	dactylic hexameter	feminine penthemimeral, hepthemimeral, trithemimeral
ἦ καὶ ἐπ’ Ἀντινόῳ ἰθύνετο πικρὸν ὀϊστόν.	- u u -uu- --uu -u u--	dactylic hexameter	masculine penthemimeral
ἤτοι ὁ καλὸν ἄλεισον ἀναιρήσεσθαι ἔμελλε,	-u u -u u-u u---u u--	dactylic hexameter	feminine penthemimeral
χρύσεον ἄμφωτον, καὶ δὴ μετὰ χερσὶν ἐνώμα,	-uu --- - - uu -u u--	dactylic hexameter	masculine penthemimeral, hepthemimeral
ὄφρα πίοι οἴνοιο· φόνος δέ οἱ οὐκ ἐνὶ θυμῷ	-u u- --u u- u u - uu --	dactylic hexameter	feminine penthemimeral, hepthemimeral, trithemimeral
μέμβλετο· τίς κ’οἴοιτο μετ’ ἀνδράσι δαιτυμόνεσσι	-uu - --u u -uu -uu--	dactylic hexameter	feminine penthemimeral, trithemimeral
μοῦνον ἐνὶ πλεόνεσσι, καὶ εἰ μάλα καρτερὸς εἴη,	-u u- uu-u u - uu -uu --	dactylic hexameter	feminine penthemimeral, hepthemimeral, trithemimeral
οἷ τεύξειν θάνατόν τε κακὸν καὶ κῆρα μέλαιναν;	- -- uu- u u- - -u u--	dactylic hexameter	masculine penthemimeral, hepthemimeral, trithemimeral
τὸν δ’Ὀδυσεὺς κατὰ λαιμὸν ἐπισχόμενος βάλεν ἰῷ,	- uu- uu -u u-uu- uu --	dactylic hexameter	feminine penthemimeral, trithemimeral
ἀντικρὺ δ᾽ἁπαλοῖο δι᾽ αὐχένος ἤλυθ᾽ ἀκωκή	--- uu-u u -uu -u u--	dactylic hexameter	feminine penthemimeral, trithemimeral
ἐκλίνθη δ’ἑτέρωσε, δέπας δέ οἱ ἔκπεσε χειρὸς	--- uu-u u- u u -uu --	dactylic hexameter	feminine penthemimeral, hepthemimeral, trithemimeral
βλημένου, αὐτίκα δ’αὐλὸς ἀνὰ ῥῖνας παχὺς ἦλθεν	-uu -uu -u u- -- uu --	dactylic hexameter	feminine penthemimeral, hepthemimeral
αἵματος ἀνδρομέοιο· θοῶς δ’ἀπὸ εἷο τράπεζαν	-uu -uu-u u- uu -u u--	dactylic hexameter	feminine penthemimeral, hepthemimeral
ὧσε ποδὶ πλήξας, ἀπὸ δ’εἴδατα χεῦεν ἔραζε·	-u u- -- uu -uu -u u--	dactylic hexameter	masculine penthemimeral, trithemimeral
σῖτός τε κρέα τ’ὀπτὰ φορύνετο. τοὶ δ’ὁμάδησαν	-- - uu -u u-uu - uu--	dactylic hexameter	feminine penthemimeral, trithemimeral
μνηστῆρες κατὰ δώμαθ’, ὅπως ἴδον ἄνδρα πεσόντα,	--- uu -u u- uu -u u--	dactylic hexameter	feminine penthemimeral, hepthemimeral, trithemimeral
ἐκ δὲ θρόνων ἀνόρουσαν ὀρινθέντες κατὰ δῶμα,	- u u- uu-u u--- uu --	dactylic hexameter	feminine penthemimeral, trithemimeral
πάντοσε παπταίνοντες ἐϋδμήτους ποτὶ τοίχους·	-uu ---u u--- uu --	dactylic hexameter	feminine penthemimeral
οὐδέ που ἀσπὶς ἔην οὐδ’ ἄλκιμον ἔγχος ἑλέσθαι.	-u u -u u- - -uu -u u--	dactylic hexameter	masculine penthemimeral
νείκειον δ’Ὀδυσῆα χολωτοῖσιν ἐπέεσσι·	--- uu-u u--- uu--	dactylic hexameter	feminine penthemimeral, trithemimeral
ξεῖνε, κακῶς ἀνδρῶν τοξάζεαι· οὐκέτ’ ἀέθλων	-u u- -- --uu -u u--	dactylic hexameter	masculine penthemimeral, trithemimeral
ἄλλων ἀντιάσεις· νῦν τοι σῶς αἰπὺς ὄλεθρος.	-- -uu- - - - -u u--	dactylic hexameter	masculine penthemimeral, hepthemimeral
καὶ γὰρ δὴ νῦν φῶτα κατέκτανες ὃς μέγ’ ἄριστος	- - - - -u u-uu - u u--	dactylic hexameter	feminine penthemimeral, trithemimeral
κούρων εἰν Ἰθάκῃ· τῶ σ’ἐνθάδε γῦπες ἔδονται.	-- - uu- - -uu -u u--	dactylic hexameter	masculine penthemimeral, trithemimeral
ἴσκεν ἕκαστος ἀνήρ, ἐπεὶ ἦ φάσαν οὐκ ἐθέλοντα	-u u-u u- uu - uu - uu--	dactylic hexameter	masculine penthemimeral, hepthemimeral
ἄνδρα κατακτεῖναι· τὸ δὲ νήπιοι οὐκ ἐνόησαν,	-u u--- u u -uu - uu--	dactylic hexameter	masculine penthemimeral
ὡς δή σφιν καὶ πᾶσιν ὀλέθρου πείρατ’ ἐφῆπτο.	- - - - -u u-- -u u--	dactylic hexameter	feminine penthemimeral, trithemimeral
τοὺς δ’ἄρ’ ὑπόδρα ἰδὼν προσέφη πολύμητις Ὀδυσσεύς·	- u u-u u- uu- uu-u u--	dactylic hexameter	masculine penthemimeral, hepthemimeral
ὧ κύνες, οὔ μ’ἔτ’ ἐφάσκεθ’ ὑπότροπον οἴκαδ’ ἱκέσθαι	- uu - u u-u u-uu -u u--	dactylic hexameter	feminine penthemimeral, trithemimeral
δήμου ἄπο Τρώων, ὅτι μοι κατεκείρετε οἶκον,	-u u- -- uu - uu-uu --	dactylic hexameter	masculine penthemimeral, hepthemimeral, trithemimeral
δμῳῇσίν τε γυναιξὶ παρευνάζεσθε βιαίως,	--- u u-u u---u u--	dactylic hexameter	feminine penthemimeral, trithemimeral
αὐτοῦ τε ζώοντος ὑπεμνάασθε γυναῖκα,	-- - --u u---u u--	dactylic hexameter	feminine penthemimeral, trithemimeral
οὔτε θεοὺς δείσαντες, οἳ οὐρανὸν εὐρὺν ἔχουσιν,	-u u- --u u -uu -u u--	dactylic hexameter	feminine penthemimeral, trithemimeral
οὔτε τιν’ ἀνθρώπων νέμεσιν κατόπισθεν ἔσεσθαι·	-u u --- uu- uu-u u--	dactylic hexameter	masculine penthemimeral, hepthemimeral
νῦν ὑμῖν καὶ πᾶσιν ὀλέθρου πείρατ’ ἐφῆπται.	- -- - -u u-- -u u--	dactylic hexameter	feminine penthemimeral, trithemimeral
ὣς φάτο, τοὺς δ’ἄρα πάντας ὑπὸ χλωρὸν δέος εἷλε·	- uu - uu -u u- -- uu --	dactylic hexameter	feminine penthemimeral, hepthemimeral, trithemimeral
πάπτηνεν δὲ ἕκαστος ὅπῃ φύγοι αἰπὺν ὄλεθρον.	--- u u-u u- uu -u u--	dactylic hexameter	feminine penthemimeral, hepthemimeral, trithemimeral
Εὐρύμαχος δέ μιν οἶος ἀμειβόμενος προσέειπεν·	-uu- u u -u u-uu- uu--	dactylic hexameter	feminine penthemimeral, trithemimeral
εἰ μὲν δὴ Ὀδυσεὺς Ἰθακήσιος εἰλήλουθας,	- - - uu- uu-uu ----	dactylic hexameter	masculine penthemimeral, trithemimeral
ταῦτα μὲν αἴσιμα εἶπες, ὅσα ῥέζεσκον Ἀχαιοί,	-u u -uu -u u- --u u--	dactylic hexameter	feminine penthemimeral, hepthemimeral
πολλὰ μὲν ἐν μεγάροισιν ἀτάσθαλα, πολλὰ δ’ἐπ’ ἀγροῦ.	-u u - uu-u u-uu -u u --	dactylic hexameter	feminine penthemimeral, trithemimeral
ἀλλ’ ὁ μὲν ἤδη κεῖται ὃς αἴτιος ἔπλετο πάντων,	- u u -- -u u -uu -uu --	dactylic hexameter	feminine penthemimeral
Ἀντίνοος· οὗτος γὰρ ἐπίηλεν τάδε ἔργα,	-uu- -- u u--- uu --	dactylic hexameter	masculine penthemimeral, trithemimeral
οὔ τι γάμου τόσσον κεχρημένος οὐδὲ χατίζων,	- u u- -- --uu -u u--	dactylic hexameter	masculine penthemimeral, trithemimeral
ἀλλ’ ἄλλα φρονέων, τά οἱ οὐκ ἐτέλεσσε Κρονίων,	- -- uu- u u - uu-u u--	dactylic hexameter	masculine penthemimeral, hepthemimeral, trithemimeral
ὄφρ’ Ἰθάκης κατὰ δῆμον ἐϋκτιμένης βασιλεύοι	- uu- uu -u u-uu- uu--	dactylic hexameter	feminine penthemimeral, trithemimeral
αὐτός, ἀτὰρ σὸν παῖδα κατακτείνειε λοχήσας.	-u u- - -u u---u u--	dactylic hexameter	feminine penthemimeral, trithemimeral
νῦν δ’ὁ μὲν ἐν μοίρῃ πέφαται, σὺ δὲ φείδεο λαῶν	- u u - -- uu- u u -uu --	dactylic hexameter	masculine penthemimeral, hepthemimeral, trithemimeral
σῶν· ἀτὰρ ἄμμες ὄπισθεν ἀρεσσάμενοι κατὰ δῆμον,	- uu -u u-u u-uu- uu --	dactylic hexameter	feminine penthemimeral
ὅσσα τοι ἐκπέποται καὶ ἐδήδοται ἐν μεγάροισι,	-u u -uu- u u-uu - uu--	dactylic hexameter	masculine penthemimeral
τιμὴν ἀμφὶς ἄγοντες ἐεικοσάβοιον ἕκαστος,	-- -u u-u u-uu-u u--	dactylic hexameter	feminine penthemimeral
χαλκόν τε χρυσόν τ’ἀποδώσομεν, εἰς ὅ κε σὸν κῆρ	-- - -- uu-uu - u u - -	dactylic hexameter	masculine penthemimeral, trithemimeral
ἰανθῇ· πρὶν δ’οὔ τι νεμεσσητὸν κεχολῶσθαι.	--- - - u u--- uu--	dactylic hexameter	masculine penthemimeral, trithemimeral
τὸν δ’ἄρ’ ὑπόδρα ἰδὼν προσέφη πολύμητις Ὀδυσσεύς·	- u u-u u- uu- uu-u u--	dactylic hexameter	masculine penthemimeral, hepthemimeral
Εὐρύμαχ’, οὐδ’ εἴ μοι πατρώϊα πάντ’ ἀποδοῖτε,	-uu - - - --uu - uu--	dactylic hexameter	masculine penthemimeral, trithemimeral
ὅσσα τε νῦν ὔμμ’ ἐστὶ καὶ εἴ ποθεν ἄλλ’ ἐπιθεῖτε,	-u u - - -u u - uu - uu--	dactylic hexameter	feminine penthemimeral, hepthemimeral, trithemimeral
οὐδέ κεν ὣς ἔτι χεῖρας ἐμὰς λήξαιμι φόνοιο	-u u - uu -u u- --u u--	dactylic hexameter	feminine penthemimeral, hepthemimeral, trithemimeral
πρὶν πᾶσαν μνηστῆρας ὑπερβασίην ἀποτῖσαι.	- -- --u u-uu- uu--	dactylic hexameter	feminine penthemimeral, trithemimeral
νῦν ὑμῖν παράκειται ἐναντίον ἠὲ μάχεσθαι	- -- uu-u u-uu -u u--	dactylic hexameter	feminine penthemimeral, trithemimeral
ἢ φεύγειν, ὅς κεν θάνατον καὶ κῆρας ἀλύξῃ·	- -- - - uu- - -u u--	dactylic hexameter	masculine penthemimeral, hepthemimeral, trithemimeral
ἀλλά τιν’ οὐ φεύξεσθαι ὀΐομαι αἰπὺν ὄλεθρον.	-u u - --u u-uu -u u--	dactylic hexameter	feminine penthemimeral, trithemimeral
ὣς φάτο, τῶν δ’αὐτοῦ λύτο γούνατα καὶ φίλον ἦτορ.	- uu - -- uu -uu - uu --	dactylic hexameter	masculine penthemimeral, trithemimeral
τοῖσιν δ’Εὐρύμαχος μετεφώνεε δεύτερον αὖτις·	-- -uu- uu-uu -uu --	dactylic hexameter	masculine penthemimeral
ὧ φίλοι, οὐ γὰρ σχήσει ἀνὴρ ὅδε χεῖρας ἀάπτους,	- uu - - -u u- uu -u u--	dactylic hexameter	feminine penthemimeral, hepthemimeral, trithemimeral
ἀλλ’ ἐπεὶ ἔλλαβε τόξον ἐΰξοον ἠδὲ φαρέτρην,	- uu -uu -u u-uu -u u--	dactylic hexameter	feminine penthemimeral
οὐδοῦ ἄπο ξεστοῦ τοξάσσεται, εἰς ὅ κε πάντας	-u u- -- --uu - u u --	dactylic hexameter	masculine penthemimeral, trithemimeral
ἄμμε κατακτείνῃ· ἀλλὰ μνησώμεθα χάρμης.	-u u--- -- --uu --	dactylic hexameter	masculine penthemimeral, hepthemimeral
φάσγανά τε σπάσσασθε καὶ ἀντίσχεσθε τραπέζας	-uu - --u u ---u u--	dactylic hexameter	feminine penthemimeral, trithemimeral
ἰῶν ὠκυμόρων· ἐπὶ δ’αὐτῷ πάντες ἔχωμεν	-- -uu- uu -- -u u--	dactylic hexameter	masculine penthemimeral
ἀθρόοι, εἴ κέ μιν οὐδοῦ ἀπώσομεν ἠδὲ θυράων,	-uu - u u -u u-uu -u u--	dactylic hexameter	feminine penthemimeral, trithemimeral
ἔλθωμεν δ’ἀνὰ ἄστυ, βοὴ δ’ὤκιστα γένηται·	--- uu -u u- --u u--	dactylic hexameter	feminine penthemimeral, hepthemimeral, trithemimeral
τῶ κε τάχ’ οὗτος ἀνὴρ νῦν ὕστατα τοξάσσαιτο.	- u u -u u- - -uu ----	dactylic hexameter	masculine penthemimeral
ὣς ἄρα φωνήσας εἰρύσσατο φάσγανον ὀξὺ	- uu --- --uu -uu --	dactylic hexameter	masculine penthemimeral
χάλκεον, ἀμφοτέρωθεν ἀκαχμένον, ἆλτο δ’ἐπ’ αὐτῷ	-uu -uu-u u-uu -u u --	dactylic hexameter	feminine penthemimeral
σμερδαλέα ἰάχων· ὁ δ’ἁμαρτῇ δῖος Ὀδυσσεὺς	-uu- uu- u u-- -u u--	dactylic hexameter	masculine penthemimeral, trithemimeral
ἰὸν ἀποπροίει, βάλε δὲ στῆθος παρὰ μαζόν,	-u u--- uu - -- uu --	dactylic hexameter	masculine penthemimeral, hepthemimeral
ἐν δέ οἱ ἥπατι πῆξε θοὸν βέλος· ἐκ δ’ἄρα χειρὸς	- u u -uu -u u- uu - uu --	dactylic hexameter	feminine penthemimeral, hepthemimeral
φάσγανον ἧκε χαμᾶζε, περιρρηδὴς δὲ τραπέζῃ	-uu -u u-u u--- u u--	dactylic hexameter	feminine penthemimeral
κάππεσεν ἰδνωθείς, ἀπὸ δ’εἴδατα χεῦεν ἔραζε	-uu --- uu -uu -u u--	dactylic hexameter	masculine penthemimeral
καὶ δέπας ἀμφικύπελλον· ὁ δὲ χθόνα τύπτε μετώπῳ	- uu -uu-u u - uu -u u--	dactylic hexameter	feminine penthemimeral, hepthemimeral
θυμῷ ἀνιάζων, ποσὶ δὲ θρόνον ἀμφοτέροισι	-u u--- uu - uu -uu--	dactylic hexameter	masculine penthemimeral, hepthemimeral
λακτίζων ἐτίνασσε· κατ’ ὀφθαλμῶν δ’ἔχυτ’ ἀχλύς.	--- uu-u u --- uu --	dactylic hexameter	feminine penthemimeral, trithemimeral
Ἀμφίνομος δ’Ὀδυσῆος ἐείσατο κυδαλίμοιο	-uu- uu-u u-uu -uu--	dactylic hexameter	feminine penthemimeral, trithemimeral
ἀντίος ἀΐξας, εἴρυτο δὲ φάσγανον ὀξύ,	-uu --- --u u -uu --	dactylic hexameter	masculine penthemimeral
εἴ πώς οἱ εἴξειε θυράων. ἀλλ’ ἄρα μιν φθῆ	- - - --u u-- - uu - -	dactylic hexameter	feminine penthemimeral, trithemimeral
Τηλέμαχος κατόπισθε βαλὼν χαλκήρεϊ δουρὶ	-uu- uu-u u- --uu --	dactylic hexameter	feminine penthemimeral, hepthemimeral, trithemimeral
ὤμων μεσσηγύς, διὰ δὲ στήθεσφιν ἔλασσε·	-- --- uu - --u u--	dactylic hexameter	masculine penthemimeral, hepthemimeral
δούπησεν δὲ πεσών, χθόνα δ’ἤλασε παντὶ μετώπῳ.	--- u u- uu -uu -u u--	dactylic hexameter	masculine penthemimeral, trithemimeral
Τηλέμαχος δ’ἀπόρουσε, λιπὼν δολιχόσκιον ἔγχος	-uu- uu-u u- uu-uu --	dactylic hexameter	feminine penthemimeral, hepthemimeral, trithemimeral
αὐτοῦ ἐν Ἀμφινόμῳ· περὶ γὰρ δίε μή τις Ἀχαιῶν	-u u -uu- uu - uu - u u--	dactylic hexameter	masculine penthemimeral, hepthemimeral
ἔγχος ἀνελκόμενον δολιχόσκιον ἢ ἐλάσειε	-u u-uu- uu-uu - uu--	dactylic hexameter	masculine penthemimeral
φασγγάνῳ ἀΐξας ἠὲ προπρηνέα τύψας.	-uu --- -- --uu --	dactylic hexameter	masculine penthemimeral, hepthemimeral
βῆ δὲ θέειν, μάλα δ’ὧκα φίλον πατέρ’ εἰσαφίκανεν,	- u u- uu -u u- uu -uu--	dactylic hexameter	feminine penthemimeral, hepthemimeral, trithemimeral
ἀγχοῦ δ’ἱστάμενος ἔπεα πτερόεντα προσηύδα·	-- -uu- uu- uu-u u--	dactylic hexameter	masculine penthemimeral, hepthemimeral
ὧ πάτερ, ἤδη τοι σάκος οἴσω καὶ δύο δοῦρε	- uu -- - uu -- - uu --	dactylic hexameter	masculine penthemimeral
καὶ κυνέην πάγχαλκον, ἐπὶ κροτάφοις ἀραρυῖαν	- uu- --u u- uu- uu--	dactylic hexameter	feminine penthemimeral, hepthemimeral, trithemimeral
αὐτός τ’ἀμφιβαλεῦμαι ἰών, δώσω δὲ συβώτῃ	-- -uu-u u- -- u u--	dactylic hexameter	feminine penthemimeral, hepthemimeral
καὶ τῷ βουκόλῳ ἄλλα· τετευχῆσθαι γὰρ ἄμεινον.	- - -uu -u u--- u u--	dactylic hexameter	feminine penthemimeral
τὸν δ’ἀπαμειβόμενος προσέφη πολύμητις Ὀδυσσεύς·	- uu-uu- uu- uu-u u--	dactylic hexameter	masculine penthemimeral, hepthemimeral
οἶσε θέων, εἵως μοι ἀμύνεσθαι πάρ’ ὀϊστοί,	-u u- -- u u--- u u--	dactylic hexameter	masculine penthemimeral, trithemimeral
μή μ’ἀποκινήσωσι θυράων μοῦνον ἐόντα.	- uu---u u-- -u u--	dactylic hexameter	feminine penthemimeral
ὣς φάτο, Τηλέμαχος δὲ φίλῳ ἐπεπείθετο πατρί,	- uu -uu- u u- uu-uu --	dactylic hexameter	masculine penthemimeral, hepthemimeral
βῆ δ’ἴμεναι θάλαμόνδ’, ὅθι οἱ κλυτὰ τεύχεα κεῖτο.	- uu- uu- uu - uu -uu --	dactylic hexameter	masculine penthemimeral, hepthemimeral, trithemimeral
ἔνθεν τέσσαρα μὲν σάκε’ εἵλετο, δούρατα δ’ὀκτὼ	-- -uu - uu -uu -uu --	dactylic hexameter	masculine penthemimeral
καὶ πίσυρας κυνέας χαλκήρεας ἱπποδασείας·	- uu- uu- --uu -uu--	dactylic hexameter	masculine penthemimeral, trithemimeral
βῆ δὲ φέρων, μάλα δ’ὧκα φίλον πατέρ’ εἰσαφίκανεν,	- u u- uu -u u- uu -uu--	dactylic hexameter	feminine penthemimeral, hepthemimeral, trithemimeral
αὐτὸς δὲ πρώτιστα περὶ χροῒ δύσετο χαλκόν·	-- - --u u- uu -uu --	dactylic hexameter	feminine penthemimeral, hepthemimeral, trithemimeral
ὣς δ’αὔτως τὼ δμῶε δυέσθην τεύχεα καλά,	- -- - -u u-- -uu --	dactylic hexameter	feminine penthemimeral, trithemimeral
ἔσταν δ’ἀμφ’ Ὀδυσῆα δαΐφρονα ποικιλομήτην.	-- - uu-u u-uu -uu--	dactylic hexameter	feminine penthemimeral, trithemimeral
αὐτὰρ ὅ γ’,ὄφρα μὲν αὐτῷ ἀμύνεσθαι ἔσαν ἰοί.	-u u -u u -u u--- uu --	dactylic hexameter	feminine penthemimeral
τόφρα μνηστήρων ἕνα γ’αἰεὶ ᾧ ἐνὶ οἴκῳ	-- --- uu -- - uu --	dactylic hexameter	masculine penthemimeral
βάλλε τιτυσκόμενος· τοὶ δ’ἀγχιστῖνοι ἔπιπτον.	-u u-uu- - ---u u--	dactylic hexameter	masculine penthemimeral
αὐτὰρ ἐπεὶ λίπον ἰοὶ ὀϊστεύοντα ἄνακτα,	-u u- uu -u u---u u--	dactylic hexameter	feminine penthemimeral, trithemimeral
τόξον μὲν πρὸς σταθμὸν ἐϋσταθέος μεγάροιο	-- - - -u u-uu- uu--	dactylic hexameter	feminine penthemimeral, trithemimeral
ἔκλιν’ ἑστάμεναι, πρὸς ἐνώπια παμφανόωντα,	-- -uu- u u-uu -uu--	dactylic hexameter	masculine penthemimeral
αὐτὸς δ’ἀμφ’ ὤμοισι σάκος θέτο τετραθέλυμνον,	-- - --u u- uu -uu--	dactylic hexameter	feminine penthemimeral, hepthemimeral, trithemimeral
κρατὶ δ’ἐπ’ ἰφθίμῳ κυνέην εὔτυκτον ἔθηκεν,	-u u --- uu- --u u--	dactylic hexameter	masculine penthemimeral, hepthemimeral
ἵππουριν, δεινὸν δὲ λόφος καθύπερθεν ἔνευεν·	--- -- u u- uu-u u--	dactylic hexameter	masculine penthemimeral, hepthemimeral, trithemimeral
εἵλετο δ’ἄλκιμα δοῦρε δύω κεκορυθμένα χαλκῷ.	-uu -uu -u u- uu-uu --	dactylic hexameter	feminine penthemimeral, hepthemimeral
ὀρσοθύρη δέ τις ἔσκεν ἐϋδμήτῳ ἐνὶ τοίχῳ,	-uu- u u -u u--- uu --	dactylic hexameter	feminine penthemimeral, trithemimeral
ἀκρότατον δὲ παρ’ οὐδὸν ἐϋσταθέος μεγάροιο	-uu- u u -u u-uu- uu--	dactylic hexameter	feminine penthemimeral, trithemimeral
ἦν ὁδὸς ἐς λαύρην, σανίδες δ’ἔχον εὖ ἀραρυῖαι.	- uu - -- uu- uu - uu--	dactylic hexameter	masculine penthemimeral, hepthemimeral, trithemimeral
τὴν Ὀδυσεὺς φράζεσθαι ἀνώγει δῖον ὑφορβὸν	- uu- --u u-- -u u--	dactylic hexameter	feminine penthemimeral, trithemimeral
ἑσταότ’ ἄγχ’ αὐτῆς· μία δ’οἴη γίνετ’ ἐφορμή.	-uu - -- uu -- -u u--	dactylic hexameter	masculine penthemimeral, trithemimeral
τοῖς δ’Ἀγέλεως μετέειπεν, ἔπος πάντεσσι πιφαύσκων·	- uu- uu-u u- --u u--	dactylic hexameter	feminine penthemimeral, hepthemimeral, trithemimeral
ὧ φίλοι, οὐκ ἂν δή τις ἀν’ ὀρσοθύρην ἀναβαίη	- uu - - - u u -uu- uu--	dactylic hexameter	masculine penthemimeral, trithemimeral
καὶ εἴποι λαοῖσι, βοὴ δ’ὤκιστα γένοιτο;	- -- --u u- --u u--	dactylic hexameter	feminine penthemimeral, hepthemimeral, trithemimeral
τῶ κε τάχ’ οὗτος ἀνὴρ νῦν ὕστατα τοξάσσαιτο.	- u u -u u- - -uu ----	dactylic hexameter	masculine penthemimeral
τὸν δ’αὖτε προσέειπε Μελάνθιος, αἰπόλος αἰγῶν·	- -- uu-u u-uu -uu --	dactylic hexameter	feminine penthemimeral, trithemimeral
οὔ πως ἔστ’, Ἀγέλαε διοτρεφές· ἄγχι γὰρ αἰνῶς	- - - uu-u u-uu -u u --	dactylic hexameter	feminine penthemimeral, trithemimeral
αὐλῆς καλὰ θύρετρα καὶ ἀργαλέον στόμα λαύρης·	-- -u u-u u -uu- uu --	dactylic hexameter	feminine penthemimeral
καί χ’εἷς πάντας ἐρύκοι ἀνήρ, ὅς τ’ἄλκιμος εἴη.	- - -u u-u u- - -uu --	dactylic hexameter	feminine penthemimeral, hepthemimeral
ἀλλ’ ἄγεθ’, ὑμῖν τεύχε’ ἐνείκω θωρηχθῆναι	- uu -- -u u-- ----	dactylic hexameter	feminine penthemimeral
ἐκ θαλάμου· ἔνδον γάρ, ὀΐομαι, οὐδέ πῃ ἄλλῃ	- uu- -- u u-uu -u u --	dactylic hexameter	masculine penthemimeral, trithemimeral
τεύχεα κατθέσθην Ὀδυσεὺς καὶ φαίδιμος υἱός.	-uu --- uu- - -uu --	dactylic hexameter	masculine penthemimeral, hepthemimeral
ὣς εἰπὼν ἀνέβαινε Μελάνθιος, αἰπόλος αἰγῶν,	- -- uu-u u-uu -uu --	dactylic hexameter	feminine penthemimeral, trithemimeral
ἐς θαλάμους Ὀδυσῆος ἀνὰ ῥῶγας μεγάροιο.	- uu- uu-u u- -- uu--	dactylic hexameter	feminine penthemimeral, hepthemimeral, trithemimeral
ἔνθεν δώδεκα μὲν σάκε’ ἔξελε, τόσσα δὲ δοῦρα	-- -uu - uu -uu -u u --	dactylic hexameter	masculine penthemimeral
καὶ τόσσας κυνέας χαλκήρεας ἱπποδασείας·	- -- uu- --uu -uu--	dactylic hexameter	masculine penthemimeral, trithemimeral
βῆ δ’ἴμεναι, μάλα δ’ὧκα φέρων μνηστῆρσιν ἔδωκε.	- uu- uu -u u- --u u--	dactylic hexameter	feminine penthemimeral, hepthemimeral, trithemimeral
καὶ τότ’ Ὀδυσσῆος λύτο γούνατα καὶ φίλον ἦτορ,	- u u--- uu -uu - uu --	dactylic hexameter	masculine penthemimeral
ὡς περιβαλλομένους ἴδε τεύχεα χερσί τε δοῦρα	- uu-uu- uu -uu -u u --	dactylic hexameter	masculine penthemimeral
μακρὰ τινάσσοντας· μέγα δ’αὐτῷ φαίνετο ἔργον.	-u u--- uu -- -uu --	dactylic hexameter	masculine penthemimeral
αἶψα δὲ Τηλέμαχον ἔπεα πτερόεντα προσηύδα·	-u u -uu- uu- uu-u u--	dactylic hexameter	masculine penthemimeral, hepthemimeral
Τηλέμαχ’, ἦ μάλα δή τις ἐνὶ μεγάροισι γυναικῶν	-uu - uu - u u- uu-u u--	dactylic hexameter	masculine penthemimeral, hepthemimeral, trithemimeral
νῶϊν ἐποτρύνει πόλεμον κακὸν ἠὲ Μελανθεύς.	-u u--- uu- uu -u u--	dactylic hexameter	masculine penthemimeral, hepthemimeral
τὸν δ’αὖ Τηλέμαχος πεπνυμένος ἀντίον ηὔδα·	- - -uu- --uu -uu --	dactylic hexameter	masculine penthemimeral
ὧ πάτερ, αὐτὸς ἐγὼ τόδε γ’ἤμβροτον οὐδέ τις ἄλλος	- uu -u u- uu -uu -u u --	dactylic hexameter	masculine penthemimeral
αἴτιος ὃς θαλάμοιο θύρην πυκινῶς ἀραρυῖαν	-uu - uu-u u- uu- uu--	dactylic hexameter	feminine penthemimeral, hepthemimeral, trithemimeral
κάλλιπον ἀγκλίνας· τῶν δὲ σκοπὸς ἦεν ἀμείνων.	-uu --- - - uu -u u--	dactylic hexameter	masculine penthemimeral, hepthemimeral
ἀλλ’ ἴθι, δῖ’ Εὔμαιε, θύρην ἐπίθες θαλάμοιο	- uu - --u u- uu- uu--	dactylic hexameter	feminine penthemimeral, hepthemimeral, trithemimeral
καὶ φράσαι εἴ τις ἄρ’ ἐστὶ γυναικῶν ἣ τάδε ῥέζει,	- uu - u u -u u-- - uu --	dactylic hexameter	feminine penthemimeral, trithemimeral
ἢ υἱὸς Δολίοιο, Μελανθεύς, τόν περ ὀΐω.	- -- uu-u u-- - u u--	dactylic hexameter	feminine penthemimeral, trithemimeral
ὣς οἱ μὲν τοιαῦτα πρὸς ἀλλήλους ἀγόρευον,	- - - --u u --- uu--	dactylic hexameter	feminine penthemimeral, trithemimeral
βῆ δ’αὖτις θάλαμόνδε Μελάνθιος, αἰπόλος αἰγῶν,	- -- uu-u u-uu -uu --	dactylic hexameter	feminine penthemimeral, trithemimeral
οἴσων τεύχεα καλά. νόησε δὲ δῖος ὑφορβός,	-- -uu -u u-u u -u u--	dactylic hexameter	feminine penthemimeral
αἶψα δ’Ὀδυσσῆα προσεφώνεεν ἐγγὺς ἐόντα·	-u u--- uu-uu -u u--	dactylic hexameter	masculine penthemimeral
διογενὲς Λαερτιάδη, πολυμήχαν’ Ὀδυσσεῦ,	-uu- --uu- uu-u u--	dactylic hexameter	hepthemimeral, trithemimeral
κεῖνος δ’αὖτ’ ἀΐδηλος ἀνήρ, ὃν ὀϊόμεθ’ αὐτοί,	-- - uu-u u- u u-uu --	dactylic hexameter	feminine penthemimeral, hepthemimeral, trithemimeral
ἔρχεται ἐς θάλαμον· σὺ δέ μοι νημερτὲς ἐνίσπες,	-uu - uu- u u - --u u--	dactylic hexameter	masculine penthemimeral, hepthemimeral, trithemimeral
ἤ μιν ἀποκτείνω, αἴ κε κρείσσων γε γένωμαι,	- u u--- - - -- u u--	dactylic hexameter	masculine penthemimeral, hepthemimeral
ἦε σοὶ ἐνθάδ’ ἄγω, ἵν’ ὑπερβασίας ἀποτίσῃ	-u u -u u- u u-uu- uu--	dactylic hexameter	masculine penthemimeral
πολλάς, ὅσσας οὗτος ἐμήσατο σῷ ἐνὶ οἴκῳ.	-- -- -u u-uu - uu --	dactylic hexameter	feminine penthemimeral
τὸν δ’ἀπαμειβόμενος προσέφη πολύμητις Ὀδυσσεύς·	- uu-uu- uu- uu-u u--	dactylic hexameter	masculine penthemimeral, hepthemimeral
ἤτοι ἐγὼ καὶ Τηλέμαχος μνηστῆρας ἀγαυοὺς	-u u- - -uu- --u u--	dactylic hexameter	hepthemimeral, trithemimeral
σχήσομεν ἔντοσθεν μεγάρων, μάλα περ μεμαῶτας.	-uu --- uu- uu - uu--	dactylic hexameter	masculine penthemimeral, hepthemimeral
σφῶϊ δ’ἀποστρέψαντε πόδας καὶ χεῖρας ὕπερθεν	-u u---u u- - -u u--	dactylic hexameter	feminine penthemimeral, hepthemimeral
ἐς θάλαμον βαλέειν, σανίδας δ’ἐκδῆσαι ὄπισθεν,	- uu- uu- uu- --u u--	dactylic hexameter	masculine penthemimeral, hepthemimeral, trithemimeral
σειρὴν δὲ πλεκτὴν ἐξ αὐτοῦ πειρήναντε	-- - -- - -- ----	dactylic hexameter	masculine penthemimeral, trithemimeral
κίον’ ἀν’ ὑψηλὴν ἐρύσαι πελάσαι τε δοκοῖσιν,	-u u --- uu- uu- u u--	dactylic hexameter	masculine penthemimeral, hepthemimeral
ὥς κεν δηθὰ ζωὸς ἐὼν χαλέπ’ ἄλγεα πάσχῃ·	- - -- -u u- uu -uu --	dactylic hexameter	feminine penthemimeral, hepthemimeral
ὣς ἔφαθ’, οἱ δ’ἄρα τοῦ μάλα μὲν κλύον ἠδ’ ἐπίθοντο,	- uu - uu - uu - uu - uu--	dactylic hexameter	masculine penthemimeral, hepthemimeral, trithemimeral
βὰν δ’ἴμεν ἐς θάλαμον, λαθέτην δέ μιν ἔνδον ἐόντα.	- uu - uu- uu- u u -u u--	dactylic hexameter	masculine penthemimeral, hepthemimeral, trithemimeral
ἤτοι ὁ μὲν θαλάμοιο μυχὸν κάτα τεύχε’ ἐρεύνα,	-u u - uu-u u- uu -u u--	dactylic hexameter	feminine penthemimeral, hepthemimeral, trithemimeral
τὼ δ’ἔσταν ἑκάτερθε παρὰ σταθμοῖσι μένοντε.	- -- uu-u u- --u u--	dactylic hexameter	feminine penthemimeral, hepthemimeral, trithemimeral
εὖθ’ ὑπὲρ οὐδὸν ἔβαινε Μελάνθιος, αἰπόλος αἰγῶν,	- uu -u u-u u-uu -uu --	dactylic hexameter	feminine penthemimeral
τῇ ἑτέρῃ μὲν χειρὶ φέρων καλὴν τρυφάλειαν,	- uu- - -u u- -- uu--	dactylic hexameter	feminine penthemimeral, hepthemimeral, trithemimeral
τῇ δ’ἑτέρῃ σάκος εὐρὺ γέρον, πεπαλαγμένον ἄζῃ,	- uu- uu -u u- uu-uu --	dactylic hexameter	feminine penthemimeral, hepthemimeral, trithemimeral
Λαέρτεω ἥρωος, ὃ κουρίζων φορέεσκε·	--- --u u --- uu--	dactylic hexameter	feminine penthemimeral, trithemimeral
δὴ τότε γ’ἤδη κεῖτο, ῥαφαὶ δ’ἐλέλυντο ἱμάντων·	- uu -- -u u- uu-u u--	dactylic hexameter	feminine penthemimeral, hepthemimeral
τὼ δ’ἄρ’ ἐπαΐξανθ’ ἑλέτην ἔρυσάν τέ μιν εἴσω	- u u--- uu- uu- u u --	dactylic hexameter	masculine penthemimeral, hepthemimeral
κουρίξ, ἐν δαπέδῳ δὲ χαμαὶ βάλον ἀχνύμενον κῆρ,	-- - uu- u u- uu -uu- -	dactylic hexameter	masculine penthemimeral, hepthemimeral, trithemimeral
σὺν δὲ πόδας χεῖράς τε δέον θυμαλγέϊ δεσμῷ	- u u- -- u u- --uu --	dactylic hexameter	masculine penthemimeral, hepthemimeral, trithemimeral
εὖ μάλ’ ἀποστρέψαντε διαμπερές, ὡς ἐκέλευσεν	- u u---u u-uu - uu--	dactylic hexameter	feminine penthemimeral
υἱὸς Λαέρταο, πολύτλας δῖος Ὀδυσσεύς·	-- ---u u-- -u u--	dactylic hexameter	feminine penthemimeral
σειρὴν δὲ πλεκτὴν ἐξ αὐτοῦ πειρήναντε	-- - -- - -- ----	dactylic hexameter	masculine penthemimeral, trithemimeral
κίον’ ἀν’ ὑψηλὴν ἔρυσαν πέλασάν τε δοκοῖσι.	-u u --- uu- uu- u u--	dactylic hexameter	masculine penthemimeral, hepthemimeral
τὸν δ’ἐπικερτομέων προσέφης, Εὔμαιε συβῶτα·	- uu-uu- uu- --u u--	dactylic hexameter	masculine penthemimeral, hepthemimeral
νῦν μὲν δὴ μάλα πάγχυ, Μελάνθιε, νύκτα φυλάξεις,	- - - uu -u u-uu -u u--	dactylic hexameter	feminine penthemimeral, trithemimeral
εὐνῇ ἔνι μαλακῇ καταλέγμενος, ὥς σε ἔοικεν·	-u u- uu- uu-uu - u u--	dactylic hexameter	masculine penthemimeral, trithemimeral
οὐδέ σέ γ’ἠριγένεια παρ’ Ὠκεανοῖο ῥοάων	-u u -uu-u u -uu-u u--	dactylic hexameter	feminine penthemimeral
λήσει ἐπερχομένη χρυσόθρονος, ἡνίκ’ ἀγινεῖς	-u u-uu- --uu -u u--	dactylic hexameter	masculine penthemimeral
αἶγας μνηστήρεσσι δόμον κάτα δαῖτα πένεσθαι.	-- ---u u- uu -u u--	dactylic hexameter	feminine penthemimeral, hepthemimeral
ὣς ὁ μὲν αὖθι λέλειπτο, ταθεὶς ὀλοῷ ἐνὶ δεσμῷ·	- u u -u u-u u- uu- uu --	dactylic hexameter	feminine penthemimeral, hepthemimeral
τὼ δ’ἐς τεύχεα δύντε, θύρην ἐπιθέντε φαεινήν,	- - -uu -u u- uu-u u--	dactylic hexameter	feminine penthemimeral, hepthemimeral
βήτην εἰς Ὀδυσῆα δαΐφρονα, ποικιλομήτην.	-- - uu-u u-uu -uu--	dactylic hexameter	feminine penthemimeral, trithemimeral
ἔνθα μένος πνείοντες ἐφέστασαν, οἱ μὲν ἐπ’ οὐδοῦ	-u u- --u u-uu - u u --	dactylic hexameter	feminine penthemimeral, trithemimeral
τέσσαρες, οἱ δ’ἔντοσθε δόμων πολέες τε καὶ ἐσθλοί.	-uu - --u u- uu- u u --	dactylic hexameter	feminine penthemimeral, hepthemimeral, trithemimeral
τοῖσι δ’ἐπ’ ἀγχίμολον θυγάτηρ Διὸς ἦλθεν Ἀθήνη,	-u u -uu- uu- uu -u u--	dactylic hexameter	masculine penthemimeral, hepthemimeral
Μέντορι εἰδομένη ἠμὲν δέμας ἠδὲ καὶ αὐδήν.	-uu -uu- -- uu -u u --	dactylic hexameter	masculine penthemimeral, hepthemimeral
τὴν δ’Ὀδυσεὺς γήθησεν ἰδὼν καὶ μῦθον ἔειπε·	- uu- --u u- - -u u--	dactylic hexameter	feminine penthemimeral, hepthemimeral, trithemimeral
Μέντορ, ἄμυνον ἀρήν, μνῆσαι δ’ἑτάροιο φίλοιο,	-u u-u u- -- uu-u u--	dactylic hexameter	masculine penthemimeral, hepthemimeral
ὅς σ’ἀγαθὰ ῥέζεσκον· ὁμηλικίη δέ μοί ἐσσι.	- uu- --u u-uu- u u --	dactylic hexameter	feminine penthemimeral, trithemimeral
ὣς φάτ’, ὀϊόμενος λαοσσόον ἔμμεν Ἀθήνην.	- u u-uu- --uu -u u--	dactylic hexameter	masculine penthemimeral
μνηστῆρες δ’ἑτέρωθεν ὁμόκλεον ἐν μεγάροισι·	--- uu-u u-uu - uu--	dactylic hexameter	feminine penthemimeral, trithemimeral
πρῶτος τήν γ’ἐνένιπε Δαμαστορίδης Ἀγέλαος·	-- - uu-u u-uu- uu--	dactylic hexameter	feminine penthemimeral, trithemimeral
Μέντορ, μή σ’ἐπέεσσι παραιπεπίθῃσιν Ὀδυσσεὺς	-- - uu-u u-uu-u u--	dactylic hexameter	feminine penthemimeral, trithemimeral
μνηστήρεσσι μάχεσθαι, ἀμυνέμεναι δέ οἱ αὐτῷ.	---u u-u u-uu- u u --	dactylic hexameter	feminine penthemimeral
ὦδε γὰρ ἡμέτερόν γε νόον τελέεσθαι ὀΐω·	-u u -uu- u u- uu-u u--	dactylic hexameter	masculine penthemimeral, hepthemimeral
ὁππότε κεν τούτους κτέωμεν, πατέρ’ ἠδὲ καὶ υἱόν,	-uu - -- -- uu -u u --	dactylic hexameter	masculine penthemimeral, hepthemimeral, trithemimeral
ἐν δὲ σὺ τοῖσιν ἔπειτα πεφήσεαι, οἷα μενοινᾷς	- u u -u u-u u-uu -u u--	dactylic hexameter	feminine penthemimeral
ἔρδειν ἐν μεγάροις· σῷ δ’αὐτοῦ κράατι τίσεις.	-- - uu- - -- -uu --	dactylic hexameter	masculine penthemimeral, trithemimeral
αὐτὰρ ἐπὴν ὑμέων γε βίας ἀφελώμεθα χαλκῷ,	-u u- uu- u u- uu-uu --	dactylic hexameter	masculine penthemimeral, hepthemimeral, trithemimeral
κτήμαθ’ ὁπόσσα τοί ἐστι, τά τ’ἔνδοθι καὶ τὰ θύρηφι,	-u u-u u -u u -uu - u u--	dactylic hexameter	feminine penthemimeral
τοῖσιν Ὀδυσσῆος μεταμίξομεν· οὐδέ τοι υἷας	-u u--- uu-uu -u u --	dactylic hexameter	masculine penthemimeral
ζώειν ἐν μεγάροισιν ἐάσομεν, οὐδέ θύγατρας	-- - uu-u u-uu -u u--	dactylic hexameter	feminine penthemimeral, trithemimeral
οὐδ’ ἄλοχον κεδνὴν Ἰθάκης κατὰ ἄστυ πολεύειν.	- uu- -- uu- uu -u u--	dactylic hexameter	masculine penthemimeral, hepthemimeral, trithemimeral
ὣς φάτ’, Ἀθηναίη δὲ χολώσατο κηρόθι μᾶλλον,	- u u--- u u-uu -uu --	dactylic hexameter	masculine penthemimeral
νείκεσσεν δ’Ὀδυσῆα χολωτοῖσιν ἐπέεσσιν·	--- uu-u u--- uu--	dactylic hexameter	feminine penthemimeral, trithemimeral
οὐκέτι σοί γ’,Ὀδυσεῦ, μένος ἔμπεδον οὐδέ τις ἀλκή	-uu - uu- uu -uu -u u --	dactylic hexameter	masculine penthemimeral, trithemimeral
οἵη ὅτ’ ἀμφ’ Ἑλένῃ λευκωλένῳ εὐπατερείῃ,	-u u - uu- --uu -uu--	dactylic hexameter	masculine penthemimeral, trithemimeral
εἰνάετες Τρώεσσιν ἐμάρναο νωλεμὲς αἰεί,	-uu- --u u-uu -uu --	dactylic hexameter	feminine penthemimeral, trithemimeral
πολλοὺς δ’ἄνδρας ἔπεφνες ἐν αἰνῇ δηϊοτῆτι,	-- -u u-u u -- -uu--	dactylic hexameter	feminine penthemimeral
σῇ δ’ἥλω βουλῇ Πριάμου πόλις εὐρυάγυια.	- -- -- uu- uu -uu--	dactylic hexameter	masculine penthemimeral, hepthemimeral, trithemimeral
πῶς δὴ νῦν, ὅτε σόν γε δόμον καὶ κτήμαθ’ ἱκάνεις,	- - - uu - u u- - -u u--	dactylic hexameter	masculine penthemimeral, hepthemimeral, trithemimeral
ἄντα μνηστήρων ὀλοφύρεαι ἄλκιμος εἶναι;	-- --- uu-uu -uu --	dactylic hexameter	masculine penthemimeral
ἀλλ’ ἄγε δεῦρο, πέπον, παρ’ ἔμ’ ἵστασο καὶ ἴδε ἔργον,	- uu -u u- u u -uu - uu --	dactylic hexameter	masculine penthemimeral
ὄφρ’ εἰδῇς οἷός τοι ἐν ἀνδράσι δυσμενέεσσι	- -- -- u u -uu -uu--	dactylic hexameter	masculine penthemimeral, trithemimeral
Μέντωρ Ἀλκιμίδης εὐεργεσίας ἀποτίνειν.	-- -uu- --uu- uu--	dactylic hexameter	masculine penthemimeral
ἦ ῥα, καὶ οὔ πω πάγχυ δίδου ἑτεραλκέα νίκην,	- u u - - -u u- uu-uu --	dactylic hexameter	feminine penthemimeral, hepthemimeral, trithemimeral
ἀλλ’ ἔτ’ ἄρα σθένεός τε καὶ ἀλκῆς πειρήτιζεν	- u u- uu- u u -- ----	dactylic hexameter	masculine penthemimeral, trithemimeral
ἠμὲν Ὀδυσσῆος ἠδ’ υἱοῦ κυδαλίμοιο.	-u u--- - -- -uu--	dactylic hexameter	masculine penthemimeral
αὐτὴ δ’αἰθαλόεντος ἀνὰ μεγάροιο μέλαθρον	-- -uu-u u- uu-u u--	dactylic hexameter	feminine penthemimeral, hepthemimeral
ἕζετ’ ἀναΐξασα, χελιδόνι εἰκέλη ἄντην.	-u u---u u-uu -uu --	dactylic hexameter	feminine penthemimeral
μνηστῆρας δ’ὤτρυνε Δαμαστορίδης Ἀγέλαος,	--- --u u-uu- uu--	dactylic hexameter	feminine penthemimeral, trithemimeral
Εὐρύνομός τε καὶ Ἀμφιμέδων Δημοπτόλεμός τε,	-uu- u u -uu- --uu- -	dactylic hexameter	hepthemimeral, trithemimeral
Πείσανδρός τε Πολυκτορίδης Πόλυβός τε δαΐφρων·	--- u u-uu- uu- u u--	dactylic hexameter	hepthemimeral, trithemimeral
οἱ γὰρ μνηστήρων ἀρετῇ ἔσαν ἔξοχ’ ἄριστοι,	- - --- uu- uu -u u--	dactylic hexameter	masculine penthemimeral, hepthemimeral
ὅσσοι ἔτ’ ἔζωον περί τε ψυχέων ἐμάχοντο·	-u u --- uu - uu- uu--	dactylic hexameter	masculine penthemimeral, hepthemimeral
τοὺς δ’ἤδη ἐδάμασσε βιὸς καὶ ταρφέες ἰοί.	- -- uu-u u- - -uu --	dactylic hexameter	feminine penthemimeral, hepthemimeral, trithemimeral
τοῖς δ’Ἀγέλεως μετέειπεν, ἔπος πάντεσσι πιφαύσκων·	- uu- uu-u u- --u u--	dactylic hexameter	feminine penthemimeral, hepthemimeral, trithemimeral
ὧ φίλοι, ἤδη σχήσει ἀνὴρ ὅδε χεῖρας ἀάπτους·	- uu -- -u u- uu -u u--	dactylic hexameter	feminine penthemimeral, hepthemimeral
καὶ δή οἱ Μέντωρ μὲν ἔβη κενὰ εὔγματα εἰπών,	- - - -- u u- uu -uu --	dactylic hexameter	masculine penthemimeral, hepthemimeral, trithemimeral
οἱ δ’οἶοι λείπονται ἐπὶ πρώτῃσι θύρῃσι.	- -- --u u- --u u--	dactylic hexameter	feminine penthemimeral, hepthemimeral, trithemimeral
τῶ νῦν μὴ ἅμα πάντες ἐφίετε δούρατα μακρά,	- - - uu -u u-uu -uu --	dactylic hexameter	feminine penthemimeral, trithemimeral
ἀλλ’ ἄγεθ’ οἱ ἓξ πρῶτον ἀκοντίσατ’, αἴ κέ ποθι Ζεὺς	- uu - - -u u-uu - u u- -	dactylic hexameter	feminine penthemimeral, trithemimeral
δώῃ Ὀδυσσῆα βλῆσθαι καὶ κῦδος ἀρέσθαι.	-u u--- -- - -u u--	dactylic hexameter	masculine penthemimeral, hepthemimeral
τῶν δ’ἄλλων οὐ κῆδος, ἐπὴν οὗτός γε πέσῃσιν.	- -- - -u u- -- u u--	dactylic hexameter	feminine penthemimeral, hepthemimeral, trithemimeral
ὣς ἔφαθ’, οἱ δ’ἄρα πάντες ἀκόντισαν ὡς ἐκέλευεν,	- uu - uu -u u-uu - uu--	dactylic hexameter	feminine penthemimeral, trithemimeral
ἱέμενοι· τὰ δὲ πάντα ἐτώσια θῆκεν Ἀθήνη,	-uu- u u -u u-uu -u u--	dactylic hexameter	feminine penthemimeral, trithemimeral
τῶν ἄλλος μὲν σταθμὸν ἐϋσταθέος μεγάροιο	- -- - -u u-uu- uu--	dactylic hexameter	feminine penthemimeral, trithemimeral
βεβλήκει, ἄλλος δὲ θύρην πυκινῶς ἀραρυῖαν·	--- -- u u- uu- uu--	dactylic hexameter	masculine penthemimeral, hepthemimeral, trithemimeral
ἄλλου δ’ἐν τοίχῳ μελίη πέσε χαλκοβάρεια.	-- - -- uu- uu -uu--	dactylic hexameter	masculine penthemimeral, hepthemimeral, trithemimeral
αὐτὰρ ἐπεὶ δὴ δούρατ’ ἀλεύαντο μνηστήρων,	-u u- - -u u--- ---	dactylic hexameter	feminine penthemimeral, trithemimeral
τοῖς ἄρα μύθων ἦρχε πολύτλας δῖος Ὀδυσσεύς·	- uu -- -u u-- -u u--	dactylic hexameter	feminine penthemimeral
ὧ φίλοι, ἤδη μέν κεν ἐγὼν εἴποιμι καὶ ἄμμι	- uu -- - u u- --u u --	dactylic hexameter	masculine penthemimeral, hepthemimeral
μνηστήρων ἐς ὅμιλον ἀκοντίσαι, οἳ μεμάασιν	--- u u-u u-uu - uu--	dactylic hexameter	feminine penthemimeral, trithemimeral
ἡμέας ἐξεναρίξαι ἐπὶ προτέροισι κακοῖσιν.	-uu -uu-u u- uu-u u--	dactylic hexameter	feminine penthemimeral, hepthemimeral
ὣς ἔφαθ’, οἱ δ’ἄρα πάντες ἀκόντισαν ὀξέα δοῦρα	- uu - uu -u u-uu -uu --	dactylic hexameter	feminine penthemimeral, trithemimeral
ἄντα τιτυσκόμενοι· Δημοπτόλεμον μὲν Ὀδυσσεύς,	-u u-uu- --uu- u u--	dactylic hexameter	masculine penthemimeral
Εὐρυάδην δ’ἄρα Τηλέμαχος, Ἔλατον δὲ συβώτης,	-uu- uu -uu- uu- u u--	dactylic hexameter	hepthemimeral, trithemimeral
Πείσανδρον δ’ἄρ’ ἔπεφνε βοῶν ἐπιβουκόλος ἀνήρ.	--- u u-u u- uu-uu --	dactylic hexameter	feminine penthemimeral, hepthemimeral, trithemimeral
οἱ μὲν ἔπειθ’ ἅμα πάντες ὀδὰξ ἕλον ἄσπετον οὖδας,	- u u- uu -u u- uu -uu --	dactylic hexameter	feminine penthemimeral, hepthemimeral, trithemimeral
μνηστῆρες δ’ἀνεχώρησαν μεγάροιο μυχόνδε·	--- uu--- uu-u u--	dactylic hexameter	hepthemimeral, trithemimeral
τοὶ δ’ἄρ’ ἐπήϊξαν, νεκύων δ’ἐξ ἔγχε’ ἕλοντο.	- u u--- uu- - -u u--	dactylic hexameter	masculine penthemimeral, hepthemimeral
αὖτις δὲ μνηστῆρες ἀκόντισαν ὀξέα δοῦρα	-- - --u u-uu -uu --	dactylic hexameter	feminine penthemimeral, trithemimeral
ἱέμενοι· τὰ δὲ πολλὰ ἐτώσια θῆκεν Ἀθήνη.	-uu- u u -u u-uu -u u--	dactylic hexameter	feminine penthemimeral, trithemimeral
τῶν ἄλλος μὲν σταθμὸν ἐϋσταθέος μεγάροιο	- -- - -u u-uu- uu--	dactylic hexameter	feminine penthemimeral, trithemimeral
βεβλήκει, ἄλλος δὲ θύρην πυκινῶς ἀραρυῖαν·	--- -- u u- uu- uu--	dactylic hexameter	masculine penthemimeral, hepthemimeral, trithemimeral
ἄλλου δ’ἐν τοίχῳ μελίη πέσε χαλκοβάρεια.	-- - -- uu- uu -uu--	dactylic hexameter	masculine penthemimeral, hepthemimeral, trithemimeral
Ἀμφιμέδων δ’ἄρα Τηλέμαχον βάλε χεῖρ’ ἐπὶ καρπῷ	-uu- uu -uu- uu - uu --	dactylic hexameter	hepthemimeral, trithemimeral
λίγδην, ἄκρον δὲ ῥινὸν δηλήσατο χαλκός.	-- -- - -- --uu --	dactylic hexameter	masculine penthemimeral, hepthemimeral
Κτήσιππος δ’Εὔμαιον ὑπὲρ σάκος ἔγχεϊ μακρῷ	--- --u u- uu -uu --	dactylic hexameter	feminine penthemimeral, hepthemimeral, trithemimeral
ὧμον ἐπέγραψεν· τὸ δ’ὑπέρπτατο, πῖπτε δ’ἔραζε.	-u u--- u u-uu -u u--	dactylic hexameter	masculine penthemimeral
τοὶ δ’αὖτ’ ἀμφ’ Ὀδυσῆα δαΐφρονα ποικιλομήτην,	- - - uu-u u-uu -uu--	dactylic hexameter	feminine penthemimeral, trithemimeral
μνηστήρων ἐς ὅμιλον ἀκόντισαν ὀξέα δοῦρα.	--- u u-u u-uu -uu --	dactylic hexameter	feminine penthemimeral, trithemimeral
ἔνθ’ αὖτ’ Εὐρυδάμαντα βάλε πτολίπορθος Ὀδυσσεύς,	- - -uu-u u- uu-u u--	dactylic hexameter	feminine penthemimeral, hepthemimeral
Ἀμφιμέδοντα δὲ Τηλέμαχος, Πόλυβον δὲ συβώτης·	-uu-u u -uu- uu- u u--	dactylic hexameter	hepthemimeral
Κτήσιππον δ’ἄρ’ ἔπειτα βοῶν ἐπιβουκόλος ἀνὴρ	--- u u-u u- uu-uu --	dactylic hexameter	feminine penthemimeral, hepthemimeral, trithemimeral
βεβλήκει πρὸς στῆθος, ἐπευχόμενος δὲ προσηύδα·	--- - -u u-uu- u u--	dactylic hexameter	feminine penthemimeral, trithemimeral
ὧ Πολυθερσεΐδη φιλοκέρτομε, μή ποτε πάμπαν	- uu-uu- uu-uu - uu --	dactylic hexameter	masculine penthemimeral
εἴκων ἀφραδίῃς μέγα εἰπεῖν, ἀλλὰ θεοῖσι	-- -uu- uu -- -u u--	dactylic hexameter	masculine penthemimeral
μῦθον ἐπιτρέψαι, ἐπεὶ ἦ πολὺ φέρτεροί εἰσι.	-u u--- uu - uu -uu --	dactylic hexameter	masculine penthemimeral, hepthemimeral
τοῦτό τοι ἀντὶ ποδὸς ξεινήϊον, ὅν ποτ’ ἔδωκας	-u u -u u- --uu - u u--	dactylic hexameter	masculine penthemimeral
ἀντιθέῳ Ὀδυσῆϊ δόμον κάτ’ ἀλητεύοντι.	-uu- uu-u u- u u----	dactylic hexameter	feminine penthemimeral, hepthemimeral, trithemimeral
ἦ ῥα βοῶν ἑλίκων ἐπιβουκόλος· αὐτὰρ Ὀδυσσεὺς	- u u- uu- uu-uu -u u--	dactylic hexameter	masculine penthemimeral, trithemimeral
οὖτα Δαμαστορίδην αὐτοσχεδὸν ἔγχεϊ μακρῷ.	-u u-uu- --uu -uu --	dactylic hexameter	masculine penthemimeral
Τηλέμαχος δ’Εὐηνορίδην Λειώκριτον οὖτα	-uu- --uu- --uu --	dactylic hexameter	hepthemimeral, trithemimeral
δουρὶ μέσον κενεῶνα, διαπρὸ δὲ χαλκὸν ἔλασσεν·	-u u- uu-u u-u u -u u--	dactylic hexameter	feminine penthemimeral, trithemimeral
ἤριπε δὲ πρηνής, χθόνα δ’ἤλασε παντὶ μετώπῳ.	-uu - -- uu -uu -u u--	dactylic hexameter	masculine penthemimeral, trithemimeral
δὴ τότ’ Ἀθηναίη φθισίμβροτον αἰγίδ’ ἀνέσχεν	- u u--- --uu -u u--	dactylic hexameter	masculine penthemimeral
ὑψόθεν ἐξ ὀροφῆς· τῶν δὲ φρένες ἐπτοίηθεν.	-uu - uu- - - uu ----	dactylic hexameter	masculine penthemimeral, hepthemimeral, trithemimeral
οἱ δ’ἐφέβοντο κατὰ μέγαρον βόες ὣς ἀγελαῖαι·	- uu-u u- uu- uu - uu--	dactylic hexameter	masculine penthemimeral, hepthemimeral
τὰς μέν τ’αἰόλος οἶστρος ἐφορμηθεὶς ἐδόνησεν	- - -uu -u u--- uu--	dactylic hexameter	feminine penthemimeral
ὥρῃ ἐν εἰαρινῇ, ὅτε τ’ἤματα μακρὰ πέλονται.	-u u -uu- uu -uu -u u--	dactylic hexameter	masculine penthemimeral
οἱ δ’ὥς τ’αἰγυπιοὶ γαμψώνυχες ἀγκυλοχεῖλαι,	- - -uu- --uu -uu--	dactylic hexameter	masculine penthemimeral
ἐξ ὀρέων ἐλθόντες ἐπ’ ὀρνίθεσσι θόρωσι·	- uu- --u u ---u u--	dactylic hexameter	feminine penthemimeral, trithemimeral
ταὶ μέν τ’ἐν πεδίῳ νέφεα πτώσσουσαι ἵενται,	- - - uu- uu- --u u--	dactylic hexameter	masculine penthemimeral, hepthemimeral, trithemimeral
οἱ δέ τε τὰς ὀλέκουσιν ἐπάλμενοι, οὐδέ τις ἀλκὴ	- u u - uu-u u-uu -u u --	dactylic hexameter	feminine penthemimeral, trithemimeral
γίνεται οὐδὲ φυγή· χαίρουσι δέ τ’ἀνέρες ἄγρῃ·	-uu -u u- --u u -uu --	dactylic hexameter	masculine penthemimeral
ὣς ἄρα τοὶ μνηστῆρας ἐπεσσύμενοι κατὰ δῶμα	- uu - --u u-uu- uu --	dactylic hexameter	feminine penthemimeral, trithemimeral
τύπτον ἐπιστροφάδην· τῶν δὲ στόνος ὤρνυτ’ ἀεικὴς	-u u-uu- - - uu -u u--	dactylic hexameter	masculine penthemimeral, hepthemimeral
κράτων τυπτομένων, δάπεδον δ’ἅπαν αἵματι θῦε.	-- -uu- uu- uu -uu --	dactylic hexameter	masculine penthemimeral, hepthemimeral
Λειώδης δ’Ὀδυσῆος ἐπεσσύμενος λάβε γούνων,	--- uu-u u-uu- uu --	dactylic hexameter	feminine penthemimeral, trithemimeral
καί μιν λισσόμενος ἔπεα πτερόεντα προσηύδα·	- - -uu- uu- uu-u u--	dactylic hexameter	masculine penthemimeral, hepthemimeral
γουνοῦμαί σ’,Ὀδυσεῦ· σὺ δέ μ’αἴδεο καί μ’ἐλέησον·	--- uu- u u -uu - uu--	dactylic hexameter	masculine penthemimeral, trithemimeral
οὐ γάρ πώ τινά φημι γυναικῶν ἐν μεγάροισιν	- - - uu -u u-- - uu--	dactylic hexameter	feminine penthemimeral, trithemimeral
εἰπεῖν οὐδέ τι ῥέξαι ἀτάσθαλον· ἀλλὰ καὶ ἄλλους	-- -u u -u u-uu -u u --	dactylic hexameter	feminine penthemimeral
παύεσκον μνηστῆρας, ὅτις τοιαῦτά γε ῥέζοι.	--- --u u- --u u --	dactylic hexameter	feminine penthemimeral, hepthemimeral, trithemimeral
ἀλλά μοι οὐ πείθοντο κακῶν ἄπο χεῖρας ἔχεσθαι·	-u u - --u u- uu -u u--	dactylic hexameter	feminine penthemimeral, hepthemimeral, trithemimeral
τῶ καὶ ἀτασθαλίῃσιν ἀεικέα πότμον ἐπέσπον.	- u u-uu-u u-uu -u u--	dactylic hexameter	feminine penthemimeral
αὐτὰρ ἐγὼ μετὰ τοῖσι θυοσκόος οὐδὲν ἐοργὼς	-u u- uu -u u-uu -u u--	dactylic hexameter	feminine penthemimeral, trithemimeral
κείσομαι, ὡς οὐκ ἔστι χάρις μετόπισθ’ εὐεργέων·	-uu - - -u u- uu- ---	dactylic hexameter	feminine penthemimeral, hepthemimeral, trithemimeral
τὸν δ’ἄρ’ ὑπόδρα ἰδὼν προσέφη πολύμητις Ὀδυσσεύς·	- u u-u u- uu- uu-u u--	dactylic hexameter	masculine penthemimeral, hepthemimeral
εἰ μὲν δὴ μετὰ τοῖσι θυοσκόος εὔχεαι εἶναι,	- - - uu -u u-uu -uu --	dactylic hexameter	feminine penthemimeral, trithemimeral
πολλάκι που μέλλεις ἀρήμεναι ἐν μεγάροισι	-uu - -- --uu - uu--	dactylic hexameter	masculine penthemimeral, trithemimeral
τηλοῦ ἐμοὶ νόστοιο τέλος γλυκεροῖο γενέσθαι,	-u u- --u u- uu-u u--	dactylic hexameter	feminine penthemimeral, hepthemimeral, trithemimeral
σοὶ δ’ἄλοχόν τε φίλην σπέσθαι καὶ τέκνα τεκέσθαι·	- uu- u u- -- - -u u--	dactylic hexameter	masculine penthemimeral, hepthemimeral, trithemimeral
τῶ οὐκ ἂν θάνατόν γε δυσηλεγέα προφύγοισθα.	- - - uu- u u-uu- uu--	dactylic hexameter	masculine penthemimeral, trithemimeral
ὣς ἄρα φωνήσας ξίφος εἵλετο χειρὶ παχείῃ	- uu --- uu -uu -u u--	dactylic hexameter	masculine penthemimeral
κείμενον, ὅ ῥ’Ἀγέλαος ἀποπροέηκε χαμᾶζε	-uu - uu-u u-uu-u u--	dactylic hexameter	feminine penthemimeral, trithemimeral
κτεινόμενος· τῷ τόν γε κατ’ αὐχένα μέσσον ἔλασσε.	-uu- - - u u -uu -u u--	dactylic hexameter	masculine penthemimeral, trithemimeral
φθεγγομένου δ’ἄρα τοῦ γε κάρη κονίῃσιν ἐμίχθη.	-uu- uu - u u- uu-u u--	dactylic hexameter	masculine penthemimeral, hepthemimeral, trithemimeral
Τερπιάδης δ’ἔτ’ ἀοιδὸς ἀλύσκανε κῆρα μέλαιναν,	-uu- u u-u u-uu -u u--	dactylic hexameter	feminine penthemimeral, trithemimeral
Φήμιος, ὅς ῥ’ἤειδε μετὰ μνηστῆρσιν ἀνάγκῃ.	-uu - --u u- --u u--	dactylic hexameter	feminine penthemimeral, hepthemimeral, trithemimeral
ἔστη δ’ἐν χείρεσσίν ἔχων φόρμιγγα λίγειαν	-- - --u u- --u u--	dactylic hexameter	feminine penthemimeral, hepthemimeral, trithemimeral
ἄγχι παρ’ ὀρσοθύρην· δίχα δὲ φρεσὶ μερμήριζεν,	-u u -uu- uu - uu ----	dactylic hexameter	masculine penthemimeral, hepthemimeral
ἢ ἐκδὺς μεγάροιο Διὸς μεγάλου ποτὶ βωμὸν	- -- uu-u u- uu- uu --	dactylic hexameter	feminine penthemimeral, hepthemimeral, trithemimeral
ἑρκείου ἕζοιτο τετυγμένον, ἔνθ’ ἄρα πολλὰ	--- --u u-uu - uu --	dactylic hexameter	feminine penthemimeral, trithemimeral
Λαέρτης Ὀδυσεύς τε βοῶν ἐπὶ μηρί’ ἔκηαν,	--- uu- u u- uu -u u--	dactylic hexameter	masculine penthemimeral, hepthemimeral, trithemimeral
ἦ γούνων λίσσοιτο προσαΐξας Ὀδυσῆα.	- -- --u u--- uu--	dactylic hexameter	feminine penthemimeral, trithemimeral
ὦδε δέ οἱ φρονέοντι δοάσσατο κέρδιον εἶναι,	-u u - uu-u u-uu -uu --	dactylic hexameter	feminine penthemimeral, trithemimeral
γούνων ἅψασθαι Λαερτιάδεω Ὀδυσῆος.	-- --- --uu- uu--	dactylic hexameter	masculine penthemimeral
ἤτοι ὁ φόρμιγγα γλαφυρὴν κατέθηκε χαμᾶζε	-u u --- uu- uu-u u--	dactylic hexameter	masculine penthemimeral, hepthemimeral
μεσσηγὺς κρητῆρος ἰδὲ θρόνου ἀργυροήλου,	--- --u u- uu -uu--	dactylic hexameter	feminine penthemimeral, hepthemimeral, trithemimeral
αὐτὸς δ’αὖτ’ Ὀδυσῆα προσαΐξας λάβε γούνων,	-- - uu-u u--- uu --	dactylic hexameter	feminine penthemimeral, trithemimeral
καί μιν λισσόμενος ἔπεα πτερόεντα προσηύδα·	- - -uu- uu- uu-u u--	dactylic hexameter	masculine penthemimeral, hepthemimeral
γουνοῦμαί σ’,Ὀδυσεῦ· σὺ δέ μ’αἴδεο καί μ’ἐλέησον·	--- uu- u u -uu - uu--	dactylic hexameter	masculine penthemimeral, trithemimeral
αὐτῷ τοι μετόπισθ’ ἄχος ἔσσεται, εἴ κεν ἀοιδὸν	-- - uu- uu -uu - u u--	dactylic hexameter	masculine penthemimeral, trithemimeral
πέφνῃς, ὅς τε θεοῖσι καὶ ἀνθρώποισιν ἀείδω.	-- - u u-u u ---u u--	dactylic hexameter	feminine penthemimeral, trithemimeral
αὐτοδίδακτος δ’εἰμί, θεὸς δέ μοι ἐν φρεσὶν οἴμας	-uu-- -u u- u u - uu --	dactylic hexameter	feminine penthemimeral, hepthemimeral
παντοίας ἐνέφυσεν· ἔοικα δέ τοι παραείδειν	--- uu-u u-u u - uu--	dactylic hexameter	feminine penthemimeral, trithemimeral
ὥς τε θεῷ· τῶ μή με λιλαίεο δειροτομῆσαι.	- u u- - - u u-uu -uu--	dactylic hexameter	masculine penthemimeral, trithemimeral
καί κεν Τηλέμαχος τάδε γ’εἴποι, σὸς φίλος υἱός,	- - -uu- uu -- - uu --	dactylic hexameter	masculine penthemimeral
ὡς ἐγὼ οὔ τι ἑκὼν ἐς σὸν δόμον οὐδὲ χατίζων	- uu - u u- - - uu -u u--	dactylic hexameter	masculine penthemimeral, hepthemimeral, trithemimeral
πωλεύμην μνηστῆρσιν ἀεισόμενος μετὰ δαῖτας,	--- --u u-uu- uu --	dactylic hexameter	feminine penthemimeral, trithemimeral
ἀλλὰ πολὺ πλέονες καὶ κρείσσονες ἦγον ἀνάγκῃ.	-u u- uu- - -uu -u u--	dactylic hexameter	masculine penthemimeral, trithemimeral
ὣς φάτο, τοῦ δ’ἤκουσ’ ἱερὴ ἲς Τηλεμάχοιο,	- uu - -- uu- - -uu--	dactylic hexameter	masculine penthemimeral, hepthemimeral, trithemimeral
αἶψα δ’ἑὸν πατέρα προσεφώνεεν ἐγγὺς ἐόντα·	-u u- uu- uu-uu -u u--	dactylic hexameter	masculine penthemimeral, trithemimeral
ἴσχεο μηδέ τι τοῦτον ἀναίτιον οὔταε χαλκῷ·	-uu -u u -u u-uu -uu --	dactylic hexameter	feminine penthemimeral
καὶ κήρυκα Μέδοντα σαώσομεν, ὅς τέ μευ αἰεὶ	- --u u-u u-uu - u u --	dactylic hexameter	feminine penthemimeral
οἴκῳ ἐν ἡμετέρῳ κηδέσκετο παιδὸς ἐόντος,	-u u -uu- --uu -u u--	dactylic hexameter	masculine penthemimeral
εἰ δὴ μή μιν ἔπεφνε Φιλοίτιος ἠὲ συβώτης,	- - - u u-u u-uu -u u--	dactylic hexameter	feminine penthemimeral, trithemimeral
ἠὲ σοὶ ἀντεβόλησεν ὀρινομένῳ κατὰ δῶμα.	-u u -uu-u u-uu- uu --	dactylic hexameter	feminine penthemimeral
ὣς φάτο, τοῦ δ’ἤκουσε Μέδων πεπνυμένα εἰδώς·	- uu - --u u- --uu --	dactylic hexameter	feminine penthemimeral, hepthemimeral, trithemimeral
πεπτηὼς γὰρ ἔκειτο ὑπὸ θρόνον, ἀμφὶ δὲ δέρμα	--- u u-u u- uu -u u --	dactylic hexameter	feminine penthemimeral, hepthemimeral, trithemimeral
ἕστο βοὸς νεόδαρτον, ἀλύσκων κῆρα μέλαιναν.	-u u- uu-u u-- -u u--	dactylic hexameter	feminine penthemimeral, trithemimeral
αἶψα δ’ὑπὸ θρόνου ὧρτο, βοὸς δ’ἀπέδυνε βοείην	-u u- uu -u u- uu-u u--	dactylic hexameter	feminine penthemimeral, hepthemimeral, trithemimeral
Τηλέμαχον δ’ἄρ’ ἔπειτα προσαΐξας λάβε γούνων,	-uu- u u-u u--- uu --	dactylic hexameter	feminine penthemimeral, trithemimeral
καί μιν λισσόμενος ἔπεα πτερόεντα προσηύδα·	- - -uu- uu- uu-u u--	dactylic hexameter	masculine penthemimeral, hepthemimeral
ὧ φίλ’, ἐγὼ μὲν ὅδ’ εἰμί, σὺ δ’ἴσχεο εἰπὲ δὲ πατρὶ	- u u- u u -u u -uu -u u --	dactylic hexameter	feminine penthemimeral, trithemimeral
μή με περισθενέων δηλήσεται ὀξέϊ χαλκῷ,	- u u-uu- --uu -uu --	dactylic hexameter	masculine penthemimeral
ἀνδρῶν μνηστήρων κεχολωμένος, οἵ οἱ ἔκειρον	-- --- uu-uu - u u--	dactylic hexameter	masculine penthemimeral
κτήματ’ ἐνὶ μεγάροις, σὲ δὲ νήπιοι οὐδὲν ἔτιον.	-u u- uu- u u -uu -u u--	dactylic hexameter	masculine penthemimeral, trithemimeral
τὸν δ’ἐπιμειδήσας προσέφη πολύμητις Ὀδυσσεύς·	- uu--- uu- uu-u u--	dactylic hexameter	masculine penthemimeral, hepthemimeral
θάρσει, ἐπεὶ δή σ’οὗτος ἐρύσατο καὶ ἐσάωσεν,	-u u- - -u u-uu - uu--	dactylic hexameter	feminine penthemimeral, trithemimeral
ὄφρα γνῷς κατὰ θυμόν, ἀτὰρ εἴπῃσθα καὶ ἄλλῳ,	-- - uu -u u- --u u --	dactylic hexameter	feminine penthemimeral, hepthemimeral, trithemimeral
ὡς κακοεργίης εὐεργεσίη μέγ’ ἀμείνων.	- uu--- --uu- u u--	dactylic hexameter	masculine penthemimeral
ἀλλ’ ἐξελθόντες μεγάρων ἕζεσθε θύραζε	- ---- uu- --u u--	dactylic hexameter	masculine penthemimeral, hepthemimeral
ἐκ φόνου εἰς αὐλήν, σύ τε καὶ πολύφημος ἀοιδός,	- uu - -- u u - uu-u u--	dactylic hexameter	masculine penthemimeral, hepthemimeral, trithemimeral
ὄφρ’ ἂν ἐγὼ κατὰ δῶμα πονήσομαι ὅττεό με χρή.	- u u- uu -u u-uu -uu - -	dactylic hexameter	feminine penthemimeral, trithemimeral
ὣς φάτο, τὼ δ’ἔξω βήτην μεγάροιο κιόντε,	- uu - -- -- uu-u u--	dactylic hexameter	masculine penthemimeral, hepthemimeral, trithemimeral
ἑζέσθην δ’ἄρα τώ γε Διὸς μεγάλου ποτὶ βωμόν,	--- uu - u u- uu- uu --	dactylic hexameter	masculine penthemimeral, hepthemimeral, trithemimeral
πάντοσε παπταίνοντε, φόνον ποτιδεγμένω αἰεί.	-uu ---u u- uu-uu --	dactylic hexameter	feminine penthemimeral, hepthemimeral
πάπτηνεν δ’Ὀδυσεὺς καθ’ ἑὸν δόμον, εἴ τις ἔτ’ ἀνδρῶν	--- uu- u u- uu - u u --	dactylic hexameter	masculine penthemimeral, hepthemimeral, trithemimeral
ζωὸς ὑποκλοπέοιτο, ἀλύσκων κῆρα μέλαιναν.	-u u-uu-u u-- -u u--	dactylic hexameter	feminine penthemimeral
τοὺς δὲ ἴδεν μάλα πάντας ἐν αἵματι καὶ κονίῃσι	- u u- uu -u u -uu - uu--	dactylic hexameter	feminine penthemimeral, trithemimeral
πεπτεῶτας πολλούς, ὥς τ’ἰχθύας, οὕς θ’ἁλιῆες	--- -- - -uu - uu--	dactylic hexameter	masculine penthemimeral, trithemimeral
κοῖλον ἐς αἰγιαλὸν πολιῆς ἔκτοσθε θαλάσσης	-u u -uu- uu- --u u--	dactylic hexameter	masculine penthemimeral, hepthemimeral
δικτύῳ ἐξέρυσαν πολυωπῷ· οἱ δέ τε πάντες	-uu -uu- uu-- - u u --	dactylic hexameter	masculine penthemimeral
κύμαθ’ ἁλὸς ποθέοντες ἐπὶ ψαμάθοισι κέχυνται·	-u u- uu-u u- uu-u u--	dactylic hexameter	feminine penthemimeral, hepthemimeral, trithemimeral
τῶν μέν τ’Ἠέλιος φαέθων ἐξείλετο θυμόν·	- - -uu- uu- --uu --	dactylic hexameter	masculine penthemimeral, hepthemimeral
ὣς τότ’ ἄρα μνηστῆρες ἐπ’ ἀλλήλοισι κέχυντο.	- u u- --u u ---u u--	dactylic hexameter	feminine penthemimeral, trithemimeral
δὴ τότε Τηλέμαχον προσέφη πολύμητις Ὀδυσσεύς·	- uu -uu- uu- uu-u u--	dactylic hexameter	masculine penthemimeral, hepthemimeral
Τηλέμαχ’, εἰ δ’ἄγε μοι κάλεσον τροφὸν Εὐρύκλειαν,	-uu - uu - uu- uu ----	dactylic hexameter	masculine penthemimeral, hepthemimeral, trithemimeral
ὄφρα ἔπος εἴπωμι τό μοι καταθύμιόν ἐστιν.	-u u- --u u - uu-uu --	dactylic hexameter	feminine penthemimeral, hepthemimeral, trithemimeral
ὣς φάτο, Τηλέμαχος δὲ φίλῳ ἐπεπείθετο πατρί,	- uu -uu- u u- uu-uu --	dactylic hexameter	masculine penthemimeral, hepthemimeral
κινήσας δὲ θύρην προσέφη τροφὸν Εὐρύκλειαν·	--- u u- uu- uu ----	dactylic hexameter	masculine penthemimeral, hepthemimeral, trithemimeral
δεῦρο δὴ ὄρσο, γρηῢ παλαιγενές, ἥ τε γυναικῶν	-u u -- -u u-uu - u u--	dactylic hexameter	feminine penthemimeral
δμῳάων σκοπός ἐσσι κατὰ μέγαρ’ ἡμετεράων·	--- uu -u u- uu -uu--	dactylic hexameter	feminine penthemimeral, hepthemimeral, trithemimeral
ἔρχεο· κικλήσκει σε πατὴρ ἐμός, ὄφρα τι εἴπῃ.	-uu --- u u- uu -u u --	dactylic hexameter	masculine penthemimeral, hepthemimeral
ὣς ἄρ’ ἐφώνησεν, τῇ δ’ἄπτερος ἔπλετο μῦθος,	- u u--- - -uu -uu --	dactylic hexameter	masculine penthemimeral
ὤϊξεν δὲ θύρας μεγάρων εὖ ναιεταόντων,	--- u u- uu- - -uu--	dactylic hexameter	masculine penthemimeral, hepthemimeral, trithemimeral
βῆ δ’ἴμεν· αὐτὰρ Τηλέμαχος πρόσθ’ ἡγεμόνευεν.	- uu -- -uu- - -uu--	dactylic hexameter	hepthemimeral
εὗρεν ἔπειτ’ Ὀδυσῆα μετὰ κταμένοισι νέκυσσιν,	-u u- uu-u u- uu-u u--	dactylic hexameter	feminine penthemimeral, hepthemimeral, trithemimeral
αἵματι καὶ λύθρῳ πεπαλαγμένον ὥς τε λέοντα,	-uu - -- uu-uu - u u--	dactylic hexameter	masculine penthemimeral, trithemimeral
ὅς ῥά τε βεβρωκὼς βοὸς ἔρχεται ἀγραύλοιο·	- u u --- uu -uu ----	dactylic hexameter	masculine penthemimeral
πᾶν δ’ἄρα οἱ στῆθός τε παρήϊά τ’ἀμφοτέρωθεν	- uu - -- u u-uu -uu--	dactylic hexameter	masculine penthemimeral, trithemimeral
αἱματόεντα πέλει, δεινὸς δ’εἰς ὧπα ἰδέσθαι·	-uu-u u- -- - -u u--	dactylic hexameter	masculine penthemimeral, hepthemimeral
ὣς Ὀδυσεὺς πεπάλακτο πόδας καὶ χεῖρας ὕπερθεν.	- uu- uu-u u- - -u u--	dactylic hexameter	feminine penthemimeral, hepthemimeral, trithemimeral
ἡ δ’ὡς οὖν νέκυάς τε καὶ ἄσπετον εἴσιδεν αἷμα,	- - - uu- u u -uu -uu --	dactylic hexameter	masculine penthemimeral, trithemimeral
ἴθυσέν ῥ’ὀλολύξαι, ἐπεὶ μέγα εἴσιδεν ἔργον·	--- uu-u u- uu -uu --	dactylic hexameter	feminine penthemimeral, hepthemimeral, trithemimeral
ἀλλ’ Ὀδυσεὺς κατέρυκε καὶ ἔσχεθεν ἱεμένην περ,	- uu- uu-u u -uu -uu- -	dactylic hexameter	feminine penthemimeral, trithemimeral
καί μιν φωνήσας ἔπεα πτερόεντα προσηύδα·	- - --- uu- uu-u u--	dactylic hexameter	masculine penthemimeral, hepthemimeral
ἐν θυμῷ, γρηῦ, χαῖρε καὶ ἴσχεο μηδ’ ὀλόλυζε·	- -- - -u u -uu - uu--	dactylic hexameter	feminine penthemimeral, trithemimeral
οὐχ ὁσίη κταμένοισιν ἐπ’ ἀνδράσιν εὐχετάασθαι.	- uu- uu-u u -uu -uu--	dactylic hexameter	feminine penthemimeral, trithemimeral
τούσδε δὲ μοῖρ’ ἐδάμασσε θεῶν καὶ σχέτλια ἔργα·	-u u - uu-u u- - -uu --	dactylic hexameter	feminine penthemimeral, hepthemimeral, trithemimeral
οὔ τινα γὰρ τίεσκον ἐπιχθονίων ἀνθρώπων,	- uu - --u u-uu- ---	dactylic hexameter	feminine penthemimeral, trithemimeral
οὐ κακὸν οὐδὲ μὲν ἐσθλόν, ὅτις σφέας εἰσαφίκοιτο·	- uu -u u -u u- uu -uu--	dactylic hexameter	feminine penthemimeral, hepthemimeral
τῶ καὶ ἀτασθαλίῃσιν ἀεικέα πότμον ἐπέσπον.	- u u-uu-u u-uu -u u--	dactylic hexameter	feminine penthemimeral
ἀλλ’ ἄγε μοι σὺ γυναῖκας ἐνὶ μεγάροις κατάλεξον,	- uu - u u-u u- uu- uu--	dactylic hexameter	feminine penthemimeral, hepthemimeral, trithemimeral
αἵ τέ μ’ἀτιμάζουσι καὶ αἳ νηλιτεῖς εἰσι.	- u u---u u - --- --	dactylic hexameter	feminine penthemimeral, hepthemimeral
τὸν δ’αὖτε προσέειπε φίλη τροφὸς Εὐρύκλεια·	- -- uu-u u- uu ----	dactylic hexameter	feminine penthemimeral, hepthemimeral, trithemimeral
τοιγὰρ ἐγώ τοι, τέκνον, ἀληθείην καταλέξω.	-u u- - -u u--- uu--	dactylic hexameter	feminine penthemimeral, trithemimeral
πεντήκοντά τοί εἰσιν ἐνὶ μεγάροισι γυναῖκες	---u u -u u- uu-u u--	dactylic hexameter	feminine penthemimeral, hepthemimeral
δμῳαί, τὰς μέν τ’ἔργα διδάξαμεν ἐργάζεσθαι,	-- - - -u u-uu ----	dactylic hexameter	feminine penthemimeral, trithemimeral
εἴριά τε ξαίνειν καὶ δουλοσύνην ἀνέχεσθαι·	-uu - -- - -uu- uu--	dactylic hexameter	masculine penthemimeral, trithemimeral
τάων δώδεκα πᾶσαι ἀναιδείης ἐπέβησαν,	-- -uu -u u--- uu--	dactylic hexameter	feminine penthemimeral
οὔτ’ ἐμὲ τίουσαι οὔτ’ αὐτὴν Πηνελόπειαν.	- uu --- - -- -uu--	dactylic hexameter	masculine penthemimeral
Τηλέμαχος δὲ νέον μὲν ἀέξετο, οὐδέ ἑ μήτηρ	-uu- u u- u u-uu -u u --	dactylic hexameter	masculine penthemimeral, trithemimeral
σημαίνειν εἴασκεν ἐπὶ δμῳῇσι γυναιξίν.	--- --u u- --u u--	dactylic hexameter	feminine penthemimeral, hepthemimeral, trithemimeral
ἀλλ’ ἄγ’ ἐγὼν ἀναβᾶσ’ ὑπερώϊα σιγαλόεντα	- u u- uu- uu-uu -uu--	dactylic hexameter	masculine penthemimeral, trithemimeral
εἴπω σῇ ἀλόχῳ, τῇ τις θεὸς ὕπνον ἐπῶρσε.	-- - uu- - - uu -u u--	dactylic hexameter	masculine penthemimeral, hepthemimeral, trithemimeral
τὴν δ’ἀπαμειβόμενος προσέφη πολύμητις Ὀδυσσεύς·	- uu-uu- uu- uu-u u--	dactylic hexameter	masculine penthemimeral, hepthemimeral
μή πω τήν γ’ἐπέγειρε· σὺ δ’ἐνθάδε εἰπὲ γυναιξὶν	- - - uu-u u -uu -u u--	dactylic hexameter	feminine penthemimeral, trithemimeral
ἐλθέμεν, αἵ περ πρόσθεν ἀεικέα μηχανόωντο.	-uu - - -u u-uu -uu--	dactylic hexameter	feminine penthemimeral, trithemimeral
ὣς ἄρ’ ἔφη, γρηῢς δὲ διὲκ μεγάροιο βεβήκει	- u u- -- u u- uu-u u--	dactylic hexameter	masculine penthemimeral, hepthemimeral, trithemimeral
ἀγγελέουσα γυναιξὶ καὶ ὀτρυνέουσα νέεσθαι.	-uu-u u-u u -uu-u u--	dactylic hexameter	feminine penthemimeral
αὐτὰρ ὁ Τηλέμαχον καὶ βουκόλον ἠδὲ συβώτην	-u u -uu- - -uu -u u--	dactylic hexameter	masculine penthemimeral
εἰς ἓ καλεσσάμενος ἔπεα πτερόεντα προσηύδα·	- u u-uu- uu- uu-u u--	dactylic hexameter	masculine penthemimeral, hepthemimeral
ἄρχετε νῦν νέκυας φορέειν καὶ ἄνωχθε γυναῖκας·	-uu - uu- uu- u u-u u--	dactylic hexameter	masculine penthemimeral, hepthemimeral, trithemimeral
αὐτὰρ ἔπειτα θρόνους περικαλλέας ἠδὲ τραπέζας	-u u-u u- uu-uu -u u--	dactylic hexameter	masculine penthemimeral
ὕδατι καὶ σπόγγοισι πολυτρήτοισι καθαίρειν.	-uu - --u u---u u--	dactylic hexameter	feminine penthemimeral, trithemimeral
αὐτὰρ ἐπὴν δὴ πάντα δόμον κατακοσμήσησθε,	-u u- - -u u- uu----	dactylic hexameter	feminine penthemimeral, hepthemimeral, trithemimeral
δμῳὰς ἐξαγαγόντες ἐϋσταθέος μεγάροιο,	-- -uu-u u-uu- uu--	dactylic hexameter	feminine penthemimeral
μεσσηγύς τε θόλου καὶ ἀμύμονος ἕρκεος αὐλῆς,	--- u u- u u-uu -uu --	dactylic hexameter	masculine penthemimeral, trithemimeral
θεινέμεναι ξίφεσιν τανυήκεσιν, εἰς ὅ κε πασέων	-uu- uu- uu-uu - u u --	dactylic hexameter	masculine penthemimeral, trithemimeral
ψυχὰς ἐξαφέλησθε καὶ ἐκλελάθωντ’ Ἀφροδίτης,	-- -uu-u u -uu- uu--	dactylic hexameter	feminine penthemimeral
τὴν ἄρ’ ὑπὸ μνηστῆρσιν ἔχον μίσγοντό τε λάθρῃ.	- u u- --u u- --u u --	dactylic hexameter	feminine penthemimeral, hepthemimeral, trithemimeral
ὣς ἔφαθ’, αἱ δὲ γυναῖκες ἀολλέες ἦλθον ἅπασαι,	- uu - u u-u u-uu -u u--	dactylic hexameter	feminine penthemimeral, trithemimeral
αἴν’ ὀλοφυρόμεναι, θαλερὸν κατὰ δάκρυ χέουσαι.	- uu-uu- uu- uu -u u--	dactylic hexameter	masculine penthemimeral, hepthemimeral
πρῶτα μὲν οὖν νέκυας φόρεον κατατεθνηῶτας,	-u u - uu- uu- uu----	dactylic hexameter	masculine penthemimeral, hepthemimeral, trithemimeral
κὰδ δ’ἄρ’ ὑπ’ αἰθούσῃ τίθεσαν εὐερκέος αὐλῆς,	- u u --- uu- --uu --	dactylic hexameter	masculine penthemimeral, hepthemimeral
ἀλλήλοισιν ἐρείδουσαι· σήμαινε δ’Ὀδυσσεὺς	---u u--- --u u--	dactylic hexameter	hepthemimeral
αὐτὸς ἐπισπέρχων· ταὶ δ’ἐκφόρεον καὶ ἀνάγκῃ.	-u u--- - -uu- u u--	dactylic hexameter	masculine penthemimeral
αὐτὰρ ἔπειτα θρόνους περικαλλέας ἠδὲ τραπέζας	-u u-u u- uu-uu -u u--	dactylic hexameter	masculine penthemimeral
ὕδατι καὶ σπόγγοισι πολυτρήτοισι κάθαιρον.	-uu - --u u---u u--	dactylic hexameter	feminine penthemimeral, trithemimeral
αὐτὰρ Τηλέμαχος καὶ βουκόλος ἠδὲ συβώτης	-- -uu- - -uu -u u--	dactylic hexameter	masculine penthemimeral
λίστροισιν δάπεδον πύκα ποιητοῖο δόμοιο	--- uu- uu ---u u--	dactylic hexameter	masculine penthemimeral, trithemimeral
ξῦον· ταὶ δ’ἐφόρεον δμῳαί, τίθεσαν δὲ θύραζε.	-- - uu- -- uu- u u--	dactylic hexameter	masculine penthemimeral, hepthemimeral, trithemimeral
αὐτὰρ ἐπεὶ δὴ πᾶν μέγαρον διεκοσμήσαντο,	-u u- - - uu- uu----	dactylic hexameter	masculine penthemimeral, hepthemimeral, trithemimeral
δμῳὰς ἐξαγαγόντες ἐϋσταθέος μεγάροιο,	-- -uu-u u-uu- uu--	dactylic hexameter	feminine penthemimeral
μεσσηγύς τε θόλου καὶ ἀμύμονος ἕρκεος αὐλῆς,	--- u u- u u-uu -uu --	dactylic hexameter	masculine penthemimeral, trithemimeral
εἴλεον ἐν στείνει, ὅθεν οὔ πως ἦεν ἀλύξαι.	-uu - -- uu - - -u u--	dactylic hexameter	masculine penthemimeral, hepthemimeral, trithemimeral
τοῖσι δὲ Τηλέμαχος πεπνυμένος ἦρχ’ ἀγορεύειν·	-u u -uu- --uu - uu--	dactylic hexameter	masculine penthemimeral
μὴ μὲν δὴ καθαρῷ θανάτῳ ἀπὸ θυμὸν ἑλοίμην	- - - uu- uu- uu -u u--	dactylic hexameter	masculine penthemimeral, hepthemimeral, trithemimeral
τάων, αἳ δὴ ἐμῇ κεφαλῇ κατ’ ὀνείδεα χεῦαν	-- - u u- uu- u u-uu --	dactylic hexameter	masculine penthemimeral, hepthemimeral, trithemimeral
μητέρι θ’ἡμετέρῃ παρά τε μνηστῆρσιν ἴαυον.	-uu -uu- uu - --u u--	dactylic hexameter	masculine penthemimeral, hepthemimeral
ὣς ἄρ’ ἔφη, καὶ πεῖσμα νεὸς κυανοπρώροιο	- u u- - -u u- uu----	dactylic hexameter	feminine penthemimeral, hepthemimeral, trithemimeral
κίονος ἐξάψας μεγάλης περίβαλλε θόλοιο,	-uu --- uu- uu-u u--	dactylic hexameter	masculine penthemimeral, hepthemimeral
ὑψόσ’ ἐπεντανύσας, μή τις ποσὶν οὖδας ἵκοιτο.	-u u-uu- - - uu -u u--	dactylic hexameter	masculine penthemimeral, hepthemimeral
ὡς δ’ὅτ’ ἂν ἢ κίχλαι τανυσίπτεροι ἠὲ πέλειαι	- u u - -- uu-uu -u u--	dactylic hexameter	masculine penthemimeral, trithemimeral
ἕρκει ἐνιπλήξωσι, τό δ’ἑστήκῃ ἐνὶ θάμνῳ,	-u u---u u --- uu --	dactylic hexameter	feminine penthemimeral
αὖλιν ἐσιέμεναι, στυγερὸς δ’ὑπεδέξατο κοῖτος,	-u u-uu- uu- uu-uu --	dactylic hexameter	masculine penthemimeral, hepthemimeral
ὣς αἵ γ’ἑξείης κεφαλὰς ἔχον, ἀμφὶ δὲ πάσαις	- - --- uu- uu -u u --	dactylic hexameter	masculine penthemimeral, hepthemimeral
δειρῇσι βρόχοι ἦσαν, ὅπως οἴκτιστα θάνοιεν.	--- uu -u u- --u u--	dactylic hexameter	feminine penthemimeral, hepthemimeral, trithemimeral
ἤσπαιρον δὲ πόδεσσι μίνυνθά περ οὔ τι μάλα δήν.	--- u u-u u-u u - u u- -	dactylic hexameter	feminine penthemimeral, trithemimeral
ἐκ δὲ Μελάνθιον ἦγον ἀνὰ πρόθυρόν τε καὶ αὐλήν·	- u u-uu -u u- uu- u u --	dactylic hexameter	feminine penthemimeral, hepthemimeral
τοῦ δ’ἀπὸ μὲν ῥῖνάς τε καὶ οὔατα νηλέϊ χαλκῷ	- uu - -- u u -uu -uu --	dactylic hexameter	masculine penthemimeral, trithemimeral
τάμνον, μήδεά τ’ἐξέρυσαν, κυσὶν ὠμὰ δάσασθαι,	-- -uu -uu- uu -u u--	dactylic hexameter	hepthemimeral
χεῖράς τ’ἠδὲ πόδας κόπτον κεκοτηότι θυμῷ.	-- -u u- -- uu-uu --	dactylic hexameter	masculine penthemimeral, hepthemimeral
οἱ μὲν ἔπειτ’ ἀπονιψάμενοι χεῖράς τε πόδας τε	- u u- uu-uu- -- u u- -	dactylic hexameter	hepthemimeral, trithemimeral
εἰς Ὀδυσῆα δόμονδε κίον, τετέλεστο δὲ ἔργον·	- uu-u u-u u- uu-u u --	dactylic hexameter	feminine penthemimeral, hepthemimeral
αὐτὰρ ὅ γε προσέειπε φίλην τροφὸν Εὐρύκλειαν·	-u u - uu-u u- uu ----	dactylic hexameter	feminine penthemimeral, hepthemimeral, trithemimeral
οἶσε θέειον, γρηΰ, κακῶν ἄκος, οἶσε δέ μοι πῦρ,	-u u-- -u u- uu -u u - -	dactylic hexameter	feminine penthemimeral, hepthemimeral
ὄφρα θεειώσω μέγαρον· σὺ δὲ Πηνελόπειαν	-u u--- uu- u u -uu--	dactylic hexameter	masculine penthemimeral, hepthemimeral
ἐλθεῖν ἐνθάδ’ ἄνωχθι σὺν ἀμφιπόλοισι γυναιξί·	-- -u u-u u -uu-u u--	dactylic hexameter	feminine penthemimeral
πάσας δ’ὄτρυνον δμῳὰς κατὰ δῶμα νέεσθαι.	-- --- -- uu -u u--	dactylic hexameter	masculine penthemimeral, hepthemimeral
τὸν δ’αὖτε προσέειπε φίλη τροφὸς Εὐρύκλεια·	- -- uu-u u- uu ----	dactylic hexameter	feminine penthemimeral, hepthemimeral, trithemimeral
ναὶ δὴ ταῦτά γε, τέκνον ἐμόν, κατὰ μοῖραν ἔειπες.	- - -u u -u u- uu -u u--	dactylic hexameter	feminine penthemimeral, hepthemimeral
ἀλλ’ ἄγε τοι χλαῖνάν τε χιτῶνά τε εἵματ’ ἐνείκω,	- uu - -- u u-u u -u u--	dactylic hexameter	masculine penthemimeral, trithemimeral
μηδ’ οὕτω ῥάκεσιν πεπυκασμένος εὐρέας ὤμους	- -- uu- uu-uu -uu --	dactylic hexameter	masculine penthemimeral, trithemimeral
ἕσταθ’ ἐνὶ μεγάροισι· νεμεσσητὸν δέ κεν εἴη.	-u u- uu-u u--- u u --	dactylic hexameter	feminine penthemimeral, trithemimeral
τὴν δ’ἀπαμειβόμενος προσέφη πολύμητις Ὀδυσσεύς·	- uu-uu- uu- uu-u u--	dactylic hexameter	masculine penthemimeral, hepthemimeral
πῦρ νῦν μοι πρώτιστον ἐνὶ μεγάροισι γενέσθω.	- - - --u u- uu-u u--	dactylic hexameter	feminine penthemimeral, hepthemimeral, trithemimeral
ὣς ἔφατ’, οὐδ’ ἀπίθησε φίλη τροφὸς Εὐρύκλεια,	- uu - uu-u u- uu ----	dactylic hexameter	feminine penthemimeral, hepthemimeral, trithemimeral
ἤνεικεν δ’ἄρα πῦρ καὶ θήϊον· αὐτὰρ Ὀδυσσεὺς	--- uu - - -uu -u u--	dactylic hexameter	masculine penthemimeral, trithemimeral
εὖ διεθείωσεν μέγαρον καὶ δῶμα καὶ αὐλήν.	- uu--- uu- - -u u --	dactylic hexameter	masculine penthemimeral, hepthemimeral
γρηῢς δ’αὖτ’ ἀπέβη διὰ δώματα κάλ’ Ὀδυσῆος	-- - uu- uu -uu - uu--	dactylic hexameter	masculine penthemimeral, trithemimeral
ἀγγελέουσα γυναιξὶ καὶ ὀτρυνέουσα νέεσθαι·	-uu-u u-u u -uu-u u--	dactylic hexameter	feminine penthemimeral
αἱ δ’ἴσαν ἐκ μεγάροιο δάος μετὰ χερσὶν ἔχουσαι.	- uu - uu-u u- uu -u u--	dactylic hexameter	feminine penthemimeral, hepthemimeral, trithemimeral
αἱ μὲν ἄρ’ ἀμφεχέοντο καὶ ἠσπάζοντ’ Ὀδυσῆα,	- u u -uu-u u --- uu--	dactylic hexameter	feminine penthemimeral
καὶ κύνεον ἀγαπαζόμεναι κεφαλήν τε καὶ ὤμους	- -- uu-uu- uu- u u --	dactylic hexameter	hepthemimeral, trithemimeral
χεῖράς τ’αἰνύμεναι· τὸν δὲ γλυκὺς ἵμερος ᾕρει	-- -uu- - - uu -uu --	dactylic hexameter	masculine penthemimeral, hepthemimeral
κλαυθμοῦ καὶ στοναχῆς, γίνωσκε δ’ἄρα φρεσὶ πάσας.	-- - uu- --u u- uu --	dactylic hexameter	masculine penthemimeral, trithemimeral
