οἱ δ’ἷξον κοίλην Λακεδαίμονα κητώεσσαν,	- -- -- uu-uu ----	dactylic hexameter	masculine penthemimeral, trithemimeral
πρὸς δ’ἄρα δώματ’ ἔλων Μενελάου κυδαλίμοιο.	- uu -u u- uu-- -uu--	dactylic hexameter	masculine penthemimeral
τὸν δ’εὗρον δαινύντα γάμον πολλοῖσιν ἔτῃσιν	- -- --u u- --u u--	dactylic hexameter	feminine penthemimeral, hepthemimeral, trithemimeral
υἱέος ἠδὲ θυγατρὸς ἀμύμονος ᾧ ἐνὶ οἴκῳ.	-uu -u u-u u-uu - uu --	dactylic hexameter	feminine penthemimeral
τὴν μὲν Ἀχιλλῆος ῥηξήνορος υἱέι πέμπεν·	- u u--- --uu -uu --	dactylic hexameter	masculine penthemimeral
ἐν Τροίῃ γὰρ πρῶτον ὑπέσχετο καὶ κατένευσε	- -- - -u u-uu - uu--	dactylic hexameter	feminine penthemimeral, trithemimeral
δωσέμεναι, τοῖσιν δὲ θεοὶ γάμον ἐξετέλειον.	-uu- -- u u- uu -uu--	dactylic hexameter	masculine penthemimeral, hepthemimeral, trithemimeral
τὴν ἄρ’ ὅ γ’ἔνθ’ ἵπποισι καὶ ἅρμασι πέμπε νέεσθαι	- u u - --u u -uu -u u--	dactylic hexameter	feminine penthemimeral, trithemimeral
Μυρμιδόνων προτὶ ἄστυ περικλυτόν, οἷσιν ἄνασσεν.	-uu- uu -u u-uu -u u--	dactylic hexameter	feminine penthemimeral, trithemimeral
υἱέι δὲ Σπάρτηθεν Ἀλέκτορος ἤγετο κούρην,	-uu - --u u-uu -uu --	dactylic hexameter	feminine penthemimeral, trithemimeral
ὅς οἱ τηλύγετος γένετο κρατερὸς Μεγαπένθης	- - -uu- uu- uu- uu--	dactylic hexameter	masculine penthemimeral, hepthemimeral
ἐκ δούλης· Ἑλένῃ δὲ θεοὶ γόνον οὐκέτ’ ἔφαινον,	- -- uu- u u- uu -u u--	dactylic hexameter	masculine penthemimeral, hepthemimeral, trithemimeral
ἐπεὶ δὴ τὸ πρῶτον ἐγείνατο παῖδ’ ἐρατεινήν,	-- - - -u u-uu - uu--	dactylic hexameter	feminine penthemimeral, trithemimeral
Ἑρμιόνην, ἣ εἶδος ἔχε χρυσῆς Ἀφροδίτης.	-uu- - -u u- -- uu--	dactylic hexameter	feminine penthemimeral, hepthemimeral, trithemimeral
ὣς οἱ μὲν δαίνυντο καθ’ ὑψερεφὲς μέγα δῶμα	- - - --u u -uu- uu --	dactylic hexameter	feminine penthemimeral, trithemimeral
γείτονες ἠδὲ ἔται Μενελάου κυδαλίμοιο,	-uu -u u- uu-- -uu--	dactylic hexameter	masculine penthemimeral
τερπόμενοι· μετὰ δέ σφιν ἐμέλπετο θεῖος ἀοιδὸς	-uu- uu - u u-uu -u u--	dactylic hexameter	masculine penthemimeral, trithemimeral
φορμίζων, δοιὼ δὲ κυβιστητῆρε κατ’ αὐτούς,	--- -- u u---u u --	dactylic hexameter	masculine penthemimeral, trithemimeral
μολπῆς ἐξάρχοντες, ἐδίνευον κατὰ μέσσον.	-- ---u u--- uu --	dactylic hexameter	feminine penthemimeral
τὼ δ’αὖτ’ ἐν προθύροισι δόμων αὐτώ τε καὶ ἵππω,	- - - uu-u u- -- u u --	dactylic hexameter	feminine penthemimeral, hepthemimeral, trithemimeral
Τηλέμαχός θ’ἥρως καὶ Νέστορος ἀγλαὸς υἱός,	-uu- -- - -uu -uu --	dactylic hexameter	masculine penthemimeral, trithemimeral
στῆσαν· ὁ δὲ προμολὼν ἴδετο κρείων Ἐτεωνεύς,	-u u - uu- uu- -- uu--	dactylic hexameter	masculine penthemimeral, hepthemimeral, trithemimeral
ὀτρηρὸς θεράπων Μενελάου κυδαλίμοιο,	--- uu- uu-- -uu--	dactylic hexameter	masculine penthemimeral, trithemimeral
βῆ δ’ἴμεν ἀγγελέων διὰ δώματα ποιμένι λαῶν,	- uu -uu- uu -uu -uu --	dactylic hexameter	masculine penthemimeral
ἀγχοῦ δ’ἱστάμενος ἔπεα πτερόεντα προσηύδα·	-- -uu- uu- uu-u u--	dactylic hexameter	masculine penthemimeral, hepthemimeral
ξείνω δή τινε τώδε, διοτρεφὲς ὦ Μενέλαε,	-- - uu -u u-uu - uu--	dactylic hexameter	feminine penthemimeral, trithemimeral
ἄνδρε δύω, γενεῇ δὲ Διὸς μεγάλοιο ἔικτον.	-u u- uu- u u- uu-u u--	dactylic hexameter	masculine penthemimeral, hepthemimeral, trithemimeral
ἀλλ’ εἴπ’, ἤ σφωιν καταλύσομεν ὠκέας ἵππους,	- - - -- uu-uu -uu --	dactylic hexameter	masculine penthemimeral, trithemimeral
ἦ ἄλλον πέμπωμεν ἱκανέμεν, ὅς κε φιλήσῃ.	- -- --u u-uu - u u--	dactylic hexameter	feminine penthemimeral, trithemimeral
τὸν δὲ μέγ’ ὀχθήσας προσέφη ξανθὸς Μενέλαος·	- u u --- uu- -- uu--	dactylic hexameter	masculine penthemimeral, hepthemimeral
οὐ μὲν νήπιος ἦσθα, Βοηθοΐδη Ἐτεωνεῦ,	- - -uu -u u-uu- uu--	dactylic hexameter	feminine penthemimeral
τὸ πρίν· ἀτὰρ μὲν νῦν γε πάϊς ὣς νήπια βάζεις.	- u u- - - u u- - -uu --	dactylic hexameter	masculine penthemimeral, hepthemimeral, trithemimeral
ἦ μὲν δὴ νῶι ξεινήια πολλὰ φαγόντες	- - - -- --uu -u u--	dactylic hexameter	masculine penthemimeral, trithemimeral
ἄλλων ἀνθρώπων δεῦρ’ ἱκόμεθ’, αἴ κέ ποθι Ζεὺς	-- --- - -uu - u u- -	dactylic hexameter	masculine penthemimeral
ἐξοπίσω περ παύσῃ ὀιζύος. ἀλλὰ λύ’ ἵππους	-uu- - -u u-uu -u u --	dactylic hexameter	feminine penthemimeral, trithemimeral
ξείνων, ἐς δ’αὐτοὺς προτέρω ἄγε θοινηθῆναι.	-- - -- uu- uu ----	dactylic hexameter	masculine penthemimeral, hepthemimeral, trithemimeral
ὣς φάθ’, ὁ δ’ἐκ μεγάροιο διέσσυτο, κέκλετο δ’ἄλλους	- u u - uu-u u-uu -uu --	dactylic hexameter	feminine penthemimeral, trithemimeral
ὀτρηροὺς θεράποντας ἅμα σπέσθαι ἑοῖ αὐτῷ.	--- uu-u u- -- - --	dactylic hexameter	feminine penthemimeral, hepthemimeral, trithemimeral
οἱ δ’ἵππους μὲν λῦσαν ὑπὸ ζυγοῦ ἱδρώοντας,	- -- - -u u- uu ----	dactylic hexameter	feminine penthemimeral, hepthemimeral, trithemimeral
καὶ τοὺς μὲν κατέδησαν ἐφ’ ἱππείῃσι κάπῃσι,	- - - uu-u u ---u u--	dactylic hexameter	feminine penthemimeral, trithemimeral
πὰρ δ’ἔβαλον ζειάς, ἀνὰ δὲ κρῖ λευκὸν ἔμιξαν,	- uu- -- uu - - -u u--	dactylic hexameter	masculine penthemimeral, hepthemimeral, trithemimeral
ἅρματα δ’ἔκλιναν πρὸς ἐνώπια παμφανόωντα,	-uu --- u u-uu -uu--	dactylic hexameter	masculine penthemimeral
αὐτοὺς δ’εἰσῆγον θεῖον δόμον. οἱ δὲ ἰδόντες	-- --- -- uu - u u--	dactylic hexameter	masculine penthemimeral, hepthemimeral
θαύμαζον κατὰ δῶμα διοτρεφέος βασιλῆος·	--- uu -u u-uu- uu--	dactylic hexameter	feminine penthemimeral, trithemimeral
ὥς τε γὰρ ἠελίου αἴγλη πέλεν ἠὲ σελήνης	- u u -uu- -- uu -u u--	dactylic hexameter	masculine penthemimeral, hepthemimeral
δῶμα καθ’ ὑψερεφὲς Μενελάου κυδαλίμοιο.	-u u -uu- uu-- -uu--	dactylic hexameter	masculine penthemimeral
αὐτὰρ ἐπεὶ τάρπησαν ὁρώμενοι ὀφθαλμοῖσιν,	-u u- --u u-uu ----	dactylic hexameter	feminine penthemimeral, trithemimeral
ἔς ῥ’ἀσαμίνθους βάντες ἐυξέστας λούσαντο.	- uu-- -u u--- ---	dactylic hexameter	feminine penthemimeral
τοὺς δ’ἐπεὶ οὖν δμῳαὶ λοῦσαν καὶ χρῖσαν ἐλαίῳ,	- uu - -- -- - -u u--	dactylic hexameter	masculine penthemimeral, hepthemimeral, trithemimeral
ἀμφὶ δ’ἄρα χλαίνας οὔλας βάλον ἠδὲ χιτῶνας,	-u u- -- -- uu -u u--	dactylic hexameter	masculine penthemimeral, hepthemimeral, trithemimeral
ἔς ῥα θρόνους ἕζοντο παρ’ Ἀτρεΐδην Μενέλαον.	- u u- --u u -uu- uu--	dactylic hexameter	feminine penthemimeral, trithemimeral
χέρνιβα δ’ἀμφίπολος προχόῳ ἐπέχευε φέρουσα	-uu -uu- uu- uu-u u--	dactylic hexameter	masculine penthemimeral, hepthemimeral
καλῇ χρυσείῃ ὑπὲρ ἀργυρέοιο λέβητος,	-- --- uu -uu-u u--	dactylic hexameter	masculine penthemimeral
νίψασθαι· παρὰ δὲ ξεστὴν ἐτάνυσσε τράπεζαν.	--- uu - -- uu-u u--	dactylic hexameter	masculine penthemimeral, hepthemimeral, trithemimeral
σῖτον δ’αἰδοίη ταμίη παρέθηκε φέρουσα,	-- --- uu- uu-u u--	dactylic hexameter	masculine penthemimeral, hepthemimeral
εἴδατα πόλλ’ ἐπιθεῖσα, χαριζομένη παρεόντων.	-uu - uu-u u-uu- uu--	dactylic hexameter	feminine penthemimeral, trithemimeral
δαιτρὸς δὲ κρειῶν πίνακας παρέθηκεν ἀείρας	-- - -- uu- uu-u u--	dactylic hexameter	masculine penthemimeral, hepthemimeral, trithemimeral
παντοίων, παρὰ δέ σφι τίθει χρύσεια κύπελλα.	--- uu - u u- --u u--	dactylic hexameter	masculine penthemimeral, hepthemimeral, trithemimeral
τὼ καὶ δεικνύμενος προσέφη ξανθὸς Μενέλαος·	- - -uu- uu- -- uu--	dactylic hexameter	masculine penthemimeral, hepthemimeral
σίτου θ’ἅπτεσθον καὶ χαίρετον. αὐτὰρ ἔπειτα	-- --- - -uu -u u--	dactylic hexameter	masculine penthemimeral
δείπνου πασσαμένω εἰρησόμεθ’, οἵ τινές ἐστον	-- -uu- --uu - uu --	dactylic hexameter	masculine penthemimeral
ἀνδρῶν· οὐ γὰρ σφῶν γε γένος ἀπόλωλε τοκήων,	-- - - - u u- uu-u u--	dactylic hexameter	masculine penthemimeral, hepthemimeral, trithemimeral
ἀλλ’ ἀνδρῶν γένος ἐστὲ διοτρεφέων βασιλήων	- -- uu -u u-uu- uu--	dactylic hexameter	feminine penthemimeral, trithemimeral
σκηπτούχων, ἐπεὶ οὔ κε κακοὶ τοιούσδε τέκοιεν.	--- uu - u u- --u u--	dactylic hexameter	masculine penthemimeral, hepthemimeral, trithemimeral
ὣς φάτο, καί σφιν νῶτα βοὸς παρὰ πίονα θῆκεν	- uu - - -u u- uu -uu --	dactylic hexameter	feminine penthemimeral, hepthemimeral, trithemimeral
ὄπτ’ ἐν χερσὶν ἑλών, τά ῥά οἱ γέρα πάρθεσαν αὐτῷ.	- - -u u- u u - uu -uu --	dactylic hexameter	masculine penthemimeral, hepthemimeral
οἱ δ’ἐπ’ ὀνείαθ’ ἑτοῖμα προκείμενα χεῖρας ἴαλλον.	- u u-u u-u u-uu -u u--	dactylic hexameter	feminine penthemimeral
αὐτὰρ ἐπεὶ πόσιος καὶ ἐδητύος ἐξ ἔρον ἕντο,	-u u- uu- u u-uu - uu --	dactylic hexameter	masculine penthemimeral, trithemimeral
δὴ τότε Τηλέμαχος προσεφώνεε Νέστορος υἱόν,	- uu -uu- uu-uu -uu --	dactylic hexameter	masculine penthemimeral
ἄγχι σχὼν κεφαλήν, ἵνα μὴ πευθοίαθ’ οἱ ἄλλοι·	-- - uu- uu - --u u --	dactylic hexameter	masculine penthemimeral, hepthemimeral, trithemimeral
φράζεο, Νεστορίδη, τῷ ἐμῷ κεχαρισμένε θυμῷ,	-uu -uu- u u- uu-uu --	dactylic hexameter	masculine penthemimeral, hepthemimeral
χαλκοῦ τε στεροπὴν κατὰ δώματα ἠχήεντα	-- - uu- uu -uu ----	dactylic hexameter	masculine penthemimeral, trithemimeral
χρυσοῦ τ’ἠλέκτρου τε καὶ ἀργύρου ἠδ’ ἐλέφαντος.	-- --- u u -uu - uu--	dactylic hexameter	masculine penthemimeral
Ζηνός που τοιήδε γ’ Ὀλυμπίου ἔνδοθεν αὐλή,	-- - --u u-uu -uu --	dactylic hexameter	feminine penthemimeral, trithemimeral
ὅσσα τάδ’ ἄσπετα πολλά· σέβας μ’ἔχει εἰσορόωντα.	-u u -uu -u u- uu -uu--	dactylic hexameter	feminine penthemimeral, hepthemimeral
τοῦ δ’ἀγορεύοντος ξύνετο ξανθὸς Μενέλαος,	- uu--- uu- -- uu--	dactylic hexameter	masculine penthemimeral, hepthemimeral
καί σφεας φωνήσας ἔπεα πτερόεντα προσηύδα·	- - --- uu- uu-u u--	dactylic hexameter	masculine penthemimeral, hepthemimeral
τέκνα φίλ’, ἤτοι Ζηνὶ βροτῶν οὐκ ἄν τις ἐρίζοι·	-u u -- -u u- - - u u--	dactylic hexameter	feminine penthemimeral, hepthemimeral
ἀθάνατοι γὰρ τοῦ γε δόμοι καὶ κτήματ’ ἔασιν·	-uu- - - u u- - -u u--	dactylic hexameter	masculine penthemimeral, hepthemimeral, trithemimeral
ἀνδρῶν δ’ἤ κέν τίς μοι ἐρίσσεται, ἠὲ καὶ οὐκί,	-- - - - u u-uu -u u --	dactylic hexameter	masculine penthemimeral, trithemimeral
κτήμασιν. ἦ γὰρ πολλὰ παθὼν καὶ πόλλ’ ἐπαληθεὶς	-uu - - -u u- - - uu--	dactylic hexameter	feminine penthemimeral, hepthemimeral, trithemimeral
ἠγαγόμην ἐν νηυσὶ καὶ ὀγδοάτῳ ἔτει ἦλθον,	-uu- - -u u -uu- uu --	dactylic hexameter	feminine penthemimeral, trithemimeral
Κύπρον Φοινίκην τε καὶ Αἰγυπτίους ἐπαληθείς,	-- --- u u --- uu--	dactylic hexameter	masculine penthemimeral
Αἰθίοπάς θ’ἱκόμην καὶ Σιδονίους καὶ Ἐρεμβοὺς	-uu- uu- - -uu- u u--	dactylic hexameter	masculine penthemimeral, trithemimeral
καὶ Λιβύην, ἵνα τ’ἄρνες ἄφαρ κεραοὶ τελέθουσι.	- uu- uu -u u- uu- uu--	dactylic hexameter	feminine penthemimeral, hepthemimeral, trithemimeral
τρὶς γὰρ τίκτει μῆλα τελεσφόρον εἰς ἐνιαυτόν.	- - -- -u u-uu - uu--	dactylic hexameter	feminine penthemimeral
ἔνθα μὲν οὔτε ἄναξ ἐπιδευὴς οὔτε τι ποιμὴν	-u u -u u- uu-- -u u --	dactylic hexameter	masculine penthemimeral
τυροῦ καὶ κρειῶν οὐδὲ γλυκεροῖο γάλακτος,	-- - -- -- uu-u u--	dactylic hexameter	masculine penthemimeral, hepthemimeral, trithemimeral
ἀλλ’ αἰεὶ παρέχουσιν ἐπηετανὸν γάλα θῆσθαι.	- -- uu-u u-uu- uu --	dactylic hexameter	feminine penthemimeral, trithemimeral
ἦος ἐγὼ περὶ κεῖνα πολὺν βίοτον ξυναγείρων	-u u- uu -u u- uu- uu--	dactylic hexameter	feminine penthemimeral, hepthemimeral, trithemimeral
ἠλώμην, τείως μοι ἀδελφεὸν ἄλλος ἔπεφνε	--- -- u u-uu -u u--	dactylic hexameter	masculine penthemimeral, trithemimeral
λάθρῃ, ἀνωιστί, δόλῳ οὐλομένης ἀλόχοιο·	-u u--- uu -uu- uu--	dactylic hexameter	masculine penthemimeral
ὣς οὔ τοι χαίρων τοῖσδε κτεάτεσσιν ἀνάσσω.	- - - -- -- uu-u u--	dactylic hexameter	masculine penthemimeral, hepthemimeral, trithemimeral
καὶ πατέρων τάδε μέλλετ’ ἀκουέμεν, οἵ τινες ὑμῖν	- uu- uu -u u-uu - uu --	dactylic hexameter	feminine penthemimeral, trithemimeral
εἰσίν, ἐπεὶ μάλα πόλλ’ ἔπαθον, καὶ ἀπώλεσα οἶκον	-u u- uu - uu- u u-uu --	dactylic hexameter	masculine penthemimeral, hepthemimeral, trithemimeral
εὖ μάλα ναιετάοντα, κεχανδότα πολλὰ καὶ ἐσθλά.	- uu -uu-u u-uu -u u --	dactylic hexameter	feminine penthemimeral
ὧν ὄφελον τριτάτην περ ἔχων ἐν δώμασι μοῖραν	- uu- uu- u u- - -uu --	dactylic hexameter	masculine penthemimeral, hepthemimeral, trithemimeral
ναίειν, οἱ δ’ἄνδρες σόοι ἔμμεναι, οἳ τότ’ ὄλοντο	-- - -- uu -uu - u u--	dactylic hexameter	masculine penthemimeral, trithemimeral
Τροίῃ ἐν εὐρείῃ ἑκὰς Ἄργεος ἱπποβότοιο.	-u u --- uu -uu -uu--	dactylic hexameter	masculine penthemimeral
ἀλλ’ ἔμπης πάντας μὲν ὀδυρόμενος καὶ ἀχεύων	- -- -- u u-uu- u u--	dactylic hexameter	masculine penthemimeral, trithemimeral
πολλάκις ἐν μεγάροισι καθήμενος ἡμετέροισιν	-uu - uu-u u-uu -uu--	dactylic hexameter	feminine penthemimeral, trithemimeral
ἄλλοτε μέν τε γόῳ φρένα τέρπομαι, ἄλλοτε δ’αὖτε	-uu - u u- uu -uu -uu --	dactylic hexameter	masculine penthemimeral, trithemimeral
παύομαι· αἰψηρὸς δὲ κόρος κρυεροῖο γόοιο.	-uu --- u u- uu-u u--	dactylic hexameter	masculine penthemimeral, hepthemimeral
τῶν πάντων οὐ τόσσον ὀδύρομαι, ἀχνύμενός περ,	- -- - -u u-uu -uu- -	dactylic hexameter	feminine penthemimeral, trithemimeral
ὡς ἑνός, ὅς τέ μοι ὕπνον ἀπεχθαίρει καὶ ἐδωδὴν	- uu - u u -u u--- u u--	dactylic hexameter	feminine penthemimeral, trithemimeral
μνωομένῳ, ἐπεὶ οὔ τις Ἀχαιῶν τόσσ’ ἐμόγησεν,	-uu- uu - u u-- - uu--	dactylic hexameter	masculine penthemimeral, trithemimeral
ὅσσ’ Ὀδυσεὺς ἐμόγησε καὶ ἤρατο. τῷ δ’ἄρ’ ἔμελλεν	- uu- uu-u u -uu - u u--	dactylic hexameter	feminine penthemimeral, trithemimeral
αὐτῷ κήδε’ ἔσεσθαι, ἐμοὶ δ’ἄχος αἰὲν ἄλαστον	-- -u u-u u- uu -u u--	dactylic hexameter	feminine penthemimeral, hepthemimeral
κείνου, ὅπως δὴ δηρὸν ἀποίχεται, οὐδέ τι ἴδμεν,	-u u- - -u u-uu -u u --	dactylic hexameter	feminine penthemimeral, trithemimeral
ζώει ὅ γ’ἦ τέθνηκεν. ὀδύρονταί νύ που αὐτὸν	-u u - --u u--- u u --	dactylic hexameter	feminine penthemimeral, trithemimeral
Λαέρτης θ’ὁ γέρων καὶ ἐχέφρων Πηνελόπεια	--- u u- u u-- -uu--	dactylic hexameter	masculine penthemimeral, trithemimeral
Τηλέμαχός θ’,ὃν ἔλειπε νέον γεγαῶτ’ ἐνὶ οἴκῳ.	-uu- u u-u u- uu- uu --	dactylic hexameter	feminine penthemimeral, hepthemimeral, trithemimeral
ὣς φάτο, τῷ δ’ἄρα πατρὸς ὑφ’ ἵμερον ὦρσε γόοιο.	- uu - uu -u u -uu -u u--	dactylic hexameter	feminine penthemimeral, trithemimeral
δάκρυ δ’ἀπὸ βλεφάρων χαμάδις βάλε πατρὸς ἀκούσας,	-u u- uu- uu- uu -u u--	dactylic hexameter	masculine penthemimeral, hepthemimeral, trithemimeral
χλαῖναν πορφυρέην ἄντ’ ὀφθαλμοῖιν ἀνασχὼν	-- -uu- - ---u u--	dactylic hexameter	masculine penthemimeral
ἀμφοτέρῃσιν χερσί. νόησε δέ μιν Μενέλαος,	-uu-- -u u-u u - uu--	dactylic hexameter	feminine penthemimeral
μερμήριξε δ’ἔπειτα κατὰ φρένα καὶ κατὰ θυμόν,	---u u-u u- uu - uu --	dactylic hexameter	feminine penthemimeral, hepthemimeral
ἠέ μιν αὐτὸν πατρὸς ἐάσειε μνησθῆναι	-u u -- -u u--- ---	dactylic hexameter	feminine penthemimeral
ἦ πρῶτ’ ἐξερέοιτο ἕκαστά τε πειρήσαιτο.	- - -uu-u u-u u ----	dactylic hexameter	feminine penthemimeral
ἦος ὁ ταῦθ’ ὥρμαινε κατὰ φρένα καὶ κατὰ θυμόν,	-u u - --u u- uu - uu --	dactylic hexameter	feminine penthemimeral, hepthemimeral, trithemimeral
ἐκ δ’Ἑλένη θαλάμοιο θυώδεος ὑψορόφοιο	- uu- uu-u u-uu -uu--	dactylic hexameter	feminine penthemimeral, trithemimeral
ἤλυθεν Ἀρτέμιδι χρυσηλακάτῳ ἐικυῖα.	-uu -uu- --uu- uu--	dactylic hexameter	masculine penthemimeral
τῇ δ’ἄρ’ ἅμ’ Ἀδρήστη κλισίην εὔτυκτον ἔθηκεν,	- u u --- uu- --u u--	dactylic hexameter	masculine penthemimeral, hepthemimeral
Ἀλκίππη δὲ τάπητα φέρεν μαλακοῦ ἐρίοιο,	--- u u-u u- uu- uu--	dactylic hexameter	feminine penthemimeral, hepthemimeral, trithemimeral
Φυλὼ δ’ἀργύρεον τάλαρον φέρε, τόν οἱ ἔδωκεν	-- -uu- uu- uu - u u--	dactylic hexameter	masculine penthemimeral, hepthemimeral
Ἀλκάνδρη, Πολύβοιο δάμαρ, ὃς ἔναι’ ἐνὶ Θήβῃς	--- uu-u u- u u- uu --	dactylic hexameter	feminine penthemimeral, hepthemimeral, trithemimeral
Αἰγυπτίῃς, ὅθι πλεῖστα δόμοις ἐν κτήματα κεῖται·	--- uu -u u- - -uu --	dactylic hexameter	feminine penthemimeral, hepthemimeral, trithemimeral
ὃς Μενελάῳ δῶκε δύ’ ἀργυρέας ἀσαμίνθους,	- uu-- -u u -uu- uu--	dactylic hexameter	feminine penthemimeral
δοιοὺς δὲ τρίποδας, δέκα δὲ χρυσοῖο τάλαντα.	-- - uu- uu - --u u--	dactylic hexameter	masculine penthemimeral, hepthemimeral, trithemimeral
χωρὶς δ’αὖθ’ Ἑλένῃ ἄλοχος πόρε κάλλιμα δῶρα·	-- - uu- uu- uu -uu --	dactylic hexameter	masculine penthemimeral, hepthemimeral, trithemimeral
χρυσῆν τ’ἠλακάτην τάλαρόν θ’ὑπόκυκλον ὄπασσεν	-- -uu- uu- uu-u u--	dactylic hexameter	masculine penthemimeral, hepthemimeral
ἀργύρεον, χρυσῷ δ’ἐπὶ χείλεα κεκράαντο.	-uu- -- uu -uu ----	dactylic hexameter	masculine penthemimeral, trithemimeral
τόν ῥά οἱ ἀμφίπολος Φυλὼ παρέθηκε φέρουσα	- u u -uu- -- uu-u u--	dactylic hexameter	masculine penthemimeral, hepthemimeral
νήματος ἀσκητοῖο βεβυσμένον· αὐτὰρ ἐπ’ αὐτῷ	-uu ---u u-uu -u u --	dactylic hexameter	feminine penthemimeral
ἠλακάτη τετάνυστο ἰοδνεφὲς εἶρος ἔχουσα.	-uu- uu-u u-uu -u u--	dactylic hexameter	feminine penthemimeral, trithemimeral
ἕζετο δ’ἐν κλισμῷ, ὑπὸ δὲ θρῆνυς ποσὶν ἦεν.	-uu - -- uu - -- uu --	dactylic hexameter	masculine penthemimeral, hepthemimeral, trithemimeral
αὐτίκα δ’ἥ γ’ἐπέεσσι πόσιν ἐρέεινεν ἕκαστα·	-uu - uu-u u- uu-u u--	dactylic hexameter	feminine penthemimeral, hepthemimeral, trithemimeral
ἴδμεν δή, Μενέλαε διοτρεφές, οἵ τινες οἵδε	-- - uu-u u-uu - uu --	dactylic hexameter	feminine penthemimeral, trithemimeral
ἀνδρῶν εὐχετόωνται ἱκανέμεν ἡμέτερον δῶ;	-- -uu-u u-uu -uu- -	dactylic hexameter	feminine penthemimeral
ψεύσομαι ἦ ἔτυμον ἐρέω; κέλεται δέ με θυμός.	-uu - uu- uu- uu- u u --	dactylic hexameter	masculine penthemimeral, hepthemimeral, trithemimeral
οὐ γάρ πώ τινά φημι ἐοικότα ὧδε ἰδέσθαι	- - - uu -u u-uu -u u--	dactylic hexameter	feminine penthemimeral, trithemimeral
οὔτ’ ἄνδρ’ οὔτε γυναῖκα, σέβας μ’ἔχει εἰσορόωσαν,	- - -u u-u u- uu -uu--	dactylic hexameter	feminine penthemimeral, hepthemimeral
ὡς ὅδ’ Ὀδυσσῆος μεγαλήτορος υἷι ἔοικε,	- u u--- uu-uu -u u--	dactylic hexameter	masculine penthemimeral
Τηλεμάχῳ, τὸν ἔλειπε νέον γεγαῶτ’ ἐνὶ οἴκῳ	-uu- u u-u u- uu- uu --	dactylic hexameter	feminine penthemimeral, hepthemimeral, trithemimeral
κεῖνος ἀνήρ, ὅτ’ ἐμεῖο κυνώπιδος εἵνεκ’ Ἀχαιοὶ	-u u- u u-u u-uu -u u--	dactylic hexameter	feminine penthemimeral, trithemimeral
ἤλθεθ’ ὑπὸ Τροίην πόλεμον θρασὺν ὁρμαίνοντες.	-u u- -- uu- uu ----	dactylic hexameter	masculine penthemimeral, hepthemimeral, trithemimeral
τὴν δ’ἀπαμειβόμενος προσέφη ξανθὸς Μενέλαος·	- uu-uu- uu- -- uu--	dactylic hexameter	masculine penthemimeral, hepthemimeral
οὕτω νῦν καὶ ἐγὼ νοέω, γύναι, ὡς σὺ ἐίσκεις·	-- - u u- uu- uu - u u--	dactylic hexameter	masculine penthemimeral, hepthemimeral, trithemimeral
κείνου γὰρ τοιοίδε πόδες τοιαίδε τε χεῖρες	-- - --u u- --u u --	dactylic hexameter	feminine penthemimeral, hepthemimeral, trithemimeral
ὀφθαλμῶν τε βολαὶ κεφαλή τ’ἐφύπερθέ τε χαῖται.	--- u u- uu- uu-u u --	dactylic hexameter	masculine penthemimeral, hepthemimeral, trithemimeral
καὶ νῦν ἤτοι ἐγὼ μεμνημένος ἀμφ’ Ὀδυσῆι	- - -u u- --uu - uu--	dactylic hexameter	masculine penthemimeral
μυθεόμην, ὅσα κεῖνος ὀιζύσας ἐμόγησεν	-uu- uu -u u--- uu--	dactylic hexameter	feminine penthemimeral, trithemimeral
ἀμφ’ ἐμοί, αὐτὰρ ὁ πυκνὸν ὑπ’ ὀφρύσι δάκρυον εἶβε,	- uu -u u -u u -uu -uu --	dactylic hexameter	feminine penthemimeral
χλαῖναν πορφυρέην ἄντ’ ὀφθαλμοῖιν ἀνασχών.	-- -uu- - ---u u--	dactylic hexameter	masculine penthemimeral
τὸν δ’αὖ Νεστορίδης Πεισίστρατος ἀντίον ηὔδα·	- - -uu- --uu -uu --	dactylic hexameter	masculine penthemimeral
Ἀτρεΐδη Μενέλαε διοτρεφές, ὄρχαμε λαῶν,	-uu- uu-u u-uu -uu --	dactylic hexameter	feminine penthemimeral, trithemimeral
κείνου μέν τοι ὅδ’ υἱὸς ἐτήτυμον, ὡς ἀγορεύεις·	-- - u u -u u-uu - uu--	dactylic hexameter	feminine penthemimeral, trithemimeral
ἀλλὰ σαόφρων ἐστί, νεμεσσᾶται δ’ἐνὶ θυμῷ	-u u-- -u u--- uu --	dactylic hexameter	feminine penthemimeral
ὧδ’ ἐλθὼν τὸ πρῶτον ἐπεσβολίας ἀναφαίνειν	- -- - -u u-uu- uu--	dactylic hexameter	feminine penthemimeral, trithemimeral
ἄντα σέθεν, τοῦ νῶι θεοῦ ὣς τερπόμεθ’ αὐδῇ.	-u u- - -u u- - -uu --	dactylic hexameter	feminine penthemimeral, hepthemimeral, trithemimeral
αὐτὰρ ἐμὲ προέηκε Γερήνιος ἱππότα Νέστωρ	-u u- uu-u u-uu -uu --	dactylic hexameter	feminine penthemimeral, trithemimeral
τῷ ἅμα πομπὸν ἕπεσθαι· ἐέλδετο γάρ σε ἰδέσθαι,	- uu -u u-u u-uu - u u--	dactylic hexameter	feminine penthemimeral
ὄφρα οἱ ἤ τι ἔπος ὑποθήσεαι ἠέ τι ἔργον.	-u u - u u- uu-uu -u u --	dactylic hexameter	masculine penthemimeral, trithemimeral
πολλὰ γὰρ ἄλγε’ ἔχει πατρὸς πάϊς οἰχομένοιο	-u u -u u- -- uu -uu--	dactylic hexameter	masculine penthemimeral, hepthemimeral
ἐν μεγάροις, ᾧ μὴ ἄλλοι ἀοσσητῆρες ἔωσιν,	- uu- u u -u u---u u--	dactylic hexameter	feminine penthemimeral, trithemimeral
ὡς νῦν Τηλεμάχῳ ὁ μὲν οἴχεται, οὐδέ οἱ ἄλλοι	- - -uu- u u -uu -u u --	dactylic hexameter	masculine penthemimeral
εἴσ’ οἵ κεν κατὰ δῆμον ἀλάλκοιεν κακότητα.	- - - uu -u u--- uu--	dactylic hexameter	feminine penthemimeral, trithemimeral
τὸν δ’ἀπαμειβόμενος προσέφη ξανθὸς Μενέλαος·	- uu-uu- uu- -- uu--	dactylic hexameter	masculine penthemimeral, hepthemimeral
ὢ πόποι, ἦ μάλα δὴ φίλου ἀνέρος υἱὸς ἐμὸν δῶ	- uu - uu - uu -uu -u u- -	dactylic hexameter	masculine penthemimeral, trithemimeral
ἵκεθ’, ὃς εἵνεκ’ ἐμεῖο πολέας ἐμόγησεν ἀέθλους·	-u u -u u-u u- uu-u u--	dactylic hexameter	feminine penthemimeral, hepthemimeral
καί μιν ἔφην ἐλθόντα φιλησέμεν ἔξοχα πάντων	- u u- --u u-uu -uu --	dactylic hexameter	feminine penthemimeral, trithemimeral
Ἀργείων, εἰ νῶιν ὑπεὶρ ἅλα νόστον ἔδωκε	--- - -u u- uu -u u--	dactylic hexameter	feminine penthemimeral, hepthemimeral, trithemimeral
νηυσὶ θοῇσι γενέσθαι Ὀλύμπιος εὐρύοπα Ζεύς.	-u u-u u-u u-uu -uu- -	dactylic hexameter	feminine penthemimeral
καί κέ οἱ Ἄργεϊ νάσσα πόλιν καὶ δώματ’ ἔτευξα,	- u u -uu -u u- - -u u--	dactylic hexameter	feminine penthemimeral, hepthemimeral
ἐξ Ἰθάκης ἀγαγὼν σὺν κτήμασι καὶ τέκεϊ ᾧ	- uu- uu- - -uu - uu- -	dactylic hexameter	masculine penthemimeral, trithemimeral
καὶ πᾶσιν λαοῖσι, μίαν πόλιν ἐξαλαπάξας,	- -- --u u- uu -uu--	dactylic hexameter	feminine penthemimeral, hepthemimeral, trithemimeral
αἳ περιναιετάουσιν, ἀνάσσονται δ’ἐμοὶ αὐτῷ.	- uu-uu-u u--- uu --	dactylic hexameter	feminine penthemimeral
καί κε θάμ’ ἐνθάδ’ ἐόντες ἐμισγόμεθ’· οὐδέ κεν ἡμέας	- u u -u u-u u-uu -u u --	dactylic hexameter	feminine penthemimeral
ἄλλο διέκρινεν φιλέοντέ τε τερπομένω τε,	-u u--- uu-u u -uu- -	dactylic hexameter	masculine penthemimeral
πρίν γ’ὅτε δὴ θανάτοιο μέλαν νέφος ἀμφεκάλυψεν.	- uu - uu-u u- uu -uu--	dactylic hexameter	feminine penthemimeral, hepthemimeral, trithemimeral
ἀλλὰ τὰ μέν που μέλλεν ἀγάσσασθαι θεὸς αὐτός,	-u u - - -u u--- uu --	dactylic hexameter	feminine penthemimeral, trithemimeral
ὃς κεῖνον δύστηνον ἀνόστιμον οἶον ἔθηκεν.	- -- --u u-uu -u u--	dactylic hexameter	feminine penthemimeral, trithemimeral
ὣς φάτο, τοῖσι δὲ πᾶσιν ὑφ’ ἵμερον ὦρσε γόοιο.	- uu -u u -u u -uu -u u--	dactylic hexameter	feminine penthemimeral
κλαῖε μὲν Ἀργείη Ἑλένη, Διὸς ἐκγεγαυῖα,	-u u --- uu- uu -uu--	dactylic hexameter	masculine penthemimeral, hepthemimeral
κλαῖε δὲ Τηλέμαχός τε καὶ Ἀτρεΐδης Μενέλαος,	-u u -uu- u u -uu- uu--	dactylic hexameter	masculine penthemimeral
οὐδ’ ἄρα Νέστορος υἱὸς ἀδακρύτω ἔχεν ὄσσε·	- uu -uu -u u--- uu --	dactylic hexameter	feminine penthemimeral
μνήσατο γὰρ κατὰ θυμὸν ἀμύμονος Ἀντιλόχοιο,	-uu - uu -u u-uu -uu--	dactylic hexameter	feminine penthemimeral, trithemimeral
τόν ῥ’Ἠοῦς ἔκτεινε φαεινῆς ἀγλαὸς υἱός·	- -- --u u-- -uu --	dactylic hexameter	feminine penthemimeral, trithemimeral
τοῦ ὅ γ’ἐπιμνησθεὶς ἔπεα πτερόεντ’ ἀγόρευεν·	- u u--- uu- uu- uu--	dactylic hexameter	masculine penthemimeral, hepthemimeral
Ἀτρεΐδη, περὶ μέν σε βροτῶν πεπνυμένον εἶναι	-uu- uu - u u- --uu --	dactylic hexameter	masculine penthemimeral, hepthemimeral, trithemimeral
Νέστωρ φάσχ’ ὁ γέρων, ὅτ’ ἐπιμνησαίμεθα σεῖο	-- - u u- u u---uu --	dactylic hexameter	masculine penthemimeral, trithemimeral
οἷσιν ἐνὶ μεγάροισι, καὶ ἀλλήλους ἐρέοιμεν.	-u u- uu-u u --- uu--	dactylic hexameter	feminine penthemimeral, trithemimeral
καὶ νῦν, εἴ τί που ἔστι, πίθοιό μοι· οὐ γὰρ ἔγωγε	- - - u u -u u-u u - u u--	dactylic hexameter	feminine penthemimeral, trithemimeral
τέρπομ’ ὀδυρόμενος μεταδόρπιος, ἀλλὰ καὶ ἠὼς	-u u-uu- uu-uu -u u --	dactylic hexameter	masculine penthemimeral
ἔσσεται ἠριγένεια· νεμεσσῶμαί γε μὲν οὐδὲν	-uu -uu-u u--- u u --	dactylic hexameter	feminine penthemimeral
κλαίειν ὅς κε θάνῃσι βροτῶν καὶ πότμον ἐπίσπῃ.	-- - u u-u u- - -u u--	dactylic hexameter	feminine penthemimeral, hepthemimeral, trithemimeral
τοῦτό νυ καὶ γέρας οἶον ὀιζυροῖσι βροτοῖσι,	-u u - uu -u u---u u--	dactylic hexameter	feminine penthemimeral, trithemimeral
κείρασθαί τε κόμην βαλέειν τ’ἀπὸ δάκρυ παρειῶν.	--- u u- uu- uu -u u--	dactylic hexameter	masculine penthemimeral, hepthemimeral, trithemimeral
καὶ γὰρ ἐμὸς τέθνηκεν ἀδελφεός, οὔ τι κάκιστος	- u u- --u u-uu - u u--	dactylic hexameter	feminine penthemimeral, trithemimeral
Ἀργείων· μέλλεις δὲ σὺ ἴδμεναι· οὐ γὰρ ἔγωγε	--- -- u u -uu - u u--	dactylic hexameter	masculine penthemimeral, trithemimeral
ἤντησ’ οὐδὲ ἴδον· περὶ δ’ἄλλων φασὶ γενέσθαι	-- -u u- uu -- -u u--	dactylic hexameter	masculine penthemimeral
Ἀντίλοχον, πέρι μὲν θείειν ταχὺν ἠδὲ μαχητήν.	-uu- uu - -- uu -u u--	dactylic hexameter	masculine penthemimeral, hepthemimeral, trithemimeral
τὸν δ’ἀπαμειβόμενος προσέφη ξανθὸς Μενέλαος·	- uu-uu- uu- -- uu--	dactylic hexameter	masculine penthemimeral, hepthemimeral
ὦ φίλ’, ἐπεὶ τόσα εἶπες, ὅσ’ ἂν πεπνυμένος ἀνὴρ	- u u- uu -u u - --uu --	dactylic hexameter	feminine penthemimeral, hepthemimeral, trithemimeral
εἴποι καὶ ῥέξειε, καὶ ὃς προγενέστερος εἴη·	-- - --u u - uu-uu --	dactylic hexameter	feminine penthemimeral, hepthemimeral, trithemimeral
τοίου γὰρ καὶ πατρός, ὃ καὶ πεπνυμένα βάζεις,	-- - - -u u - --uu --	dactylic hexameter	feminine penthemimeral, hepthemimeral, trithemimeral
ῥεῖα δ’ἀρίγνωτος γόνος ἀνέρος ᾧ τε Κρονίων	-u u--- uu -uu - u u--	dactylic hexameter	masculine penthemimeral
ὄλβον ἐπικλώσῃ γαμέοντί τε γεινομένῳ τε,	-u u--- uu-u u -uu- -	dactylic hexameter	masculine penthemimeral
ὡς νῦν Νέστορι δῶκε διαμπερὲς ἤματα πάντα	- - -uu -u u-uu -uu --	dactylic hexameter	feminine penthemimeral
αὐτὸν μὲν λιπαρῶς γηρασκέμεν ἐν μεγάροισιν,	-- - uu- --uu - uu--	dactylic hexameter	masculine penthemimeral, trithemimeral
υἱέας αὖ πινυτούς τε καὶ ἔγχεσιν εἶναι ἀρίστους.	-uu - uu- u u -uu -u u--	dactylic hexameter	masculine penthemimeral, trithemimeral
ἡμεῖς δὲ κλαυθμὸν μὲν ἐάσομεν, ὃς πρὶν ἐτύχθη,	-- - -- u u-uu - u u--	dactylic hexameter	masculine penthemimeral, trithemimeral
δόρπου δ’ἐξαῦτις μνησώμεθα, χερσὶ δ’ἐφ’ ὕδωρ	-- --- --uu -u u --	dactylic hexameter	masculine penthemimeral
χευάντων. μῦθοι δὲ καὶ ἠῶθέν περ ἔσονται	--- -- u u --- u u--	dactylic hexameter	masculine penthemimeral, trithemimeral
Τηλεμάχῳ καὶ ἐμοὶ διαειπέμεν ἀλλήλοισιν.	-uu- u u- uu-uu ----	dactylic hexameter	masculine penthemimeral, trithemimeral
ὣς ἔφατ’, Ἀσφαλίων δ’ἄρ ὕδωρ ἐπὶ χεῖρας ἔχευεν,	- uu -uu- u u- uu -u u--	dactylic hexameter	masculine penthemimeral, hepthemimeral
ὀτρηρὸς θεράπων Μενελάου κυδαλίμοιο.	--- uu- uu-- -uu--	dactylic hexameter	masculine penthemimeral, trithemimeral
οἱ δ’ἐπ’ ὀνείαθ’ ἑτοῖμα προκείμενα χεῖρας ἴαλλον.	- u u-u u-u u-uu -u u--	dactylic hexameter	feminine penthemimeral
ἔνθ’ αὖτ’ ἄλλ’ ἐνόησ’ Ἑλένη Διὸς ἐκγεγαυῖα·	- - - uu- uu- uu -uu--	dactylic hexameter	masculine penthemimeral, hepthemimeral, trithemimeral
αὐτίκ’ ἄρ’ εἰς οἶνον βάλε φάρμακον, ἔνθεν ἔπινον,	-u u - -- uu -uu -u u--	dactylic hexameter	masculine penthemimeral, trithemimeral
νηπενθές τ’ἄχολόν τε, κακῶν ἐπίληθον ἁπάντων.	--- uu- u u- uu-u u--	dactylic hexameter	masculine penthemimeral, hepthemimeral, trithemimeral
ὃς τὸ καταβρόξειεν, ἐπὴν κρητῆρι μιγείη,	- u u---u u- --u u--	dactylic hexameter	feminine penthemimeral, hepthemimeral
οὔ κεν ἐφημέριός γε βάλοι κατὰ δάκρυ παρειῶν,	- u u-uu- u u- uu -u u--	dactylic hexameter	masculine penthemimeral, hepthemimeral
οὐδ’ εἴ οἱ κατατεθναίη μήτηρ τε πατήρ τε,	- - - uu--- -- u u- -	dactylic hexameter	hepthemimeral, trithemimeral
οὐδ’ εἴ οἱ προπάροιθεν ἀδελφεὸν ἢ φίλον υἱὸν	- - - uu-u u-uu - uu --	dactylic hexameter	feminine penthemimeral, trithemimeral
χαλκῷ δηιόῳεν, ὁ δ’ὀφθαλμοῖσιν ὁρῷτο.	-- -uu-u u ---u u--	dactylic hexameter	feminine penthemimeral
τοῖα Διὸς θυγάτηρ ἔχε φάρμακα μητιόεντα,	-u u- uu- uu -uu -uu--	dactylic hexameter	masculine penthemimeral, trithemimeral
ἐσθλά, τά οἱ Πολύδαμνα πόρεν, Θῶνος παράκοιτις	-u u - uu-u u- -- uu--	dactylic hexameter	feminine penthemimeral, hepthemimeral, trithemimeral
Αἰγυπτίη, τῇ πλεῖστα φέρει ζείδωρος ἄρουρα	--- - -u u- --u u--	dactylic hexameter	feminine penthemimeral, hepthemimeral, trithemimeral
φάρμακα, πολλὰ μὲν ἐσθλὰ μεμιγμένα πολλὰ δὲ λυγρά·	-uu -u u -u u-uu -u u --	dactylic hexameter	feminine penthemimeral
ἰητρὸς δὲ ἕκαστος ἐπιστάμενος περὶ πάντων	--- u u-u u-uu- uu --	dactylic hexameter	feminine penthemimeral, trithemimeral
ἀνθρώπων· ἦ γὰρ Παιήονός εἰσι γενέθλης.	--- - - --uu -u u--	dactylic hexameter	masculine penthemimeral, trithemimeral
αὐτὰρ ἐπεί ῥ’ἐνέηκε κέλευσέ τε οἰνοχοῆσαι,	-u u- uu-u u-u u -uu--	dactylic hexameter	feminine penthemimeral, trithemimeral
ἐξαῦτις μύθοισιν ἀμειβομένη προσέειπεν·	--- --u u-uu- uu--	dactylic hexameter	feminine penthemimeral, trithemimeral
Ἀτρεΐδη Μενέλαε διοτρεφὲς ἠδὲ καὶ οἵδε	-uu- uu-u u-uu -u u --	dactylic hexameter	feminine penthemimeral, trithemimeral
ἀνδρῶν ἐσθλῶν παῖδες· ἀτὰρ θεὸς ἄλλοτε ἄλλῳ	-- -- -u u- uu -uu --	dactylic hexameter	feminine penthemimeral, hepthemimeral
Ζεὺς ἀγαθόν τε κακόν τε διδοῖ· δύναται γὰρ ἅπαντα·	- uu- u u- u u- uu- u u--	dactylic hexameter	masculine penthemimeral, hepthemimeral, trithemimeral
ἤτοι νῦν δαίνυσθε καθήμενοι ἐν μεγάροισι	-- - --u u-uu - uu--	dactylic hexameter	feminine penthemimeral, trithemimeral
καὶ μύθοις τέρπεσθε· ἐοικότα γὰρ καταλέξω.	- -- --u u-uu - uu--	dactylic hexameter	feminine penthemimeral, trithemimeral
πάντα μὲν οὐκ ἂν ἐγὼ μυθήσομαι οὐδ’ ὀνομήνω,	-u u - u u- --uu - uu--	dactylic hexameter	masculine penthemimeral, trithemimeral
ὅσσοι Ὀδυσσῆος ταλασίφρονός εἰσιν ἄεθλοι·	-u u--- uu-uu -u u--	dactylic hexameter	masculine penthemimeral
ἀλλ’ οἷον τόδ’ ἔρεξε καὶ ἔτλη καρτερὸς ἀνὴρ	- -- u u-u u -- -uu --	dactylic hexameter	feminine penthemimeral, trithemimeral
δήμῳ ἔνι Τρώων, ὅθι πάσχετε πήματ’ Ἀχαιοί.	-u u- -- uu -uu -u u--	dactylic hexameter	masculine penthemimeral, trithemimeral
αὐτόν μιν πληγῇσιν ἀεικελίῃσι δαμάσσας,	-- - --u u-uu-u u--	dactylic hexameter	feminine penthemimeral, trithemimeral
σπεῖρα κάκ’ ἀμφ’ ὤμοισι βαλών, οἰκῆι ἐοικώς,	-u u - --u u- --u u--	dactylic hexameter	feminine penthemimeral, hepthemimeral, trithemimeral
ἀνδρῶν δυσμενέων κατέδυ πόλιν εὐρυάγυιαν·	-- -uu- uu- uu -uu--	dactylic hexameter	masculine penthemimeral, hepthemimeral
ἄλλῳ δ’αὐτὸν φωτὶ κατακρύπτων ἤισκε,	-- -- -u u--- ---	dactylic hexameter	feminine penthemimeral
δέκτῃ, ὃς οὐδὲν τοῖος ἔην ἐπὶ νηυσὶν Ἀχαιῶν.	-u u -- -u u- uu -u u--	dactylic hexameter	feminine penthemimeral, hepthemimeral
τῷ ἴκελος κατέδυ Τρώων πόλιν, οἱ δ’ἀβάκησαν	- uu- uu- -- uu - uu--	dactylic hexameter	masculine penthemimeral, hepthemimeral, trithemimeral
πάντες· ἐγὼ δέ μιν οἴη ἀνέγνων τοῖον ἐόντα,	-u u- u u -u u-- -u u--	dactylic hexameter	feminine penthemimeral, trithemimeral
καί μιν ἀνειρώτευν· ὁ δὲ κερδοσύνῃ ἀλέεινεν.	- u u--- u u -uu- uu--	dactylic hexameter	masculine penthemimeral
ἀλλ’ ὅτε δή μιν ἐγὼ λόεον καὶ χρῖον ἐλαίῳ,	- uu - u u- uu- - -u u--	dactylic hexameter	masculine penthemimeral, hepthemimeral, trithemimeral
ἀμφὶ δὲ εἵματα ἕσσα καὶ ὤμοσα καρτερὸν ὅρκον	-u u -uu -u u -uu -uu --	dactylic hexameter	feminine penthemimeral
μὴ μὲν πρὶν Ὀδυσῆα μετὰ Τρώεσσ’ ἀναφῆναι,	- - - uu-u u- -- uu--	dactylic hexameter	feminine penthemimeral, hepthemimeral, trithemimeral
πρίν γε τὸν ἐς νῆάς τε θοὰς κλισίας τ’ἀφικέσθαι,	- u u - -- u u- uu- uu--	dactylic hexameter	masculine penthemimeral, hepthemimeral, trithemimeral
καὶ τότε δή μοι πάντα νόον κατέλεξεν Ἀχαιῶν.	- uu - - -u u- uu-u u--	dactylic hexameter	feminine penthemimeral, hepthemimeral, trithemimeral
πολλοὺς δὲ Τρώων κτείνας ταναήκεϊ χαλκῷ	-- - -- -- uu-uu --	dactylic hexameter	masculine penthemimeral, hepthemimeral, trithemimeral
ἦλθε μετ’ Ἀργείους, κατὰ δὲ φρόνιν ἤγαγε πολλήν.	-u u --- uu - uu -uu --	dactylic hexameter	masculine penthemimeral, hepthemimeral
ἔνθ’ ἄλλαι Τρῳαὶ λίγ’ ἐκώκυον· αὐτὰρ ἐμὸν κῆρ	- -- -- u u-uu -u u- -	dactylic hexameter	masculine penthemimeral, trithemimeral
χαῖρ’, ἐπεὶ ἤδη μοι κραδίη τέτραπτο νέεσθαι	- uu -- - uu- --u u--	dactylic hexameter	masculine penthemimeral, hepthemimeral
ἂψ οἶκόνδ’, ἄτην δὲ μετέστενον, ἣν Ἀφροδίτη	- -- -- u u-uu - uu--	dactylic hexameter	masculine penthemimeral, trithemimeral
δῶχ’, ὅτε μ’ἤγαγε κεῖσε φίλης ἀπὸ πατρίδος αἴης,	- uu -uu -u u- uu -uu --	dactylic hexameter	feminine penthemimeral, hepthemimeral
παῖδά τ’ἐμὴν νοσφισσαμένην θάλαμόν τε πόσιν τε	-u u- --uu- uu- u u- -	dactylic hexameter	hepthemimeral, trithemimeral
οὔ τευ δευόμενον, οὔτ’ ἂρ φρένας οὔτε τι εἶδος.	- - -uu- - - uu -u u --	dactylic hexameter	masculine penthemimeral, hepthemimeral
τὴν δ’ἀπαμειβόμενος προσέφη ξανθὸς Μενέλαος·	- uu-uu- uu- -- uu--	dactylic hexameter	masculine penthemimeral, hepthemimeral
ναὶ δὴ ταῦτά γε πάντα, γύναι, κατὰ μοῖραν ἔειπες.	- - -u u -u u- uu -u u--	dactylic hexameter	feminine penthemimeral, hepthemimeral
ἤδη μὲν πολέων ἐδάην βουλήν τε νόον τε	-- - uu- uu- -- u u- -	dactylic hexameter	masculine penthemimeral, hepthemimeral, trithemimeral
ἀνδρῶν ἡρώων, πολλὴν δ’ἐπελήλυθα γαῖαν·	-- --- -- uu-uu --	dactylic hexameter	masculine penthemimeral, hepthemimeral
ἀλλ’ οὔ πω τοιοῦτον ἐγὼν ἴδον ὀφθαλμοῖσιν,	- - - --u u- uu ----	dactylic hexameter	feminine penthemimeral, hepthemimeral, trithemimeral
οἷον Ὀδυσσῆος ταλασίφρονος ἔσκε φίλον κῆρ.	-u u--- uu-uu -u u- -	dactylic hexameter	masculine penthemimeral
οἷον καὶ τόδ’ ἔρεξε καὶ ἔτλη καρτερὸς ἀνὴρ	-- - u u-u u -- -uu --	dactylic hexameter	feminine penthemimeral, trithemimeral
ἵππῳ ἔνι ξεστῷ, ἵν’ ἐνήμεθα πάντες ἄριστοι	-u u- -- u u-uu -u u--	dactylic hexameter	masculine penthemimeral, trithemimeral
Ἀργείων Τρώεσσι φόνον καὶ κῆρα φέροντες.	--- --u u- - -u u--	dactylic hexameter	feminine penthemimeral, hepthemimeral, trithemimeral
ἦλθες ἔπειτα σὺ κεῖσε· κελευσέμεναι δέ σ’ἔμελλε	-u u-u u -u u-uu- u u--	dactylic hexameter	feminine penthemimeral
δαίμων, ὃς Τρώεσσιν ἐβούλετο κῦδος ὀρέξαι·	-- - --u u-uu -u u--	dactylic hexameter	feminine penthemimeral, trithemimeral
καί τοι Δηΐφοβος θεοείκελος ἕσπετ’ ἰούσῃ.	- - -uu- uu-uu -u u--	dactylic hexameter	masculine penthemimeral
τρὶς δὲ περίστιξας κοῖλον λόχον ἀμφαφόωσα,	- u u--- -- uu -uu--	dactylic hexameter	masculine penthemimeral, hepthemimeral
ἐκ δ’ὀνομακλήδην Δαναῶν ὀνόμαζες ἀρίστους,	- uu--- uu- uu-u u--	dactylic hexameter	masculine penthemimeral, hepthemimeral
πάντων Ἀργείων φωνὴν ἴσκουσ’ ἀλόχοισιν.	-- --- -- -- uu--	dactylic hexameter	masculine penthemimeral, hepthemimeral
αὐτὰρ ἐγὼ καὶ Τυδεΐδης καὶ δῖος Ὀδυσσεὺς	-u u- - -uu- - -u u--	dactylic hexameter	hepthemimeral, trithemimeral
ἥμενοι ἐν μέσσοισιν ἀκούσαμεν ὡς ἐβόησας.	-uu - --u u-uu - uu--	dactylic hexameter	feminine penthemimeral, trithemimeral
νῶι μὲν ἀμφοτέρω μενεήναμεν ὁρμηθέντες	-u u -uu- uu-uu ----	dactylic hexameter	masculine penthemimeral
ἢ ἐξελθέμεναι, ἢ ἔνδοθεν αἶψ’ ὑπακοῦσαι·	- --uu- - -uu - uu--	dactylic hexameter	masculine penthemimeral
ἀλλ’ Ὀδυσεὺς κατέρυκε καὶ ἔσχεθεν ἱεμένω περ.	- uu- uu-u u -uu -uu- -	dactylic hexameter	feminine penthemimeral, trithemimeral
ἔνθ’ ἄλλοι μὲν πάντες ἀκὴν ἔσαν υἷες Ἀχαιῶν,	- -- - -u u- uu -u u--	dactylic hexameter	feminine penthemimeral, hepthemimeral, trithemimeral
Ἄντικλος δὲ σέ γ’οἶος ἀμείψασθαι ἐπέεσσιν	--- u u -u u--- uu--	dactylic hexameter	feminine penthemimeral, trithemimeral
ἤθελεν. ἀλλ’ Ὀδυσεὺς ἐπὶ μάστακα χερσὶ πίεζε	-uu - uu- uu -uu -u u--	dactylic hexameter	masculine penthemimeral, trithemimeral
νωλεμέως κρατερῇσι, σάωσε δὲ πάντας Ἀχαιούς·	-uu- uu-u u-u u -u u--	dactylic hexameter	feminine penthemimeral, trithemimeral
τόφρα δ’ἔχ’, ὄφρα σε νόσφιν ἀπήγαγε Παλλὰς Ἀθήνη.	-u u -u u -u u-uu -u u--	dactylic hexameter	feminine penthemimeral
τὸν δ’αὖ Τηλέμαχος πεπνυμένος ἀντίον ηὔδα·	- - -uu- --uu -uu --	dactylic hexameter	masculine penthemimeral
Ἀτρεΐδη Μενέλαε διοτρεφές, ὄρχαμε λαῶν,	-uu- uu-u u-uu -uu --	dactylic hexameter	feminine penthemimeral, trithemimeral
ἄλγιον· οὐ γάρ οἵ τι τό γ’ἤρκεσε λυγρὸν ὄλεθρον,	-uu - - - u u -uu -u u--	dactylic hexameter	masculine penthemimeral, trithemimeral
οὐδ’ εἴ οἱ κραδίη γε σιδηρέη ἔνδοθεν ἦεν.	- - - uu- u u-uu -uu --	dactylic hexameter	masculine penthemimeral, trithemimeral
ἀλλ’ ἄγετ’ εἰς εὐνὴν τράπεθ’ ἡμέας, ὄφρα καὶ ἤδη	- uu - -- uu -uu -u u --	dactylic hexameter	masculine penthemimeral, trithemimeral
ὕπνῳ ὕπο γλυκερῷ ταρπώμεθα κοιμηθέντες.	-u u- uu- --uu ----	dactylic hexameter	masculine penthemimeral, trithemimeral
ὣς ἔφατ’, Ἀργείη δ’Ἑλένη δμῳῇσι κέλευσε	- uu --- uu- --u u--	dactylic hexameter	masculine penthemimeral, hepthemimeral
δέμνι’ ὑπ’ αἰθούσῃ θέμεναι καὶ ῥήγεα καλὰ	-u u --- uu- - -uu --	dactylic hexameter	masculine penthemimeral, hepthemimeral
πορφύρε’ ἐμβαλέειν στορέσαι τ’ἐφύπερθε τάπητας,	-uu -uu- uu- uu-u u--	dactylic hexameter	masculine penthemimeral, hepthemimeral
χλαίνας τ’ἐνθέμεναι οὔλας καθύπερθεν ἕσασθαι.	-- -uu- -- uu-u u--	dactylic hexameter	masculine penthemimeral, hepthemimeral
αἱ δ’ἴσαν ἐκ μεγάροιο δάος μετὰ χερσὶν ἔχουσαι,	- uu - uu-u u- uu -u u--	dactylic hexameter	feminine penthemimeral, hepthemimeral, trithemimeral
δέμνια δ’ἐστόρεσαν· ἐκ δὲ ξείνους ἄγε κῆρυξ.	-uu -uu- - - -- uu --	dactylic hexameter	masculine penthemimeral, hepthemimeral
οἱ μὲν ἄρ’ ἐν προδόμῳ δόμου αὐτόθι κοιμήσαντο,	- u u - uu- uu -uu ----	dactylic hexameter	masculine penthemimeral, trithemimeral
Τηλέμαχός θ’ἥρως καὶ Νέστορος ἀγλαὸς υἱός·	-uu- -- - -uu -uu --	dactylic hexameter	masculine penthemimeral, trithemimeral
Ἀτρεΐδης δὲ καθεῦδε μυχῷ δόμου ὑψηλοῖο,	-uu- u u-u u- uu ----	dactylic hexameter	feminine penthemimeral, hepthemimeral, trithemimeral
πὰρ δ’Ἑλένη τανύπεπλος ἐλέξατο, δῖα γυναικῶν.	- uu- uu-u u-uu -u u--	dactylic hexameter	feminine penthemimeral, trithemimeral
ἦμος δ’ἠριγένεια φάνη ῥοδοδάκτυλος Ἠώς,	-- -uu-u u- uu-uu --	dactylic hexameter	feminine penthemimeral, hepthemimeral
ὤρνυτ’ ἄρ’ ἐξ εὐνῆφι βοὴν ἀγαθὸς Μενέλαος	-u u - --u u- uu- uu--	dactylic hexameter	feminine penthemimeral, hepthemimeral, trithemimeral
εἵματα ἑσσάμενος, περὶ δὲ ξίφος ὀξὺ θέτ’ ὤμῳ,	-uu -uu- uu - uu -u u --	dactylic hexameter	masculine penthemimeral, hepthemimeral
ποσσὶ δ’ὑπὸ λιπαροῖσιν ἐδήσατο καλὰ πέδιλα,	-u u- uu-u u-uu -u u--	dactylic hexameter	feminine penthemimeral, trithemimeral
βῆ δ’ἴμεν ἐκ θαλάμοιο θεῷ ἐναλίγκιος ἄντην,	- uu - uu-u u- uu-uu --	dactylic hexameter	feminine penthemimeral, hepthemimeral, trithemimeral
Τηλεμάχῳ δὲ παρῖζεν, ἔπος τ’ἔφατ’ ἔκ τ’ὀνόμαζε·	-uu- u u-u u- uu - uu--	dactylic hexameter	feminine penthemimeral, hepthemimeral, trithemimeral
τίπτε δέ σε χρειὼ δεῦρ’ ἤγαγε, Τηλέμαχ’ ἥρως,	-u u - -- - -uu -uu --	dactylic hexameter	masculine penthemimeral, trithemimeral
ἐς Λακεδαίμονα δῖαν, ἐπ’ εὐρέα νῶτα θαλάσσης;	- uu-uu -u u -uu -u u--	dactylic hexameter	feminine penthemimeral
δήμιον ἦ ἴδιον; τόδε μοι νημερτὲς ἐνίσπες.	-uu - uu- uu - --u u--	dactylic hexameter	masculine penthemimeral, hepthemimeral, trithemimeral
τὸν δ’αὖ Τηλέμαχος πεπνυμένος ἀντίον ηὔδα·	- - -uu- --uu -uu --	dactylic hexameter	masculine penthemimeral
Ἀτρεΐδη Μενέλαε διοτρεφές, ὄρχαμε λαῶν,	-uu- uu-u u-uu -uu --	dactylic hexameter	feminine penthemimeral, trithemimeral
ἤλυθον, εἴ τινά μοι κληηδόνα πατρὸς ἐνίσποις.	-uu - uu - --uu -u u--	dactylic hexameter	masculine penthemimeral, trithemimeral
ἐσθίεταί μοι οἶκος, ὄλωλε δὲ πίονα ἔργα,	-uu- - -u u-u u -uu --	dactylic hexameter	feminine penthemimeral, trithemimeral
δυσμενέων δ’ἀνδρῶν πλεῖος δόμος, οἵ τέ μοι αἰεὶ	-uu- -- -- uu - u u --	dactylic hexameter	masculine penthemimeral, hepthemimeral, trithemimeral
μῆλ’ ἁδινὰ σφάζουσι καὶ εἰλίποδας ἕλικας βοῦς,	- uu- --u u -uu- uu- -	dactylic hexameter	feminine penthemimeral, trithemimeral
μητρὸς ἐμῆς μνηστῆρες ὑπέρβιον ὕβριν ἔχοντες.	-u u- --u u-uu -u u--	dactylic hexameter	feminine penthemimeral, trithemimeral
τοὔνεκα νῦν τὰ σὰ γούναθ’ ἱκάνομαι, αἴ κ’ἐθέλῃσθα	-uu - u u -u u-uu - uu--	dactylic hexameter	feminine penthemimeral, trithemimeral
κείνου λυγρὸν ὄλεθρον ἐνισπεῖν, εἴ που ὄπωπας	-- -u u-u u-- - u u--	dactylic hexameter	feminine penthemimeral
ὀφθαλμοῖσι τεοῖσιν ἢ ἄλλου μῦθον ἄκουσας	---u u-u u -- -u u--	dactylic hexameter	feminine penthemimeral
πλαζομένου· περὶ γάρ μιν ὀιζυρὸν τέκε μήτηρ.	-uu- uu - u u--- uu --	dactylic hexameter	masculine penthemimeral, trithemimeral
μηδέ τί μ’αἰδόμενος μειλίσσεο μηδ’ ἐλεαίρων,	-u u -uu- --uu - uu--	dactylic hexameter	masculine penthemimeral
ἀλλ’ εὖ μοι κατάλεξον ὅπως ἤντησας ὀπωπῆς.	- - - uu-u u- --u u--	dactylic hexameter	feminine penthemimeral, hepthemimeral, trithemimeral
λίσσομαι, εἴ ποτέ τοί τι πατὴρ ἐμός, ἐσθλὸς Ὀδυσσεὺς	-uu - uu - u u- uu -u u--	dactylic hexameter	masculine penthemimeral, hepthemimeral, trithemimeral
ἢ ἔπος ἠέ τι ἔργον ὑποστὰς ἐξετέλεσσε	- uu -u u -u u-- -uu--	dactylic hexameter	feminine penthemimeral
δήμῳ ἔνι Τρώων, ὅθι πάσχετε πήματ’ Ἀχαιοί,	-u u- -- uu -uu -u u--	dactylic hexameter	masculine penthemimeral, trithemimeral
τῶν νῦν μοι μνῆσαι, καί μοι νημερτὲς ἐνίσπες.	- - - -- - - --u u--	dactylic hexameter	masculine penthemimeral, hepthemimeral, trithemimeral
τὸν δὲ μέγ’ ὀχθήσας προσέφη ξανθὸς Μενέλαος·	- u u --- uu- -- uu--	dactylic hexameter	masculine penthemimeral, hepthemimeral
ὢ πόποι, ἦ μάλα δὴ κρατερόφρονος ἀνδρὸς ἐν εὐνῇ	- uu - uu - uu-uu -u u --	dactylic hexameter	masculine penthemimeral, trithemimeral
ἤθελον εὐνηθῆναι ἀνάλκιδες αὐτοὶ ἐόντες.	-uu ---u u-uu -u u--	dactylic hexameter	feminine penthemimeral
ὡς δ’ὁπότ’ ἐν ξυλόχῳ ἔλαφος κρατεροῖο λέοντος	- uu - uu- uu- uu-u u--	dactylic hexameter	masculine penthemimeral, hepthemimeral, trithemimeral
νεβροὺς κοιμήσασα νεηγενέας γαλαθηνοὺς	-- ---u u-uu- uu--	dactylic hexameter	feminine penthemimeral
κνημοὺς ἐξερέῃσι καὶ ἄγκεα ποιήεντα	-- -uu-u u -uu ----	dactylic hexameter	feminine penthemimeral
βοσκομένη, ὁ δ’ἔπειτα ἑὴν εἰσήλυθεν εὐνήν,	-uu- u u-u u- --uu --	dactylic hexameter	feminine penthemimeral, hepthemimeral, trithemimeral
ἀμφοτέροισι δὲ τοῖσιν ἀεικέα πότμον ἐφῆκεν,	-uu-u u -u u-uu -u u--	dactylic hexameter	feminine penthemimeral
ὣς Ὀδυσεὺς κείνοισιν ἀεικέα πότμον ἐφήσει.	- uu- --u u-uu -u u--	dactylic hexameter	feminine penthemimeral, trithemimeral
αἲ γάρ, Ζεῦ τε πάτερ καὶ Ἀθηναίη καὶ Ἄπολλον,	- - - u u- u u--- u u--	dactylic hexameter	masculine penthemimeral, trithemimeral
τοῖος ἐών, οἷός ποτ’ ἐυκτιμένῃ ἐνὶ Λέσβῳ	-u u- -- u u-uu- uu --	dactylic hexameter	masculine penthemimeral, trithemimeral
ἐξ ἔριδος Φιλομηλεΐδῃ ἐπάλαισεν ἀναστάς,	- uu- uu-uu- uu-u u--	dactylic hexameter	hepthemimeral, trithemimeral
κὰδ δ’ἔβαλε κρατερῶς, κεχάροντο δὲ πάντες Ἀχαιοί,	- uu- uu- uu-u u -u u--	dactylic hexameter	masculine penthemimeral, trithemimeral
τοῖος ἐὼν μνηστῆρσιν ὁμιλήσειεν Ὀδυσσεύς·	-u u- --u u---u u--	dactylic hexameter	feminine penthemimeral, trithemimeral
πάντες κ’ὠκύμοροί τε γενοίατο πικρόγαμοί τε.	-- -uu- u u-uu -uu- -	dactylic hexameter	masculine penthemimeral
ταῦτα δ’ἅ μ’εἰρωτᾷς καὶ λίσσεαι, οὐκ ἂν ἔγωγε	-u u --- - -uu - u u--	dactylic hexameter	masculine penthemimeral
ἄλλα παρὲξ εἴποιμι παρακλιδόν, οὐδ’ ἀπατήσω,	-u u- --u u-uu - uu--	dactylic hexameter	feminine penthemimeral, trithemimeral
ἀλλὰ τὰ μέν μοι ἔειπε γέρων ἅλιος νημερτής,	-u u - u u-u u- uu- ---	dactylic hexameter	feminine penthemimeral, hepthemimeral, trithemimeral
τῶν οὐδέν τοι ἐγὼ κρύψω ἔπος οὐδ’ ἐπικεύσω.	- -- u u- -- uu - uu--	dactylic hexameter	masculine penthemimeral, hepthemimeral, trithemimeral
Αἰγύπτῳ μ’ἔτι δεῦρο θεοὶ μεμαῶτα νέεσθαι	--- uu -u u- uu-u u--	dactylic hexameter	feminine penthemimeral, hepthemimeral, trithemimeral
ἔσχον, ἐπεὶ οὔ σφιν ἔρεξα τεληέσσας ἑκατόμβας.	-u u- u u-u u--- uu--	dactylic hexameter	feminine penthemimeral, trithemimeral
οἱ δ’αἰεὶ βούλοντο θεοὶ μεμνῆσθαι ἐφετμέων.	- -- --u u- --u u--	dactylic hexameter	feminine penthemimeral, hepthemimeral, trithemimeral
νῆσος ἔπειτά τις ἔστι πολυκλύστῳ ἐνὶ πόντῳ	-u u-u u -u u--- uu --	dactylic hexameter	feminine penthemimeral
Αἰγύπτου προπάροιθε, Φάρον δέ ἑ κικλήσκουσι,	--- uu-u u- u u ----	dactylic hexameter	feminine penthemimeral, hepthemimeral, trithemimeral
τόσσον ἄνευθ’ ὅσσον τε πανημερίη γλαφυρὴ νηῦς	-u u- -- u u-uu- uu- -	dactylic hexameter	masculine penthemimeral, trithemimeral
ἤνυσεν, ᾗ λιγὺς οὖρος ἐπιπνείῃσιν ὄπισθεν·	-uu - uu -u u---u u--	dactylic hexameter	feminine penthemimeral, trithemimeral
ἐν δὲ λιμὴν ἐύορμος, ὅθεν τ’ἀπὸ νῆας ἐίσας	- u u- uu-u u- uu -u u--	dactylic hexameter	feminine penthemimeral, hepthemimeral, trithemimeral
ἐς πόντον βάλλουσιν, ἀφυσσάμενοι μέλαν ὕδωρ.	- -- --u u-uu- uu --	dactylic hexameter	feminine penthemimeral, trithemimeral
ἔνθα μ’ἐείκοσιν ἤματ’ ἔχον θεοί, οὐδέ ποτ’ οὖροι	-u u-uu -u u- uu -u u --	dactylic hexameter	feminine penthemimeral, hepthemimeral
πνείοντες φαίνονθ’ ἁλιαέες, οἵ ῥά τε νηῶν	--- -- uu-uu - u u --	dactylic hexameter	masculine penthemimeral, trithemimeral
πομπῆες γίνονται ἐπ’ εὐρέα νῶτα θαλάσσης.	--- --u u -uu -u u--	dactylic hexameter	feminine penthemimeral, trithemimeral
καί νύ κεν ἤϊα πάντα κατέφθιτο καὶ μένε’ ἀνδρῶν,	- u u -uu -u u-uu - uu --	dactylic hexameter	feminine penthemimeral
εἰ μή τίς με θεῶν ὀλοφύρατο καί μ’ἐλέησε,	- - - u u- uu-uu - uu--	dactylic hexameter	masculine penthemimeral, trithemimeral
Πρωτέος ἰφθίμου θυγάτηρ ἁλίοιο γέροντος,	-uu --- uu- uu-u u--	dactylic hexameter	masculine penthemimeral, hepthemimeral
Εἰδοθέη· τῇ γάρ ῥα μάλιστά γε θυμὸν ὄρινα.	-uu- - - u u-u u -u u--	dactylic hexameter	masculine penthemimeral, trithemimeral
ἥ μ’οἴῳ ἔρροντι συνήντετο νόσφιν ἑταίρων·	- -- --u u-uu -u u--	dactylic hexameter	feminine penthemimeral, trithemimeral
αἰεὶ γὰρ περὶ νῆσον ἀλώμενοι ἰχθυάασκον	-- - uu -u u-uu -uu--	dactylic hexameter	feminine penthemimeral, trithemimeral
γναμπτοῖς ἀγκίστροισιν, ἔτειρε δὲ γαστέρα λιμός.	-- ---u u-u u -uu --	dactylic hexameter	feminine penthemimeral
ἡ δέ μευ ἄγχι στᾶσα ἔπος φάτο φώνησέν τε·	- u u -- -u u- uu --- -	dactylic hexameter	feminine penthemimeral, hepthemimeral
νήπιός εἰς, ὦ ξεῖνε, λίην τόσον ἠδὲ χαλίφρων,	-uu - - -u u- uu -u u--	dactylic hexameter	feminine penthemimeral, hepthemimeral, trithemimeral
ἦε ἑκὼν μεθιεῖς καὶ τέρπεαι ἄλγεα πάσχων;	-u u- uu- - -uu -uu --	dactylic hexameter	masculine penthemimeral, trithemimeral
ὡς δὴ δήθ’ ἐνὶ νήσῳ ἐρύκεαι, οὐδέ τι τέκμωρ	- - - uu -u u-uu -u u --	dactylic hexameter	feminine penthemimeral, trithemimeral
εὑρέμεναι δύνασαι, μινύθει δέ τοι ἦτορ ἑταίρων.	-uu- uu- uu- u u -u u--	dactylic hexameter	masculine penthemimeral, hepthemimeral, trithemimeral
ὣς ἔφατ’, αὐτὰρ ἐγώ μιν ἀμειβόμενος προσέειπον·	- uu -u u- u u-uu- uu--	dactylic hexameter	masculine penthemimeral
ἐκ μέν τοι ἐρέω, ἥ τις σύ πέρ ἐσσι θεάων,	- - - uu- - - u u -u u--	dactylic hexameter	masculine penthemimeral, hepthemimeral, trithemimeral
ὡς ἐγὼ οὔ τι ἑκὼν κατερύκομαι, ἀλλά νυ μέλλω	- uu - u u- uu-uu -u u --	dactylic hexameter	masculine penthemimeral, trithemimeral
ἀθανάτους ἀλιτέσθαι, οἳ οὐρανὸν εὐρὺν ἔχουσιν.	-uu- uu-u u -uu -u u--	dactylic hexameter	feminine penthemimeral, trithemimeral
ἀλλὰ σύ πέρ μοι εἰπέ, θεοὶ δέ τε πάντα ἴσασιν,	-u u - - -u u- u u -u u--	dactylic hexameter	feminine penthemimeral, hepthemimeral, trithemimeral
ὅς τίς μ’ἀθανάτων πεδάᾳ καὶ ἔδησε κελεύθου,	- - -uu- uu- u u-u u--	dactylic hexameter	masculine penthemimeral, hepthemimeral
νόστον θ’,ὡς ἐπὶ πόντον ἐλεύσομαι ἰχθυόεντα.	-- - uu -u u-uu -uu--	dactylic hexameter	feminine penthemimeral, trithemimeral
ὣς ἐφάμην, ἡ δ’αὐτίκ’ ἀμείβετο δῖα θεάων·	- uu- - -u u-uu -u u--	dactylic hexameter	feminine penthemimeral, trithemimeral
τοιγὰρ ἐγώ τοι, ξεῖνε, μάλ’ ἀτρεκέως ἀγορεύσω.	-u u- - -u u -uu- uu--	dactylic hexameter	feminine penthemimeral, trithemimeral
πωλεῖταί τις δεῦρο γέρων ἅλιος νημερτὴς	--- - -u u- uu- ---	dactylic hexameter	feminine penthemimeral, hepthemimeral, trithemimeral
ἀθάνατος Πρωτεὺς Αἰγύπτιος, ὅς τε θαλάσσης	-uu- -- --uu - u u--	dactylic hexameter	masculine penthemimeral, trithemimeral
πάσης βένθεα οἶδε, Ποσειδάωνος ὑποδμώς·	-- -uu -u u---u u--	dactylic hexameter	feminine penthemimeral
τὸν δέ τ’ἐμόν φασιν πατέρ’ ἔμμεναι ἠδὲ τεκέσθαι.	- u u- -- uu -uu -u u--	dactylic hexameter	masculine penthemimeral, trithemimeral
τόν γ’εἴ πως σὺ δύναιο λοχησάμενος λελαβέσθαι,	- - - u u-u u-uu- uu--	dactylic hexameter	feminine penthemimeral, trithemimeral
ὅς κέν τοι εἴπῃσιν ὁδὸν καὶ μέτρα κελεύθου	- - - --u u- - -u u--	dactylic hexameter	feminine penthemimeral, hepthemimeral, trithemimeral
νόστον θ’,ὡς ἐπὶ πόντον ἐλεύσεαι ἰχθυόεντα.	-- - uu -u u-uu -uu--	dactylic hexameter	feminine penthemimeral, trithemimeral
καὶ δέ κέ τοι εἴπῃσι, διοτρεφές, αἴ κ’ἐθέλῃσθα,	- u u - --u u-uu - uu--	dactylic hexameter	feminine penthemimeral, trithemimeral
ὅττι τοι ἐν μεγάροισι κακόν τ’ἀγαθόν τε τέτυκται	-u u - uu-u u- uu- u u--	dactylic hexameter	feminine penthemimeral, hepthemimeral, trithemimeral
οἰχομένοιο σέθεν δολιχὴν ὁδὸν ἀργαλέην τε.	-uu-u u- uu- uu -uu- -	dactylic hexameter	masculine penthemimeral, hepthemimeral
ὣς ἔφατ’, αὐτὰρ ἐγώ μιν ἀμειβόμενος προσέειπον·	- uu -u u- u u-uu- uu--	dactylic hexameter	masculine penthemimeral
αὐτὴ νῦν φράζευ σὺ λόχον θείοιο γέροντος,	-- - -- u u- --u u--	dactylic hexameter	masculine penthemimeral, hepthemimeral, trithemimeral
μή πώς με προϊδὼν ἠὲ προδαεὶς ἀλέηται·	- - - uu- -- uu- uu--	dactylic hexameter	masculine penthemimeral, hepthemimeral, trithemimeral
ἀργαλέος γάρ τ’ἐστὶ θεὸς βροτῷ ἀνδρὶ δαμῆναι.	-uu- - -u u- uu -u u--	dactylic hexameter	feminine penthemimeral, hepthemimeral, trithemimeral
ὣς ἐφάμην, ἡ δ’αὐτίκ’ ἀμείβετο δῖα θεάων·	- uu- - -u u-uu -u u--	dactylic hexameter	feminine penthemimeral, trithemimeral
τοιγὰρ ἐγώ τοι ταῦτα μάλ’ ἀτρεκέως ἀγορεύσω.	-u u- - -u u -uu- uu--	dactylic hexameter	feminine penthemimeral, trithemimeral
ἦμος δ’ἠέλιος μέσον οὐρανὸν ἀμφιβεβήκει,	-- -uu- uu -uu -uu--	dactylic hexameter	masculine penthemimeral
τῆμος ἄρ’ ἐξ ἁλὸς εἶσι γέρων ἅλιος νημερτὴς	-u u - uu -u u- uu- ---	dactylic hexameter	feminine penthemimeral, hepthemimeral, trithemimeral
πνοιῇ ὕπο Ζεφύροιο μελαίνῃ φρικὶ καλυφθείς,	-u u- uu-u u-- -u u--	dactylic hexameter	feminine penthemimeral, trithemimeral
ἐκ δ’ἐλθὼν κοιμᾶται ὑπὸ σπέσσι γλαφυροῖσιν·	- -- --u u- -- uu--	dactylic hexameter	feminine penthemimeral, hepthemimeral, trithemimeral
ἀμφὶ δέ μιν φῶκαι νέποδες καλῆς ἁλοσύδνης	-u u - -- uu- -- uu--	dactylic hexameter	masculine penthemimeral, hepthemimeral, trithemimeral
ἁθρόαι εὕδουσιν, πολιῆς ἁλὸς ἐξαναδῦσαι,	-uu --- uu- uu -uu--	dactylic hexameter	masculine penthemimeral, hepthemimeral
πικρὸν ἀποπνείουσαι ἁλὸς πολυβενθέος ὀδμήν.	-u u---u u- uu-uu --	dactylic hexameter	feminine penthemimeral, hepthemimeral
ἔνθα σ’ἐγὼν ἀγαγοῦσα ἅμ’ ἠοῖ φαινομένηφι	-u u- uu-u u -- -uu--	dactylic hexameter	feminine penthemimeral, trithemimeral
εὐνάσω ἑξείης· σὺ δ’ἐὺ κρίνασθαι ἑταίρους	-uu --- u u- --u u--	dactylic hexameter	masculine penthemimeral, hepthemimeral
τρεῖς, οἵ τοι παρὰ νηυσὶν ἐυσσέλμοισιν ἄριστοι.	- - - uu -u u---u u--	dactylic hexameter	feminine penthemimeral, trithemimeral
πάντα δέ τοι ἐρέω ὀλοφώια τοῖο γέροντος.	-u u - uu- uu-uu -u u--	dactylic hexameter	masculine penthemimeral, trithemimeral
φώκας μέν τοι πρῶτον ἀριθμήσει καὶ ἔπεισιν·	-- - - -u u--- u u--	dactylic hexameter	feminine penthemimeral, trithemimeral
αὐτὰρ ἐπὴν πάσας πεμπάσσεται ἠδὲ ἴδηται,	-u u- -- --uu -u u--	dactylic hexameter	masculine penthemimeral, trithemimeral
λέξεται ἐν μέσσῃσι νομεὺς ὣς πώεσι μήλων.	-uu - --u u- - -uu --	dactylic hexameter	feminine penthemimeral, hepthemimeral, trithemimeral
τὸν μὲν ἐπὴν δὴ πρῶτα κατευνηθέντα ἴδησθε,	- u u- - -u u---u u--	dactylic hexameter	feminine penthemimeral, trithemimeral
καὶ τότ’ ἔπειθ’ ὑμῖν μελέτω κάρτος τε βίη τε,	- u u- -- uu- -- u u- -	dactylic hexameter	masculine penthemimeral, hepthemimeral, trithemimeral
αὖθι δ’ἔχειν μεμαῶτα καὶ ἐσσύμενόν περ ἀλύξαι.	-u u- uu-u u -uu- u u--	dactylic hexameter	feminine penthemimeral, trithemimeral
πάντα δὲ γινόμενος πειρήσεται, ὅσσ’ ἐπὶ γαῖαν	-u u -uu- --uu - uu --	dactylic hexameter	masculine penthemimeral
ἑρπετὰ γίνονται, καὶ ὕδωρ καὶ θεσπιδαὲς πῦρ·	-uu --- u u- - -uu- -	dactylic hexameter	masculine penthemimeral, hepthemimeral
ὑμεῖς δ’ἀστεμφέως ἐχέμεν μᾶλλόν τε πιέζειν.	-- --- uu- -- u u--	dactylic hexameter	masculine penthemimeral, hepthemimeral
ἀλλ’ ὅτε κεν δή σ’αὐτὸς ἀνείρηται ἐπέεσσι,	- uu - - -u u--- uu--	dactylic hexameter	feminine penthemimeral, trithemimeral
τοῖος ἐὼν οἷόν κε κατευνηθέντα ἴδηαι,	-u u- -- u u---u u--	dactylic hexameter	masculine penthemimeral, trithemimeral
καὶ τότε δὴ σχέσθαι τε βίης λῦσαί τε γέροντα,	- uu - -- u u- -- u u--	dactylic hexameter	masculine penthemimeral, hepthemimeral, trithemimeral
ἥρως, εἴρεσθαι δέ, θεῶν ὅς τίς σε χαλέπτει,	-- --- u u- - - u u--	dactylic hexameter	masculine penthemimeral, hepthemimeral
νόστον θ’,ὡς ἐπὶ πόντον ἐλεύσεαι ἰχθυόεντα.	-- - uu -u u-uu -uu--	dactylic hexameter	feminine penthemimeral, trithemimeral
ὣς εἰποῦσ’ ὑπὸ πόντον ἐδύσατο κυμαίνοντα.	- -- uu -u u-uu ----	dactylic hexameter	feminine penthemimeral, trithemimeral
αὐτὰρ ἐγὼν ἐπὶ νῆας, ὅθ’ ἕστασαν ἐν ψαμάθοισιν,	-u u- uu -u u -uu - uu--	dactylic hexameter	feminine penthemimeral, trithemimeral
ἤϊα· πολλὰ δέ μοι κραδίη πόρφυρε κιόντι.	-uu -u u - uu- --u u--	dactylic hexameter	masculine penthemimeral, hepthemimeral
αὐτὰρ ἐπεί ῥ’ἐπὶ νῆα κατήλυθον ἠδὲ θάλασσαν,	-u u- uu -u u-uu -u u--	dactylic hexameter	feminine penthemimeral, trithemimeral
δόρπον ἄρ’ ὁπλισάμεσθ’, ἐπί τ’ἤλυθεν ἀμβροσίη νύξ·	-u u -uu- uu -uu -uu- -	dactylic hexameter	masculine penthemimeral
δὴ τότε κοιμήθημεν ἐπὶ ῥηγμῖνι θαλάσσης.	- uu ---u u- --u u--	dactylic hexameter	feminine penthemimeral, hepthemimeral
ἦμος δ’ἠριγένεια φάνη ῥοδοδάκτυλος Ἠώς,	-- -uu-u u- uu-uu --	dactylic hexameter	feminine penthemimeral, hepthemimeral
καὶ τότε δὴ παρὰ θῖνα θαλάσσης εὐρυπόροιο	- uu - uu -u u-- -uu--	dactylic hexameter	feminine penthemimeral, trithemimeral
ἤϊα πολλὰ θεοὺς γουνούμενος· αὐτὰρ ἑταίρους	-uu -u u- --uu -u u--	dactylic hexameter	masculine penthemimeral
τρεῖς ἄγον, οἷσι μάλιστα πεποίθεα πᾶσαν ἐπ’ ἰθύν.	- uu -u u-u u-uu -u u --	dactylic hexameter	feminine penthemimeral
τόφρα δ’ἄρ’ ἥ γ’ὑποδῦσα θαλάσσης εὐρέα κόλπον	-u u - uu-u u-- -uu --	dactylic hexameter	feminine penthemimeral, trithemimeral
τέσσαρα φωκάων ἐκ πόντου δέρματ’ ἔνεικε·	-uu --- - -- -u u--	dactylic hexameter	masculine penthemimeral
πάντα δ’ἔσαν νεόδαρτα· δόλον δ’ἐπεμήδετο πατρί.	-u u- uu-u u- uu-uu --	dactylic hexameter	feminine penthemimeral, hepthemimeral, trithemimeral
εὐνὰς δ’ἐν ψαμάθοισι διαγλάψασ’ ἁλίῃσιν	-- - uu-u u--- uu--	dactylic hexameter	feminine penthemimeral, trithemimeral
ἧστο μένουσ’· ἡμεῖς δὲ μάλα σχεδὸν ἤλθομεν αὐτῆς·	-u u- -- u u- uu -uu --	dactylic hexameter	masculine penthemimeral, hepthemimeral, trithemimeral
ἑξείης δ’εὔνησε, βάλεν δ’ἐπὶ δέρμα ἑκάστῳ.	--- --u u- uu -u u--	dactylic hexameter	feminine penthemimeral, hepthemimeral, trithemimeral
ἔνθα κεν αἰνότατος λόχος ἔπλετο· τεῖρε γὰρ αἰνῶς	-u u -uu- uu -uu -u u --	dactylic hexameter	masculine penthemimeral
φωκάων ἁλιοτρεφέων ὀλοώτατος ὀδμή·	--- uu-uu- uu-uu --	dactylic hexameter	hepthemimeral, trithemimeral
τίς γάρ κ’εἰναλίῳ παρὰ κήτεϊ κοιμηθείη;	- - -uu- uu -uu ----	dactylic hexameter	masculine penthemimeral
ἀλλ’ αὐτὴ ἐσάωσε καὶ ἐφράσατο μέγ’ ὄνειαρ·	- -- uu-u u -uu- u u--	dactylic hexameter	feminine penthemimeral, trithemimeral
ἀμβροσίην ὑπὸ ῥῖνα ἑκάστῳ θῆκε φέρουσα	-uu- uu -u u-- -u u--	dactylic hexameter	feminine penthemimeral, trithemimeral
ἡδὺ μάλα πνείουσαν, ὄλεσσε δὲ κήτεος ὀδμήν.	-u u- --u u-u u -uu --	dactylic hexameter	feminine penthemimeral, trithemimeral
πᾶσαν δ’ἠοίην μένομεν τετληότι θυμῷ·	-- --- uu- --uu --	dactylic hexameter	masculine penthemimeral, hepthemimeral
φῶκαι δ’ἐξ ἁλὸς ἦλθον ἀολλέες. αἱ μὲν ἔπειτα	-- - uu -u u-uu - u u--	dactylic hexameter	feminine penthemimeral, trithemimeral
ἑξῆς εὐνάζοντο παρὰ ῥηγμῖνι θαλάσσης·	-- ---u u- --u u--	dactylic hexameter	feminine penthemimeral, hepthemimeral
ἔνδιος δ’ὁ γέρων ἦλθ’ ἐξ ἁλός, εὗρε δὲ φώκας	--- u u- - - uu -u u --	dactylic hexameter	masculine penthemimeral, hepthemimeral, trithemimeral
ζατρεφέας, πάσας δ’ἄρ’ ἐπῴχετο, λέκτο δ’ἀριθμόν·	-uu- -- u u-uu -u u--	dactylic hexameter	masculine penthemimeral, trithemimeral
ἐν δ’ἡμέας πρώτους λέγε κήτεσιν, οὐδέ τι θυμῷ	- -- -- uu -uu -u u --	dactylic hexameter	masculine penthemimeral, trithemimeral
ὠΐσθη δόλον εἶναι· ἔπειτα δὲ λέκτο καὶ αὐτός.	--- uu -u u-u u -u u --	dactylic hexameter	feminine penthemimeral, trithemimeral
ἡμεῖς δὲ ἰάχοντες ἐπεσσύμεθ’, ἀμφὶ δὲ χεῖρας	-- - uu-u u-uu -u u --	dactylic hexameter	feminine penthemimeral, trithemimeral
βάλλομεν· οὐδ’ ὁ γέρων δολίης ἐπελήθετο τέχνης,	-uu - u u- uu- uu-uu --	dactylic hexameter	masculine penthemimeral, hepthemimeral, trithemimeral
ἀλλ’ ἤτοι πρώτιστα λέων γένετ’ ἠυγένειος,	- -- --u u- uu -uu--	dactylic hexameter	feminine penthemimeral, hepthemimeral, trithemimeral
αὐτὰρ ἔπειτα δράκων καὶ πάρδαλις ἠδὲ μέγας σῦς·	-u u-u u- - -uu -u u- -	dactylic hexameter	masculine penthemimeral
γίνετο δ’ὑγρὸν ὕδωρ καὶ δένδρεον ὑψιπέτηλον·	-uu -u u- - -uu -uu--	dactylic hexameter	masculine penthemimeral
ἡμεῖς δ’ἀστεμφέως ἔχομεν τετληότι θυμῷ.	-- --- uu- --uu --	dactylic hexameter	masculine penthemimeral, hepthemimeral
ἀλλ’ ὅτε δή ῥ’ἀνίαζ’ ὁ γέρων ὀλοφώια εἰδώς,	- uu - uu- u u- uu-uu --	dactylic hexameter	masculine penthemimeral, hepthemimeral, trithemimeral
καὶ τότε δή μ’ἐπέεσσιν ἀνειρόμενος προσέειπε·	- uu - uu-u u-uu- uu--	dactylic hexameter	feminine penthemimeral, trithemimeral
τίς νύ τοι, Ἀτρέος υἱέ, θεῶν συμφράσσατο βουλάς,	- u u -uu -u u- --uu --	dactylic hexameter	feminine penthemimeral, hepthemimeral
ὄφρα μ’ἕλοις ἀέκοντα λοχησάμενος; τέο σε χρή;	-u u- uu-u u-uu- uu - -	dactylic hexameter	feminine penthemimeral, trithemimeral
ὣς ἔφατ’, αὐτὰρ ἐγώ μιν ἀμειβόμενος προσέειπον·	- uu -u u- u u-uu- uu--	dactylic hexameter	masculine penthemimeral
οἶσθα, γέρον, τί με ταῦτα παρατροπέων ἐρεείνεις;	-u u- u u -u u-uu- uu--	dactylic hexameter	feminine penthemimeral, trithemimeral
ὡς δὴ δήθ’ ἐνὶ νήσῳ ἐρύκομαι, οὐδέ τι τέκμωρ	- - - uu -u u-uu -u u --	dactylic hexameter	feminine penthemimeral, trithemimeral
εὑρέμεναι δύναμαι, μινύθει δέ μοι ἔνδοθεν ἦτορ.	-uu- uu- uu- u u -uu --	dactylic hexameter	masculine penthemimeral, hepthemimeral, trithemimeral
ἀλλὰ σύ πέρ μοι εἰπέ, θεοὶ δέ τε πάντα ἴσασιν,	-u u - - -u u- u u -u u--	dactylic hexameter	feminine penthemimeral, hepthemimeral, trithemimeral
ὅς τίς μ’ἀθανάτων πεδάᾳ καὶ ἔδησε κελεύθου,	- - -uu- uu- u u-u u--	dactylic hexameter	masculine penthemimeral, hepthemimeral
νόστον θ’,ὡς ἐπὶ πόντον ἐλεύσομαι ἰχθυόεντα.	-- - uu -u u-uu -uu--	dactylic hexameter	feminine penthemimeral, trithemimeral
ὣς ἐφάμην, ὁ δέ μ’αὐτίκ’ ἀμειβόμενος προσέειπεν·	- uu- u u -u u-uu- uu--	dactylic hexameter	feminine penthemimeral, trithemimeral
ἀλλὰ μάλ’ ὤφελλες Διί τ’ἄλλοισίν τε θεοῖσι	-u u --- uu --- u u--	dactylic hexameter	masculine penthemimeral
ῥέξας ἱερὰ κάλ’ ἀναβαινέμεν, ὄφρα τάχιστα	-- -uu - uu-uu -u u--	dactylic hexameter	masculine penthemimeral
σὴν ἐς πατρίδ’ ἵκοιο πλέων ἐπὶ οἴνοπα πόντον.	- - -u u-u u- uu -uu --	dactylic hexameter	feminine penthemimeral, hepthemimeral
οὐ γάρ τοι πρὶν μοῖρα φίλους τ’ἰδέειν καὶ ἱκέσθαι	- - - - -u u- uu- u u--	dactylic hexameter	feminine penthemimeral, hepthemimeral, trithemimeral
οἶκον ἐυκτίμενον καὶ σὴν ἐς πατρίδα γαῖαν,	-u u-uu- - - - -uu --	dactylic hexameter	masculine penthemimeral, hepthemimeral
πρίν γ’ὅτ’ ἂν Αἰγύπτοιο, διιπετέος ποταμοῖο,	- u u ---u u-uu- uu--	dactylic hexameter	feminine penthemimeral
αὖτις ὕδωρ ἔλθῃς ῥέξῃς θ’ἱερὰς ἑκατόμβας	-u u- -- -- uu- uu--	dactylic hexameter	masculine penthemimeral, hepthemimeral, trithemimeral
ἀθανάτοισι θεοῖσι, τοὶ οὐρανὸν εὐρὺν ἔχουσι·	-uu-u u-u u -uu -u u--	dactylic hexameter	feminine penthemimeral
καὶ τότε τοι δώσουσιν ὁδὸν θεοί, ἣν σὺ μενοινᾷς.	- uu - --u u- uu - u u--	dactylic hexameter	feminine penthemimeral, hepthemimeral, trithemimeral
ὣς ἔφατ’, αὐτὰρ ἐμοί γε κατεκλάσθη φίλον ἦτορ,	- uu -u u- u u--- uu --	dactylic hexameter	masculine penthemimeral
οὕνεκά μ’αὖτις ἄνωγεν ἐπ’ ἠεροειδέα πόντον	-uu -u u-u u -uu-uu --	dactylic hexameter	feminine penthemimeral
Αἴγυπτόνδ’ ἰέναι, δολιχὴν ὁδὸν ἀργαλέην τε.	--- uu- uu- uu -uu- -	dactylic hexameter	masculine penthemimeral, hepthemimeral, trithemimeral
ἀλλὰ καὶ ὣς μύθοισιν ἀμειβόμενος προσέειπον·	-u u - --u u-uu- uu--	dactylic hexameter	feminine penthemimeral, trithemimeral
ταῦτα μὲν οὕτω δὴ τελέω, γέρον, ὡς σὺ κελεύεις.	-u u -- - uu- uu - u u--	dactylic hexameter	masculine penthemimeral, hepthemimeral
ἀλλ’ ἄγε μοι τόδε εἰπὲ καὶ ἀτρεκέως κατάλεξον,	- uu - uu -u u -uu- uu--	dactylic hexameter	feminine penthemimeral, trithemimeral
εἰ πάντες σὺν νηυσὶν ἀπήμονες ἦλθον Ἀχαιοί,	- -- - -u u-uu -u u--	dactylic hexameter	feminine penthemimeral, trithemimeral
οὓς Νέστωρ καὶ ἐγὼ λίπομεν Τροίηθεν ἰόντες,	- -- u u- uu- --u u--	dactylic hexameter	masculine penthemimeral, hepthemimeral, trithemimeral
ἦέ τις ὤλετ’ ὀλέθρῳ ἀδευκέι ἧς ἐπὶ νηὸς	-u u -u u-u u-uu - uu --	dactylic hexameter	feminine penthemimeral
ἠὲ φίλων ἐν χερσίν, ἐπεὶ πόλεμον τολύπευσεν.	-u u- - -u u- uu- uu--	dactylic hexameter	feminine penthemimeral, hepthemimeral, trithemimeral
ὣς ἐφάμην, ὁ δέ μ’αὐτίκ’ ἀμειβόμενος προσέειπεν·	- uu- u u -u u-uu- uu--	dactylic hexameter	feminine penthemimeral, trithemimeral
Ἀτρεΐδη, τί με ταῦτα διείρεαι; οὐδέ τί σε χρὴ	-uu- u u -u u-uu -u u - -	dactylic hexameter	feminine penthemimeral, trithemimeral
ἴδμεναι, οὐδὲ δαῆναι ἐμὸν νόον· οὐδέ σέ φημι	-uu -u u-u u- uu -u u --	dactylic hexameter	feminine penthemimeral, hepthemimeral
δὴν ἄκλαυτον ἔσεσθαι, ἐπεί κ’ἐὺ πάντα πύθηαι.	- --u u-u u- uu -u u--	dactylic hexameter	feminine penthemimeral, hepthemimeral
πολλοὶ μὲν γὰρ τῶν γε θανον, πολλοὶ δὲ λίποντο·	-- - - - u u- -- u u--	dactylic hexameter	masculine penthemimeral, hepthemimeral, trithemimeral
ἀρχοὶ δ’αὖ δύο μοῦνοι Ἀχαιῶν χαλκοχιτώνων	-- - uu -u u-- -uu--	dactylic hexameter	feminine penthemimeral, trithemimeral
ἐν νόστῳ ἀπόλοντο· μάχῃ δέ τε καὶ σὺ παρῆσθα.	- -- uu-u u- u u - u u--	dactylic hexameter	feminine penthemimeral, hepthemimeral, trithemimeral
εἷς δ’ἔτι που ζωὸς κατερύκεται εὐρέι πόντῳ.	- uu - -- uu-uu -uu --	dactylic hexameter	masculine penthemimeral, trithemimeral
Αἴας μὲν μετὰ νηυσὶ δάμη δολιχηρέτμοισι.	-- - uu -u u- uu----	dactylic hexameter	feminine penthemimeral, hepthemimeral, trithemimeral
Γυρῇσίν μιν πρῶτα Ποσειδάων ἐπέλασσε	--- - -u u--- uu--	dactylic hexameter	feminine penthemimeral, trithemimeral
πέτρῃσιν μεγάλῃσι καὶ ἐξεσάωσε θαλάσσης·	--- uu-u u -uu-u u--	dactylic hexameter	feminine penthemimeral, trithemimeral
καί νύ κεν ἔκφυγε κῆρα καὶ ἐχθόμενός περ Ἀθήνῃ,	- u u -uu -u u -uu- u u--	dactylic hexameter	feminine penthemimeral
εἰ μὴ ὑπερφίαλον ἔπος ἔκβαλε καὶ μέγ’ ἀάσθη·	- u u-uu- uu -uu - u u--	dactylic hexameter	masculine penthemimeral
φῆ ῥ’ἀέκητι θεῶν φυγέειν μέγα λαῖτμα θαλάσσης.	- uu-u u- uu- uu -u u--	dactylic hexameter	masculine penthemimeral, hepthemimeral
τοῦ δὲ Ποσειδάων μεγάλ’ ἔκλυεν αὐδήσαντος·	- u u--- uu -uu ----	dactylic hexameter	masculine penthemimeral
αὐτίκ’ ἔπειτα τρίαιναν ἑλὼν χερσὶ στιβαρῇσιν	-u u-u u-u u- -- uu--	dactylic hexameter	feminine penthemimeral, hepthemimeral
ἤλασε Γυραίην πέτρην, ἀπὸ δ’ἔσχισεν αὐτήν·	-uu --- -- uu -uu --	dactylic hexameter	masculine penthemimeral, hepthemimeral
καὶ τὸ μὲν αὐτόθι μεῖνε, τὸ δὲ τρύφος ἔμπεσε πόντῳ,	- u u -uu -u u - uu -uu --	dactylic hexameter	feminine penthemimeral, hepthemimeral
τῷ ῥ’Αἴας τὸ πρῶτον ἐφεζόμενος μέγ’ ἀάσθη·	- -- - -u u-uu- u u--	dactylic hexameter	feminine penthemimeral, trithemimeral
τὸν δ’ἐφόρει κατὰ πόντον ἀπείρονα κυμαίνοντα.	- uu- uu -u u-uu ----	dactylic hexameter	feminine penthemimeral, trithemimeral
ὣς ὁ μὲν ἔνθ’ ἀπόλωλεν, ἐπεὶ πίεν ἁλμυρὸν ὕδωρ.	- u u - uu-u u- uu -uu --	dactylic hexameter	feminine penthemimeral, hepthemimeral, trithemimeral
σὸς δέ που ἔκφυγε κῆρας ἀδελφεὸς ἠδ’ ὑπάλυξεν	- u u -uu -u u-uu - uu--	dactylic hexameter	feminine penthemimeral
ἐν νηυσὶ γλαφυρῇσι· σάωσε δὲ πότνια Ἥρη.	- -- uu-u u-u u -uu --	dactylic hexameter	feminine penthemimeral, trithemimeral
ἀλλ’ ὅτε δὴ τάχ’ ἔμελλε Μαλειάων ὄρος αἰπὺ	- uu - u u-u u--- uu --	dactylic hexameter	feminine penthemimeral, trithemimeral
ἵξεσθαι, τότε δή μιν ἀναρπάξασα θύελλα	--- uu - u u---u u--	dactylic hexameter	masculine penthemimeral, trithemimeral
πόντον ἐπ’ ἰχθυόεντα φέρεν βαρέα στενάχοντα,	-u u -uu-u u- uu- uu--	dactylic hexameter	feminine penthemimeral, hepthemimeral
ἀγροῦ ἐπ’ ἐσχατιήν, ὅθι δώματα ναῖε Θυέστης	-u u -uu- uu -uu -u u--	dactylic hexameter	masculine penthemimeral
τὸ πρίν, ἀτὰρ τότ’ ἔναιε Θυεστιάδης Αἴγισθος.	- u u- u u-u u-uu- ---	dactylic hexameter	feminine penthemimeral, trithemimeral
ἀλλ’ ὅτε δὴ καὶ κεῖθεν ἐφαίνετο νόστος ἀπήμων,	- uu - - -u u-uu -u u--	dactylic hexameter	feminine penthemimeral, trithemimeral
ἂψ δὲ θεοὶ οὖρον στρέψαν, καὶ οἴκαδ’ ἵκοντο,	- u u- -- -- - -u u--	dactylic hexameter	masculine penthemimeral, hepthemimeral, trithemimeral
ἤτοι ὁ μὲν χαίρων ἐπεβήσετο πατρίδος αἴης	-u u - -- uu-uu -uu --	dactylic hexameter	masculine penthemimeral, trithemimeral
καὶ κύνει ἁπτόμενος ἣν πατρίδα· πολλὰ δ’ἀπ’ αὐτοῦ	- uu -uu- - -uu -u u --	dactylic hexameter	masculine penthemimeral
δάκρυα θερμὰ χέοντ’, ἐπεὶ ἀσπασίως ἴδε γαῖαν.	-uu -u u- uu -uu- uu --	dactylic hexameter	masculine penthemimeral
τὸν δ’ἄρ’ ἀπὸ σκοπιῆς εἶδε σκοπός, ὅν ῥα καθεῖσεν	- u u- uu- -- uu - u u--	dactylic hexameter	masculine penthemimeral, hepthemimeral, trithemimeral
Αἴγισθος δολόμητις ἄγων, ὑπὸ δ’ἔσχετο μισθὸν	--- uu-u u- uu -uu --	dactylic hexameter	feminine penthemimeral, hepthemimeral, trithemimeral
χρυσοῦ δοιὰ τάλαντα· φύλασσε δ’ὅ γ’εἰς ἐνιαυτόν,	-- -u u-u u-u u - uu--	dactylic hexameter	feminine penthemimeral
μή ἑ λάθοι παριών, μνήσαιτο δὲ θούριδος ἀλκῆς.	- u u- uu- --u u -uu --	dactylic hexameter	masculine penthemimeral, trithemimeral
βῆ δ’ἴμεν ἀγγελέων πρὸς δώματα ποιμένι λαῶν.	- uu -uu- - -uu -uu --	dactylic hexameter	masculine penthemimeral
αὐτίκα δ’Αἴγισθος δολίην ἐφράσσατο τέχνην·	-uu --- uu- --uu --	dactylic hexameter	masculine penthemimeral, hepthemimeral
κρινάμενος κατὰ δῆμον ἐείκοσι φῶτας ἀρίστους	-uu- uu -u u-uu -u u--	dactylic hexameter	feminine penthemimeral, trithemimeral
εἷσε λόχον, ἑτέρωθι δ’ ἀνώγει δαῖτα πένεσθαι.	-u u- uu-u u-- -u u--	dactylic hexameter	feminine penthemimeral, trithemimeral
αὐτὰρ ὁ βῆ καλέων Ἀγαμέμνονα, ποιμένα λαῶν	-u u - uu- uu-uu -uu --	dactylic hexameter	masculine penthemimeral, trithemimeral
ἵπποισιν καὶ ὄχεσφιν, ἀεικέα μερμηρίζων.	--- u u-u u-uu ----	dactylic hexameter	feminine penthemimeral, trithemimeral
τὸν δ’οὐκ εἰδότ’ ὄλεθρον ἀνήγαγε καὶ κατέπεφνε	- - -u u-u u-uu - uu--	dactylic hexameter	feminine penthemimeral
δειπνίσσας, ὥς τίς τε κατέκτανε βοῦν ἐπὶ φάτνῃ.	--- - - u u-uu - uu --	dactylic hexameter	masculine penthemimeral, trithemimeral
οὐδέ τις Ἀτρεΐδεω ἑτάρων λίπεθ’ οἵ οἱ ἕποντο,	-u u -uu- uu- uu - u u--	dactylic hexameter	masculine penthemimeral, hepthemimeral
οὐδέ τις Αἰγίσθου, ἀλλ’ ἔκταθεν ἐν μεγάροισιν.	-u u --- - -uu - uu--	dactylic hexameter	masculine penthemimeral
ὣς ἔφατ’, αὐτὰρ ἔμοιγε κατεκλάσθη φίλον ἦτορ,	- uu -u u-u u--- uu --	dactylic hexameter	feminine penthemimeral
κλαῖον δ’ἐν ψαμάθοισι καθήμενος, οὐδέ νύ μοι κῆρ	-- - uu-u u-uu -u u - -	dactylic hexameter	feminine penthemimeral, trithemimeral
ἤθελ’ ἔτι ζώειν καὶ ὁρᾶν φάος ἠελίοιο.	-u u- -- u u- uu -uu--	dactylic hexameter	masculine penthemimeral, hepthemimeral, trithemimeral
αὐτὰρ ἐπεὶ κλαίων τε κυλινδόμενός τε κορέσθην,	-u u- -- u u-uu- u u--	dactylic hexameter	masculine penthemimeral, trithemimeral
δὴ τότε με προσέειπε γέρων ἅλιος νημερτής·	- uu - uu-u u- uu- ---	dactylic hexameter	feminine penthemimeral, hepthemimeral, trithemimeral
μηκέτι, Ἀτρέος υἱέ, πολὺν χρόνον ἀσκελὲς οὕτω	-uu -uu -u u- uu -uu --	dactylic hexameter	feminine penthemimeral, hepthemimeral
κλαῖ’, ἐπεὶ οὐκ ἄνυσίν τινα δήομεν· ἀλλὰ τάχιστα	- uu - uu- uu -uu -u u--	dactylic hexameter	masculine penthemimeral, trithemimeral
πείρα ὅπως κεν δὴ σὴν πατρίδα γαῖαν ἵκηαι.	-u u- - - - -uu -u u--	dactylic hexameter	masculine penthemimeral, trithemimeral
ἢ γάρ μιν ζωόν γε κιχήσεαι, ἤ κεν Ὀρέστης	- - - -- u u-uu - u u--	dactylic hexameter	masculine penthemimeral, trithemimeral
κτεῖνεν ὑποφθάμενος, σὺ δέ κεν τάφου ἀντιβολήσαις.	-u u-uu- u u - uu -uu--	dactylic hexameter	masculine penthemimeral, hepthemimeral
ὣς ἔφατ’, αὐτὰρ ἐμοὶ κραδίη καὶ θυμὸς ἀγήνωρ	- uu -u u- uu- - -u u--	dactylic hexameter	masculine penthemimeral, hepthemimeral
αὖτις ἐνὶ στήθεσσι καὶ ἀχνυμένῳ περ ἰάνθη,	-u u- --u u -uu- u u--	dactylic hexameter	feminine penthemimeral, trithemimeral
καί μιν φωνήσας ἔπεα πτερόεντα προσηύδων·	- - --- uu- uu-u u--	dactylic hexameter	masculine penthemimeral, hepthemimeral
τούτους μὲν δὴ οἶδα· σὺ δὲ τρίτον ἄνδρ’ ὀνόμαζε,	-- - - -u u - uu - uu--	dactylic hexameter	feminine penthemimeral, hepthemimeral, trithemimeral
ὅς τις ἔτι ζωὸς κατερύκεται εὐρέι πόντῳ	- u u- -- uu-uu -uu --	dactylic hexameter	masculine penthemimeral, trithemimeral
ἠὲ θανών· ἐθέλω δὲ καὶ ἀχνύμενός περ ἀκοῦσαι.	-u u- uu- u u -uu- u u--	dactylic hexameter	masculine penthemimeral, trithemimeral
ὣς ἐφάμην, ὁ δέ μ’αὐτίκ’ ἀμειβόμενος προσέειπεν·	- uu- u u -u u-uu- uu--	dactylic hexameter	feminine penthemimeral, trithemimeral
υἱὸς Λαέρτεω, Ἰθάκῃ ἔνι οἰκία ναίων·	-- --- uu- uu -uu --	dactylic hexameter	masculine penthemimeral, hepthemimeral
τὸν δ’ἴδον ἐν νήσῳ θαλερὸν κατὰ δάκρυ χέοντα,	- uu - -- uu- uu -u u--	dactylic hexameter	masculine penthemimeral, hepthemimeral, trithemimeral
νύμφης ἐν μεγάροισι Καλυψοῦς, ἥ μιν ἀνάγκῃ	-- - uu-u u-- - u u--	dactylic hexameter	feminine penthemimeral, trithemimeral
ἴσχει· ὁ δ’οὐ δύναται ἣν πατρίδα γαῖαν ἱκέσθαι·	-u u - uu- - -uu -u u--	dactylic hexameter	masculine penthemimeral, trithemimeral
οὐ γάρ οἱ πάρα νῆες ἐπήρετμοι καὶ ἑταῖροι,	- - - uu -u u--- u u--	dactylic hexameter	feminine penthemimeral, trithemimeral
οἵ κέν μιν πέμποιεν ἐπ’ εὐρέα νῶτα θαλάσσης.	- - - --u u -uu -u u--	dactylic hexameter	feminine penthemimeral, trithemimeral
σοι δ’οὐ θέσφατόν ἐστι, διοτρεφὲς ὦ Μενέλαε,	- - -uu -u u-uu - uu--	dactylic hexameter	feminine penthemimeral
Ἄργει ἐν ἱπποβότῳ θανέειν καὶ πότμον ἐπισπεῖν,	-u u -uu- uu- - -u u--	dactylic hexameter	masculine penthemimeral, hepthemimeral
ἀλλά σ’ἐς Ἠλύσιον πεδίον καὶ πείρατα γαίης	-u u -uu- uu- - -uu --	dactylic hexameter	masculine penthemimeral, hepthemimeral
ἀθάνατοι πέμψουσιν, ὅθι ξανθὸς Ῥαδάμανθυς,	-uu- --u u- -- uu--	dactylic hexameter	feminine penthemimeral, hepthemimeral, trithemimeral
τῇ περ ῥηίστη βιοτὴ πέλει ἀνθρώποισιν·	- - --- uu- uu ----	dactylic hexameter	masculine penthemimeral, hepthemimeral
οὐ νιφετός, οὔτ’ ἂρ χειμὼν πολὺς οὔτε ποτ’ ὄμβρος,	- uu- - - -- uu -u u --	dactylic hexameter	masculine penthemimeral, hepthemimeral, trithemimeral
ἀλλ’ αἰεὶ Ζεφύροιο λιγὺ πνείοντος ἀήτας	- -- uu-u u- --u u--	dactylic hexameter	feminine penthemimeral, hepthemimeral, trithemimeral
Ὠκεανὸς ἀνίησιν ἀναψύχειν ἀνθρώπους·	-uu- uu-u u--- ---	dactylic hexameter	feminine penthemimeral, trithemimeral
οὕνεκ’ ἔχεις Ἑλένην καί σφιν γαμβρὸς Διός ἐσσι.	-u u- uu- - - -- uu --	dactylic hexameter	masculine penthemimeral, hepthemimeral, trithemimeral
ὣς εἰπὼν ὑπὸ πόντον ἐδύσατο κυμαίνοντα.	- -- uu -u u-uu ----	dactylic hexameter	feminine penthemimeral, trithemimeral
αὐτὰρ ἐγὼν ἐπὶ νῆας ἅμ’ ἀντιθέοις ἑτάροισιν	-u u- uu -u u -uu- uu--	dactylic hexameter	feminine penthemimeral, trithemimeral
ἤϊα, πολλὰ δέ μοι κραδίη πόρφυρε κιόντι.	-uu -u u - uu- --u u--	dactylic hexameter	masculine penthemimeral, hepthemimeral
αὐτὰρ ἐπεί ῥ’ἐπὶ νῆα κατήλθομεν ἠδὲ θάλασσαν,	-u u- uu -u u-uu -u u--	dactylic hexameter	feminine penthemimeral, trithemimeral
δόρπον θ’ὁπλισάμεσθ’, ἐπί τ’ἤλυθεν ἀμβροσίη νύξ,	-- -uu- uu -uu -uu- -	dactylic hexameter	masculine penthemimeral
δὴ τότε κοιμήθημεν ἐπὶ ῥηγμῖνι θαλάσσης.	- uu ---u u- --u u--	dactylic hexameter	feminine penthemimeral, hepthemimeral
ἦμος δ’ἠριγένεια φάνη ῥοδοδάκτυλος Ἠώς,	-- -uu-u u- uu-uu --	dactylic hexameter	feminine penthemimeral, hepthemimeral
νῆας μὲν πάμπρωτον ἐρύσσαμεν εἰς ἅλα δῖαν,	-- - --u u-uu - uu --	dactylic hexameter	feminine penthemimeral, trithemimeral
ἐν δ’ἱστοὺς τιθέμεσθα καὶ ἱστία νηυσὶν ἐίσῃς,	- -- uu-u u -uu -u u--	dactylic hexameter	feminine penthemimeral, trithemimeral
ἂν δὲ καὶ αὐτοὶ βάντες ἐπὶ κληῖσι καθῖζον·	- u u -- -u u- --u u--	dactylic hexameter	feminine penthemimeral, hepthemimeral
ἑξῆς δ’ἑζόμενοι πολιὴν ἅλα τύπτον ἐρετμοῖς.	-- -uu- uu- uu -u u--	dactylic hexameter	masculine penthemimeral, hepthemimeral
ἂψ δ’εἰς Αἰγύπτοιο διιπετέος ποταμοῖο	- - ---u u-uu- uu--	dactylic hexameter	feminine penthemimeral
στῆσα νέας, καὶ ἔρεξα τεληέσσας ἑκατόμβας.	-u u- u u-u u--- uu--	dactylic hexameter	feminine penthemimeral, trithemimeral
αὐτὰρ ἐπεὶ κατέπαυσα θεῶν χόλον αἰὲν ἐόντων,	-u u- uu-u u- uu -u u--	dactylic hexameter	feminine penthemimeral, hepthemimeral, trithemimeral
χεῦ’ Ἀγαμέμνονι τύμβον, ἵν’ ἄσβεστον κλέος εἴη.	- uu-uu -u u --- uu --	dactylic hexameter	feminine penthemimeral
ταῦτα τελευτήσας νεόμην, ἔδοσαν δέ μοι οὖρον	-u u--- uu- uu- u u --	dactylic hexameter	masculine penthemimeral, hepthemimeral
ἀθάνατοι, τοί μ’ὦκα φίλην ἐς πατρίδ’ ἔπεμψαν.	-uu- - -u u- - -u u--	dactylic hexameter	feminine penthemimeral, hepthemimeral, trithemimeral
ἀλλ’ ἄγε νῦν ἐπίμεινον ἐνὶ μεγάροισιν ἐμοῖσιν,	- uu - uu-u u- uu-u u--	dactylic hexameter	feminine penthemimeral, hepthemimeral, trithemimeral
ὄφρα κεν ἑνδεκάτη τε δυωδεκάτη τε γένηται·	-u u -uu- u u-uu- u u--	dactylic hexameter	masculine penthemimeral
καὶ τότε σ’εὖ πέμψω, δώσω δέ τοι ἀγλαὰ δῶρα,	- uu - -- -- u u -uu --	dactylic hexameter	masculine penthemimeral, hepthemimeral, trithemimeral
τρεῖς ἵππους καὶ δίφρον ἐύξοον· αὐτὰρ ἔπειτα	- -- - -u u-uu -u u--	dactylic hexameter	feminine penthemimeral, trithemimeral
δώσω καλὸν ἄλεισον, ἵνα σπένδῃσθα θεοῖσιν	-- -u u-u u- --u u--	dactylic hexameter	feminine penthemimeral, hepthemimeral
ἀθανάτοις ἐμέθεν μεμνημένος ἤματα πάντα.	-uu- uu- --uu -uu --	dactylic hexameter	masculine penthemimeral, trithemimeral
τὸν δ’αὖ Τηλέμαχος πεπνυμένος ἀντίον ηὔδα·	- - -uu- --uu -uu --	dactylic hexameter	masculine penthemimeral
Ἀτρεΐδη, μὴ δή με πολὺν χρόνον ἐνθάδ’ ἔρυκε.	-uu- - - u u- uu -u u--	dactylic hexameter	masculine penthemimeral, hepthemimeral, trithemimeral
καὶ γάρ κ’εἰς ἐνιαυτὸν ἐγὼ παρὰ σοί γ’ἀνεχοίμην	- - - uu-u u- uu - uu--	dactylic hexameter	feminine penthemimeral, hepthemimeral, trithemimeral
ἥμενος, οὐδέ κέ μ’οἴκου ἕλοι πόθος οὐδὲ τοκήων·	-uu -u u -u u- uu -u u--	dactylic hexameter	feminine penthemimeral, hepthemimeral
αἰνῶς γὰρ μύθοισιν ἔπεσσί τε σοῖσιν ἀκούων	-- - --u u-u u -u u--	dactylic hexameter	feminine penthemimeral, trithemimeral
τέρπομαι. ἀλλ’ ἤδη μοι ἀνιάζουσιν ἑταῖροι	-uu - -- u u---u u--	dactylic hexameter	masculine penthemimeral, trithemimeral
ἐν Πύλῳ ἠγαθέῃ· σὺ δέ με χρόνον ἐνθάδ’ ἐρύκεις.	- uu -uu- u u - uu -u u--	dactylic hexameter	masculine penthemimeral, hepthemimeral
δῶρον δ’ὅττι κέ μοι δοίης, κειμήλιον ἔστω·	-- -u u - -- --uu --	dactylic hexameter	masculine penthemimeral, hepthemimeral
ἵππους δ’εἰς Ἰθάκην οὐκ ἄξομαι, ἀλλὰ σοὶ αὐτῷ	-- - uu- - -uu -u u --	dactylic hexameter	masculine penthemimeral, trithemimeral
ἐνθάδε λείψω ἄγαλμα· σὺ γὰρ πεδίοιο ἀνάσσεις	-uu -u u-u u - uu-u u--	dactylic hexameter	feminine penthemimeral, hepthemimeral
εὐρέος, ᾧ ἔνι μὲν λωτὸς πολύς, ἐν δὲ κύπειρον	-uu - uu - -- uu - u u--	dactylic hexameter	masculine penthemimeral, hepthemimeral, trithemimeral
πυροί τε ζειαί τε ἰδ’ εὐρυφυὲς κρῖ λευκόν.	-- - -- u u -uu- - --	dactylic hexameter	masculine penthemimeral, trithemimeral
ἐν δ’Ἰθάκῃ οὔτ’ ἂρ δρόμοι εὐρέες οὔτε τι λειμών·	- uu- - - uu -uu -u u --	dactylic hexameter	masculine penthemimeral, trithemimeral
αἰγίβοτος, καὶ μᾶλλον ἐπήρατος ἱπποβότοιο.	-uu- - -u u-uu -uu--	dactylic hexameter	feminine penthemimeral, trithemimeral
οὐ γάρ τις νήσων ἱππήλατος οὐδ’ ἐυλείμων,	- - - -- --uu - uu--	dactylic hexameter	masculine penthemimeral, trithemimeral
αἵ θ’ἁλὶ κεκλίαται· Ἰθάκη δέ τε καὶ περὶ πασέων.	- uu -uu- uu- u u - uu --	dactylic hexameter	masculine penthemimeral, hepthemimeral
ὣς φάτο, μείδησεν δὲ βοὴν ἀγαθὸς Μενέλαος,	- uu --- u u- uu- uu--	dactylic hexameter	masculine penthemimeral, hepthemimeral
χειρί τέ μιν κατέρεξεν ἔπος τ’ἔφατ’ ἔκ τ’ὀνόμαζεν·	-u u - uu-u u- uu - uu--	dactylic hexameter	feminine penthemimeral, hepthemimeral, trithemimeral
αἵματός εἰς ἀγαθοῖο, φίλον τέκος, οἷ’ ἀγορεύεις·	-uu - uu-u u- uu - uu--	dactylic hexameter	feminine penthemimeral, hepthemimeral, trithemimeral
τοιγὰρ ἐγώ τοι ταῦτα μεταστήσω· δύναμαι γάρ.	-u u- - -u u--- uu- -	dactylic hexameter	feminine penthemimeral, trithemimeral
δώρων δ’ὅσσ’ ἐν ἐμῷ οἴκῳ κειμήλια κεῖται,	-- - u u- -- --uu --	dactylic hexameter	masculine penthemimeral, hepthemimeral, trithemimeral
δώσω ὃ κάλλιστον καὶ τιμηέστατόν ἐστι·	-u u --- - ---uu --	dactylic hexameter	masculine penthemimeral
δώσω τοι κρητῆρα τετυγμένον· ἀργύρεος δὲ	-- - --u u-uu -uu- -	dactylic hexameter	feminine penthemimeral, trithemimeral
ἔστιν ἅπας, χρυσῷ δ’ἐπὶ χείλεα κεκράανται,	-u u- -- uu -uu ----	dactylic hexameter	masculine penthemimeral, trithemimeral
ἔργον δ’Ἡφαίστοιο. πόρεν δέ ἑ Φαίδιμος ἥρως,	-- ---u u- u u -uu --	dactylic hexameter	feminine penthemimeral, hepthemimeral
Σιδονίων βασιλεύς, ὅθ’ ἑὸς δόμος ἀμφεκάλυψε	-uu- uu- u u- uu -uu--	dactylic hexameter	masculine penthemimeral, hepthemimeral, trithemimeral
κεῖσέ με νοστήσαντα· τεῒν δ’ἐθέλω τόδ’ ὀπάσσαι.	-u u ---u u- uu- u u--	dactylic hexameter	feminine penthemimeral, hepthemimeral
ὣς οἱ μὲν τοιαῦτα πρὸς ἀλλήλους ἀγόρευον,	- - - --u u --- uu--	dactylic hexameter	feminine penthemimeral, trithemimeral
δαιτυμόνες δ’ἐς δώματ’ ἴσαν θείου βασιλῆος.	-uu- - -u u- -- uu--	dactylic hexameter	feminine penthemimeral, hepthemimeral, trithemimeral
οἱ δ’ἦγον μὲν μῆλα, φέρον δ’εὐήνορα οἶνον·	- -- - -u u- --uu --	dactylic hexameter	feminine penthemimeral, hepthemimeral, trithemimeral
σῖτον δέ σφ’ἄλοχοι καλλικρήδεμνοι ἔπεμπον.	-- - uu- ----u u--	dactylic hexameter	masculine penthemimeral, trithemimeral
ὣς οἱ μὲν περὶ δεῖπνον ἐνὶ μεγάροισι πένοντο.	- - - uu -u u- uu-u u--	dactylic hexameter	feminine penthemimeral, hepthemimeral, trithemimeral
μνηστῆρες δὲ πάροιθεν Ὀδυσσῆος μεγάροιο	--- u u-u u--- uu--	dactylic hexameter	feminine penthemimeral, trithemimeral
δίσκοισιν τέρποντο καὶ αἰγανέῃσιν ἱέντες	--- --u u -uu-u u--	dactylic hexameter	feminine penthemimeral, trithemimeral
ἐν τυκτῷ δαπέδῳ, ὅθι περ πάρος, ὕβριν ἔχεσκον.	- -- uu- uu - uu -u u--	dactylic hexameter	masculine penthemimeral, hepthemimeral, trithemimeral
Ἀντίνοος δὲ καθῆστο καὶ Εὐρύμαχος θεοειδής,	-uu- u u-u u -uu- uu--	dactylic hexameter	feminine penthemimeral, trithemimeral
ἀρχοὶ μνηστήρων, ἀρετῇ δ’ἔσαν ἔξοχ’ ἄριστοι.	-- --- uu- uu -u u--	dactylic hexameter	masculine penthemimeral, hepthemimeral
τοῖς δ’υἱὸς Φρονίοιο Νοήμων ἐγγύθεν ἐλθὼν	- -- uu-u u-- -uu --	dactylic hexameter	feminine penthemimeral, trithemimeral
Ἀντίνοον μύθοισιν ἀνειρόμενος προσέειπεν·	-uu- --u u-uu- uu--	dactylic hexameter	feminine penthemimeral, trithemimeral
Ἀντίνο’, ἦ ῥά τι ἴδμεν ἐνὶ φρεσίν, ἦε καὶ οὐκί,	-uu - u u -u u- uu -u u --	dactylic hexameter	feminine penthemimeral, hepthemimeral, trithemimeral
ὁππότε Τηλέμαχος νεῖτ’ ἐκ Πύλου ἠμαθόεντος;	-uu -uu- - - uu -uu--	dactylic hexameter	masculine penthemimeral, hepthemimeral
νῆά μοι οἴχετ’ ἄγων· ἐμὲ δὲ χρεὼ γίνεται αὐτῆς	-u u -u u- uu - - -uu --	dactylic hexameter	masculine penthemimeral, hepthemimeral
Ἤλιδ’ ἐς εὐρύχορον διαβήμεναι, ἔνθα μοι ἵπποι	-u u -uu- uu-uu -u u --	dactylic hexameter	masculine penthemimeral
δώδεκα θήλειαι, ὑπὸ δ’ἡμίονοι ταλαεργοὶ	-uu --- uu -uu- uu--	dactylic hexameter	masculine penthemimeral
ἀδμῆτες· τῶν κέν τιν’ ἐλασσάμενος δαμασαίμην.	--- - - u u-uu- uu--	dactylic hexameter	masculine penthemimeral, trithemimeral
ὣς ἔφαθ’, οἱ δ’ἀνὰ θυμὸν ἐθάμβεον· οὐ γὰρ ἔφαντο	- uu - uu -u u-uu - u u--	dactylic hexameter	feminine penthemimeral, trithemimeral
ἐς Πύλον οἴχεσθαι Νηλήιον, ἀλλά που αὐτοῦ	- uu --- --uu -u u --	dactylic hexameter	masculine penthemimeral
ἀγρῶν ἢ μήλοισι παρέμμεναι ἠὲ συβώτῃ.	-- - --u u-uu -u u--	dactylic hexameter	feminine penthemimeral, trithemimeral
τὸν δ’αὖτ’ Ἀντίνοος προσέφη Εὐπείθεος υἱός·	- - -uu- uu- --uu --	dactylic hexameter	masculine penthemimeral, hepthemimeral
νημερτές μοι ἔνισπε, πότ’ ᾤχετο καὶ τίνες αὐτῷ	--- u u-u u -uu - uu --	dactylic hexameter	feminine penthemimeral, trithemimeral
κοῦροι ἕποντ’; Ἰθάκης ἐξαίρετοι, ἦ ἑοὶ αὐτοῦ	-u u- uu- --uu - - --	dactylic hexameter	masculine penthemimeral, trithemimeral
θῆτές τε δμῶές τε; δύναιτό κε καὶ τὸ τελέσσαι.	-- - -- u u-u u - u u--	dactylic hexameter	masculine penthemimeral, trithemimeral
καί μοι τοῦτ’ ἀγόρευσον ἐτήτυμον, ὄφρ’ ἐὺ εἰδῶ,	- - - uu-u u-uu - uu --	dactylic hexameter	feminine penthemimeral, trithemimeral
ἤ σε βίῃ ἀέκοντος ἀπηύρα νῆα μέλαιναν,	- u u- uu-u u-- -u u--	dactylic hexameter	feminine penthemimeral, trithemimeral
ἦε ἑκών οἱ δῶκας, ἐπεὶ προσπτύξατο μύθῳ.	-u u- - -u u- --uu --	dactylic hexameter	feminine penthemimeral, hepthemimeral, trithemimeral
τὸν δ’υἱὸς Φρονίοιο Νοήμων ἀντίον ηὔδα·	- -- uu-u u-- -uu --	dactylic hexameter	feminine penthemimeral, trithemimeral
αὐτὸς ἑκών οἱ δῶκα· τί κεν ῥέξειε καὶ ἄλλος,	-u u- - -u u - --u u --	dactylic hexameter	feminine penthemimeral, hepthemimeral, trithemimeral
ὁππότ’ ἀνὴρ τοιοῦτος ἔχων μελεδήματα θυμῷ	-u u- --u u- uu-uu --	dactylic hexameter	feminine penthemimeral, hepthemimeral, trithemimeral
αἰτίζῃ; χαλεπόν κεν ἀνήνασθαι δόσιν εἴη.	--- uu- u u--- uu --	dactylic hexameter	masculine penthemimeral, trithemimeral
κοῦροι δ’,οἳ κατὰ δῆμον ἀριστεύουσι μεθ’ ἡμέας,	-- - uu -u u---u u --	dactylic hexameter	feminine penthemimeral, trithemimeral
οἵ οἱ ἕποντ’· ἐν δ’ἀρχὸν ἐγὼ βαίνοντ’ ἐνόησα	- u u- - -u u- -- uu--	dactylic hexameter	feminine penthemimeral, hepthemimeral, trithemimeral
Μέντορα, ἠὲ θεόν, τῷ δ’αὐτῷ πάντα ἐῴκει.	-uu -u u- - -- -u u--	dactylic hexameter	masculine penthemimeral
ἀλλὰ τὸ θαυμάζω· ἴδον ἐνθάδε Μέντορα δῖον	-u u --- uu -uu -uu --	dactylic hexameter	masculine penthemimeral
χθιζὸν ὑπηοῖον, τότε δ’ἔμβη νηὶ Πύλονδε.	-u u--- uu -- -u u--	dactylic hexameter	masculine penthemimeral
ὣς ἄρα φωνήσας ἀπέβη πρὸς δώματα πατρός,	- uu --- uu- - -uu --	dactylic hexameter	masculine penthemimeral, hepthemimeral
τοῖσιν δ’ἀμφοτέροισιν ἀγάσσατο θυμὸς ἀγήνωρ.	-- -uu-u u-uu -u u--	dactylic hexameter	feminine penthemimeral
μνηστῆρας δ’ἄμυδις κάθισαν καὶ παῦσαν ἀέθλων.	--- uu- uu- - -u u--	dactylic hexameter	masculine penthemimeral, hepthemimeral, trithemimeral
τοῖσιν δ’Ἀντίνοος μετέφη Εὐπείθεος υἱός,	-- -uu- uu- --uu --	dactylic hexameter	masculine penthemimeral, hepthemimeral
ἀχνύμενος· μένεος δὲ μέγα φρένες ἀμφιμέλαιναι	-uu- uu- u u- uu -uu--	dactylic hexameter	masculine penthemimeral, hepthemimeral, trithemimeral
πίμπλαντ’, ὄσσε δέ οἱ πυρὶ λαμπετόωντι ἐίκτην·	-- -u u - uu -uu-u u--	dactylic hexameter	masculine penthemimeral
ὢ πόποι, ἦ μέγα ἔργον ὑπερφιάλως ἐτελέσθη	- uu - uu -u u-uu- uu--	dactylic hexameter	feminine penthemimeral, trithemimeral
Τηλεμάχῳ ὁδὸς ἥδε· φάμεν δέ οἱ οὐ τελέεσθαι.	-uu- uu -u u- u u - uu--	dactylic hexameter	feminine penthemimeral, hepthemimeral, trithemimeral
εἰ τοσσῶνδ’ ἀέκητι νέος πάϊς οἴχεται αὔτως	- -- uu-u u- uu -uu --	dactylic hexameter	feminine penthemimeral, hepthemimeral, trithemimeral
νῆα ἐρυσσάμενος, κρίνας τ’ἀνὰ δῆμον ἀρίστους.	-u u-uu- -- uu -u u--	dactylic hexameter	masculine penthemimeral, hepthemimeral
ἄρξει καὶ προτέρω κακὸν ἔμμεναι· ἀλλά οἱ αὐτῷ	-- - uu- uu -uu -u u --	dactylic hexameter	masculine penthemimeral, trithemimeral
Ζεὺς ὀλέσειε βίην, πρὶν ἡμῖν πῆμα γενέσθαι.	- uu-u u- - -- -u u--	dactylic hexameter	masculine penthemimeral
ἀλλ’ ἄγε μοι δότε νῆα θοὴν καὶ εἴκοσ’ ἑταίρους,	- uu - uu -u u- - -u u--	dactylic hexameter	feminine penthemimeral, hepthemimeral, trithemimeral
ὄφρα μιν αὐτὸν ἰόντα λοχήσομαι ἠδὲ φυλάξω	-u u -u u-u u-uu -u u--	dactylic hexameter	feminine penthemimeral
ἐν πορθμῷ Ἰθάκης τε Σάμοιό τε παιπαλοέσσης,	- -- uu- u u-u u -uu--	dactylic hexameter	masculine penthemimeral, trithemimeral
ὡς ἂν ἐπισμυγερῶς ναυτίλλεται εἵνεκα πατρός.	- u u-uu- --uu -uu --	dactylic hexameter	masculine penthemimeral
ὣς ἔφαθ’, οἱ δ’ἄρα πάντες ἐπῄνεον ἠδ’ ἐκέλευον.	- uu - uu -u u-uu - uu--	dactylic hexameter	feminine penthemimeral, trithemimeral
αὐτίκ’ ἔπειτ’ ἀνστάντες ἔβαν δόμον εἰς Ὀδυσῆος.	-u u- --u u- uu - uu--	dactylic hexameter	feminine penthemimeral, hepthemimeral, trithemimeral
οὐδ’ ἄρα Πηνελόπεια πολὺν χρόνον ἦεν ἄπυστος	- uu -uu-u u- uu -u u--	dactylic hexameter	feminine penthemimeral, hepthemimeral
μύθων, οὓς μνηστῆρες ἐνὶ φρεσὶ βυσσοδόμευον·	-- - --u u- uu -uu--	dactylic hexameter	feminine penthemimeral, hepthemimeral, trithemimeral
κῆρυξ γάρ οἱ ἔειπε Μέδων, ὃς ἐπεύθετο βουλὰς	-- - u u-u u- u u-uu --	dactylic hexameter	feminine penthemimeral, hepthemimeral, trithemimeral
αὐλῆς ἐκτὸς ἐών· οἱ δ’ἔνδοθι μῆτιν ὕφαινον.	-- -u u- - -uu -u u--	dactylic hexameter	masculine penthemimeral
βῆ δ’ἴμεν ἀγγελέων διὰ δώματα Πηνελοπείῃ·	- uu -uu- uu -uu -uu--	dactylic hexameter	masculine penthemimeral
τὸν δὲ κατ’ οὐδοῦ βάντα προσηύδα Πηνελόπεια·	- u u -- -u u-- -uu--	dactylic hexameter	feminine penthemimeral
κῆρυξ, τίπτε δέ σε πρόεσαν μνηστῆρες ἀγαυοί;	-- -u u - uu- --u u--	dactylic hexameter	masculine penthemimeral, hepthemimeral
ἦ εἰ πέμεναι δμῳῇσιν Ὀδυσσῆος θείοιο	- uu- --u u--- ---	dactylic hexameter	feminine penthemimeral, trithemimeral
ἔργων παύσασθαι, σφίσι δ’αὐτοῖς δαῖτα πένεσθαι;	-- --- uu -- -u u--	dactylic hexameter	masculine penthemimeral
μὴ μνηστεύσαντες μηδ’ ἄλλοθ’ ὁμιλήσαντες	- ---- - -u u----	dactylic hexameter	masculine penthemimeral
ὕστατα καὶ πύματα νῦν ἐνθάδε δειπνήσειαν·	-uu - uu- - -uu ----	dactylic hexameter	masculine penthemimeral, trithemimeral
οἳ θάμ’ ἀγειρόμενοι βίοτον κατακείρετε πολλόν,	- u u-uu- uu- uu-uu --	dactylic hexameter	masculine penthemimeral, hepthemimeral
κτῆσιν Τηλεμάχοιο δαΐφρονος· οὐδέ τι πατρῶν	-- -uu-u u-uu -u u --	dactylic hexameter	feminine penthemimeral
ὑμετέρων τὸ πρόσθεν ἀκούετε, παῖδες ἐόντες,	-uu- - -u u-uu -u u--	dactylic hexameter	feminine penthemimeral, trithemimeral
οἷος Ὀδυσσεὺς ἔσκε μεθ’ ὑμετέροισι τοκεῦσιν,	-u u-- -u u -uu-u u--	dactylic hexameter	feminine penthemimeral
οὔτε τινὰ ῥέξας ἐξαίσιον οὔτε τι εἰπὼν	-u u- -- --uu -u u --	dactylic hexameter	masculine penthemimeral, trithemimeral
ἐν δήμῳ, ἥ τ’ἐστὶ δίκη θείων βασιλήων·	- -- - -u u- -- uu--	dactylic hexameter	feminine penthemimeral, hepthemimeral, trithemimeral
ἄλλον κ’ἐχθαίρῃσι βροτῶν, ἄλλον κε φιλοίη.	-- ---u u- -- u u--	dactylic hexameter	feminine penthemimeral, hepthemimeral
κεῖνος δ’οὔ ποτε πάμπαν ἀτάσθαλον ἄνδρα ἐώργει.	-- - uu -u u-uu -u u--	dactylic hexameter	feminine penthemimeral, trithemimeral
ἀλλ’ ὁ μὲν ὑμέτερος θυμὸς καὶ ἀεικέα ἔργα	- u u -uu- -- u u-uu --	dactylic hexameter	masculine penthemimeral, hepthemimeral
φαίνεται, οὐδέ τίς ἐστι χάρις μετόπισθ’ ἐυεργέων.	-uu -u u -u u- uu- uu--	dactylic hexameter	feminine penthemimeral, hepthemimeral
τὴν δ’αὖτε προσέειπε Μέδων πεπνυμένα εἰδώς·	- -- uu-u u- --uu --	dactylic hexameter	feminine penthemimeral, hepthemimeral, trithemimeral
εἰ γὰρ δή, βασίλεια, τόδε πλεῖστον κακὸν εἴη.	- - - uu-u u- -- uu --	dactylic hexameter	feminine penthemimeral, hepthemimeral, trithemimeral
ἀλλὰ πολὺ μεῖζόν τε καὶ ἀργαλεώτερον ἄλλο	-u u- -- u u -uu-uu --	dactylic hexameter	masculine penthemimeral, trithemimeral
μνηστῆρες φράζονται, ὃ μὴ τελέσειε Κρονίων·	--- --u u - uu-u u--	dactylic hexameter	feminine penthemimeral, hepthemimeral, trithemimeral
Τηλέμαχον μεμάασι κατακτάμεν ὀξέι χαλκῷ	-uu- uu-u u-uu -uu --	dactylic hexameter	feminine penthemimeral, trithemimeral
οἴκαδε νισόμενον· ὁ δ’ἔβη μετὰ πατρὸς ἀκουὴν	-uu -uu- u u- uu -u u--	dactylic hexameter	masculine penthemimeral, hepthemimeral
ἐς Πύλον ἠγαθέην ἠδ’ ἐς Λακεδαίμονα δῖαν.	- uu -uu- - - uu-uu --	dactylic hexameter	masculine penthemimeral, hepthemimeral
ὣς φάτο, τῆς δ’αὐτοῦ λύτο γούνατα καὶ φίλον ἦτορ,	- uu - -- uu -uu - uu --	dactylic hexameter	masculine penthemimeral, trithemimeral
δὴν δέ μιν ἀμφασίη ἐπέων λάβε· τὼ δέ οἱ ὄσσε	- u u -uu- uu- uu - u u --	dactylic hexameter	masculine penthemimeral, hepthemimeral
δακρυόφιν πλῆσθεν, θαλερὴ δέ οἱ ἔσχετο φωνή.	-uu- -- uu- u u -uu --	dactylic hexameter	masculine penthemimeral, hepthemimeral, trithemimeral
ὀψὲ δὲ δή μιν ἔπεσσιν ἀμειβομένη προσέειπε·	-u u - u u-u u-uu- uu--	dactylic hexameter	feminine penthemimeral, trithemimeral
κῆρυξ, τίπτε δέ μοι πάϊς οἴχεται; οὐδέ τί μιν χρεὼ	-- -u u - uu -uu -u u - -	dactylic hexameter	masculine penthemimeral
νηῶν ὠκυπόρων ἐπιβαινέμεν, αἵ θ’ἁλὸς ἵπποι	-- -uu- uu-uu - uu --	dactylic hexameter	masculine penthemimeral
ἀνδράσι γίνονται ,  περόωσι δὲ πουλὺν ἐφ’ ὑγρήν.	-uu --- uu-u u -u u --	dactylic hexameter	masculine penthemimeral
ἦ ἵνα μηδ’ ὄνομ’ αὐτοῦ ἐν ἀνθρώποισι λίπηται;	- uu - uu -u u ---u u--	dactylic hexameter	feminine penthemimeral, trithemimeral
τὴν δ’ἠμείβετ’ ἔπειτα Μέδων πεπνυμένα εἰδώς·	- --u u-u u- --uu --	dactylic hexameter	feminine penthemimeral, hepthemimeral
οὐκ οἶδ’ εἴ τίς μιν θεὸς ὤρορεν, ἦε καὶ αὐτοῦ	- - - - - uu -uu -u u --	dactylic hexameter	masculine penthemimeral, trithemimeral
θυμὸς ἐφωρμήθη ἴμεν ἐς Πύλον, ὄφρα πύθηται	-u u--- uu - uu -u u--	dactylic hexameter	masculine penthemimeral, hepthemimeral
πατρὸς ἑοῦ ἢ νόστον ἢ ὅν τινα πότμον ἐπέσπεν.	-u u- - -u u - uu -u u--	dactylic hexameter	feminine penthemimeral, hepthemimeral, trithemimeral
ὣς ἄρα φωνήσας ἀπέβη κατὰ δῶμ’ Ὀδυσῆος.	- uu --- uu- uu - uu--	dactylic hexameter	masculine penthemimeral, hepthemimeral
τὴν δ’ἄχος ἀμφεχύθη θυμοφθόρον, οὐδ’ ἄρ’ ἔτ’ ἔτλη	- uu -uu- --uu - u u --	dactylic hexameter	masculine penthemimeral
δίφρῳ ἐφέζεσθαι πολλῶν κατὰ οἶκον ἐόντων,	-u u--- -- uu -u u--	dactylic hexameter	masculine penthemimeral, hepthemimeral
ἀλλ’ ἄρ’ ἐπ’ οὐδοῦ ἷζε πολυκμήτου θαλάμοιο	- u u -- -u u--- uu--	dactylic hexameter	feminine penthemimeral
οἴκτρ’ ὀλοφυρομένη· περὶ δὲ δμῳαὶ μινύριζον	- uu-uu- uu - -- uu--	dactylic hexameter	masculine penthemimeral, hepthemimeral
πᾶσαι, ὅσαι κατὰ δώματ’ ἔσαν νέαι ἠδὲ παλαιαί.	-u u- uu -u u- uu -u u--	dactylic hexameter	feminine penthemimeral, hepthemimeral, trithemimeral
τῇς δ’ἁδινὸν γοόωσα μετηύδα Πηνελόπεια·	- uu- uu-u u-- -uu--	dactylic hexameter	feminine penthemimeral, trithemimeral
κλῦτε, φίλαι· πέρι γάρ μοι Ὀλύμπιος ἄλγε’ ἔδωκεν	-u u- uu - u u-uu -u u--	dactylic hexameter	masculine penthemimeral, trithemimeral
ἐκ πασέων, ὅσσαι μοι ὁμοῦ τράφεν ἠδ’ ἐγένοντο·	- uu- -- u u- uu - uu--	dactylic hexameter	masculine penthemimeral, hepthemimeral, trithemimeral
ἣ πρὶν μὲν πόσιν ἐσθλὸν ἀπώλεσα θυμολέοντα,	- - - uu -u u-uu -uu--	dactylic hexameter	feminine penthemimeral, trithemimeral
παντοίῃς ἀρετῇσι κεκασμένον ἐν Δαναοῖσιν,	--- uu-u u-uu - uu--	dactylic hexameter	feminine penthemimeral, trithemimeral
ἐσθλόν, τοῦ κλέος εὐρὺ καθ’ Ἑλλάδα καὶ μέσον Ἄργος.	-- - uu -u u -uu - uu --	dactylic hexameter	feminine penthemimeral, trithemimeral
νῦν αὖ παῖδ’ ἀγαπητὸν ἀνηρείψαντο θύελλαι	- - - uu-u u---u u--	dactylic hexameter	feminine penthemimeral, trithemimeral
ἀκλέα ἐκ μεγάρων, οὐδ’ ὁρμηθέντος ἄκουσα.	-uu - uu- - ---u u--	dactylic hexameter	masculine penthemimeral, trithemimeral
σχέτλιαι, οὐδ’ ὑμεῖς περ ἐνὶ φρεσὶ θέσθε ἑκάστη	-uu - -- u u- uu -u u--	dactylic hexameter	masculine penthemimeral, hepthemimeral, trithemimeral
ἐκ λεχέων μ’ἀνεγεῖραι, ἐπιστάμεναι σάφα θυμῷ,	- uu- uu-u u-uu- uu --	dactylic hexameter	feminine penthemimeral, trithemimeral
ὁππότ’ ἐκεῖνος ἔβη κοίλην ἐπὶ νῆα μέλαιναν.	-u u-u u- -- uu -u u--	dactylic hexameter	masculine penthemimeral, hepthemimeral
εἰ γὰρ ἐγὼ πυθόμην ταύτην ὁδὸν ὁρμαίνοντα,	- u u- uu- -- uu ----	dactylic hexameter	masculine penthemimeral, hepthemimeral, trithemimeral
τῶ κε μάλ’ ἤ κεν ἔμεινε καὶ ἐσσύμενός περ ὁδοῖο,	- u u - u u-u u -uu- u u--	dactylic hexameter	feminine penthemimeral, trithemimeral
ἤ κέ με τεθνηκυῖαν ἐνὶ μεγάροισιν ἔλειπεν.	- u u ---u u- uu-u u--	dactylic hexameter	feminine penthemimeral, hepthemimeral
ἀλλά τις ὀτρηρῶς Δολίον καλέσειε γέροντα,	-u u --- uu- uu-u u--	dactylic hexameter	masculine penthemimeral, hepthemimeral
δμῶ’ ἐμόν, ὅν μοι δῶκε πατὴρ ἔτι δεῦρο κιούσῃ,	- uu - - -u u- uu -u u--	dactylic hexameter	feminine penthemimeral, hepthemimeral, trithemimeral
καί μοι κῆπον ἔχει πολυδένδρεον, ὄφρα τάχιστα	- - -u u- uu-uu -u u--	dactylic hexameter	masculine penthemimeral
Λαέρτῃ τάδε πάντα παρεζόμενος καταλέξῃ,	--- uu -u u-uu- uu--	dactylic hexameter	feminine penthemimeral, trithemimeral
εἰ δή πού τινα κεῖνος ἐνὶ φρεσὶ μῆτιν ὑφήνας	- - - uu -u u- uu -u u--	dactylic hexameter	feminine penthemimeral, hepthemimeral, trithemimeral
ἐξελθὼν λαοῖσιν ὀδύρεται, οἳ μεμάασιν	--- --u u-uu - uu--	dactylic hexameter	feminine penthemimeral, trithemimeral
ὃν καὶ Ὀδυσσῆος φθῖσαι γόνον ἀντιθέοιο.	- u u--- -- uu -uu--	dactylic hexameter	masculine penthemimeral, hepthemimeral
τὴν δ’αὖτε προσέειπε φίλη τροφὸς Εὐρύκλεια·	- -- uu-u u- uu ----	dactylic hexameter	feminine penthemimeral, hepthemimeral, trithemimeral
νύμφα φίλη, σὺ μὲν ἄρ με κατάκτανε νηλέι χαλκῷ	-u u- u u - u u-uu -uu --	dactylic hexameter	masculine penthemimeral, trithemimeral
ἢ ἔα ἐν μεγάρῳ· μῦθον δέ τοι οὐκ ἐπικεύσω.	- uu - uu- -- u u - uu--	dactylic hexameter	masculine penthemimeral, hepthemimeral, trithemimeral
ᾔδε’ ἐγὼ τάδε πάντα, πόρον δέ οἱ ὅσσ’ ἐκέλευσε,	-u u- uu -u u- u u - uu--	dactylic hexameter	feminine penthemimeral, hepthemimeral, trithemimeral
σῖτον καὶ μέθυ ἡδύ· ἐμεῦ δ’ἕλετο μέγαν ὅρκον	-- - uu -u u- uu- uu --	dactylic hexameter	feminine penthemimeral, hepthemimeral, trithemimeral
μὴ πρὶν σοὶ ἐρέειν, πρὶν δωδεκάτην τε γενέσθαι	- - - uu- - -uu- u u--	dactylic hexameter	masculine penthemimeral, trithemimeral
ἢ σ’αὐτὴν ποθέσαι καὶ ἀφορμηθέντος ἀκοῦσαι,	- -- uu- u u---u u--	dactylic hexameter	masculine penthemimeral, trithemimeral
ὡς ἂν μὴ κλαίουσα κατὰ χρόα καλὸν ἰάπτῃς.	- - - --u u- uu -u u--	dactylic hexameter	feminine penthemimeral, hepthemimeral, trithemimeral
ἀλλ’ ὑδρηναμένη, καθαρὰ χροῒ εἵμαθ’ ἑλοῦσα,	- --uu- uu- uu -u u--	dactylic hexameter	masculine penthemimeral, hepthemimeral
εἰς ὑπερῷ’ ἀναβᾶσα σὺν ἀμφιπόλοισι γυναιξὶν	- uu- uu-u u -uu-u u--	dactylic hexameter	feminine penthemimeral, trithemimeral
εὔχε’ Ἀθηναίῃ κούρῃ Διὸς αἰγιόχοιο·	-u u--- -- uu -uu--	dactylic hexameter	masculine penthemimeral, hepthemimeral
ἡ γάρ κέν μιν ἔπειτα καὶ ἐκ θανάτοιο σαώσαι.	- - - u u-u u - uu-u u--	dactylic hexameter	feminine penthemimeral, hepthemimeral, trithemimeral
μηδὲ γέροντα κάκου κεκακωμένον· οὐ γὰρ ὀίω	-u u-u u- uu-uu - u u--	dactylic hexameter	masculine penthemimeral
πάγχυ θεοῖς μακάρεσσι γονὴν Ἀρκεισιάδαο	-u u- uu-u u- --uu--	dactylic hexameter	feminine penthemimeral, hepthemimeral, trithemimeral
ἔχθεσθ’, ἀλλ’ ἔτι πού τις ἐπέσσεται ὅς κεν ἔχῃσι	-- - uu - u u-uu - u u--	dactylic hexameter	masculine penthemimeral, trithemimeral
δώματά θ’ὑψερεφέα καὶ ἀπόπροθι πίονας ἀγρούς.	-uu -uu- u u-uu -uu --	dactylic hexameter	masculine penthemimeral
ὣς φάτο, τῆς δ’εὔνησε γόον, σχέθε δ’ὄσσε γόοιο.	- uu - --u u- uu -u u--	dactylic hexameter	feminine penthemimeral, hepthemimeral, trithemimeral
ἡ δ’ὑδρηναμένη, καθαρὰ χροῒ εἵμαθ’ ἑλοῦσα	- --uu- uu- uu -u u--	dactylic hexameter	masculine penthemimeral, hepthemimeral
εἰς ὑπερῷ’ ἀνέβαινε σὺν ἀμφιπόλοισι γυναιξίν,	- uu- uu-u u -uu-u u--	dactylic hexameter	feminine penthemimeral, trithemimeral
ἐν δ’ἔθετ’ οὐλοχύτας κανέῳ, ἠρᾶτο δ’Ἀθήνῃ·	- uu -uu- uu- --u u--	dactylic hexameter	masculine penthemimeral, hepthemimeral
κλῦθί μοι, αἰγιόχοιο Διὸς τέκος, Ἀτρυτώνη,	-u u -uu-u u- uu ----	dactylic hexameter	feminine penthemimeral, hepthemimeral
εἴ ποτέ τοι πολύμητις ἐνὶ μεγάροισιν Ὀδυσσεὺς	- uu - uu-u u- uu-u u--	dactylic hexameter	feminine penthemimeral, hepthemimeral, trithemimeral
ἢ βοὸς ἢ ὄϊος κατὰ πίονα μηρί’ ἔκηε,	- uu - uu- uu -uu -u u--	dactylic hexameter	masculine penthemimeral, trithemimeral
τῶν νῦν μοι μνῆσαι, καί μοι φίλον υἷα σάωσον,	- - - -- - - uu -u u--	dactylic hexameter	masculine penthemimeral, hepthemimeral, trithemimeral
μνηστῆρας δ’ἀπάλαλκε κακῶς ὑπερηνορέοντας.	--- uu-u u- uu-uu--	dactylic hexameter	feminine penthemimeral, hepthemimeral, trithemimeral
ὣς εἰποῦσ’ ὀλόλυξε, θεὰ δέ οἱ ἔκλυεν ἀρῆς.	- -- uu-u u- u u -uu --	dactylic hexameter	feminine penthemimeral, hepthemimeral, trithemimeral
μνηστῆρες δ’ὁμάδησαν ἀνὰ μέγαρα σκιόεντα·	--- uu-u u- uu- uu--	dactylic hexameter	feminine penthemimeral, hepthemimeral, trithemimeral
ὧδε δέ τις εἴπεσκε νέων ὑπερηνορεόντων·	-u u - --u u- uu-uu--	dactylic hexameter	feminine penthemimeral, hepthemimeral, trithemimeral
ἦ μάλα δὴ γάμον ἄμμι πολυμνήστη βασίλεια	- uu - uu -u u--- uu--	dactylic hexameter	feminine penthemimeral, trithemimeral
ἀρτύει, οὐδέ τι οἶδεν ὅ οἱ φόνος υἷι τέτυκται.	-uu -u u -u u - uu -u u--	dactylic hexameter	feminine penthemimeral, hepthemimeral
ὣς ἄρα τις εἴπεσκε, τὰ δ’οὐκ ἴσαν ὡς ἐτέτυκτο.	- uu - --u u - uu - uu--	dactylic hexameter	feminine penthemimeral, hepthemimeral, trithemimeral
τοῖσιν δ’Ἀντίνοος ἀγορήσατο καὶ μετέειπε·	-- -uu- uu-uu - uu--	dactylic hexameter	masculine penthemimeral
δαιμόνιοι, μύθους μὲν ὑπερφιάλους ἀλέασθε	-uu- -- u u-uu- uu--	dactylic hexameter	masculine penthemimeral, trithemimeral
πάντας ὁμῶς, μή πού τις ἀπαγγείλῃσι καὶ εἴσω.	-u u- - - u u---u u --	dactylic hexameter	masculine penthemimeral, trithemimeral
ἀλλ’ ἄγε σιγῇ τοῖον ἀναστάντες τελέωμεν	- uu -- -u u--- uu--	dactylic hexameter	feminine penthemimeral
μῦθον, ὃ δὴ καὶ πᾶσιν ἐνὶ φρεσὶν ἤραρεν ἡμῖν.	-u u - - -u u- uu -uu --	dactylic hexameter	feminine penthemimeral, hepthemimeral, trithemimeral
ὣς εἰπὼν ἐκρίνατ’ ἐείκοσι φῶτας ἀρίστους,	- -- --u u-uu -u u--	dactylic hexameter	feminine penthemimeral, trithemimeral
βὰν δ’ἰέναι ἐπὶ νῆα θοὴν καὶ θῖνα θαλάσσης.	- uu- uu -u u- - -u u--	dactylic hexameter	feminine penthemimeral, hepthemimeral, trithemimeral
νῆα μὲν οὖν πάμπρωτον ἁλὸς βένθοσδε ἔρυσσαν,	-u u - --u u- --u u--	dactylic hexameter	feminine penthemimeral, hepthemimeral, trithemimeral
ἐν δ’ἱστόν τ’ἐτίθεντο καὶ ἱστία νηὶ μελαίνῃ,	- -- uu-u u -uu -u u--	dactylic hexameter	feminine penthemimeral, trithemimeral
ἠρτύναντο δ’ἐρετμὰ τροποῖς ἐν δερματίνοισι,	---u u-u u- - -uu--	dactylic hexameter	feminine penthemimeral, hepthemimeral
πάντα κατὰ μοῖραν, ἀνά θ’ἱστία λευκὰ πέτασσαν·	-u u- -- uu -uu -u u--	dactylic hexameter	masculine penthemimeral, trithemimeral
τεύχεα δέ σφ’ἤνεικαν ὑπέρθυμοι θεράποντες.	-uu - --u u--- uu--	dactylic hexameter	feminine penthemimeral, trithemimeral
ὑψοῦ δ’ἐν νοτίῳ τήν γ’ὥρμισαν, ἐκ δ’ἔβαν αὐτοί·	-- - uu- - -uu - uu --	dactylic hexameter	masculine penthemimeral, trithemimeral
ἔνθα δὲ δόρπον ἕλοντο, μένον δ’ἐπὶ ἕσπερον ἐλθεῖν.	-u u -u u-u u- uu -uu --	dactylic hexameter	feminine penthemimeral, hepthemimeral
ἡ δ’ὑπερωίῳ αὖθι περίφρων Πηνελόπεια	- uu-uu -u u-- -uu--	dactylic hexameter	feminine penthemimeral
κεῖτ’ ἄρ’ ἄσιτος, ἄπαστος ἐδητύος ἠδὲ ποτῆτος,	- u u-u u-u u-uu -u u--	dactylic hexameter	feminine penthemimeral
ὁρμαίνουσ’ εἴ οἱ θάνατον φύγοι υἱὸς ἀμύμων,	--- - - uu- uu -u u--	dactylic hexameter	masculine penthemimeral, hepthemimeral, trithemimeral
ἦ ὅ γ’ὑπὸ μνηστῆρσιν ὑπερφιάλοισι δαμείη.	- u u- --u u-uu-u u--	dactylic hexameter	feminine penthemimeral, trithemimeral
ὅσσα δὲ μερμήριξε λέων ἀνδρῶν ἐν ὁμίλῳ	-u u ---u u- -- u u--	dactylic hexameter	feminine penthemimeral, hepthemimeral
δείσας, ὁππότε μιν δόλιον περὶ κύκλον ἄγωσι,	-- -uu - uu- uu -u u--	dactylic hexameter	masculine penthemimeral, hepthemimeral
τόσσα μιν ὁρμαίνουσαν ἐπήλυθε νήδυμος ὕπνος·	-u u ---u u-uu -uu --	dactylic hexameter	feminine penthemimeral
εὗδε δ’ἀνακλινθεῖσα, λύθεν δέ οἱ ἅψεα πάντα.	-u u---u u- u u -uu --	dactylic hexameter	feminine penthemimeral, hepthemimeral
ἔνθ’ αὖτ’ ἄλλ’ ἐνόησε θεά, γλαυκῶπις Ἀθήνη·	- - - uu-u u- --u u--	dactylic hexameter	feminine penthemimeral, hepthemimeral, trithemimeral
εἴδωλον ποίησε, δέμας δ’ἤικτο γυναικί,	--- --u u- --u u--	dactylic hexameter	feminine penthemimeral, hepthemimeral, trithemimeral
Ἰφθίμῃ, κούρῃ μεγαλήτορος Ἰκαρίοιο,	--- -- uu-uu -uu--	dactylic hexameter	masculine penthemimeral, trithemimeral
τὴν Εὔμηλος ὄπυιε Φερῇς ἔνι οἰκία ναίων.	- --u u-u u- uu -uu --	dactylic hexameter	feminine penthemimeral, hepthemimeral
πέμπε δέ μιν πρὸς δώματ’ Ὀδυσσῆος θείοιο,	-u u - - -u u--- ---	dactylic hexameter	feminine penthemimeral, trithemimeral
εἵως Πηνελόπειαν ὀδυρομένην γοόωσαν	-- -uu-u u-uu- uu--	dactylic hexameter	feminine penthemimeral
παύσειε κλαυθμοῖο γόοιό τε δακρυόεντος.	--- --u u-u u -uu--	dactylic hexameter	feminine penthemimeral, trithemimeral
ἐς θάλαμον δ’εἰσῆλθε παρὰ κληῖδος ἱμάντα,	- uu- --u u- --u u--	dactylic hexameter	feminine penthemimeral, hepthemimeral, trithemimeral
στῆ δ’ἄρ ὑπὲρ κεφαλῆς, καί μιν πρὸς μῦθον ἔειπεν·	- u u- uu- - - - -u u--	dactylic hexameter	masculine penthemimeral, hepthemimeral, trithemimeral
εὕδεις, Πηνελόπεια, φίλον τετιημένη ἦτορ;	-- -uu-u u- uu-uu --	dactylic hexameter	feminine penthemimeral, hepthemimeral
οὐ μέν σ’οὐδὲ ἐῶσι θεοὶ ῥεῖα ζώοντες	- - -u u-u u- -- ---	dactylic hexameter	feminine penthemimeral, hepthemimeral
κλαίειν οὐδ’ ἀκάχησθαι, ἐπεί ῥ’ἔτι νόστιμός ἐστι	-- - uu-u u- uu -uu --	dactylic hexameter	feminine penthemimeral, hepthemimeral, trithemimeral
σὸς παῖς· οὐ μὲν γάρ τι θεοῖς ἀλιτήμενός ἐστι.	- - - - - u u- uu-uu --	dactylic hexameter	masculine penthemimeral, hepthemimeral, trithemimeral
τὴν δ’ἠμείβετ’ ἔπειτα περίφρων Πηνελόπεια,	- --u u-u u-- -uu--	dactylic hexameter	feminine penthemimeral
ἡδὺ μάλα κνώσσουσ’ ἐν ὀνειρείῃσι πύλῃσιν·	-u u- -- u u---u u--	dactylic hexameter	masculine penthemimeral, trithemimeral
τίπτε, κασιγνήτη, δεῦρ’ ἤλυθες; οὔ τι πάρος γε	-u u--- - -uu - u u- -	dactylic hexameter	masculine penthemimeral
πωλέ’, ἐπεὶ μάλα πολλὸν ἀπόπροθι δώματα ναίεις·	-u u- uu -u u-uu -uu --	dactylic hexameter	feminine penthemimeral, trithemimeral
καί με κέλεαι παύσασθαι ὀιζύος ἠδ’ ὀδυνάων	- u u- --u u-uu - uu--	dactylic hexameter	feminine penthemimeral, trithemimeral
πολλέων, αἵ μ’ἐρέθουσι κατὰ φρένα καὶ κατὰ θυμόν,	-- - uu-u u- uu - uu --	dactylic hexameter	feminine penthemimeral, hepthemimeral, trithemimeral
ἣ πρὶν μὲν πόσιν ἐσθλὸν ἀπώλεσα θυμολέοντα,	- - - uu -u u-uu -uu--	dactylic hexameter	feminine penthemimeral, trithemimeral
παντοίῃς ἀρετῇσι κεκασμένον ἐν Δαναοῖσιν,	--- uu-u u-uu - uu--	dactylic hexameter	feminine penthemimeral, trithemimeral
ἐσθλόν, τοῦ κλέος εὐρὺ καθ’ Ἑλλάδα καὶ μέσον Ἄργος·	-- - uu -u u -uu - uu --	dactylic hexameter	feminine penthemimeral, trithemimeral
νῦν αὖ παῖς ἀγαπητὸς ἔβη κοίλης ἐπὶ νηός,	- - - uu-u u- -- uu --	dactylic hexameter	feminine penthemimeral, hepthemimeral, trithemimeral
νήπιος, οὔτε πόνων ἐὺ εἰδὼς οὔτ’ ἀγοράων.	-uu -u u- uu -- - uu--	dactylic hexameter	masculine penthemimeral
τοῦ δὴ ἐγὼ καὶ μᾶλλον ὀδύρομαι ἤ περ ἐκείνου·	- u u- - -u u-uu - u u--	dactylic hexameter	feminine penthemimeral, trithemimeral
τοῦ δ’ἀμφιτρομέω καὶ δείδια, μή τι πάθῃσιν,	- --uu- - -uu - u u--	dactylic hexameter	masculine penthemimeral
ἢ ὅ γε τῶν ἐνὶ δήμῳ, ἵν’ οἴχεται, ἢ ἐνὶ πόντῳ·	- u u - uu -u u -uu - uu --	dactylic hexameter	feminine penthemimeral, trithemimeral
δυσμενέες γὰρ πολλοὶ ἐπ’ αὐτῷ μηχανόωνται,	-uu- - -u u -- -uu--	dactylic hexameter	feminine penthemimeral, trithemimeral
ἱέμενοι κτεῖναι πρὶν πατρίδα γαῖαν ἱκέσθαι.	-uu- -- - -uu -u u--	dactylic hexameter	masculine penthemimeral, trithemimeral
τὴν δ’ἀπαμειβόμενον προσέφη εἴδωλον ἀμαυρόν·	- uu-uu- uu- --u u--	dactylic hexameter	masculine penthemimeral, hepthemimeral
θάρσει, μηδέ τι πάγχυ μετὰ φρεσὶ δείδιθι λίην·	-- -u u -u u- uu -uu --	dactylic hexameter	feminine penthemimeral, hepthemimeral
τοίη γάρ οἱ πομπὸς ἅμ’ ἔρχεται, ἥν τε καὶ ἄλλοι	-- - - -u u -uu - u u --	dactylic hexameter	feminine penthemimeral, trithemimeral
ἀνέρες ἠρήσαντο παρεστάμεναι, δύναται γάρ,	-uu ---u u-uu- uu- -	dactylic hexameter	feminine penthemimeral
Παλλὰς Ἀθηναίη· σὲ δ’ὀδυρομένην ἐλεαίρει·	-u u--- u u-uu- uu--	dactylic hexameter	masculine penthemimeral
ἣ νῦν με προέηκε τεῒν τάδε μυθήσασθαι.	- - - uu-u u- uu ----	dactylic hexameter	feminine penthemimeral, hepthemimeral, trithemimeral
τὴν δ’αὖτε προσέειπε περίφρων Πηνελόπεια·	- -- uu-u u-- -uu--	dactylic hexameter	feminine penthemimeral, trithemimeral
εἰ μὲν δὴ θεός ἐσσι θεοῖό τε ἔκλυες αὐδήν,	- - - uu -u u-u u -uu --	dactylic hexameter	feminine penthemimeral, trithemimeral
εἰ δ’ἄγε μοι καὶ κεῖνον ὀιζυρὸν κατάλεξον,	- uu - - -u u--- uu--	dactylic hexameter	feminine penthemimeral, trithemimeral
εἴ που ἔτι ζώει καὶ ὁρᾷ φάος ἠελίοιο,	- u u- -- u u- uu -uu--	dactylic hexameter	masculine penthemimeral, hepthemimeral, trithemimeral
ἦ ἤδη τέθνηκε καὶ εἰν Ἀίδαο δόμοισι.	- -- --u u - uu-u u--	dactylic hexameter	feminine penthemimeral, hepthemimeral, trithemimeral
τὴν δ’ἀπαμειβόμενον προσέφη εἴδωλον ἀμαυρόν·	- uu-uu- uu- --u u--	dactylic hexameter	masculine penthemimeral, hepthemimeral
οὐ μέν τοι κεῖνόν γε διηνεκέως ἀγορεύσω,	- - - -- u u-uu- uu--	dactylic hexameter	masculine penthemimeral, trithemimeral
ζώει ὅ γ’ἦ τέθνηκε· κακὸν δ’ἀνεμώλια βάζειν.	-u u - --u u- uu-uu --	dactylic hexameter	feminine penthemimeral, hepthemimeral, trithemimeral
ὣς εἰπὸν σταθμοῖο παρὰ κληῖδα λιάσθη	- -- --u u- --u u--	dactylic hexameter	feminine penthemimeral, hepthemimeral, trithemimeral
ἐς πνοιὰς ἀνέμων. ἡ δ’ἐξ ὕπνου ἀνόρουσε	- -- uu- - - -- uu--	dactylic hexameter	masculine penthemimeral, hepthemimeral, trithemimeral
κούρη Ἰκαρίοιο· φίλον δέ οἱ ἦτορ ἰάνθη,	-- -uu-u u- u u -u u--	dactylic hexameter	feminine penthemimeral, hepthemimeral
ὥς οἱ ἐναργὲς ὄνειρον ἐπέσσυτο νυκτὸς ἀμολγῷ.	- u u-u u-u u-uu -u u--	dactylic hexameter	feminine penthemimeral
μνηστῆρες δ’ἀναβάντες ἐπέπλεον ὑγρὰ κέλευθα	--- uu-u u-uu -u u--	dactylic hexameter	feminine penthemimeral, trithemimeral
Τηλεμάχῳ φόνον αἰπὺν ἐνὶ φρεσὶν ὁρμαίνοντες.	-uu- uu -u u- uu ----	dactylic hexameter	feminine penthemimeral, hepthemimeral, trithemimeral
ἔστι δέ τις νῆσος μέσσῃ ἁλὶ πετρήεσσα,	-u u - -- -- uu ----	dactylic hexameter	masculine penthemimeral, hepthemimeral, trithemimeral
μεσσηγὺς Ἰθάκης τε Σάμοιό τε παιπαλοέσσης,	--- uu- u u-u u -uu--	dactylic hexameter	masculine penthemimeral, trithemimeral
Ἀστερίς, οὐ μεγάλη· λιμένες δ’ἔνι ναύλοχοι αὐτῇ	-uu - uu- uu- uu -uu --	dactylic hexameter	masculine penthemimeral, hepthemimeral, trithemimeral
ἀμφίδυμοι· τῇ τόν γε μένον λοχόωντες Ἀχαιοί.	-uu- - - u u- uu-u u--	dactylic hexameter	masculine penthemimeral, hepthemimeral, trithemimeral
