αὐτὰρ ὁ ἐν μεγάρῳ ὑπελείπετο δῖος Ὀδυσσεύς,	-u u - uu- uu-uu -u u--	dactylic hexameter	masculine penthemimeral, trithemimeral
μνηστήρεσσι φόνον σὺν Ἀθήνῃ μερμηρίζων·	---u u- u u-- ----	dactylic hexameter	masculine penthemimeral
αἶψα δὲ Τηλέμαχον ἔπεα πτερόεντα προσηύδα·	-u u -uu- uu- uu-u u--	dactylic hexameter	masculine penthemimeral, hepthemimeral
Τηλέμαχε, χρὴ τεύχε’ ἀρήϊα κατθέμεν εἴσω	-uu- - -u u-uu -uu --	dactylic hexameter	feminine penthemimeral, trithemimeral
πάντα μάλ’· αὐτὰρ μνηστῆρας μαλακοῖς ἐπέεσσι	-u u -- --- uu- uu--	dactylic hexameter	hepthemimeral
παρφάσθαι, ὅτε κέν σε μεταλλῶσιν ποθέοντες·	--- uu - u u--- uu--	dactylic hexameter	masculine penthemimeral, trithemimeral
ἐκ καπνοῦ κατέθηκ’, ἐπεὶ οὐκέτι τοῖσιν ἐῴκει	- -- uu- uu -uu -u u--	dactylic hexameter	masculine penthemimeral, trithemimeral
οἷά ποτε Τροίηνδε κιὼν κατέλειπεν Ὀδυσσεύς,	-u u- --u u- uu-u u--	dactylic hexameter	feminine penthemimeral, hepthemimeral, trithemimeral
ἀλλὰ κατῄκισται, ὅσσον πυρὸς ἵκετ’ ἀϋτμή.	-u u--- -- uu -u u--	dactylic hexameter	masculine penthemimeral, hepthemimeral
πρὸς δ’ἔτι καὶ τόδε μεῖζον ἐνὶ φρεσὶν ἔμβαλε δαίμων	- uu - uu -u u- uu -uu --	dactylic hexameter	feminine penthemimeral, hepthemimeral, trithemimeral
μή πως οἰνωθέντες, ἔριν στήσαντες ἐν ὑμῖν,	- - ---u u- --u u --	dactylic hexameter	feminine penthemimeral, hepthemimeral
ἀλλήλους τρώσητε καταισχύνητέ τε δαῖτα	--- --u u---u u --	dactylic hexameter	feminine penthemimeral, trithemimeral
καὶ μνηστύν· αὐτὸς γὰρ ἐφέλκεται ἄνδρα σίδηρος.	- -- -- u u-uu -u u--	dactylic hexameter	masculine penthemimeral, trithemimeral
ὣς φάτο, Τηλέμαχος δὲ φίλῳ ἐπεπείθετο πατρί,	- uu -uu- u u- uu-uu --	dactylic hexameter	masculine penthemimeral, hepthemimeral
ἐκ δὲ καλεσσάμενος προσέφη τροφὸν Εὐρύκλειαν·	- u u-uu- uu- uu ----	dactylic hexameter	masculine penthemimeral, hepthemimeral
μαῖ’, ἄγε δή μοι ἔρυξον ἐνὶ μεγάροισι γυναῖκας,	- uu - u u-u u- uu-u u--	dactylic hexameter	feminine penthemimeral, hepthemimeral, trithemimeral
ὄφρα κεν ἐς θάλαμον καταθείομαι ἔντεα πατρὸς	-u u - uu- uu-uu -uu --	dactylic hexameter	masculine penthemimeral, trithemimeral
καλά, τά μοι κατὰ οἶκον ἀκηδέα καπνὸς ἀμέρδει	-u u - uu -u u-uu -u u--	dactylic hexameter	feminine penthemimeral, trithemimeral
πατρὸς ἀποιχομένοιο· ἐγὼ δ’ἔτι νήπιος ἦα.	-u u-uu-u u- uu -uu --	dactylic hexameter	feminine penthemimeral, hepthemimeral
νῦν δ’ἐθέλω καταθέσθαι, ἵν’ οὐ πυρὸς ἵξετ’ ἀϋτμή.	- uu- uu-u u - uu -u u--	dactylic hexameter	feminine penthemimeral, hepthemimeral, trithemimeral
τὸν δ’αὖτε προσέειπε φίλη τροφὸς Εὐρύκλεια·	- -- uu-u u- uu ----	dactylic hexameter	feminine penthemimeral, hepthemimeral, trithemimeral
αἲ γὰρ δή ποτε, τέκνον, ἐπιφροσύνας ἀνέλοιο	- - - uu -u u-uu- uu--	dactylic hexameter	feminine penthemimeral, trithemimeral
οἴκου κήδεσθαι καὶ κτήματα πάντα φυλάσσειν.	-- --- - -uu -u u--	dactylic hexameter	masculine penthemimeral
ἀλλ’ ἄγε, τίς τοι ἔπειτα μετοιχομένη φάος οἴσει;	- uu - u u-u u-uu- uu --	dactylic hexameter	feminine penthemimeral, trithemimeral
δμῳὰς δ’οὐκ εἴας προβλωσκέμεν, αἵ κεν ἔφαινον.	-- - -- --uu - u u--	dactylic hexameter	masculine penthemimeral, trithemimeral
τὴν δ’αὖ Τηλέμαχος πεπνυμένος ἀντίον ηὔδα·	- - -uu- --uu -uu --	dactylic hexameter	masculine penthemimeral
ξεῖνος ὅδ’· οὐ γὰρ ἀεργὸν ἀνέξομαι ὅς κεν ἐμῆς γε	-u u - u u-u u-uu - u u- -	dactylic hexameter	feminine penthemimeral, trithemimeral
χοίνικος ἅπτηται, καὶ τηλόθεν εἰληλουθώς.	-uu --- - -uu ----	dactylic hexameter	masculine penthemimeral
ὣς ἄρ’ ἐφώνησεν, τῇ δ’ἄπτερος ἔπλετο μῦθος.	- u u--- - -uu -uu --	dactylic hexameter	masculine penthemimeral
κλήϊσεν δὲ θύρας μεγάρων εὖ ναιεταόντων.	--- u u- uu- - -uu--	dactylic hexameter	masculine penthemimeral, hepthemimeral, trithemimeral
τὼ δ’ἄρ’ ἀναΐξαντ’ Ὀδυσεὺς καὶ φαίδιμος υἱὸς	- u u--- uu- - -uu --	dactylic hexameter	masculine penthemimeral, hepthemimeral
ἐσφόρεον κόρυθάς τε καὶ ἀσπίδας ὀμφαλοέσσας	-uu- uu- u u -uu -uu--	dactylic hexameter	masculine penthemimeral, trithemimeral
ἔγχεά τ’ὀξυόεντα· πάροιθε δὲ Παλλὰς Ἀθήνη,	-uu -uu-u u-u u -u u--	dactylic hexameter	feminine penthemimeral
χρύσεον λύχνον ἔχουσα, φάος περικαλλὲς ἐποίει.	-- -u u-u u- uu-u u--	dactylic hexameter	feminine penthemimeral, hepthemimeral
δὴ τότε Τηλέμαχος προσεφώνεεν ὃν πατέρ’ αἶψα·	- uu -uu- uu-uu - uu --	dactylic hexameter	masculine penthemimeral
ὧ πάτερ, ἦ μέγα θαῦμα τόδ’ ὀφθαλμοῖσιν ὁρῶμαι.	- uu - uu -u u ---u u--	dactylic hexameter	feminine penthemimeral, trithemimeral
ἔμπης μοι τοῖχοι μεγάρων καλαί τε μεσόδμαι,	-- - -- uu- -- u u--	dactylic hexameter	masculine penthemimeral, hepthemimeral, trithemimeral
εἰλάτιναί τε δοκοί, καὶ κίονες ὑψόσ’ ἔχοντες	-uu- u u- - -uu -u u--	dactylic hexameter	masculine penthemimeral, trithemimeral
φαίνοντ’ ὀφθαλμοῖς ὡς εἰ πυρὸς αἰθομένοιο.	-- --- - - uu -uu--	dactylic hexameter	masculine penthemimeral, hepthemimeral
ἦ μάλα τις θεὸς ἔνδον, οἳ οὐρανὸν εὐρὺν ἔχουσι.	- uu - uu -u u -uu -u u--	dactylic hexameter	feminine penthemimeral, trithemimeral
τὸν δ’ἀπαμειβόμενος προσέφη πολύμητις Ὀδυσσεύς·	- uu-uu- uu- uu-u u--	dactylic hexameter	masculine penthemimeral, hepthemimeral
σίγα καὶ κατὰ σὸν νόον ἴσχανε μηδ’ ἐρέεινε·	-- - uu - uu -uu - uu--	dactylic hexameter	masculine penthemimeral, trithemimeral
αὕτη τοι δίκη ἐστὶ θεῶν, οἳ Ὄλυμπον ἔχουσιν.	-- - uu -u u- u u-u u--	dactylic hexameter	feminine penthemimeral, hepthemimeral, trithemimeral
ἀλλὰ σὺ μὲν κατάλεξαι, ἐγὼ δ’ὑπολείψομαι αὐτοῦ,	-u u - uu-u u- uu-uu --	dactylic hexameter	feminine penthemimeral, hepthemimeral, trithemimeral
ὄφρα κ’ἔτι δμῳὰς καὶ μητέρα σὴν ἐρεθίζω·	-u u- -- - -uu - uu--	dactylic hexameter	masculine penthemimeral, trithemimeral
ἡ δέ μ’ὀδυρομένη εἰρήσεται ἀμφὶς ἕκαστα.	- u u-uu- --uu -u u--	dactylic hexameter	masculine penthemimeral
ὣς φάτο, Τηλέμαχος δὲ διὲκ μεγάροιο βεβήκει	- uu -uu- u u- uu-u u--	dactylic hexameter	masculine penthemimeral, hepthemimeral
κείων ἐς θάλαμον, δαΐδων ὕπο λαμπομενάων,	-- - uu- uu- uu -uu--	dactylic hexameter	masculine penthemimeral, hepthemimeral, trithemimeral
ἔνθα πάρος κοιμᾶθ’, ὅτε μιν γλυκὺς ὕπνος ἱκάνοι·	-u u- -- uu - uu -u u--	dactylic hexameter	masculine penthemimeral, hepthemimeral, trithemimeral
ἔνθ’ ἄρα καὶ τότ’ ἔλεκτο καὶ Ἠῶ δῖαν ἔμιμνεν.	- uu - u u-u u -- -u u--	dactylic hexameter	feminine penthemimeral, trithemimeral
αὐτὰρ ὁ ἐν μεγάρῳ ὑπελείπετο δῖος Ὀδυσσεύς,	-u u - uu- uu-uu -u u--	dactylic hexameter	masculine penthemimeral, trithemimeral
μνηστήρεσσι φόνον σὺν Ἀθήνῃ μερμηρίζων.	---u u- u u-- ----	dactylic hexameter	masculine penthemimeral
ἡ δ’ἴεν ἐκ θαλάμοιο περίφρων Πηνελόπεια,	- uu - uu-u u-- -uu--	dactylic hexameter	feminine penthemimeral, trithemimeral
Ἀρτέμιδι ἰκέλη ἠὲ χρυσῇ Ἀφροδίτῃ.	-uu- uu- -- -- uu--	dactylic hexameter	masculine penthemimeral, hepthemimeral, trithemimeral
τῇ παρὰ μὲν κλισίην πυρὶ κάτθεσαν, ἔνθ’ ἄρ’ ἐφῖζε,	- uu - uu- uu -uu - u u--	dactylic hexameter	masculine penthemimeral, trithemimeral
δινωτὴν ἐλέφαντι καὶ ἀργύρῳ· ἥν ποτε τέκτων	--- uu-u u -uu - uu --	dactylic hexameter	feminine penthemimeral, trithemimeral
ποίησ’ Ἰκμάλιος, καὶ ὑπὸ θρῆνυν ποσὶν ἧκε	-- -uu- u u- -- uu --	dactylic hexameter	masculine penthemimeral, hepthemimeral
προσφυέ’ ἐξ αὐτῆς, ὅθ’ ἐπὶ μέγα βάλλετο κῶας.	-uu - -- u u- uu -uu --	dactylic hexameter	masculine penthemimeral, hepthemimeral, trithemimeral
ἔνθα καθέζετ’ ἔπειτα περίφρων Πηνελόπεια.	-u u-u u-u u-- -uu--	dactylic hexameter	feminine penthemimeral
ἦλθον δὲ δμῳαὶ λευκώλενοι ἐκ μεγάροιο.	-- - -- --uu - uu--	dactylic hexameter	masculine penthemimeral, trithemimeral
αἱ δ’ἀπὸ μὲν σῖτον πολὺν ᾕρεον ἠδὲ τραπέζας	- uu - -- uu -uu -u u--	dactylic hexameter	masculine penthemimeral, trithemimeral
καὶ δέπα, ἔνθεν ἄρ’ ἄνδρες ὑπερμενέοντες ἔπινον·	- uu -u u -u u-uu-u u--	dactylic hexameter	feminine penthemimeral
πῦρ δ’ἀπὸ λαμπτήρων χαμάδις βάλον, ἄλλα δ’ἐπ’ αὐτῶν	- uu --- uu- uu -u u --	dactylic hexameter	masculine penthemimeral, hepthemimeral
νήησαν ξύλα πολλά, φόως ἔμεν ἠδὲ θέρεσθαι.	--- uu -u u- uu -u u--	dactylic hexameter	feminine penthemimeral, hepthemimeral, trithemimeral
ἡ δ’Ὀδυσῆ’ ἐνένιπε Μελανθὼ δεύτερον αὖτις·	- uu- uu-u u-- -uu --	dactylic hexameter	feminine penthemimeral, trithemimeral
ξεῖν’, ἔτι καὶ νῦν ἐνθάδ’ ἀνιήσεις διὰ νύκτα	- uu - - -u u--- uu --	dactylic hexameter	feminine penthemimeral, trithemimeral
δινεύων κατὰ οἶκον, ὀπιπεύσεις δὲ γυναῖκας;	--- uu -u u--- u u--	dactylic hexameter	feminine penthemimeral, trithemimeral
ἀλλ’ ἔξελθε θύραζε, τάλαν, καὶ δαιτὸς ὄνησο·	- --u u-u u- - -u u--	dactylic hexameter	feminine penthemimeral, hepthemimeral
ἢ τάχα καὶ δαλῷ βεβλημένος εἶσθα θύραζε.	- uu - -- --uu -u u--	dactylic hexameter	masculine penthemimeral, trithemimeral
τὴν δ’ἄρ’ ὑπόδρα ἰδὼν προσέφη πολύμητις Ὀδυσσεύς·	- u u-u u- uu- uu-u u--	dactylic hexameter	masculine penthemimeral, hepthemimeral
δαιμονίη, τί μοι ὦδ’ ἐπέχεις κεκοτηότι θυμῷ;	-uu- u u - uu- uu-uu --	dactylic hexameter	masculine penthemimeral, hepthemimeral, trithemimeral
ἦ ὅτι δὴ ῥυπόω, κακὰ δὲ χροῒ εἵματα εἷμαι,	- uu - uu- uu - uu -uu --	dactylic hexameter	masculine penthemimeral, hepthemimeral, trithemimeral
πτωχεύω δ’ἀνὰ δῆμον; ἀναγκαίη γὰρ ἐπείγει.	--- uu -u u--- u u--	dactylic hexameter	feminine penthemimeral, trithemimeral
τοιοῦτοι πτωχοὶ καὶ ἀλήμονες ἄνδρες ἔασι	--- -- u u-uu -u u--	dactylic hexameter	masculine penthemimeral, trithemimeral
καὶ γὰρ ἐγώ ποτε οἶκον ἐν ἀνθρώποισιν ἔναιον	- u u- uu -u u ---u u--	dactylic hexameter	feminine penthemimeral, trithemimeral
ὄλβιος ἀφνειὸν καὶ πολλάκι δόσκον ἀλήτῃ,	-uu --- - -uu -u u--	dactylic hexameter	masculine penthemimeral
τοίῳ ὁποῖος ἔοι καὶ ὅτευ κεχρημένος ἔλθοι·	-u u-u u- u u- --uu --	dactylic hexameter	masculine penthemimeral, hepthemimeral
ἦσαν δὲ δμῶες μάλα μυρίοι, ἄλλα τε πολλὰ	-- - -- uu -uu -u u --	dactylic hexameter	masculine penthemimeral, trithemimeral
οἷσίν τ’εὖ ζώουσι καὶ ἀφνειοὶ καλέονται.	-- - --u u --- uu--	dactylic hexameter	feminine penthemimeral, trithemimeral
ἀλλὰ Ζεὺς ἀλάπαξε Κρονίων· ἤθελε γάρ που·	-- - uu-u u-- -uu - -	dactylic hexameter	feminine penthemimeral, trithemimeral
τῶ νῦν μή ποτε καὶ σύ, γύναι, ἀπὸ πᾶσαν ὀλέσσῃς	- - - uu - u u- uu -u u--	dactylic hexameter	masculine penthemimeral, hepthemimeral, trithemimeral
ἀγλαΐην, τῇ νῦν γε μετὰ δμῳῇσι κέκασσαι·	-uu- - - u u- --u u--	dactylic hexameter	masculine penthemimeral, hepthemimeral, trithemimeral
μή πώς τοι δέσποινα κοτεσσαμένη χαλεπήνῃ,	- - - --u u-uu- uu--	dactylic hexameter	feminine penthemimeral, trithemimeral
ἢ Ὀδυσεὺς ἔλθῃ· ἔτι γὰρ καὶ ἐλπίδος αἶσα.	- uu- -- uu - - -uu --	dactylic hexameter	masculine penthemimeral, hepthemimeral, trithemimeral
εἰ δ’ὁ μὲν ὣς ἀπόλωλε καὶ οὐκέτι νόστιμός ἐστιν,	- u u - uu-u u -uu -uu --	dactylic hexameter	feminine penthemimeral, trithemimeral
ἀλλ’ ἤδη παῖς τοῖος Ἀπόλλωνός γε ἕκητι,	- -- - -u u--- u u--	dactylic hexameter	feminine penthemimeral, trithemimeral
Τηλέμαχος· τὸν δ’οὔ τις ἐνὶ μεγάροισι γυναικῶν	-uu- - - u u- uu-u u--	dactylic hexameter	masculine penthemimeral, hepthemimeral, trithemimeral
λήθει ἀτασθάλλουσ’, ἐπεὶ οὐκέτι τηλίκος ἐστίν.	-u u--- uu -uu -uu --	dactylic hexameter	masculine penthemimeral
ὣς φάτο, τοῦ δ’ἤκουσε περίφρων Πηνελόπεια,	- uu - --u u-- -uu--	dactylic hexameter	feminine penthemimeral, trithemimeral
ἀμφίπολον δ’ἐνένιπεν ἔπος τ’ἔφατ’ ἔκ τ’ὀνόμαζε·	-uu- uu-u u- uu - uu--	dactylic hexameter	feminine penthemimeral, hepthemimeral, trithemimeral
πάντως, θαρσαλέη, κύον ἀδδεές, οὔ τί με λήθεις	-- -uu- uu -uu - u u --	dactylic hexameter	masculine penthemimeral
ἔρδουσα μέγα ἔργον, ὃ σῇ κεφαλῇ ἀναμάξεις·	--- uu -u u - uu- uu--	dactylic hexameter	feminine penthemimeral, hepthemimeral, trithemimeral
πάντα γὰρ εὖ ᾔδησθ’, ἐπεὶ ἐξ ἐμεῦ ἔκλυες αὐτῆς	-u u - -- uu - uu -uu --	dactylic hexameter	masculine penthemimeral, hepthemimeral, trithemimeral
ὡς τὸν ξεῖνον ἔμελλον ἐνὶ μεγάροισιν ἐμοῖσιν	- - -u u-u u- uu-u u--	dactylic hexameter	feminine penthemimeral, hepthemimeral
ἀμφὶ πόσει εἴρεσθαι, ἐπεὶ πυκινῶς ἀκάχημαι.	-u u- --u u- uu- uu--	dactylic hexameter	feminine penthemimeral, hepthemimeral, trithemimeral
ἦ ῥα καὶ Εὐρυνόμην ταμίην πρὸς μῦθον ἔειπεν·	- u u -uu- uu- - -u u--	dactylic hexameter	masculine penthemimeral, hepthemimeral
Εὐρυνόμη, φέρε δὴ δίφρον καὶ κῶας ἐπ’ αὐτοῦ,	-uu- uu - -- - -u u --	dactylic hexameter	masculine penthemimeral, hepthemimeral, trithemimeral
ὄφρα καθεζόμενος εἴπῃ ἔπος ἠδ’ ἐπακούσῃ	-u u-uu- -- uu - uu--	dactylic hexameter	masculine penthemimeral, hepthemimeral
ὁ ξεῖνος ἐμέθεν· ἐθέλω δέ μιν ἐξερέεσθαι.	- -- uu- uu- u u -uu--	dactylic hexameter	masculine penthemimeral, hepthemimeral, trithemimeral
ὣς ἔφαθ’, ἡ δὲ μάλ’ ὀτραλέως κατέθηκε φέρουσα	- uu - u u -uu- uu-u u--	dactylic hexameter	hepthemimeral, trithemimeral
δίφρον ἐΰξεστον καὶ ἐπ’ αὐτῷ κῶας ἔβαλλεν·	-u u--- u u -- -u u--	dactylic hexameter	masculine penthemimeral
ἔνθα καθέζετ’ ἔπειτα πολύτλας δῖος Ὀδυσσεύς.	-u u-u u-u u-- -u u--	dactylic hexameter	feminine penthemimeral
τοῖσι δὲ μύθων ἦρχε περίφρων Πηνελόπεια·	-u u -- -u u-- -uu--	dactylic hexameter	feminine penthemimeral
ξεῖνε, τὸ μέν σε πρῶτον ἐγὼν εἰρήσομαι αὐτή·	-u u - - -u u- --uu --	dactylic hexameter	feminine penthemimeral, hepthemimeral, trithemimeral
τίς πόθεν εἶς ἀνδρῶν; πόθι τοι πόλις ἠδὲ τοκῆες;	- uu - -- uu - uu -u u--	dactylic hexameter	masculine penthemimeral, hepthemimeral, trithemimeral
τὴν δ’ἀπαμειβόμενος προσέφη πολύμητις Ὀδυσσεύς·	- uu-uu- uu- uu-u u--	dactylic hexameter	masculine penthemimeral, hepthemimeral
ὧ γύναι, οὐκ ἄν τίς σε βροτῶν ἐπ’ ἀπείρονα γαῖαν	- uu - - - u u- u u-uu --	dactylic hexameter	masculine penthemimeral, hepthemimeral, trithemimeral
νεικέοι· ἦ γάρ σευ κλέος οὐρανὸν εὐρὺν ἱκάνει,	-uu - - - uu -uu -u u--	dactylic hexameter	masculine penthemimeral, trithemimeral
ὥς τέ τευ ἢ βασιλῆος ἀμύμονος, ὅς τε θεουδὴς	- u u - uu-u u-uu - u u--	dactylic hexameter	feminine penthemimeral, trithemimeral
ἀνδράσιν ἐν πολλοῖσι καὶ ἰφθίμοισιν ἀνάσσων	-uu - --u u ---u u--	dactylic hexameter	feminine penthemimeral, trithemimeral
εὐδικίας ἀνέχῃσι, φέρῃσι δὲ γαῖα μέλαινα	-uu- uu-u u-u u -u u--	dactylic hexameter	feminine penthemimeral, trithemimeral
πυροὺς καὶ κριθάς, βρίθῃσι δὲ δένδρεα καρπῷ,	-- - -- --u u -uu --	dactylic hexameter	masculine penthemimeral, trithemimeral
τίκτῃ δ’ἔμπεδα μῆλα, θάλασσα δὲ παρέχῃ ἰχθῦς	-- -uu -u u-u u -uu --	dactylic hexameter	feminine penthemimeral
ἐξ εὐηγεσίης, ἀρετῶσι δὲ λαοὶ ὑπ’ αὐτοῦ.	- --uu- uu-u u -u u --	dactylic hexameter	masculine penthemimeral
τῶ ἐμὲ νῦν τὰ μὲν ἄλλα μετάλλα σῷ ἐνὶ οἴκῳ,	- uu - u u -u u-- - uu --	dactylic hexameter	feminine penthemimeral, trithemimeral
μηδ’ ἐμὸν ἐξερέεινε γένος καὶ πατρίδα γαῖαν,	- uu -uu-u u- - -uu --	dactylic hexameter	feminine penthemimeral, hepthemimeral
μή μοι μᾶλλον θυμὸν ἐνιπλήσῃς ὀδυνάων	- - -- -u u--- uu--	dactylic hexameter	feminine penthemimeral
μνησαμένῳ μάλα δ’εἰμὶ πολύστονος· οὐδέ τί με χρὴ	-uu- uu -u u-uu -u u - -	dactylic hexameter	feminine penthemimeral, trithemimeral
οἴκῳ ἐν ἀλλοτρίῳ γοόωντά τε μυρόμενόν τε	-u u -uu- uu-u u -uu- -	dactylic hexameter	masculine penthemimeral
ἧσθαι, ἐπεὶ κάκιον πενθήμεναι ἄκριτον αἰεί·	-u u- uu- --uu -uu --	dactylic hexameter	masculine penthemimeral, trithemimeral
μή τίς μοι δμῳῶν νεμεσήσεται, ἠὲ σύ γ’αὐτή,	- - - -- uu-uu -u u --	dactylic hexameter	masculine penthemimeral, trithemimeral
φῇ δὲ δάκρυ πλώειν βεβαρηότα με φρένας οἴνῳ.	- u u- -- uu-uu - uu --	dactylic hexameter	masculine penthemimeral, trithemimeral
τὸν δ’ἠμείβετ’ ἔπειτα περίφρων Πηνελόπεια·	- --u u-u u-- -uu--	dactylic hexameter	feminine penthemimeral
ξεῖν’, ἤτοι μὲν ἐμὴν ἀρετὴν εἶδός τε δέμας τε	- -- u u- uu- -- u u- -	dactylic hexameter	masculine penthemimeral, hepthemimeral, trithemimeral
ὤλεσαν ἀθάνατοι, ὅτε Ἴλιον εἰσανέβαινον	-uu -uu- uu -uu -uu--	dactylic hexameter	masculine penthemimeral
Ἀργεῖοι, μετὰ τοῖσι δ’ ἐμὸς πόσις ᾖεν Ὀδυσσεύς	--- uu -u u- uu -u u--	dactylic hexameter	feminine penthemimeral, hepthemimeral, trithemimeral
εἰ κεῖνός γ’ἐλθὼν τὸν ἐμὸν βίον ἀμφιπολεύοι,	- -- -- u u- uu -uu--	dactylic hexameter	masculine penthemimeral, hepthemimeral, trithemimeral
μεῖζον κε κλέος εἴη ἐμὸν καὶ κάλλιον οὕτω.	-- - uu -u u- - -uu --	dactylic hexameter	feminine penthemimeral, hepthemimeral, trithemimeral
νῦν δ’ἄχομαι· τόσα γάρ μοι ἐπέσσευεν κακὰ δαίμων.	- uu- uu - u u--- uu --	dactylic hexameter	masculine penthemimeral, trithemimeral
ὅσσοι γὰρ νήσοισιν ἐπικρατέουσιν ἄριστοι,	-- - --u u-uu-u u--	dactylic hexameter	feminine penthemimeral, trithemimeral
Δουλιχίῳ τε Σάμῃ τε καὶ ὑλήεντι Ζακύνθῳ,	-uu- u u- u u ---u u--	dactylic hexameter	masculine penthemimeral, trithemimeral
οἵ τ’αὐτὴν Ἰθάκην εὐδείελον ἀμφινέμονται,	- -- uu- --uu -uu--	dactylic hexameter	masculine penthemimeral, trithemimeral
οἵ μ’ἀεκαζομένην μνῶνται, τρύχουσι δὲ οἶκον.	- uu-uu- -- --u u --	dactylic hexameter	masculine penthemimeral, hepthemimeral
τῶ οὔτε ξείνων ἐμπάζομαι οὔθ’ ἱκετάων	- -- -- --uu - uu--	dactylic hexameter	masculine penthemimeral, trithemimeral
οὔτε τι κηρύκων, οἳ δημιοεργοὶ ἔασιν·	-u u --- - -uu-u u--	dactylic hexameter	masculine penthemimeral
ἀλλ’ Ὀδυσῆα ποθέουσα φίλον κατατήκομαι ἦτορ.	- uu-u u-u u- uu-uu --	dactylic hexameter	feminine penthemimeral, hepthemimeral
οἱ δὲ γάμον σπεύδουσιν· ἐγὼ δὲ δόλους τολυπεύω.	- u u- --u u- u u- uu--	dactylic hexameter	feminine penthemimeral, hepthemimeral, trithemimeral
φᾶρος μέν μοι πρῶτον ἐνέπνευσε φρεσὶ δαίμων,	-- - - -u u--- uu --	dactylic hexameter	feminine penthemimeral, trithemimeral
στησαμένη μέγαν ἱστόν, ἐνὶ μεγάροισιν ὕφαινον,	-uu- uu -u u- uu-u u--	dactylic hexameter	feminine penthemimeral, hepthemimeral, trithemimeral
λεπτὸν καὶ περίμετρον· ἄφαρ δ’αὐτοῖς μετέειπον·	-- - uu-u u- -- uu--	dactylic hexameter	feminine penthemimeral, hepthemimeral, trithemimeral
κοῦροι, ἐμοὶ μνηστῆρες, ἐπεὶ θάνε δῖος Ὀδυσσεύς,	-u u- --u u- uu -u u--	dactylic hexameter	feminine penthemimeral, hepthemimeral, trithemimeral
μίμνετ’ ἐπειγόμενοι τὸν ἐμὸν γάμον, εἰς ὅ κε φᾶρος	-u u-uu- u u- uu - u u --	dactylic hexameter	masculine penthemimeral, hepthemimeral
ἐκτελέσω μή μοι μεταμώνια νήματ’ ὄληται	-uu- - - uu-uu -u u--	dactylic hexameter	masculine penthemimeral, trithemimeral
Λαέρτῃ ἥρωϊ ταφήϊον, εἰς ὅτε κέν μιν	--- --u u-uu - uu - -	dactylic hexameter	feminine penthemimeral, trithemimeral
μοῖρ’ ὀλοὴ καθέλῃσι τανηλεγέος θανάτοιο·	- uu- uu-u u-uu- uu--	dactylic hexameter	feminine penthemimeral, trithemimeral
μή τίς μοι κατὰ δῆμον Ἀχαιϊάδων νεμεσήσῃ,	- - - uu -u u-uu- uu--	dactylic hexameter	feminine penthemimeral, trithemimeral
αἴ κεν ἄτερ σπείρου κεῖται πολλὰ κτεατίσσας.	- u u- -- -- -- uu--	dactylic hexameter	masculine penthemimeral, hepthemimeral, trithemimeral
ὣς ἐφάμην, τοῖσιν δ’ἐπεπείθετο θυμὸς ἀγήνωρ.	- uu- -- uu-uu -u u--	dactylic hexameter	masculine penthemimeral, trithemimeral
ἔνθα καὶ ἠματίη μὲν ὑφαίνεσκον μέγαν ἱστόν,	-u u -uu- u u--- uu --	dactylic hexameter	masculine penthemimeral
νύκτας δ’ἀλλύεσκον, ἐπὴν δαΐδας παραθείμην.	-- ---u u- uu- uu--	dactylic hexameter	feminine penthemimeral, hepthemimeral
ὣς τρίετες μὲν ἔληθον ἐγὼ καὶ ἔπειθον Ἀχαιούς·	- uu- u u-u u- u u-u u--	dactylic hexameter	feminine penthemimeral, hepthemimeral, trithemimeral
ἀλλ’ ὅτε τέτρατον ἦλθεν ἔτος καὶ ἐπήλυθον ὦραι,	- uu -uu -u u- u u-uu --	dactylic hexameter	feminine penthemimeral, hepthemimeral
μηνῶν φθινόντων, περὶ δ’ἤματα πόλλ’ ἐτελέσθη,	-- --- uu -uu - uu--	dactylic hexameter	masculine penthemimeral
καὶ τότε δή με διὰ δμῳάς, κύνας οὐκ ἀλεγούσας,	- uu - u u- -- uu - uu--	dactylic hexameter	masculine penthemimeral, hepthemimeral, trithemimeral
εἷλον ἐπελθόντες καὶ ὁμόκλησαν ἐπέεσσιν.	-u u--- u u--- uu--	dactylic hexameter	masculine penthemimeral
ὣς τὸ μὲν ἐξετέλεσσα, καὶ οὐκ ἐθέλουσ’, ὑπ’ ἀνάγκης·	- u u -uu-u u - uu- u u--	dactylic hexameter	feminine penthemimeral, hepthemimeral
νῦν δ’οὔτ’ ἐκφυγέειν δύναμαι γάμον οὔτε τιν’ ἄλλην	- - -uu- uu- uu -u u --	dactylic hexameter	masculine penthemimeral, hepthemimeral
μῆτιν ἔθ’ εὑρίσκω· μάλα δ’ὀτρύνουσι τοκῆες	-u u --- uu ---u u--	dactylic hexameter	masculine penthemimeral
γήμασθ’, ἀσχαλάᾳ δὲ πάϊς βίοτον κατεδόντων,	-- -uu- u u- uu- uu--	dactylic hexameter	masculine penthemimeral, hepthemimeral
γινώσκων· ἤδη γὰρ ἀνὴρ οἶός τε μάλιστα	--- -- u u- -- u u--	dactylic hexameter	masculine penthemimeral, hepthemimeral, trithemimeral
οἴκου κήδεσθαι, τῷ τε Ζεὺς ὄλβον ὀπάζει.	-- --- - - - -u u--	dactylic hexameter	masculine penthemimeral, hepthemimeral
ἀλλὰ καὶ ὥς μοι εἰπὲ τεὸν γένος, ὁππόθεν ἐσσί.	-u u - - -u u- uu -uu --	dactylic hexameter	feminine penthemimeral, hepthemimeral, trithemimeral
οὐ γὰρ ἀπὸ δρυός ἐσσι παλαιφάτου οὐδ’ ἀπὸ πέτρης.	- u u- uu -u u-uu - uu --	dactylic hexameter	feminine penthemimeral, trithemimeral
τὴν δ’ἀπαμειβόμενος προσέφη πολύμητις Ὀδυσσεύς·	- uu-uu- uu- uu-u u--	dactylic hexameter	masculine penthemimeral, hepthemimeral
ὧ γύναι αἰδοίη Λαερτιάδεω Ὀδυσῆος,	- uu --- --uu- uu--	dactylic hexameter	masculine penthemimeral
οὐκέτ’ ἀπολλήξεις τὸν ἐμὸν γόνον ἐξερέουσα;	-u u--- u u- uu -uu--	dactylic hexameter	masculine penthemimeral, hepthemimeral
ἀλλ’ ἔκ τοι ἐρέω· ἦ μέν μ’ἀχέεσσί γε δώσεις	- - - uu- - - uu-u u --	dactylic hexameter	masculine penthemimeral, hepthemimeral, trithemimeral
πλείοσιν ἢ ἔχομαι· ἡ γὰρ δίκη, ὁππότε πάτρης	-uu - uu- - - uu -uu --	dactylic hexameter	masculine penthemimeral, hepthemimeral, trithemimeral
ἧς ἀπέῃσιν ἀνὴρ τόσσον χρόνον ὅσσον ἐγὼ νῦν,	- uu-u u- -- uu -u u- -	dactylic hexameter	masculine penthemimeral, hepthemimeral
πολλὰ βροτῶν ἐπὶ ἄστε’ ἀλώμενος, ἄλγεα πάσχων·	-u u- uu -u u-uu -uu --	dactylic hexameter	feminine penthemimeral, trithemimeral
ἀλλὰ καὶ ὣς ἐρέω ὅ μ’ἀνείρεαι ἠδὲ μεταλλᾷς.	-u u - uu- u u-uu -u u--	dactylic hexameter	masculine penthemimeral, trithemimeral
Κρήτη τις γαῖ’ ἔστι, μέσῳ ἐνὶ οἴνοπι πόντῳ,	-- - - -u u- uu -uu --	dactylic hexameter	feminine penthemimeral, hepthemimeral, trithemimeral
καλὴ καὶ πίειρα, περίρρυτος· ἐν δ’ἄνθρωποι	-- - --u u-uu - ---	dactylic hexameter	feminine penthemimeral, trithemimeral
πολλοί, ἀπειρέσιοι, καὶ ἐννήκοντα πόληες.	-u u-uu- - ---u u--	dactylic hexameter	masculine penthemimeral
ἄλλη δ’ἄλλων γλῶσσα μεμιγμένη· ἐν μὲν Ἀχαιοί,	-- -- -u u-uu - u u--	dactylic hexameter	feminine penthemimeral
ἐν δ’Ἐτεόκρητες μεγαλήτορες, ἐν δὲ Κύδωνες,	- uu--- uu-uu - u u--	dactylic hexameter	masculine penthemimeral
Δωριέες τε τριχάϊκες δῖοί τε Πελασγοί.	-uu- u u--- -- u u--	dactylic hexameter	hepthemimeral, trithemimeral
τῇσι δ’ἐνὶ Κνωσός, μεγάλη πόλις, ἔνθα τε Μίνως	-u u- -- uu- uu -u u --	dactylic hexameter	masculine penthemimeral, hepthemimeral, trithemimeral
ἐννέωρος βασίλευε Διὸς μεγάλου ὀαριστής,	--- uu-u u- uu- uu--	dactylic hexameter	feminine penthemimeral, hepthemimeral, trithemimeral
πατρὸς ἐμοῖο πατήρ, μεγαθύμου Δευκαλίωνος	-u u-u u- uu-- -uu--	dactylic hexameter	masculine penthemimeral
Δευκαλίων δ’ἐμὲ τίκτε καὶ Ἰδομενῆα ἄνακτα·	-uu- uu -u u -uu-u u--	dactylic hexameter	feminine penthemimeral, trithemimeral
ἀλλ’ ὁ μὲν ἐν νήεσσι κορωνίσιν Ἴλιον εἴσω	- u u - --u u-uu -uu --	dactylic hexameter	feminine penthemimeral, trithemimeral
ᾤχεθ’ ἅμ’ Ἀτρεΐδῃσιν, ἐμοὶ δ’ὄνομα κλυτὸν Αἴθων,	-u u -uu-u u- uu- uu --	dactylic hexameter	feminine penthemimeral, hepthemimeral
ὁπλότερος γενεῇ· ὁ δ’ἄρα πρότερος καὶ ἀρείων.	-uu- uu- u u- uu- u u--	dactylic hexameter	masculine penthemimeral, hepthemimeral, trithemimeral
ἔνθ’ Ὀδυσῆα ἐγὼν ἰδόμην καὶ ξείνια δῶκα.	- uu-u u- uu- - -uu --	dactylic hexameter	masculine penthemimeral, hepthemimeral
καὶ γὰρ τὸν Κρήτηνδε κατήγαγεν ἲς ἀνέμοιο,	- - - --u u-uu - uu--	dactylic hexameter	feminine penthemimeral, trithemimeral
ἱέμενον Τροίηνδε παραπλάγξασα Μαλειῶν·	-uu- --u u---u u--	dactylic hexameter	feminine penthemimeral, trithemimeral
στῆσε δ’ἐν Ἀμνισῷ, ὅθι τε σπέος Εἰλειθυίης,	-u u --- uu - uu ----	dactylic hexameter	masculine penthemimeral, hepthemimeral
ἐν λιμέσιν χαλεποῖσι, μόγις δ’ὑπάλυξεν ἀέλλας.	- uu- uu-u u- uu-u u--	dactylic hexameter	feminine penthemimeral, hepthemimeral, trithemimeral
αὐτίκα δ’Ἰδομενῆα μετάλλα ἄστυδ’ ἀνελθών·	-uu -uu-u u-- -u u--	dactylic hexameter	feminine penthemimeral
ξεῖνον γάρ οἱ ἔφασκε φίλον τ’ἔμεν αἰδοῖόν τε.	-- - u u-u u- uu --- -	dactylic hexameter	feminine penthemimeral, hepthemimeral, trithemimeral
τῷ δ’ἤδη δεκάτη ἢ ἑνδεκάτη πέλεν ἠὼς	- -- uu- - -uu- uu --	dactylic hexameter	masculine penthemimeral, trithemimeral
οἰχομένῳ σὺν νηυσὶ κορωνίσιν Ἴλιον εἴσω.	-uu- - -u u-uu -uu --	dactylic hexameter	feminine penthemimeral, trithemimeral
τὸν μὲν ἐγὼ πρὸς δώματ’ ἄγων ἐῢ ἐξείνισσα,	- u u- - -u u- uu ----	dactylic hexameter	feminine penthemimeral, hepthemimeral, trithemimeral
ἐνδυκέως φιλέων, πολλῶν κατὰ οἶκον ἐόντων·	-uu- uu- -- uu -u u--	dactylic hexameter	masculine penthemimeral, hepthemimeral, trithemimeral
καί οἱ τοῖς ἄλλοις ἑτάροις, οἳ ἅμ’ αὐτῷ ἕποντο,	- - - -- uu- u u -u u--	dactylic hexameter	masculine penthemimeral, hepthemimeral, trithemimeral
δημόθεν ἄλφιτα δῶκα καὶ αἴθοπα οἶνον ἀγείρας	-uu -uu -u u -uu -u u--	dactylic hexameter	feminine penthemimeral
καὶ βοῦς ἱρεύσασθαι, ἵνα πλησαίατο θυμόν.	- - ---u u- --uu --	dactylic hexameter	feminine penthemimeral, hepthemimeral
ἔνθα δυώδεκα μὲν μένον ἤματα δῖοι Ἀχαιοί·	-u u-uu - uu -uu -u u--	dactylic hexameter	masculine penthemimeral
εἴλει γὰρ Βορέης ἄνεμος μέγας οὐδ’ ἐπὶ γαίῃ	-- - uu- uu- uu - uu --	dactylic hexameter	masculine penthemimeral, hepthemimeral, trithemimeral
εἴα ἵστασθαι, χαλεπὸς δέ τις ὤρορε δαίμων.	-- --- uu- u u -uu --	dactylic hexameter	masculine penthemimeral, hepthemimeral
τῇ τρισκαιδεκάτῃ δ’ἄνεμος πέσε, τοὶ δ’ἀνάγοντο.	- --uu- uu- uu - uu--	dactylic hexameter	masculine penthemimeral, hepthemimeral
ἴσκε ψεύδεα πολλὰ λέγων ἐτύμοισιν ὁμοῖα·	-- -uu -u u- uu-u u--	dactylic hexameter	feminine penthemimeral, hepthemimeral
τῆς δ’ἄρ’ ἀκουούσης ῥέε δάκρυα, τήκετο δὲ χρώς·	- u u--- uu -uu -uu - -	dactylic hexameter	masculine penthemimeral
ὡς δὲ χιὼν κατατήκετ’ ἐν ἀκροπόλοισιν ὄρεσσιν,	- u u- uu-u u -uu-u u--	dactylic hexameter	feminine penthemimeral, trithemimeral
ἥν τ’Εὖρος κατέτηξεν, ἐπὴν Ζέφυρος καταχεύῃ·	- -- uu-u u- uu- uu--	dactylic hexameter	feminine penthemimeral, hepthemimeral, trithemimeral
τηκομένης δ’ἄρα τῆς ποταμοὶ πλήθουσι ῥέοντες·	-uu- uu - uu- --u u--	dactylic hexameter	masculine penthemimeral, hepthemimeral, trithemimeral
ὣς τῆς τήκετο καλὰ παρήϊα δάκρυ χεούσης,	- - -uu -u u-uu -u u--	dactylic hexameter	feminine penthemimeral
κλαιούσης ἑὸν ἄνδρα παρήμενον. αὐτὰρ Ὀδυσσεὺς	--- uu -u u-uu -u u--	dactylic hexameter	feminine penthemimeral, trithemimeral
θυμῷ μὲν γοόωσαν ἑὴν ἐλέαιρε γυναῖκα,	-- - uu-u u- uu-u u--	dactylic hexameter	feminine penthemimeral, hepthemimeral, trithemimeral
ὀφθαλμοὶ δ’ὡς εἰ κέρα ἕστασαν ἠὲ σίδηρος	--- - - uu -uu -u u--	dactylic hexameter	masculine penthemimeral, trithemimeral
ἀτρέμας ἐν βλεφάροισι· δόλῳ δ’ὅ γε δάκρυα κεῦθεν.	-uu - uu-u u- u u -uu --	dactylic hexameter	feminine penthemimeral, hepthemimeral, trithemimeral
ἡ δ’ἐπεὶ οὖν τάρφθη πολυδακρύτοιο γόοιο,	- uu - -- uu---u u--	dactylic hexameter	masculine penthemimeral, trithemimeral
ἐξαῦτίς μιν ἔπεσσιν ἀμειβομένη προσέειπε·	--- u u-u u-uu- uu--	dactylic hexameter	feminine penthemimeral, trithemimeral
νῦν μὲν δή σευ, ξεῖνέ γ’, ὀΐω πειρήσεσθαι,	- - - - -u u-- ----	dactylic hexameter	feminine penthemimeral, trithemimeral
εἰ ἐτεὸν δὴ κεῖθι σὺν ἀντιθέοις ἑτάροισι	- uu- - -u u -uu- uu--	dactylic hexameter	feminine penthemimeral, trithemimeral
ξείνισας ἐν μεγάροισιν ἐμὸν πόσιν, ὡς ἀγορεύεις.	-uu - uu-u u- uu - uu--	dactylic hexameter	feminine penthemimeral, hepthemimeral, trithemimeral
εἰπέ μοι ὁπποῖ’ ἄσσα περὶ χροῒ εἵματα ἕστο,	-u u -- -u u- uu -uu --	dactylic hexameter	feminine penthemimeral, hepthemimeral
αὐτός θ’οἷος ἔην, καὶ ἑταίρους, οἵ οἱ ἕποντο.	-- -u u- u u-- - u u--	dactylic hexameter	masculine penthemimeral
τὴν δ’ἀπαμειβόμενος προσέφη πολύμητις Ὀδυσσεύς·	- uu-uu- uu- uu-u u--	dactylic hexameter	masculine penthemimeral, hepthemimeral
ὧ γύναι, ἀργαλέον τόσσον χρόνον ἀμφὶς ἐόντα	- uu -uu- -- uu -u u--	dactylic hexameter	masculine penthemimeral, hepthemimeral
εἰπέμεν· ἤδη γάρ οἱ ἐεικοστὸν ἔτος ἐστὶν	-uu -- - u u--- uu --	dactylic hexameter	masculine penthemimeral
ἐξ οὗ κεῖθεν ἔβη καὶ ἐμῆς ἀπελήλυθε πάτρης·	- - -u u- u u- uu-uu --	dactylic hexameter	masculine penthemimeral, hepthemimeral
αὐτάρ τοι ἐρέω ὥς μοι ἰνδάλλεται ἦτορ.	-- - uu- - - --uu --	dactylic hexameter	masculine penthemimeral, hepthemimeral, trithemimeral
χλαῖναν πορφυρέην οὔλην ἔχε δῖος Ὀδυσσεύς,	-- -uu- -- uu -u u--	dactylic hexameter	masculine penthemimeral, hepthemimeral
διπλῆν· ἐν δ’ἄρα οἱ περόνη χρυσοῖο τέτυκτο	-- - uu - uu- --u u--	dactylic hexameter	masculine penthemimeral, hepthemimeral, trithemimeral
αὐλοῖσιν διδύμοισι· πάροιθε δὲ δαίδαλον ἦεν·	--- uu-u u-u u -uu --	dactylic hexameter	feminine penthemimeral, trithemimeral
ἐν προτέροισι πόδεσσι κύων ἔχε ποικίλον ἐλλόν,	- uu-u u-u u- uu -uu --	dactylic hexameter	feminine penthemimeral, hepthemimeral
ἀσπαίροντα λάων· τὸ δὲ θαυμάζεσκον ἅπαντες,	---u u- u u ---u u--	dactylic hexameter	masculine penthemimeral
ὡς οἱ χρύσεοι ὄντες ὁ μὲν λάε νεβρὸν ἀπάγχων,	- - -uu -u u - uu -u u--	dactylic hexameter	feminine penthemimeral, hepthemimeral
αὐτὰρ ὁ ἐκφυγέειν μεμαὼς ἤσπαιρε πόδεσσι.	-u u -uu- uu- --u u--	dactylic hexameter	masculine penthemimeral, hepthemimeral
τὸν δὲ χιτῶν’ ἐνόησα περὶ χροῒ σιγαλόεντα,	- u u- uu-u u- uu -uu--	dactylic hexameter	feminine penthemimeral, hepthemimeral, trithemimeral
οἷόν τε κρομύοιο λοπὸν κάτα ἰσχαλέοιο·	-- - uu-u u- uu -uu--	dactylic hexameter	feminine penthemimeral, hepthemimeral, trithemimeral
τὼς μὲν ἔην μαλακός, λαμπρὸς δ’ἦν ἠέλιος ὥς·	- u u- uu- -- - -uu- -	dactylic hexameter	masculine penthemimeral, hepthemimeral, trithemimeral
ἦ μὲν πολλαί γ’αὐτὸν ἐθηήσαντο γυναῖκες.	- - -- -u u---u u--	dactylic hexameter	feminine penthemimeral
ἄλλο δέ τοι ἐρέω, σὺ δ’ἐνὶ φρεσὶ βάλλεο σῇσιν·	-u u - uu- u u- uu -uu --	dactylic hexameter	masculine penthemimeral, hepthemimeral, trithemimeral
οὐκ οἶδ’ εἰ τάδε ἕστο περὶ χροῒ οἴκοθ’ Ὀδυσσεύς,	- - - uu -u u- uu -u u--	dactylic hexameter	feminine penthemimeral, hepthemimeral, trithemimeral
ἦ τις ἑταίρων δῶκε θοῆς ἐπὶ νηὸς ἰόντι,	- u u-- -u u- uu -u u--	dactylic hexameter	feminine penthemimeral, hepthemimeral
ἤ τίς που καὶ ξεῖνος, ἐπεὶ πολλοῖσιν Ὀδυσσεὺς	- - - - -u u- --u u--	dactylic hexameter	feminine penthemimeral, hepthemimeral, trithemimeral
ἔσκε φίλος· παῦροι γὰρ Ἀχαιῶν ἦσαν ὁμοῖοι.	-u u- -- u u-- -u u--	dactylic hexameter	masculine penthemimeral, trithemimeral
καί οἱ ἐγὼ χάλκειον ἄορ καὶ δίπλακα δῶκα	- u u- --u u- - -uu --	dactylic hexameter	feminine penthemimeral, hepthemimeral, trithemimeral
καλὴν πορφυρέην καὶ τερμιόεντα χιτῶνα,	-- -uu- - -uu-u u--	dactylic hexameter	masculine penthemimeral
αἰδοίως δ’ἀπέπεμπον ἐϋσσέλμου ἐπὶ νηός.	--- uu-u u--- uu --	dactylic hexameter	feminine penthemimeral, trithemimeral
καὶ μέν οἱ κῆρυξ ὀλίγον προγενέστερος αὐτοῦ	- - - -- uu- uu-uu --	dactylic hexameter	masculine penthemimeral, hepthemimeral, trithemimeral
εἵπετο· καὶ τόν τοι μυθήσομαι, οἷος ἔην περ.	-uu - - - --uu -u u- -	dactylic hexameter	masculine penthemimeral, trithemimeral
γυρὸς ἐν ὤμοισιν, μελανόχροος, οὐλοκάρηνος,	-u u --- uu-uu -uu--	dactylic hexameter	masculine penthemimeral
Εὐρυβάτης δ’ὄνομ’ ἔσκε· τίεν δέ μιν ἔξοχον ἄλλων	-uu- uu -u u- u u -uu --	dactylic hexameter	feminine penthemimeral, hepthemimeral, trithemimeral
ὦν ἑτάρων Ὀδυσεύς, ὅτι οἱ φρεσὶν ἄρτια ᾔδη.	- uu- uu- uu - uu -uu --	dactylic hexameter	masculine penthemimeral, hepthemimeral, trithemimeral
ὣς φάτο, τῇ δ’ἔτι μᾶλλον ὑφ’ ἵμερον ὧρσε γόοιο,	- uu - uu -u u -uu -u u--	dactylic hexameter	feminine penthemimeral, trithemimeral
σήματ’ ἀναγνούσῃ τά οἱ ἔμπεδα πέφραδ’ Ὀδυσσεύς.	-u u--- u u -uu -u u--	dactylic hexameter	masculine penthemimeral
ἡ δ’ἐπεὶ οὖν τάρφθη πολυδακρύτοιο γόοιο.	- uu - -- uu---u u--	dactylic hexameter	masculine penthemimeral, trithemimeral
καὶ τότε μιν μύθοισιν ἀμειβομένη προσέειπε·	- uu - --u u-uu- uu--	dactylic hexameter	feminine penthemimeral, trithemimeral
νῦν μὲν δή μοι, ξεῖνε, πάρος περ ἐὼν ἐλεεινός,	- - - - -u u- u u- uu--	dactylic hexameter	feminine penthemimeral, hepthemimeral, trithemimeral
ἐν μεγάροισιν ἐμοῖσι φίλος τ’ἔσῃ αἰδοῖός τε·	- uu-u u-u u- uu --- -	dactylic hexameter	feminine penthemimeral, hepthemimeral
αὐτὴ γὰρ τάδε εἵματ’ ἐγὼ πόρον, οἷ’ ἀγορεύεις,	-- - uu -u u- uu - uu--	dactylic hexameter	feminine penthemimeral, hepthemimeral, trithemimeral
πτύξασ’ ἐκ θαλάμου, περόνην τ’ἐπέθηκα φαεινὴν	-- - uu- uu- uu-u u--	dactylic hexameter	masculine penthemimeral, hepthemimeral, trithemimeral
κείνῳ ἄγαλμ’ ἔμεναι· τὸν δ’οὐχ ὑποδέξομαι αὖτις	-u u- uu- - - uu-uu --	dactylic hexameter	masculine penthemimeral, hepthemimeral, trithemimeral
οἴκαδε νοστήσαντα φίλην ἐς πατρίδα γαῖαν.	-uu ---u u- - -uu --	dactylic hexameter	feminine penthemimeral, hepthemimeral
τῶ ῥα κακῇ αἴσῃ κοίλης ἐπὶ νηὸς Ὀδυσσεὺς	- u u- -- -- uu -u u--	dactylic hexameter	masculine penthemimeral, hepthemimeral, trithemimeral
ᾤχετ’ ἐποψόμενος Κακοΐλιον οὐκ ὀνομαστήν.	-u u-uu- uu-uu - uu--	dactylic hexameter	masculine penthemimeral
τὴν δ’ἀπαμειβόμενος προσέφη πολύμητις Ὀδυσσεύς·	- uu-uu- uu- uu-u u--	dactylic hexameter	masculine penthemimeral, hepthemimeral
ὧ γύναι αἰδοίη Λαερτιάδεω Ὀδυσῆος,	- uu --- --uu- uu--	dactylic hexameter	masculine penthemimeral
μηκέτι νῦν χρόα καλὸν ἐναίρεο, μηδέ τι θυμὸν	-uu - uu -u u-uu -u u --	dactylic hexameter	feminine penthemimeral, trithemimeral
τῆκε, πόσιν γοόωσα. νεμεσσῶμαί γε μὲν οὐδέν·	-u u- uu-u u--- u u --	dactylic hexameter	feminine penthemimeral, trithemimeral
καὶ γάρ τίς τ’ἀλλοῖον ὀδύρεται ἄνδρ’ ὀλέσασα	- - - --u u-uu - uu--	dactylic hexameter	feminine penthemimeral, trithemimeral
κουρίδιον, τῷ τέκνα τέκῃ φιλότητι μιγεῖσα,	-uu- - -u u- uu-u u--	dactylic hexameter	feminine penthemimeral, hepthemimeral, trithemimeral
ἢ Ὀδυσῆ’, ὅν φασι θεοῖς ἐναλίγκιον εἶναι.	- uu- - -u u- uu-uu --	dactylic hexameter	feminine penthemimeral, hepthemimeral, trithemimeral
ἀλλὰ γόου μὲν παῦσαι, ἐμεῖο δὲ σύνθεο μῦθον·	-u u- - -u u-u u -uu --	dactylic hexameter	feminine penthemimeral, trithemimeral
νημερτέως γάρ τοι μυθήσομαι οὐδ’ ἐπικεύσω	--- - - --uu - uu--	dactylic hexameter	masculine penthemimeral, trithemimeral
ὡς ἤδη Ὀδυσῆος ἐγὼ περὶ νόστου ἄκουσα	- -- uu-u u- uu -u u--	dactylic hexameter	feminine penthemimeral, hepthemimeral, trithemimeral
ἀγχοῦ, Θεσπρωτῶν ἀνδρῶν ἐν πίονι δήμῳ,	-- --- -- - -uu --	dactylic hexameter	masculine penthemimeral, hepthemimeral
ζωοῦ· αὐτὰρ ἄγει κειμήλια πολλὰ καὶ ἐσθλὰ	-- -u u- --uu -u u --	dactylic hexameter	masculine penthemimeral
αἰτίζων ἀνὰ δῆμον. ἀτὰρ ἐρίηρας ἑταίρους	--- uu -u u- uu-u u--	dactylic hexameter	feminine penthemimeral, hepthemimeral, trithemimeral
ὤλεσε καὶ νῆα γλαφυρὴν ἐνὶ οἴνοπι πόντῳ,	-uu - -- uu- uu -uu --	dactylic hexameter	masculine penthemimeral, hepthemimeral, trithemimeral
Θρινακίης ἄπο νήσου ἰών· ὀδύσαντο γὰρ αὐτῷ	-uu- uu -u u- uu-u u --	dactylic hexameter	feminine penthemimeral, hepthemimeral, trithemimeral
Ζεύς τε καὶ Ἠέλιος· τοῦ γὰρ βόας ἔκταν ἑταῖροι.	- u u -uu- - - uu -u u--	dactylic hexameter	masculine penthemimeral, hepthemimeral
οἱ μὲν πάντες ὄλοντο πολυκλύστῳ ἐνὶ πόντῳ·	- - -u u-u u--- uu --	dactylic hexameter	feminine penthemimeral
τὸν δ’ἄρ’ ἐπὶ τρόπιος νεὸς ἔκβαλε κῦμ’ ἐπὶ χέρσου,	- u u- uu- uu -uu - uu --	dactylic hexameter	masculine penthemimeral, trithemimeral
Φαιήκων ἐς γαῖαν, οἳ ἀγχίθεοι γεγάασιν,	--- - -u u -uu- uu--	dactylic hexameter	feminine penthemimeral, trithemimeral
οἳ δή μιν περὶ κῆρι θεὸν ὣς τιμήσαντο	- - - uu -u u- - ----	dactylic hexameter	feminine penthemimeral, hepthemimeral, trithemimeral
καί οἱ πολλὰ δόσαν πέμπειν τέ μιν ἤθελον αὐτοὶ	- - -u u- -- u u -uu --	dactylic hexameter	masculine penthemimeral, hepthemimeral
οἴκαδ’ ἀπήμαντον. καί κεν πάλαι ἐνθάδ’ Ὀδυσσεὺς	-u u--- - - uu -u u--	dactylic hexameter	masculine penthemimeral, hepthemimeral
ἤην· ἀλλ’ ἄρα οἱ τό γε κέρδιον εἴσατο θυμῷ,	-- - uu - u u -uu -uu --	dactylic hexameter	masculine penthemimeral, trithemimeral
χρήματ’ ἀγυρτάζειν πολλὴν ἐπὶ γαῖαν ἰόντι·	-u u--- -- uu -u u--	dactylic hexameter	masculine penthemimeral, hepthemimeral
ὣς περὶ κέρδεα πολλὰ καταθνητῶν ἀνθρώπων	- uu -uu -u u--- ---	dactylic hexameter	feminine penthemimeral
οἶδ’ Ὀδυσεύς, οὐδ’ ἄν τις ἐρίσσειε βροτὸς ἄλλος.	- uu- - - u u--- uu --	dactylic hexameter	masculine penthemimeral, trithemimeral
ὥς μοι Θεσπρωτῶν βασιλεὺς μυθήσατο Φείδων·	- - --- uu- --uu --	dactylic hexameter	masculine penthemimeral, hepthemimeral
ὤμνυε δὲ πρὸς ἔμ’ αὐτόν, ἀποσπένδων ἐνὶ οἴκῳ,	-uu - u u -u u--- uu --	dactylic hexameter	feminine penthemimeral, trithemimeral
νῆα κατειρύσθαι καὶ ἐπαρτέας ἔμμεν ἑταίρους,	-u u--- u u-uu -u u--	dactylic hexameter	masculine penthemimeral
οἳ δή μιν πέμψουσι φίλην ἐς πατρίδα γαῖαν.	- - - --u u- - -uu --	dactylic hexameter	feminine penthemimeral, hepthemimeral, trithemimeral
ἀλλ’ ἐμὲ πρὶν ἀπέπεμψε· τύχησε γὰρ ἐρχομένη νηῦς	- uu - uu-u u-u u -uu- -	dactylic hexameter	feminine penthemimeral, trithemimeral
ἀνδρῶν Θεσπρωτῶν ἐς Δουλίχιον πολύπυρον.	-- --- - -uu- uu--	dactylic hexameter	masculine penthemimeral
καί μοι κτήματ’ ἔδειξεν, ὅσα ξυναγείρατ’ Ὀδυσσεύς·	- - -u u-u u- uu-u u--	dactylic hexameter	feminine penthemimeral, hepthemimeral
καί νύ κεν ἐς δεκάτην γενεὴν ἕτερόν γ’ἔτι βόσκοι,	- u u - uu- uu- uu- uu --	dactylic hexameter	masculine penthemimeral, hepthemimeral, trithemimeral
ὅσσα οἱ ἐν μεγάροις κειμήλια κεῖτο ἄνακτος.	-u u - uu- --uu -u u--	dactylic hexameter	masculine penthemimeral, trithemimeral
τὸν δ’ἐς Δωδώνην φάτο βήμεναι, ὄφρα θεοῖο	- - --- uu -uu -u u--	dactylic hexameter	masculine penthemimeral
ἐκ δρυὸς ὑψικόμοιο Διὸς βουλὴν ἐπακούσῃ,	- uu -uu-u u- -- uu--	dactylic hexameter	feminine penthemimeral, hepthemimeral
ὅππως νοστήσειε φίλην ἐς πατρίδα γαῖαν	-- ---u u- - -uu --	dactylic hexameter	feminine penthemimeral, hepthemimeral
ἤδη δὴν ἀπεών, ἤ ἀμφαδὸν ἦε κρυφηδόν.	-- - uu- - -uu -u u--	dactylic hexameter	masculine penthemimeral, trithemimeral
ὣς ὁ μὲν οὕτως ἐστὶ σόος καὶ ἐλεύσεται ἤδη	- u u -- -u u- u u-uu --	dactylic hexameter	feminine penthemimeral, hepthemimeral
ἄγχι μάλ’, οὐδ’ ἔτι τῆλε φίλων καὶ πατρίδος αἴης	-u u - uu -u u- - -uu --	dactylic hexameter	feminine penthemimeral, hepthemimeral, trithemimeral
δηρὸν ἀπεσσεῖται· ἔμπης δέ τοι ὅρκια δώσω.	-u u--- -- u u -uu --	dactylic hexameter	masculine penthemimeral, hepthemimeral
ἴστω νῦν Ζεὺς πρῶτα, θεῶν ὕπατος καὶ ἄριστος,	-- - - -u u- uu- u u--	dactylic hexameter	feminine penthemimeral, hepthemimeral, trithemimeral
ἱστίη τ’Ὀδυσῆος ἀμύμονος, ἣν ἀφικάνω·	--- uu-u u-uu - uu--	dactylic hexameter	feminine penthemimeral, trithemimeral
ἦ μέν τοι τάδε πάντα τελείεται ὡς ἀγορεύω.	- - - uu -u u-uu - uu--	dactylic hexameter	feminine penthemimeral, trithemimeral
τοῦδ’ αὐτοῦ λυκάβαντος ἐλεύσεται ἐνθάδ’ Ὀδυσσεύς,	- -- uu-u u-uu -u u--	dactylic hexameter	feminine penthemimeral, trithemimeral
τοῦ μὲν φθίνοντος μηνός, τοῦ δ’ἱσταμένοιο.	- - --- -- - -uu--	dactylic hexameter	masculine penthemimeral, hepthemimeral
τὸν δ’αὖτε προσέειπε περίφρων Πηνελόπεια·	- -- uu-u u-- -uu--	dactylic hexameter	feminine penthemimeral, trithemimeral
αἲ γὰρ τοῦτο, ξεῖνε, ἔπος τετελεσμένον εἴη·	- - -- -u u- uu-uu --	dactylic hexameter	feminine penthemimeral, hepthemimeral
τῶ κε τάχα γνοίης φιλότητά τε πολλά τε δῶρα	- u u- -- uu-u u -u u --	dactylic hexameter	masculine penthemimeral, trithemimeral
ἐξ ἐμεῦ, ὡς ἄν τίς σε συναντόμενος μακαρίζοι.	- uu - - - u u-uu- uu--	dactylic hexameter	masculine penthemimeral, trithemimeral
ἀλλά μοι ὦδ’ ἀνὰ θυμὸν ὀΐεται, ὡς ἔσεταί περ·	-u u - uu -u u-uu - uu- -	dactylic hexameter	feminine penthemimeral, trithemimeral
οὔτ’ Ὀδυσεὺς ἔτι οἶκον ἐλεύσεται, οὔτε σὺ πομπῆς	- uu- uu -u u-uu -u u --	dactylic hexameter	feminine penthemimeral, trithemimeral
τεύξ᾽ ἐπεὶ οὐ τοῖοι σημάντορές εἰσ’ ἐνὶ οἴκῳ	- uu - -- --uu - uu --	dactylic hexameter	masculine penthemimeral, trithemimeral
οἷος Ὀδυσσεὺς ἔσκε μετ’ ἀνδράσιν, εἴ ποτ’ ἔην γε,	-u u-- -u u -uu - u u- -	dactylic hexameter	feminine penthemimeral
ξείνους αἰδοίους ἀποπεμπέμεν ἠδὲ δέχεσθαι.	-- --- uu-uu -u u--	dactylic hexameter	masculine penthemimeral
ἀλλά μιν, ἀμφίπολοι, ἀπονίψατε, κάτθετε δ’εὐνήν,	-u u -uu- uu-uu -uu --	dactylic hexameter	masculine penthemimeral
δέμνια καὶ χλαίνας καὶ ῥήγεα σιγαλόεντα,	-uu - -- - -uu -uu--	dactylic hexameter	masculine penthemimeral, trithemimeral
ὥς κ’εὖ θαλπιόων χρυσόθρονον Ἠῶ ἵκηται.	- - -uu- --uu -u u--	dactylic hexameter	masculine penthemimeral
ἠῶθεν δὲ μάλ’ ἦρι λοέσσαι τε χρῖσαί τε,	--- u u -u u-- - -- -	dactylic hexameter	feminine penthemimeral, trithemimeral
ὥς κ’ἔνδον παρὰ Τηλεμάχῳ δείπνοιο μέδηται	- -- uu -uu- --u u--	dactylic hexameter	hepthemimeral, trithemimeral
ἥμενος ἐν μεγάρῳ· τῷ δ’ἄλγιον ὅς κεν ἐκείνων	-uu - uu- - -uu - u u--	dactylic hexameter	masculine penthemimeral, trithemimeral
τοῦτον ἀνιάζῃ θυμοφθόρος· οὐδέ τι ἔργον	-u u--- --uu -u u --	dactylic hexameter	masculine penthemimeral
ἐνθάδ’ ἔτι πρήξει, μάλα περ κεχολωμένος αἰνῶς.	-u u- -- uu - uu-uu --	dactylic hexameter	masculine penthemimeral, hepthemimeral, trithemimeral
πῶς γὰρ ἐμεῦ σύ, ξεῖνε, δαήσεαι εἴ τι γυναικῶν	- u u- - -u u-uu - u u--	dactylic hexameter	feminine penthemimeral, trithemimeral
ἀλλάων περίειμι νόον καὶ ἐπίφρονα μῆτιν,	--- uu-u u- u u-uu --	dactylic hexameter	feminine penthemimeral, hepthemimeral, trithemimeral
εἴ κεν ἀϋσταλέος, κακὰ εἱμένος ἐν μεγάροισι	- u u-uu- uu -uu - uu--	dactylic hexameter	masculine penthemimeral
δαινύῃ; ἄνθρωποι δὲ μινυνθάδιοι τελέθουσιν.	-uu --- u u-uu- uu--	dactylic hexameter	masculine penthemimeral
ὃς μὲν ἀπηνὴς αὐτὸς ἔῃ καὶ ἀπηνέα εἰδῇ,	- u u-- -u u- u u-uu --	dactylic hexameter	feminine penthemimeral, hepthemimeral
τῷ δὲ καταρῶνται πάντες βροτοὶ ἄλγε’ ὀπίσσω	- u u--- -- uu -u u--	dactylic hexameter	masculine penthemimeral, hepthemimeral
ζωῷ, ἀτὰρ τεθνεῶτί γ’ ἐφεψιόωνται ἅπαντες·	-u u- --u u-uu-u u--	dactylic hexameter	feminine penthemimeral, trithemimeral
ὃς δ’ἂν ἀμύμων αὐτὸς ἔῃ καὶ ἀμύμονα εἰδῇ,	- u u-- -u u- u u-uu --	dactylic hexameter	feminine penthemimeral, hepthemimeral
τοῦ μέν τε κλέος εὐρὺ διὰ ξεῖνοι φορέουσι	- - - uu -u u- -- uu--	dactylic hexameter	feminine penthemimeral, hepthemimeral, trithemimeral
πάντας ἐπ’ ἀνθρώπους, πολλοί τέ μιν ἐσθλὸν ἔειπον.	-u u --- -- u u -u u--	dactylic hexameter	masculine penthemimeral, hepthemimeral
τὴν δ’ἀπαμειβόμενος προσέφη πολύμητις Ὀδυσσεύς·	- uu-uu- uu- uu-u u--	dactylic hexameter	masculine penthemimeral, hepthemimeral
ὧ γύναι αἰδοίη Λαερτιάδεω Ὀδυσῆος,	- uu --- --uu- uu--	dactylic hexameter	masculine penthemimeral
ἤτοι ἐμοὶ χλαῖναι καὶ ῥήγεα σιγαλόεντα	-u u- -- - -uu -uu--	dactylic hexameter	masculine penthemimeral, trithemimeral
ἤχθεθ’, ὅτε πρῶτον Κρήτης ὄρεα νιφόεντα	-u u- -- -- uu- uu--	dactylic hexameter	masculine penthemimeral, hepthemimeral, trithemimeral
νοσφισάμην ἐπὶ νηὸς ἰὼν δολιχηρέτμοιο,	-uu- uu -u u- uu----	dactylic hexameter	feminine penthemimeral, hepthemimeral, trithemimeral
κείω δ’ὡς τὸ πάρος περ ἀΰπνους νύκτας ἴαυον·	-- - u u- u u-- -u u--	dactylic hexameter	masculine penthemimeral, trithemimeral
πολλὰς γὰρ δὴ νύκτας ἀεικελίῳ ἐνὶ κοίτῃ	-- - - -u u-uu- uu --	dactylic hexameter	feminine penthemimeral, trithemimeral
ἄεσα καί τ’ἀνέμεινα ἐΰθρονον Ἠῶ δῖαν.	-uu - uu-u u-uu -- --	dactylic hexameter	feminine penthemimeral, trithemimeral
οὐδέ τί μοι ποδάνιπτρα ποδῶν ἐπιήρανα θυμῷ	-u u - uu-u u- uu-uu --	dactylic hexameter	feminine penthemimeral, hepthemimeral, trithemimeral
γίνεται· οὐδὲ γυνὴ ποδὸς ἅψεται ἡμετέροιο	-uu -u u- uu -uu -uu--	dactylic hexameter	masculine penthemimeral
τάων αἵ τοι δῶμα κάτα δρήστειραι ἔασιν,	-- - - -u u- --u u--	dactylic hexameter	feminine penthemimeral, hepthemimeral, trithemimeral
εἰ μή τις γρηῦς ἔστι παλαιή, κέδν’ εἰδυῖα,	- - - - -u u-- - ---	dactylic hexameter	feminine penthemimeral, trithemimeral
ἥ τις δὴ τέτληκε τόσα φρεσὶν ὅσσα τ’ἐγώ περ·	- - - --u u- uu -u u- -	dactylic hexameter	feminine penthemimeral, hepthemimeral, trithemimeral
τῇ δ’οὐκ ἂν φθονέοιμι ποδῶν ἅψασθαι ἐμεῖο.	- - - uu-u u- --u u--	dactylic hexameter	feminine penthemimeral, hepthemimeral, trithemimeral
τὸν δ’αὖτε προσέειπε περίφρων Πηνελόπεια·	- -- uu-u u-- -uu--	dactylic hexameter	feminine penthemimeral, trithemimeral
ξεῖνε φίλ’· οὐ γάρ πώ τις ἀνὴρ πεπνυμένος ὦδε	-u u - - - u u- --uu --	dactylic hexameter	masculine penthemimeral, hepthemimeral, trithemimeral
ξείνων τηλεδαπῶν φιλίων ἐμὸν ἵκετο δῶμα,	-- -uu- uu- uu -uu --	dactylic hexameter	masculine penthemimeral, hepthemimeral
ὡς σὺ μάλ’ εὐφραδέως πεπνυμένα πάντ’ ἀγορεύεις·	- u u -uu- --uu - uu--	dactylic hexameter	masculine penthemimeral
ἔστι δέ μοι γρηῢς πυκινὰ φρεσὶ μήδε’ ἔχουσα	-u u - -- uu- uu -u u--	dactylic hexameter	masculine penthemimeral, hepthemimeral, trithemimeral
ἣ κεῖνον δύστηνον ἐῢ τρέφεν ἠδ’ ἀτίταλλε,	- -- --u u- uu - uu--	dactylic hexameter	feminine penthemimeral, hepthemimeral, trithemimeral
δεξαμένη χείρεσσ’, ὅτε μιν πρῶτον τέκε μήτηρ,	-uu- -- uu - -- uu --	dactylic hexameter	masculine penthemimeral, hepthemimeral, trithemimeral
ἥ σε πόδας νίψει, ὀλιγηπελέουσά περ ἔμπης.	- u u- -- uu-uu-u u --	dactylic hexameter	masculine penthemimeral, trithemimeral
ἀλλ’ ἄγε νῦν ἀνστᾶσα, περίφρων Εὐρύκλεια,	- uu - --u u-- ----	dactylic hexameter	feminine penthemimeral, trithemimeral
νίψον σοῖο ἄνακτος ὁμήλικα· καί που Ὀδυσσεὺς	-- -u u-u u-uu - u u--	dactylic hexameter	feminine penthemimeral
ἤδη τοιόσδ’ ἐστὶ πόδας τοιόσδε τε χεῖρας·	-- -- -u u- --u u --	dactylic hexameter	feminine penthemimeral, hepthemimeral
αἶψα γὰρ ἐν κακότητι βροτοὶ καταγηράσκουσιν.	-u u - uu-u u- uu----	dactylic hexameter	feminine penthemimeral, hepthemimeral, trithemimeral
ὣς ἄρ’ ἔφη, γρηῢς δὲ κατέσχετο χερσὶ πρόσωπα,	- u u- -- u u-uu -u u--	dactylic hexameter	masculine penthemimeral, trithemimeral
δάκρυα δ’ἔκβαλε θερμά, ἔπος δ’ὀλοφυδνὸν ἔειπεν·	-uu -uu -u u- uu-u u--	dactylic hexameter	feminine penthemimeral, hepthemimeral
ὤ μοι ἐγὼ σέο, τέκνον, ἀμήχανος· ἦ σε περὶ Ζεὺς	- u u- uu -u u-uu - u u- -	dactylic hexameter	feminine penthemimeral, trithemimeral
ἀνθρώπων ἤχθηρε θεουδέα θυμὸν ἔχοντα.	--- --u u-uu -u u--	dactylic hexameter	feminine penthemimeral, trithemimeral
οὐ γάρ πώ τις τόσσα βροτῶν Διῒ τερπικεραύνῳ	- - - - -u u- uu -uu--	dactylic hexameter	feminine penthemimeral, hepthemimeral, trithemimeral
πίονα μηρί’ ἔκη’ οὐδ’ ἐξαίτους ἑκατόμβας,	-uu -u u- - --- uu--	dactylic hexameter	masculine penthemimeral
ὅσσα σὺ τῷ ἐδίδους, ἀρώμενος ἕως ἵκοιο	-u u - uu- --uu - ---	dactylic hexameter	masculine penthemimeral, trithemimeral
γῆράς τε λιπαρὸν θρέψαιό τε φαίδιμον υἱόν·	-- - uu- --u u -uu --	dactylic hexameter	masculine penthemimeral, trithemimeral
νῦν δέ τοι οἴῳ πάμπαν ἀφείλετο νόστιμον ἦμαρ.	- u u -- -u u-uu -uu --	dactylic hexameter	feminine penthemimeral
οὕτω που καὶ κείνῳ ἐφεψιόωντο γυναῖκες	-- - - -u u-uu-u u--	dactylic hexameter	feminine penthemimeral, trithemimeral
ξείνων τηλεδαπῶν, ὅτε τευ κλυτὰ δώμαθ’ ἵκοιτο,	-- -uu- uu - uu -u u--	dactylic hexameter	masculine penthemimeral, hepthemimeral
ὡς σέθεν αἱ κύνες αἵδε καθεψιόωνται ἅπασαι,	- uu - uu -u u-uu-u u--	dactylic hexameter	feminine penthemimeral, trithemimeral
τάων νῦν λώβην τε καὶ αἴσχεα πόλλ’ ἀλεείνων	-- - -- u u -uu - uu--	dactylic hexameter	masculine penthemimeral, trithemimeral
οὐκ ἐάᾳς νίζειν· ἐμὲ δ’οὐκ ἀέκουσαν ἄνωγε	- uu- -- uu - uu-u u--	dactylic hexameter	masculine penthemimeral, hepthemimeral, trithemimeral
κούρη Ἰκαρίοιο, περίφρων Πηνελόπεια.	-- -uu-u u-- -uu--	dactylic hexameter	feminine penthemimeral
τῶ σε πόδας νίψω ἅμα τ’αὐτῆς Πηνελοπείης	- u u- -- uu -- -uu--	dactylic hexameter	masculine penthemimeral, trithemimeral
καὶ σέθεν εἵνεκ’, ἐπεί μοι ὀρώρεται ἔνδοθι θυμὸς	- uu -u u- u u-uu -uu --	dactylic hexameter	masculine penthemimeral
κήδεσιν. ἀλλ’ ἄγε νῦν ξυνίει ἔπος, ὅττι κεν εἴπω·	-uu - uu - uu- uu -u u --	dactylic hexameter	masculine penthemimeral, hepthemimeral, trithemimeral
πολλοὶ δὴ ξεῖνοι ταλαπείριοι ἐνθάδ’ ἵκοντο,	-- - -- uu-uu -u u--	dactylic hexameter	masculine penthemimeral, trithemimeral
ἀλλ’ οὔ πώ τινά φημι ἐοικότα ὦδε ἰδέσθαι	- - - uu -u u-uu -u u--	dactylic hexameter	feminine penthemimeral, trithemimeral
ὡς σὺ δέμας φωνήν τε πόδας τ’Ὀδυσῆϊ ἔοικας.	- u u- -- u u- uu-u u--	dactylic hexameter	masculine penthemimeral, hepthemimeral, trithemimeral
τὴν δ’ἀπαμειβόμενος προσέφη πολύμητις Ὀδυσσεύς·	- uu-uu- uu- uu-u u--	dactylic hexameter	masculine penthemimeral, hepthemimeral
ὧ γρηῦ, οὕτω φασὶν ὅσοι ἴδον ὀφθαλμοῖσιν	- - -- -u u- uu ----	dactylic hexameter	feminine penthemimeral, hepthemimeral
ἡμέας ἀμφοτέρους, μάλα εἰκέλω ἀλλήλοιϊν	-uu -uu- uu -uu ----	dactylic hexameter	masculine penthemimeral
ἔμμεναι, ὡς σύ περ αὐτὴ ἐπιφρονέουσ’ ἀγορεύεις.	-uu - u u -u u-uu- uu--	dactylic hexameter	feminine penthemimeral, trithemimeral
ὣς ἄρ’ ἔφη, γρηῢς δὲ λέβηθ’ ἕλε παμφανόωντα	- u u- -- u u- uu -uu--	dactylic hexameter	masculine penthemimeral, hepthemimeral, trithemimeral
τῷ πόδας ἐξαπένιζεν, ὕδωρ δ’ἐνεχεύατο πολλὸν	- uu -uu-u u- uu-uu --	dactylic hexameter	feminine penthemimeral, hepthemimeral
ψυχρόν, ἔπειτα δὲ θερμὸν ἐπήφυσεν. αὐτὰρ Ὀδυσσεὺς	-u u-u u -u u-uu -u u--	dactylic hexameter	feminine penthemimeral
ἷζεν ἀπ’ ἐσχαρόφιν, ποτὶ δὲ σκότον ἐτράπετ’ αἶψα·	-u u -uu- uu - uu -uu --	dactylic hexameter	masculine penthemimeral, hepthemimeral
αὐτίκα γὰρ κατὰ θυμὸν ὀΐσατο, μή ἑ λαβοῦσα	-uu - uu -u u-uu - u u--	dactylic hexameter	feminine penthemimeral, trithemimeral
οὐλὴν ἀμφράσσαιτο καὶ ἀμφαδὰ ἔργα γένοιτο.	-- ---u u -uu -u u--	dactylic hexameter	feminine penthemimeral
νίζε δ’ἄρ’ ἆσσον ἰοῦσα ἄναχθ’ ἑόν· αὐτίκα δ’ἔγνω	-u u -u u-u u- uu -uu --	dactylic hexameter	feminine penthemimeral, hepthemimeral
οὐλήν, τήν ποτέ μιν σῦς ἤλασε λευκῷ ὀδόντι	-- - uu - - -uu -u u--	dactylic hexameter	masculine penthemimeral, trithemimeral
Παρνησόνδ’ ἐλθόντα μετ’ Αὐτόλυκόν τε καὶ υἷας,	--- --u u -uu- u u --	dactylic hexameter	feminine penthemimeral, trithemimeral
μητρὸς ἑῆς πάτερ’ ἐσθλόν, ὃς ἀνθρώπους ἐκέκαστο	-u u- uu -u u --- uu--	dactylic hexameter	feminine penthemimeral, trithemimeral
κλεπτοσύνῃ θ’ὅρκῳ τε· θεὸς δέ οἱ αὐτὸς ἔδωκεν	-uu- -- u u- u u -u u--	dactylic hexameter	masculine penthemimeral, hepthemimeral, trithemimeral
Ἑρμείας· τῷ γὰρ κεχαρισμένα μηρία καῖεν	--- - - uu-uu -uu --	dactylic hexameter	masculine penthemimeral, trithemimeral
ἀρνῶν ἠδ’ ἐρίφων· ὁ δέ οἱ πρόφρων ἅμ’ ὀπήδει.	-- - uu- u u - -- u u--	dactylic hexameter	masculine penthemimeral, hepthemimeral, trithemimeral
Αὐτόλυκος δ’ἐλθὼν Ἰθάκης ἐς πίονα δῆμον	-uu- -- uu- - -uu --	dactylic hexameter	masculine penthemimeral, hepthemimeral, trithemimeral
παῖδα νέον γεγαῶτα κιχήσατο θυγατέρος ἧς·	-u u- uu-u u-uu -uu- -	dactylic hexameter	feminine penthemimeral, trithemimeral
τόν ῥά οἱ Εὐρύκλεια φίλοις ἐπὶ γούνασι θῆκε	- u u ---u u- uu -uu --	dactylic hexameter	feminine penthemimeral, hepthemimeral
παυομένῳ δόρποιο, ἔπος τ’ἔφατ’ ἔκ τ’ὀνόμαζεν·	-uu- --u u- uu - uu--	dactylic hexameter	feminine penthemimeral, hepthemimeral, trithemimeral
Αὐτόλυκ’, αὐτὸς νῦν ὄνομ’ εὕρεο ὅττι κε θεῖο	-uu -- - uu -uu -u u --	dactylic hexameter	masculine penthemimeral
παιδὸς παιδὶ φίλῳ· πολυάρητος δέ τοί ἐστι.	-- -u u- uu--- u u --	dactylic hexameter	masculine penthemimeral
τὴν δ’αὖτ’ Αὐτόλυκος ἀπαμείβετο φώνησέν τε·	- - -uu- uu-uu --- -	dactylic hexameter	masculine penthemimeral
γαμβρὸς ἐμὸς θύγατέρ τε, τίθεσθ’ ὄνομ’ ὅττι κεν εἴπω·	-u u- uu- u u- uu -u u --	dactylic hexameter	masculine penthemimeral, hepthemimeral, trithemimeral
πολλοῖσιν γὰρ ἔγωγε ὀδυσσάμενος τόδ’ ἱκάνω,	--- u u-u u-uu- u u--	dactylic hexameter	feminine penthemimeral, trithemimeral
ἀνδράσιν ἠδὲ γυναιξὶν ἀνὰ χθόνα βωτιάνειραν·	-uu -u u-u u- uu -uu--	dactylic hexameter	feminine penthemimeral, hepthemimeral
τῷ δ’Ὀδυσεὺς ὄνομ’ ἔστω ἐπώνυμον· αὐτὰρ ἔγωγε,	- uu- uu -u u-uu -u u--	dactylic hexameter	feminine penthemimeral, trithemimeral
ὁππότ’ ἂν ἡβήσας μητρώϊον ἐς μέγα δῶμα	-u u --- --uu - uu --	dactylic hexameter	masculine penthemimeral
ἔλθῃ Παρνησόνδ’, ὅθι πού μοι κτήματ’ ἔασι,	-- --- uu - - -u u--	dactylic hexameter	masculine penthemimeral, hepthemimeral
τῶν οἱ ἐγὼ δώσω καί μιν χαίροντ’ ἀποπέμψω.	- u u- -- - - -- uu--	dactylic hexameter	masculine penthemimeral, hepthemimeral, trithemimeral
τῶν ἕνεκ’ ἦλθ’ Ὀδυσεύς, ἵνα οἱ πόροι ἀγλαὰ δῶρα.	- uu - uu- uu - uu -uu --	dactylic hexameter	masculine penthemimeral, hepthemimeral, trithemimeral
τὸν μὲν ἄρ’ Αὐτόλυκός τε καὶ υἱέες Αὐτολύκοιο	- u u -uu- u u -uu -uu--	dactylic hexameter	masculine penthemimeral
χερσίν τ’ἠσπάζοντο ἔπεσσί τε μειλιχίοισι·	-- ---u u-u u -uu--	dactylic hexameter	feminine penthemimeral
μήτηρ δ’Ἀμφιθέη μητρὸς περιφῦσ’ Ὀδυσῆϊ	-- -uu- -- uu- uu--	dactylic hexameter	masculine penthemimeral, hepthemimeral
κύσσ’ ἄρα μιν κεφαλήν τε καὶ ἄμφω φάεα καλά.	- uu - uu- u u -- -uu --	dactylic hexameter	masculine penthemimeral, trithemimeral
Αὐτόλυκος δ’υἱοῖσιν ἐκέκλετο κυδαλίμοισι	-uu- --u u-uu -uu--	dactylic hexameter	feminine penthemimeral, trithemimeral
δεῖπνον ἐφοπλίσσαι· τοὶ δ’ὀτρύνοντος ἄκουσαν,	-u u--- - ---u u--	dactylic hexameter	masculine penthemimeral
αὐτίκα δ’εἰσάγαγον βοῦν ἄρσενα πενταέτηρον·	-uu -uu- - -uu -uu--	dactylic hexameter	masculine penthemimeral
τὸν δέρον ἀμφί θ’ἕπον, καί μιν διέχευαν ἅπαντα,	- uu -u u- - - uu-u u--	dactylic hexameter	masculine penthemimeral, hepthemimeral
μίστυλλόν τ’ἄρ’ ἐπισταμένως πεῖράν τ’ὀβελοῖσιν,	--- u u-uu- -- uu--	dactylic hexameter	hepthemimeral, trithemimeral
ὤπτησάν τε περιφραδέως, ἐρύσαντό τε πάντα.	--- u u-uu- uu-u u --	dactylic hexameter	hepthemimeral, trithemimeral
ὣς τότε μὲν πρόπαν ἦμαρ ἐς ἠέλιον καταδύντα	- uu - uu -u u -uu- uu--	dactylic hexameter	feminine penthemimeral, trithemimeral
δαίνυντ’, οὐδέ τι θυμὸς ἐδεύετο δαιτὸς ἐΐσης·	-- -u u -u u-uu -u u--	dactylic hexameter	feminine penthemimeral
ἦμος δ’ἠέλιος κατέδυ καὶ ἐπὶ κνέφας ἦλθε,	-- -uu- uu- u u- uu --	dactylic hexameter	masculine penthemimeral, hepthemimeral
δὴ τότε κοιμήσαντο καὶ ὕπνου δῶρον ἕλοντο.	- uu ---u u -- -u u--	dactylic hexameter	feminine penthemimeral
ἦμος δ’ἠριγένεια φάνη ῥοδοδάκτυλος Ἠώς,	-- -uu-u u- uu-uu --	dactylic hexameter	feminine penthemimeral, hepthemimeral
βάν ῥ’ἴμεν ἐς θήρην, ἠμὲν κύνες ἠδὲ καὶ αὐτοὶ	- uu - -- -- uu -u u --	dactylic hexameter	masculine penthemimeral, hepthemimeral, trithemimeral
υἱέες Αὐτολύκου· μετὰ τοῖσι δὲ δῖος Ὀδυσσεὺς	-uu -uu- uu -u u -u u--	dactylic hexameter	masculine penthemimeral
ἤϊεν· αἰπὺ δ’ὄρος προσέβαν καταειμένον ὕλῃ	-uu -u u- uu- uu-uu --	dactylic hexameter	masculine penthemimeral, hepthemimeral
Παρνησοῦ, τάχα δ’ἵκανον πτύχας ἠνεμοέσσας.	--- uu --- uu -uu--	dactylic hexameter	hepthemimeral, trithemimeral
Ἠέλιος μὲν ἔπειτα νέον προσέβαλλεν ἀρούρας	-uu- u u-u u- uu-u u--	dactylic hexameter	feminine penthemimeral, hepthemimeral, trithemimeral
ἐξ ἀκαλαρρείταο βαθυρρόου Ὠκεανοῖο,	- uu---u u-uu -uu--	dactylic hexameter	feminine penthemimeral
οἱ δ’ἐς βῆσσαν ἵκανον ἐπακτῆρες· πρὸ δ’ἄρ’ αὐτῶν	- - -u u-u u--- u u --	dactylic hexameter	feminine penthemimeral
ἴχνι’ ἐρευνῶντες κύνες ἤϊσαν, αὐτὰρ ὄπισθεν	-u u--- uu -uu -u u--	dactylic hexameter	masculine penthemimeral
υἱέες Αὐτολύκου· μετὰ τοῖσι δὲ δῖος Ὀδυσσεὺς	-uu -uu- uu -u u -u u--	dactylic hexameter	masculine penthemimeral
ἤϊεν ἄγχι κυνῶν, κραδάων δολιχόσκιον ἔγχος.	-uu -u u- uu- uu-uu --	dactylic hexameter	masculine penthemimeral, hepthemimeral
ἔνθα δ’ἄρ’ ἐν λόχμῃ πυκινῇ κατέκειτο μέγας σῦς·	-u u - -- uu- uu-u u- -	dactylic hexameter	masculine penthemimeral, hepthemimeral, trithemimeral
τὴν μὲν ἄρ’ οὔτ’ ἀνέμων διάη μένος ὑγρὸν ἀέντων,	- u u - uu- uu- uu -u u--	dactylic hexameter	masculine penthemimeral, hepthemimeral, trithemimeral
οὔτε μιν Ἠέλιος φαέθων ἀκτῖσιν ἔβαλλεν,	-u u -uu- uu- --u u--	dactylic hexameter	masculine penthemimeral, hepthemimeral
οὔτ’ ὄμβρος περάασκε διαμπερές· ὣς ἄρα πυκνὴ	- -- uu-u u-uu - uu --	dactylic hexameter	feminine penthemimeral, trithemimeral
ἦεν, ἀτὰρ φύλλων ἐνέην χύσις ἤλιθα πολλή.	-u u- -- uu- uu -uu --	dactylic hexameter	masculine penthemimeral, hepthemimeral, trithemimeral
τὸν δ’ἀνδρῶν τε κυνῶν τε περὶ κτύπος ἦλθε ποδοῖϊν,	- -- u u- u u- uu -u u--	dactylic hexameter	masculine penthemimeral, hepthemimeral, trithemimeral
ὡς ἐπάγοντες ἐπῇσαν· ὁ δ’ἀντίος ἐκ ξυλόχοιο	- uu-u u-u u -uu - uu--	dactylic hexameter	feminine penthemimeral
φρίξας εὖ λοφιήν, πῦρ δ’ὀφθαλμοῖσι δεδορκώς,	-- - uu- - ---u u--	dactylic hexameter	masculine penthemimeral, trithemimeral
στῆ ῥ’αὐτῶν σχεδόθεν· ὁ δ’ἄρα πρώτιστος Ὀδυσσεὺς	- -- uu- u u- --u u--	dactylic hexameter	masculine penthemimeral, hepthemimeral, trithemimeral
ἔσσυτ’ ἀνασχόμενος δολιχὸν δόρυ χειρὶ παχείῃ,	-u u-uu- uu- uu -u u--	dactylic hexameter	masculine penthemimeral, hepthemimeral
οὐτάμεναι μεμαώς· ὁ δέ μιν φθάμενος ἔλασεν σῦς	-uu- uu- u u - uu- uu- -	dactylic hexameter	masculine penthemimeral, hepthemimeral, trithemimeral
γουνὸς ὕπερ, πολλὸν δὲ διήφυσε σαρκὸς ὀδόντι	-u u- -- u u-uu -u u--	dactylic hexameter	masculine penthemimeral, trithemimeral
λικριφὶς ἀΐξας, οὐδ’ ὀστέον ἵκετο φωτός.	-uu --- - -uu -uu --	dactylic hexameter	masculine penthemimeral
τὸν δ’Ὀδυσεὺς οὔτησε τυχὼν κατὰ δεξιὸν ὧμον,	- uu- --u u- uu -uu --	dactylic hexameter	feminine penthemimeral, hepthemimeral, trithemimeral
ἀντικρὺ δὲ διῆλθε φαεινοῦ δουρὸς ἀκωκή·	--- u u-u u-- -u u--	dactylic hexameter	feminine penthemimeral, trithemimeral
κὰδ δ’ἔπεσ’ ἐν κονίῃσι μακών, ἀπὸ δ’ἔπτατο θυμός.	- uu - uu-u u- uu -uu --	dactylic hexameter	feminine penthemimeral, hepthemimeral, trithemimeral
τὸν μὲν ἄρ’ Αὐτολύκου παῖδες φίλοι ἀμφεπένοντο,	- u u -uu- -- uu -uu--	dactylic hexameter	masculine penthemimeral, hepthemimeral
ὠτειλὴν δ’Ὀδυσῆος ἀμύμονος ἀντιθέοιο	--- uu-u u-uu -uu--	dactylic hexameter	feminine penthemimeral, trithemimeral
δῆσαν ἐπισταμένως, ἐπαοιδῇ δ’αἷμα κελαινὸν	-u u-uu- uu-- -u u--	dactylic hexameter	masculine penthemimeral
ἔσχεθον, αἶψα δ’ἵκοντο φίλου πρὸς δώματα πατρός.	-uu -u u-u u- - -uu --	dactylic hexameter	feminine penthemimeral, hepthemimeral
τὸν μὲν ἄρ’ Αὐτόλυκός τε καὶ υἱέες Αὐτολύκοιο	- u u -uu- u u -uu -uu--	dactylic hexameter	masculine penthemimeral
εὖ ἰησάμενοι ἠδ’ ἀγλαὰ δῶρα πορόντες	- --uu- - -uu -u u--	dactylic hexameter	masculine penthemimeral
καρπαλίμως χαίροντα φίλως χαίροντες ἔπεμπον	-uu- --u u- --u u--	dactylic hexameter	feminine penthemimeral, hepthemimeral, trithemimeral
εἰς Ἰθάκην. τῷ μέν ῥα πατὴρ καὶ πότνια μήτηρ	- uu- - - u u- - -uu --	dactylic hexameter	masculine penthemimeral, hepthemimeral, trithemimeral
χαῖρον νοστήσαντι καὶ ἐξερέεινον ἕκαστα,	-- ---u u -uu-u u--	dactylic hexameter	feminine penthemimeral
οὐλὴν ὅττι πάθοι· ὁ δ’ἄρα σφίσιν εὖ κατέλεξεν	-- -u u- u u- uu - uu--	dactylic hexameter	masculine penthemimeral, hepthemimeral
ὥς μιν θηρεύοντ’ ἔλασεν σῦς λευκῷ ὀδόντι,	- - --- uu- - -u u--	dactylic hexameter	masculine penthemimeral, hepthemimeral
Παρνησόνδ’ ἐλθόντα σὺν υἱάσιν Αὐτολύκοιο.	--- --u u -uu -uu--	dactylic hexameter	feminine penthemimeral, trithemimeral
τὴν γρηῢς χείρεσσι καταπρηνέσσι λαβοῦσα	- -- --u u---u u--	dactylic hexameter	feminine penthemimeral, trithemimeral
γνῶ ῥ’ἐπιμασσαμένη, πόδα δὲ προέηκε φέρεσθαι·	- uu-uu- uu - uu-u u--	dactylic hexameter	masculine penthemimeral, hepthemimeral
ἐν δὲ λέβητι πέσε κνήμη, κανάχησε δὲ χαλκός,	- u u-u u- -- uu-u u --	dactylic hexameter	masculine penthemimeral, hepthemimeral
ἂψ δ’ἑτέρωσ’ ἐκλίθη· τὸ δ’ἐπὶ χθονὸς ἐξέχυθ’ ὕδωρ.	- uu- uu- u u- uu -uu --	dactylic hexameter	masculine penthemimeral, hepthemimeral, trithemimeral
τὴν δ’ἅμα χάρμα καὶ ἄλγος ἕλε φρένα, τὼ δέ οἱ ὄσσε	- uu -u u -u u- uu - u u --	dactylic hexameter	feminine penthemimeral, hepthemimeral
δακρυόφιν πλῆσθεν, θαλερὴ δέ οἱ ἔσχετο φωνή.	-uu- -- uu- u u -uu --	dactylic hexameter	masculine penthemimeral, hepthemimeral, trithemimeral
ἁψαμένη δὲ γενείου Ὀδυσσῆα προσέειπεν·	-uu- u u-u u--- uu--	dactylic hexameter	feminine penthemimeral, trithemimeral
ἦ μάλ’ Ὀδυσσεύς ἐσσι, φίλον τέκος· οὐδέ σ’ἔγωγε	- u u-- -u u- uu -u u--	dactylic hexameter	feminine penthemimeral, hepthemimeral
πρὶν ἔγνων, πρὶν πάντα ἄνακτ’ ἐμὸν ἀμφαφάασθαι.	- -- - -u u- uu -uu--	dactylic hexameter	feminine penthemimeral, hepthemimeral, trithemimeral
ἦ καὶ Πηνελόπειαν ἐσέδρακεν ὀφθαλμοῖσι,	- - -uu-u u-uu ----	dactylic hexameter	feminine penthemimeral
πεφραδέειν ἐθέλουσα φίλον πόσιν ἔνδον ἐόντα.	-uu- uu-u u- uu -u u--	dactylic hexameter	feminine penthemimeral, hepthemimeral, trithemimeral
ἡ δ’οὔτ’ ἀθρῆσαι δύνατ’ ἀντίη οὔτε νοῆσαι·	- - --- uu -uu -u u--	dactylic hexameter	masculine penthemimeral
τῇ γὰρ Ἀθηναίη νόον ἔτραπεν· αὐτὰρ Ὀδυσσεὺς	- u u--- uu -uu -u u--	dactylic hexameter	masculine penthemimeral
χεῖρ’ ἐπιμασσάμενος φάρυγος λάβε δεξιτερῆφι,	- uu-uu- uu- uu -uu--	dactylic hexameter	masculine penthemimeral, hepthemimeral
τῇ δ’ἑτέρῃ ἕθεν ἆσσον ἐρύσσατο φώνησέν τε.	- uu- uu -u u-uu --- -	dactylic hexameter	feminine penthemimeral, trithemimeral
μαῖα, τίη μ’ἐθέλεις ὀλέσαι; σὺ δέ μ’ἔτρεφες αὐτὴ	-u u- uu- uu- u u -uu --	dactylic hexameter	masculine penthemimeral, hepthemimeral, trithemimeral
τῷ σῷ ἐπὶ μαζῷ· νῦν δ’ἄλγεα πολλὰ μογήσας	- u u- -- - -uu -u u--	dactylic hexameter	masculine penthemimeral, trithemimeral
ἤλυθον εἰκοστῷ ἔτεϊ ἐς πατρίδα γαῖαν.	-uu --- uu- - -uu --	dactylic hexameter	masculine penthemimeral, hepthemimeral
ἀλλ’ ἐπεὶ ἐφράσθης καί τοι θεὸς ἔμβαλε θυμῷ,	- uu --- - - uu -uu --	dactylic hexameter	masculine penthemimeral, hepthemimeral
σίγα, μή τίς τ’ἄλλος ἐνὶ μεγάροισι πύθηται.	-- - - -u u- uu-u u--	dactylic hexameter	feminine penthemimeral, hepthemimeral, trithemimeral
ὦδε γὰρ ἐξερέω, καὶ μὴν τετελεσμένον ἔσται·	-u u -uu- - - uu-uu --	dactylic hexameter	masculine penthemimeral, hepthemimeral
εἴ χ’ὑπ’ ἐμοί γε θεὸς δαμάσῃ μνηστῆρας ἀγαυούς,	- u u- u u- uu- --u u--	dactylic hexameter	masculine penthemimeral, hepthemimeral, trithemimeral
οὐδὲ τροφοῦ οὔσης σεῦ ἀφέξομαι, ὁππότ’ ἂν ἄλλας	-u u- -- u u-uu -u u --	dactylic hexameter	masculine penthemimeral, trithemimeral
δμῳὰς ἐν μεγάροισιν ἐμοῖς κτείνωμι γυναῖκας.	-- - uu-u u- --u u--	dactylic hexameter	feminine penthemimeral, hepthemimeral, trithemimeral
τὸν δ’αὖτε προσέειπε περίφρων Εὐρύκλεια·	- -- uu-u u-- ----	dactylic hexameter	feminine penthemimeral, trithemimeral
τέκνον ἐμόν, ποῖόν σε ἔπος φύγεν ἕρκος ὀδόντων.	-u u- -- u u- uu -u u--	dactylic hexameter	masculine penthemimeral, hepthemimeral, trithemimeral
οἶσθα μὲν οἷον ἐμὸν μένος ἔμπεδον οὐδ’ ἐπιεικτόν,	-u u -u u- uu -uu - uu--	dactylic hexameter	masculine penthemimeral
ἕξω δ’ὡς ὅτε τις στερεὴ λίθος ἠὲ σίδηρος.	-- - uu - uu- uu -u u--	dactylic hexameter	masculine penthemimeral, hepthemimeral, trithemimeral
ἄλλο δέ τοι ἐρέω, σὺ δ’ἐνὶ φρεσὶ βάλλεο σῇσιν·	-u u - uu- u u- uu -uu --	dactylic hexameter	masculine penthemimeral, hepthemimeral, trithemimeral
εἴ χ’ὑπό σοι γε θεὸς δαμάσῃ μνηστῆρας ἀγαυούς,	- uu - u u- uu- --u u--	dactylic hexameter	masculine penthemimeral, hepthemimeral, trithemimeral
δὴ τότε τοι καταλέξω ἐνὶ μεγάροισι γυναῖκας,	- uu - uu-u u- uu-u u--	dactylic hexameter	feminine penthemimeral, hepthemimeral, trithemimeral
αἵ τέ σ’ἀτιμάζουσι καὶ αἳ νηλίτιδές εἰσι.	- u u---u u - --uu --	dactylic hexameter	feminine penthemimeral, hepthemimeral
τὴν δ’ἀπαμειβόμενος προσέφη πολύμητις Ὀδυσσεύς·	- uu-uu- uu- uu-u u--	dactylic hexameter	masculine penthemimeral, hepthemimeral
μαῖα, τίη δὲ σὺ τὰς μυθήσεαι; οὐδέ τί σε χρή.	-u u- u u - --uu -u u - -	dactylic hexameter	masculine penthemimeral, trithemimeral
εὖ νυ καὶ αὐτὸς ἐγὼ φράσομαι καὶ εἴσομ’ ἑκάστην·	- u u -u u- uu- - -u u--	dactylic hexameter	masculine penthemimeral, hepthemimeral
ἀλλ’ ἔχε σιγῇ μῦθον, ἐπίτρεψον δὲ θεοῖσιν.	- uu -- -u u--- u u--	dactylic hexameter	feminine penthemimeral
ὣς ἄρ’ ἔφη, γρηῢς δὲ διὲκ μεγάροιο βεβήκει	- u u- -- u u- uu-u u--	dactylic hexameter	masculine penthemimeral, hepthemimeral, trithemimeral
οἰσομένη ποδάνιπτρα· τὰ γὰρ πρότερ’ ἔκχυτο πάντα.	-uu- uu-u u - uu -uu --	dactylic hexameter	feminine penthemimeral, hepthemimeral, trithemimeral
αὐτὰρ ἐπεὶ νίψεν τε καὶ ἤλειψεν λίπ’ ἐλαίῳ,	-u u- -- u u --- u u--	dactylic hexameter	masculine penthemimeral, trithemimeral
αὖτις ἄρ’ ἀσσοτέρω πυρὸς ἕλκετο δίφρον Ὀδυσσεὺς	-u u -uu- uu -uu -u u--	dactylic hexameter	masculine penthemimeral
θερσόμενος, οὐλὴν δὲ κατὰ ῥακέεσσι κάλυψε.	-uu- -- u u- uu-u u--	dactylic hexameter	masculine penthemimeral, hepthemimeral, trithemimeral
τοῖσι δὲ μύθων ἦρχε περίφρων Πηνελόπεια·	-u u -- -u u-- -uu--	dactylic hexameter	feminine penthemimeral
ξεῖνε, τὸ μέν σ’ἔτι τυτθὸν ἐγὼν εἰρήσομαι αὐτή·	-u u - uu -u u- --uu --	dactylic hexameter	feminine penthemimeral, hepthemimeral, trithemimeral
καὶ γὰρ δὴ κοίτοιο τάχ’ ἔσσεται ἡδέος ὥρη,	- - - --u u -uu -uu --	dactylic hexameter	feminine penthemimeral, trithemimeral
ὅν τινά γ’ὕπνος ἕλῃ γλυκερός, καὶ κηδόμενόν περ.	- uu -u u- uu- - -uu- -	dactylic hexameter	masculine penthemimeral, hepthemimeral
αὐτὰρ ἐμοὶ καὶ πένθος ἀμέτρητον πόρε δαίμων·	-u u- - -u u--- uu --	dactylic hexameter	feminine penthemimeral, trithemimeral
ἤματα μὲν γὰρ τέρπομ’ ὀδυρομένη, γοόωσα,	-uu - - -u u-uu- uu--	dactylic hexameter	feminine penthemimeral, trithemimeral
ἔς τ’ἐμὰ ἔργ’ ὁρόωσα καὶ ἀμφιπόλων ἐνὶ οἴκῳ·	- uu - uu-u u -uu- uu --	dactylic hexameter	feminine penthemimeral, trithemimeral
αὐτὰρ ἐπὴν νὺξ ἔλθῃ, ἕλῃσί τε κοῖτος ἅπαντας,	-u u- - -u u-u u -u u--	dactylic hexameter	feminine penthemimeral, trithemimeral
κεῖμαι ἐνὶ λέκτρῳ, πυκιναὶ δέ μοι ἀμφ’ ἀδινὸν κῆρ	-u u- -- uu- u u - uu- -	dactylic hexameter	masculine penthemimeral, hepthemimeral, trithemimeral
ὀξεῖαι μελεδῶναι ὀδυρομένην ἐρέθουσιν.	--- uu-u u-uu- uu--	dactylic hexameter	feminine penthemimeral, trithemimeral
ὡς δ’ὅτε Πανδαρέου κούρη, χλωρηῒς ἀηδών,	- uu -uu- -- --u u--	dactylic hexameter	masculine penthemimeral, hepthemimeral
καλὸν ἀείδῃσιν ἔαρος νέον ἱσταμένοιο,	-u u--- uu- uu -uu--	dactylic hexameter	masculine penthemimeral, hepthemimeral
δενδρέων ἐν πετάλοισι καθεζομένη πυκινοῖσιν,	-- - uu-u u-uu- uu--	dactylic hexameter	feminine penthemimeral, trithemimeral
ἥ τε θαμὰ τρωπῶσα χέει πολυηχέα φωνήν,	- u u- --u u- uu-uu --	dactylic hexameter	feminine penthemimeral, hepthemimeral, trithemimeral
παῖδ’ ὀλοφυρομένη Ἴτυλον φίλον, ὅν ποτε χαλκῷ	- uu-uu- uu- uu - uu --	dactylic hexameter	masculine penthemimeral, hepthemimeral
κτεῖνε δι’ ἀφραδίας, κοῦρον Ζήθοιο ἄνακτος,	-u u -uu- -- --u u--	dactylic hexameter	masculine penthemimeral, hepthemimeral
ὣς καὶ ἐμοὶ δίχα θυμὸς ὀρώρεται ἔνθα καὶ ἔνθα,	- u u- uu -u u-uu -u u --	dactylic hexameter	feminine penthemimeral, trithemimeral
ἠὲ μένω παρὰ παιδὶ καὶ ἔμπεδα πάντα φυλάσσω,	-u u- uu -u u -uu -u u--	dactylic hexameter	feminine penthemimeral, trithemimeral
κτῆσιν ἐμήν, δμῷάς τε καὶ ὑψερεφὲς μέγα δῶμα,	-u u- -- u u -uu- uu --	dactylic hexameter	masculine penthemimeral, trithemimeral
εὐνήν τ’αἰδομένη πόσιος δήμοιό τε φῆμιν,	-- -uu- uu- --u u --	dactylic hexameter	masculine penthemimeral, hepthemimeral
ἦ ἤδη ἅμ’ ἕπωμαι Ἀχαιῶν ὅς τις ἄριστος	- -- u u-u u-- - u u--	dactylic hexameter	feminine penthemimeral, trithemimeral
μνᾶται ἐνὶ μεγάροισι, πορὼν ἀπερείσια ἕδνα.	-u u- uu-u u- uu-uu --	dactylic hexameter	feminine penthemimeral, hepthemimeral, trithemimeral
παῖς δ’ἐμὸς ἕως μὲν ἔην ἔτι νήπιος ἠδὲ χαλίφρων,	- uu - u u- uu -uu -u u--	dactylic hexameter	masculine penthemimeral, trithemimeral
γήμασθ’ οὔ μ’εἴα πόσιος κατὰ δῶμα λιποῦσαν·	-- - -- uu- uu -u u--	dactylic hexameter	masculine penthemimeral, hepthemimeral, trithemimeral
νῦν δ’ὅτε δὴ μέγας ἐστὶ καὶ ἥβης μέτρον ἱκάνει,	- uu - uu -u u -- -u u--	dactylic hexameter	feminine penthemimeral, trithemimeral
καὶ δή μ’ἀρᾶται πάλιν ἐλθέμεν ἐκ μεγάροιο,	- - --- uu -uu - uu--	dactylic hexameter	masculine penthemimeral
κτήσιος ἀσχαλόων, τήν οἱ κατέδουσιν Ἀχαιοί.	-uu -uu- - - uu-u u--	dactylic hexameter	masculine penthemimeral, hepthemimeral
ἀλλ’ ἄγε μοι τὸν ὄνειρον ὑπόκριναι καὶ ἄκουσον.	- uu - u u-u u--- u u--	dactylic hexameter	feminine penthemimeral, trithemimeral
χῆνές μοι κατὰ οἶκον ἐείκοσι πυρὸν ἔδουσιν	-- - uu -u u-uu -u u--	dactylic hexameter	feminine penthemimeral, trithemimeral
ἐξ ὕδατος, καί τέ σφιν ἰαίνομαι εἰσορόωσα·	- uu- - - u u-uu -uu--	dactylic hexameter	masculine penthemimeral, trithemimeral
ἐλθὼν δ’ἐξ ὄρεος μέγας αἰετὸς ἀγκυλοχείλης	-- - uu- uu -uu -uu--	dactylic hexameter	masculine penthemimeral, trithemimeral
πᾶσι κατ’ αὐχένας ἦξε καὶ ἔκτανεν· οἱ δ’ἐκέχυντο	-u u -uu -u u -uu - uu--	dactylic hexameter	feminine penthemimeral
ἀθρόοι ἐν μεγάροις, ὁ δ’ἐς αἰθέρα δῖαν ἀέρθη.	-uu - uu- u u -uu -u u--	dactylic hexameter	masculine penthemimeral, trithemimeral
αὐτὰρ ἐγὼ κλαῖον καὶ ἐκώκυον ἔν περ ὀνείρῳ,	-u u- -- u u-uu - u u--	dactylic hexameter	masculine penthemimeral, trithemimeral
ἀμφὶ δέ μ’ἠγερέθοντο ἐϋπλοκαμῖδες Ἀχαιαί,	-u u -uu-u u-uu-u u--	dactylic hexameter	feminine penthemimeral
οἴκτρ’ ὀλοφυρομένην ὅ μοι αἰετὸς ἔκτανε χῆνας.	- uu-uu- u u -uu -uu --	dactylic hexameter	masculine penthemimeral
ἂψ δ’ἐλθὼν κατ’ ἄρ’ ἕζετ’ ἐπὶ προὔχοντι μελάθρῳ,	- -- u u -u u- --u u--	dactylic hexameter	feminine penthemimeral, hepthemimeral, trithemimeral
φωνῇ δὲ βροτέῃ κατερήτυε φώνησέν τε·	-- - uu- uu-uu --- -	dactylic hexameter	masculine penthemimeral, trithemimeral
θάρσει, Ἰκαρίου κούρη τηλεκλειτοῖο·	-- -uu- -- -----	dactylic hexameter	masculine penthemimeral, hepthemimeral
οὐκ ὄναρ, ἀλλ’ ὕπαρ ἐσθλόν, ὅ τοι τετελεσμένον ἔσται.	- uu - uu -u u - uu-uu --	dactylic hexameter	feminine penthemimeral, hepthemimeral, trithemimeral
χῆνες μὲν μνηστῆρες, ἐγὼ δέ τοι αἰετὸς ὄρνις	-- - --u u- u u -uu --	dactylic hexameter	feminine penthemimeral, hepthemimeral, trithemimeral
ἦα πάρος, νῦν αὖτε τεὸς πόσις εἰλήλουθα,	-u u- - -u u- uu ----	dactylic hexameter	feminine penthemimeral, hepthemimeral, trithemimeral
ὃς πᾶσι μνηστῆρσιν ἀεικέα πότμον ἐφήσω.	- -- --u u-uu -u u--	dactylic hexameter	feminine penthemimeral, trithemimeral
ὣς ἔφατ’, αὐτὰρ ἐμὲ μελιηδὴς ὕπνος ἀνῆκε·	- uu -u u- uu-- -u u--	dactylic hexameter	masculine penthemimeral
παπτήνασα δὲ χῆνας ἐνὶ μεγάροις ἐνόησα	---u u -u u- uu- uu--	dactylic hexameter	feminine penthemimeral, hepthemimeral
πυρὸν ἐρεπτομένους παρὰ πύελον, ἧχι πάρος περ.	-u u-uu- uu -uu -u u- -	dactylic hexameter	masculine penthemimeral
τὴν δ’ἀπαμειβόμενος προσέφη πολύμητις Ὀδυσσεύς·	- uu-uu- uu- uu-u u--	dactylic hexameter	masculine penthemimeral, hepthemimeral
ὧ γύναι, οὔ πως ἔστιν ὑποκρίνασθαι ὄνειρον	- uu - - -u u---u u--	dactylic hexameter	feminine penthemimeral, trithemimeral
ἄλλῃ ἀποκλίναντ’, ἐπεὶ ἦ ῥά τοι αὐτὸς Ὀδυσσεὺς	-u u--- uu - u u -u u--	dactylic hexameter	masculine penthemimeral, hepthemimeral
πέφραδ’ ὅπως τελέει· μνηστῆρσι δὲ φαίνετ’ ὄλεθρος	-u u- uu- --u u -u u--	dactylic hexameter	masculine penthemimeral, trithemimeral
πᾶσι μάλ’, οὐδέ κέ τις θάνατον καὶ κῆρας ἀλύξει.	-u u -u u - uu- - -u u--	dactylic hexameter	masculine penthemimeral, hepthemimeral
τὸν δ’αὖτε προσέειπε περίφρων Πηνελόπεια·	- -- uu-u u-- -uu--	dactylic hexameter	feminine penthemimeral, trithemimeral
ξεῖν’, ἤτοι μὲν ὄνειροι ἀμήχανοι ἀκριτόμυθοι	- -- u u-u u-uu -uu--	dactylic hexameter	feminine penthemimeral, trithemimeral
γίνοντ’, οὐδέ τι πάντα τελείεται ἀνθρώποισι.	-- -u u -u u-uu ----	dactylic hexameter	feminine penthemimeral
δοιαὶ γάρ τε πύλαι ἀμενηνῶν εἰσὶν ὀνείρων·	-- - u u- uu-- -u u--	dactylic hexameter	masculine penthemimeral, trithemimeral
αἱ μὲν γὰρ κεράεσσι τετεύχαται, αἱ δ’ἐλέφαντι·	- - - uu-u u-uu - uu--	dactylic hexameter	feminine penthemimeral, trithemimeral
τῶν οἳ μέν κ’ἔλθωσι διὰ πριστοῦ ἐλέφαντος,	- - - --u u- -- uu--	dactylic hexameter	feminine penthemimeral, hepthemimeral, trithemimeral
οἵ ῥ’ἐλεφαίρονται, ἔπε’ ἀκράαντα φέροντες·	- uu--- uu ---u u--	dactylic hexameter	masculine penthemimeral
οἱ δὲ διὰ ξεστῶν κεράων ἔλθωσι θύραζε,	- u u- -- uu- --u u--	dactylic hexameter	masculine penthemimeral, hepthemimeral, trithemimeral
οἵ ῥ’ἔτυμα κραίνουσι, βροτῶν ὅτε κέν τις ἴδηται.	- uu- --u u- uu - u u--	dactylic hexameter	feminine penthemimeral, hepthemimeral, trithemimeral
ἀλλ’ ἐμοὶ οὐκ ἐντεῦθεν ὀΐομαι αἰνὸν ὄνειρον	- uu - --u u-uu -u u--	dactylic hexameter	feminine penthemimeral, trithemimeral
ἐλθέμεν· ἦ κ’ἀσπαστὸν ἐμοὶ καὶ παιδὶ γένοιτο.	-uu - --u u- - -u u--	dactylic hexameter	feminine penthemimeral, hepthemimeral, trithemimeral
ἄλλο δέ τοι ἐρέω, σὺ δ’ἐνὶ φρεσὶ βάλλεο σῇσιν·	-u u - uu- u u- uu -uu --	dactylic hexameter	masculine penthemimeral, hepthemimeral, trithemimeral
ἥδε δὴ ἠὼς εἶσι δυσώνυμος, ἥ μ’Ὀδυσῆος	-u u -- -u u-uu - uu--	dactylic hexameter	feminine penthemimeral
οἴκου ἀποσχήσει· νῦν γὰρ καταθήσω ἄεθλον,	-u u--- - - uu-u u--	dactylic hexameter	masculine penthemimeral, hepthemimeral
τοὺς πελέκεας, τοὺς κεῖνος ἐνὶ μεγάροισιν ἑοῖσιν	- uu- - -u u- uu-u u--	dactylic hexameter	feminine penthemimeral, hepthemimeral, trithemimeral
ἵστασχ’ ἑξείης, δρυόχους ὥς, δώδεκα πάντας·	-- --- uu- - -uu --	dactylic hexameter	masculine penthemimeral, hepthemimeral
στὰς δ’ὅ γε πολλὸν ἄνευθε διαρρίπτασκεν ὀϊστόν.	- u u -u u-u u---u u--	dactylic hexameter	feminine penthemimeral
νῦν δὲ μνηστήρεσσιν ἄεθλον τοῦτον ἐφήσω·	- - ---u u-- -u u--	dactylic hexameter	feminine penthemimeral
ὃς δέ κε ῥηΐτατ’ ἐντανύσῃ βιὸν ἐν παλάμῃσι	- u u -uu -uu- uu - uu--	dactylic hexameter	hepthemimeral
καὶ διοϊστεύσῃ πελέκεων δυοκαίδεκα πάντων,	- uu--- uu- uu-uu --	dactylic hexameter	masculine penthemimeral, hepthemimeral
τῷ κεν ἅμ’ ἑσποίμην, νοσφισσαμένη τόδε δῶμα	- u u --- --uu- uu --	dactylic hexameter	masculine penthemimeral
κουρίδιον, μάλα καλόν, ἐνίπλειον βιότοιο·	-uu- uu -u u--- uu--	dactylic hexameter	feminine penthemimeral, trithemimeral
τοῦ ποτὲ μεμνήσεσθαι ὀΐομαι ἔν περ ὀνείρῳ.	- uu ---u u-uu - u u--	dactylic hexameter	feminine penthemimeral
τὴν δ’ἀπαμειβόμενος προσέφη πολύμητις Ὀδυσσεύς·	- uu-uu- uu- uu-u u--	dactylic hexameter	masculine penthemimeral, hepthemimeral
ὧ γύναι αἰδοίη Λαερτιάδεω Ὀδυσῆος,	- uu --- --uu- uu--	dactylic hexameter	masculine penthemimeral
μηκέτι νῦν ἀνάβαλλε δόμοις ἔνι τοῦτον ἄεθλον·	-uu - uu-u u- uu -u u--	dactylic hexameter	feminine penthemimeral, hepthemimeral, trithemimeral
πρὶν γάρ τοι πολύμητις ἐλεύσεται ἐνθάδ’ Ὀδυσσεύς,	- - - uu-u u-uu -u u--	dactylic hexameter	feminine penthemimeral, trithemimeral
πρὶν τούτους τόδε τόξον ἐΰξοον ἀμφαφόωντας	- -- uu -u u-uu -uu--	dactylic hexameter	feminine penthemimeral, trithemimeral
νευρήν τ’ἐντανύσαι διοϊστεῦσαί τε σιδήρου.	-- -uu- uu--- u u--	dactylic hexameter	masculine penthemimeral
τὸν δ’αὖτε προσέειπε περίφρων Πηνελόπεια·	- -- uu-u u-- -uu--	dactylic hexameter	feminine penthemimeral, trithemimeral
εἴ κ’ἐθέλοις μοι, ξεῖνε, παρήμενος ἐν μεγάροισι	- uu- - -u u-uu - uu--	dactylic hexameter	feminine penthemimeral, trithemimeral
τέρπειν, οὔ κέ μοι ὕπνος ἐπὶ βλεφάροισι χυθείη.	-- - u u -u u- uu-u u--	dactylic hexameter	feminine penthemimeral, hepthemimeral, trithemimeral
ἀλλ’ οὐ γάρ πως ἔστιν ἀΰπνους ἔμμεναι αἰὲν	- - - - -u u-- -uu --	dactylic hexameter	feminine penthemimeral, trithemimeral
ἀνθρώπους· ἐπὶ γάρ τοι ἑκάστῳ μοῖραν ἔθηκαν	--- uu - u u-- -u u--	dactylic hexameter	masculine penthemimeral, trithemimeral
ἀθάνατοι θνητοῖσιν ἐπὶ ζείδωρον ἄρουραν.	-uu- --u u- --u u--	dactylic hexameter	feminine penthemimeral, hepthemimeral, trithemimeral
ἀλλ’ ἤτοι μὲν ἐγὼν ὑπερώϊον εἰσαναβᾶσα	- -- u u- uu-uu -uu--	dactylic hexameter	masculine penthemimeral, trithemimeral
λέξομαι εἰς εὐνήν, ἥ μοι στονόεσσα τέτυκται,	-uu - -- - - uu-u u--	dactylic hexameter	masculine penthemimeral, hepthemimeral, trithemimeral
αἰεὶ δάκρυσ’ ἐμοῖσι πεφυρμένη, ἐξ οὗ Ὀδυσσεὺς	-- -u u-u u-uu - u u--	dactylic hexameter	feminine penthemimeral
ᾤχετ’ ἐποψόμενος Κακοΐλιον οὐκ ὀνομαστήν.	-u u-uu- uu-uu - uu--	dactylic hexameter	masculine penthemimeral
ἔνθα κε λεξαίμην· σὺ δὲ λέξεο τῷδ’ ἐνὶ οἴκῳ,	-u u --- u u -uu - uu --	dactylic hexameter	masculine penthemimeral
ἢ χαμάδις στορέσας ἤ τοι κατὰ δέμνια θέντων.	- uu- uu- - - uu -uu --	dactylic hexameter	masculine penthemimeral, hepthemimeral, trithemimeral
ὣς εἰποῦσ’ ἀνέβαιν’ ὑπερώϊα σιγαλόεντα,	- -- uu- uu-uu -uu--	dactylic hexameter	masculine penthemimeral, trithemimeral
οὐκ οἴη, ἅμα τῇ γε καὶ ἀμφίπολοι κίον ἄλλαι.	- -- uu - u u -uu- uu --	dactylic hexameter	masculine penthemimeral, trithemimeral
ἐς δ’ὑπερῷ’ ἀναβᾶσα σὺν ἀμφιπόλοισι γυναιξὶ	- uu- uu-u u -uu-u u--	dactylic hexameter	feminine penthemimeral, trithemimeral
κλαῖεν ἔπειτ’ Ὀδυσῆα, φίλον πόσιν, ὄφρα οἱ ὕπνον	-u u- uu-u u- uu -u u --	dactylic hexameter	feminine penthemimeral, hepthemimeral, trithemimeral
ἡδὺν ἐπὶ βλεφάροισι βάλε γλαυκῶπις Ἀθήνη.	-u u- uu-u u- --u u--	dactylic hexameter	feminine penthemimeral, hepthemimeral, trithemimeral
