ὧς ὁ μὲν ἔνθ’ ἠρᾶτο πολύτλας δῖος Ὀδυσσεύς,	- u u - --u u-- -u u--	dactylic hexameter	feminine penthemimeral, trithemimeral
κούρην δὲ προτὶ ἄστυ φέρεν μένος ἡμιόνοιϊν.	-- - uu -u u- uu -uu--	dactylic hexameter	feminine penthemimeral, hepthemimeral, trithemimeral
ἡ δ’ὅτε δὴ οὗ πατρὸς ἀγακλυτὰ δώμαθ’ ἵκανε,	- uu - - -u u-uu -u u--	dactylic hexameter	feminine penthemimeral, trithemimeral
στῆσεν ἄρ’ ἐν προθύροισι, κασίγνητοι δέ μιν ἀμφὶς	-u u - uu-u u--- u u --	dactylic hexameter	feminine penthemimeral, trithemimeral
ἵσταντ’ ἀθανάτοις ἐναλίγκιοι, οἵ ῥ’ὑπ’ ἀπήνης	-- -uu- uu-uu - u u--	dactylic hexameter	masculine penthemimeral
ἡμιόνους ἔλυον ἐσθῆτά τε ἔσφερον εἴσω.	-uu- uu- --u u -uu --	dactylic hexameter	masculine penthemimeral, trithemimeral
αὐτὴ δ’ἐς θάλαμον ἑὸν ἤϊε· δαῖε δέ οἱ πῦρ	-- - uu- uu -uu -u u - -	dactylic hexameter	masculine penthemimeral, trithemimeral
γρηῢς Ἀπειραίη, θαλαμηπόλος Εὐρυμέδουσα,	-u u--- uu-uu -uu--	dactylic hexameter	masculine penthemimeral
τήν ποτ’ Ἀπείρηθεν νέες ἤγαγον ἀμφιέλισσαι·	- u u--- uu -uu -uu--	dactylic hexameter	masculine penthemimeral
Ἀλκινόῳ δ’αὐτὴν γέρας ἔξελον, οὕνεκα πᾶσι	-uu- -- uu -uu -uu --	dactylic hexameter	masculine penthemimeral, trithemimeral
Φαιήκεσσιν ἄνασσε, θεοῦ δ’ὣς δῆμος ἄκουεν·	---u u-u u- - -u u--	dactylic hexameter	feminine penthemimeral, hepthemimeral
ἣ τρέφε Ναυσικάαν λευκώλενον ἐν μεγάροισιν.	- uu -uu- --uu - uu--	dactylic hexameter	masculine penthemimeral
ἥ οἱ πῦρ ἀνέκαιε καὶ εἴσω δόρπον ἐκόσμει.	- - - uu-u u -- -u u--	dactylic hexameter	feminine penthemimeral, trithemimeral
καὶ τότ’ Ὀδυσσεὺς ὦρτο πόλινδ’ ἴμεν· ἀμφὶ δ’Ἀθήνη	- u u-- -u u- uu -u u--	dactylic hexameter	feminine penthemimeral, hepthemimeral
πολλὴν ἠέρα χεῦε φίλα φρονέουσ’ Ὀδυσῆϊ,	-- -uu -u u- uu- uu--	dactylic hexameter	feminine penthemimeral, hepthemimeral
μή τις Φαιήκων μεγαθύμων ἀντιβολήσας	- - --- uu-- -uu--	dactylic hexameter	masculine penthemimeral
κερτομέοι τ’ἐπέεσσι καὶ ἐξερέοιθ’ ὅτις εἴη.	-uu- uu-u u -uu- uu --	dactylic hexameter	feminine penthemimeral, trithemimeral
ἀλλ’ ὅτε δὴ ἄρ’ ἔμελλε πόλιν δύσεσθαι ἐραννήν,	- uu - u u-u u- --u u--	dactylic hexameter	feminine penthemimeral, hepthemimeral, trithemimeral
ἔνθα οἱ ἀντεβόλησε θεά, γλαυκῶπις Ἀθήνη,	-u u -uu-u u- --u u--	dactylic hexameter	feminine penthemimeral, hepthemimeral
παρθενικῇ ἐϊκυῖα νεήνιδι, κάλπιν ἐχούσῃ.	-uu- uu-u u-uu -u u--	dactylic hexameter	feminine penthemimeral, trithemimeral
στῆ δὲ πρόσθ’ αὐτοῦ, ὁ δ’ἀνείρετο δῖος Ὀδυσσεύς·	- - - -- u u-uu -u u--	dactylic hexameter	masculine penthemimeral, trithemimeral
ὦ τέκος, οὐκ ἄν μοι δόμον ἀνέρος ἡγήσαιο	- uu - - - uu -uu ----	dactylic hexameter	masculine penthemimeral, trithemimeral
Ἀλκινόου, ὃς τοῖσδε μετ’ ἀνθρώποισιν ἀνάσσει;	-uu- - -u u ---u u--	dactylic hexameter	feminine penthemimeral, trithemimeral
καὶ γὰρ ἐγὼ ξεῖνος ταλαπείριος ἐνθάδ’ ἱκάνω	- u u- -- uu-uu -u u--	dactylic hexameter	masculine penthemimeral, trithemimeral
τηλόθεν ἐξ ἀπίης γαίης· τῶ οὔ τινα οἶδα	-uu - uu- -- - - uu --	dactylic hexameter	masculine penthemimeral, hepthemimeral, trithemimeral
ἀνθρώπων, οἳ τήνδε πόλιν καὶ γαῖαν ἔχουσι.	--- - -u u- - -u u--	dactylic hexameter	feminine penthemimeral, hepthemimeral, trithemimeral
τὸν δ’αὖτε προσέειπε θεά γλαυκῶπις Ἀθήνη·	- -- uu-u u- --u u--	dactylic hexameter	feminine penthemimeral, hepthemimeral, trithemimeral
τοιγὰρ ἐγώ τοι, ξεῖνε πάτερ, δόμον, ὅν με κελεύεις,	-u u- - -u u- uu - u u--	dactylic hexameter	feminine penthemimeral, hepthemimeral, trithemimeral
δείξω, ἐπεί μοι πατρὸς ἀμύμονος ἐγγύθι ναίει.	-u u- - -u u-uu -uu --	dactylic hexameter	feminine penthemimeral, trithemimeral
ἀλλ’ ἴθι σιγῇ τοῖον, ἐγὼ δ’ὁδὸν ἡγεμονεύσω,	- uu -- -u u- uu -uu--	dactylic hexameter	feminine penthemimeral, hepthemimeral
μηδέ τιν’ ἀνθρώπων προτιόσσεο μηδ’ ἐρέεινε.	-u u --- uu-uu - uu--	dactylic hexameter	masculine penthemimeral
οὐ γὰρ ξείνους οἵ γε μάλ’ ἀνθρώπους ἀνέχονται,	- - -- - u u --- uu--	dactylic hexameter	masculine penthemimeral
οὐδ’ ἀγαπαζόμενοι φιλέουσ’ ὅς κ’ἄλλοθεν ἔλθῃ.	- uu-uu- uu- - -uu --	dactylic hexameter	masculine penthemimeral, hepthemimeral
νηυσὶ θοῇσιν τοί γε πεποιθότες ὠκείῃσι	-u u-- - u u-uu ----	dactylic hexameter	masculine penthemimeral
λαῖτμα μέγ’ ἐκπερόωσιν, ἐπεί σφισι δῶκ’ ἐνοσίχθων·	-u u -uu-u u- uu - uu--	dactylic hexameter	feminine penthemimeral, hepthemimeral
τῶν νέες ὠκεῖαι ὡς εἰ πτερὸν ἠὲ νόημα.	- uu --- - - uu -u u--	dactylic hexameter	masculine penthemimeral, hepthemimeral
ὣς ἄρα φωνήσασ’ ἡγήσατο Παλλὰς Ἀθήνη	- uu --- --uu -u u--	dactylic hexameter	masculine penthemimeral
καρπαλίμως· ὁ δ’ἔπειτα μετ’ ἴχνια βαῖνε θεοῖο.	-uu- u u-u u -uu -u u--	dactylic hexameter	feminine penthemimeral, trithemimeral
τὸν δ’ἄρα Φαίηκες ναυσικλυτοὶ οὐκ ἐνόησαν	- uu --- --uu - uu--	dactylic hexameter	masculine penthemimeral
ἐρχόμενον κατὰ ἄστυ διὰ σφέας· οὐ γὰρ Ἀθήνη	-uu- uu -u u- uu - u u--	dactylic hexameter	feminine penthemimeral, hepthemimeral, trithemimeral
εἴα ἐϋπλόκαμος, δεινὴ θεός, ἥ ῥά οἱ ἀχλὺν	-u u-uu- -- uu - u u --	dactylic hexameter	masculine penthemimeral, hepthemimeral
θεσπεσίην κατέχευε φίλα φρονέουσ’ ἐνὶ θυμῷ.	-uu- uu-u u- uu- uu --	dactylic hexameter	feminine penthemimeral, hepthemimeral, trithemimeral
θαύμαζεν δ’Ὀδυσεὺς λιμένας καὶ νῆας ἐΐσας	--- uu- uu- - -u u--	dactylic hexameter	masculine penthemimeral, hepthemimeral, trithemimeral
αὐτῶν θ’ἡρώων ἀγορὰς καὶ τείχεα μακρὰ	-- --- uu- - -uu --	dactylic hexameter	masculine penthemimeral, hepthemimeral
ὑψηλά, σκολόπεσσιν ἀρηρότα, θαῦμα ἰδέσθαι.	--- uu-u u-uu -u u--	dactylic hexameter	feminine penthemimeral, trithemimeral
ἀλλ’ ὅτε δὴ βασιλῆος ἀγακλυτὰ δώμαθ’ ἵκοντο,	- uu - uu-u u-uu -u u--	dactylic hexameter	feminine penthemimeral, trithemimeral
τοῖσι δὲ μύθων ἦρχε θεά, γλαυκῶπις Ἀθήνη·	-u u -- -u u- --u u--	dactylic hexameter	feminine penthemimeral, hepthemimeral
οὗτος δή τοι, ξεῖνε πάτερ, δόμος, ὅν με κελεύεις	-- - - -u u- uu - u u--	dactylic hexameter	feminine penthemimeral, hepthemimeral, trithemimeral
πεφραδέμεν· δήεις δὲ διοτρεφέας βασιλῆας	-uu- -- u u-uu- uu--	dactylic hexameter	masculine penthemimeral, trithemimeral
δαίτην δαινυμένους· σὺ δ’ἔσω κίε, μηδέ τι θυμῷ	-- -uu- u u- uu -u u --	dactylic hexameter	masculine penthemimeral, hepthemimeral
τάρβει· θαρσαλέος γὰρ ἀνὴρ ἐν πᾶσιν ἀμείνων	-- -uu- u u- - -u u--	dactylic hexameter	masculine penthemimeral, hepthemimeral
ἔργοισιν τελέθει, εἰ καί ποθεν ἄλλοθεν ἔλθοι.	--- uu- - - uu -uu --	dactylic hexameter	masculine penthemimeral, hepthemimeral, trithemimeral
δέσποιναν μὲν πρῶτα κιχήσεαι ἐν μεγάροισιν·	--- - -u u-uu - uu--	dactylic hexameter	feminine penthemimeral, trithemimeral
Ἀρήτη δ’ὄνομ’ ἐστὶν ἐπώνυμον, ἐκ δὲ τοκήων	--- uu -u u-uu - u u--	dactylic hexameter	feminine penthemimeral, trithemimeral
τῶν αὐτῶν οἵ περ τέκον Ἀλκίνοον βασιλῆα.	- -- - - uu -uu- uu--	dactylic hexameter	masculine penthemimeral, trithemimeral
Ναυσίθοον μὲν πρῶτα Ποσειδάων ἐνοσίχθων	-uu- - -u u--- uu--	dactylic hexameter	feminine penthemimeral, trithemimeral
γείνατο καὶ Περίβοια, γυναικῶν εἶδος ἀρίστη,	-uu - uu-u u-- -u u--	dactylic hexameter	feminine penthemimeral, trithemimeral
ὁπλοτάτη θυγάτηρ μεγαλήτορος Εὐρυμέδοντος,	-uu- uu- uu-uu -uu--	dactylic hexameter	masculine penthemimeral, trithemimeral
ὅς ποθ’ ὑπερθύμοισι Γιγάντεσσιν βασίλευεν.	- u u---u u--- uu--	dactylic hexameter	feminine penthemimeral
ἀλλ’ ὁ μὲν ὤλεσε λαὸν ἀτάσθαλον, ὤλετο δ’αὐτός·	- u u -uu -u u-uu -uu --	dactylic hexameter	feminine penthemimeral
τῇ δὲ Ποσειδάων ἐμίγη καὶ ἐγείνατο παῖδα	- u u--- uu- u u-uu --	dactylic hexameter	masculine penthemimeral, hepthemimeral
Ναυσίθοον μεγάθυμον, ὃς ἐν Φαίηξιν ἄνασσε·	-uu- uu-u u - --u u--	dactylic hexameter	feminine penthemimeral, hepthemimeral, trithemimeral
Ναυσίθοος δ’ἔτεκεν Ῥηξήνορά τ’Ἀλκίνοόν τε.	-uu- uu- --uu -uu- -	dactylic hexameter	masculine penthemimeral, trithemimeral
τὸν μὲν ἄκουρον ἐόντα βάλ’ ἀργυρότοξος Ἀπόλλων	- u u-u u-u u -uu-u u--	dactylic hexameter	feminine penthemimeral
νυμφίον ἐν μεγάρῳ, μίαν οἴην παῖδα λιπόντα	-uu - uu- uu -- -u u--	dactylic hexameter	masculine penthemimeral, trithemimeral
Ἀρήτην· τὴν δ’Ἀλκίνοος ποιήσατ’ ἄκοιτιν,	--- - -uu- --u u--	dactylic hexameter	hepthemimeral, trithemimeral
καί μιν ἔτισ’, ὡς οὔ τις ἐπὶ χθονὶ τίεται ἄλλη,	- u u- - - u u- uu -uu --	dactylic hexameter	masculine penthemimeral, hepthemimeral, trithemimeral
ὅσσαι νῦν γε γυναῖκες ὑπ’ ἀνδράσιν οἶκον ἔχουσιν.	-- - u u-u u -uu -u u--	dactylic hexameter	feminine penthemimeral, trithemimeral
ὣς κείνη περὶ κῆρι τετίμηταί τε καὶ ἔστιν	- -- uu -u u--- u u --	dactylic hexameter	feminine penthemimeral, trithemimeral
ἔκ τε φίλων παίδων ἔκ τ’αὐτοῦ Ἀλκινόοιο	- u u- -- - -- -uu--	dactylic hexameter	masculine penthemimeral, trithemimeral
καὶ λαῶν, οἵ μίν ῥα θεὸν ὣς εἰσορόωντες	- -- - - u u- - -uu--	dactylic hexameter	masculine penthemimeral, hepthemimeral, trithemimeral
δειδέχαται μύθοισιν, ὅτε στείχῃσ’ ἀνὰ ἄστυ.	-uu- --u u- -- uu --	dactylic hexameter	feminine penthemimeral, hepthemimeral, trithemimeral
οὐ μὲν γάρ τι νόου γε καὶ αὐτὴ δεύεται ἐσθλοῦ·	- - - u u- u u -- -uu --	dactylic hexameter	masculine penthemimeral, trithemimeral
οἷσι τ’ἐῢ φρονέῃσι καὶ ἀνδράσι νείκεα λύει.	-u u- uu-u u -uu -uu --	dactylic hexameter	feminine penthemimeral, trithemimeral
εἴ κέν τοι κείνη γε φίλα φρονέῃσ’ ἐνὶ θυμῷ,	- - - -- u u- uu- uu --	dactylic hexameter	masculine penthemimeral, hepthemimeral, trithemimeral
ἐλπωρή τοι ἔπειτα φίλους τ’ἰδέειν καὶ ἱκέσθαι	--- u u-u u- uu- u u--	dactylic hexameter	feminine penthemimeral, hepthemimeral, trithemimeral
οἶκον ἐς ὑψόροφον καὶ σὴν ἐς πατρίδα γαῖαν.	-u u -uu- - - - -uu --	dactylic hexameter	masculine penthemimeral, hepthemimeral
ὣς ἄρα φωνήσασ’ ἀπέβη γλαυκῶπις Ἀθήνη	- uu --- uu- --u u--	dactylic hexameter	masculine penthemimeral, hepthemimeral
πόντον ἐπ’ ἀτρύγετον, λίπε δὲ Σχερίην ἐρατεινήν,	-u u -uu- uu - uu- uu--	dactylic hexameter	masculine penthemimeral, hepthemimeral
ἵκετο δ’ἐς Μαραθῶνα καὶ εὐρυάγυιαν Ἀθήνην,	-uu - uu-u u -uu-u u--	dactylic hexameter	feminine penthemimeral, trithemimeral
δῦνε δ’Ἐρεχθῆος πυκινὸν δόμον. αὐτὰρ Ὀδυσσεὺς	-u u--- uu- uu -u u--	dactylic hexameter	masculine penthemimeral, hepthemimeral
Ἀλκινόου πρὸς δώματ’ ἴε κλυτά· πολλὰ δέ οἱ κῆρ	-uu- - -u u- uu -u u - -	dactylic hexameter	feminine penthemimeral, hepthemimeral, trithemimeral
ὥρμαιν’ ἱσταμένῳ, πρὶν χάλκεον οὐδὸν ἱκέσθαι.	-- -uu- - -uu -u u--	dactylic hexameter	masculine penthemimeral
ὥς τε γὰρ ἠελίου αἴγλη πέλεν ἠὲ σελήνης	- u u -uu- -- uu -u u--	dactylic hexameter	masculine penthemimeral, hepthemimeral
δῶμα καθ’ ὑψερεφὲς μεγαλήτορος Ἀλκινόοιο.	-u u -uu- uu-uu -uu--	dactylic hexameter	masculine penthemimeral
χάλκεοι μὲν γὰρ τοῖχοι ἐληλέδατ’ ἔνθα καὶ ἔνθα,	-- - - -u u-uu -u u --	dactylic hexameter	feminine penthemimeral, trithemimeral
ἐς μυχὸν ἐξ οὐδοῦ, περὶ δὲ θριγκὸς κυάνοιο·	- uu - -- uu - -- uu--	dactylic hexameter	masculine penthemimeral, hepthemimeral, trithemimeral
χρύσειαι δὲ θύραι πυκινὸν δόμον ἐντὸς ἔεργον·	--- u u- uu- uu -u u--	dactylic hexameter	masculine penthemimeral, hepthemimeral, trithemimeral
ἀργύρεοι σταθμοὶ ἐν χαλκέῳ ἕστασαν οὐδῷ,	-uu- -- - -- -uu --	dactylic hexameter	masculine penthemimeral, trithemimeral
ἀργύρεον δ’ἐφ’ ὑπερθύριον, χρυσέη δὲ κορώνη.	-uu- u u-uu- uu- u u--	dactylic hexameter	hepthemimeral, trithemimeral
χρύσειοι δ’ἑκάτερθε καὶ ἀργύρεοι κύνες ἦσαν,	--- uu-u u -uu- uu --	dactylic hexameter	feminine penthemimeral, trithemimeral
οὓς Ἥφαιστος ἔτευξεν ἰδυίῃσι πραπίδεσσι	- --u u-u u--- uu--	dactylic hexameter	feminine penthemimeral
δῶμα φυλασσέμεναι μεγαλήτορος Ἀλκινόοιο,	-u u-uu- uu-uu -uu--	dactylic hexameter	masculine penthemimeral
ἀθανάτους ὄντας καὶ ἀγήρως ἤματα πάντα.	-uu- -- u u-- -uu --	dactylic hexameter	masculine penthemimeral, trithemimeral
ἐν δὲ θρόνοι περὶ τοῖχον ἐρηρέδατ’ ἔνθα καὶ ἔνθα,	- u u- uu -u u-uu -u u --	dactylic hexameter	feminine penthemimeral, trithemimeral
ἐς μυχὸν ἐξ οὐδοῖο διαμπερές, ἔνθ’ ἐνὶ πέπλοι	- uu - --u u-uu - uu --	dactylic hexameter	feminine penthemimeral, trithemimeral
λεπτοὶ ἐΰννητοι βεβλήατο, ἔργα γυναικῶν.	-u u--- --uu -u u--	dactylic hexameter	masculine penthemimeral
ἔνθα δὲ Φαιήκων ἡγήτορες ἑδριόωντο	-u u --- --uu -uu--	dactylic hexameter	masculine penthemimeral
πίνοντες καὶ ἔδοντες· ἐπηετανὸν γὰρ ἔχεσκον.	--- u u-u u-uu- u u--	dactylic hexameter	feminine penthemimeral, trithemimeral
χρύσειοι δ’ἄρα κοῦροι ἐϋδμήτων ἐπὶ βωμῶν	--- uu -u u--- uu --	dactylic hexameter	feminine penthemimeral, trithemimeral
ἕστασαν αἰθομένας δαΐδας μετὰ χερσὶν ἔχοντες,	-uu -uu- uu- uu -u u--	dactylic hexameter	masculine penthemimeral, hepthemimeral
φαίνοντες νύκτας κατὰ δώματα δαιτυμόνεσσι.	--- -- uu -uu -uu--	dactylic hexameter	masculine penthemimeral, trithemimeral
πεντήκοντα δέ οἱ δμῳαὶ κατὰ δῶμα γυναῖκες	---u u - -- uu -u u--	dactylic hexameter	masculine penthemimeral, hepthemimeral
αἱ μὲν ἀλετρεύουσι μύλῃς ἔπι μήλοπα καρπόν,	- u u---u u- uu -uu --	dactylic hexameter	feminine penthemimeral, hepthemimeral
αἱ δ’ἱστοὺς ὑφόωσι καὶ ἠλάκατα στρωφῶσιν	- -- uu-u u -uu- ---	dactylic hexameter	feminine penthemimeral, trithemimeral
ἥμεναι, οἷά τε φύλλα μακεδνῆς αἰγείροιο·	-uu -u u -u u-- ----	dactylic hexameter	feminine penthemimeral
καιροσέων δ’ὀθονέων ἀπολείβεται ὑγρὸν ἔλαιον.	-uu- uu- uu-uu -u u--	dactylic hexameter	masculine penthemimeral, trithemimeral
ὅσσον Φαίηκες περὶ πάντων ἴδριες ἀνδρῶν	-- --- uu -- -uu --	dactylic hexameter	masculine penthemimeral
νῆα θοὴν ἐνὶ πόντῳ ἐλαυνέμεν, ὣς δὲ γυναῖκες	-u u- uu -u u-uu - u u--	dactylic hexameter	feminine penthemimeral, trithemimeral
ἱστὸν τεχνῆσσαι· πέρι γάρ σφισι δῶκεν Ἀθήνη	-- --- uu - uu -u u--	dactylic hexameter	masculine penthemimeral, hepthemimeral
ἔργα τ’ἐπίστασθαι περικαλλέα καὶ φρένας ἐσθλάς.	-u u--- uu-uu - uu --	dactylic hexameter	masculine penthemimeral
ἔκτοσθεν δ’αὐλῆς μέγας ὄρχατος ἄγχι θυράων	--- -- uu -uu -u u--	dactylic hexameter	masculine penthemimeral, trithemimeral
τετράγυος· περὶ δ’ἕρκος ἐλήλαται ἀμφοτέρωθεν.	-uu- uu -u u-uu -uu--	dactylic hexameter	feminine penthemimeral, trithemimeral
ἔνθα δὲ δένδρεα μακρὰ πεφύκει τηλεθάοντα,	-u u -uu -u u-- -uu--	dactylic hexameter	feminine penthemimeral
ὄγχναι καὶ ῥοιαὶ καὶ μηλέαι ἀγλαόκαρποι	-- - -- - -uu -uu--	dactylic hexameter	masculine penthemimeral, trithemimeral
συκέαι τε γλυκεραὶ καὶ ἐλαῖαι τηλεθόωσαι.	-- - uu- u u-- -uu--	dactylic hexameter	masculine penthemimeral, trithemimeral
τάων οὔ ποτε καρπὸς ἀπόλλυται οὐδ’ ἀπολείπει	-- - uu -u u-uu - uu--	dactylic hexameter	feminine penthemimeral, trithemimeral
χείματος οὐδὲ θέρευς, ἐπετήσιος· ἀλλὰ μάλ’ αἰεὶ	-uu -u u- uu-uu -u u --	dactylic hexameter	masculine penthemimeral
Ζαφυρίη πνείουσα τὰ μὲν φύει, ἄλλα δὲ πέσσει.	-uu- --u u - uu -u u --	dactylic hexameter	feminine penthemimeral, hepthemimeral, trithemimeral
ὄγχνη ἐπ’ ὄγχνῃ γηράσκει, μῆλον δ’ἐπὶ μήλῳ,	-u u -- --- -- uu --	dactylic hexameter	hepthemimeral
αὐτὰρ ἐπὶ σταφυλῇ σταφυλή, σῦκον δ’ἐπὶ σύκῳ.	-u u- uu- uu- -- uu --	dactylic hexameter	masculine penthemimeral, hepthemimeral, trithemimeral
ἔνθα δέ οἱ πολύκαρπος ἀλωὴ ἐρρίζωται,	-u u - uu-u u-- ----	dactylic hexameter	feminine penthemimeral, trithemimeral
τῆς ἕτερον μέν εἱλόπεδον λευρῷ ἐνὶ χώρῳ	- uu- - -uu- -- uu --	dactylic hexameter	hepthemimeral, trithemimeral
τέρσεται ἠελίῳ, ἑτέρας δ’ἄρα τε τρυγόωσιν,	-uu -uu- uu- uu - uu--	dactylic hexameter	masculine penthemimeral, hepthemimeral
ἄλλας δὲ τραπέουσι· πάροιθε δέ τ’ὄμφακές εἰσιν	-- - uu-u u-u u -uu --	dactylic hexameter	feminine penthemimeral, trithemimeral
ἄνθος ἀφιεῖσαι, ἕτεραι δ’ὑποπερκάζουσιν.	-u u--- uu- uu----	dactylic hexameter	masculine penthemimeral, hepthemimeral
ἔνθα δὲ κοσμηταὶ πρασιαὶ παρὰ νείατον ὄρχον	-u u --- uu- uu -uu --	dactylic hexameter	masculine penthemimeral, hepthemimeral
παντοῖαι πεφύασιν, ἐπηετανὸν γανόωσαι·	--- uu-u u-uu- uu--	dactylic hexameter	feminine penthemimeral, trithemimeral
ἐν δὲ δύω κρῆναι ἡ μέν τ’ἀνὰ κῆπον ἅπαντα	- u u- -- - - uu -u u--	dactylic hexameter	masculine penthemimeral, hepthemimeral, trithemimeral
σκίδναται, ἡ δ’ἑτέρωθεν ὑπ’ αὐλῆς οὐδὸν ἵησι	-uu - uu-u u -- -u u--	dactylic hexameter	feminine penthemimeral, trithemimeral
πρὸς δόμον ὑψηλόν, ὅθεν ὑδρεύοντο πολῖται.	- uu --- uu ---u u--	dactylic hexameter	masculine penthemimeral
τοῖ’ ἄρ’ ἐν Ἀλκινόοιο θεῶν ἔσαν ἀγλαὰ δῶρα.	- u u -uu-u u- uu -uu --	dactylic hexameter	feminine penthemimeral, hepthemimeral
ἔνθα στὰς θηεῖτο πολύτλας δῖος Ὀδυσσεύς.	-- - --u u-- -u u--	dactylic hexameter	feminine penthemimeral, trithemimeral
αὐτὰρ ἐπεὶ δὴ πάντα ἑῷ θηήσατο θυμῷ,	-u u- - -- - --uu --	dactylic hexameter	hepthemimeral, trithemimeral
καρπαλίμως ὑπὲρ οὐδὸν ἐβήσετο δώματος εἴσω.	-uu- uu -u u-uu -uu --	dactylic hexameter	feminine penthemimeral, trithemimeral
εὗρε δὲ Φαιήκων ἡγήτορας ἠδὲ μέδοντας	-u u --- --uu -u u--	dactylic hexameter	masculine penthemimeral
σπένδοντας δεπάεσσιν ἐϋσκόπῳ ἀργεϊφόντῃ,	--- uu-u u-uu -uu--	dactylic hexameter	feminine penthemimeral, trithemimeral
ᾧ πυμάτῳ σπένδεσκον, ὅτε μνησαίατο κοίτου.	- uu- --u u- --uu --	dactylic hexameter	feminine penthemimeral, hepthemimeral, trithemimeral
αὐτὰρ ὁ βῆ διὰ δῶμα πολύτλας δῖος Ὀδυσσεὺς	-u u - uu -u u-- -u u--	dactylic hexameter	feminine penthemimeral, trithemimeral
πολλὴν ἠέρ’ ἔχων, ἥν οἱ περίχευεν Ἀθήνη,	-- -u u- - - uu-u u--	dactylic hexameter	masculine penthemimeral, hepthemimeral
ὄφρ’ ἵκετ’ Ἀρήτην τε καὶ Ἀλκίνοον βασιλῆα.	- uu --- u u -uu- uu--	dactylic hexameter	masculine penthemimeral
ἀμφὶ δ’ἄρ’ Ἀρήτης βάλε γούνασι χεῖρας Ὀδυσσεύς,	-u u --- uu -uu -u u--	dactylic hexameter	masculine penthemimeral
καὶ τότε δή ῥ’αὐτοῖο πάλιν χύτο θέσφατος ἀήρ.	- uu - --u u- uu -uu --	dactylic hexameter	feminine penthemimeral, hepthemimeral, trithemimeral
οἱ δ’ἄνεω ἐγένοντο, δόμον κάτα φῶτα ἰδόντες·	- uu- uu-u u- uu -u u--	dactylic hexameter	feminine penthemimeral, hepthemimeral, trithemimeral
θαύμαζον δ’ὁρόωντες. ὁ δ’ἐλλιτάνευεν Ὀδυσσεύς·	--- uu-u u -uu-u u--	dactylic hexameter	feminine penthemimeral, trithemimeral
Ἀρήτη, θύγατερ Ῥηξήνορος ἀντιθέοιο,	--- uu- --uu -uu--	dactylic hexameter	masculine penthemimeral, trithemimeral
σόν τε πόσιν σά τε γούναθ’ ἱκάνω πολλὰ μογήσας	- u u- u u -u u-- -u u--	dactylic hexameter	feminine penthemimeral, trithemimeral
τούσδε τε δαιτυμόνας· τοῖσιν θεοὶ ὄλβια δοῖεν	-u u -uu- -- uu -uu --	dactylic hexameter	masculine penthemimeral, hepthemimeral
ζωέμεναι, καὶ παισὶν ἐπιτρέψειεν ἕκαστος	-uu- - -u u---u u--	dactylic hexameter	feminine penthemimeral, trithemimeral
κτήματ’ ἐνὶ μεγάροισι γέρας θ’ὅ τι δῆμος ἔδωκεν·	-u u- uu-u u- u u -u u--	dactylic hexameter	feminine penthemimeral, hepthemimeral, trithemimeral
αὐτὰρ ἐμοὶ πομπὴν ὀτρύνετε πατρίδ’ ἱκέσθαι	-u u- -- --uu -u u--	dactylic hexameter	masculine penthemimeral, trithemimeral
θᾶσσον, ἐπεὶ δὴ δηθὰ φίλων ἄπο πήματα πάσχω.	-u u- - -u u- uu -uu --	dactylic hexameter	feminine penthemimeral, hepthemimeral, trithemimeral
ὣς εἰπὼν κατ’ ἄρ’ ἕζετ’ ἐπ’ ἐσχάρῃ ἐν κονίῃσι	- -- u u -u u -uu - uu--	dactylic hexameter	feminine penthemimeral, trithemimeral
πὰρ πυρί· οἱ δ’ἄρα πάντες ἀκὴν ἐγένοντο σιωπῇ.	- uu - uu -u u- uu-u u--	dactylic hexameter	feminine penthemimeral, hepthemimeral, trithemimeral
ὀψὲ δὲ δὴ μετέειπε γέρων ἥρως Ἐχένηος,	-u u - uu-u u- -- uu--	dactylic hexameter	feminine penthemimeral, hepthemimeral, trithemimeral
ὃς δὴ Φαιήκων ἀνδρῶν προγενέστερος ἦεν	- - --- -- uu-uu --	dactylic hexameter	masculine penthemimeral, hepthemimeral
καὶ μύθοισι κέκαστο, παλαιά τε πολλά τε εἰδώς·	- --u u-u u-u u -u u --	dactylic hexameter	feminine penthemimeral
ὅ σφιν ἐῢ φρονέων ἀγορήσατο καὶ μετέειπεν·	- u u- uu- uu-uu - uu--	dactylic hexameter	masculine penthemimeral, trithemimeral
Ἀλκίνο’, οὐ μέν τοι τόδε κάλλιον, οὐδὲ ἔοικε,	-uu - - - uu -uu -u u--	dactylic hexameter	masculine penthemimeral, trithemimeral
ξεῖνον μὲν χαμαὶ ἧσθαι ἐπ’ ἐσχάρῃ ἐν κονίῃσιν,	-- - uu -u u -uu - uu--	dactylic hexameter	feminine penthemimeral, trithemimeral
οἵδε δὲ σὸν μῦθον ποτιδέγμενοι ἰσχανόωνται.	-u u - -- uu-uu -uu--	dactylic hexameter	masculine penthemimeral, trithemimeral
ἄλλ’ ἄγε δὴ ξεῖνον μὲν ἐπὶ θρόνου ἀργυροήλου	- uu - -- u u- uu -uu--	dactylic hexameter	masculine penthemimeral, hepthemimeral, trithemimeral
εἷσον ἀναστήσας, σὺ δὲ κηρύκεσσι κέλευσον	-u u--- u u ---u u--	dactylic hexameter	masculine penthemimeral
οἶνον ἐπικρῆσαι, ἵνα καὶ Διῒ τερπικεραύνῳ	-u u--- uu - uu -uu--	dactylic hexameter	masculine penthemimeral, hepthemimeral
σπείσομεν, ὅς θ’ἱκέτῃσιν ἅμ’ αἰδοίοισιν ὀπηδεῖ·	-uu - uu-u u ---u u--	dactylic hexameter	feminine penthemimeral, trithemimeral
δόρπον δὲ ξείνῳ ταμίη δότω ἔνδον ἐόντων.	-- - -- uu- uu -u u--	dactylic hexameter	masculine penthemimeral, hepthemimeral, trithemimeral
αὐτὰρ ἐπεὶ τό γ’ἄκουσ’ ἱερὸν μένος Ἀλκινόοιο,	-u u- u u- uu- uu -uu--	dactylic hexameter	masculine penthemimeral, hepthemimeral, trithemimeral
χειρὸς ἑλὼν Ὀδυσῆα δαΐφρονα ποικιλομήτην	-u u- uu-u u-uu -uu--	dactylic hexameter	feminine penthemimeral, trithemimeral
ὦρσεν ἀπ’ ἐσχαρόφιν καὶ ἐπὶ θρόνου εἷσε φαεινοῦ,	-u u -uu- u u- uu -u u--	dactylic hexameter	masculine penthemimeral, hepthemimeral
υἱὸν ἀναστήσας ἀγαπήνορα Λαοδάμαντα,	-u u--- uu-uu -uu--	dactylic hexameter	masculine penthemimeral
ὅς οἱ πλησίον ἷζε, μάλιστα δέ μιν φιλέεσκε.	- - -uu -u u-u u - uu--	dactylic hexameter	feminine penthemimeral
χέρνιβα δ’ἀμφίπολος προχόῳ ἐπέχευε φέρουσα	-uu -uu- uu- uu-u u--	dactylic hexameter	masculine penthemimeral, hepthemimeral
καλῇ χρυσείῃ ὑπὲρ ἀργυρέοιο λέβητος,	-- --- uu -uu-u u--	dactylic hexameter	masculine penthemimeral
νίψασθαι· παρὰ δὲ ξεστὴν ἐτάνυσσε τράπεζαν.	--- uu - -- uu-u u--	dactylic hexameter	masculine penthemimeral, hepthemimeral, trithemimeral
σῖτον δ’αἰδοίη ταμίη παρέθηκε φέρουσα,	-- --- uu- uu-u u--	dactylic hexameter	masculine penthemimeral, hepthemimeral
εἴδατα πόλλ’ ἐπιθεῖσα, χαριζομένη παρεόντων.	-uu - uu-u u-uu- uu--	dactylic hexameter	feminine penthemimeral, trithemimeral
αὐτὰρ ὁ πῖνε καὶ ἦσθε πολύτλας δῖος Ὀδυσσεύς.	-u u -u u -u u-- -u u--	dactylic hexameter	feminine penthemimeral
καὶ τότε κήρυκα προσέφη μένος Ἀλκινόοιο·	- uu --- uu- uu -uu--	dactylic hexameter	masculine penthemimeral, hepthemimeral
Ποντόνοε, κρητῆρα κερασσάμενος μέθυ νεῖμον	-uu- --u u-uu- uu --	dactylic hexameter	feminine penthemimeral, trithemimeral
πᾶσιν ἀνὰ μέγαρον, ἵνα καὶ Διῒ τερπικεραύνῳ	-u u- uu- uu - uu -uu--	dactylic hexameter	masculine penthemimeral, hepthemimeral, trithemimeral
σπείσομεν, ὅς θ’ἱκέτῃσιν ἅμ’ αἰδοίοισιν ὀπηδεῖ.	-uu - uu-u u ---u u--	dactylic hexameter	feminine penthemimeral, trithemimeral
ὣς φάτο, Ποντόνοος δὲ μελίφρονα οἶνον ἐκίρνα,	- uu -uu- u u-uu -u u--	dactylic hexameter	masculine penthemimeral
νώμησεν δ’ἄρα πᾶσιν ἐπαρξάμενος δεπάεσσιν.	--- uu -u u-uu- uu--	dactylic hexameter	feminine penthemimeral, trithemimeral
αὐτὰρ ἐπεὶ σπεῖσάν τ’ἔπιόν θ’,ὅσον ἤθελε θυμός,	-u u- -- uu- uu -uu --	dactylic hexameter	masculine penthemimeral, hepthemimeral, trithemimeral
τοῖσιν δ’Ἀλκίνοος ἀγορήσατο καὶ μετέειπε·	-- -uu- uu-uu - uu--	dactylic hexameter	masculine penthemimeral
κέκλυτε, Φαιήκων ἡγήτορες ἠδὲ μέδοντες	-uu --- --uu -u u--	dactylic hexameter	masculine penthemimeral
ὄφρ’ εἴπω τά με θυμὸς ἐνὶ στήθεσσι κελεύει.	- -- u u -u u- --u u--	dactylic hexameter	feminine penthemimeral, hepthemimeral, trithemimeral
νῦν μὲν δαισάμενοι κατακείετε οἴκαδ’ ἰόντες·	- - -uu- uu-uu -u u--	dactylic hexameter	masculine penthemimeral
ἠῶθεν δὲ γέροντας ἐπὶ πλέονας καλέσαντες	--- u u-u u- uu- uu--	dactylic hexameter	feminine penthemimeral, hepthemimeral, trithemimeral
ξεῖνον ἐνὶ μεγάροις ξεινίσσομεν ἠδὲ θεοῖσι	-u u- uu- --uu -u u--	dactylic hexameter	masculine penthemimeral, trithemimeral
ῥέξομεν ἱερὰ καλά, ἔπειτα δὲ καὶ περὶ πομπῆς	-uu -uu -u u-u u - uu --	dactylic hexameter	feminine penthemimeral
μνησόμεθ’, ὥς χ’ὁ ξεῖνος ἄνευθε πόνου καὶ ἀνίης	-uu - - -u u-u u- u u--	dactylic hexameter	feminine penthemimeral, trithemimeral
πομπῇ ὑφ’ ἡμετέρῃ ἣν πατρίδα γαῖαν ἵκηται	-u u -uu- - -uu -u u--	dactylic hexameter	masculine penthemimeral
χαίρων καρπαλίμως, εἰ καὶ μάλα τηλόθεν ἐστί,	-- -uu- - - uu -uu --	dactylic hexameter	masculine penthemimeral, hepthemimeral
μηδέ τι μεσσηγύς γε κακὸν καὶ πῆμα πάθῃσι,	-u u --- u u- - -u u--	dactylic hexameter	masculine penthemimeral, hepthemimeral
πρίν γε τὸν ἧς γαίης ἐπιβήμεναι· ἔνθα δ’ἔπειτα	- u u - -- uu-uu -u u--	dactylic hexameter	masculine penthemimeral, trithemimeral
πείσεται, ἅσσα οἱ αἶσα κατὰ κλῶθές τε βαρεῖαι	-uu -u u -u u- -- u u--	dactylic hexameter	feminine penthemimeral, hepthemimeral
γεινομένῳ νήσαντο λίνῳ, ὅτε μιν τέκε μήτηρ.	-uu- --u u- uu - uu --	dactylic hexameter	feminine penthemimeral, hepthemimeral, trithemimeral
εἰ δέ τις ἀθανάτων γε κατ’ οὐρανοῦ εἰλήλουθεν,	- u u -uu- u u -uu ----	dactylic hexameter	masculine penthemimeral
ἄλλο τι δὴ τόδ’ ἔπειτα θεοὶ περιμηχανόωνται.	-u u - u u-u u- uu-uu--	dactylic hexameter	feminine penthemimeral, hepthemimeral, trithemimeral
αἰεὶ γὰρ τὸ πάρος γε θεοὶ φαίνονται ἐναργεῖς	-- - u u- u u- --u u--	dactylic hexameter	masculine penthemimeral, hepthemimeral, trithemimeral
ἡμῖν, εὖθ’ ἕρδωμεν ἀγακλειτὰς ἑκατόμβας,	-- - --u u--- uu--	dactylic hexameter	feminine penthemimeral, trithemimeral
δαίνυνταί τε παρ’ ἄμμι καθήμενοι ἔνθα περ ἡμεῖς.	--- u u -u u-uu -u u --	dactylic hexameter	feminine penthemimeral, trithemimeral
εἰ δ’ἄρα τις καὶ μοῦνος ἰὼν ξύμβληται ὁδίτης,	- uu - - -u u- --u u--	dactylic hexameter	feminine penthemimeral, hepthemimeral, trithemimeral
οὔ τι κατακρύπτουσιν, ἐπεί σφισιν ἐγγύθεν εἰμέν,	- u u---u u- uu -uu --	dactylic hexameter	feminine penthemimeral, hepthemimeral
ὥς περ Κύκλωπές τε καὶ ἄγρια φῦλα Γιγάντων.	- - --- u u -uu -u u--	dactylic hexameter	masculine penthemimeral
τὸν δ’ἀπαμειβόμενος προσέφη πολύμητις Ὀδυσσεύς·	- uu-uu- uu- uu-u u--	dactylic hexameter	masculine penthemimeral, hepthemimeral
Ἀλκίνο’, ἄλλο τί τοι μελέτω φρεσίν· οὐ γὰρ ἔγωγε	-uu -u u - uu- uu - u u--	dactylic hexameter	masculine penthemimeral, hepthemimeral
ἀθανάτοισιν ἔοικα, τοὶ οὐρανὸν εὐρὺν ἔχουσιν,	-uu-u u-u u -uu -u u--	dactylic hexameter	feminine penthemimeral
οὐ δέμας οὐδὲ φυήν, ἀλλὰ θνητοῖσι βροτοῖσιν.	- uu -u u- -- --u u--	dactylic hexameter	masculine penthemimeral, hepthemimeral
οὕς τινας ὑμεῖς ἴστε μάλιστ’ ὀχέοντας ὀϊζὺν	- uu -- -u u- uu-u u--	dactylic hexameter	feminine penthemimeral, hepthemimeral
ἀνθρώπων, τοῖσίν κεν ἐν ἄλγεσιν ἰσωσαίμην.	--- -- u u -uu ----	dactylic hexameter	masculine penthemimeral, trithemimeral
καὶ δ’ἔτι κεν καὶ πλεῖον ἐγὼ κακὰ μυθησαίμην,	- uu - - -u u- uu ----	dactylic hexameter	feminine penthemimeral, hepthemimeral, trithemimeral
ὅσσα γε δὴ ξύμπαντα θεῶν ἰότητι μόγησα.	-u u - --u u- uu-u u--	dactylic hexameter	feminine penthemimeral, hepthemimeral, trithemimeral
ἀλλ’ ἐμὲ μὲν δορπῆσαι ἐάσατε κηδόμενόν περ·	- uu - --u u-uu -uu- -	dactylic hexameter	feminine penthemimeral, trithemimeral
οὐ γάρ τι στυγερῇ ἐπὶ γαστέρι κύντερον ἄλλο	- - - uu- uu -uu -uu --	dactylic hexameter	masculine penthemimeral, trithemimeral
ἔπλετο, ἥ τ’ἐκέλευσεν ἕο μνήσασθαι ἀνάγκῃ	-uu - uu-u u- --u u--	dactylic hexameter	feminine penthemimeral, hepthemimeral, trithemimeral
καὶ μάλα τειρόμενον καὶ ἐνὶ φρεσὶ πένθος ἔχοντα,	- uu -uu- u u- uu -u u--	dactylic hexameter	masculine penthemimeral, hepthemimeral
ὡς καὶ ἐγὼ πένθος μὲν ἔχω φρεσίν, ἡ δὲ μάλ’ αἰεὶ	- u u- -- u u- uu - u u --	dactylic hexameter	masculine penthemimeral, hepthemimeral, trithemimeral
ἐσθέμεναι κέλεται καὶ πινέμεν, ἐκ δέ με πάντων	-uu- uu- - -uu - u u --	dactylic hexameter	masculine penthemimeral, trithemimeral
ληθάνει ὅσσ’ ἔπαθον, καὶ ἐνιπλήσασθαι ἀνώγει.	-uu - uu- u u---u u--	dactylic hexameter	masculine penthemimeral, trithemimeral
ὑμεῖς δ’ὀτρύνεσθε ἅμ’ ἠοῖ φαινομένηφι,	-- ---u u -- -uu--	dactylic hexameter	feminine penthemimeral
ὥς κ’ἐμὲ τὸν δύστηνον ἐμῆς ἐπιβήσετε πάτρης	- uu - --u u- uu-uu --	dactylic hexameter	feminine penthemimeral, hepthemimeral, trithemimeral
καί περ πολλὰ παθόντα· ἰδόντα με καὶ λίποι αἰὼν	- - -u u-u u-u u - uu --	dactylic hexameter	feminine penthemimeral
κτῆσιν ἐμήν, δμῶάς τε καὶ ὑψερεφὲς μέγα δῶμα.	-u u- -- u u -uu- uu --	dactylic hexameter	masculine penthemimeral, trithemimeral
ὣς ἔφαθ’, οἱ δ’ἄρα πάντες ἐπῄνεον ἠδ’ ἐκέλευον	- uu - uu -u u-uu - uu--	dactylic hexameter	feminine penthemimeral, trithemimeral
πεμπέμεναι τὸν ξεῖνον, ἐπεὶ κατὰ μοῖραν ἔειπεν.	-uu- - -u u- uu -u u--	dactylic hexameter	feminine penthemimeral, hepthemimeral, trithemimeral
αὐτὰρ ἐπεὶ σπεῖσάν τ’ἔπιον θ’ὅσον ἤθελε θυμός,	-u u- -- uu- uu -uu --	dactylic hexameter	masculine penthemimeral, hepthemimeral, trithemimeral
οἱ μὲν κακκείοντες ἔβαν οἶκόνδε ἕκαστος,	- - ---u u- --u u--	dactylic hexameter	feminine penthemimeral, hepthemimeral
αὐτὰρ ὁ ἐν μεγάρῳ ὑπελείπετο δῖος Ὀδυσσεύς,	-u u - uu- uu-uu -u u--	dactylic hexameter	masculine penthemimeral, trithemimeral
πὰρ δέ οἱ Ἀρήτη τε καὶ Ἀλκίνοος θεοειδὴς	- u u --- u u -uu- uu--	dactylic hexameter	masculine penthemimeral
ἥσθην· ἀμφίπολοι δ’ἀπεκόσμεον ἔντεα δαιτός.	-- -uu- uu-uu -uu --	dactylic hexameter	masculine penthemimeral
τοῖσιν δ’Ἀρήτη λευκώλενος ἤρχετο μύθων·	-- --- --uu -uu --	dactylic hexameter	masculine penthemimeral
ἔγνω γὰρ φᾶρός τε χιτῶνά τε εἵματ’ ἰδοῦσα	-- - -- u u-u u -u u--	dactylic hexameter	masculine penthemimeral, trithemimeral
καλά, τά ῥ’αὐτὴ τεῦξε σὺν ἀμφιπόλοισι γυναιξί·	-u u -- -u u -uu-u u--	dactylic hexameter	feminine penthemimeral
καί μιν φωνήσασ’ ἔπεα πτερόεντα προσηύδα·	- - --- uu- uu-u u--	dactylic hexameter	masculine penthemimeral, hepthemimeral
ξεῖνε, τὸ μέν σε πρῶτον ἐγὼν εἰρήσομαι αὐτή·	-u u - - -u u- --uu --	dactylic hexameter	feminine penthemimeral, hepthemimeral, trithemimeral
τίς πόθεν εἰς ἀνδρῶν; τίς τοι τάδε εἵματ’ ἔδωκεν;	- uu - -- - - uu -u u--	dactylic hexameter	masculine penthemimeral, hepthemimeral, trithemimeral
οὐ δὴ φῇς ἐπὶ πόντον ἀλώμενος ἐνθάδ’ ἱκέσθαι;	- - - uu -u u-uu -u u--	dactylic hexameter	feminine penthemimeral, trithemimeral
τὴν δ’ἀπαμειβόμενος προσέφη πολύμητις Ὀδυσσεύς·	- uu-uu- uu- uu-u u--	dactylic hexameter	masculine penthemimeral, hepthemimeral
ἀργαλέον, βασίλεια, διηνεκέως ἀγορεῦσαι	-uu- uu-u u-uu- uu--	dactylic hexameter	feminine penthemimeral, trithemimeral
κήδε’, ἐπεί μοι πολλὰ δόσαν θεοὶ Οὐρανίωνες·	-u u- - -u u- uu -uu--	dactylic hexameter	feminine penthemimeral, hepthemimeral, trithemimeral
τοῦτο δέ τοι ἐρέω ὅ μ’ἀνείρεαι ἠδὲ μεταλλᾷς.	-u u - uu- u u-uu -u u--	dactylic hexameter	masculine penthemimeral, trithemimeral
Ὠγυγίη τις νῆσος ἀπόπροθεν εἰν ἁλὶ κεῖται·	-uu- - -u u-uu - uu --	dactylic hexameter	feminine penthemimeral, trithemimeral
ἔνθα μὲν Ἄτλαντος θυγάτηρ, δολόεσσα Καλυψὼ	-u u --- uu- uu-u u--	dactylic hexameter	masculine penthemimeral, hepthemimeral
ναίει ἐϋπλόκαμος, δεινὴ θεός· οὐδέ τις αὐτῇ	-u u-uu- -- uu -u u --	dactylic hexameter	masculine penthemimeral, hepthemimeral
μίσγεται οὔτε θεῶν οὔτε θνητῶν ἀνθρώπων.	-uu -u u- -- -- ---	dactylic hexameter	masculine penthemimeral, hepthemimeral
ἀλλ’ ἐμὲ τὸν δύστηνον ἐφέστιον ἤγαγε δαίμων	- uu - --u u-uu -uu --	dactylic hexameter	feminine penthemimeral, trithemimeral
οἶον, ἐπεί μοι νῆα θοὴν ἀργῆτι κεραυνῷ	-u u- - -u u- --u u--	dactylic hexameter	feminine penthemimeral, hepthemimeral, trithemimeral
Ζεὺς ἐλάσας ἐκέασσε μέσῳ ἐνὶ οἴνοπι πόντῳ.	- uu- uu-u u- uu -uu --	dactylic hexameter	feminine penthemimeral, hepthemimeral, trithemimeral
ἔνθ’ ἄλλοι μὲν πάντες ἀπέφθιθεν ἐσθλοὶ ἑταῖροι,	- -- - -u u-uu -u u--	dactylic hexameter	feminine penthemimeral, trithemimeral
αὐτὰρ ἐγὼ τρόπιν ἀγκὰς ἑλὼν νεὸς ἀμφιελίσσης	-u u- uu -u u- uu -uu--	dactylic hexameter	feminine penthemimeral, hepthemimeral, trithemimeral
ἐννῆμαρ φερόμην· δεκάτῃ δέ με νυκτὶ μελαίνῃ	--- uu- uu- u u -u u--	dactylic hexameter	masculine penthemimeral, hepthemimeral, trithemimeral
νῆσον ἐς Ὠγυγίην πέλασαν θεοί, ἔνθα Καλυψὼ	-u u -uu- uu- uu -u u--	dactylic hexameter	masculine penthemimeral, hepthemimeral
ναίει ἐϋπλόκαμος, δεινὴ θεός, ἥ με λαβοῦσα	-u u-uu- -- uu - u u--	dactylic hexameter	masculine penthemimeral, hepthemimeral
ἐνδυκέως ἐφίλει τε καὶ ἔτρεφεν ἠδὲ ἔφασκε	-uu- uu- u u -uu -u u--	dactylic hexameter	masculine penthemimeral, trithemimeral
θήσειν ἀθάνατον καὶ ἀγήραον ἤματα πάντα·	-- -uu- u u-uu -uu --	dactylic hexameter	masculine penthemimeral
ἀλλ’ ἐμὸν οὔ ποτε θυμὸν ἐνὶ στήθεσσιν ἔπειθεν.	- uu - uu -u u- --u u--	dactylic hexameter	feminine penthemimeral, hepthemimeral, trithemimeral
ἔνθα μὲν ἑπτάετες μένον ἔμπεδον, εἵματα δ’αἰεὶ	-u u -uu- uu -uu -uu --	dactylic hexameter	masculine penthemimeral
δάκρυσι δεύεσκον, τά μοι ἄμβροτα δῶκε Καλυψώ·	-uu --- u u -uu -u u--	dactylic hexameter	masculine penthemimeral
ἀλλ’ ὅτε δὴ ὄγδοόν μοι ἐπιπλόμενον ἔτος ἦλθε,	- uu - uu- u u-uu- uu --	dactylic hexameter	masculine penthemimeral, trithemimeral
καὶ τότε δή μ’ἐκέλευσεν ἐποτρύνουσα νέεσθαι	- uu - uu-u u---u u--	dactylic hexameter	feminine penthemimeral, trithemimeral
Ζηνὸς ὑπ’ ἀγγελίης, ἢ καὶ νόος ἐτράπετ’ αὐτῆς.	-u u -uu- - - uu -uu --	dactylic hexameter	masculine penthemimeral, hepthemimeral
πέμπε δ’ἐπὶ σχεδίης πολυδέσμου, πολλὰ δ’ἔδωκε,	-u u- uu- uu-- -u u--	dactylic hexameter	masculine penthemimeral, trithemimeral
σῖτον καὶ μέθυ ἡδύ, καὶ ἄμβροτα εἵματα ἕσσεν,	-- - uu -u u -uu -uu --	dactylic hexameter	feminine penthemimeral, trithemimeral
οὖρον δὲ προέηκεν ἀπήμονά τε λιαρόν τε.	-- - uu-u u-uu - uu- -	dactylic hexameter	feminine penthemimeral, trithemimeral
ἑπτὰ δὲ καὶ δέκα μὲν πλέον ἤματα ποντοπορεύων,	-u u - uu - uu -uu -uu--	dactylic hexameter	masculine penthemimeral, trithemimeral
ὀκτωκαιδεκάτῃ δ’ἐφάνη ὄρεα σκιόεντα	---uu- uu- uu- uu--	dactylic hexameter	masculine penthemimeral, hepthemimeral
γαίης ὑμετέρης, γήθησε δέ μοι φίλον ἦτορ	-- -uu- --u u - uu --	dactylic hexameter	masculine penthemimeral
δυσμόρῳ· ἦ γὰρ ἔμελλον ἔτι ξυνέσεσθαι ὀϊζυῖ	-uu - u u-u u- uu-u u--	dactylic hexameter	feminine penthemimeral, hepthemimeral, trithemimeral
πολλῇ, τήν μοι ἐπῶρσε Ποσειδάων ἐνοσίχθων,	-- - u u-u u--- uu--	dactylic hexameter	feminine penthemimeral, trithemimeral
ὅς μοι ἐφορμήσας ἀνέμους κατέδησε κέλευθον,	- u u--- uu- uu-u u--	dactylic hexameter	masculine penthemimeral, hepthemimeral
ὤρινεν δὲ θάλασσαν ἀθέσφατον, οὐδέ τι κῦμα	--- u u-u u-uu -u u --	dactylic hexameter	feminine penthemimeral, trithemimeral
εἴα ἐπὶ σχεδίης ἁδινὰ στενάχοντα φέρεσθαι.	-u u- uu- uu- uu-u u--	dactylic hexameter	masculine penthemimeral, hepthemimeral, trithemimeral
τὴν μὲν ἔπειτα θύελλα διεσκέδασ’· αὐτὰρ ἔγωγε	- u u-u u-u u-uu -u u--	dactylic hexameter	feminine penthemimeral
νηχόμενος τόδε λαῖτμα διέτμαγον, ὄφρα με γαίῃ	-uu- uu -u u-uu -u u --	dactylic hexameter	feminine penthemimeral, trithemimeral
ὑμετέρῃ ἐπέλασσε φέρων ἄνεμός τε καὶ ὕδωρ.	-uu- uu-u u- uu- u u --	dactylic hexameter	feminine penthemimeral, hepthemimeral, trithemimeral
ἔνθα κέ μ’ἐκβαίνοντα βιήσατο κῦμ’ ἐπὶ χέρσου,	-u u ---u u-uu - uu --	dactylic hexameter	feminine penthemimeral
πέτρῃς πρὸς μεγάλῃσι βαλὸν καὶ ἀτερπέϊ χώρῳ·	-- - uu-u u- u u-uu --	dactylic hexameter	feminine penthemimeral, hepthemimeral, trithemimeral
ἀλλ’ ἀναχασσάμενος νῆχον πάλιν, ἧος ἐπῆλθον	- uu-uu- -- uu -u u--	dactylic hexameter	masculine penthemimeral, hepthemimeral
ἐς ποταμόν, τῇ δή μοι ἐείσατο χῶρος ἄριστος,	- uu- - - u u-uu -u u--	dactylic hexameter	masculine penthemimeral, trithemimeral
λεῖος πετράων, καὶ ἐπὶ σκέπας ἦν ἀνέμοιο.	-- --- u u- uu - uu--	dactylic hexameter	masculine penthemimeral, hepthemimeral
ἐκ δ’ἔπεσον θυμηγερέων, ἐπὶ δ’ἀμβροσίη νὺξ	- uu- --uu- uu -uu- -	dactylic hexameter	hepthemimeral, trithemimeral
ἤλυθ’. ἐγὼ δ’ἀπάνευθε διϊπετέος ποταμοῖο	-u u- uu-u u-uu- uu--	dactylic hexameter	feminine penthemimeral, trithemimeral
ἐκβὰς ἐν θάμνοισι κατέδραθον, ἀμφὶ δὲ φύλλα	-- - --u u-uu -u u --	dactylic hexameter	feminine penthemimeral, trithemimeral
ἠφυσάμην· ὕπνον δὲ θεὸς κατ’ ἀπείρονα χεῦεν.	-uu- -- u u- u u-uu --	dactylic hexameter	masculine penthemimeral, hepthemimeral, trithemimeral
ἔνθα μὲν ἐν φύλλοισι φίλον τετιημένος ἦτορ	-u u - --u u- uu-uu --	dactylic hexameter	feminine penthemimeral, hepthemimeral, trithemimeral
εὗδον παννύχιος καὶ ἐπ’ ἠῶ καὶ μέσον ἦμαρ.	-- -uu- u u -- - uu --	dactylic hexameter	masculine penthemimeral
δύσετό τ’ἠέλιος καί με γλυκὺς ὕπνος ἀνῆκεν.	-uu -uu- - - uu -u u--	dactylic hexameter	masculine penthemimeral, hepthemimeral
ἀμφιπόλους δ’ἐπὶ θινὶ τεῆς ἐνόησα θυγατρὸς	-uu- uu -u u- uu-u u--	dactylic hexameter	feminine penthemimeral, hepthemimeral, trithemimeral
παιζούσας, ἐν δ’αὐτὴ ἔην ἐϊκυῖα θεῇσι·	--- - -u u- uu-u u--	dactylic hexameter	feminine penthemimeral, hepthemimeral, trithemimeral
τὴν ἱκέτευσ’· ἡ δ’οὔ τι νοήματος ἤμβροτεν ἐσθλοῦ,	- uu- - - u u-uu -uu --	dactylic hexameter	masculine penthemimeral, trithemimeral
ὡς οὐκ ἂν ἔλποιο νεώτερον ἀντιάσαντα	- - - --u u-uu -uu--	dactylic hexameter	feminine penthemimeral, trithemimeral
ἐρξέμεν· αἰεὶ γάρ τε νεώτεροι ἀφραδέουσιν.	-uu -- - u u-uu -uu--	dactylic hexameter	masculine penthemimeral
ἥ μοι σῖτον ἔδωκεν ἅλις ἠδ’ αἴθοπα οἶνον	- - -u u-u u- - -uu --	dactylic hexameter	feminine penthemimeral, hepthemimeral
καὶ λοῦσ’ ἐν ποταμῷ καί μοι τάδε εἵματ’ ἔδωκε.	- - - uu- - - uu -u u--	dactylic hexameter	masculine penthemimeral, hepthemimeral, trithemimeral
ταῦτά τοι ἀχνύμενός περ ἀληθείην κατέλεξα.	-u u -uu- u u--- uu--	dactylic hexameter	masculine penthemimeral
τὸν δ’αὖτ’ Ἀλκίνοος ἀπαμείβετο φώνησέν τε·	- - -uu- uu-uu --- -	dactylic hexameter	masculine penthemimeral
ξεῖν’, ἤτοι μὲν τοῦτο γ’ ἐναίσιμον οὐκ ἐνόησε	- -- - -u u-uu - uu--	dactylic hexameter	feminine penthemimeral, trithemimeral
παῖς ἐμή, οὕνεκά σ’οὔ τι nbsp;μετ’ ἀμφιπόλοισι γυναιξὶν	- uu -uu - u u -uu-u u--	dactylic hexameter	masculine penthemimeral
ἦγεν ἐς ἡμέτερον, σὺ δ’ἄρα πρώτην ἱκέτευσας.	-u u -uu- u u- -- uu--	dactylic hexameter	masculine penthemimeral, hepthemimeral
τὸν δ’ἀπαμειβόμενος προσέφη πολύμητις Ὀδυσσεύς·	- uu-uu- uu- uu-u u--	dactylic hexameter	masculine penthemimeral, hepthemimeral
ἥρως, μή μοι τοὔνεκ’ ἀμύμονα νείκεε κούρην·	-- - - -u u-uu -uu --	dactylic hexameter	feminine penthemimeral, trithemimeral
ἡ μὲν γάρ μ’ἐκέλευε σὺν ἀμφιπόλοισιν ἕπεσθαι,	- - - uu-u u -uu-u u--	dactylic hexameter	feminine penthemimeral, trithemimeral
ἀλλ’ ἐγὼ οὐκ ἔθελον δείσας αἰσχυνόμενός τε,	- uu - uu- -- --uu- -	dactylic hexameter	masculine penthemimeral, hepthemimeral, trithemimeral
μή πως καὶ σοὶ θυμὸς ἐπισκύσσαιτο ἰδόντι·	- - - - -u u---u u--	dactylic hexameter	feminine penthemimeral, trithemimeral
δύσζηλοι γάρ τ’εἰμὲν ἐπὶ χθονὶ φῦλ’ ἀνθρώπων.	--- - -u u- uu - ---	dactylic hexameter	feminine penthemimeral, hepthemimeral, trithemimeral
τὸν δ’αὖτ’ Ἀλκίνοος ἀπαμείβετο φώνησέν τε·	- - -uu- uu-uu --- -	dactylic hexameter	masculine penthemimeral
ξεῖν’, οὔ μοι τοιοῦτον ἐνὶ στήθεσσι φίλον κῆρ	- - - --u u- --u u- -	dactylic hexameter	feminine penthemimeral, hepthemimeral, trithemimeral
μαψιδίως κεχολῶσθαι· ἀμείνω δ’αἴσιμα πάντα.	-uu- uu-u u-- -uu --	dactylic hexameter	feminine penthemimeral, trithemimeral
αἲ γάρ, Ζεῦ τε πάτερ καὶ Ἀθηναίη καὶ Ἄπολλον,	- - - u u- u u--- u u--	dactylic hexameter	masculine penthemimeral, trithemimeral
τοῖος ἐὼν οἷός ἐσσι, τά τε φρονέων ἅ τ’ἐγώ περ,	-u u- uu -u u - uu- u u- -	dactylic hexameter	feminine penthemimeral, hepthemimeral, trithemimeral
παῖδά τ’ἐμὴν ἐχέμεν καὶ ἐμὸς γαμβρὸς καλέεσθαι	-u u- uu- u u- -- uu--	dactylic hexameter	masculine penthemimeral, hepthemimeral, trithemimeral
αὖθι μένων· οἶκον δέ κ’ἐγὼ καὶ κτήματα δοίην,	-u u- -- u u- - -uu --	dactylic hexameter	masculine penthemimeral, hepthemimeral, trithemimeral
εἴ κ’ἐθέλων γε μένοις· ἀέκοντα δέ σ’οὔ τις ἐρύξει	- uu- u u- uu-u u - u u--	dactylic hexameter	masculine penthemimeral, trithemimeral
Φαιήκων· μὴ τοῦτο φίλον Διῒ πατρὶ γένοιτο.	--- - -u u- uu -u u--	dactylic hexameter	feminine penthemimeral, hepthemimeral, trithemimeral
πομπὴν δ’ἐς τόδ’ ἐγὼ τεκμαίρομαι, ὄφρ’ ἐῢ εἰδῇς,	-- - u u- --uu - uu --	dactylic hexameter	masculine penthemimeral, trithemimeral
αὔριον ἔς· τῆμος δὲ σὺ μὲν δεδμημένος ὕπνῳ	-uu - -- u u - --uu --	dactylic hexameter	masculine penthemimeral, hepthemimeral, trithemimeral
λέξεαι, οἱ δ’ἐλόωσι γαλήνην, ὄφρ’ ἂν ἵκηαι	-uu - uu-u u-- - u u--	dactylic hexameter	feminine penthemimeral, trithemimeral
πατρίδα σὴν καὶ δῶμα, καὶ εἴ πού τοι φίλον ἐστίν,	-uu - - -u u - - - uu --	dactylic hexameter	feminine penthemimeral, hepthemimeral, trithemimeral
εἴ περ καὶ μάλα πολλὸν ἑκαστέρω ἔστ’ Εὐβοίης,	- - - uu -u u-uu - ---	dactylic hexameter	feminine penthemimeral, trithemimeral
τὴν γὰρ τηλοτάτω φάσ’ ἔμμεναι, οἵ μιν ἴδοντο	- - -uu- - -uu - u u--	dactylic hexameter	masculine penthemimeral
λαῶν ἡμετέρων, ὅτε τε ξανθὸν Ῥαδάμανθυν	-- -uu- uu - -- uu--	dactylic hexameter	masculine penthemimeral, hepthemimeral
ἦγον ἐποψόμενον Τιτυὸν Γαιήϊον υἱόν.	-u u-uu- uu- --uu --	dactylic hexameter	masculine penthemimeral, hepthemimeral
καὶ μὲν οἱ ἔνθ’ ἦλθον καὶ ἄτερ καμάτοιο τέλεσσαν	- u u - -- u u- uu-u u--	dactylic hexameter	masculine penthemimeral, hepthemimeral, trithemimeral
ἤματι τῷ αὐτῷ καὶ ἀπήνυσαν οἴκαδ’ ὀπίσσω.	-uu - -- u u-uu -u u--	dactylic hexameter	masculine penthemimeral, trithemimeral
εἰδήσεις δὲ καὶ αὐτὸς ἐνὶ φρεσὶν ὅσσον ἄρισται	--- u u -u u- uu -u u--	dactylic hexameter	feminine penthemimeral, hepthemimeral, trithemimeral
νῆες ἐμαὶ καὶ κοῦροι ἀναρρίπτειν ἅλα πηδῷ.	-u u- - -u u--- uu --	dactylic hexameter	feminine penthemimeral, trithemimeral
ὣς φάτο, γήθησεν δὲ πολύτλας δῖος Ὀδυσσεύς,	- uu --- u u-- -u u--	dactylic hexameter	masculine penthemimeral
εὐχόμενος δ’ἄρα εἶπεν, ἔπος τ’ἔφατ’ ἔκ τ’ὀνόμαζε·	-uu- uu -u u- uu - uu--	dactylic hexameter	feminine penthemimeral, hepthemimeral, trithemimeral
Ζεῦ πάτερ, αἴθ’ ὅσα εἶπε τελευτήσειεν ἅπαντα	- uu - uu -u u---u u--	dactylic hexameter	feminine penthemimeral, trithemimeral
Ἀλκίνοος· τοῦ μέν κεν ἐπὶ ζείδωρον ἄρουραν	-uu- - - u u- --u u--	dactylic hexameter	masculine penthemimeral, hepthemimeral, trithemimeral
ἄσβεστον κλέος εἴη, ἐγὼ δέ κε πατρίδ’ ἱκοίμην.	--- uu -u u- u u -u u--	dactylic hexameter	feminine penthemimeral, hepthemimeral, trithemimeral
ὣς οἱ μὲν τοιαῦτα πρὸς ἀλλήλους ἀγόρευον·	- - - --u u --- uu--	dactylic hexameter	feminine penthemimeral, trithemimeral
κέκλετο δ’Ἀρήτη λευκώλενος ἀμφιπόλοισι	-uu --- --uu -uu--	dactylic hexameter	masculine penthemimeral
δέμνι’ ὑπ’ αἰθούσῃ θέμεναι καὶ ῥήγεα καλὰ	-u u --- uu- - -uu --	dactylic hexameter	masculine penthemimeral, hepthemimeral
πορφύρε’ ἐμβαλέειν, στορέσαι τ’ἐφύπερθε τάπητας	-uu -uu- uu- uu-u u--	dactylic hexameter	masculine penthemimeral, hepthemimeral
χλαίνας τ’ἐνθέμεναι οὔλας καθύπερθεν ἕσασθαι.	-- -uu- -- uu-u u--	dactylic hexameter	masculine penthemimeral, hepthemimeral
αἱ δ’ἴσαν ἐκ μεγάροιο δάος μετὰ χερσὶν ἔχουσαι·	- uu - uu-u u- uu -u u--	dactylic hexameter	feminine penthemimeral, hepthemimeral, trithemimeral
αὐτὰρ ἐπεὶ στόρεσαν πυκινὸν λέχος ἐγκονέουσαι,	-u u- uu- uu- uu -uu--	dactylic hexameter	masculine penthemimeral, hepthemimeral, trithemimeral
ὤτρυνον δ’Ὀδυσῆα παριστάμεναι ἐπέεσσιν·	--- uu-u u-uu- uu--	dactylic hexameter	feminine penthemimeral, trithemimeral
ὄρσο κέων, ὦ ξεῖνε· πεποίηται δέ τοι εὐνή.	-u u- - -u u--- u u --	dactylic hexameter	feminine penthemimeral, trithemimeral
ὣς φάν, τῷ δ’ἀσπαστὸν ἐείσατο κοιμηθῆναι.	- - - --u u-uu ----	dactylic hexameter	feminine penthemimeral, trithemimeral
ὣς ὁ μὲν ἔνθα καθεῦδε πολύτλας δῖος Ὀδυσσεὺς	- u u -u u-u u-- -u u--	dactylic hexameter	feminine penthemimeral
τρητοῖς ἐν λεχέεσσιν ὑπ’ αἰθούσῃ ἐριδούπῳ·	-- - uu-u u --- uu--	dactylic hexameter	feminine penthemimeral, trithemimeral
Ἀλκίνοος δ’ἄρα λέκτο μυχῷ δόμου ὑψηλοῖο,	-uu- uu -u u- uu ----	dactylic hexameter	feminine penthemimeral, hepthemimeral, trithemimeral
πὰρ δὲ γυνὴ δέσποινα λέχος πόρσυνε καὶ εὐνήν.	- u u- --u u- --u u --	dactylic hexameter	feminine penthemimeral, hepthemimeral, trithemimeral
