ἄνδρα μοι ἔννεπε, μοῦσα, πολύτροπον, ὃς μάλα πολλὰ	-u u -uu -u u-uu - uu --	dactylic hexameter	feminine penthemimeral
πλάγχθη, ἐπεὶ Τροίης ἱερὸν πτολίεθρον ἔπερσεν·	-u u- -- uu- uu-u u--	dactylic hexameter	masculine penthemimeral, hepthemimeral, trithemimeral
πολλῶν δ’ἀνθρώπων ἴδεν ἄστεα καὶ νόον ἔγνω,	-- --- uu -uu - uu --	dactylic hexameter	masculine penthemimeral
πολλὰ δ’ὅ γ’ἐν πόντῳ πάθεν ἄλγεα ὃν κατὰ θυμόν,	-u u - -- uu -uu - uu --	dactylic hexameter	masculine penthemimeral, trithemimeral
ἀρνύμενος ἥν τε ψυχὴν καὶ νόστον ἑταίρων.	-uu- - - -- - -u u--	dactylic hexameter	masculine penthemimeral, hepthemimeral, trithemimeral
ἀλλ’ οὐδ’ ὣς ἑτάρους ἐρρύσατο, ἱέμενός περ·	- - - uu- --uu -uu- -	dactylic hexameter	masculine penthemimeral, trithemimeral
αὐτῶν γὰρ σφετέρῃσιν ἀτασθαλίῃσιν ὄλοντο,	-- - uu-u u-uu-u u--	dactylic hexameter	feminine penthemimeral, trithemimeral
νήπιοι, οἳ κατὰ βοῦς Ὑπερίονος Ἠελίοιο	-uu - uu - uu-uu -uu--	dactylic hexameter	masculine penthemimeral, trithemimeral
ἤσθιον· αὐτὰρ ὁ τοῖσιν ἀφείλετο νόστιμον ἦμαρ.	-uu -u u -u u-uu -uu --	dactylic hexameter	feminine penthemimeral
τῶν ἁμόθεν γε, θεά, θύγατερ Διός, εἰπὲ καὶ ἡμῖν.	- uu- u u- uu- uu -u u --	dactylic hexameter	masculine penthemimeral, hepthemimeral, trithemimeral
ἔνθ’ ἄλλοι μὲν πάντες, ὅσοι φύγον αἰπὺν ὄλεθρον,	- -- - -u u- uu -u u--	dactylic hexameter	feminine penthemimeral, hepthemimeral, trithemimeral
οἴκοι ἔσαν, πόλεμόν τε πεφευγότες ἠδὲ θάλασσαν·	-u u- uu- u u-uu -u u--	dactylic hexameter	masculine penthemimeral, trithemimeral
τὸν δ’οἶον νόστου κεχρημένον ἠδὲ γυναικὸς	- -- -- --uu -u u--	dactylic hexameter	masculine penthemimeral, trithemimeral
νύμφη πότνι’ ἔρυκε Καλυψὼ δῖα θεάων	-- -u u-u u-- -u u--	dactylic hexameter	feminine penthemimeral
ἐν σπέσσι γλαφυροῖσι, λιλαιομένη πόσιν εἶναι.	- -- uu-u u-uu- uu --	dactylic hexameter	feminine penthemimeral, trithemimeral
ἀλλ’ ὅτε δὴ ἔτος ἦλθε περιπλομένων ἐνιαυτῶν,	- uu - uu -u u-uu- uu--	dactylic hexameter	feminine penthemimeral, trithemimeral
τῷ οἱ ἐπεκλώσαντο θεοὶ οἶκόνδε νέεσθαι	- u u---u u- --u u--	dactylic hexameter	feminine penthemimeral, hepthemimeral
εἰς Ἰθάκην, οὐδ’ ἔνθα πεφυγμένος ἦεν ἀέθλων	- uu- - -u u-uu -u u--	dactylic hexameter	feminine penthemimeral, trithemimeral
καὶ μετὰ οἷσι φίλοισι. θεοὶ δ’ἐλέαιρον ἅπαντες	- uu -u u-u u- uu-u u--	dactylic hexameter	feminine penthemimeral, hepthemimeral
νόσφι Ποσειδάωνος· ὁ δ’ἀσπερχὲς μενέαινεν	-u u---u u --- uu--	dactylic hexameter	feminine penthemimeral
ἀντιθέῳ Ὀδυσῆι πάρος ἣν γαῖαν ἱκέσθαι.	-uu- uu-u u- - -u u--	dactylic hexameter	feminine penthemimeral, hepthemimeral, trithemimeral
ἀλλ’ ὁ μὲν Αἰθίοπας μετεκίαθε τηλόθ’ ἐόντας,	- u u -uu- uu-uu -u u--	dactylic hexameter	masculine penthemimeral
Αἰθίοπας τοὶ διχθὰ δεδαίαται, ἔσχατοι ἀνδρῶν,	-uu- - -u u-uu -uu --	dactylic hexameter	feminine penthemimeral, trithemimeral
οἱ μὲν δυσομένου Ὑπερίονος οἱ δ’ἀνιόντος,	- - -uu- uu-uu - uu--	dactylic hexameter	masculine penthemimeral
ἀντιόων ταύρων τε καὶ ἀρνειῶν ἑκατόμβης.	-uu- -- u u --- uu--	dactylic hexameter	masculine penthemimeral, trithemimeral
ἔνθ’ ὅ γ’ἐτέρπετο δαιτὶ παρήμενος· οἱ δὲ δὴ ἄλλοι	- u u-uu -u u-uu - u u --	dactylic hexameter	feminine penthemimeral
Ζηνὸς ἐνὶ μεγάροισιν Ὀλυμπίου ἁθρόοι ἦσαν.	-u u- uu-u u-uu -uu --	dactylic hexameter	feminine penthemimeral, trithemimeral
τοῖσι δὲ μύθων ἦρχε πατὴρ ἀνδρῶν τε θεῶν τε·	-u u -- -u u- -- u u- -	dactylic hexameter	feminine penthemimeral, hepthemimeral
μνήσατο γὰρ κατὰ θυμὸν ἀμύμονος Αἰγίσθοιο,	-uu - uu -u u-uu ----	dactylic hexameter	feminine penthemimeral, trithemimeral
τόν ῥ’Ἀγαμεμνονίδης τηλεκλυτὸς ἔκταν’ Ὀρέστης·	- uu-uu- --uu -u u--	dactylic hexameter	masculine penthemimeral
τοῦ ὅ γ’ἐπιμνησθεὶς ἔπε’ ἀθανάτοισι μετηύδα·	- u u--- uu -uu-u u--	dactylic hexameter	masculine penthemimeral
ὢ πόποι, οἷον δή νυ θεοὺς βροτοὶ αἰτιόωνται·	- uu -- - u u- uu -uu--	dactylic hexameter	masculine penthemimeral, hepthemimeral
ἐξ ἡμέων γάρ φασι κάκ’ ἔμμεναι, οἱ δὲ καὶ αὐτοὶ	- -- - -u u -uu - u u --	dactylic hexameter	feminine penthemimeral, trithemimeral
σφῇσιν ἀτασθαλίῃσιν ὑπὲρ μόρον ἄλγε’ ἔχουσιν,	-u u-uu-u u- uu -u u--	dactylic hexameter	feminine penthemimeral, hepthemimeral
ὡς καὶ νῦν Αἴγισθος ὑπὲρ μόρον Ἀτρεΐδαο	- - - --u u- uu -uu--	dactylic hexameter	feminine penthemimeral, hepthemimeral, trithemimeral
γῆμ’ ἄλοχον μνηστήν, τὸν δ’ἔκτανε νοστήσαντα,	- uu- -- - -uu ----	dactylic hexameter	masculine penthemimeral, trithemimeral
εἰδὼς αἰπὺν ὄλεθρον, ἐπεὶ πρό οἱ εἴπομεν ἡμεῖς,	-- -u u-u u- u u -uu --	dactylic hexameter	feminine penthemimeral, hepthemimeral
Ἑρμείαν πέμψαντες, ἐύσκοπον ἀργεϊφόντην,	--- --u u-uu -uu--	dactylic hexameter	feminine penthemimeral, trithemimeral
μήτ’ αὐτὸν κτείνειν μήτε μνάασθαι ἄκοιτιν·	- -- -- -- --u u--	dactylic hexameter	masculine penthemimeral, hepthemimeral, trithemimeral
ἐκ γὰρ Ὀρέσταο τίσις ἔσσεται Ἀτρεΐδαο,	- u u--- uu -uu -uu--	dactylic hexameter	masculine penthemimeral
ὁππότ’ ἂν ἡβήσῃ τε καὶ ἧς ἱμείρεται αἴης.	-u u --- u u - --uu --	dactylic hexameter	masculine penthemimeral, hepthemimeral
ὣς ἔφαθ’ Ἑρμείας, ἀλλ’ οὐ φρένας Αἰγίσθοιο	- uu --- - - uu ----	dactylic hexameter	masculine penthemimeral, hepthemimeral
πεῖθ’ ἀγαθὰ φρονέων· νῦν δ’ἁθρόα πάντ’ ἀπέτισεν.	- uu- uu- - -uu - uu--	dactylic hexameter	masculine penthemimeral, trithemimeral
τὸν δ’ἠμείβετ’ ἔπειτα θεά, γλαυκῶπις Ἀθήνη·	- --u u-u u- --u u--	dactylic hexameter	feminine penthemimeral, hepthemimeral
ὦ πάτερ ἡμέτερε Κρονίδη, ὕπατε κρειόντων,	- uu -uu- uu- uu- ---	dactylic hexameter	masculine penthemimeral, hepthemimeral
καὶ λίην κεῖνός γε ἐοικότι κεῖται ὀλέθρῳ·	- -- -- u u-uu -u u--	dactylic hexameter	masculine penthemimeral, trithemimeral
ὡς ἀπόλοιτο καὶ ἄλλος, ὅτις τοιαῦτά γε ῥέζοι·	- uu-u u -u u- --u u --	dactylic hexameter	feminine penthemimeral, hepthemimeral
ἀλλά μοι ἀμφ’ Ὀδυσῆι δαΐφρονι δαίεται ἦτορ,	-u u - uu-u u-uu -uu --	dactylic hexameter	feminine penthemimeral, trithemimeral
δυσμόρῳ, ὃς δὴ δηθὰ φίλων ἄπο πήματα πάσχει	-uu - - -u u- uu -uu --	dactylic hexameter	feminine penthemimeral, hepthemimeral, trithemimeral
νήσῳ ἐν ἀμφιρύτῃ, ὅθι τ’ὀμφαλός ἐστι θαλάσσης.	-u u -uu- uu -uu -u u--	dactylic hexameter	masculine penthemimeral
νῆσος δενδρήεσσα, θεὰ δ’ἐν δώματα ναίει,	-- ---u u- - -uu --	dactylic hexameter	feminine penthemimeral, hepthemimeral
Ἄτλαντος θυγάτηρ ὀλοόφρονος, ὅς τε θαλάσσης	--- uu- uu-uu - u u--	dactylic hexameter	masculine penthemimeral, trithemimeral
πάσης βένθεα οἶδεν, ἔχει δέ τε κίονας αὐτὸς	-- -uu -u u- u u -uu --	dactylic hexameter	feminine penthemimeral, hepthemimeral
μακράς, αἳ γαῖάν τε καὶ οὐρανὸν ἀμφὶς ἔχουσιν.	-- - -- u u -uu -u u--	dactylic hexameter	masculine penthemimeral, trithemimeral
τοῦ θυγάτηρ δύστηνον ὀδυρόμενον κατερύκει,	- uu- --u u-uu- uu--	dactylic hexameter	feminine penthemimeral, trithemimeral
αἰεὶ δὲ μαλακοῖσι καὶ αἱμυλίοισι λόγοισιν	-- - uu-u u -uu-u u--	dactylic hexameter	feminine penthemimeral, trithemimeral
θέλγει, ὅπως Ἰθάκης ἐπιλήσεται· αὐτὰρ Ὀδυσσεύς,	-u u- uu- uu-uu -u u--	dactylic hexameter	masculine penthemimeral, trithemimeral
ἱέμενος καὶ καπνὸν ἀποθρᾐσκοντα νοῆσαι	-uu- - -u u---u u--	dactylic hexameter	feminine penthemimeral, trithemimeral
ἧς γαίης, θανέειν ἱμείρεται. οὐδέ νυ σοί περ	- -- uu- --uu -u u - -	dactylic hexameter	masculine penthemimeral, trithemimeral
ἐντρέπεται φίλον ἦτορ, Ὀλύμπιε. οὔ νύ τ’Ὀδυσσεὺς	-uu- uu -u u-uu - u u--	dactylic hexameter	feminine penthemimeral, trithemimeral
Ἀργείων παρὰ νηυσὶ χαρίζετο ἱερὰ ῥέζων	--- uu -u u-uu -uu --	dactylic hexameter	feminine penthemimeral, trithemimeral
Τροίῃ ἐν εὐρείῃ; τί νύ οἱ τόσον ὠδύσαο, Ζεῦ;	-u u --- u u - uu -uu- -	dactylic hexameter	masculine penthemimeral, hepthemimeral
τὴν δ’ἀπαμειβόμενος προσέφη νεφεληγερέτα Ζεύς·	- uu-uu- uu- uu-uu- -	dactylic hexameter	masculine penthemimeral, hepthemimeral
τέκνον ἐμόν, ποῖόν σε ἔπος φύγεν ἕρκος ὀδόντων.	-u u- -- u u- uu -u u--	dactylic hexameter	masculine penthemimeral, hepthemimeral, trithemimeral
πῶς ἂν ἔπειτ’ Ὀδυσῆος ἐγὼ θείοιο λαθοίμην,	- u u- uu-u u- --u u--	dactylic hexameter	feminine penthemimeral, hepthemimeral, trithemimeral
ὃς περὶ μὲν νόον ἐστὶ βροτῶν, περὶ δ’ἱρὰ θεοῖσιν	- uu - uu -u u- uu -u u--	dactylic hexameter	feminine penthemimeral, hepthemimeral, trithemimeral
ἀθανάτοισιν ἔδωκε, τοὶ οὐρανὸν εὐρὺν ἔχουσιν;	-uu-u u-u u -uu -u u--	dactylic hexameter	feminine penthemimeral
ἀλλὰ Ποσειδάων γαιήοχος ἀσκελὲς αἰεὶ	-u u--- --uu -uu --	dactylic hexameter	masculine penthemimeral
Κύκλωπος κεχόλωται, ὃν ὀφθαλμοῦ ἀλάωσεν,	--- uu-u u --- uu--	dactylic hexameter	feminine penthemimeral, trithemimeral
ἀντίθεον Πολύφημον, ὅου κράτος ἐστὶ μέγιστον	-uu- uu-u u- uu -u u--	dactylic hexameter	feminine penthemimeral, hepthemimeral, trithemimeral
πᾶσιν Κυκλώπεσσι· Θόωσα δέ μιν τέκε νύμφη,	-- ---u u-u u - uu --	dactylic hexameter	feminine penthemimeral
Φόρκυνος θυγάτηρ ἁλὸς ἀτρυγέτοιο μέδοντος,	--- uu- uu -uu-u u--	dactylic hexameter	masculine penthemimeral, trithemimeral
ἐν σπέσσι γλαφυροῖσι Ποσειδάωνι μιγεῖσα.	- -- uu-u u---u u--	dactylic hexameter	feminine penthemimeral, trithemimeral
ἐκ τοῦ δὴ Ὀδυσῆα Ποσειδάων ἐνοσίχθων	- - - uu-u u--- uu--	dactylic hexameter	feminine penthemimeral, trithemimeral
οὔ τι κατακτείνει, πλάζει δ’ἀπὸ πατρίδος αἴης.	- u u--- -- uu -uu --	dactylic hexameter	masculine penthemimeral, hepthemimeral
ἀλλ’ ἄγεθ’, ἡμεῖς οἵδε περιφραζώμεθα πάντες	- uu -- -u u---uu --	dactylic hexameter	feminine penthemimeral
νόστον, ὅπως ἔλθῃσι· Ποσειδάων δὲ μεθήσει	-u u- --u u--- u u--	dactylic hexameter	feminine penthemimeral, trithemimeral
ὃν χόλον· οὐ μὲν γὰρ τι δυνήσεται ἀντία πάντων	- uu - - - u u-uu -uu --	dactylic hexameter	masculine penthemimeral, trithemimeral
ἀθανάτων ἀέκητι θεῶν ἐριδαινέμεν οἶος.	-uu- uu-u u- uu-uu --	dactylic hexameter	feminine penthemimeral, hepthemimeral, trithemimeral
τὸν δ’ἠμείβετ’ ἔπειτα θεά, γλαυκῶπις Ἀθήνη·	- --u u-u u- --u u--	dactylic hexameter	feminine penthemimeral, hepthemimeral
ὦ πάτερ ἡμέτερε Κρονίδη, ὕπατε κρειόντων,	- uu -uu- uu- uu- ---	dactylic hexameter	masculine penthemimeral, hepthemimeral
εἰ μὲν δὴ νῦν τοῦτο φίλον μακάρεσσι θεοῖσιν,	- - - - -u u- uu-u u--	dactylic hexameter	feminine penthemimeral, hepthemimeral, trithemimeral
νοστῆσαι Ὀδυσῆα πολύφρονα ὅνδε δόμονδε,	--- uu-u u-uu -u u--	dactylic hexameter	feminine penthemimeral, trithemimeral
Ἑρμείαν μὲν ἔπειτα διάκτορον ἀργεϊφόντην	--- u u-u u-uu -uu--	dactylic hexameter	feminine penthemimeral, trithemimeral
νῆσον ἐς Ὠγυγίην ὀτρύνομεν, ὄφρα τάχιστα	-u u -uu- --uu -u u--	dactylic hexameter	masculine penthemimeral
νύμφῃ ἐυπλοκάμῳ εἴπῃ νημερτέα βουλήν,	-u u-uu- -- --uu --	dactylic hexameter	masculine penthemimeral, hepthemimeral
νόστον Ὀδυσσῆος ταλασίφρονος, ὥς κε νέηται·	-u u--- uu-uu - u u--	dactylic hexameter	masculine penthemimeral
αὐτὰρ ἐγὼν Ἰθάκηνδ’ ἐσελεύσομαι, ὄφρα οἱ υἱὸν	-u u- uu- uu-uu -u u --	dactylic hexameter	masculine penthemimeral, trithemimeral
μᾶλλον ἐποτρύνω καί οἱ μένος ἐν φρεσὶ θείω,	-u u--- - - uu - uu --	dactylic hexameter	masculine penthemimeral, hepthemimeral
εἰς ἀγορὴν καλέσαντα κάρη κομόωντας Ἀχαιοὺς	- uu- uu-u u- uu-u u--	dactylic hexameter	feminine penthemimeral, hepthemimeral, trithemimeral
πᾶσι μνηστήρεσσιν ἀπειπέμεν, οἵ τέ οἱ αἰεὶ	-- ---u u-uu - u u --	dactylic hexameter	feminine penthemimeral
μῆλ’ ἁδινὰ σφάζουσι καὶ εἰλίποδας ἕλικας βοῦς.	- uu- --u u -uu- uu- -	dactylic hexameter	feminine penthemimeral, trithemimeral
πέμψω δ’ἐς Σπάρτην τε καὶ ἐς Πύλον ἠμαθόεντα	-- - -- u u - uu -uu--	dactylic hexameter	masculine penthemimeral, hepthemimeral, trithemimeral
νόστον πευσόμενον πατρὸς φίλου, ἤν που ἀκούσῃ,	-- -uu- -- uu - u u--	dactylic hexameter	masculine penthemimeral, hepthemimeral
ἠδ’ ἵνα μιν κλέος ἐσθλὸν ἐν ἀνθρώποισιν ἔχῃσιν.	- uu - uu -u u ---u u--	dactylic hexameter	feminine penthemimeral, trithemimeral
ὣς εἰποῦσ’ ὑπὸ ποσσὶν ἐδήσατο καλὰ πέδιλα,	- -- uu -u u-uu -u u--	dactylic hexameter	feminine penthemimeral, trithemimeral
ἀμβρόσια χρύσεια, τά μιν φέρον ἠμὲν ἐφ’ ὑγρὴν	-uu- --u u - uu -u u --	dactylic hexameter	feminine penthemimeral, hepthemimeral, trithemimeral
ἠδ’ ἐπ’ ἀπείρονα γαῖαν ἅμα πνοιῇς ἀνέμοιο·	- u u-uu -u u- -- uu--	dactylic hexameter	feminine penthemimeral, hepthemimeral
εἵλετο δ’ἄλκιμον ἔγχος, ἀκαχμένον ὀξέι χαλκῷ,	-uu -uu -u u-uu -uu --	dactylic hexameter	feminine penthemimeral
βριθὺ μέγα στιβαρόν, τῷ δάμνησι στίχας ἀνδρῶν	-u u- uu- - --- uu --	dactylic hexameter	masculine penthemimeral, trithemimeral
ἡρώων, τοῖσίν τε κοτέσσεται ὀβριμοπάτρη.	--- -- u u-uu -uu--	dactylic hexameter	masculine penthemimeral, trithemimeral
βῆ δὲ κατ’ Οὐλύμποιο καρήνων ἀίξασα,	- u u ---u u-- ----	dactylic hexameter	feminine penthemimeral
στῆ δ’Ἰθάκης ἐνὶ δήμῳ ἐπὶ προθύροις Ὀδυσῆος,	- uu- uu -u u- uu- uu--	dactylic hexameter	feminine penthemimeral, hepthemimeral, trithemimeral
οὐδοῦ ἐπ’ αὐλείου· παλάμῃ δ’ἔχε χάλκεον ἔγχος,	-u u --- uu- uu -uu --	dactylic hexameter	masculine penthemimeral, hepthemimeral
εἰδομένη ξείνῳ, Ταφίων ἡγήτορι Μέντῃ.	-uu- -- uu- --uu --	dactylic hexameter	masculine penthemimeral, hepthemimeral, trithemimeral
εὗρε δ’ἄρα μνηστῆρας ἀγήνορας. οἱ μὲν ἔπειτα	-u u- --u u-uu - u u--	dactylic hexameter	feminine penthemimeral, trithemimeral
πεσσοῖσι προπάροιθε θυράων θυμὸν ἔτερπον	--- uu-u u-- -u u--	dactylic hexameter	feminine penthemimeral, trithemimeral
ἥμενοι ἐν ῥινοῖσι βοῶν, οὓς ἔκτανον αὐτοί·	-uu - --u u- - -uu --	dactylic hexameter	feminine penthemimeral, hepthemimeral, trithemimeral
κήρυκες δ’αὐτοῖσι καὶ ὀτρηροὶ θεράποντες	--- --u u --- uu--	dactylic hexameter	feminine penthemimeral, trithemimeral
οἱ μὲν οἶνον ἔμισγον ἐνὶ κρητῆρσι καὶ ὕδωρ,	- - -u u-u u- --u u --	dactylic hexameter	feminine penthemimeral, hepthemimeral
οἱ δ’αὖτε σπόγγοισι πολυτρήτοισι τραπέζας	- -- --u u---u u--	dactylic hexameter	feminine penthemimeral, trithemimeral
νίζον καὶ πρότιθεν, τοὶ δὲ κρέα πολλὰ δατεῦντο.	-- - uu- - - uu -u u--	dactylic hexameter	masculine penthemimeral, hepthemimeral, trithemimeral
τὴν δὲ πολὺ πρῶτος ἴδε Τηλέμαχος θεοειδής,	- u u- -- uu -uu- uu--	dactylic hexameter	masculine penthemimeral, trithemimeral
ἧστο γὰρ ἐν μνηστῆρσι φίλον τετιημένος ἦτορ,	-u u - --u u- uu-uu --	dactylic hexameter	feminine penthemimeral, hepthemimeral, trithemimeral
ὀσσόμενος πατέρ ἐσθλὸν ἐνὶ φρεσίν, εἴ ποθεν ἐλθὼν	-uu- uu -u u- uu - uu --	dactylic hexameter	feminine penthemimeral, hepthemimeral, trithemimeral
μνηστήρων τῶν μὲν σκέδασιν κατὰ δώματα θείη,	--- - - uu- uu -uu --	dactylic hexameter	masculine penthemimeral, hepthemimeral, trithemimeral
τιμὴν δ’αὐτὸς ἔχοι καὶ δώμασιν οἷσιν ἀνάσσοι.	-- -u u- - -uu -u u--	dactylic hexameter	masculine penthemimeral
τὰ φρονέων, μνηστῆρσι μεθήμενος, εἴσιδ’ Ἀθήνην.	- uu- --u u-uu -u u--	dactylic hexameter	feminine penthemimeral, trithemimeral
βῆ δ’ἰθὺς προθύροιο, νεμεσσήθη δ’ἐνὶ θυμῷ	- -- uu-u u--- uu --	dactylic hexameter	feminine penthemimeral, trithemimeral
ξεῖνον δηθὰ θύρῃσιν ἐφεστάμεν· ἐγγύθι δὲ στὰς	-- -u u-u u-uu -uu - -	dactylic hexameter	feminine penthemimeral
χεῖρ’ ἕλε δεξιτερὴν καὶ ἐδέξατο χάλκεον ἔγχος,	- uu -uu- u u-uu -uu --	dactylic hexameter	masculine penthemimeral
καί μιν φωνήσας ἔπεα πτερόεντα προσηύδα·	- - --- uu- uu-u u--	dactylic hexameter	masculine penthemimeral, hepthemimeral
χαῖρε, ξεῖνε, παρ’ ἄμμι φιλήσεαι· αὐτὰρ ἔπειτα	-- -u u -u u-uu -u u--	dactylic hexameter	feminine penthemimeral
δείπνου πασσάμενος μυθήσεαι ὅττεό σε χρή.	-- -uu- --uu -uu - -	dactylic hexameter	masculine penthemimeral
ὣς εἰπὼν ἡγεῖθ’, ἡ δ’ἕσπετο Παλλὰς Ἀθήνη.	- -- -- - -uu -u u--	dactylic hexameter	masculine penthemimeral, trithemimeral
οἱ δ’ὅτε δή ῥ’ἔντοσθεν ἔσαν δόμου ὑψηλοῖο,	- uu - --u u- uu ----	dactylic hexameter	feminine penthemimeral, hepthemimeral, trithemimeral
ἔγχος μέν ῥ’ἔστησε φέρων πρὸς κίονα μακρὴν	-- - --u u- - -uu --	dactylic hexameter	feminine penthemimeral, hepthemimeral, trithemimeral
δουροδόκης ἔντοσθεν ἐυξόου, ἔνθα περ ἄλλα	-uu- --u u-uu -u u --	dactylic hexameter	feminine penthemimeral, trithemimeral
ἔγχε’ Ὀδυσσῆος ταλασίφρονος ἵστατο πολλά,	-u u--- uu-uu -uu --	dactylic hexameter	masculine penthemimeral
αὐτὴν δ’ἐς θρόνον εἷσεν ἄγων, ὑπὸ λῖτα πετάσσας,	-- - uu -u u- uu -u u--	dactylic hexameter	feminine penthemimeral, hepthemimeral, trithemimeral
καλὸν δαιδάλεον· ὑπὸ δὲ θρῆνυς ποσὶν ἦεν.	-- -uu- uu - -- uu --	dactylic hexameter	masculine penthemimeral, hepthemimeral
πὰρ δ’αὐτὸς κλισμὸν θέτο ποικίλον, ἔκτοθεν ἄλλων	- -- -- uu -uu -uu --	dactylic hexameter	masculine penthemimeral, trithemimeral
μνηστήρων, μὴ ξεῖνος ἀνιηθεὶς ὀρυμαγδῷ	--- - -u u--- uu--	dactylic hexameter	feminine penthemimeral, trithemimeral
δείπνῳ ἁδήσειεν, ὑπερφιάλοισι μετελθών,	-- ---u u-uu-u u--	dactylic hexameter	feminine penthemimeral
ἠδ’ ἵνα μιν περὶ πατρὸς ἀποιχομένοιο ἔροιτο.	- uu - uu -u u-uu-u u--	dactylic hexameter	feminine penthemimeral, trithemimeral
χέρνιβα δ’ἀμφίπολος προχόῳ ἐπέχευε φέρουσα	-uu -uu- uu- uu-u u--	dactylic hexameter	masculine penthemimeral, hepthemimeral
καλῇ χρυσείῃ, ὑπὲρ ἀργυρέοιο λέβητος,	-- --- uu -uu-u u--	dactylic hexameter	masculine penthemimeral
νίψασθαι· παρὰ δὲ ξεστὴν ἐτάνυσσε τράπεζαν.	--- uu - -- uu-u u--	dactylic hexameter	masculine penthemimeral, hepthemimeral, trithemimeral
σῖτον δ’αἰδοίη ταμίη παρέθηκε φέρουσα,	-- --- uu- uu-u u--	dactylic hexameter	masculine penthemimeral, hepthemimeral
εἴδατα πόλλ’ ἐπιθεῖσα, χαριζομένη παρεόντων·	-uu - uu-u u-uu- uu--	dactylic hexameter	feminine penthemimeral, trithemimeral
δαιτρὸς δὲ κρειῶν πίνακας παρέθηκεν ἀείρας	-- - -- uu- uu-u u--	dactylic hexameter	masculine penthemimeral, hepthemimeral, trithemimeral
παντοίων, παρὰ δέ σφι τίθει χρύσεια κύπελλα·	--- uu - u u- --u u--	dactylic hexameter	masculine penthemimeral, hepthemimeral, trithemimeral
κῆρυξ δ’αὐτοῖσιν θάμ’ ἐπᾐχετο οἰνοχοεύων.	-- --- u u-uu -uu--	dactylic hexameter	masculine penthemimeral
ἐς δ’ἦλθον μνηστῆρες ἀγήνορες. οἱ μὲν ἔπειτα	- -- --u u-uu - u u--	dactylic hexameter	feminine penthemimeral, trithemimeral
ἑξείης ἕζοντο κατὰ κλισμούς τε θρόνους τε,	--- --u u- -- u u- -	dactylic hexameter	feminine penthemimeral, hepthemimeral, trithemimeral
τοῖσι δὲ κήρυκες μὲν ὕδωρ ἐπὶ χεῖρας ἔχευαν,	-u u --- u u- uu -u u--	dactylic hexameter	masculine penthemimeral, hepthemimeral
σῖτον δὲ δμῳαὶ παρενήνεον ἐν κανέοισιν,	-- - -- uu-uu - uu--	dactylic hexameter	masculine penthemimeral, trithemimeral
κοῦροι δὲ κρητῆρας ἐπεστέψαντο ποτοῖο.	-- - --u u---u u--	dactylic hexameter	feminine penthemimeral, trithemimeral
οἱ δ’ἐπ’ ὀνείαθ’ ἑτοῖμα προκείμενα χεῖρας ἴαλλον.	- u u-u u-u u-uu -u u--	dactylic hexameter	feminine penthemimeral
αὐτὰρ ἐπεὶ πόσιος καὶ ἐδητύος ἐξ ἔρον ἕντο	-u u- uu- u u-uu - uu --	dactylic hexameter	masculine penthemimeral, trithemimeral
μνηστῆρες, τοῖσιν μὲν ἐνὶ φρεσὶν ἄλλα μεμήλει,	--- -- u u- uu -u u--	dactylic hexameter	masculine penthemimeral, hepthemimeral, trithemimeral
μολπή τ’ὀρχηστύς τε· τὰ γὰρ τ’ἀναθήματα δαιτός·	-- --- u u - uu-uu --	dactylic hexameter	masculine penthemimeral, hepthemimeral
κῆρυξ δ’ἐν χερσὶν κίθαριν περικαλλέα θῆκεν	-- - -- uu- uu-uu --	dactylic hexameter	masculine penthemimeral, hepthemimeral, trithemimeral
Φημίῳ, ὅς ῥ’ἤειδε παρὰ μνηστῆρσιν ἀνάγκῃ.	-uu - --u u- --u u--	dactylic hexameter	feminine penthemimeral, hepthemimeral, trithemimeral
ἦ τοι ὁ φορμίζων ἀνεβάλλετο καλὸν ἀείδειν.	- u u --- uu-uu -u u--	dactylic hexameter	masculine penthemimeral
αὐτὰρ Τηλέμαχος προσέφη γλαυκῶπιν Ἀθήνην,	-- -uu- uu- --u u--	dactylic hexameter	masculine penthemimeral, hepthemimeral
ἄγχι σχὼν κεφαλήν, ἵνα μὴ πευθοίαθ’ οἱ ἄλλοι·	-- - uu- uu - --u u --	dactylic hexameter	masculine penthemimeral, hepthemimeral, trithemimeral
ξεῖνε φίλ’, ἦ καὶ μοι νεμεσήσεαι ὅττι κεν εἴπω;	-u u - - - uu-uu -u u --	dactylic hexameter	masculine penthemimeral, trithemimeral
τούτοισιν μὲν ταῦτα μέλει, κίθαρις καὶ ἀοιδή,	--- - -u u- uu- u u--	dactylic hexameter	feminine penthemimeral, hepthemimeral, trithemimeral
ῥεῖ’, ἐπεὶ ἀλλότριον βίοτον νήποινον ἔδουσιν,	- uu -uu- uu- --u u--	dactylic hexameter	masculine penthemimeral, hepthemimeral
ἀνέρος, οὗ δή που λεύκ’ ὀστέα πύθεται ὄμβρῳ	-uu - - - - -uu -uu --	dactylic hexameter	masculine penthemimeral, trithemimeral
κείμεν’ ἐπ’ ἠπείρου, ἢ εἰν ἁλὶ κῦμα κυλίνδει.	-u u --- - - uu -u u--	dactylic hexameter	masculine penthemimeral, hepthemimeral
εἰ κεῖνόν γ’Ἰθάκηνδε ἰδοίατο νοστήσαντα,	- -- uu-u u-uu ----	dactylic hexameter	feminine penthemimeral, trithemimeral
πάντες κ’ἀρησαίατ’ ἐλαφρότεροι πόδας εἶναι	-- ---u u-uu- uu --	dactylic hexameter	feminine penthemimeral
ἢ ἀφνειότεροι χρυσοῖό τε ἐσθῆτός τε.	- --uu- --u u --- -	dactylic hexameter	masculine penthemimeral
νῦν δ’ὁ μὲν ὣς ἀπόλωλε κακὸν μόρον, οὐδέ τις ἡμῖν	- u u - uu-u u- uu -u u --	dactylic hexameter	feminine penthemimeral, hepthemimeral, trithemimeral
θαλπωρή, εἴ πέρ τις ἐπιχθονίων ἀνθρώπων	--- - - u u-uu- ---	dactylic hexameter	masculine penthemimeral, trithemimeral
φῇσιν ἐλεύσεσθαι· τοῦ δ’ὤλετο νόστιμον ἦμαρ.	-u u--- - -uu -uu --	dactylic hexameter	masculine penthemimeral
ἀλλ’ ἄγε μοι τόδε εἰπὲ καὶ ἀτρεκέως κατάλεξον·	- uu - uu -u u -uu- uu--	dactylic hexameter	feminine penthemimeral, trithemimeral
τίς πόθεν εἰς ἀνδρῶν; πόθι τοι πόλις ἠδὲ τοκῆες;	- uu - -- uu - uu -u u--	dactylic hexameter	masculine penthemimeral, hepthemimeral, trithemimeral
ὁπποίης τ’ἐπὶ νηὸς ἀφίκεο· πῶς δέ σε ναῦται	--- uu -u u-uu - u u --	dactylic hexameter	feminine penthemimeral, trithemimeral
ἤγαγον εἰς Ἰθάκην; τίνες ἔμμεναι εὐχετόωντο;	-uu - uu- uu -uu -uu--	dactylic hexameter	masculine penthemimeral, trithemimeral
οὐ μὲν γὰρ τί σε πεζὸν ὀίομαι ἐνθάδ’ ἱκέσθαι.	- - - u u -u u-uu -u u--	dactylic hexameter	feminine penthemimeral, trithemimeral
καί μοι τοῦτ’ ἀγόρευσον ἐτήτυμον, ὄφρ’ ἐὺ εἰδῶ,	- - - uu-u u-uu - uu --	dactylic hexameter	feminine penthemimeral, trithemimeral
ἠὲ νέον μεθέπεις ἦ καὶ πατρώιός ἐσσι	-u u- uu- - - --uu --	dactylic hexameter	masculine penthemimeral, hepthemimeral, trithemimeral
ξεῖνος, ἐπεὶ πολλοὶ ἴσαν ἀνέρες ἡμέτερον δῶ	-u u- -- uu -uu -uu- -	dactylic hexameter	masculine penthemimeral, trithemimeral
ἄλλοι, ἐπεὶ καὶ κεῖνος ἐπίστροφος ἦν ἀνθρώπων.	-u u- - -u u-uu - ---	dactylic hexameter	feminine penthemimeral, trithemimeral
τὸν δ’αὖτε προσέειπε θεά, γλαυκῶπις Ἀθήνη·	- -- uu-u u- --u u--	dactylic hexameter	feminine penthemimeral, hepthemimeral, trithemimeral
τοιγὰρ ἐγώ τοι ταῦτα μάλ’ ἀτρεκέως ἀγορεύσω.	-u u- - -u u -uu- uu--	dactylic hexameter	feminine penthemimeral, trithemimeral
Μέντης Ἀγχιάλοιο δαΐφρονος εὔχομαι εἶναι	-- -uu-u u-uu -uu --	dactylic hexameter	feminine penthemimeral
υἱός, ἀτὰρ Ταφίοισι φιληρέτμοισιν ἀνάσσω.	-u u- uu-u u---u u--	dactylic hexameter	feminine penthemimeral, trithemimeral
νῦν δ’ὧδε ξὺν νηὶ κατήλυθον ἠδ’ ἑτάροισιν	- -- - -u u-uu - uu--	dactylic hexameter	feminine penthemimeral, trithemimeral
πλέων ἐπὶ οἴνοπα πόντον ἐπ’ ἀλλοθρόους ἀνθρώπους,	- uu -uu -u u -uu- ---	dactylic hexameter	feminine penthemimeral
ἐς Τεμέσην μετὰ χαλκόν, ἄγω δ’αἴθωνα σίδηρον.	- uu- uu -u u- --u u--	dactylic hexameter	feminine penthemimeral, hepthemimeral, trithemimeral
νηῦς δέ μοι ἥδ’ ἕστηκεν ἐπ’ ἀγροῦ νόσφι πόληος,	- u u - --u u -- -u u--	dactylic hexameter	feminine penthemimeral, trithemimeral
ἐν λιμένι ’Ρείθρῳ ὑπὸ Νηίῳ ὑλήεντι.	- uu- -- uu -uu ----	dactylic hexameter	masculine penthemimeral, trithemimeral
ξεῖνοι δ’ἀλλήλων πατρώιοι εὐχόμεθ’ εἶναι	-- --- --uu -uu --	dactylic hexameter	masculine penthemimeral
ἐξ ἀρχῆς, εἴ πέρ τε γέροντ’ εἴρηαι ἐπελθὼν	- -- - - u u- --u u--	dactylic hexameter	masculine penthemimeral, hepthemimeral, trithemimeral
Λαέρτην ἥρωα, τὸν οὐκέτι φασὶ πόλινδε	--- --u u -uu -u u--	dactylic hexameter	feminine penthemimeral, trithemimeral
ἔρχεσθ’, ἀλλ’ ἀπάνευθεν ἐπ’ ἀγροῦ πήματα πάσχειν	-- - uu-u u -- -uu --	dactylic hexameter	feminine penthemimeral, trithemimeral
γρηὶ σὺν ἀμφιπόλῳ, ἥ οἱ βρῶσίν τε πόσιν τε	-u u -uu- - - -- u u- -	dactylic hexameter	masculine penthemimeral, hepthemimeral
παρτιθεῖ, εὖτ’ ἄν μιν κάματος κατὰ γυῖα λάβῃσιν	-uu - - - uu- uu -u u--	dactylic hexameter	masculine penthemimeral, hepthemimeral, trithemimeral
ἑρπύζοντ’ ἀνὰ γουνὸν ἀλωῆς οἰνοπέδοιο.	--- uu -u u-- -uu--	dactylic hexameter	feminine penthemimeral, trithemimeral
νῦν δ’ἦλθον· δὴ γάρ μιν ἔφαντ’ ἐπιδήμιον εἶναι,	- -- - - u u- uu-uu --	dactylic hexameter	masculine penthemimeral, hepthemimeral, trithemimeral
σὸν πατέρ’· ἀλλά νυ τόν γε θεοὶ βλάπτουσι κελεύθου.	- uu -u u - u u- --u u--	dactylic hexameter	masculine penthemimeral, hepthemimeral
οὐ γάρ πω τέθνηκεν ἐπὶ χθονὶ δῖος Ὀδυσσεύς,	- - - --u u- uu -u u--	dactylic hexameter	feminine penthemimeral, hepthemimeral, trithemimeral
ἀλλ’ ἔτι που ζωὸς κατερύκεται εὐρέι πόντῳ	- uu - -- uu-uu -uu --	dactylic hexameter	masculine penthemimeral, trithemimeral
νήσῳ ἐν ἀμφιρύτῃ, χαλεποὶ δέ μιν ἄνδρες ἔχουσιν	-u u -uu- uu- u u -u u--	dactylic hexameter	masculine penthemimeral, hepthemimeral
ἄγριοι, οἵ που κεῖνον ἐρυκανόωσ’ ἀέκοντα.	-uu - - -u u-uu- uu--	dactylic hexameter	feminine penthemimeral, trithemimeral
αὐτὰρ νῦν τοι ἐγὼ μαντεύσομαι, ὡς ἐνὶ θυμῷ	-- - u u- --uu - uu --	dactylic hexameter	masculine penthemimeral, trithemimeral
ἀθάνατοι βάλλουσι καὶ ὡς τελέεσθαι ὀίω,	-uu- --u u - uu-u u--	dactylic hexameter	feminine penthemimeral, hepthemimeral, trithemimeral
οὔτε τι μάντις ἐὼν οὔτ’ οἰωνῶν σάφα εἰδώς.	-u u -u u- - --- uu --	dactylic hexameter	masculine penthemimeral
οὔ τοι ἔτι δηρόν γε φίλης ἀπὸ πατρίδος αἴης	- u u- -- u u- uu -uu --	dactylic hexameter	masculine penthemimeral, hepthemimeral, trithemimeral
ἔσσεται, οὐδ’ εἴ πέρ τε σιδήρεα δέσματ’ ἔχῃσιν·	-uu - - - u u-uu -u u--	dactylic hexameter	masculine penthemimeral, trithemimeral
φράσσεται ὥς κε νέηται, ἐπεὶ πολυμήχανός ἐστιν.	-uu - u u-u u- uu-uu --	dactylic hexameter	feminine penthemimeral, hepthemimeral, trithemimeral
ἀλλ’ ἄγε μοι τόδε εἰπὲ καὶ ἀτρεκέως κατάλεξον,	- uu - uu -u u -uu- uu--	dactylic hexameter	feminine penthemimeral, trithemimeral
εἰ δὴ ἐξ αὐτοῖο τόσος πάϊς εἰς Ὀδυσῆος.	- - - --u u- uu - uu--	dactylic hexameter	feminine penthemimeral, hepthemimeral, trithemimeral
αἰνῶς μὲν κεφαλήν τε καὶ ὄμματα καλὰ ἔοικας	-- - uu- u u -uu -u u--	dactylic hexameter	masculine penthemimeral, trithemimeral
κείνῳ, ἐπεὶ θαμὰ τοῖον ἐμισγόμεθ’ ἀλλήλοισιν,	-u u- uu -u u-uu ----	dactylic hexameter	feminine penthemimeral, trithemimeral
πρίν γε τὸν ἐς Τροίην ἀναβήμεναι, ἔνθα περ ἄλλοι	- u u - -- uu-uu -u u --	dactylic hexameter	masculine penthemimeral, trithemimeral
Ἀργείων οἱ ἄριστοι ἔβαν κοίλῃς ἐνὶ νηυσίν·	--- u u-u u- -- uu --	dactylic hexameter	feminine penthemimeral, hepthemimeral, trithemimeral
ἐκ τοῦ δ’οὔτ’ Ὀδυσῆα ἐγὼν ἴδον οὔτ’ ἔμ’ ἐκεῖνος.	- - - uu-u u- uu - u u--	dactylic hexameter	feminine penthemimeral, hepthemimeral, trithemimeral
τὴν δ’αὖ Τηλέμαχος πεπνυμένος ἀντίον ηὔδα·	- - -uu- --uu -uu --	dactylic hexameter	masculine penthemimeral
τοιγὰρ ἐγώ τοι, ξεῖνε, μάλ’ ἀτρεκέως ἀγορεύσω.	-u u- - -u u -uu- uu--	dactylic hexameter	feminine penthemimeral, trithemimeral
μήτηρ μέν τέ μέ φησι τοῦ ἔμμεναι, αὐτὰρ ἐγώ γε	-- - u u -u u -uu -u u- -	dactylic hexameter	feminine penthemimeral, trithemimeral
οὐκ οἶδ’· οὐ γάρ πώ τις ἑὸν γόνον αὐτὸς ἀνέγνω.	- - - - - u uu uu -u u--	lyric	
ὡς δὴ ἐγώ γ’ὄφελον μάκαρός νύ τευ ἔμμεναι υἱὸς	- u u- uu- uu- u u -uu --	dactylic hexameter	masculine penthemimeral, hepthemimeral, trithemimeral
ἀνέρος, ὃν κτεάτεσσιν ἑοῖς ἔπι γῆρας ἔτετμε.	-uu - uu-u u- uu -u u--	dactylic hexameter	feminine penthemimeral, hepthemimeral, trithemimeral
νῦν δ’ὃς ἀποτμότατος γένετο θνητῶν ἀνθρώπων,	- u u-uu- uu- -- ---	dactylic hexameter	masculine penthemimeral, hepthemimeral
τοῦ μ’ἔκ φασι γενέσθαι, ἐπεὶ σύ με τοῦτ’ ἐρεείνεις.	- - -u u-u u- u u - uu--	dactylic hexameter	feminine penthemimeral, hepthemimeral
τὸν δ’αὖτε προσέειπε θεά, γλαυκῶπις Ἀθήνη·	- -- uu-u u- --u u--	dactylic hexameter	feminine penthemimeral, hepthemimeral, trithemimeral
οὐ μέν τοι γενεήν γε θεοὶ νώνυμνον ὀπίσσω	- - - uu- u u- --u u--	dactylic hexameter	masculine penthemimeral, hepthemimeral, trithemimeral
θῆκαν, ἐπεὶ σέ γε τοῖον ἐγείνατο Πηνελόπεια.	-u u- u u -u u-uu -uu--	dactylic hexameter	feminine penthemimeral, trithemimeral
ἀλλ’ ἄγε μοι τόδε εἰπὲ καὶ ἀτρεκέως κατάλεξον·	- uu - uu -u u -uu- uu--	dactylic hexameter	feminine penthemimeral, trithemimeral
τίς δαίς, τίς δὲ ὅμιλος ὅδ’ ἔπλετο; τίπτε δέ σε χρεώ;	- - - u u-u u -uu -u u - -	dactylic hexameter	feminine penthemimeral, trithemimeral
εἰλαπίνη ἠὲ γάμος; ἐπεὶ οὐκ ἔρανος τάδε γ’ἐστίν·	-uu -u u- uu - uu- uu --	dactylic hexameter	masculine penthemimeral, hepthemimeral
ὥς τέ μοι ὑβρίζοντες ὑπερφιάλως δοκέουσι	- u u ---u u-uu- uu--	dactylic hexameter	feminine penthemimeral
δαίνυσθαι κατὰ δῶμα. νεμεσσήσαιτό κεν ἀνὴρ	--- uu -u u---u u --	dactylic hexameter	feminine penthemimeral, trithemimeral
αἴσχεα πόλλ’ ὁρόων, ὅς τις πινυτός γε μετέλθοι.	-uu - uu- - - uu- u u--	dactylic hexameter	masculine penthemimeral, hepthemimeral, trithemimeral
τὴν δ’αὖ Τηλέμαχος πεπνυμένος ἀντίον ηὔδα·	- - -uu- --uu -uu --	dactylic hexameter	masculine penthemimeral
ξεῖν’, ἐπεὶ ἂρ δὴ ταῦτά μ’ ἀνείρεαι ἠδὲ μεταλλᾷς,	- uu - - -u u-uu -u u--	dactylic hexameter	feminine penthemimeral, trithemimeral
μέλλεν μέν ποτε οἶκος ὅδ’ ἀφνειὸς καὶ ἀμύμων	-- - uu -u u --- u u--	dactylic hexameter	feminine penthemimeral, trithemimeral
ἔμμεναι, ὄφρ’ ἔτι κεῖνος ἀνὴρ ἐπιδήμιος ἦεν·	-uu - uu -u u- uu-uu --	dactylic hexameter	feminine penthemimeral, hepthemimeral, trithemimeral
νῦν δ’ἑτέρως ἐβόλοντο θεοὶ κακὰ μητιόωντες,	- uu- uu-u u- uu -uu--	dactylic hexameter	feminine penthemimeral, hepthemimeral, trithemimeral
οἳ κεῖνον μὲν ἄιστον ἐποίησαν περὶ πάντων	- -- u u-u u--- uu --	dactylic hexameter	feminine penthemimeral, trithemimeral
ἀνθρώπων, ἐπεὶ οὔ κε θανόντι περ ὧδ’ ἀκαχοίμην,	--- uu - u u-u u - uu--	dactylic hexameter	masculine penthemimeral, trithemimeral
εἰ μετὰ οἷς ἑτάροισι δάμη Τρώων ἐνὶ δήμῳ,	- uu - uu-u u- -- uu --	dactylic hexameter	feminine penthemimeral, hepthemimeral, trithemimeral
ἠὲ φίλων ἐν χερσίν, ἐπεὶ πόλεμον τολύπευσεν.	-u u- - -u u- uu- uu--	dactylic hexameter	feminine penthemimeral, hepthemimeral, trithemimeral
τῷ κέν οἱ τύμβον μὲν ἐποίησαν Παναχαιοί,	- - - -- u u--- uu--	dactylic hexameter	masculine penthemimeral, trithemimeral
ἠδέ κε καὶ ᾧ παιδὶ μέγα κλέος ἤρατ’ ὀπίσσω.	-u u - - -u u- uu -u u--	dactylic hexameter	feminine penthemimeral, hepthemimeral, trithemimeral
νῦν δέ μιν ἀκλειῶς ἅρπυιαι ἀνηρείψαντο·	- u u --- --u u----	dactylic hexameter	masculine penthemimeral
οἴχετ’ ἄιστος ἄπυστος, ἐμοὶ δ’ὀδύνας τε γόους τε	-u u-u u-u u- uu- u u- -	dactylic hexameter	feminine penthemimeral, hepthemimeral
κάλλιπεν. οὐδέ τι κεῖνον ὀδυρόμενος στεναχίζω	-uu -u u -u u-uu- uu--	dactylic hexameter	feminine penthemimeral
οἶον, ἐπεί νύ μοι ἄλλα θεοὶ κακὰ κήδε’ ἔτευξαν.	-u u- u u -u u- uu -u u--	dactylic hexameter	feminine penthemimeral, hepthemimeral, trithemimeral
ὅσσοι γὰρ νήσοισιν ἐπικρατέουσιν ἄριστοι,	-- - --u u-uu-u u--	dactylic hexameter	feminine penthemimeral, trithemimeral
Δουλιχίῳ τε Σάμῃ τε καὶ ὑλήεντι Ζακύνθῳ,	-uu- u u- u u ---u u--	dactylic hexameter	masculine penthemimeral, trithemimeral
ἠδ’ ὅσσοι κραναὴν Ἰθάκην κάτα κοιρανέουσιν,	- -- uu- uu- uu -uu--	dactylic hexameter	masculine penthemimeral, hepthemimeral, trithemimeral
τόσσοι μητέρ’ ἐμὴν μνῶνται, τρύχουσι δὲ οἶκον.	-- -u u- -- --u u --	dactylic hexameter	masculine penthemimeral, hepthemimeral
ἡ δ’οὔτ’ ἀρνεῖται στυγερὸν γάμον οὔτε τελευτὴν	- - --- uu- uu -u u--	dactylic hexameter	masculine penthemimeral, hepthemimeral
ποιῆσαι δύναται· τοὶ δὲ φθινύθουσιν ἔδοντες	--- uu- - - uu-u u--	dactylic hexameter	masculine penthemimeral, hepthemimeral, trithemimeral
οἶκον ἐμόν· τάχα δή με διαρραίσουσι καὶ αὐτόν.	-u u- uu - u u---u u --	dactylic hexameter	masculine penthemimeral, trithemimeral
τὸν δ’ἐπαλαστήσασα προσηύδα Παλλὰς Ἀθήνη·	- uu---u u-- -u u--	dactylic hexameter	feminine penthemimeral
ὢ πόποι, ἦ δὴ πολλὸν ἀποιχομένου Ὀδυσῆος	- uu - - -u u-uu- uu--	dactylic hexameter	feminine penthemimeral, trithemimeral
δεύῃ, ὅ κε μνηστῆρσιν ἀναιδέσι χεῖρας ἐφείη.	-u u - --u u-uu -u u--	dactylic hexameter	feminine penthemimeral, trithemimeral
εἰ γὰρ νῦν ἐλθὼν δόμου ἐν πρώτῃσι θύρῃσι	- - - -- uu - --u u--	dactylic hexameter	masculine penthemimeral, hepthemimeral, trithemimeral
σταίη, ἔχων πήληκα καὶ ἀσπίδα καὶ δύο δοῦρε,	-u u- --u u -uu - uu --	dactylic hexameter	feminine penthemimeral, trithemimeral
τοῖος ἐὼν οἷόν μιν ἐγὼ τὰ πρῶτ’ ἐνόησα	-u u- -- u u- - - uu--	dactylic hexameter	masculine penthemimeral, hepthemimeral, trithemimeral
οἴκῳ ἐν ἡμετέρῳ πίνοντά τε τερπόμενόν τε,	-u u -uu- --u u -uu- -	dactylic hexameter	masculine penthemimeral
ἐξ Ἐφύρης ἀνιόντα παρ’ Ἴλου Μερμερίδαο--	- uu- uu-u u -- -uu--	dactylic hexameter	feminine penthemimeral, trithemimeral
ᾤχετο γὰρ καὶ κεῖσε θοῆς ἐπὶ νηὸς Ὀδυσσεὺς	-uu - - -u u- uu -u u--	dactylic hexameter	feminine penthemimeral, hepthemimeral, trithemimeral
φάρμακον ἀνδροφόνον διζήμενος, ὄφρα οἱ εἴη	-uu -uu- --uu -u u --	dactylic hexameter	masculine penthemimeral
ἰοὺς χρίεσθαι χαλκήρεας· ἀλλ’ ὁ μὲν οὔ οἱ	-- --- --uu - u u - -	dactylic hexameter	masculine penthemimeral
δῶκεν, ἐπεί ῥα θεοὺς νεμεσίζετο αἰὲν ἐόντας,	-u u- u u- uu-uu -u u--	dactylic hexameter	masculine penthemimeral, trithemimeral
ἀλλὰ πατήρ οἱ δῶκεν ἐμός· φιλέεσκε γὰρ αἰνῶς--	-u u- - -u u- uu-u u --	dactylic hexameter	feminine penthemimeral, hepthemimeral, trithemimeral
τοῖος ἐὼν μνηστῆρσιν ὁμιλήσειεν Ὀδυσσεύς·	-u u- --u u---u u--	dactylic hexameter	feminine penthemimeral, trithemimeral
πάντες κ’ὠκύμοροί τε γενοίατο πικρόγαμοί τε.	-- -uu- u u-uu -uu- -	dactylic hexameter	masculine penthemimeral
ἀλλ’ ἦ τοι μὲν ταῦτα θεῶν ἐν γούνασι κεῖται,	- - - - -u u- - -uu --	dactylic hexameter	feminine penthemimeral, hepthemimeral, trithemimeral
ἤ κεν νοστήσας ἀποτίσεται, ἦε καὶ οὐκί,	- - --- uu-uu -u u --	dactylic hexameter	masculine penthemimeral
οἷσιν ἐνὶ μεγάροισι· σὲ δὲ φράζεσθαι ἄνωγα,	-u u- uu-u u - --u u--	dactylic hexameter	feminine penthemimeral, hepthemimeral, trithemimeral
ὅππως κε μνηστῆρας ἀπώσεαι ἐκ μεγάροιο.	-- - --u u-uu - uu--	dactylic hexameter	feminine penthemimeral, trithemimeral
εἰ δ’ἄγε νῦν ξυνίει καὶ ἐμῶν ἐμπάζεο μύθων·	- uu - uu- u u- --uu --	dactylic hexameter	masculine penthemimeral, hepthemimeral, trithemimeral
αὔριον εἰς ἀγορὴν καλέσας ἥρωας Ἀχαιοὺς	-uu - uu- uu- --u u--	dactylic hexameter	masculine penthemimeral, hepthemimeral, trithemimeral
μῦθον πέφραδε πᾶσι, θεοὶ δ’ἐπὶ μάρτυροι ἔστων.	-- -uu -u u- uu -uu --	dactylic hexameter	feminine penthemimeral, hepthemimeral
μνηστῆρας μὲν ἐπὶ σφέτερα σκίδνασθαι ἄνωχθι,	--- u u- uu- --u u--	dactylic hexameter	masculine penthemimeral, hepthemimeral, trithemimeral
μητέρα δ’,εἴ οἱ θυμὸς ἐφορμᾶται γαμέεσθαι,	-uu - - -u u--- uu--	dactylic hexameter	feminine penthemimeral, trithemimeral
ἂψ ἴτω ἐς μέγαρον πατρὸς μέγα δυναμένοιο·	- uu - uu- -- uu -uu--	dactylic hexameter	masculine penthemimeral, hepthemimeral, trithemimeral
οἱ δὲ γάμον τεύξουσι καὶ ἀρτυνέουσιν ἔεδνα	- u u- --u u -uu-u u--	dactylic hexameter	feminine penthemimeral, trithemimeral
πολλὰ μάλ’, ὅσσα ἔοικε φίλης ἐπὶ παιδὸς ἕπεσθαι.	-u u -u u-u u- uu -u u--	dactylic hexameter	feminine penthemimeral, hepthemimeral
σοὶ δ’αὐτῷ πυκινῶς ὑποθήσομαι, αἴ κε πίθηαι·	- -- uu- uu-uu - u u--	dactylic hexameter	masculine penthemimeral, trithemimeral
νῆ’ ἄρσας ἐρέτῃσιν ἐείκοσιν, ἥ τις ἀρίστη,	- -- uu-u u-uu - u u--	dactylic hexameter	feminine penthemimeral, trithemimeral
ἔρχεο πευσόμενος πατρὸς δὴν οἰχομένοιο,	-uu -uu- -- - -uu--	dactylic hexameter	masculine penthemimeral, hepthemimeral
ἤν τίς τοι εἴπῃσι βροτῶν, ἢ ὄσσαν ἀκούσῃς	- - - --u u- - -u u--	dactylic hexameter	feminine penthemimeral, hepthemimeral, trithemimeral
ἐκ Διός, ἥ τε μάλιστα φέρει κλέος ἀνθρώποισι.	- uu - u u-u u- uu ----	dactylic hexameter	feminine penthemimeral, hepthemimeral, trithemimeral
πρῶτα μὲν ἐς Πύλον ἐλθὲ καὶ εἴρεο Νέστορα δῖον,	-u u - uu -u u -uu -uu --	dactylic hexameter	feminine penthemimeral, trithemimeral
κεῖθεν δὲ Σπάρτηνδε παρὰ ξανθὸν Μενέλαον·	-- - --u u- -- uu--	dactylic hexameter	feminine penthemimeral, hepthemimeral, trithemimeral
ὃς γὰρ δεύτατος ἦλθεν Ἀχαιῶν χαλκοχιτώνων.	- - -uu -u u-- -uu--	dactylic hexameter	feminine penthemimeral
εἰ μέν κεν πατρὸς βίοτον καὶ νόστον ἀκούσῃς,	- - - -- uu- - -u u--	dactylic hexameter	masculine penthemimeral, hepthemimeral, trithemimeral
ἦ τ’ἂν τρυχόμενός περ ἔτι τλαίης ἐνιαυτόν·	- - -uu- u u- -- uu--	dactylic hexameter	masculine penthemimeral, hepthemimeral
εἰ δέ κε τεθνηῶτος ἀκούσῃς μηδ’ ἔτ’ ἐόντος,	- u u ---u u-- - u u--	dactylic hexameter	feminine penthemimeral
νοστήσας δὴ ἔπειτα φίλην ἐς πατρίδα γαῖαν	--- u u-u u- - -uu --	dactylic hexameter	feminine penthemimeral, hepthemimeral, trithemimeral
σῆμά τέ οἱ χεῦαι καὶ ἐπὶ κτέρεα κτερεΐξαι	-u u - -- u u- uu- uu--	dactylic hexameter	masculine penthemimeral, hepthemimeral, trithemimeral
πολλὰ μάλ’, ὅσσα ἔοικε, καὶ ἀνέρι μητέρα δοῦναι.	-u u -u u-u u -uu -uu --	dactylic hexameter	feminine penthemimeral
αὐτὰρ ἐπὴν δὴ ταῦτα τελευτήσῃς τε καὶ ἔρξῃς,	-u u- - -u u--- u u --	dactylic hexameter	feminine penthemimeral, trithemimeral
φράζεσθαι δὴ ἔπειτα κατὰ φρένα καὶ κατὰ θυμὸν	--- u u-u u- uu - uu --	dactylic hexameter	feminine penthemimeral, hepthemimeral, trithemimeral
ὅππως κε μνηστῆρας ἐνὶ μεγάροισι τεοῖσι	-- - --u u- uu-u u--	dactylic hexameter	feminine penthemimeral, hepthemimeral, trithemimeral
κτείνῃς ἠὲ δόλῳ ἢ ἀμφαδόν· οὐδέ τί σε χρὴ	-- -u u- - -uu -u u - -	dactylic hexameter	masculine penthemimeral
νηπιάας ὀχέειν, ἐπεὶ οὐκέτι τηλίκος ἐσσι.	-uu- uu- uu -uu -uu --	dactylic hexameter	masculine penthemimeral, trithemimeral
ἢ οὐκ ἀίεις οἷον κλέος ἔλλαβε δῖος Ὀρέστης	- uu- -- uu -uu -u u--	dactylic hexameter	masculine penthemimeral, trithemimeral
πάντας ἐπ’ ἀνθρώπους, ἐπεὶ ἔκτανε πατροφονῆα,	-u u --- uu -uu -uu--	dactylic hexameter	masculine penthemimeral
Αἴγισθον δολόμητιν, ὅ οἱ πατέρα κλυτὸν ἔκτα;	--- uu-u u - uu- uu --	dactylic hexameter	feminine penthemimeral, hepthemimeral, trithemimeral
καὶ σύ, φίλος, μάλα γάρ σ’ὁρόω καλόν τε μέγαν τε,	- u u- uu - uu- -- u u- -	dactylic hexameter	masculine penthemimeral, hepthemimeral, trithemimeral
ἄλκιμος ἔσσ’, ἵνα τίς σε καὶ ὀψιγόνων ἐὺ εἴπῃ.	-uu - uu - u u -uu- uu --	dactylic hexameter	masculine penthemimeral, trithemimeral
αὐτὰρ ἐγὼν ἐπὶ νῆα θοὴν κατελεύσομαι ἤδη	-u u- uu -u u- uu-uu --	dactylic hexameter	feminine penthemimeral, hepthemimeral, trithemimeral
ἠδ’ ἑτάρους, οἵ πού με μάλ’ ἀσχαλόωσι μένοντες·	- uu- - - u u -uu-u u--	dactylic hexameter	masculine penthemimeral, trithemimeral
σοὶ δ’αὐτῷ μελέτω, καὶ ἐμῶν ἐμπάζεο μύθων.	- -- uu- u u- --uu --	dactylic hexameter	masculine penthemimeral, hepthemimeral, trithemimeral
τὴν δ’αὖ Τηλέμαχος πεπνυμένος ἀντίον ηὔδα·	- - -uu- --uu -uu --	dactylic hexameter	masculine penthemimeral
ξεῖν’, ἦ τοι μὲν ταῦτα φίλα φρονέων ἀγορεύεις,	- - - - -u u- uu- uu--	dactylic hexameter	feminine penthemimeral, hepthemimeral, trithemimeral
ὥς τε πατὴρ ᾧ παιδί, καὶ οὔ ποτε λήσομαι αὐτῶν.	- u u- - -u u - uu -uu --	dactylic hexameter	feminine penthemimeral, hepthemimeral, trithemimeral
ἀλλ’ ἄγε νῦν ἐπίμεινον, ἐπειγόμενός περ ὁδοῖο,	- uu - uu-u u-uu- u u--	dactylic hexameter	feminine penthemimeral, trithemimeral
ὄφρα λοεσσάμενός τε τεταρπόμενός τε φίλον κῆρ,	-u u-uu- u u-uu- u u- -	dactylic hexameter	masculine penthemimeral
δῶρον ἔχων ἐπὶ νῆα κίῃς, χαίρων ἐνὶ θυμῷ,	-u u- uu -u u- -- uu --	dactylic hexameter	feminine penthemimeral, hepthemimeral, trithemimeral
τιμῆεν, μάλα καλόν, ὅ τοι κειμήλιον ἔσται	--- uu -u u - --uu --	dactylic hexameter	feminine penthemimeral, hepthemimeral, trithemimeral
ἐξ ἐμεῦ, οἷα φίλοι ξεῖνοι ξείνοισι διδοῦσι.	- uu -u u- -- --u u--	dactylic hexameter	masculine penthemimeral, hepthemimeral
τὸν δ’ἠμείβετ’ ἔπειτα θεά, γλαυκῶπις Ἀθήνη·	- --u u-u u- --u u--	dactylic hexameter	feminine penthemimeral, hepthemimeral
μή μ’ἔτι νῦν κατέρυκε, λιλαιόμενόν περ ὁδοῖο.	- uu - uu-u u-uu- u u--	dactylic hexameter	feminine penthemimeral, trithemimeral
δῶρον δ’ὅττι κέ μοι δοῦναι φίλον ἦτορ ἀνώγῃ,	-- -u u - -- uu -u u--	dactylic hexameter	masculine penthemimeral, hepthemimeral
αὖτις ἀνερχομένῳ δόμεναι οἶκόνδε φέρεσθαι,	-u u-uu- uu- --u u--	dactylic hexameter	masculine penthemimeral, hepthemimeral
καὶ μάλα καλὸν ἑλών· σοὶ δ’ἄξιον ἔσται ἀμοιβῆς.	- uu -u u- - -uu -u u--	dactylic hexameter	masculine penthemimeral
ἡ μὲν ἄρ’ ὣς εἰποῦσ’ ἀπέβη γλαυκῶπις Ἀθήνη,	- u u - -- uu- --u u--	dactylic hexameter	masculine penthemimeral, hepthemimeral, trithemimeral
ὄρνις δ’ὣς ἀνόπαια διέπτατο· τῷ δ’ἐνὶ θυμῷ	-- - uu-u u-uu - uu --	dactylic hexameter	feminine penthemimeral, trithemimeral
θῆκε μένος καὶ θάρσος, ὑπέμνησέν τέ ἑ πατρὸς	-u u- - -u u--- u u --	dactylic hexameter	feminine penthemimeral, trithemimeral
μᾶλλον ἔτ’ ἢ τὸ πάροιθεν. ὁ δὲ φρεσὶν ᾗσι νοήσας	-u u - u u-u u - uu -u u--	dactylic hexameter	feminine penthemimeral, hepthemimeral, trithemimeral
θάμβησεν κατὰ θυμόν· ὀίσατο γὰρ θεὸν εἶναι.	--- uu -u u-uu - uu --	dactylic hexameter	feminine penthemimeral, trithemimeral
αὐτίκα δὲ μνηστῆρας ἐπᾐχετο ἰσόθεος φώς.	-uu - --u u-uu -uu- -	dactylic hexameter	feminine penthemimeral, trithemimeral
τοῖσι δ’ἀοιδὸς ἄειδε περικλυτός, οἱ δὲ σιωπῇ	-u u-u u-u u-uu - u u--	dactylic hexameter	feminine penthemimeral
ἥατ’ ἀκούοντες· ὁ δ’Ἀχαιῶν νόστον ἄειδε	-u u--- u u-- -u u--	dactylic hexameter	masculine penthemimeral
λυγρόν, ὃν ἐκ Τροίης ἐπετείλατο Παλλὰς Ἀθήνη.	-u u - -- uu-uu -u u--	dactylic hexameter	masculine penthemimeral, trithemimeral
τοῦ δ’ὑπερωιόθεν φρεσὶ σύνθετο θέσπιν ἀοιδὴν	- uu-uu- uu -uu -u u--	dactylic hexameter	masculine penthemimeral
κούρη Ἰκαρίοιο, περίφρων Πηνελόπεια·	-- -uu-u u-- -uu--	dactylic hexameter	feminine penthemimeral
κλίμακα δ’ὑψηλὴν κατεβήσετο οἷο δόμοιο,	-uu --- uu-uu -u u--	dactylic hexameter	masculine penthemimeral
οὐκ οἴη, ἅμα τῇ γε καὶ ἀμφίπολοι δύ’ ἕποντο.	- -- uu - u u -uu- u u--	dactylic hexameter	masculine penthemimeral, trithemimeral
ἡ δ’ὅτε δὴ μνηστῆρας ἀφίκετο δῖα γυναικῶν,	- uu - --u u-uu -u u--	dactylic hexameter	feminine penthemimeral, trithemimeral
στῆ ῥα παρὰ σταθμὸν τέγεος πύκα ποιητοῖο,	- u u- -- uu- uu ----	dactylic hexameter	masculine penthemimeral, hepthemimeral, trithemimeral
ἄντα παρειάων σχομένη λιπαρὰ κρήδεμνα·	-u u--- uu- uu- ---	dactylic hexameter	masculine penthemimeral, hepthemimeral
ἀμφίπολος δ’ἄρα οἱ κεδνὴ ἑκάτερθε παρέστη.	-uu- uu - -- uu-u u--	dactylic hexameter	masculine penthemimeral, hepthemimeral, trithemimeral
δακρύσασα δ’ἔπειτα προσηύδα θεῖον ἀοιδόν·	---u u-u u-- -u u--	dactylic hexameter	feminine penthemimeral
Φήμιε, πολλὰ γὰρ ἄλλα βροτῶν θελκτήρια οἶδας,	-uu -u u -u u- --uu --	dactylic hexameter	feminine penthemimeral, hepthemimeral
ἔργ’ ἀνδρῶν τε θεῶν τε, τά τε κλείουσιν ἀοιδοί·	- -- u u- u u - --u u--	dactylic hexameter	masculine penthemimeral, hepthemimeral, trithemimeral
τῶν ἕν γέ σφιν ἄειδε παρήμενος, οἱ δὲ σιωπῇ	- - - u u-u u-uu - u u--	dactylic hexameter	feminine penthemimeral, trithemimeral
οἶνον πινόντων· ταύτης δ’ἀποπαύε’ ἀοιδῆς	-- --- -- uu-u u--	dactylic hexameter	masculine penthemimeral, hepthemimeral
λυγρῆς, ἥ τέ μοι αἰεὶ ἐνὶ στήθεσσι φίλον κῆρ	-- - u u -u u- --u u- -	dactylic hexameter	feminine penthemimeral, hepthemimeral, trithemimeral
τείρει, ἐπεί με μάλιστα καθίκετο πένθος ἄλαστον.	-u u- u u-u u-uu -u u--	dactylic hexameter	feminine penthemimeral, trithemimeral
τοίην γὰρ κεφαλὴν ποθέω μεμνημένη αἰεί,	-- - uu- uu- --uu --	dactylic hexameter	masculine penthemimeral, hepthemimeral, trithemimeral
ἀνδρός, τοῦ κλέος εὐρὺ καθ’ Ἑλλάδα καὶ μέσον Ἄργος.	-- - uu -u u -uu - uu --	dactylic hexameter	feminine penthemimeral, trithemimeral
τὴν δ’αὖ Τηλέμαχος πεπνυμένος ἀντίον ηὔδα·	- - -uu- --uu -uu --	dactylic hexameter	masculine penthemimeral
μῆτερ ἐμή, τί τ’ἄρα φθονέεις ἐρίηρον ἀοιδὸν	-u u- u u- uu- uu-u u--	dactylic hexameter	masculine penthemimeral, hepthemimeral, trithemimeral
τέρπειν ὅππῃ οἱ νόος ὄρνυται; οὔ νύ τ’ἀοιδοὶ	-- -- - uu -uu - u u--	dactylic hexameter	masculine penthemimeral
αἴτιοι, ἀλλά ποθι Ζεὺς αἴτιος, ὅς τε δίδωσιν	-uu -u u- - -uu - u u--	dactylic hexameter	masculine penthemimeral
ἀνδράσιν ἀλφηστῇσιν, ὅπως ἐθέλῃσιν, ἑκάστῳ.	-uu ---u u- uu-u u--	dactylic hexameter	feminine penthemimeral, hepthemimeral
τούτῳ δ’οὐ νέμεσις Δαναῶν κακὸν οἶτον ἀείδειν·	-- - uu- uu- uu -u u--	dactylic hexameter	masculine penthemimeral, hepthemimeral, trithemimeral
τὴν γὰρ ἀοιδὴν μᾶλλον ἐπικλείουσ’ ἄνθρωποι,	- u u-- -u u--- ---	dactylic hexameter	feminine penthemimeral
ἥ τις ἀκουόντεσσι νεωτάτη ἀμφιπέληται.	- u u---u u-uu -uu--	dactylic hexameter	feminine penthemimeral
σοί δ’ἐπιτολμάτω κραδίη καὶ θυμὸς ἀκούειν·	- uu--- uu- - -u u--	dactylic hexameter	masculine penthemimeral, hepthemimeral
οὐ γὰρ Ὀδυσσεὺς οἶος ἀπώλεσε νόστιμον ἦμαρ	- u u-- -u u-uu -uu --	dactylic hexameter	feminine penthemimeral
ἐν Τροίῃ, πολλοὶ δὲ καὶ ἄλλοι φῶτες ὄλοντο.	- -- -- u u -- -u u--	dactylic hexameter	masculine penthemimeral, trithemimeral
ἀλλ’ εἰς οἶκον ἰοῦσα τὰ σ’αὐτῆς ἔργα κόμιζε,	- - -u u-u u -- -u u--	dactylic hexameter	feminine penthemimeral
ἱστόν τ’ἠλακάτην τε, καὶ ἀμφιπόλοισι κέλευε	-- -uu- u u -uu-u u--	dactylic hexameter	masculine penthemimeral
ἔργον ἐποίχεσθαι· μῦθος δ’ἄνδρεσσι μελήσει	-u u--- -- --u u--	dactylic hexameter	masculine penthemimeral, hepthemimeral
πᾶσι, μάλιστα δ’ἐμοί· τοῦ γὰρ κράτος ἔστ’ ἐνὶ οἴκῳ.	-u u-u u- - - uu - uu --	dactylic hexameter	masculine penthemimeral, hepthemimeral
ἡ μὲν θαμβήσασα πάλιν οἶκόνδε βεβήκει·	- - ---u u- --u u--	dactylic hexameter	feminine penthemimeral, hepthemimeral
παιδὸς γὰρ μῦθον πεπνυμένον ἔνθετο θυμῷ.	-- - -- --uu -uu --	dactylic hexameter	masculine penthemimeral, trithemimeral
ἐς δ’ὑπερῷ’ ἀναβᾶσα σὺν ἀμφιπόλοισι γυναιξὶ	- uu- uu-u u -uu-u u--	dactylic hexameter	feminine penthemimeral, trithemimeral
κλαῖεν ἔπειτ’ Ὀδυσῆα φίλον πόσιν, ὄφρα οἱ ὕπνον	-u u- uu-u u- uu -u u --	dactylic hexameter	feminine penthemimeral, hepthemimeral, trithemimeral
ἡδὺν ἐπὶ βλεφάροισι βάλε γλαυκῶπις Ἀθήνη.	-u u- uu-u u- --u u--	dactylic hexameter	feminine penthemimeral, hepthemimeral, trithemimeral
μνηστῆρες δ’ὁμάδησαν ἀνὰ μέγαρα σκιόεντα,	--- uu-u u- uu- uu--	dactylic hexameter	feminine penthemimeral, hepthemimeral, trithemimeral
πάντες δ’ἠρήσαντο παραὶ λεχέεσσι κλιθῆναι.	-- ---u u- uu-u u--	dactylic hexameter	feminine penthemimeral, hepthemimeral
τοῖσι δὲ Τηλέμαχος πεπνυμένος ἤρχετο μύθων·	-u u -uu- --uu -uu --	dactylic hexameter	masculine penthemimeral
μητρὸς ἐμῆς μνηστῆρες ὑπέρβιον ὕβριν ἔχοντες,	-u u- --u u-uu -u u--	dactylic hexameter	feminine penthemimeral, trithemimeral
νῦν μὲν δαινύμενοι τερπώμεθα, μηδὲ βοητὺς	- - -uu- --uu -u u--	dactylic hexameter	masculine penthemimeral
ἔστω, ἐπεὶ τόδε καλὸν ἀκουέμεν ἐστὶν ἀοιδοῦ	-u u- uu -u u-uu -u u--	dactylic hexameter	feminine penthemimeral, trithemimeral
τοιοῦδ’ οἷος ὅδ’ ἐστί, θεοῖς ἐναλίγκιος αὐδήν.	-- -u u -u u- uu-uu --	dactylic hexameter	feminine penthemimeral, hepthemimeral
ἠῶθεν δ’ἀγορήνδε καθεζώμεσθα κιόντες	--- uu-u u---u u--	dactylic hexameter	feminine penthemimeral, trithemimeral
πάντες, ἵν’ ὕμιν μῦθον ἀπηλεγέως ἀποείπω,	-u u -- -u u-uu- uu--	dactylic hexameter	feminine penthemimeral
ἐξιέναι μεγάρων· ἄλλας δ’ἀλεγύνετε δαῖτας,	-uu- uu- -- uu-uu --	dactylic hexameter	masculine penthemimeral, hepthemimeral, trithemimeral
ὑμὰ κτήματ’ ἔδοντες, ἀμειβόμενοι κατὰ οἴκους.	-- -u u-u u-uu- uu --	dactylic hexameter	feminine penthemimeral
εἰ δ’ὕμιν δοκέει τόδε λωίτερον καὶ ἄμεινον	- -- uu- uu -uu- u u--	dactylic hexameter	masculine penthemimeral, trithemimeral
ἔμμεναι, ἀνδρὸς ἑνὸς βίοτον νήποινον ὀλέσθαι,	-uu -u u- uu- --u u--	dactylic hexameter	masculine penthemimeral, hepthemimeral
κείρετ’· ἐγὼ δὲ θεοὺς ἐπιβώσομαι αἰὲν ἐόντας,	-u u- u u- uu-uu -u u--	dactylic hexameter	masculine penthemimeral, trithemimeral
αἴ κέ ποθι Ζεὺς δῷσι παλίντιτα ἔργα γενέσθαι·	- u u- - -u u-uu -u u--	dactylic hexameter	feminine penthemimeral, trithemimeral
νήποινοί κεν ἔπειτα δόμων ἔντοσθεν ὄλοισθε.	--- u u-u u- --u u--	dactylic hexameter	feminine penthemimeral, hepthemimeral, trithemimeral
ὣς ἔφαθ’, οἱ δ’ἄρα πάντες ὀδὰξ ἐν χείλεσι φύντες	- uu - uu -u u- - -uu --	dactylic hexameter	feminine penthemimeral, hepthemimeral, trithemimeral
Τηλέμαχον θαύμαζον, ὃ θαρσαλέως ἀγόρευεν.	-uu- --u u -uu- uu--	dactylic hexameter	feminine penthemimeral, trithemimeral
τὸν δ’αὖτ’ Ἀντίνοος προσέφη, Εὐπείθεος υἱός·	- - -uu- uu- --uu --	dactylic hexameter	masculine penthemimeral, hepthemimeral
Τηλέμαχ’, ἦ μάλα δή σε διδάσκουσιν θεοὶ αὐτοὶ	-uu - uu - u u--- uu --	dactylic hexameter	masculine penthemimeral, trithemimeral
ὑψαγόρην τ’ἔμεναι καὶ θαρσαλέως ἀγορεύειν·	-uu- uu- - -uu- uu--	dactylic hexameter	masculine penthemimeral, trithemimeral
μὴ σέ γ’ἐν ἀμφιάλῳ Ἰθάκῃ βασιλῆα Κρονίων	- u u -uu- uu- uu-u u--	dactylic hexameter	masculine penthemimeral, hepthemimeral
ποιήσειεν, ὅ τοι γενεῇ πατρώιόν ἐστιν.	---u u - uu- --uu --	dactylic hexameter	masculine penthemimeral, hepthemimeral
τὸν δ’αὖ Τηλέμαχος πεπνυμένος ἀντίον ηὔδα·	- - -uu- --uu -uu --	dactylic hexameter	masculine penthemimeral
Ἀντίνο’, ἦ καί μοι νεμεσήσεαι ὅττι κεν εἴπω;	-uu - - - uu-uu -u u --	dactylic hexameter	masculine penthemimeral, trithemimeral
καὶ κεν τοῦτ’ ἐθέλοιμι Διός γε διδόντος ἀρέσθαι.	- - - uu-u u- u u-u u--	dactylic hexameter	feminine penthemimeral, hepthemimeral, trithemimeral
ἦ φῂς τοῦτο κάκιστον ἐν ἀνθρώποισι τετύχθαι;	- - -u u-u u ---u u--	dactylic hexameter	feminine penthemimeral
οὐ μὲν γάρ τι κακὸν βασιλευέμεν· αἶψά τέ οἱ δῶ	- - - u u- uu-uu -u u - -	dactylic hexameter	masculine penthemimeral, trithemimeral
ἀφνειὸν πέλεται καὶ τιμηέστερος αὐτός.	--- uu- - ---uu --	dactylic hexameter	masculine penthemimeral, trithemimeral
ἀλλ’ ἦ τοι βασιλῆες Ἀχαιῶν εἰσὶ καὶ ἄλλοι	- - - uu-u u-- -u u --	dactylic hexameter	feminine penthemimeral, trithemimeral
πολλοὶ ἐν ἀμφιάλῳ Ἰθάκῃ, νέοι ἠδὲ παλαιοί,	-u u -uu- uu- uu -u u--	dactylic hexameter	masculine penthemimeral, hepthemimeral
τῶν κέν τις τόδ’ ἔχῃσιν, ἐπεὶ θάνε δῖος Ὀδυσσεύς·	- - - u u-u u- uu -u u--	dactylic hexameter	feminine penthemimeral, hepthemimeral, trithemimeral
αὐτὰρ ἐγὼν οἴκοιο ἄναξ ἔσομ’ ἡμετέροιο	-u u- --u u- uu -uu--	dactylic hexameter	feminine penthemimeral, hepthemimeral, trithemimeral
καὶ δμώων, οὕς μοι ληίσσατο δῖος Ὀδυσσεύς.	- -- - - --uu -u u--	dactylic hexameter	masculine penthemimeral, trithemimeral
τὸν δ’αὖτ’ Εὐρύμαχος Πολύβου πάϊς ἀντίον ηὔδα·	- - -uu- uu- uu -uu --	dactylic hexameter	masculine penthemimeral, hepthemimeral
Τηλέμαχ’, ἦ τοι ταῦτα θεῶν ἐν γούνασι κεῖται,	-uu - - -u u- - -uu --	dactylic hexameter	feminine penthemimeral, hepthemimeral, trithemimeral
ὅς τις ἐν ἀμφιάλῳ Ἰθάκῃ βασιλεύσει Ἀχαιῶν·	- u u -uu- uu- uu-u u--	dactylic hexameter	masculine penthemimeral, hepthemimeral
κτήματα δ’αὐτὸς ἔχοις καὶ δώμασιν οἷσιν ἀνάσσοις.	-uu -u u- - -uu -u u--	dactylic hexameter	masculine penthemimeral
μὴ γὰρ ὅ γ’ἔλθοι ἀνὴρ ὅς τίς σ’ἀέκοντα βίηφιν	- u u -u u- - - uu-u u--	dactylic hexameter	masculine penthemimeral, hepthemimeral
κτήματ’ ἀπορραίσει, Ἰθάκης ἔτι ναιετοώσης.	-u u--- uu- uu -uu--	dactylic hexameter	masculine penthemimeral, hepthemimeral
ἀλλ’ ἐθέλω σε, φέριστε, περὶ ξείνοιο ἐρέσθαι,	- uu- u u-u u- --u u--	dactylic hexameter	feminine penthemimeral, hepthemimeral, trithemimeral
ὁππόθεν οὗτος ἀνήρ, ποίης δ’ἐξ εὔχεται εἶναι	-uu -u u- -- - -uu --	dactylic hexameter	masculine penthemimeral, hepthemimeral
γαίης, ποῦ δέ νύ οἱ γενεὴ καὶ πατρὶς ἄρουρα.	-- - u u - uu- - -u u--	dactylic hexameter	masculine penthemimeral, hepthemimeral, trithemimeral
ἠέ τιν’ ἀγγελίην πατρὸς φέρει ἐρχομένοιο,	-u u -uu- -- uu -uu--	dactylic hexameter	masculine penthemimeral, hepthemimeral
ἦ ἑὸν αὐτοῦ χρεῖος ἐελδόμενος τόδ’ ἱκάνει;	- uu -- -u u-uu- u u--	dactylic hexameter	feminine penthemimeral
οἷον ἀναΐξας ἄφαρ οἴχεται, οὐδ’ ὑπέμεινε	-u u--- uu -uu - uu--	dactylic hexameter	masculine penthemimeral
γνώμεναι· οὐ μὲν γάρ τι κακῷ εἰς ὦπα ἐᾐκει.	-uu - - - u u- - -u u--	dactylic hexameter	masculine penthemimeral, hepthemimeral, trithemimeral
τὸν δ’αὖ Τηλέμαχος πεπνυμένος ἀντίον ηὔδα·	- - -uu- --uu -uu --	dactylic hexameter	masculine penthemimeral
Εὐρύμαχ’, ἦ τοι νόστος ἀπώλετο πατρὸς ἐμοῖο·	-uu - - -u u-uu -u u--	dactylic hexameter	feminine penthemimeral, trithemimeral
οὔτ’ οὖν ἀγγελίῃ ἔτι πείθομαι, εἴ ποθεν ἔλθοι,	- - -uu- uu -uu - uu --	dactylic hexameter	masculine penthemimeral
οὔτε θεοπροπίης ἐμπάζομαι, ἥν τινα μήτηρ	-u u-uu- --uu - uu --	dactylic hexameter	masculine penthemimeral
ἐς μέγαρον καλέσασα θεοπρόπον ἐξερέηται.	- uu- uu-u u-uu -uu--	dactylic hexameter	feminine penthemimeral, trithemimeral
ξεῖνος δ’οὗτος ἐμὸς πατρώιος ἐκ Τάφου ἐστίν,	-- -u u- --uu - uu --	dactylic hexameter	masculine penthemimeral
Μέντης δ’Ἀγχιάλοιο δαΐφρονος εὔχεται εἶναι	-- -uu-u u-uu -uu --	dactylic hexameter	feminine penthemimeral
υἱός, ἀτὰρ Ταφίοισι φιληρέτμοισιν ἀνάσσει.	-u u- uu-u u---u u--	dactylic hexameter	feminine penthemimeral, trithemimeral
ὣς φάτο Τηλέμαχος, φρεσὶ δ’ἀθανάτην θεὸν ἔγνω.	- uu -uu- uu -uu- uu --	dactylic hexameter	masculine penthemimeral
οἱ δ’εἰς ὀρχηστύν τε καὶ ἱμερόεσσαν ἀοιδὴν	- - --- u u -uu-u u--	dactylic hexameter	masculine penthemimeral
τρεψάμενοι τέρποντο, μένον δ’ἐπὶ ἕσπερον ἐλθεῖν.	-uu- --u u- uu -uu --	dactylic hexameter	feminine penthemimeral, hepthemimeral, trithemimeral
τοῖσι δὲ τερπομένοισι μέλας ἐπὶ ἕσπερος ἦλθε·	-u u -uu-u u- uu -uu --	dactylic hexameter	feminine penthemimeral, hepthemimeral
δὴ τότε κακκείοντες ἔβαν οἶκόνδε ἕκαστος.	- uu ---u u- --u u--	dactylic hexameter	feminine penthemimeral, hepthemimeral
Τηλέμαχος δ’,ὅθι οἱ θάλαμος περικαλλέος αὐλῆς	-uu- uu - uu- uu-uu --	dactylic hexameter	masculine penthemimeral, hepthemimeral, trithemimeral
ὑψηλὸς δέδμητο περισκέπτῳ ἐνὶ χώρῳ,	--- --u u--- uu --	dactylic hexameter	feminine penthemimeral, trithemimeral
ἔνθ’ ἔβη εἰς εὐνὴν πολλὰ φρεσὶ μερμηρίζων.	- uu - -- -- uu ----	dactylic hexameter	masculine penthemimeral, hepthemimeral, trithemimeral
τῷ δ’ἄρ’ ἅμ’ αἰθομένας δαΐδας φέρε κεδνὰ ἰδυῖα	- u u -uu- uu- uu -u u--	dactylic hexameter	masculine penthemimeral, hepthemimeral
Εὐρύκλει’, Ὦπος θυγάτηρ Πεισηνορίδαο,	--- -- uu- --uu--	dactylic hexameter	masculine penthemimeral, hepthemimeral, trithemimeral
τήν ποτε Λαέρτης πρίατο κτεάτεσσιν ἑοῖσιν	- uu --- uu- uu-u u--	dactylic hexameter	masculine penthemimeral, hepthemimeral
πρωθήβην ἔτ’ ἐοῦσαν, ἐεικοσάβοια δ’ἔδωκεν,	--- u u-u u-uu-u u--	dactylic hexameter	feminine penthemimeral, trithemimeral
ἶσα δέ μιν κεδνῇ ἀλόχῳ τίεν ἐν μεγάροισιν,	-u u - -- uu- uu - uu--	dactylic hexameter	masculine penthemimeral, hepthemimeral, trithemimeral
εὐνῇ δ’οὔ ποτ’ ἔμικτο, χόλον δ’ἀλέεινε γυναικός·	-- - u u-u u- uu-u u--	dactylic hexameter	feminine penthemimeral, hepthemimeral, trithemimeral
ἥ οἱ ἅμ’ αἰθομένας δαΐδας φέρε, καί ἑ μάλιστα	- u u -uu- uu- uu - u u--	dactylic hexameter	masculine penthemimeral, hepthemimeral
δμῳάων φιλέεσκε, καὶ ἔτρεφε τυτθὸν ἐόντα.	--- uu-u u -uu -u u--	dactylic hexameter	feminine penthemimeral, trithemimeral
ὤιξεν δὲ θύρας θαλάμου πύκα ποιητοῖο,	--- u u- uu- uu ----	dactylic hexameter	masculine penthemimeral, hepthemimeral, trithemimeral
ἕζετο δ’ἐν λέκτρῳ, μαλακὸν δ’ἔκδυνε χιτῶνα·	-uu - -- uu- --u u--	dactylic hexameter	masculine penthemimeral, hepthemimeral, trithemimeral
καὶ τὸν μὲν γραίης πυκιμηδέος ἔμβαλε χερσίν.	- - - -- uu-uu -uu --	dactylic hexameter	masculine penthemimeral, trithemimeral
ἡ μὲν τὸν πτύξασα καὶ ἀσκήσασα χιτῶνα,	- - - --u u ---u u--	dactylic hexameter	feminine penthemimeral, trithemimeral
πασσάλῳ ἀγκρεμάσασα παρὰ τρητοῖσι λέχεσσι	-uu -uu-u u- --u u--	dactylic hexameter	feminine penthemimeral, hepthemimeral
βῆ ῥ’ἴμεν ἐκ θαλάμοιο, θύρην δ’ἐπέρυσσε κορώνῃ	- uu - uu-u u- uu-u u--	dactylic hexameter	feminine penthemimeral, hepthemimeral, trithemimeral
ἀργυρέῃ, ἐπὶ δὲ κληῖδ’ ἐτάνυσσεν ἱμάντι.	-uu- uu - -- uu-u u--	dactylic hexameter	masculine penthemimeral, hepthemimeral, trithemimeral
ἔνθ’ ὅ γε παννύχιος, κεκαλυμμένος οἰὸς ἀώτῳ,	- u u -uu- uu-uu -u u--	dactylic hexameter	masculine penthemimeral
βούλευε φρεσὶν ᾗσιν ὁδὸν τὴν πέφραδ’ Ἀθήνη.	--- uu -u u- - -u u--	dactylic hexameter	feminine penthemimeral, hepthemimeral, trithemimeral
