ἡ δ’εἰς εὐρύχορον Λακεδαίμονα Παλλὰς Ἀθήνη	- - -uu- uu-uu -u u--	dactylic hexameter	masculine penthemimeral
ᾤχετ’, Ὀδυσσῆος μεγαθύμου φαίδιμον υἱὸν	-u u--- uu-- -uu --	dactylic hexameter	masculine penthemimeral
νόστου ὑπομνήσουσα καὶ ὀτρυνέουσα νέεσθαι.	-u u---u u -uu-u u--	dactylic hexameter	feminine penthemimeral
εὗρε δὲ Τηλέμαχον καὶ Νέστορος ἀγλαὸν υἱὸν	-u u -uu- - -uu -uu --	dactylic hexameter	masculine penthemimeral
εὕδοντ’ ἐν προδόμῳ Μενελάου κυδαλίμοιο,	-- - uu- uu-- -uu--	dactylic hexameter	masculine penthemimeral, trithemimeral
ἤτοι Νεστορίδην μαλακῷ δεδμημένον ὕπνῳ·	-- -uu- uu- --uu --	dactylic hexameter	masculine penthemimeral, hepthemimeral
Τηλέμαχον δ’οὐχ ὕπνος ἔχε γλυκύς, ἀλλ’ ἐνὶ θυμῷ	-uu- - -u u- uu - uu --	dactylic hexameter	feminine penthemimeral, hepthemimeral, trithemimeral
νύκτα δι’ ἀμβροσίην μελεδήματα πατρὸς ἔγειρεν.	-u u -uu- uu-uu -u u--	dactylic hexameter	masculine penthemimeral
ἀγχοῦ δ’ἱσταμένη προσέφη γλαυκῶπις Ἀθήνη·	-- -uu- uu- --u u--	dactylic hexameter	masculine penthemimeral, hepthemimeral
Τηλέμαχ’, οὐκέτι καλὰ δόμων ἄπο τῆλ’ ἀλάλησαι,	-uu -uu -u u- uu - uu--	dactylic hexameter	feminine penthemimeral, hepthemimeral
κτήματά τε προλιπὼν ἄνδρας τ’ἐν σοῖσι δόμοισιν	-uu - uu- -- - -u u--	dactylic hexameter	masculine penthemimeral, hepthemimeral, trithemimeral
οὕτω ὑπερφιάλους· μή τοι κατὰ πάντα φάγωσι	-u u-uu- - - uu -u u--	dactylic hexameter	masculine penthemimeral, hepthemimeral
κτήματα δασσάμενοι, σὺ δὲ τηϋσίην ὁδὸν ἔλθῃς.	-uu -uu- u u -uu- uu --	dactylic hexameter	masculine penthemimeral
ἀλλ’ ὄτρυνε τάχιστα βοὴν ἀγαθὸν Μενέλαον	- --u u-u u- uu- uu--	dactylic hexameter	feminine penthemimeral, hepthemimeral
πεμπέμεν, ὄφρ’ ἔτι οἴκοι ἀμύμονα μητέρα τέτμῃς.	-uu - uu -u u-uu -uu --	dactylic hexameter	feminine penthemimeral, trithemimeral
ἤδη γάρ ῥα πατήρ τε κασίγνητοί τε κέλονται	-- - u u- u u--- u u--	dactylic hexameter	masculine penthemimeral, trithemimeral
Εὐρυμάχῳ γήμασθαι· ὁ γὰρ περιβάλλει ἅπαντας	-uu- --u u - uu-u u--	dactylic hexameter	feminine penthemimeral, hepthemimeral, trithemimeral
μνηστῆρας δώροισι καὶ ἐξώφελλεν ἔεδνα·	--- --u u ---u u--	dactylic hexameter	feminine penthemimeral, trithemimeral
μή νύ τι σεῦ ἀέκητι δόμων ἐκ κτῆμα φέρηται.	- u u - uu-u u- - -u u--	dactylic hexameter	feminine penthemimeral, hepthemimeral, trithemimeral
οἶσθα γὰρ οἷος θυμὸς ἐνὶ στήθεσσι γυναικός·	-u u -- -u u- --u u--	dactylic hexameter	feminine penthemimeral, hepthemimeral
κείνου βούλεται οἶκον ὀφέλλειν ὅς κεν ὀπυίοι,	-- -uu -u u-- - u u--	dactylic hexameter	feminine penthemimeral
παίδων δὲ προτέρων καὶ κουριδίοιο φίλοιο	-- - uu- - -uu-u u--	dactylic hexameter	masculine penthemimeral, trithemimeral
οὐκέτι μέμνηται τεθνηότος οὐδὲ μεταλλᾷ.	-uu --- --uu -u u--	dactylic hexameter	masculine penthemimeral
ἀλλὰ σύ γ’ἐλθὼν αὐτὸς ἐπιτρέψειας ἕκαστα	-u u -- -u u---u u--	dactylic hexameter	feminine penthemimeral
δμῳάων ἥ τίς τοι ἀρίστη φαίνεται εἶναι,	--- - - u u-- -uu --	dactylic hexameter	masculine penthemimeral, trithemimeral
εἰς ὅ κέ τοι φήνωσι θεοὶ κυδρὴν παράκοιτιν.	- u u - --u u- -- uu--	dactylic hexameter	feminine penthemimeral, hepthemimeral, trithemimeral
ἄλλο δέ τοί τι ἔπος ἐρέω, σὺ δὲ σύνθεο θυμῷ.	-u u - u u- uu- u u -uu --	dactylic hexameter	masculine penthemimeral, hepthemimeral, trithemimeral
μνηστήρων σ’ἐπιτηδὲς ἀριστῆες λοχόωσιν	--- uu-u u--- uu--	dactylic hexameter	feminine penthemimeral, trithemimeral
ἐν πορθμῷ Ἰθάκης τε Σάμοιό τε παιπαλοέσσης.	- -- uu- u u-u u -uu--	dactylic hexameter	masculine penthemimeral, trithemimeral
ἱέμενοι κτεῖναι, πρὶν πατρίδα γαῖαν ἱκέσθαι.	-uu- -- - -uu -u u--	dactylic hexameter	masculine penthemimeral, trithemimeral
ἀλλὰ τά γ’οὐκ ὀΐω· πρὶν καί τινα γαῖα καθέξει	-u u - uu- - - uu -u u--	dactylic hexameter	masculine penthemimeral, hepthemimeral, trithemimeral
ἀνδρῶν μνηστήρων, οἵ τοι βίοτον κατέδουσιν.	-- --- - - uu- uu--	dactylic hexameter	masculine penthemimeral, hepthemimeral
ἀλλὰ ἑκὰς νήσων ἀπέχειν εὐεργέα νῆα,	-u u- -- uu- --uu --	dactylic hexameter	masculine penthemimeral, hepthemimeral, trithemimeral
νυκτὶ δ’ὁμῶς πλείειν· πέμψει δέ τοι οὖρον ὄπισθεν	-u u- -- -- u u -u u--	dactylic hexameter	masculine penthemimeral, hepthemimeral, trithemimeral
ἀθανάτων ὅς τίς σε φυλάσσει τε ῥύεταί τε.	-uu- - - u u-- - uu- -	dactylic hexameter	masculine penthemimeral, trithemimeral
αὐτὰρ ἐπὴν πρώτην ἀκτὴν Ἰθάκης ἀφίκηαι,	-u u- -- -- uu- uu--	dactylic hexameter	masculine penthemimeral, hepthemimeral, trithemimeral
νῆα μὲν ἐς πόλιν ὀτρῦναι καὶ πάντας ἑταίρους,	-u u - uu --- - -u u--	dactylic hexameter	hepthemimeral, trithemimeral
αὐτὸς δὲ πρώτιστα συβώτην εἰσαφικέσθαι,	-- - --u u-- -uu--	dactylic hexameter	feminine penthemimeral, trithemimeral
ὅς τοι ὑῶν ἐπίουρος, ὁμῶς δέ τοι ἤπια οἶδεν.	- u u- uu-u u- u u -uu --	dactylic hexameter	feminine penthemimeral, hepthemimeral, trithemimeral
ἔνθα δὲ νύκτ’ ἀέσαι· τὸν δ’ὀτρῦναι πόλιν εἴσω	-u u - uu- - --- uu --	dactylic hexameter	masculine penthemimeral, trithemimeral
ἀγγελίην ἐρέοντα περίφρονι Πηνελοπείῃ,	-uu- uu-u u-uu -uu--	dactylic hexameter	feminine penthemimeral, trithemimeral
οὕνεκά οἱ σῶς ἐσσὶ καὶ ἐκ Πύλου εἰλήλουθας.	-uu - - -u u - uu ----	dactylic hexameter	feminine penthemimeral, hepthemimeral, trithemimeral
ἡ μὲν ἄρ’ ὣς εἰποῦσ’ ἀπέβη πρὸς μακρὸν Ὄλυμπον,	- u u - -- uu- - -u u--	dactylic hexameter	masculine penthemimeral, hepthemimeral, trithemimeral
αὐτὰρ ὁ Νεστορίδην ἐξ ἡδέος ὕπνου ἔγειρε	-u u -uu- - -uu -u u--	dactylic hexameter	masculine penthemimeral
λὰξ ποδὶ κινήσας, καί μιν πρὸς μῦθον ἔειπεν·	- uu --- - - - -u u--	dactylic hexameter	masculine penthemimeral, hepthemimeral
ἔγρεο, Νεστορίδη Πεισίστρατε, μώνυχας ἵππους	-uu -uu- --uu -uu --	dactylic hexameter	masculine penthemimeral
ζεῦξον ὑφ’ ἅρματ’ ἄγων, ὄφρα πρήσσωμεν ὁδοῖο.	-u u -u u- -- --u u--	dactylic hexameter	masculine penthemimeral, hepthemimeral
τὸν δ’αὖ Νεστορίδης Πεισίστρατος ἀντίον ηὔδα·	- - -uu- --uu -uu --	dactylic hexameter	masculine penthemimeral
Τηλέμαχ’, οὔ πως ἔστιν ἐπειγομένους περ ὁδοῖο	-uu - - -u u-uu- u u--	dactylic hexameter	feminine penthemimeral, trithemimeral
νύκτα διὰ δνοφερὴν ἐλάαν· τάχα δ’ἔσσεται ἠώς.	-u u- uu- uu- uu -uu --	dactylic hexameter	masculine penthemimeral, hepthemimeral, trithemimeral
ἀλλὰ μέν’ εἰς ὅ κε δῶρα φέρων ἐπιδίφρια θήῃ	-u u - u u -u u- uu-uu --	dactylic hexameter	feminine penthemimeral, hepthemimeral, trithemimeral
ἥρως Ἀτρεΐδης, δουρικλειτὸς Μενέλαος,	-- -uu- ---- uu--	dactylic hexameter	masculine penthemimeral
καὶ μύθοις ἀγανοῖσι παραυδήσας ἀποπέμψῃ.	- -- uu-u u--- uu--	dactylic hexameter	feminine penthemimeral, trithemimeral
τοῦ γάρ τε ξεῖνος μιμνήσκεται ἤματα πάντα	- - - -- --uu -uu --	dactylic hexameter	masculine penthemimeral, trithemimeral
ἀνδρὸς ξεινοδόκου, ὅς κεν φιλότητα παράσχῃ.	-- -uu- - - uu-u u--	dactylic hexameter	masculine penthemimeral, hepthemimeral
ὣς ἔφατ’, αὐτίκα δὲ χρυσόθρονος ἤλυθεν Ἠώς.	- uu -uu - --uu -uu --	dactylic hexameter	masculine penthemimeral
ἀγχίμολον δέ σφ’ἦλθε βοὴν ἀγαθὸς Μενέλαος,	-uu- - -u u- uu- uu--	dactylic hexameter	feminine penthemimeral, hepthemimeral, trithemimeral
ἀνστὰς ἐξ εὐνῆς, Ἑλένης πάρα καλλικόμοιο.	-- - -- uu- uu -uu--	dactylic hexameter	masculine penthemimeral, hepthemimeral, trithemimeral
τὸν δ’ὡς οὖν ἐνόησεν Ὀδυσσῆος φίλος υἱός,	- - - uu-u u--- uu --	dactylic hexameter	feminine penthemimeral, trithemimeral
σπερχόμενός ῥα χιτῶνα περὶ χροῒ σιγαλόεντα	-uu- u u-u u- uu -uu--	dactylic hexameter	feminine penthemimeral, hepthemimeral, trithemimeral
δῦνεν, καὶ μέγα φᾶρος ἐπὶ στιβαροῖς βάλετ’ ὤμοις	-- - uu -u u- uu- uu --	dactylic hexameter	feminine penthemimeral, hepthemimeral, trithemimeral
ἥρως, βῆ δὲ θύραζε, παριστάμενος δὲ προσηύδα	-- - u u-u u-uu- u u--	dactylic hexameter	feminine penthemimeral, trithemimeral
Τηλέμαχος, φίλος υἱὸς Ὀδυσσῆος θείοιο·	-uu- uu -u u--- ---	dactylic hexameter	feminine penthemimeral, trithemimeral
Ἀτρεΐδη Μενέλαε διοτρεφές, ὄρχαμε λαῶν,	-uu- uu-u u-uu -uu --	dactylic hexameter	feminine penthemimeral, trithemimeral
ἤδη νῦν μ’ἀπόπεμπε φίλην ἐς πατρίδα γαῖαν·	-- - uu-u u- - -uu --	dactylic hexameter	feminine penthemimeral, hepthemimeral, trithemimeral
ἤδη γάρ μοι θυμὸς ἐέλδεται οἴκαδ’ ἱκέσθαι.	-- - - -u u-uu -u u--	dactylic hexameter	feminine penthemimeral, trithemimeral
τὸν δ’ἠμείβετ’ ἔπειτα βοὴν ἀγαθὸς Μενέλαος·	- --u u-u u- uu- uu--	dactylic hexameter	feminine penthemimeral, hepthemimeral
Τηλέμαχ’, οὔ τί σ’ἔγωγε πολὺν χρόνον ἐνθάδ’ ἐρύξω	-uu - u u-u u- uu -u u--	dactylic hexameter	feminine penthemimeral, hepthemimeral, trithemimeral
ἱέμενον νόστοιο· νεμεσσῶμαι δὲ καὶ ἄλλῳ	-uu- --u u--- u u --	dactylic hexameter	feminine penthemimeral, trithemimeral
ἀνδρὶ ξεινοδόκῳ, ὅς κ’ἔξοχα μὲν φιλέῃσιν,	-- -uu- - -uu - uu--	dactylic hexameter	masculine penthemimeral
ἔξοχα δ’ἐχθαίρῃσιν· ἀμείνω δ’αἴσιμα πάντα.	-uu ---u u-- -uu --	dactylic hexameter	feminine penthemimeral
ἶσόν τοι κακόν ἐσθ’, ὅς τ’οὐκ ἐθέλοντα νέεσθαι	-- - uu - - - uu-u u--	dactylic hexameter	masculine penthemimeral, hepthemimeral, trithemimeral
ξεῖνον ἐποτρύνῃ καὶ ὃς ἐσσύμενον κατερύκῃ.	-u u--- u u -uu- uu--	dactylic hexameter	masculine penthemimeral
χρὴ ξεῖνον παρεόντα φιλεῖν, ἐθέλοντα δὲ πέμπειν.	- -- uu-u u- uu-u u --	dactylic hexameter	feminine penthemimeral, hepthemimeral, trithemimeral
ἀλλὰ μέν’ εἰς ὅ κε δῶρα φέρων ἐπιδίφρια θείω	-u u - u u -u u- uu-uu --	dactylic hexameter	feminine penthemimeral, hepthemimeral, trithemimeral
καλά, σὺ δ’ὀφθαλμοῖσιν ἴδῃς, εἴπω δὲ γυναιξὶ	-u u ---u u- -- u u--	dactylic hexameter	feminine penthemimeral, hepthemimeral
δεῖπνον ἐνὶ μεγάροις τετυκεῖν ἅλις ἔνδον ἐόντων.	-u u- uu- uu- uu -u u--	dactylic hexameter	masculine penthemimeral, hepthemimeral, trithemimeral
ἀμφότερον, κῦδός τε καὶ ἀγλαΐη καὶ ὄνειαρ,	-uu- -- u u -uu- u u--	dactylic hexameter	masculine penthemimeral, trithemimeral
δειπνήσαντας ἴμεν πολλὴν ἐπ’ ἀπείρονα γαῖαν.	---u u- -- u u-uu --	dactylic hexameter	masculine penthemimeral, hepthemimeral
εἰ δ’ἐθέλεις τραφθῆναι ἀν’ Ἑλλάδα καὶ μέσον Ἄργος,	- uu- --u u -uu - uu --	dactylic hexameter	feminine penthemimeral, trithemimeral
ὄφρα τοι αὐτὸς ἕπωμαι, ὑποζεύξω δέ τοι ἵππους,	-u u -u u-u u--- u u --	dactylic hexameter	feminine penthemimeral
ἄστεα δ’ἀνθρώπων ἡγήσομαι· οὐδέ τις ἡμέας	-uu --- --uu -u u --	dactylic hexameter	masculine penthemimeral
αὔτως ἀμπέμψει, δώσει δέ τι ἕν γε φέρεσθαι,	-- --- -- u u - u u--	dactylic hexameter	masculine penthemimeral, hepthemimeral
ἠέ τινα τριπόδων εὐχάλκων ἠὲ λεβήτων,	-u u- uu- --- -u u--	dactylic hexameter	masculine penthemimeral, trithemimeral
ἠὲ δύ’ ἡμιόνους ἠὲ χρύσειον ἄλεισον.	-u u -uu- -- --u u--	dactylic hexameter	masculine penthemimeral, hepthemimeral
τὸν δ’αὖ Τηλέμαχος πεπνυμένος ἀντίον ηὔδα·	- - -uu- --uu -uu --	dactylic hexameter	masculine penthemimeral
Ἀτρεΐδη Μενέλαε διοτρεφές, ὄρχαμε λαῶν,	-uu- uu-u u-uu -uu --	dactylic hexameter	feminine penthemimeral, trithemimeral
βούλομαι ἤδη νεῖσθαι ἐφ’ ἡμέτερ’· οὐ γὰρ ὄπισθεν	-uu -- -u u -uu - u u--	dactylic hexameter	feminine penthemimeral
οὖρον ἰὼν κατέλειπον ἐπὶ κτεάτεσσιν ἐμοῖσι·	-u u- uu-u u- uu-u u--	dactylic hexameter	feminine penthemimeral, hepthemimeral, trithemimeral
μὴ πατέρ’ ἀντίθεον διζήμενος αὐτὸς ὄλωμαι,	- uu -uu- --uu -u u--	dactylic hexameter	masculine penthemimeral
ἤ τί μοι ἐκ μεγάρων κειμήλιον ἐσθλὸν ὄληται.	- u u - uu- --uu -u u--	dactylic hexameter	masculine penthemimeral, trithemimeral
αὐτὰρ ἐπεὶ τό γ’ἄκουσε βοὴν ἀγαθὸς Μενέλαος,	-u u- u u-u u- uu- uu--	dactylic hexameter	feminine penthemimeral, hepthemimeral, trithemimeral
αὐτίκ’ ἄρ’ ᾗ ἀλόχῳ ἠδὲ δμῳῇσι κέλευσε	-u u - uu- -- --u u--	dactylic hexameter	masculine penthemimeral, hepthemimeral, trithemimeral
δεῖπνον ἐνὶ μεγάροις τετυκεῖν ἅλις ἔνδον ἐόντων.	-u u- uu- uu- uu -u u--	dactylic hexameter	masculine penthemimeral, hepthemimeral, trithemimeral
ἀγχίμολον δέ οἱ ἦλθε Βοηθοΐδης Ἐτεωνεύς,	-uu- u u -u u-uu- uu--	dactylic hexameter	feminine penthemimeral, trithemimeral
ἀνστὰς ἐξ εὐνῆς, ἐπεὶ οὐ πολὺ ναῖεν ἀπ’ αὐτοῦ·	-- - -- uu - uu -u u --	dactylic hexameter	masculine penthemimeral, hepthemimeral, trithemimeral
τὸν πῦρ κῆαι ἄνωγε βοὴν ἀγαθὸς Μενέλαος	- - -u u-u u- uu- uu--	dactylic hexameter	feminine penthemimeral, hepthemimeral
ὀπτῆσαί τε κρεῶν· ὁ δ’ἄρ’ οὐκ ἀπίθησεν ἀκούσας.	--- u u- u u - uu-u u--	dactylic hexameter	masculine penthemimeral, hepthemimeral, trithemimeral
αὐτὸς δ’ἐς θάλαμον κατεβήσατο κηώεντα,	-- - uu- uu-uu ----	dactylic hexameter	masculine penthemimeral, trithemimeral
οὐκ οἶος, ἅμα τῷ γ’Ἑλένη κίε καὶ Μεγαπένθης.	- -- uu - uu- uu - uu--	dactylic hexameter	masculine penthemimeral, hepthemimeral, trithemimeral
ἀλλ’ ὅτε δή ῥ’ἵκαν’ ὅθι οἱ κειμήλια κεῖτο,	- uu - -- uu - --uu --	dactylic hexameter	masculine penthemimeral, hepthemimeral, trithemimeral
Ἀτρεΐδης μὲν ἔπειτα δέπας λάβεν ἀμφικύπελλον,	-uu- u u-u u- uu -uu--	dactylic hexameter	feminine penthemimeral, hepthemimeral, trithemimeral
υἱὸν δὲ κρητῆρα φέρειν Μεγαπένθε’ ἄνωγεν	-- - --u u- uu-u u--	dactylic hexameter	feminine penthemimeral, hepthemimeral, trithemimeral
ἀργύρεον· Ἑλένη δὲ παρίστατο φωριαμοῖσιν,	-uu- uu- u u-uu -uu--	dactylic hexameter	masculine penthemimeral, trithemimeral
ἔνθ’ ἔσαν οἱ πέπλοι παμποίκιλοι, οὓς κάμεν αὐτή.	- uu - -- --uu - uu --	dactylic hexameter	masculine penthemimeral, trithemimeral
τῶν ἕν’ ἀειραμένη Ἑλένη φέρε, δῖα γυναικῶν,	- u u-uu- uu- uu -u u--	dactylic hexameter	masculine penthemimeral, hepthemimeral
ὃς κάλλιστος ἔην ποικίλμασιν ἠδὲ μέγιστος,	- --u u- --uu -u u--	dactylic hexameter	masculine penthemimeral
ἀστὴρ δ’ὣς ἀπέλαμπεν· ἔκειτο δὲ νείατος ἄλλων.	-- - uu-u u-u u -uu --	dactylic hexameter	feminine penthemimeral, trithemimeral
βὰν δ’ἰέναι προτέρω διὰ δώματος, ἕως ἵκοντο	- uu- uu- uu -uu - ---	dactylic hexameter	masculine penthemimeral, trithemimeral
Τηλέμαχον· τὸν δὲ προσέφη ξανθὸς Μενέλαος·	-uu- - - uu- -- uu--	dactylic hexameter	masculine penthemimeral, hepthemimeral, trithemimeral
Τηλέμαχ’, ἤτοι νόστον, ὅπως φρεσὶ σῇσι μενοινᾷς,	-uu -- -u u- uu -u u--	dactylic hexameter	feminine penthemimeral, hepthemimeral
ὥς τοι Ζεὺς τελέσειεν, ἐρίγδουπος πόσις Ἥρης.	- - - uu-u u--- uu --	dactylic hexameter	feminine penthemimeral, trithemimeral
δώρων δ’,ὅσσ’ ἐν ἐμῷ οἴκῳ κειμήλια κεῖται,	-- - u u- -- --uu --	dactylic hexameter	masculine penthemimeral, hepthemimeral, trithemimeral
δώσω ὃ κάλλιστον καὶ τιμηέστατόν ἐστι.	-u u --- - ---uu --	dactylic hexameter	masculine penthemimeral
δώσω τοι κρητῆρα τετυγμένον· ἀργύρεος δὲ	-- - --u u-uu -uu- -	dactylic hexameter	feminine penthemimeral, trithemimeral
ἐστὶν ἅπας, χρυσῷ δ’ἐπὶ χείλεα κεκράανται,	-u u- -- uu -uu ----	dactylic hexameter	masculine penthemimeral, trithemimeral
ἔργον δ’Ἡφαίστοιο· πόρεν δέ ἑ Φαίδιμος ἥρως,	-- ---u u- u u -uu --	dactylic hexameter	feminine penthemimeral, hepthemimeral
Σιδονίων βασιλεύς, ὅθ’ ἑὸς δόμος ἀμφεκάλυψε	-uu- uu- u u- uu -uu--	dactylic hexameter	masculine penthemimeral, hepthemimeral, trithemimeral
κεῖσέ με νοστήσαντα· τεῒν δ’ἐθέλω τόδ’ ὀπάσσαι.	-u u ---u u- uu- u u--	dactylic hexameter	feminine penthemimeral, hepthemimeral
ὣς εἰπὼν ἐν χερσὶ τίθει δέπας ἀμφικύπελλον	- -- - -u u- uu -uu--	dactylic hexameter	feminine penthemimeral, hepthemimeral, trithemimeral
ἥρως Ἀτρεΐδης· ὁ δ’ἄρα κρητῆρα φαεινὸν	-- -uu- u u- --u u--	dactylic hexameter	masculine penthemimeral, hepthemimeral
θῆκ’ αὐτοῦ προπάροιθε φέρων κρατερὸς Μεγαπένθης,	- -- uu-u u- uu- uu--	dactylic hexameter	feminine penthemimeral, hepthemimeral, trithemimeral
ἀργύρεον· Ἑλένη δὲ παρίστατο καλλιπάρηος	-uu- uu- u u-uu -uu--	dactylic hexameter	masculine penthemimeral, trithemimeral
πέπλον ἔχουσ’ ἐν χερσίν, ἔπος τ’ἔφατ’ ἔκ τ’ὀνόμαζε·	-u u- - -u u- uu - uu--	dactylic hexameter	feminine penthemimeral, hepthemimeral, trithemimeral
δῶρόν τοι καὶ ἐγώ, τέκνον φίλε, τοῦτο δίδωμι,	-- - u u- -- uu -u u--	dactylic hexameter	masculine penthemimeral, hepthemimeral, trithemimeral
μνῆμ’ Ἑλένης χειρῶν, πολυηράτου ἐς γάμου ὥρην,	- uu- -- uu-uu - uu --	dactylic hexameter	masculine penthemimeral, trithemimeral
σῇ ἀλόχῳ φορέειν· τείως δὲ φίλῃ παρὰ μητρὶ	- uu- uu- -- u u- uu --	dactylic hexameter	masculine penthemimeral, hepthemimeral, trithemimeral
κείσθω ἐνὶ μεγάρῳ. σὺ δέ μοι χαίρων ἀφίκοιο	-u u- uu- u u - -- uu--	dactylic hexameter	masculine penthemimeral, hepthemimeral, trithemimeral
οἶκον ἐϋκτίμενον καὶ σὴν ἐς πατρίδα γαῖαν.	-u u-uu- - - - -uu --	dactylic hexameter	masculine penthemimeral, hepthemimeral
ὣς εἰποῦσ’ ἐν χερσὶ τίθει, ὁ δ’ἐδέξατο χαίρων.	- -- - -u u- u u-uu --	dactylic hexameter	feminine penthemimeral, hepthemimeral, trithemimeral
καὶ τὰ μὲν ἐς πείρινθα τίθει Πεισίστρατος ἥρως	- u u - --u u- --uu --	dactylic hexameter	feminine penthemimeral, hepthemimeral, trithemimeral
δεξάμενος, καὶ πάντα ἑῷ θηήσατο θυμῷ·	-uu- - -- - --uu --	dactylic hexameter	hepthemimeral, trithemimeral
τοὺς δ’ἦγε πρὸς δῶμα κάρη ξανθὸς Μενέλαος.	- -- - -u u- -- uu--	dactylic hexameter	feminine penthemimeral, hepthemimeral, trithemimeral
ἑζέσθην δ’ἄρ’ ἔπειτα κατὰ κλισμούς τε θρόνους τε.	--- u u-u u- -- u u- -	dactylic hexameter	feminine penthemimeral, hepthemimeral, trithemimeral
χέρνιβα δ’ἀμφίπολος προχόῳ ἐπέχευε φέρουσα	-uu -uu- uu- uu-u u--	dactylic hexameter	masculine penthemimeral, hepthemimeral
καλῇ χρυσείῃ, ὑπὲρ ἀργυρέοιο λέβητος,	-- --- uu -uu-u u--	dactylic hexameter	masculine penthemimeral
νίψασθαι· παρὰ δὲ ξεστὴν ἐτάνυσσε τράπεζαν.	--- uu - -- uu-u u--	dactylic hexameter	masculine penthemimeral, hepthemimeral, trithemimeral
σῖτον δ’αἰδοίη ταμίη παρέθηκε φέρουσα·	-- --- uu- uu-u u--	dactylic hexameter	masculine penthemimeral, hepthemimeral
εἴδατα πόλλ’ ἐπιθεῖσα, χαριζομένη παρεόντων·	-uu - uu-u u-uu- uu--	dactylic hexameter	feminine penthemimeral, trithemimeral
πὰρ δὲ Βοηθοΐδης κρέα δαίετο καὶ νέμε μοίρας·	- u u-uu- uu -uu - uu --	dactylic hexameter	masculine penthemimeral
ᾠνοχόει δ’υἱὸς Μενελάου κυδαλίμοιο.	-uu- -- uu-- -uu--	dactylic hexameter	masculine penthemimeral, trithemimeral
οἱ δ’ἐπ’ ὀνείαθ’ ἑτοῖμα προκείμενα χεῖρας ἴαλλον.	- u u-u u-u u-uu -u u--	dactylic hexameter	feminine penthemimeral
αὐτὰρ ἐπεὶ πόσιος καὶ ἐδητύος ἐξ ἔρον ἕντο,	-u u- uu- u u-uu - uu --	dactylic hexameter	masculine penthemimeral, trithemimeral
δὴ τότε Τηλέμαχος καὶ Νέστορος ἀγλαὸς υἱὸς	- uu -uu- - -uu -uu --	dactylic hexameter	masculine penthemimeral
ἵππους τ’ἐζεύγνυντ’ ἀνά θ’ἅρματα ποικίλ’ ἔβαινον,	-- --- uu -uu -u u--	dactylic hexameter	masculine penthemimeral
ἐκ δ’ἔλασαν προθύροιο καὶ αἰθούσης ἐριδούπου.	- uu- uu-u u --- uu--	dactylic hexameter	feminine penthemimeral, trithemimeral
τοὺς δὲ μετ’ Ἀτρεΐδης ἔκιε ξανθὸς Μενέλαος,	- u u -uu- uu- -- uu--	dactylic hexameter	masculine penthemimeral, hepthemimeral
οἶνον ἔχων ἐν χειρὶ μελίφρονα δεξιτερῆφι,	-u u- - -u u-uu -uu--	dactylic hexameter	feminine penthemimeral, trithemimeral
ἐν δέπαϊ χρυσέῳ, ὄφρα λείψαντε κιοίτην.	- uu- uu- -- --u u--	dactylic hexameter	masculine penthemimeral, hepthemimeral, trithemimeral
στῆ δ’ἵππων προπάροιθε, δεδισκόμενος δὲ προσηύδα·	- -- uu-u u-uu- u u--	dactylic hexameter	feminine penthemimeral, trithemimeral
χαίρετον, ὦ κούρω, καὶ Νέστορι ποιμένι λαῶν	-uu - -- - -uu -uu --	dactylic hexameter	masculine penthemimeral, trithemimeral
εἰπεῖν· ἦ γὰρ ἔμοιγε πατὴρ ὣς ἤπιος ἦεν,	-- - u u-u u- - -uu --	dactylic hexameter	feminine penthemimeral, hepthemimeral, trithemimeral
ἦος ἐνὶ Τροίῃ πολεμίζομεν υἷες Ἀχαιῶν.	-u u- -- uu-uu -u u--	dactylic hexameter	masculine penthemimeral, trithemimeral
τὸν δ’αὖ Τηλέμαχος πεπνυμένος ἀντίον ηὔδα·	- - -uu- --uu -uu --	dactylic hexameter	masculine penthemimeral
καὶ λίην κείνῳ γε, διοτρεφές, ὡς ἀγορεύεις,	- -- -- u u-uu - uu--	dactylic hexameter	masculine penthemimeral, trithemimeral
πάντα τάδ’ ἐλθόντες καταλέξομεν· αἲ γὰρ ἐγὼν ὣς	-u u --- uu-uu - u u- -	dactylic hexameter	masculine penthemimeral
νοστήσας Ἰθάκηνδε, κιχὼν Ὀδυσῆ’ ἐνὶ οἴκῳ,	--- uu-u u- uu- uu --	dactylic hexameter	feminine penthemimeral, hepthemimeral, trithemimeral
εἴποιμ’ ὡς παρὰ σεῖο τυχὼν φιλότητος ἁπάσης	-- - uu -u u- uu-u u--	dactylic hexameter	feminine penthemimeral, hepthemimeral, trithemimeral
ἔρχομαι, αὐτὰρ ἄγω κειμήλια πολλὰ καὶ ἐσθλά.	-uu -u u- --uu -u u --	dactylic hexameter	masculine penthemimeral
ὣς ἄρα οἱ εἰπόντι ἐπέπτατο δεξιὸς ὄρνις,	- uu - --u u-uu -uu --	dactylic hexameter	feminine penthemimeral, trithemimeral
αἰετὸς ἀργὴν χῆνα φέρων ὀνύχεσσι πέλωρον,	-uu -- -u u- uu-u u--	dactylic hexameter	feminine penthemimeral, hepthemimeral
ἥμερον ἐξ αὐλῆς· οἱ δ’ἰΰζοντες ἕποντο	-uu - -- - ---u u--	dactylic hexameter	masculine penthemimeral, trithemimeral
ἀνέρες ἠδὲ γυναῖκες· ὁ δέ σφισιν ἐγγύθεν ἐλθὼν	-uu -u u-u u - uu -uu --	dactylic hexameter	feminine penthemimeral, hepthemimeral
δεξιὸς ἤϊξε πρόσθ’ ἵππων· οἱ δὲ ἰδόντες	-uu --- - -- - u u--	dactylic hexameter	masculine penthemimeral
γήθησαν, καὶ πᾶσιν ἐνὶ φρεσὶ θυμὸς ἰάνθη.	--- - -u u- uu -u u--	dactylic hexameter	feminine penthemimeral, hepthemimeral, trithemimeral
τοῖσι δὲ Νεστορίδης Πεισίστρατος ἤρχετο μύθων·	-u u -uu- --uu -uu --	dactylic hexameter	masculine penthemimeral
φράζεο δή, Μενέλαε διοτρεφές, ὄρχαμε λαῶν,	-uu - uu-u u-uu -uu --	dactylic hexameter	feminine penthemimeral, trithemimeral
εἰ νῶϊν τόδ’ ἔφηνε θεὸς τέρας ἦε σοὶ αὐτῷ.	- -- u u-u u- uu -u u --	dactylic hexameter	feminine penthemimeral, hepthemimeral, trithemimeral
ὣς φάτο, μερμήριξε δ’ ἀρηΐφιλος Μενέλαος,	- uu ---u u-uu- uu--	dactylic hexameter	feminine penthemimeral
ὅππως οἱ κατὰ μοῖραν ὑποκρίναιτο νοήσας.	-- - uu -u u---u u--	dactylic hexameter	feminine penthemimeral, trithemimeral
τὸν δ’Ἑλένη τανύπεπλος ὑποφθαμένη φάτο μῦθον·	- uu- uu-u u-uu- uu --	dactylic hexameter	feminine penthemimeral, trithemimeral
κλῦτέ μευ· αὐτὰρ ἐγὼ μαντεύσομαι, ὡς ἐνὶ θυμῷ	-u u -u u- --uu - uu --	dactylic hexameter	masculine penthemimeral
ἀθάνατοι βάλλουσι καὶ ὡς τελέεσθαι ὀΐω.	-uu- --u u - uu-u u--	dactylic hexameter	feminine penthemimeral, hepthemimeral, trithemimeral
ὡς ὅδε χῆν’ ἥρπαξ’ ἀτιταλλομένην ἐνὶ οἴκῳ	- uu - -- uu-uu- uu --	dactylic hexameter	masculine penthemimeral, trithemimeral
ἐλθὼν ἐξ ὄρεος, ὅθι οἱ γενεή τε τόκος τε,	-- - uu- uu - uu- u u- -	dactylic hexameter	masculine penthemimeral, hepthemimeral, trithemimeral
ὣς Ὀδυσεὺς κακὰ πολλὰ παθὼν καὶ πόλλ’ ἐπαληθεὶς	- uu- uu -u u- - - uu--	dactylic hexameter	feminine penthemimeral, hepthemimeral, trithemimeral
οἴκαδε νοστήσει καὶ τίσεται· ἠὲ καὶ ἤδη	-uu --- - -uu -u u --	dactylic hexameter	masculine penthemimeral
οἴκοι, ἀτὰρ μνηστῆρσι κακὸν πάντεσσι φυτεύει.	-u u- --u u- --u u--	dactylic hexameter	feminine penthemimeral, hepthemimeral, trithemimeral
τὴν δ’αὖ Τηλέμαχος πεπνυμένος ἀντίον ηὔδα·	- - -uu- --uu -uu --	dactylic hexameter	masculine penthemimeral
οὕτω νῦν Ζεὺς θείη, ἐρίγδουπος πόσις Ἥρης·	-- - - -u u--- uu --	dactylic hexameter	feminine penthemimeral, trithemimeral
τῶ κέν τοι καὶ κεῖθι θεῷ ὣς εὐχετοῴμην.	- - - - -u u- - -uu--	dactylic hexameter	feminine penthemimeral, hepthemimeral, trithemimeral
ἦ καὶ ἐφ’ ἵπποιϊν μάστιν βάλε· τοὶ δὲ μάλ’ ὦκα	- u u --- -- uu - u u --	dactylic hexameter	masculine penthemimeral, hepthemimeral
ἤϊξαν πεδίονδε διὰ πτόλιος μεμαῶτες.	--- uu-u u- uu- uu--	dactylic hexameter	feminine penthemimeral, hepthemimeral, trithemimeral
οἱ δὲ πανημέριοι σεῖον ζυγὸν ἀμφὶς ἔχοντες.	- u u-uu- -- uu -u u--	dactylic hexameter	masculine penthemimeral, hepthemimeral
δύσετό τ’ἠέλιος σκιόωντό τε πᾶσαι ἀγυιαί·	-uu -uu- uu-u u -u u--	dactylic hexameter	masculine penthemimeral
ἐς Φηρὰς δ’ἵκοντο Διοκλῆος ποτὶ δῶμα,	- -- --u u--- uu --	dactylic hexameter	feminine penthemimeral, trithemimeral
υἱέος Ὀρτιλόχοιο, τὸν Ἀλφειὸς τέκε παῖδα.	-uu -uu-u u --- uu --	dactylic hexameter	feminine penthemimeral
ἔνθα δὲ νύκτ’ ἄεσαν ὁ δὲ τοῖς πὰρ ξείνια θῆκεν.	-u u - uu- u u - - -uu --	dactylic hexameter	masculine penthemimeral, hepthemimeral, trithemimeral
ἦμος δ’ἠριγένεια φάνη ῥοδοδάκτυλος Ἠώς,	-- -uu-u u- uu-uu --	dactylic hexameter	feminine penthemimeral, hepthemimeral
ἵππους τ’ἐζεύγνυντ’ ἀνά θ’ἅρματα ποικίλ’ ἔβαινον,	-- --- uu -uu -u u--	dactylic hexameter	masculine penthemimeral
ἐκ δ’ἔλασαν προθύροιο καὶ αἰθούσης ἐριδούπου·	- uu- uu-u u --- uu--	dactylic hexameter	feminine penthemimeral, trithemimeral
μάστιξεν δ’ἐλάαν, τὼ δ’οὐκ ἄκοντε πετέσθην.	--- uu- - - --u u--	dactylic hexameter	masculine penthemimeral, hepthemimeral, trithemimeral
αἶψα δ’ἔπειθ’ ἵκοντο Πύλου αἰπὺ πτολίεθρον·	-u u- --u u- -- uu--	dactylic hexameter	feminine penthemimeral, hepthemimeral, trithemimeral
καὶ τότε Τηλέμαχος προσεφώνεε Νέστορος υἱόν·	- uu -uu- uu-uu -uu --	dactylic hexameter	masculine penthemimeral
Νεστορίδη, πῶς κέν μοι ὑποσχόμενος τελέσειας	-uu- - - u u-uu- uu--	dactylic hexameter	masculine penthemimeral, trithemimeral
μῦθον ἐμόν; ξεῖνοι δὲ διαμπερὲς εὐχόμεθ’ εἶναι	-u u- -- u u-uu -uu --	dactylic hexameter	masculine penthemimeral, trithemimeral
ἐκ πατέρων φιλότητος, ἀτὰρ καὶ ὁμήλικές εἰμεν·	- uu- uu-u u- u u-uu --	dactylic hexameter	feminine penthemimeral, hepthemimeral, trithemimeral
ἥδε δ’ὁδὸς καὶ μᾶλλον ὁμοφροσύνῃσιν ἐνήσει.	-u u- - -u u-uu-u u--	dactylic hexameter	feminine penthemimeral, trithemimeral
μή με παρὲξ ἄγε νῆα, διοτρεφές, ἀλλὰ λίπ’ αὐτοῦ,	- u u- uu -u u-uu -u u --	dactylic hexameter	feminine penthemimeral, trithemimeral
μή μ’ὁ γέρων ἀέκοντα κατάσχῃ ᾧ ἐνὶ οἴκῳ	- u u- uu-u u-- - uu --	dactylic hexameter	feminine penthemimeral, trithemimeral
ἱέμενος φιλέειν· ἐμὲ δὲ χρεὼ θᾶσσον ἱκέσθαι.	-uu- uu- uu - - -u u--	dactylic hexameter	masculine penthemimeral, hepthemimeral, trithemimeral
ὣς φάτο, Νεστορίδης δ’ἄρ’ ἑῷ συμφράσσατο θυμῷ,	- uu -uu- - - --uu --	dactylic hexameter	masculine penthemimeral, hepthemimeral
ὅππως οἱ κατὰ μοῖραν ὑποσχόμενος τελέσειεν.	-- - uu -u u-uu- uu--	dactylic hexameter	feminine penthemimeral, trithemimeral
ὧδε δέ οἱ φρονέοντι δοάσσατο κέρδιον εἶναι·	-u u - uu-u u-uu -uu --	dactylic hexameter	feminine penthemimeral, trithemimeral
στρέψ’ ἵππους ἐπὶ νῆα θοὴν καὶ θῖνα θαλάσσης,	- -- uu -u u- - -u u--	dactylic hexameter	feminine penthemimeral, hepthemimeral, trithemimeral
νηῒ δ’ἐνὶ πρύμνῃ ἐξαίνυτο κάλλιμα δῶρα,	-u u- -- --uu -uu --	dactylic hexameter	masculine penthemimeral, trithemimeral
ἐσθῆτα χρυσόν τε, τά οἱ Μενέλαος ἔδωκε·	--- -- u u - uu-u u--	dactylic hexameter	masculine penthemimeral, hepthemimeral, trithemimeral
καί μιν ἐποτρύνων ἔπεα πτερόεντα προσηύδα·	- u u--- uu- uu-u u--	dactylic hexameter	masculine penthemimeral, hepthemimeral
σπουδῇ νῦν ἀνάβαινε κέλευέ τε πάντας ἑταίρους,	-- - uu-u u-u u -u u--	dactylic hexameter	feminine penthemimeral, trithemimeral
πρὶν ἐμὲ οἴκαδ’ ἱκέσθαι ἀπαγγεῖλαί τε γέροντι.	- uu -u u-u u--- u u--	dactylic hexameter	feminine penthemimeral
εὖ γὰρ ἐγὼ τόδε οἶδα κατὰ φρένα καὶ κατὰ θυμόν·	- u u- uu -u u- uu - uu --	dactylic hexameter	feminine penthemimeral, hepthemimeral, trithemimeral
οἷος ἐκείνου θυμὸς ὑπέρβιος, οὔ σε μεθήσει,	-u u-- -u u-uu - u u--	dactylic hexameter	feminine penthemimeral
ἀλλ’ αὐτὸς καλέων δεῦρ’ εἴσεται, οὐδέ ἕ φημι	- -- uu- - -uu -u u --	dactylic hexameter	masculine penthemimeral, trithemimeral
ἂψ ἰέναι κενεόν· μάλα γὰρ κεχολώσεται ἔμπης.	- uu- uu- uu - uu-uu --	dactylic hexameter	masculine penthemimeral, hepthemimeral, trithemimeral
ὣς ἄρα φωνήσας ἔλασεν καλλίτριχας ἵππους	- uu --- uu- --uu --	dactylic hexameter	masculine penthemimeral, hepthemimeral
ἂψ Πυλίων εἰς ἄστυ, θοῶς δ’ἄρα δώμαθ’ ἵκανε.	- uu- - -u u- uu -u u--	dactylic hexameter	feminine penthemimeral, hepthemimeral, trithemimeral
Τηλέμαχος δ’ἑτάροισιν ἐποτρύνων ἐκέλευσεν·	-uu- uu-u u--- uu--	dactylic hexameter	feminine penthemimeral, trithemimeral
ἐγκοσμεῖτε τὰ τεύχε’, ἑταῖροι, νηῒ μελαίνῃ,	---u u -u u-- -u u--	dactylic hexameter	feminine penthemimeral
αὐτοί τ’ἀμβαίνωμεν, ἵνα πρήσσωμεν ὁδοῖο.	-- ---u u- --u u--	dactylic hexameter	feminine penthemimeral, hepthemimeral
ὣς ἔφαθ’, οἱ δ’ἄρα τοῦ μάλα μὲν κλύον ἠδ’ ἐπίθοντο,	- uu - uu - uu - uu - uu--	dactylic hexameter	masculine penthemimeral, hepthemimeral, trithemimeral
αἶψα δ’ἄρ’ εἴσβαινον καὶ ἐπὶ κληῗσι καθῖζον.	-u u --- u u- --u u--	dactylic hexameter	masculine penthemimeral, hepthemimeral
ἤτοι ὁ μὲν τὰ πονεῖτο καὶ εὔχετο, θῦε δ’Ἀθήνῃ	-u u - u u-u u -uu -u u--	dactylic hexameter	feminine penthemimeral, trithemimeral
νηῒ πάρα πρυμνῇ· σχεδόθεν δέ οἱ ἤλυθεν ἀνὴρ	-u u- -- uu- u u -uu --	dactylic hexameter	masculine penthemimeral, hepthemimeral, trithemimeral
τηλεδαπός, φεύγων ἐξ Ἄργεος ἄνδρα κατακτάς,	-uu- -- - -uu -u u--	dactylic hexameter	masculine penthemimeral, trithemimeral
μάντις· ἀτὰρ γενεήν γε Μελάμποδος ἔκγονος ἦεν,	-u u- uu- u u-uu -uu --	dactylic hexameter	masculine penthemimeral, trithemimeral
ὃς πρὶν μέν ποτ’ ἔναιε Πύλῳ ἔνι, μητέρι μήλων,	- - - u u-u u- uu -uu --	dactylic hexameter	feminine penthemimeral, hepthemimeral, trithemimeral
ἀφνειὸς Πυλίοισι μέγ’ ἔξοχα δώματα ναίων·	--- uu-u u -uu -uu --	dactylic hexameter	feminine penthemimeral, trithemimeral
δὴ τότε γ’ἄλλων δῆμον ἀφίκετο, πατρίδα φεύγων	- uu -- -u u-uu -uu --	dactylic hexameter	feminine penthemimeral
Νηλέα τε μεγάθυμον, ἀγαυότατον ζωόντων,	-uu - uu-u u-uu- ---	dactylic hexameter	feminine penthemimeral, trithemimeral
ὅς οἱ χρήματα πολλὰ τελεσφόρον εἰς ἐνιαυτὸν	- - -uu -u u-uu - uu--	dactylic hexameter	feminine penthemimeral
εἶχε βίῃ. ὁ δὲ τέως μὲν ἐνὶ μεγάροις Φυλάκοιο	-u u- u u - u u- uu- uu--	dactylic hexameter	masculine penthemimeral, hepthemimeral, trithemimeral
δεσμῷ ἐν ἀργαλέῳ δέδετο, κρατέρ’ ἄλγεα πάσχων	-u u -uu- uu- uu -uu --	dactylic hexameter	masculine penthemimeral, hepthemimeral
εἵνεκα Νηλῆος κούρης ἄτης τε βαρείης,	-uu --- -- -- u u--	dactylic hexameter	masculine penthemimeral, hepthemimeral
τήν οἱ ἐπὶ φρεσὶ θῆκε θεὰ δασπλῆτις Ἐρινύς.	- u u- uu -u u- --u u--	dactylic hexameter	feminine penthemimeral, hepthemimeral, trithemimeral
ἀλλ’ ὁ μὲν ἔκφυγε κῆρα καὶ ἤλασε βοῦς ἐριμύκους	- u u -uu -u u -uu - uu--	dactylic hexameter	feminine penthemimeral
ἐς Πύλον ἐκ Φυλάκης καὶ ἐτίσατο ἔργον ἀεικὲς	- uu - uu- u u-uu -u u--	dactylic hexameter	masculine penthemimeral, trithemimeral
ἀντίθεον Νηλῆα, κασιγνήτῳ δὲ γυναῖκα	-uu- --u u--- u u--	dactylic hexameter	feminine penthemimeral, trithemimeral
ἠγάγετο πρὸς δώμαθ’. ὁ δ’ἄλλων ἵκετο δῆμον,	-uu- - -u u -- -uu --	dactylic hexameter	feminine penthemimeral, trithemimeral
Ἄργος ἐς ἱππόβοτον· τόθι γάρ νύ οἱ αἴσιμον ἦεν	-u u -uu- uu - u u -uu --	dactylic hexameter	masculine penthemimeral, hepthemimeral
ναιέμεναι πολλοῖσιν ἀνάσσοντ’ Ἀργείοισιν	-uu- --u u-- ----	dactylic hexameter	feminine penthemimeral, trithemimeral
ἔνθα δ’ἔγημε γυναῖκα καὶ ὑψερεφὲς θέτο δῶμα,	-u u-u u-u u -uu- uu --	dactylic hexameter	feminine penthemimeral
γείνατο δ’Ἀντιφάτην καὶ Μάντιον, υἷε κραταιώ.	-uu -uu- - -uu -u u--	dactylic hexameter	masculine penthemimeral
Ἀντιφάτης μὲν ἔτικτεν Ὀϊκλῆα μεγάθυμον,	-uu- u u-u u--- uu--	dactylic hexameter	feminine penthemimeral, trithemimeral
αὐτὰρ Ὀϊκλείης λαοσσόον Ἀμφιάρηον,	-u u--- --uu -uu--	dactylic hexameter	masculine penthemimeral
ὃν περὶ κῆρι φίλει Ζεύς τ’αἰγίοχος καὶ Ἀπόλλων	- uu -u u- - -uu- u u--	dactylic hexameter	masculine penthemimeral
παντοίην φιλότητ’· οὐδ’ ἵκετο γήραος οὐδόν,	--- uu- - -uu -uu --	dactylic hexameter	masculine penthemimeral, trithemimeral
ἀλλ’ ὄλετ’ ἐν Θήβῃσι γυναίων εἵνεκα δώρων.	- uu - --u u-- -uu --	dactylic hexameter	feminine penthemimeral, trithemimeral
τοῦ υἱεῖς ἐγένοντ’ Ἀλκμάων Ἀμφίλοχός τε.	- -- uu- --- -uu- -	dactylic hexameter	masculine penthemimeral, trithemimeral
Μάντιος αὖ τέκετο Πολυφείδεά τε Κλεῖτόν τε·	-uu - uu- uu-uu - -- -	dactylic hexameter	masculine penthemimeral, trithemimeral
ἀλλ’ ἤτοι Κλεῖτον χρυσόθρονος ἥρπασεν Ἠὼς	- -- -- --uu -uu --	dactylic hexameter	masculine penthemimeral, trithemimeral
κάλλεος εἵνεκα οἷο, ἵν’ ἀθανάτοισι μετείη·	-uu -uu -u u -uu-u u--	dactylic hexameter	feminine penthemimeral
αὐτὰρ ὑπέρθυμον Πολυφείδεα μάντιν Ἀπόλλων	-u u--- uu-uu -u u--	dactylic hexameter	masculine penthemimeral
θῆκε βροτῶν ὄχ’ ἄριστον, ἐπεὶ θάνεν Ἀμφιάρηος·	-u u- u u-u u- uu -uu--	dactylic hexameter	feminine penthemimeral, hepthemimeral, trithemimeral
ὅς ῥ’Ὑπερησίηνδ’ ἀπενάσσατο πατρὶ χολωθείς,	- uu--- uu-uu -u u--	dactylic hexameter	masculine penthemimeral
ἔνθ’ ὅ γε ναιετάων μαντεύετο πᾶσι βροτοῖσι.	- u u -uu- --uu -u u--	dactylic hexameter	masculine penthemimeral
τοῦ μὲν ἄρ’ υἱὸς ἐπῆλθε, Θεοκλύμενος δ’ὄνομ’ ἦεν,	- u u -u u-u u-uu- uu --	dactylic hexameter	feminine penthemimeral
ὃς τότε Τηλεμάχου πέλας ἵστατο· τὸν δ’ἐκίχανε	- uu -uu- uu -uu - uu--	dactylic hexameter	masculine penthemimeral
σπένδοντ’ εὐχόμενόν τε θοῇ παρὰ νηῒ μελαίνῃ,	-- -uu- u u- uu -u u--	dactylic hexameter	masculine penthemimeral, hepthemimeral
καί μιν φωνήσας ἔπεα πτερόεντα προσηύδα·	- - --- uu- uu-u u--	dactylic hexameter	masculine penthemimeral, hepthemimeral
ὦ φίλ’, ἐπεί σε θύοντα κιχάνω τῷδ’ ἐνὶ χώρῳ,	- u u- u u-u u-- - uu --	dactylic hexameter	feminine penthemimeral, trithemimeral
λίσσομ’ ὑπὲρ θυέων καὶ δαίμονος, αὐτὰρ ἔπειτα	-u u- uu- - -uu -u u--	dactylic hexameter	masculine penthemimeral, trithemimeral
σῆς τ’αὐτοῦ κεφαλῆς καὶ ἑταίρων, οἵ τοι ἕπονται,	- -- uu- u u-- - u u--	dactylic hexameter	masculine penthemimeral, trithemimeral
εἰπέ μοι εἰρομένῳ νημερτέα μηδ’ ἐπικεύσῃς·	-u u -uu- --uu - uu--	dactylic hexameter	masculine penthemimeral
τίς πόθεν εἶς ἀνδρῶν; πόθι τοι πόλις ἠδὲ τοκῆες;	- uu - -- uu - uu -u u--	dactylic hexameter	masculine penthemimeral, hepthemimeral, trithemimeral
τὸν δ’αὖ Τηλέμαχος πεπνυμένος ἀντίον ηὔδα·	- - -uu- --uu -uu --	dactylic hexameter	masculine penthemimeral
τοιγὰρ ἐγώ τοι, ξεῖνε, μάλ’ ἀτρεκέως ἀγορεύσω.	-u u- - -u u -uu- uu--	dactylic hexameter	feminine penthemimeral, trithemimeral
ἐξ Ἰθάκης γένος εἰμί, πατὴρ δέ μοί ἐστιν Ὀδυσσεύς,	- uu- uu -u u- u u -u u--	dactylic hexameter	feminine penthemimeral, hepthemimeral, trithemimeral
εἴ ποτ’ ἔην· νῦν δ’ἤδη ἀπέφθιτο λυγρῷ ὀλέθρῳ.	- u u- - -u u-uu -u u--	dactylic hexameter	feminine penthemimeral, trithemimeral
τοὔνεκα νῦν ἑτάρους τε λαβὼν καὶ νῆα μέλαιναν	-uu - uu- u u- - -u u--	dactylic hexameter	masculine penthemimeral, hepthemimeral, trithemimeral
ἦλθον πευσόμενος πατρὸς δὴν οἰχομένοιο.	-- -uu- -- - -uu--	dactylic hexameter	masculine penthemimeral, hepthemimeral
τὸν δ’αὖτε προσέειπε Θεοκλύμενος θεοειδής·	- -- uu-u u-uu- uu--	dactylic hexameter	feminine penthemimeral, trithemimeral
οὕτω τοι καὶ ἐγὼν ἐκ πατρίδος, ἄνδρα κατακτὰς	-- - u u- - -uu -u u--	dactylic hexameter	masculine penthemimeral, trithemimeral
ἔμφυλον· πολλοὶ δὲ κασίγνητοί τε ἔται τε	--- -- u u--- u u- -	dactylic hexameter	masculine penthemimeral, trithemimeral
Ἄργος ἀν’ ἱππόβοτον, μέγα δὲ κρατέουσιν Ἀχαιῶν.	-u u -uu- uu - uu-u u--	dactylic hexameter	masculine penthemimeral, hepthemimeral
τῶν ὑπαλευάμενος θάνατον καὶ κῆρα μέλαιναν	- uu-uu- uu- - -u u--	dactylic hexameter	masculine penthemimeral, hepthemimeral
φεύγω, ἐπεί νύ μοι αἶσα κατ’ ἀνθρώπους ἀλάλησθαι.	-u u- u u -u u --- uu--	dactylic hexameter	feminine penthemimeral, trithemimeral
ἀλλά με νηὸς ἔφεσσαι, ἐπεί σε φυγὼν ἱκέτευσα,	-u u -u u-u u- u u- uu--	dactylic hexameter	feminine penthemimeral, hepthemimeral
μή με κατακτείνωσι· διωκέμεναι γὰρ ὀΐω.	- u u---u u-uu- u u--	dactylic hexameter	feminine penthemimeral
τὸν δ’αὖ Τηλέμαχος πεπνυμένος ἀντίον ηὔδα·	- - -uu- --uu -uu --	dactylic hexameter	masculine penthemimeral
οὐ μὲν δή σ’ἐθέλοντά γ’ ἀπώσω νηὸς ἐΐσης,	- - - uu-u u-- -u u--	dactylic hexameter	feminine penthemimeral, trithemimeral
ἀλλ’ ἕπευ· αὐτὰρ κεῖθι φιλήσεαι, οἷά κ’ἔχωμεν.	- uu -- -u u-uu -u u--	dactylic hexameter	feminine penthemimeral
ὣς ἄρα φωνήσας οἱ ἐδέξατο χάλκεον ἔγχος,	- uu --- u u-uu -uu --	dactylic hexameter	masculine penthemimeral
καὶ τό γ’ἐπ’ ἰκριόφιν τάνυσεν νεὸς ἀμφιελίσσης·	- u u -uu- uu- uu -uu--	dactylic hexameter	masculine penthemimeral, hepthemimeral
ἂν δὲ καὶ αὐτὸς νηὸς ἐβήσετο ποντοπόροιο.	- u u -- -u u-uu -uu--	dactylic hexameter	feminine penthemimeral
ἐν πρύμνῃ δ’ἄρ’ ἔπειτα καθέζετο, πὰρ δὲ οἷ αὐτῷ	- -- u u-u u-uu - u u --	dactylic hexameter	feminine penthemimeral, trithemimeral
εἷσε Θεοκλύμενον· τοὶ δὲ πρυμνήσι’ ἔλυσαν.	-u u-uu- - - --u u--	dactylic hexameter	masculine penthemimeral, hepthemimeral
Τηλέμαχος δ’ἑτάροισιν ἐποτρύνας ἐκέλευσεν	-uu- uu-u u--- uu--	dactylic hexameter	feminine penthemimeral, trithemimeral
ὅπλων ἅπτεσθαι· τοὶ δ’ἐσσυμένως ἐπίθοντο.	-- --- - -uu- uu--	dactylic hexameter	masculine penthemimeral
ἱστὸν δ’εἰλάτινον κοίλης ἔντοσθε μεσόδμης	-- -uu- -- --u u--	dactylic hexameter	masculine penthemimeral, hepthemimeral
στῆσαν ἀείραντες, κατὰ δὲ προτόνοισιν ἔδησαν,	-u u--- uu - uu-u u--	dactylic hexameter	masculine penthemimeral, hepthemimeral
ἕλκον δ’ἱστία λευκὰ ἐϋστρέπτοισι βοεῦσι.	-- -uu -u u---u u--	dactylic hexameter	feminine penthemimeral
τοῖσιν δ’ἴκμενον οὖρον ἵει γλαυκῶπις Ἀθήνη,	-- -uu -u u- --u u--	dactylic hexameter	feminine penthemimeral, hepthemimeral
λάβρον ἐπαιγίζοντα δι’ αἰθέρος, ὄφρα τάχιστα	-u u---u u -uu -u u--	dactylic hexameter	feminine penthemimeral
νηῦς ἀνύσειε θέουσα θαλάσσης ἁλμυρὸν ὕδωρ.	- uu-u u-u u-- -uu --	dactylic hexameter	feminine penthemimeral
βὰν δὲ παρὰ Κρουνοὺς καὶ Χαλκίδα καλλιρέεθρον.	- u u- -- - -uu -uu--	dactylic hexameter	masculine penthemimeral, trithemimeral
δύσετό τ’ἠέλιος σκιόωντό τε πᾶσαι ἀγυιαί·	-uu -uu- uu-u u -u u--	dactylic hexameter	masculine penthemimeral
ἡ δὲ Φεὰς ἐπέβαλλεν ἐπειγομένη Διὸς οὔρῳ	- u u- uu-u u-uu- uu --	dactylic hexameter	feminine penthemimeral, trithemimeral
ἠδὲ παρ’ Ἤλιδα δῖαν, ὅθι κρατέουσιν Ἐπειοί.	-u u -uu -u u- uu-u u--	dactylic hexameter	feminine penthemimeral, hepthemimeral
ἔνθεν δ’αὖ νήσοισιν ἐπιπροέηκε θοῇσιν,	-- - --u u-uu-u u--	dactylic hexameter	feminine penthemimeral, trithemimeral
ὁρμαίνων ἤ κεν θάνατον φύγοι ἦ κεν ἁλώῃ.	--- - - uu- uu - u u--	dactylic hexameter	masculine penthemimeral, hepthemimeral, trithemimeral
τὼ δ’αὖτ’ ἐν κλισίῃ Ὀδυσεὺς καὶ δῖος ὑφορβὸς	- - - uu- uu- - -u u--	dactylic hexameter	masculine penthemimeral, hepthemimeral, trithemimeral
δορπείτην· παρὰ δέ σφιν ἐδόρπεον ἀνέρες ἄλλοι.	--- uu - u u-uu -uu --	dactylic hexameter	masculine penthemimeral, trithemimeral
αὐτὰρ ἐπεὶ πόσιος καὶ ἐδητύος ἐξ ἔρον ἕντο,	-u u- uu- u u-uu - uu --	dactylic hexameter	masculine penthemimeral, trithemimeral
τοῖς δ’Ὀδυσεὺς μετέειπε, συβώτεω πειρητίζων,	- uu- uu-u u-- ----	dactylic hexameter	feminine penthemimeral, trithemimeral
εἴ μιν ἔτ’ ἐνδυκέως φιλέοι μεῖναί τε κελεύοι	- u u -uu- uu- -- u u--	dactylic hexameter	masculine penthemimeral, hepthemimeral
αὐτοῦ ἐνὶ σταθμῷ, ἦ ὀτρύνειε πόλινδε·	-u u- -- - ---u u--	dactylic hexameter	masculine penthemimeral, trithemimeral
κέκλυθι νῦν, Εὔμαιε, καὶ ἄλλοι πάντες ἑταῖροι·	-uu - --u u -- -u u--	dactylic hexameter	feminine penthemimeral, trithemimeral
ἠῶθεν προτὶ ἄστυ λιλαίομαι ἀπονέεσθαι	--- uu -u u-uu -uu--	dactylic hexameter	feminine penthemimeral, trithemimeral
πτωχεύσων, ἵνα μή σε κατατρύχω καὶ ἑταίρους.	--- uu - u u--- u u--	dactylic hexameter	masculine penthemimeral, trithemimeral
ἀλλά μοι εὖ θ’ὑπόθευ καὶ ἅμ’ ἡγεμόν’ ἐσθλὸν ὄπασσον	-u u - uu- u u -uu -u u--	dactylic hexameter	masculine penthemimeral, trithemimeral
ὅς κέ με κεῖσ’ ἀγάγῃ· κατὰ δὲ πτόλιν αὐτὸς ἀνάγκῃ	- u u - uu- uu - uu -u u--	dactylic hexameter	masculine penthemimeral, hepthemimeral, trithemimeral
πλάγξομαι, αἴ κέν τις κοτύλην καὶ πύρνον ὀρέξῃ.	-uu - - - uu- - -u u--	dactylic hexameter	masculine penthemimeral, hepthemimeral, trithemimeral
καί κ’ἐλθὼν πρὸς δώματ’ Ὀδυσσῆος θείοιο	- -- - -u u--- ---	dactylic hexameter	feminine penthemimeral, trithemimeral
ἀγγελίην εἴποιμι περίφρονι Πηνελοπείῃ,	-uu- --u u-uu -uu--	dactylic hexameter	feminine penthemimeral, trithemimeral
καί κεν μνηστήρεσσιν ὑπερφιάλοισι μιγείην,	- - ---u u-uu-u u--	dactylic hexameter	feminine penthemimeral
εἴ μοι δεῖπνον δοῖεν ὀνείατα μυρί’ ἔχοντες.	- - -- -u u-uu -u u--	dactylic hexameter	feminine penthemimeral
αἶψά κεν εὖ δρώοιμι μετὰ σφίσιν ὅττι θέλοιεν.	-u u - --u u- uu -u u--	dactylic hexameter	feminine penthemimeral, hepthemimeral, trithemimeral
ἐκ γάρ τοι ἐρέω, σὺ δὲ σύνθεο καί μευ ἄκουσον·	- - - uu- u u -uu - u u--	dactylic hexameter	masculine penthemimeral, trithemimeral
Ἑρμείαο ἕκητι διακτόρου, ὅς ῥά τε πάντων	---u u-u u-uu - u u --	dactylic hexameter	feminine penthemimeral
ἀνθρώπων ἔργοισι χάριν καὶ κῦδος ὀπάζει,	--- --u u- - -u u--	dactylic hexameter	feminine penthemimeral, hepthemimeral, trithemimeral
δρηστοσύνῃ οὐκ ἄν μοι ἐρίσσειε βροτὸς ἄλλος,	-uu- - - u u--- uu --	dactylic hexameter	masculine penthemimeral, trithemimeral
πῦρ τ’εὖ νηῆσαι διά τε ξύλα δανὰ κεάσσαι,	- - --- uu - uu -u u--	dactylic hexameter	masculine penthemimeral, hepthemimeral
δαιτρεῦσαί τε καὶ ὀπτῆσαι καὶ οἰνοχοῆσαι,	--- u u --- - -uu--	dactylic hexameter	hepthemimeral, trithemimeral
οἷά τε τοῖς ἀγαθοῖσι παραδρώωσι χέρηες.	-u u - uu-u u---u u--	dactylic hexameter	feminine penthemimeral, trithemimeral
τὸν δὲ μέγ’ ὀχθήσας προσέφης, Εὔμαιε συβῶτα·	- u u --- uu- --u u--	dactylic hexameter	masculine penthemimeral, hepthemimeral
ὤ μοι, ξεῖνε, τίη τοι ἐνὶ φρεσὶ τοῦτο νόημα	- - -u u- u u- uu -u u--	dactylic hexameter	masculine penthemimeral, hepthemimeral
ἔπλετο; ἦ σύ γε πάγχυ λιλαίεαι αὐτόθ’ ὀλέσθαι.	-uu - u u -u u-uu -u u--	dactylic hexameter	feminine penthemimeral, trithemimeral
εἰ δὴ μνηστήρων ἐθέλεις καταδῦναι ὅμιλον,	- - --- uu- uu-u u--	dactylic hexameter	masculine penthemimeral, hepthemimeral
τῶν ὕβρις τε βίη τε σιδήρεον οὐρανὸν ἵκει.	- -- u u- u u-uu -uu --	dactylic hexameter	masculine penthemimeral, trithemimeral
οὔ τοι τοιοίδ’ εἰσὶν ὑποδρηστῆρες ἐκείνων,	- - -- -u u---u u--	dactylic hexameter	feminine penthemimeral
ἀλλὰ νέοι, χλαίνας εὖ εἱμένοι ἠδὲ χιτῶνας,	-u u- -- - -uu -u u--	dactylic hexameter	masculine penthemimeral, trithemimeral
αἰεὶ δὲ λιπαροὶ κεφαλὰς καὶ καλὰ πρόσωπα,	-- - uu- uu- - -u u--	dactylic hexameter	masculine penthemimeral, hepthemimeral, trithemimeral
οἵ σφιν ὑποδρώωσιν· ἐΰξεστοι δὲ τράπεζαι	- u u---u u--- u u--	dactylic hexameter	feminine penthemimeral
σίτου καὶ κρειῶν ἠδ’ οἴνου βεβρίθασιν.	-- - -- - -- ----	dactylic hexameter	masculine penthemimeral, trithemimeral
ἀλλὰ μέν’· οὐ γάρ τίς τοι ἀνιᾶται παρεόντι,	-u u - - - u u--- uu--	dactylic hexameter	masculine penthemimeral, trithemimeral
οὔτ’ ἐγὼ οὔτε τις ἄλλος ἑταίρων, οἵ μοι ἔασιν.	- uu -u u -u u-- - u u--	dactylic hexameter	feminine penthemimeral
αὐτὰρ ἐπὴν ἔλθῃσιν Ὀδυσσῆος φίλος υἱός,	-u u- --u u--- uu --	dactylic hexameter	feminine penthemimeral, trithemimeral
κεῖνός σε χλαῖνάν τε χιτῶνά τε εἵματα ἕσσει,	-- - -- u u-u u -uu --	dactylic hexameter	masculine penthemimeral, trithemimeral
πέμψει δ’ὅππῃ σε κραδίη θυμός τε κελεύει.	-- -- - uu- -- u u--	dactylic hexameter	masculine penthemimeral, hepthemimeral
τὸν δ’ἠμείβετ’ ἔπειτα πολύτλας δῖος Ὀδυσσεύς·	- --u u-u u-- -u u--	dactylic hexameter	feminine penthemimeral
αἴθ’ οὕτως, Εὔμαιε, φίλος Διῒ πατρὶ γένοιο	- -- --u u- uu -u u--	dactylic hexameter	feminine penthemimeral, hepthemimeral, trithemimeral
ὡς ἐμοί, ὅττι μ’ἔπαυσας ἄλης καὶ ὀϊζύος αἰνῆς.	- uu -u u-u u- u u-uu --	dactylic hexameter	feminine penthemimeral, hepthemimeral
πλαγκτοσύνης δ’οὐκ ἔστι κακώτερον ἄλλο βροτοῖσιν·	-uu- - -u u-uu -u u--	dactylic hexameter	feminine penthemimeral, trithemimeral
ἀλλ’ ἕνεκ’ οὐλομένης γαστρὸς κακὰ κήδε’ ἔχουσιν	- uu -uu- -- uu -u u--	dactylic hexameter	masculine penthemimeral, hepthemimeral
ἀνέρες, ὅν τιν’ ἵκηται ἄλη καὶ πῆμα καὶ ἄλγος.	-uu - u u-u u- - -u u --	dactylic hexameter	feminine penthemimeral, hepthemimeral, trithemimeral
νῦν δ’ἐπεὶ ἰσχανάᾳς μεῖναι τέ με κεῖνον ἄνωγας,	- uu -uu- -- u u -u u--	dactylic hexameter	masculine penthemimeral, hepthemimeral
εἴπ’ ἄγε μοι περὶ μητρὸς Ὀδυσσῆος θείοιο	- uu - uu -u u--- ---	dactylic hexameter	feminine penthemimeral, trithemimeral
πατρός θ’,ὃν κατέλειπεν ἰὼν ἐπὶ γήραος οὐδῷ,	-- - uu-u u- uu -uu --	dactylic hexameter	feminine penthemimeral, hepthemimeral, trithemimeral
εἴ που ἔτι ζώουσιν ὑπ’ αὐγὰς ἠελίοιο,	- u u- --u u -- -uu--	dactylic hexameter	feminine penthemimeral, trithemimeral
ἦ ἤδη τεθνᾶσι καὶ εἰν Ἀΐδαο δόμοισι.	- -- --u u - uu-u u--	dactylic hexameter	feminine penthemimeral, hepthemimeral, trithemimeral
τὸν δ’αὖτε προσέειπε συβώτης, ὄρχαμος ἀνδρῶν·	- -- uu-u u-- -uu --	dactylic hexameter	feminine penthemimeral, trithemimeral
τοιγὰρ ἐγώ τοι, ξεῖνε, μάλ’ ἀτρεκέως ἀγορεύσω.	-u u- - -u u -uu- uu--	dactylic hexameter	feminine penthemimeral, trithemimeral
Λαέρτης μὲν ἔτι ζώει, Διῒ δ’εὔχεται αἰεὶ	--- u u- -- uu -uu --	dactylic hexameter	masculine penthemimeral, hepthemimeral, trithemimeral
θυμὸν ἀπὸ μελέων φθίσθαι οἷς ἐν μεγάροισιν·	-u u- uu- -- - - uu--	dactylic hexameter	masculine penthemimeral, hepthemimeral, trithemimeral
ἐκπάγλως γὰρ παιδὸς ὀδύρεται οἰχομένοιο	--- - -u u-uu -uu--	dactylic hexameter	feminine penthemimeral, trithemimeral
κουριδίης τ’ἀλόχοιο δαΐφρονος, ἥ ἑ μάλιστα	-uu- uu-u u-uu - u u--	dactylic hexameter	feminine penthemimeral, trithemimeral
ἤκαχ’ ἀποφθιμένη καὶ ἐν ὠμῷ γήραϊ θῆκεν.	-u u-uu- u u -- -uu --	dactylic hexameter	masculine penthemimeral
ἡ δ’ἄχεϊ οὗ παιδὸς ἀπέφθιτο κυδαλίμοιο,	- uu- - -u u-uu -uu--	dactylic hexameter	feminine penthemimeral, trithemimeral
λευγαλέῳ θανάτῳ, ὡς μὴ θάνοι ὅς τις ἔμοιγε	-uu- uu- - - uu - u u--	dactylic hexameter	masculine penthemimeral, hepthemimeral, trithemimeral
ἐνθάδε ναιετάων φίλος εἴη καὶ φίλα ἔρδοι.	-uu -uu- uu -- - uu --	dactylic hexameter	masculine penthemimeral
ὄφρα μὲν οὖν δὴ κείνη ἔην, ἀχέουσά περ ἔμπης,	-u u - - -u u- uu-u u --	dactylic hexameter	feminine penthemimeral, hepthemimeral, trithemimeral
τόφρα τί μοι φίλον ἔσκε μεταλλῆσαι καὶ ἐρέσθαι,	-u u - uu -u u--- u u--	dactylic hexameter	feminine penthemimeral, trithemimeral
οὕνεκά μ’αὐτὴ θρέψεν ἅμα Κτιμένῃ τανυπέπλῳ,	-uu -- -u u- uu- uu--	dactylic hexameter	feminine penthemimeral, hepthemimeral
θυγατέρ’ ἰφθίμῃ, τὴν ὁπλοτάτην τέκε παίδων·	-uu --- - -uu- uu --	dactylic hexameter	masculine penthemimeral
τῇ ὁμοῦ ἐτρεφόμην, ὀλίγον δέ τί μ’ἧσσον ἐτίμα.	- uu -uu- uu- u u -u u--	dactylic hexameter	masculine penthemimeral, hepthemimeral
αὐτὰρ ἐπεί ῥ’ἥβην πολυήρατον ἱκόμεθ’ ἄμφω,	-u u- -- uu-uu -uu --	dactylic hexameter	masculine penthemimeral, trithemimeral
τὴν μὲν ἔπειτα Σάμηνδ’ ἔδοσαν καὶ μυρί’ ἕλοντο,	- u u-u u- uu- - -u u--	dactylic hexameter	masculine penthemimeral, hepthemimeral
αὐτὰρ ἐμὲ χλαῖνάν τε χιτῶνά τε εἵματ’ ἐκείνη	-u u- -- u u-u u -u u--	dactylic hexameter	masculine penthemimeral, trithemimeral
καλὰ μάλ’ ἀμφιέσασα, ποσὶν θ’ὑποδήματα δοῦσα	-u u -uu-u u- uu-uu --	dactylic hexameter	feminine penthemimeral, hepthemimeral
ἀγρόνδε προΐαλλε· φίλει δέ με κηρόθι μᾶλλον.	--- uu-u u- u u -uu --	dactylic hexameter	feminine penthemimeral, hepthemimeral, trithemimeral
νῦν δ’ἤδη τούτων ἐπιδεύομαι· ἀλλά μοι αὐτῷ	- -- -- uu-uu -u u --	dactylic hexameter	masculine penthemimeral, trithemimeral
ἔργον ἀέξουσιν μάκαρες θεοὶ ᾧ ἐπιμίμνω·	-u u--- uu- uu - uu--	dactylic hexameter	masculine penthemimeral, hepthemimeral
τῶν ἔφαγόν τ’ἔπιόν τε καὶ αἰδοίοισιν ἔδωκα.	- uu- uu- u u ---u u--	dactylic hexameter	masculine penthemimeral, trithemimeral
ἐκ δ’ἄρα δεσποίνης οὐ μείλιχον ἔστιν ἀκοῦσαι	- uu --- - -uu -u u--	dactylic hexameter	masculine penthemimeral
οὔτ’ ἔπος οὔτε τι ἔργον, ἐπεὶ κακὸν ἔμπεσεν οἴκῳ,	- uu -u u -u u- uu -uu --	dactylic hexameter	feminine penthemimeral, hepthemimeral
ἄνδρες ὑπερφίαλοι· μέγα δὲ δμῶες χατέουσιν	-u u-uu- uu - -- uu--	dactylic hexameter	masculine penthemimeral, hepthemimeral
ἀντία δεσποίνης φάσθαι καὶ ἕκαστα πυθέσθαι	-uu --- -- u u-u u--	dactylic hexameter	masculine penthemimeral, hepthemimeral
καὶ φαγέμεν πιέμεν τε, ἔπειτα δὲ καί τι φέρεσθαι	- uu- uu- u u-u u - u u--	dactylic hexameter	masculine penthemimeral, trithemimeral
ἀγρόνδ’, οἷά τε θυμὸν ἀεὶ δμώεσσιν ἰαίνει.	-- -u u -u u- --u u--	dactylic hexameter	feminine penthemimeral, hepthemimeral
τὸν δ’ἀπαμειβόμενος προσέφη πολύμητις Ὀδυσσεύς·	- uu-uu- uu- uu-u u--	dactylic hexameter	masculine penthemimeral, hepthemimeral
ὢ πόποι, ὡς ἄρα τυτθὸς ἐών, Εὔμαιε συβῶτα,	- uu - uu -u u- --u u--	dactylic hexameter	feminine penthemimeral, hepthemimeral, trithemimeral
πολλὸν ἀπεπλάγχθης σῆς πατρίδος ἠδὲ τοκήων.	-u u--- - -uu -u u--	dactylic hexameter	masculine penthemimeral
ἀλλ’ ἄγε μοι τόδε εἰπὲ καὶ ἀτρεκέως κατάλεξον,	- uu - uu -u u -uu- uu--	dactylic hexameter	feminine penthemimeral, trithemimeral
ἠὲ διεπράθετο πτόλις ἀνδρῶν εὐρυάγυια,	-u u-uu- uu -- -uu--	dactylic hexameter	masculine penthemimeral
ᾗ ἔνι ναιετάασκε πατὴρ καὶ πότνια μήτηρ,	- uu -uu-u u- - -uu --	dactylic hexameter	feminine penthemimeral, hepthemimeral
ἦ σέ γε μουνωθέντα παρ’ οἴεσιν ἢ παρὰ βουσὶν	- u u ---u u -uu - uu --	dactylic hexameter	feminine penthemimeral
ἄνδρες δυσμενέες νηυσὶν λάβον ἠδ’ ἐπέρασσαν	-- -uu- -- uu - uu--	dactylic hexameter	masculine penthemimeral, hepthemimeral
τοῦδ’ ἀνδρὸς πρὸς δώμαθ’, ὁ δ’ἄξιον ὦνον ἔδωκε.	- -- - -u u -uu -u u--	dactylic hexameter	feminine penthemimeral, trithemimeral
τὸν δ’αὖτε προσέειπε συβώτης, ὄρχαμος ἀνδρῶν·	- -- uu-u u-- -uu --	dactylic hexameter	feminine penthemimeral, trithemimeral
ξεῖν’, ἐπεὶ ἂρ δὴ ταῦτά μ’ ἀνείρεαι ἠδὲ μεταλλᾷς,	- uu - - -u u-uu -u u--	dactylic hexameter	feminine penthemimeral, trithemimeral
σιγῇ νῦν ξυνίει καὶ τέρπεο, πῖνέ τε οἶνον	-- - uu- - -uu -u u --	dactylic hexameter	masculine penthemimeral, trithemimeral
ἥμενος. αἵδε δὲ νύκτες ἀθέσφατοι· ἔστι μὲν εὕδειν,	-uu -u u -u u-uu -u u --	dactylic hexameter	feminine penthemimeral
ἔστι δὲ τερπομένοισιν ἀκουέμεν· οὐδέ τί σε χρή,	-u u -uu-u u-uu -u u - -	dactylic hexameter	feminine penthemimeral
πρὶν ὥρη, καταλέχθαι· ἀνίη καὶ πολὺς ὕπνος.	- -- uu-u u-- - uu --	dactylic hexameter	feminine penthemimeral, trithemimeral
τῶν δ’ἄλλων ὅτινα κραδίη καὶ θυμὸς ἀνώγει,	- -- uu- uu- - -u u--	dactylic hexameter	masculine penthemimeral, hepthemimeral, trithemimeral
εὑδέτω ἐξελθών· ἅμα δ’ἠοῖ φαινομένηφι	-uu --- uu -- -uu--	dactylic hexameter	masculine penthemimeral
δειπνήσας ἅμ’ ὕεσσιν ἀνακτορίῃσιν ἑπέσθω.	--- u u-u u-uu-u u--	dactylic hexameter	feminine penthemimeral, trithemimeral
νῶϊ δ’ἐνὶ κλισίῃ πίνοντέ τε δαινυμένω τε	-u u- uu- --u u -uu- -	dactylic hexameter	masculine penthemimeral, trithemimeral
κήδεσιν ἀλλήλων τερπώμεθα λευγαλέοισι,	-uu --- --uu -uu--	dactylic hexameter	masculine penthemimeral
μνωομένω· μετὰ γάρ τε καὶ ἄλγεσι τέρπεται ἀνήρ,	-uu- uu - u u -uu -uu --	dactylic hexameter	masculine penthemimeral, trithemimeral
ὅς τις δὴ μάλα πολλὰ πάθῃ καὶ πόλλ’ ἐπαληθῇ.	- - - uu -u u- - - uu--	dactylic hexameter	feminine penthemimeral, hepthemimeral, trithemimeral
τοῦτο δέ τοι ἐρέω ὅ μ’ἀνείρεαι ἠδὲ μεταλλᾷς.	-u u - uu- u u-uu -u u--	dactylic hexameter	masculine penthemimeral, trithemimeral
νῆσός τις Συρίη κικλήσκεται, εἴ που ἀκούεις,	-- - uu- --uu - u u--	dactylic hexameter	masculine penthemimeral, trithemimeral
Ὀρτυγίης καθύπερθεν, ὅθι τροπαὶ ἠελίοιο,	-uu- uu-u u- uu -uu--	dactylic hexameter	feminine penthemimeral, hepthemimeral, trithemimeral
οὔ τι περιπληθὴς λίην τόσον, ἀλλ’ ἀγαθὴ μέν,	- u u--- -- uu - uu- -	dactylic hexameter	masculine penthemimeral, hepthemimeral
εὔβοτος, εὔμηλος, οἰνοπληθής, πολύπυρος.	-uu --- ---- uu--	dactylic hexameter	masculine penthemimeral
πείνη δ’οὔ ποτε δῆμον ἐσέρχεται, οὐδέ τις ἄλλη	-- - uu -u u-uu -u u --	dactylic hexameter	feminine penthemimeral, trithemimeral
νοῦσος ἐπὶ στυγερὴ πέλεται δειλοῖσι βροτοῖσιν·	-u u- uu- uu- --u u--	dactylic hexameter	masculine penthemimeral, hepthemimeral, trithemimeral
ἀλλ’ ὅτε γηράσκωσι πόλιν κάτα φῦλ’ ἀνθρώπων,	- uu ---u u- uu - ---	dactylic hexameter	feminine penthemimeral, hepthemimeral
ἐλθὼν ἀργυρότοξος Ἀπόλλων Ἀρτέμιδι ξὺν	-- -uu-u u-- -uu- -	dactylic hexameter	feminine penthemimeral
οἷς ἀγανοῖς βελέεσσιν ἐποιχόμενος κατέπεφνεν.	- uu- uu-u u-uu- uu--	dactylic hexameter	feminine penthemimeral, trithemimeral
ἔνθα δύω πόλιες, δίχα δέ σφισι πάντα δέδασται·	-u u- uu- uu - uu -u u--	dactylic hexameter	masculine penthemimeral, hepthemimeral, trithemimeral
τῇσιν δ’ἀμφοτέρῃσι πατὴρ ἐμὸς ἐμβασίλευε,	-- -uu-u u- uu -uu--	dactylic hexameter	feminine penthemimeral, hepthemimeral
Κτήσιος Ὀρμενίδης, ἐπιείκελος ἀθανάτοισιν.	-uu -uu- uu-uu -uu--	dactylic hexameter	masculine penthemimeral
ἔνθα δὲ Φοίνικες ναυσίκλυτοι ἤλυθον ἄνδρες,	-u u --- --uu -uu --	dactylic hexameter	masculine penthemimeral
τρῶκται, μυρί’ ἄγοντες ἀθύρματα νηῒ μελαίνῃ.	-- -u u-u u-uu -u u--	dactylic hexameter	feminine penthemimeral
ἔσκε δὲ πατρὸς ἐμοῖο γυνὴ Φοίνισσ’ ἐνὶ οἴκῳ,	-u u -u u-u u- -- uu --	dactylic hexameter	feminine penthemimeral, hepthemimeral
καλή τε μεγάλη τε καὶ ἀγλαὰ ἔργ’ εἰδυῖα·	-- - uu- u u -uu - ---	dactylic hexameter	masculine penthemimeral, trithemimeral
τὴν δ’ἄρα Φοίνικες πολυπαίπαλοι ἠπερόπευον.	- uu --- uu-uu -uu--	dactylic hexameter	masculine penthemimeral
πλυνούσῃ τις πρῶτα μίγη κοίλῃ παρὰ νηῒ	--- - -u u- -- uu --	dactylic hexameter	feminine penthemimeral, hepthemimeral, trithemimeral
εὐνῇ καὶ φιλότητι, τά τε φρένας ἠπεροπεύει	-- - uu-u u - uu -uu--	dactylic hexameter	feminine penthemimeral, hepthemimeral, trithemimeral
θηλυτέρῃσι γυναιξί, καὶ ἥ κ’εὐεργὸς ἔῃσιν.	-uu-u u-u u - --u u--	dactylic hexameter	feminine penthemimeral, hepthemimeral
εἰρώτα δὴ ἔπειτα τίς εἴη καὶ πόθεν ἔλθοι·	--- u u-u u -- - uu --	dactylic hexameter	feminine penthemimeral, trithemimeral
ἡ δὲ μάλ’ αὐτίκα πατρὸς ἐπέφραδεν ὑψερεφὲς δῶ·	- u u -uu -u u-uu -uu- -	dactylic hexameter	feminine penthemimeral
ἐκ μὲν Σιδῶνος πολυχάλκου εὔχομαι εἶναι,	- - --- uu-- -uu --	dactylic hexameter	masculine penthemimeral
κούρη δ’εἴμ’ Ἀρύβαντος ἐγὼ ῥυδὸν ἀφνειοῖο·	-- - uu-u u- uu ----	dactylic hexameter	feminine penthemimeral, hepthemimeral, trithemimeral
ἀλλά μ’ἀνήρπαξαν Τάφιοι ληΐστορες ἄνδρες	-u u--- uu- --uu --	dactylic hexameter	masculine penthemimeral, hepthemimeral
ἀγρόθεν ἐρχομένην, πέρασαν δέ με δεῦρ’ ἀγαγόντες	-uu -uu- uu- u u - uu--	dactylic hexameter	masculine penthemimeral, hepthemimeral
τοῦδ’ ἀνδρὸς πρὸς δώμαθ’· ὁ δ’ἄξιον ὦνον ἔδωκε.	- -- - -u u -uu -u u--	dactylic hexameter	feminine penthemimeral, trithemimeral
τὴν δ’αὖτε προσέειπεν ἀνήρ, ὃς ἐμίσγετο λάθρῃ·	- -- uu-u u- u u-uu --	dactylic hexameter	feminine penthemimeral, hepthemimeral, trithemimeral
ἦ ῥά κε νῦν πάλιν αὖτις ἅμ’ ἡμῖν οἴκαδ’ ἕποιο,	- u u - uu -u u -- -u u--	dactylic hexameter	feminine penthemimeral, trithemimeral
ὄφρα ἴδῃς πατρὸς καὶ μητέρος ὑψερεφὲς δῶ	-u u- -- - -uu -uu- -	dactylic hexameter	masculine penthemimeral, trithemimeral
αὐτούς τ’;ἦ γὰρ ἔτ’ εἰσὶ καὶ ἀφνειοὶ καλέονται.	-- - u u -u u --- uu--	dactylic hexameter	feminine penthemimeral, trithemimeral
τὸν δ’αὖτε προσέειπε γυνὴ καὶ ἀμείβετο μύθῳ·	- -- uu-u u- u u-uu --	dactylic hexameter	feminine penthemimeral, hepthemimeral, trithemimeral
εἴη κεν καὶ τοῦτ’, εἴ μοι ἐθέλοιτέ γε, ναῦται,	-- - - - - - uu-u u --	dactylic hexameter	masculine penthemimeral, hepthemimeral, trithemimeral
ὅρκῳ πιστωθῆναι ἀπήμονά μ’οἴκαδ’ ἀπάξειν.	-- ---u u-uu -u u--	dactylic hexameter	feminine penthemimeral
ὣς ἔφαθ’, οἱ δ’ἄρα πάντες ἀπώμνυον ὡς ἐκέλευεν.	- uu - uu -u u-uu - uu--	dactylic hexameter	feminine penthemimeral, trithemimeral
αὐτὰρ ἐπεί ῥ’ὄμοσάν τε τελεύτησάν τε τὸν ὅρκον,	-u u- uu- u u--- u u --	dactylic hexameter	masculine penthemimeral, trithemimeral
τοῖς δ’αὖτις μετέειπε γυνὴ καὶ ἀμείβετο μύθῳ·	- -- uu-u u- u u-uu --	dactylic hexameter	feminine penthemimeral, hepthemimeral, trithemimeral
σιγῇ νῦν, μή τίς με προσαυδάτω ἐπέεσσιν	-- - - - u u--- uu--	dactylic hexameter	masculine penthemimeral, trithemimeral
ὑμετέρων ἑτάρων, ξυμβλήμενος ἢ ἐν ἀγυιῇ,	-uu- uu- --uu - u u--	dactylic hexameter	masculine penthemimeral, trithemimeral
ἤ που ἐπὶ κρήνῃ· μή τις ποτὶ δῶμα γέροντι	- u u- -- - - uu -u u--	dactylic hexameter	masculine penthemimeral, hepthemimeral, trithemimeral
ἐλθὼν ἐξείπῃ, ὁ δ’ὀϊσάμενος καταδήσῃ	-- --- u u-uu- uu--	dactylic hexameter	masculine penthemimeral
δεσμῷ ἐν ἀργαλέῳ, ὑμῖν δ’ἐπιφράσσετ’ ὄλεθρον.	-u u -uu- -- uu-u u--	dactylic hexameter	masculine penthemimeral, hepthemimeral
ἀλλ’ ἔχετ’ ἐν φρεσὶ μῦθον, ἐπείγετε δ’ὦνον ὁδαίων.	- uu - uu -u u-uu -u u--	dactylic hexameter	feminine penthemimeral, trithemimeral
ἀλλ’ ὅτε κεν δὴ νηῦς πλείη βιότοιο γένηται,	- uu - - - -- uu-u u--	dactylic hexameter	masculine penthemimeral, hepthemimeral, trithemimeral
ἀγγελίη μοι ἔπειτα θοῶς πρὸς δώμαθ’ ἱκέσθω·	-uu- u u-u u- - -u u--	dactylic hexameter	feminine penthemimeral, hepthemimeral, trithemimeral
οἴσω γὰρ καὶ χρυσόν, ὅτις χ’ὑποχείριος ἔλθῃ·	-- - - -u u- uu-uu --	dactylic hexameter	feminine penthemimeral, hepthemimeral, trithemimeral
καὶ δέ κεν ἄλλ’ ἐπίβαθρον ἐγὼν ἐθέλουσά γε δοίην.	- u u - uu-u u- uu-u u --	dactylic hexameter	feminine penthemimeral, hepthemimeral, trithemimeral
παῖδα γὰρ ἀνδρὸς ἑῆος ἐνὶ μεγάροις ἀτιτάλλω,	-u u -u u-u u- uu- uu--	dactylic hexameter	feminine penthemimeral, hepthemimeral
κερδαλέον δὴ τοῖον, ἅμα τροχόωντα θύραζε·	-uu- - -u u- uu-u u--	dactylic hexameter	feminine penthemimeral, hepthemimeral, trithemimeral
τόν κεν ἄγοιμ’ ἐπὶ νηός, ὁ δ’ὑμῖν μυρίον ὦνον	- u u- uu -u u -- -uu --	dactylic hexameter	feminine penthemimeral, trithemimeral
ἄλφοι, ὅπῃ περάσητε κατ’ ἀλλοθρόους ἀνθρώπους.	-u u- uu-u u -uu- ---	dactylic hexameter	feminine penthemimeral, trithemimeral
ἡ μὲν ἄρ’ ὣς εἰποῦσ’ ἀπέβη πρὸς δώματα καλά,	- u u - -- uu- - -uu --	dactylic hexameter	masculine penthemimeral, hepthemimeral, trithemimeral
οἱ δ’ἐνιαυτὸν ἅπαντα παρ’ ἡμῖν αὖθι μένοντες	- uu-u u-u u -- -u u--	dactylic hexameter	feminine penthemimeral
ἐν νηῒ γλαφυρῇ βίοτον πολὺν ἐμπολόωντο.	- -- uu- uu- uu -uu--	dactylic hexameter	masculine penthemimeral, hepthemimeral, trithemimeral
ἀλλ’ ὅτε δὴ κοίλη νηῦς ἤχθετο τοῖσι νέεσθαι,	- uu - -- - -uu -u u--	dactylic hexameter	masculine penthemimeral, trithemimeral
καὶ τότ’ ἄρ’ ἄγγελον ἧκαν, ὃς ἀγγείλειε γυναικί.	- u u -uu -u u ---u u--	dactylic hexameter	feminine penthemimeral
ἤλυθ’ ἀνὴρ πολύϊδρις ἐμοῦ πρὸς δώματα πατρὸς	-u u- uu-u u- - -uu --	dactylic hexameter	feminine penthemimeral, hepthemimeral, trithemimeral
χρύσεον ὅρμον ἔχων, μετὰ δ’ἠλέκτροισιν ἔερτο.	-uu -u u- uu ---u u--	dactylic hexameter	masculine penthemimeral
τὸν μὲν ἄρ’ ἐν μεγάρῳ δμῳαὶ καὶ πότνια μήτηρ	- u u - uu- -- - -uu --	dactylic hexameter	masculine penthemimeral, hepthemimeral, trithemimeral
χερσίν τ’ἀμφαφόωντο καὶ ὀφθαλμοῖσιν ὁρῶντο,	-- -uu-u u ---u u--	dactylic hexameter	feminine penthemimeral
ὦνον ὑπισχόμεναι· ὁ δὲ τῇ κατένευσε σιωπῇ.	-u u-uu- u u - uu-u u--	dactylic hexameter	masculine penthemimeral, hepthemimeral
ἤτοι ὁ καννεύσας κοίλην ἐπὶ νῆα βεβήκει,	-u u --- -- uu -u u--	dactylic hexameter	masculine penthemimeral, hepthemimeral
ἡ δέ μὲ χειρὸς ἑλοῦσα δόμων ἐξῆγε θύραζε.	- u u -u u-u u- --u u--	dactylic hexameter	feminine penthemimeral, hepthemimeral
εὗρε δ’ἐνὶ προδόμῳ ἠμὲν δέπας ἠδὲ τραπέζας	-u u- uu- -- uu -u u--	dactylic hexameter	masculine penthemimeral, hepthemimeral, trithemimeral
ἀνδρῶν δαιτυμόνων, οἵ μευ πατέρ’ ἀμφεπένοντο.	-- -uu- - - uu -uu--	dactylic hexameter	masculine penthemimeral, hepthemimeral
οἱ μὲν ἄρ’ ἐς θῶκον πρόμολον, δήμοιό τε φῆμιν,	- u u - -- uu- --u u --	dactylic hexameter	masculine penthemimeral, hepthemimeral, trithemimeral
ἡ δ’αἶψα τρί’ ἄλεισα κατακρύψασ’ ὑπὸ κόλπῳ	- -- u u-u u--- uu --	dactylic hexameter	feminine penthemimeral, trithemimeral
ἔκφερεν· αὐτὰρ ἐγὼν ἑπόμην ἀεσιφροσύνῃσι.	-uu -u u- uu- uu-uu--	dactylic hexameter	masculine penthemimeral, hepthemimeral
δύσετό τ’ἠέλιος, σκιόωντό τε πᾶσαι ἀγυιαί·	-uu -uu- uu-u u -u u--	dactylic hexameter	masculine penthemimeral
ἡμεῖς δ’ἐς λιμένα κλυτὸν ἤλθομεν ὦκα κιόντες,	-- - uu- uu -uu -u u--	dactylic hexameter	masculine penthemimeral, trithemimeral
ἔνθ’ ἄρα Φοινίκων ἀνδρῶν ἦν ὠκύαλος νηῦς.	- uu --- -- - -uu- -	dactylic hexameter	masculine penthemimeral, hepthemimeral
οἱ μὲν ἔπειτ’ ἀναβάντες ἐπέπλεον ὑγρὰ κέλευθα,	- u u- uu-u u-uu -u u--	dactylic hexameter	feminine penthemimeral, trithemimeral
νὼ ἀναβησάμενοι· ἐπὶ δὲ Ζεὺς οὖρον ἴαλλεν.	- uu-uu- uu - - -u u--	dactylic hexameter	masculine penthemimeral, hepthemimeral
ἑξῆμαρ μὲν ὁμῶς πλέομεν νύκτας τε καὶ ἦμαρ·	--- u u- uu- -- u u --	dactylic hexameter	masculine penthemimeral, hepthemimeral, trithemimeral
ἀλλ’ ὅτε δὴ ἕβδομον ἦμαρ ἐπὶ Ζεὺς θῆκε Κρονίων,	- uu -uu -u u- - -u u--	dactylic hexameter	feminine penthemimeral, hepthemimeral
τὴν μὲν ἔπειτα γυναῖκα βάλ’ Ἄρτεμις ἰοχέαιρα,	- u u-u u-u u -uu -uu--	dactylic hexameter	feminine penthemimeral
ἄντλῳ δ’ἐνδούπησε πεσοῦσ’ ὡς εἰναλίη κήξ.	-- ---u u- - -uu- -	dactylic hexameter	feminine penthemimeral, hepthemimeral
καὶ τὴν μὲν φώκῃσι καὶ ἰχθύσι κύρμα γενέσθαι	- - - --u u -uu -u u--	dactylic hexameter	feminine penthemimeral, trithemimeral
ἔκβαλον· αὐτὰρ ἐγὼ λιπόμην ἀκαχήμενος ἦτορ·	-uu -u u- uu- uu-uu --	dactylic hexameter	masculine penthemimeral, hepthemimeral
τοὺς δ’Ἰθάκῃ ἐπέλασσε φέρων ἄνεμός τε καὶ ὕδωρ,	- uu- uu-u u- uu- u u --	dactylic hexameter	feminine penthemimeral, hepthemimeral, trithemimeral
ἔνθα με Λαέρτης πρίατο κτεάτεσσιν ἑοῖσιν.	-u u --- uu- uu-u u--	dactylic hexameter	masculine penthemimeral, hepthemimeral
οὕτω τήνδε τε γαῖαν ἐγὼν ἴδον ὀφθαλμοῖσι.	-- -u u -u u- uu ----	dactylic hexameter	feminine penthemimeral, hepthemimeral
τὸν δ’αὖ διογενὴς Ὀδυσεὺς ἠμείβετο μύθῳ·	- - -uu- uu- --uu --	dactylic hexameter	masculine penthemimeral, hepthemimeral
Εὔμαι’, ἦ μάλα δή μοι ἐνὶ φρεσὶ θυμὸν ὄρινας	-- - uu - u u- uu -u u--	dactylic hexameter	masculine penthemimeral, hepthemimeral, trithemimeral
ταῦτα ἕκαστα λέγων, ὅσα δὴ πάθες ἄλγεα θυμῷ.	-u u-u u- uu - uu -uu --	dactylic hexameter	masculine penthemimeral, hepthemimeral
ἀλλ’ ἤτοι σοὶ μὲν παρὰ καὶ κακῷ ἐσθλὸν ἔθηκε	- -- - - uu - uu -u u--	dactylic hexameter	masculine penthemimeral, hepthemimeral, trithemimeral
Ζεύς, ἐπεὶ ἀνδρὸς δώματ’ ἀφίκεο πολλὰ μογήσας	- uu -- -u u-uu -u u--	dactylic hexameter	feminine penthemimeral
ἠπίου, ὃς δή τοι παρέχει βρῶσίν τε πόσιν τε	-uu - - - uu- -- u u- -	dactylic hexameter	masculine penthemimeral, hepthemimeral, trithemimeral
ἐνδυκέως, ζώεις δ’ἀγαθὸν βίον· αὐτὰρ ἔγωγε	-uu- -- uu- uu -u u--	dactylic hexameter	masculine penthemimeral, hepthemimeral, trithemimeral
πολλὰ βροτῶν ἐπὶ ἄστε’ ἀλώμενος ἐνθάδ’ ἱκάνω.	-u u- uu -u u-uu -u u--	dactylic hexameter	feminine penthemimeral, trithemimeral
ὣς οἱ μὲν τοιαῦτα πρὸς ἀλλήλους ἀγόρευον,	- - - --u u --- uu--	dactylic hexameter	feminine penthemimeral, trithemimeral
καδδραθέτην δ’οὐ πολλὸν ἐπὶ χρόνον, ἀλλὰ μίνυνθα·	-uu- - -u u- uu -u u--	dactylic hexameter	feminine penthemimeral, hepthemimeral, trithemimeral
αἶψα γὰρ Ἠὼς ἦλθεν ἐΰθρονος. οἱ δ’ἐπὶ χέρσου	-u u -- -u u-uu - uu --	dactylic hexameter	feminine penthemimeral
Τηλεμάχου ἕταροι λύον ἱστία, κὰδ δ’ἕλον ἱστὸν	-uu- uu- uu -uu - uu --	dactylic hexameter	masculine penthemimeral, trithemimeral
καρπαλίμως, τὴν δ’εἰς ὅρμον προέρεσσαν ἐρετμοῖς·	-uu- - - -- uu-u u--	dactylic hexameter	masculine penthemimeral, hepthemimeral, trithemimeral
ἐκ δ’εὐνὰς ἔβαλον, κατὰ δὲ πρυμνήσι’ ἔδησαν·	- -- uu- uu - --u u--	dactylic hexameter	masculine penthemimeral, hepthemimeral, trithemimeral
ἐκ δὲ καὶ αὐτοὶ βαῖνον ἐπὶ ῥηγμῖνι θαλάσσης,	- u u -- -u u- --u u--	dactylic hexameter	feminine penthemimeral, hepthemimeral
δεῖπνόν τ’ἐντύνοντο κερῶντό τε αἴθοπα οἶνον.	-- ---u u-u u -uu --	dactylic hexameter	feminine penthemimeral
αὐτὰρ ἐπεὶ πόσιος καὶ ἐδητύος ἐξ ἔρον ἕντο,	-u u- uu- u u-uu - uu --	dactylic hexameter	masculine penthemimeral, trithemimeral
τοῖσι δὲ Τηλέμαχος πεπνυμένος ἤρχετο μύθων·	-u u -uu- --uu -uu --	dactylic hexameter	masculine penthemimeral
ὑμεῖς μὲν νῦν ἄστυδ’ ἐλαύνετε νῆα μέλαιναν,	-- - - -u u-uu -u u--	dactylic hexameter	feminine penthemimeral, trithemimeral
αὐτὰρ ἐγὼν ἀγροὺς ἐπιείσομαι ἠδὲ βοτῆρας·	-u u- -- uu-uu -u u--	dactylic hexameter	masculine penthemimeral, trithemimeral
ἑσπέριος δ’εἰς ἄστυ ἰδὼν ἐμὰ ἔργα κάτειμι.	-uu- - -u u- uu -u u--	dactylic hexameter	feminine penthemimeral, hepthemimeral, trithemimeral
ἠῶθεν δέ κεν ὔμμιν ὁδοιπόριον παραθείμην,	--- u u -u u-uu- uu--	dactylic hexameter	feminine penthemimeral, trithemimeral
δαῖτ’ ἀγαθὴν κρειῶν τε καὶ οἴνου ἡδυπότοιο.	- uu- -- u u -- -uu--	dactylic hexameter	masculine penthemimeral, trithemimeral
τὸν δ’αὖτε προσέειπε Θεοκλύμενος θεοειδής·	- -- uu-u u-uu- uu--	dactylic hexameter	feminine penthemimeral, trithemimeral
πῇ γὰρ ἐγώ, φίλε τέκνον, ἴω; τεῦ δώμαθ’ ἵκωμαι	- u u- uu -u u- - -u u--	dactylic hexameter	feminine penthemimeral, hepthemimeral, trithemimeral
ἀνδρῶν οἳ κραναὴν Ἰθάκην κάτα κοιρανέουσιν;	-- - uu- uu- uu -uu--	dactylic hexameter	masculine penthemimeral, hepthemimeral, trithemimeral
ἦ ἰθὺς σῆς μητρὸς ἴω καὶ σοῖο δόμοιο;	- -- - -u u- - -u u--	dactylic hexameter	feminine penthemimeral, hepthemimeral, trithemimeral
τὸν δ’αὖ Τηλέμαχος πεπνυμένος ἀντίον ηὔδα·	- - -uu- --uu -uu --	dactylic hexameter	masculine penthemimeral
ἄλλως μέν σ’ἂν ἔγωγε καὶ ἡμέτερόνδε κελοίμην	-- - u u-u u -uu-u u--	dactylic hexameter	feminine penthemimeral, trithemimeral
ἔρχεσθ’· οὐ γάρ τι ξενίων ποθή· ἀλλὰ σοὶ αὐτῷ	-- - - - uu- uu -u u --	dactylic hexameter	masculine penthemimeral, hepthemimeral, trithemimeral
χεῖρον, ἐπεί τοι ἐγὼ μὲν ἀπέσσομαι, οὐδέ σε μήτηρ	-u u- u u- u u-uu -u u --	dactylic hexameter	masculine penthemimeral, trithemimeral
ὄψεται· οὐ μὲν γάρ τι θαμὰ μνηστῆρσ’ ἐνὶ οἴκῳ	-uu - - - u u- -- uu --	dactylic hexameter	masculine penthemimeral, hepthemimeral, trithemimeral
φαίνεται, ἀλλ’ ἀπὸ τῶν ὑπερωΐῳ ἱστὸν ὑφαίνει.	-uu - uu - uu-uu -u u--	dactylic hexameter	masculine penthemimeral, trithemimeral
ἀλλά τοι ἄλλον φῶτα πιφαύσκομαι ὅν κεν ἵκοιο,	-u u -- -u u-uu - u u--	dactylic hexameter	feminine penthemimeral
Εὐρύμαχον, Πολύβοιο δαΐφρονος ἀγλαὸν υἱόν,	-uu- uu-u u-uu -uu --	dactylic hexameter	feminine penthemimeral, trithemimeral
τὸν νῦν ἶσα θεῷ Ἰθακήσιοι εἰσορόωσι·	- - -u u- uu-uu -uu--	dactylic hexameter	masculine penthemimeral
καὶ γὰρ πολλὸν ἄριστος ἀνὴρ μέμονέν τε μάλιστα	- - -u u-u u- uu- u u--	dactylic hexameter	feminine penthemimeral, hepthemimeral
μητέρ’ ἐμὴν γαμέειν καὶ Ὀδυσσῆος γέρας ἕξειν.	-u u- uu- u u--- uu --	dactylic hexameter	masculine penthemimeral, trithemimeral
ἀλλὰ τά γε Ζεὺς οἶδεν Ὀλύμπιος, αἰθέρι ναίων,	-u u - - -u u-uu -uu --	dactylic hexameter	feminine penthemimeral, trithemimeral
εἴ κέ σφιν πρὸ γάμοιο τελευτήσει κακὸν ἦμαρ.	- - - u u-u u--- uu --	dactylic hexameter	feminine penthemimeral, trithemimeral
ὣς ἄρα οἱ εἰπόντι ἐπέπτατο δεξιὸς ὄρνις,	- uu - --u u-uu -uu --	dactylic hexameter	feminine penthemimeral, trithemimeral
κίρκος, Ἀπόλλωνος ταχὺς ἄγγελος· ἐν δὲ πόδεσσι	-u u--- uu -uu - u u--	dactylic hexameter	masculine penthemimeral
τίλλε πέλειαν ἔχων, κατὰ δὲ πτερὰ χεῦεν ἔραζε	-u u-u u- uu - uu -u u--	dactylic hexameter	masculine penthemimeral, hepthemimeral
μεσσηγὺς νηός τε καὶ αὐτοῦ Τηλεμάχοιο.	--- -- u u -- -uu--	dactylic hexameter	masculine penthemimeral, trithemimeral
τὸν δὲ Θεοκλύμενος ἑτάρων ἀπονόσφι καλέσσας	- u u-uu- uu- uu-u u--	dactylic hexameter	masculine penthemimeral, hepthemimeral
ἔν τ’ἄρα οἱ φῦ χειρὶ ἔπος τ’ἔφατ’ ἔκ τ’ὀνόμαζε·	- uu - - -u u- uu - uu--	dactylic hexameter	feminine penthemimeral, hepthemimeral, trithemimeral
Τηλέμαχ’, οὔ τοι ἄνευ θεοῦ ἤλυθε δεξιὸς ὄρνις	-uu - u u- uu -uu -uu --	dactylic hexameter	masculine penthemimeral, trithemimeral
ἔγνων γάρ μιν ἐσάντα ἰδὼν οἰωνὸν ἐόντα.	-- - u u-u u- --u u--	dactylic hexameter	feminine penthemimeral, hepthemimeral, trithemimeral
ὑμετέρου δ’οὐκ ἔστι γένευς βασιλεύτερον ἄλλο	-uu- - -u u- uu-uu --	dactylic hexameter	feminine penthemimeral, hepthemimeral, trithemimeral
ἐν δήμῳ Ἰθάκης, ἀλλ’ ὑμεῖς καρτεροὶ αἰεί.	- -- uu- - -- -uu --	dactylic hexameter	masculine penthemimeral, trithemimeral
τὸν δ’αὖ Τηλέμαχος πεπνυμένος ἀντίον ηὔδα·	- - -uu- --uu -uu --	dactylic hexameter	masculine penthemimeral
αἲ γὰρ τοῦτο, ξεῖνε, ἔπος τετελεσμένον εἴη·	- - -- -u u- uu-uu --	dactylic hexameter	feminine penthemimeral, hepthemimeral
τῶ κε τάχα γνοίης φιλότητά τε πολλά τε δῶρα	- u u- -- uu-u u -u u --	dactylic hexameter	masculine penthemimeral, trithemimeral
ἐξ ἐμεῦ, ὡς ἄν τίς σε συναντόμενος μακαρίζοι.	- uu - - - u u-uu- uu--	dactylic hexameter	masculine penthemimeral, trithemimeral
ἦ καὶ Πείραιον προσεφώνεε, πιστὸν ἑταῖρον·	- - --- uu-uu -u u--	dactylic hexameter	masculine penthemimeral
Πείραιε Κλυτίδη, σὺ δέ μοι τά περ ἄλλα μάλιστα	--- uu- u u - u u -u u--	dactylic hexameter	masculine penthemimeral, hepthemimeral, trithemimeral
πείθῃ ἐμῶν ἑτάρων, οἵ μοι Πύλον εἰς ἅμ’ ἕποντο·	-u u- uu- - - uu - u u--	dactylic hexameter	masculine penthemimeral, hepthemimeral, trithemimeral
καὶ νῦν μοι τὸν ξεῖνον ἄγων ἐν δώμασι σοῖσιν	- - - - -u u- - -uu --	dactylic hexameter	feminine penthemimeral, hepthemimeral, trithemimeral
ἐνδυκέως φιλέειν καὶ τιέμεν, εἰς ὅ κεν ἔλθω.	-uu- uu- - -uu - u u --	dactylic hexameter	masculine penthemimeral, trithemimeral
τὸν δ’αὖ Πείραιος δουρικλυτὸς ἀντίον ηὔδα·	- - --- --uu -uu --	dactylic hexameter	masculine penthemimeral
Τηλέμαχ’, εἰ γάρ κεν σὺ πολὺν χρόνον ἐνθάδε μίμνοις,	-uu - - - u u- uu -uu --	dactylic hexameter	masculine penthemimeral, hepthemimeral, trithemimeral
τόνδε τ’ἐγὼ κομιῶ, ξενίων δέ οἱ οὐ ποθὴ ἔσται.	-u u- uu- uu- u u - uu --	dactylic hexameter	masculine penthemimeral, hepthemimeral, trithemimeral
ὣς εἰπὼν ἐπὶ νηὸς ἔβη, ἐκέλευσε δ’ἑταίρους	- -- uu -u u- uu-u u--	dactylic hexameter	feminine penthemimeral, hepthemimeral, trithemimeral
αὐτούς τ’ἀμβαίνειν ἀνά τε πρυμνήσια λῦσαι.	-- --- uu - --uu --	dactylic hexameter	masculine penthemimeral, hepthemimeral
οἱ δ’αἶψ’ εἴσβαινον καὶ ἐπὶ κληῗσι καθῖζον.	- - --- u u- --u u--	dactylic hexameter	masculine penthemimeral, hepthemimeral
Τηλέμαχος δ’ὑπὸ ποσσὶν ἐδήσατο καλὰ πέδιλα,	-uu- uu -u u-uu -u u--	dactylic hexameter	feminine penthemimeral, trithemimeral
εἵλετο δ’ἄλκιμον ἔγχος, ἀκαχμένον ὀξέϊ χαλκῷ,	-uu -uu -u u-uu -uu --	dactylic hexameter	feminine penthemimeral
νηὸς ἀπ’ ἰκριόφιν· τοὶ δὲ πρυμνήσι’ ἔλυσαν.	-u u -uu- - - --u u--	dactylic hexameter	masculine penthemimeral, hepthemimeral
οἱ μὲν ἀνώσαντες πλέον ἐς πόλιν, ὡς ἐκέλευσε	- u u--- uu - uu - uu--	dactylic hexameter	masculine penthemimeral, hepthemimeral
Τηλέμαχος, φίλος υἱὸς Ὀδυσσῆος θείοιο·	-uu- uu -u u--- ---	dactylic hexameter	feminine penthemimeral, trithemimeral
τὸν δ’ὦκα προβιβώντα πόδες φέρον, ὄφρ’ ἵκετ’ αὐλήν,	- -- uu-u u- uu - uu --	dactylic hexameter	feminine penthemimeral, hepthemimeral, trithemimeral
ἔνθα οἱ ἦσαν ὕες μάλα μυρίαι, ᾗσι συβώτης	-u u -u u- uu -uu -u u--	dactylic hexameter	masculine penthemimeral
ἐσθλὸς ἐὼν ἐνίαυεν, ἀνάκτεσιν ἤπια εἰδώς,	-u u- uu-u u-uu -uu --	dactylic hexameter	feminine penthemimeral, trithemimeral
