ἦμος δ’ἠριγένεια φάνη ῥοδοδάκτυλος Ἠώς,	-- -uu-u u- uu-uu --	dactylic hexameter	feminine penthemimeral, hepthemimeral
ὤρνυτ’ ἄρ’ ἐξ εὐνῆφιν Ὀδυσσῆος φίλος υἱὸς	-u u - --u u--- uu --	dactylic hexameter	feminine penthemimeral, trithemimeral
εἵματα ἑσσάμενος, περὶ δὲ ξίφος ὀξὺ θέτ’ ὤμῳ,	-uu -uu- uu - uu -u u --	dactylic hexameter	masculine penthemimeral, hepthemimeral
ποσσὶ δ’ὑπὸ λιπαροῖσιν ἐδήσατο καλὰ πέδιλα,	-u u- uu-u u-uu -u u--	dactylic hexameter	feminine penthemimeral, trithemimeral
βῆ δ’ἴμεν ἐκ θαλάμοιο θεῷ ἐναλίγκιος ἄντην.	- uu - uu-u u- uu-uu --	dactylic hexameter	feminine penthemimeral, hepthemimeral, trithemimeral
αἶψα δὲ κηρύκεσσι λιγυφθόγγοισι κέλευσε	-u u ---u u---u u--	dactylic hexameter	feminine penthemimeral
κηρύσσειν ἀγορήνδε κάρη κομόωντας Ἀχαιούς.	--- uu-u u- uu-u u--	dactylic hexameter	feminine penthemimeral, hepthemimeral, trithemimeral
οἱ μὲν ἐκήρυσσον, τοὶ δ’ἠγείροντο μάλ’ ὦκα.	- u u--- - ---u u --	dactylic hexameter	masculine penthemimeral
αὐτὰρ ἐπεί ῥ’ἤγερθεν ὁμηγερέες τ’ἐγένοντο,	-u u- --u u-uu- uu--	dactylic hexameter	feminine penthemimeral, trithemimeral
βῆ ῥ’ἴμεν εἰς ἀγορήν, παλάμῃ δ’ἔχε χάλκεον ἔγχος,	- uu - uu- uu- uu -uu --	dactylic hexameter	masculine penthemimeral, hepthemimeral, trithemimeral
οὐκ οἶος, ἅμα τῷ γε δύω κύνες ἀργοὶ ἕποντο.	- -- uu - u u- uu -u u--	dactylic hexameter	masculine penthemimeral, hepthemimeral, trithemimeral
θεσπεσίην δ’ἄρα τῷ γε χάριν κατέχευεν Ἀθήνη.	-uu- uu - u u- uu-u u--	dactylic hexameter	masculine penthemimeral, hepthemimeral, trithemimeral
τὸν δ’ἄρα πάντες λαοὶ ἐπερχόμενον θηεῦντο·	- uu -- -u u-uu- ---	dactylic hexameter	feminine penthemimeral
ἕζετο δ’ἐν πατρὸς θώκῳ, εἶξαν δὲ γέροντες.	-uu - -- -- -- u u--	dactylic hexameter	masculine penthemimeral, hepthemimeral, trithemimeral
τοῖσι δ’ἔπειθ’ ἥρως Αἰγύπτιος ἦρχ’ ἀγορεύειν,	-u u- -- --uu - uu--	dactylic hexameter	masculine penthemimeral, trithemimeral
ὃς δὴ γήραϊ κυφὸς ἔην καὶ μυρία ᾔδη.	- - -uu -u u- - -uu --	dactylic hexameter	feminine penthemimeral, hepthemimeral
καὶ γὰρ τοῦ φίλος υἱὸς ἅμ’ ἀντιθέῳ Ὀδυσῆι	- - - uu -u u -uu- uu--	dactylic hexameter	feminine penthemimeral, trithemimeral
Ἴλιον εἰς ἐύπωλον ἔβη κοίλῃς ἐνὶ νηυσίν,	-uu - uu-u u- -- uu --	dactylic hexameter	feminine penthemimeral, hepthemimeral, trithemimeral
Ἄντιφος αἰχμητής· τὸν δ’ἄγριος ἔκτανε Κύκλωψ	-uu --- - -uu -uu --	dactylic hexameter	masculine penthemimeral
ἐν σπῆι γλαφυρῷ, πύματον δ’ὡπλίσσατο δόρπον.	- -- uu- uu- --uu --	dactylic hexameter	masculine penthemimeral, hepthemimeral, trithemimeral
τρεῖς δέ οἱ ἄλλοι ἔσαν, καὶ ὁ μὲν μνηστῆρσιν ὁμίλει,	- u u -u u- u u - --u u--	dactylic hexameter	masculine penthemimeral, hepthemimeral
Εὐρύνομος, δύο δ’αἰὲν ἔχον πατρώια ἔργα.	-uu- uu -u u- --uu --	dactylic hexameter	feminine penthemimeral, hepthemimeral, trithemimeral
ἀλλ’ οὐδ’ ὣς τοῦ λήθετ’ ὀδυρόμενος καὶ ἀχεύων.	- - - - -u u-uu- u u--	dactylic hexameter	feminine penthemimeral, trithemimeral
τοῦ ὅ γε δάκρυ χέων ἀγορήσατο καὶ μετέειπε·	- u u -u u- uu-uu - uu--	dactylic hexameter	masculine penthemimeral
κέκλυτε δὴ νῦν μευ, Ἰθακήσιοι, ὅττι κεν εἴπω·	-uu - - - uu-uu -u u --	dactylic hexameter	masculine penthemimeral, trithemimeral
οὔτε ποθ’ ἡμετέρη ἀγορὴ γένετ’ οὔτε θόωκος	-u u -uu- uu- uu -u u--	dactylic hexameter	masculine penthemimeral, hepthemimeral
ἐξ οὗ Ὀδυσσεὺς δῖος ἔβη κοίλῃς ἐνὶ νηυσί.	- u u-- -u u- -- uu --	dactylic hexameter	feminine penthemimeral, hepthemimeral
νῦν δὲ τίς ὧδ’ ἤγειρε; τίνα χρειὼ τόσον ἵκει	- u u - --u u- -- uu --	dactylic hexameter	feminine penthemimeral, hepthemimeral, trithemimeral
ἠὲ νέων ἀνδρῶν ἢ οἳ προγενέστεροί εἰσιν;	-u u- -- - - uu-uu --	dactylic hexameter	masculine penthemimeral, hepthemimeral, trithemimeral
ἠέ τιν’ ἀγγελίην στρατοῦ ἔκλυεν ἐρχομένοιο,	-u u -uu- uu -uu -uu--	dactylic hexameter	masculine penthemimeral
ἥν χ’ἡμῖν σάφα εἴποι, ὅτε πρότερός γε πύθοιτο;	- -- uu -u u- uu- u u--	dactylic hexameter	feminine penthemimeral, hepthemimeral, trithemimeral
ἦέ τι δήμιον ἄλλο πιφαύσκεται ἠδ’ ἀγορεύει;	-u u -uu -u u-uu - uu--	dactylic hexameter	feminine penthemimeral
ἐσθλός μοι δοκεῖ εἶναι, ὀνήμενος. εἴθε οἱ αὐτῷ	-- - uu -u u-uu -u u --	dactylic hexameter	feminine penthemimeral, trithemimeral
Ζεὺς ἀγαθὸν τελέσειεν, ὅτι φρεσὶν ᾗσι μενοινᾷ.	- uu- uu-u u- uu -u u--	dactylic hexameter	feminine penthemimeral, hepthemimeral, trithemimeral
ὣς φάτο, χαῖρε δὲ φήμῃ Ὀδυσσῆος φίλος υἱός,	- uu -u u -u u--- uu --	dactylic hexameter	feminine penthemimeral
οὐδ’ ἄρ’ ἔτι δὴν ἧστο, μενοίνησεν δ’ἀγορεύειν,	- u u- - -u u--- uu--	dactylic hexameter	feminine penthemimeral, trithemimeral
στῆ δὲ μέσῃ ἀγορῇ· σκῆπτρον δέ οἱ ἔμβαλε χειρὶ	- u u- uu- -- u u -uu --	dactylic hexameter	masculine penthemimeral, hepthemimeral, trithemimeral
κῆρυξ Πεισήνωρ πεπνυμένα μήδεα εἰδώς.	-- --- --uu -uu --	dactylic hexameter	masculine penthemimeral
πρῶτον ἔπειτα γέροντα καθαπτόμενος προσέειπεν·	-u u-u u-u u-uu- uu--	dactylic hexameter	feminine penthemimeral
ὦ γέρον, οὐχ ἑκὰς οὗτος ἀνήρ, τάχα δ’εἴσεαι αὐτός,	- uu - uu -u u- uu -uu --	dactylic hexameter	feminine penthemimeral, hepthemimeral, trithemimeral
ὃς λαὸν ἤγειρα· μάλιστα δέ μ’ἄλγος ἱκάνει.	- -- --u u-u u -u u--	dactylic hexameter	feminine penthemimeral, trithemimeral
οὔτε τιν’ ἀγγελίην στρατοῦ ἔκλυον ἐρχομένοιο,	-u u -uu- uu -uu -uu--	dactylic hexameter	masculine penthemimeral
ἥν χ’ὑμῖν σάφα εἴπω, ὅτε πρότερός γε πυθοίμην,	- -- uu -u u- uu- u u--	dactylic hexameter	feminine penthemimeral, hepthemimeral, trithemimeral
οὔτε τι δήμιον ἄλλο πιφαύσκομαι οὐδ’ ἀγορεύω,	-u u -uu -u u-uu - uu--	dactylic hexameter	feminine penthemimeral
ἀλλ’ ἐμὸν αὐτοῦ χρεῖος, ὅ μοι κακὰ ἔμπεσεν οἴκῳ	- uu -- -u u - uu -uu --	dactylic hexameter	feminine penthemimeral, hepthemimeral
δοιά· τὸ μὲν πατέρ’ ἐσθλὸν ἀπώλεσα, ὅς ποτ’ ἐν ὑμῖν	-u u - uu -u u-uu - u u --	dactylic hexameter	feminine penthemimeral, trithemimeral
τοίσδεσσιν βασίλευε, πατὴρ δ’ὣς ἤπιος ἦεν·	--- uu-u u- - -uu --	dactylic hexameter	feminine penthemimeral, hepthemimeral, trithemimeral
νῦν δ’αὖ καὶ πολὺ μεῖζον, ὃ δὴ τάχα οἶκον ἅπαντα	- - - uu -u u - uu -u u--	dactylic hexameter	feminine penthemimeral, hepthemimeral, trithemimeral
πάγχυ διαρραίσει, βίοτον δ’ἀπὸ πάμπαν ὀλέσσει.	-u u--- uu- uu -u u--	dactylic hexameter	masculine penthemimeral, hepthemimeral
μητέρι μοι μνηστῆρες ἐπέχραον οὐκ ἐθελούσῃ,	-uu - --u u-uu - uu--	dactylic hexameter	feminine penthemimeral, trithemimeral
τῶν ἀνδρῶν φίλοι υἷες, οἳ ἐνθάδε γ’εἰσὶν ἄριστοι,	- -- uu -u u -uu -u u--	dactylic hexameter	feminine penthemimeral, trithemimeral
οἳ πατρὸς μὲν ἐς οἶκον ἀπερρίγασι νέεσθαι	- -- u u -u u---u u--	dactylic hexameter	feminine penthemimeral, trithemimeral
Ἰκαρίου, ὥς κ’αὐτὸς ἐεδνώσαιτο θύγατρα,	-uu- - -u u---u u--	dactylic hexameter	feminine penthemimeral, trithemimeral
δοίη δ’ᾧ κ’ἐθέλοι καί οἱ κεχαρισμένος ἔλθοι·	-- - uu- - - uu-uu --	dactylic hexameter	masculine penthemimeral, hepthemimeral, trithemimeral
οἱ δ’εἰς ἡμέτερον πωλεύμενοι ἤματα πάντα,	- - -uu- --uu -uu --	dactylic hexameter	masculine penthemimeral
βοῦς ἱερεύοντες καὶ ὄις καὶ πίονας αἶγας	- uu--- u u- - -uu --	dactylic hexameter	masculine penthemimeral, hepthemimeral
εἰλαπινάζουσιν πίνουσί τε αἴθοπα οἶνον	-uu--- --u u -uu --	dactylic hexameter	masculine penthemimeral
μαψιδίως· τὰ δὲ πολλὰ κατάνεται. οὐ γὰρ ἔπ’ ἀνήρ,	-uu- u u -u u-uu - u u --	dactylic hexameter	feminine penthemimeral, trithemimeral
οἷος Ὀδυσσεὺς ἔσκεν, ἀρὴν ἀπὸ οἴκου ἀμῦναι.	-u u-- -u u- uu -u u--	dactylic hexameter	feminine penthemimeral, hepthemimeral
ἡμεῖς δ’οὔ νύ τι τοῖοι ἀμυνέμεν· ἦ καὶ ἔπειτα	-- - u u -u u-uu - u u--	dactylic hexameter	feminine penthemimeral, trithemimeral
λευγαλέοι τ’ἐσόμεσθα καὶ οὐ δεδαηκότες ἀλκήν.	-uu- uu-u u - uu-uu --	dactylic hexameter	feminine penthemimeral, hepthemimeral, trithemimeral
ἦ τ’ἂν ἀμυναίμην, εἴ μοι δύναμίς γε παρείη.	- u u--- - - uu- u u--	dactylic hexameter	masculine penthemimeral, hepthemimeral
οὐ γὰρ ἔτ’ ἀνσχετὰ ἔργα τετεύχαται, οὐδ’ ἔτι καλῶς	- u u -uu -u u-uu - uu --	dactylic hexameter	feminine penthemimeral
οἶκος ἐμὸς διόλωλε. νεμεσσήθητε καὶ αὐτοί,	-u u- uu-u u---u u --	dactylic hexameter	feminine penthemimeral, trithemimeral
ἄλλους τ’αἰδέσθητε περικτίονας ἀνθρώπους,	-- ---u u-uu- ---	dactylic hexameter	feminine penthemimeral
οἳ περιναιετάουσι· θεῶν δ’ὑποδείσατε μῆνιν,	- uu-uu-u u- uu-uu --	dactylic hexameter	feminine penthemimeral, hepthemimeral
μή τι μεταστρέψωσιν ἀγασσάμενοι κακὰ ἔργα.	- u u---u u-uu- uu --	dactylic hexameter	feminine penthemimeral
λίσσομαι ἠμὲν Ζηνὸς Ὀλυμπίου ἠδὲ Θέμιστος,	-uu -- -u u-uu -u u--	dactylic hexameter	feminine penthemimeral
ἥ τ’ἀνδρῶν ἀγορὰς ἠμὲν λύει ἠδὲ καθίζει·	- -- uu- -- uu -u u--	dactylic hexameter	masculine penthemimeral, hepthemimeral, trithemimeral
σχέσθε, φίλοι, καί μ’οἶον ἐάσατε πένθεϊ λυγρῷ	-u u- - -u u-uu -uu --	dactylic hexameter	feminine penthemimeral, trithemimeral
τείρεσθ’, εἰ μή πού τι πατὴρ ἐμὸς ἐσθλὸς Ὀδυσσεὺς	-- - - - u u- uu -u u--	dactylic hexameter	masculine penthemimeral, hepthemimeral, trithemimeral
δυσμενέων κάκ’ ἔρεξεν ἐυκνήμιδας Ἀχαιούς,	-uu- u u-u u---u u--	dactylic hexameter	feminine penthemimeral, trithemimeral
τῶν μ’ἀποτινύμενοι κακὰ ῥέζετε δυσμενέοντες,	- uu-uu- uu -uu -uu--	dactylic hexameter	masculine penthemimeral
τούτους ὀτρύνοντες. ἐμοὶ δέ κε κέρδιον εἴη	-- ---u u- u u -uu --	dactylic hexameter	feminine penthemimeral, hepthemimeral
ὑμέας ἐσθέμεναι κειμήλιά τε πρόβασίν τε.	-uu -uu- --uu - uu- -	dactylic hexameter	masculine penthemimeral
εἴ χ’ὑμεῖς γε φάγοιτε, τάχ’ ἄν ποτε καὶ τίσις εἴη·	- -- u u-u u - uu - uu --	dactylic hexameter	feminine penthemimeral, hepthemimeral, trithemimeral
τόφρα γὰρ ἂν κατὰ ἄστυ ποτιπτυσσοίμεθα μύθῳ	-u u - uu -u u---uu --	dactylic hexameter	feminine penthemimeral, trithemimeral
χρήματ’ ἀπαιτίζοντες, ἕως κ’ἀπὸ πάντα δοθείη·	-u u---u u- uu -u u--	dactylic hexameter	feminine penthemimeral, hepthemimeral
νῦν δέ μοι ἀπρήκτους ὀδύνας ἐμβάλλετε θυμῷ.	- u u --- uu- --uu --	dactylic hexameter	masculine penthemimeral, hepthemimeral
ὣς φάτο χωόμενος, ποτὶ δὲ σκῆπτρον βάλε γαίῃ	- uu -uu- uu - -- uu --	dactylic hexameter	masculine penthemimeral, hepthemimeral
δάκρυ’ ἀναπρήσας· οἶκτος δ’ἕλε λαὸν ἅπαντα.	-u u--- -- uu -u u--	dactylic hexameter	masculine penthemimeral, hepthemimeral
ἔνθ’ ἄλλοι μὲν πάντες ἀκὴν ἔσαν, οὐδέ τις ἔτλη	- -- - -u u- uu -u u --	dactylic hexameter	feminine penthemimeral, hepthemimeral, trithemimeral
Τηλέμαχον μύθοισιν ἀμείψασθαι χαλεποῖσιν·	-uu- --u u--- uu--	dactylic hexameter	feminine penthemimeral, trithemimeral
Ἀντίνοος δέ μιν οἶος ἀμειβόμενος προσέειπε·	-uu- u u -u u-uu- uu--	dactylic hexameter	feminine penthemimeral, trithemimeral
Τηλέμαχ’ ὑψαγόρη, μένος ἄσχετε, ποῖον ἔειπες	-uu -uu- uu -uu -u u--	dactylic hexameter	masculine penthemimeral
ἡμέας αἰσχύνων· ἐθέλοις δέ κε μῶμον ἀνάψαι.	-uu --- uu- u u -u u--	dactylic hexameter	masculine penthemimeral, hepthemimeral
σοὶ δ’οὔ τι μνηστῆρες Ἀχαιῶν αἴτιοί εἰσιν,	- - - --u u-- -uu --	dactylic hexameter	feminine penthemimeral, trithemimeral
ἀλλὰ φίλη μήτηρ, ἥ τοι πέρι κέρδεα οἶδεν.	-u u- -- - - uu -uu --	dactylic hexameter	masculine penthemimeral, hepthemimeral, trithemimeral
ἤδη γὰρ τρίτον ἐστὶν ἔτος, τάχα δ’εἶσι τέταρτον,	-- - uu -u u- uu -u u--	dactylic hexameter	feminine penthemimeral, hepthemimeral, trithemimeral
ἐξ οὗ ἀτέμβει θυμὸν ἐνὶ στήθεσσιν Ἀχαιῶν.	- u u-- -u u- --u u--	dactylic hexameter	feminine penthemimeral, hepthemimeral
πάντας μέν ῥ’ἔλπει καὶ ὑπίσχεται ἀνδρὶ ἑκάστῳ	-- - -- u u-uu -u u--	dactylic hexameter	masculine penthemimeral, trithemimeral
ἀγγελίας προϊεῖσα, νόος δέ οἱ ἄλλα μενοινᾷ.	-uu- uu-u u- u u -u u--	dactylic hexameter	feminine penthemimeral, hepthemimeral, trithemimeral
ἡ δὲ δόλον τόνδ’ ἄλλον ἐνὶ φρεσὶ μερμήριξε·	- u u- - -u u- uu ----	dactylic hexameter	feminine penthemimeral, hepthemimeral, trithemimeral
στησαμένη μέγαν ἱστὸν ἐνὶ μεγάροισιν ὕφαινε,	-uu- uu -u u- uu-u u--	dactylic hexameter	feminine penthemimeral, hepthemimeral, trithemimeral
λεπτὸν καὶ περίμετρον· ἄφαρ δ’ἡμῖν μετέειπε·	-- - uu-u u- -- uu--	dactylic hexameter	feminine penthemimeral, hepthemimeral, trithemimeral
’κοῦροι ἐμοὶ μνηστῆρες, ἐπεὶ θάνε δῖος Ὀδυσσεύς,	-u u- --u u- uu -u u--	dactylic hexameter	feminine penthemimeral, hepthemimeral, trithemimeral
μίμνετ’ ἐπειγόμενοι τὸν ἐμὸν γάμον, εἰς ὅ κε φᾶρος	-u u-uu- u u- uu - u u --	dactylic hexameter	masculine penthemimeral, hepthemimeral
ἐκτελέσω, μή μοι μεταμώνια νήματ’ ὄληται,	-uu- - - uu-uu -u u--	dactylic hexameter	masculine penthemimeral, trithemimeral
Λαέρτῃ ἥρωι ταφήιον, εἰς ὅτε κέν μιν	--- --u u-uu - uu - -	dactylic hexameter	feminine penthemimeral, trithemimeral
μοῖρ’ ὀλοὴ καθέλῃσι τανηλεγέος θανάτοιο,	- uu- uu-u u-uu- uu--	dactylic hexameter	feminine penthemimeral, trithemimeral
μή τίς μοι κατὰ δῆμον Ἀχαιϊάδων νεμεσήσῃ.	- - - uu -u u-uu- uu--	dactylic hexameter	feminine penthemimeral, trithemimeral
αἴ κεν ἄτερ σπείρου κεῖται πολλὰ κτεατίσσασ’.	- u u- -- -- -- uu--	dactylic hexameter	masculine penthemimeral, hepthemimeral, trithemimeral
ὣς ἔφαθ’, ἡμῖν δ’αὖτ’ ἐπεπείθετο θυμὸς ἀγήνωρ.	- uu -- - uu-uu -u u--	dactylic hexameter	masculine penthemimeral
ἔνθα καὶ ἠματίη μὲν ὑφαίνεσκεν μέγαν ἱστόν,	-u u -uu- u u--- uu --	dactylic hexameter	masculine penthemimeral
νύκτας δ’ἀλλύεσκεν, ἐπεὶ δαΐδας παραθεῖτο.	-- ---u u- uu- uu--	dactylic hexameter	feminine penthemimeral, hepthemimeral
ὣς τρίετες μὲν ἔληθε δόλῳ καὶ ἔπειθεν Ἀχαιούς·	- uu- u u-u u- u u-u u--	dactylic hexameter	feminine penthemimeral, hepthemimeral, trithemimeral
ἀλλ’ ὅτε τέτρατον ἦλθεν ἔτος καὶ ἐπήλυθον ὧραι,	- uu -uu -u u- u u-uu --	dactylic hexameter	feminine penthemimeral, hepthemimeral
καὶ τότε δή τις ἔειπε γυναικῶν, ἣ σάφα ᾔδη,	- uu - u u-u u-- - uu --	dactylic hexameter	feminine penthemimeral, trithemimeral
καὶ τήν γ’ἀλλύουσαν ἐφεύρομεν ἀγλαὸν ἱστόν.	- - ---u u-uu -uu --	dactylic hexameter	feminine penthemimeral
ὣς τὸ μὲν ἐξετέλεσσε καὶ οὐκ ἐθέλουσ’ ὑπ’ ἀνάγκης·	- u u -uu-u u - uu- u u--	dactylic hexameter	feminine penthemimeral, hepthemimeral
σοὶ δ’ὧδε μνηστῆρες ὑποκρίνονται, ἵν’ εἰδῇς	- -- --u u---u u --	dactylic hexameter	feminine penthemimeral, trithemimeral
αὐτὸς σῷ θυμῷ, εἰδῶσι δὲ πάντες Ἀχαιοί·	-- - -- --u u -u u--	dactylic hexameter	masculine penthemimeral, trithemimeral
μητέρα σὴν ἀπόπεμψον, ἄνωχθι δέ μιν γαμέεσθαι	-uu - uu-u u-u u - uu--	dactylic hexameter	feminine penthemimeral, trithemimeral
τῷ ὅτεᾐ τε πατὴρ κέλεται καὶ ἁνδάνει αὐτῇ.	- uu- u u- uu- - -uu --	dactylic hexameter	masculine penthemimeral, hepthemimeral, trithemimeral
εἰ δ’ἔτ’ ἀνιήσει γε πολὺν χρόνον υἷας Ἀχαιῶν,	- u u--- u u- uu -u u--	dactylic hexameter	masculine penthemimeral, hepthemimeral
τὰ φρονέουσ’ ἀνὰ θυμόν, ὅ οἱ πέρι δῶκεν Ἀθήνη	- uu- uu -u u - uu -u u--	dactylic hexameter	feminine penthemimeral, hepthemimeral, trithemimeral
ἔργα τ’ἐπίστασθαι περικαλλέα καὶ φρένας ἐσθλὰς	-u u--- uu-uu - uu --	dactylic hexameter	masculine penthemimeral
κέρδεά θ’,οἷ’ οὔ πώ τιν’ ἀκούομεν οὐδὲ παλαιῶν,	-uu - - - u u-uu -u u--	dactylic hexameter	masculine penthemimeral, trithemimeral
τάων αἳ πάρος ἦσαν ἐυπλοκαμῖδες Ἀχαιαί,	-- - uu -u u-uu-u u--	dactylic hexameter	feminine penthemimeral, trithemimeral
Τυρώ τ’Ἀλκμήνη τε ἐυστέφανός τε Μυκήνη·	-- --- u u-uu- u u--	dactylic hexameter	masculine penthemimeral
τάων οὔ τις ὁμοῖα νοήματα Πηνελοπείῃ	-- - u u-u u-uu -uu--	dactylic hexameter	feminine penthemimeral, trithemimeral
ᾔδη· ἀτὰρ μὲν τοῦτό γ’ ἐναίσιμον οὐκ ἐνόησε.	-u u- - -u u-uu - uu--	dactylic hexameter	feminine penthemimeral, trithemimeral
τόφρα γὰρ οὖν βίοτόν τε τεὸν καὶ κτήματ’ ἔδονται,	-u u - uu- u u- - -u u--	dactylic hexameter	masculine penthemimeral, hepthemimeral, trithemimeral
ὄφρα κε κείνη τοῦτον ἔχῃ νόον, ὅν τινά οἱ νῦν	-u u -- -u u- uu - uu - -	dactylic hexameter	feminine penthemimeral, hepthemimeral
ἐν στήθεσσι τιθεῖσι θεοί. μέγα μὲν κλέος αὐτῇ	- --u u-u u- uu - uu --	dactylic hexameter	feminine penthemimeral, hepthemimeral
ποιεῖτ’, αὐτὰρ σοί γε ποθὴν πολέος βιότοιο.	-- -- - u u- uu- uu--	dactylic hexameter	masculine penthemimeral, hepthemimeral
ἡμεῖς δ’οὔτ’ ἐπὶ ἔργα πάρος γ’ἴμεν οὔτε πῃ ἄλλῃ,	-- - uu -u u- uu -u u --	dactylic hexameter	feminine penthemimeral, hepthemimeral, trithemimeral
πρίν γ’αὐτὴν γήμασθαι Ἀχαιῶν ᾧ κ’ἐθέλῃσι.	- -- --u u-- - uu--	dactylic hexameter	feminine penthemimeral, trithemimeral
τὸν δ’αὖ Τηλέμαχος πεπνυμένος ἀντίον ηὔδα·	- - -uu- --uu -uu --	dactylic hexameter	masculine penthemimeral
Ἀντίνο’, οὔ πως ἔστι δόμων ἀέκουσαν ἀπῶσαι	-uu - - -u u- uu-u u--	dactylic hexameter	feminine penthemimeral, hepthemimeral, trithemimeral
ἥ μ’ἔτεχ’, ἥ μ’ἔθρεψε· πατὴρ δ’ἐμὸς ἄλλοθι γαίης,	- uu - --u u- uu -uu --	dactylic hexameter	feminine penthemimeral, hepthemimeral, trithemimeral
ζώει ὅ γ’ἦ τέθνηκε· κακὸν δέ με πόλλ’ ἀποτίνειν	-u u - --u u- u u - uu--	dactylic hexameter	feminine penthemimeral, hepthemimeral, trithemimeral
Ἰκαρίῳ, αἴ κ’αὐτὸς ἑκὼν ἀπὸ μητέρα πέμψω.	-uu- - -u u- uu -uu --	dactylic hexameter	feminine penthemimeral, hepthemimeral, trithemimeral
ἐκ γὰρ τοῦ πατρὸς κακὰ πείσομαι, ἄλλα δὲ δαίμων	- - - -- uu -uu -u u --	dactylic hexameter	masculine penthemimeral, trithemimeral
δώσει, ἐπεὶ μήτηρ στυγερὰς ἀρήσετ’ ἐρινῦς	-u u- -- uu- --u u--	dactylic hexameter	masculine penthemimeral, hepthemimeral, trithemimeral
οἴκου ἀπερχομένη· νέμεσις δέ μοι ἐξ ἀνθρώπων	-u u-uu- uu- u u - ---	dactylic hexameter	masculine penthemimeral, hepthemimeral
ἔσσεται· ὣς οὐ τοῦτον ἐγώ ποτε μῦθον ἐνίψω.	-uu - - -u u- uu -u u--	dactylic hexameter	feminine penthemimeral, hepthemimeral, trithemimeral
ὑμέτερος δ’εἰ μὲν θυμὸς νεμεσίζεται αὐτῶν,	-uu- - - -- uu-uu --	dactylic hexameter	masculine penthemimeral, hepthemimeral, trithemimeral
ἔξιτέ μοι μεγάρων, ἄλλας δ’ἀλεγύνετε δαῖτας	-uu - uu- -- uu-uu --	dactylic hexameter	masculine penthemimeral, hepthemimeral, trithemimeral
ὑμὰ κτήματ’ ἔδοντες ἀμειβόμενοι κατὰ οἴκους.	-- -u u-u u-uu- uu --	dactylic hexameter	feminine penthemimeral
εἰ δ’ὑμῖν δοκέει τόδε λωίτερον καὶ ἄμεινον	- -- uu- uu -uu- u u--	dactylic hexameter	masculine penthemimeral, trithemimeral
ἔμμεναι, ἀνδρὸς ἑνὸς βίοτον νήποινον ὀλέσθαι,	-uu -u u- uu- --u u--	dactylic hexameter	masculine penthemimeral, hepthemimeral
κείρετ’· ἐγὼ δὲ θεοὺς ἐπιβώσομαι αἰὲν ἐόντας,	-u u- u u- uu-uu -u u--	dactylic hexameter	masculine penthemimeral, trithemimeral
αἴ κέ ποθι Ζεὺς δῷσι παλίντιτα ἔργα γενέσθαι.	- u u- - -u u-uu -u u--	dactylic hexameter	feminine penthemimeral, trithemimeral
νήποινοί κεν ἔπειτα δόμων ἔντοσθεν ὄλοισθε.	--- u u-u u- --u u--	dactylic hexameter	feminine penthemimeral, hepthemimeral, trithemimeral
ὣς φάτο Τηλέμαχος, τῷ δ’αἰετὼ εὐρύοπα Ζεὺς	- uu -uu- - -uu -uu- -	dactylic hexameter	masculine penthemimeral
ὑψόθεν ἐκ κορυφῆς ὄρεος προέηκε πέτεσθαι.	-uu - uu- uu- uu-u u--	dactylic hexameter	masculine penthemimeral, hepthemimeral, trithemimeral
τὼ δ’ἕως μέν ῥ’ἐπέτοντο μετὰ πνοιῇς ἀνέμοιο	- - - uu-u u- -- uu--	dactylic hexameter	feminine penthemimeral, hepthemimeral, trithemimeral
πλησίω ἀλλήλοισι τιταινομένω πτερύγεσσιν·	-uu ---u u-uu- uu--	dactylic hexameter	feminine penthemimeral
ἀλλ’ ὅτε δὴ μέσσην ἀγορὴν πολύφημον ἱκέσθην,	- uu - -- uu- uu-u u--	dactylic hexameter	masculine penthemimeral, hepthemimeral, trithemimeral
ἔνθ’ ἐπιδινηθέντε τιναξάσθην πτερὰ πυκνά,	- uu---u u--- uu --	dactylic hexameter	feminine penthemimeral
ἐς δ’ἰδέτην πάντων κεφαλάς, ὄσσοντο δ’ὄλεθρον·	- uu- -- uu- --u u--	dactylic hexameter	masculine penthemimeral, hepthemimeral, trithemimeral
δρυψαμένω δ’ὀνύχεσσι παρειὰς ἀμφί τε δειρὰς	-uu- uu-u u-- -u u --	dactylic hexameter	feminine penthemimeral, trithemimeral
δεξιὼ ἤιξαν διά τ’οἰκία καὶ πόλιν αὐτῶν.	-uu --- uu -uu - uu --	dactylic hexameter	masculine penthemimeral
θάμβησαν δ’ὄρνιθας, ἐπεὶ ἴδον ὀφθαλμοῖσιν·	--- --u u- uu ----	dactylic hexameter	feminine penthemimeral, hepthemimeral, trithemimeral
ὥρμηναν δ’ἀνὰ θυμὸν ἅ περ τελέεσθαι ἔμελλον.	--- uu -u u - uu-u u--	dactylic hexameter	feminine penthemimeral, hepthemimeral, trithemimeral
τοῖσι δὲ καὶ μετέειπε γέρων ἥρως Ἁλιθέρσης	-u u - uu-u u- -- uu--	dactylic hexameter	feminine penthemimeral, hepthemimeral, trithemimeral
Μαστορίδης· ὁ γὰρ οἶος ὁμηλικίην ἐκέκαστο	-uu- u u -u u-uu- uu--	dactylic hexameter	feminine penthemimeral, trithemimeral
ὄρνιθας γνῶναι καὶ ἐναίσιμα μυθήσασθαι·	--- -- u u-uu ----	dactylic hexameter	masculine penthemimeral, trithemimeral
ὅ σφιν ἐὺ φρονέων ἀγορήσατο καὶ μετέειπε·	- u u- uu- uu-uu - uu--	dactylic hexameter	masculine penthemimeral, trithemimeral
κέκλυτε δὴ νῦν μευ, Ἰθακήσιοι, ὅττι κεν εἴπω·	-uu - - - uu-uu -u u --	dactylic hexameter	masculine penthemimeral, trithemimeral
μνηστῆρσιν δὲ μάλιστα πιφαυσκόμενος τάδε εἴρω·	--- u u-u u-uu- uu --	dactylic hexameter	feminine penthemimeral, trithemimeral
τοῖσιν γὰρ μέγα πῆμα κυλίνδεται· οὐ γὰρ Ὀδυσσεὺς	-- - uu -u u-uu - u u--	dactylic hexameter	feminine penthemimeral, trithemimeral
δὴν ἀπάνευθε φίλων ὧν ἔσσεται, ἀλλά που ἤδη	- uu-u u- - -uu -u u --	dactylic hexameter	masculine penthemimeral
ἐγγὺς ἐὼν τοῖσδεσσι φόνον καὶ κῆρα φυτεύει	-u u- --u u- - -u u--	dactylic hexameter	feminine penthemimeral, hepthemimeral, trithemimeral
πάντεσσιν· πολέσιν δὲ καὶ ἄλλοισιν κακὸν ἔσται,	--- uu- u u --- uu --	dactylic hexameter	masculine penthemimeral, trithemimeral
οἳ νεμόμεσθ’ Ἰθάκην ἐυδείελον. ἀλλὰ πολὺ πρὶν	- uu- uu- uu-uu -u u- -	dactylic hexameter	masculine penthemimeral, trithemimeral
φραζώμεσθ’, ὥς κεν καταπαύσομεν· οἱ δὲ καὶ αὐτοὶ	--- - - uu-uu - u u --	dactylic hexameter	masculine penthemimeral, trithemimeral
παυέσθων· καὶ γάρ σφιν ἄφαρ τόδε λώιόν ἐστιν.	--- - - u u- uu -uu --	dactylic hexameter	masculine penthemimeral, hepthemimeral, trithemimeral
οὐ γὰρ ἀπείρητος μαντεύομαι, ἀλλ’ ἐὺ εἰδώς·	- u u--- --uu - uu --	dactylic hexameter	masculine penthemimeral
καὶ γὰρ κείνῳ φημὶ τελευτηθῆναι ἅπαντα,	- - -- -u u---u u--	dactylic hexameter	feminine penthemimeral
ὥς οἱ ἐμυθεόμην, ὅτε Ἴλιον εἰσανέβαινον	- u u-uu- uu -uu -uu--	dactylic hexameter	masculine penthemimeral
Ἀργεῖοι, μετὰ δέ σφιν ἔβη πολύμητις Ὀδυσσεύς.	--- uu - u u- uu-u u--	dactylic hexameter	masculine penthemimeral, hepthemimeral, trithemimeral
φῆν κακὰ πολλὰ παθόντ’, ὀλέσαντ’ ἄπο πάντας ἑταίρους,	- uu -u u- uu- uu -u u--	dactylic hexameter	masculine penthemimeral, hepthemimeral
ἄγνωστον πάντεσσιν ἐεικοστῷ ἐνιαυτῷ	--- --u u--- uu--	dactylic hexameter	feminine penthemimeral, trithemimeral
οἴκαδ’ ἐλεύσεσθαι· τὰ δὲ δὴ νῦν πάντα τελεῖται.	-u u--- u u - - -u u--	dactylic hexameter	masculine penthemimeral, hepthemimeral
τὸν δ’αὖτ’ Εὐρύμαχος Πολύβου πάϊς ἀντίον ηὔδα·	- - -uu- uu- uu -uu --	dactylic hexameter	masculine penthemimeral, hepthemimeral
ὦ γέρον, εἰ δ’ἄγε νῦν μαντεύεο σοῖσι τέκεσσιν	- uu - uu - --uu -u u--	dactylic hexameter	masculine penthemimeral, trithemimeral
οἴκαδ’ ἰών, μή πού τι κακὸν πάσχωσιν ὀπίσσω·	-u u- - - u u- --u u--	dactylic hexameter	masculine penthemimeral, hepthemimeral, trithemimeral
ταῦτα δ’ἐγὼ σέο πολλὸν ἀμείνων μαντεύεσθαι.	-u u- uu -u u-- ----	dactylic hexameter	feminine penthemimeral, trithemimeral
ὄρνιθες δέ τε πολλοὶ ὑπ’ αὐγὰς ἠελίοιο	--- u u -u u -- -uu--	dactylic hexameter	feminine penthemimeral, trithemimeral
φοιτῶσ’, οὐδέ τε πάντες ἐναίσιμοι· αὐτὰρ Ὀδυσσεὺς	-- -u u -u u-uu -u u--	dactylic hexameter	feminine penthemimeral
ὤλετο τῆλ’, ὡς καὶ σὺ καταφθίσθαι σὺν ἐκείνῳ	-uu - - - u u--- u u--	dactylic hexameter	masculine penthemimeral, trithemimeral
ὤφελες. οὐκ ἂν τόσσα θεοπροπέων ἀγόρευες,	-uu - - -u u-uu- uu--	dactylic hexameter	feminine penthemimeral, trithemimeral
οὐδέ κε Τηλέμαχον κεχολωμένον ὧδ’ ἀνιείης,	-u u -uu- uu-uu - uu--	dactylic hexameter	masculine penthemimeral
σῷ οἴκῳ δῶρον ποτιδέγμενος, αἴ κε πόρῃσιν.	- -- -- uu-uu - u u--	dactylic hexameter	masculine penthemimeral, trithemimeral
ἀλλ’ ἔκ τοι ἐρέω, τὸ δὲ καὶ τετελεσμένον ἔσται·	- - - uu- u u - uu-uu --	dactylic hexameter	masculine penthemimeral, hepthemimeral, trithemimeral
αἴ κε νεώτερον ἄνδρα παλαιά τε πολλά τε εἰδὼς	- u u-uu -u u-u u -u u --	dactylic hexameter	feminine penthemimeral
παρφάμενος ἐπέεσσιν ἐποτρύνῃς χαλεπαίνειν,	-uu- uu-u u--- uu--	dactylic hexameter	feminine penthemimeral, trithemimeral
αὐτῷ μέν οἱ πρῶτον ἀνιηρέστερον ἔσται,	-- - - -u u---uu --	dactylic hexameter	feminine penthemimeral, trithemimeral
πρῆξαι δ’ἔμπης οὔ τι δυνήσεται εἵνεκα τῶνδε·	-- -- - u u-uu -uu --	dactylic hexameter	masculine penthemimeral
σοὶ δέ, γέρον, θωὴν ἐπιθήσομεν, ἥν κ’ἐνὶ θυμῷ	- u u- -- uu-uu - uu --	dactylic hexameter	masculine penthemimeral, trithemimeral
τίνων ἀσχάλλῃς· χαλεπὸν δέ τοι ἔσσεται ἄλγος.	-- --- uu- u u -uu --	dactylic hexameter	masculine penthemimeral, hepthemimeral
Τηλεμάχῳ δ’ἐν πᾶσιν ἐγὼν ὑποθήσομαι αὐτός·	-uu- - -u u- uu-uu --	dactylic hexameter	feminine penthemimeral, hepthemimeral, trithemimeral
μητέρα ἣν ἐς πατρὸς ἀνωγέτω ἀπονέεσθαι·	-uu - - -u u-uu -uu--	dactylic hexameter	feminine penthemimeral, trithemimeral
οἱ δὲ γάμον τεύξουσι καὶ ἀρτυνέουσιν ἔεδνα	- u u- --u u -uu-u u--	dactylic hexameter	feminine penthemimeral, trithemimeral
πολλὰ μάλ’, ὅσσα ἔοικε φίλης ἐπὶ παιδὸς ἕπεσθαι.	-u u -u u-u u- uu -u u--	dactylic hexameter	feminine penthemimeral, hepthemimeral
οὐ γὰρ πρὶν παύσεσθαι ὀίομαι υἷας Ἀχαιῶν	- - - --u u-uu -u u--	dactylic hexameter	feminine penthemimeral, trithemimeral
μνηστύος ἀργαλέης, ἐπεὶ οὔ τινα δείδιμεν ἔμπης,	-uu -uu- uu - uu -uu --	dactylic hexameter	masculine penthemimeral, hepthemimeral
οὔτ’ οὖν Τηλέμαχον μάλα περ πολύμυθον ἐόντα,	- - -uu- uu - uu-u u--	dactylic hexameter	masculine penthemimeral, hepthemimeral
οὔτε θεοπροπίης ἐμπαζόμεθ’, ἣν σύ, γεραιέ,	-u u-uu- --uu - u u--	dactylic hexameter	masculine penthemimeral
μυθέαι ἀκράαντον, ἀπεχθάνεαι δ’ἔτι μᾶλλον.	-uu ---u u-uu- uu --	dactylic hexameter	feminine penthemimeral
χρήματα δ’αὖτε κακῶς βεβρώσεται, οὐδέ ποτ’ ἶσα	-uu -u u- --uu -u u --	dactylic hexameter	masculine penthemimeral
ἔσσεται, ὄφρα κεν ἥ γε διατρίβῃσιν Ἀχαιοὺς	-uu -u u - u u---u u--	dactylic hexameter	masculine penthemimeral
ὃν γάμον· ἡμεῖς δ’αὖ ποτιδέγμενοι ἤματα πάντα	- uu -- - uu-uu -uu --	dactylic hexameter	masculine penthemimeral
εἵνεκα τῆς ἀρετῆς ἐριδαίνομεν, οὐδὲ μετ’ ἄλλας	-uu - uu- uu-uu -u u --	dactylic hexameter	masculine penthemimeral, trithemimeral
ἐρχόμεθ’, ἃς ἐπιεικὲς ὀπυιέμεν ἐστὶν ἑκάστῳ.	-uu - uu-u u-uu -u u--	dactylic hexameter	feminine penthemimeral, trithemimeral
τὸν δ’αὖ Τηλέμαχος πεπνυμένος ἀντίον ηὔδα·	- - -uu- --uu -uu --	dactylic hexameter	masculine penthemimeral
Εὐρύμαχ’ ἠδὲ καὶ ἄλλοι, ὅσοι μνηστῆρες ἀγαυοί,	-uu -u u -u u- --u u--	dactylic hexameter	feminine penthemimeral, hepthemimeral
ταῦτα μὲν οὐχ ὑμέας ἔτι λίσσομαι οὐδ’ ἀγορεύω·	-u u - uu- uu -uu - uu--	dactylic hexameter	masculine penthemimeral, trithemimeral
ἤδη γὰρ τὰ ἴσασι θεοὶ καὶ πάντες Ἀχαιοί.	-- - u u-u u- - -u u--	dactylic hexameter	feminine penthemimeral, hepthemimeral, trithemimeral
ἀλλ’ ἄγε μοι δότε νῆα θοὴν καὶ εἴκοσ’ ἑταίρους,	- uu - uu -u u- - -u u--	dactylic hexameter	feminine penthemimeral, hepthemimeral, trithemimeral
οἵ κέ μοι ἔνθα καὶ ἔνθα διαπρήσσωσι κέλευθον.	- u u -u u -u u---u u--	dactylic hexameter	feminine penthemimeral
εἶμι γὰρ ἐς Σπάρτην τε καὶ ἐς Πύλον ἠμαθόεντα	-u u - -- u u - uu -uu--	dactylic hexameter	masculine penthemimeral, hepthemimeral, trithemimeral
νόστον πευσόμενος πατρὸς δὴν οἰχομένοιο,	-- -uu- -- - -uu--	dactylic hexameter	masculine penthemimeral, hepthemimeral
ἤν τίς μοι εἴπῃσι βροτῶν ἢ ὄσσαν ἀκούσω	- - - --u u- - -u u--	dactylic hexameter	feminine penthemimeral, hepthemimeral, trithemimeral
ἐκ Διός, ἥ τε μάλιστα φέρει κλέος ἀνθρώποισιν·	- uu - u u-u u- uu ----	dactylic hexameter	feminine penthemimeral, hepthemimeral, trithemimeral
εἰ μέν κεν πατρὸς βίοτον καὶ νόστον ἀκούσω,	- - - -- uu- - -u u--	dactylic hexameter	masculine penthemimeral, hepthemimeral, trithemimeral
ἦ τ’ἄν, τρυχόμενός περ, ἔτι τλαίην ἐνιαυτόν·	- - -uu- u u- -- uu--	dactylic hexameter	masculine penthemimeral, hepthemimeral
εἰ δέ κε τεθνηῶτος ἀκούσω μηδ’ ἔτ’ ἐόντος,	- u u ---u u-- - u u--	dactylic hexameter	feminine penthemimeral
νοστήσας δὴ ἔπειτα φίλην ἐς πατρίδα γαῖαν	--- u u-u u- - -uu --	dactylic hexameter	feminine penthemimeral, hepthemimeral, trithemimeral
σῆμά τέ οἱ χεύω καὶ ἐπὶ κτέρεα κτερεΐξω	-u u - -- u u- uu- uu--	dactylic hexameter	masculine penthemimeral, hepthemimeral, trithemimeral
πολλὰ μάλ’, ὅσσα ἔοικε, καὶ ἀνέρι μητέρα δώσω.	-u u -u u-u u -uu -uu --	dactylic hexameter	feminine penthemimeral
ἦ τοι ὅ γ’ὣς εἰπὼν κατ’ ἄρ’ ἕζετο, τοῖσι δ’ἀνέστη	- u u - -- u u -uu -u u--	dactylic hexameter	masculine penthemimeral, trithemimeral
Μέντωρ, ὅς ῥ’Ὀδυσῆος ἀμύμονος ἦεν ἑταῖρος,	-- - uu-u u-uu -u u--	dactylic hexameter	feminine penthemimeral, trithemimeral
καὶ οἱ ἰὼν ἐν νηυσὶν ἐπέτρεπεν οἶκον ἅπαντα,	- u u- - -u u-uu -u u--	dactylic hexameter	feminine penthemimeral, trithemimeral
πείθεσθαί τε γέροντι καὶ ἔμπεδα πάντα φυλάσσειν·	--- u u-u u -uu -u u--	dactylic hexameter	feminine penthemimeral, trithemimeral
ὅ σφιν ἐὺ φρονέων ἀγορήσατο καὶ μετέειπεν·	- u u- uu- uu-uu - uu--	dactylic hexameter	masculine penthemimeral, trithemimeral
κέκλυτε δὴ νῦν μευ, Ἰθακήσιοι, ὅττι κεν εἴπω·	-uu - - - uu-uu -u u --	dactylic hexameter	masculine penthemimeral, trithemimeral
μή τις ἔτι πρόφρων ἀγανὸς καὶ ἤπιος ἔστω	- u u- -- uu- - -uu --	dactylic hexameter	masculine penthemimeral, hepthemimeral, trithemimeral
σκηπτοῦχος βασιλεύς, μηδὲ φρεσὶν αἴσιμα εἰδώς,	--- uu- -- uu -uu --	dactylic hexameter	masculine penthemimeral, hepthemimeral, trithemimeral
ἀλλ’ αἰεὶ χαλεπός τ’εἴη καὶ αἴσυλα ῥέζοι·	- -- uu- -- - -uu --	dactylic hexameter	masculine penthemimeral, hepthemimeral, trithemimeral
ὡς οὔ τις μέμνηται Ὀδυσσῆος θείοιο	- - - --u u--- ---	dactylic hexameter	feminine penthemimeral, trithemimeral
λαῶν οἷσιν ἄνασσε, πατὴρ δ’ὣς ἤπιος ἦεν.	-- -u u-u u- - -uu --	dactylic hexameter	feminine penthemimeral, hepthemimeral
ἀλλ’ ἦ τοι μνηστῆρας ἀγήνορας οὔ τι μεγαίρω	- - - --u u-uu - u u--	dactylic hexameter	feminine penthemimeral, trithemimeral
ἔρδειν ἔργα βίαια κακορραφίῃσι νόοιο·	-- -u u-u u-uu-u u--	dactylic hexameter	feminine penthemimeral
σφὰς γὰρ παρθέμενοι κεφαλὰς κατέδουσι βιαίως	- - -uu- uu- uu-u u--	dactylic hexameter	masculine penthemimeral, hepthemimeral
οἶκον Ὀδυσσῆος, τὸν δ’οὐκέτι φασὶ νέεσθαι.	-u u--- - -uu -u u--	dactylic hexameter	masculine penthemimeral
νῦν δ’ἄλλῳ δήμῳ νεμεσίζομαι, οἷον ἅπαντες	- -- -- uu-uu -u u--	dactylic hexameter	masculine penthemimeral, trithemimeral
ἧσθ’ ἄνεῳ, ἀτὰρ οὔ τι καθαπτόμενοι ἐπέεσσι	- uu- uu - u u-uu- uu--	dactylic hexameter	masculine penthemimeral, trithemimeral
παύρους μνηστῆρας καταπαύετε πολλοὶ ἐόντες.	-- --- uu-uu -u u--	dactylic hexameter	masculine penthemimeral
τὸν δ’Εὐηνορίδης Λειώκριτος ἀντίον ηὔδα·	- --uu- --uu -uu --	dactylic hexameter	masculine penthemimeral
Μέντορ ἀταρτηρέ, φρένας ἠλεέ, ποῖον ἔειπες	-u u--- uu -uu -u u--	dactylic hexameter	masculine penthemimeral
ἡμέας ὀτρύνων καταπαυέμεν. ἀργαλέον δὲ	-uu --- uu-uu -uu- -	dactylic hexameter	masculine penthemimeral
ἀνδράσι καὶ πλεόνεσσι μαχήσασθαι περὶ δαιτί.	-uu - uu-u u--- uu --	dactylic hexameter	feminine penthemimeral, trithemimeral
εἴ περ γάρ κ’Ὀδυσεὺς Ἰθακήσιος αὐτὸς ἐπελθὼν	- - - uu- uu-uu -u u--	dactylic hexameter	masculine penthemimeral, trithemimeral
δαινυμένους κατὰ δῶμα ἑὸν μνηστῆρας ἀγαυοὺς	-uu- uu -u u- --u u--	dactylic hexameter	feminine penthemimeral, hepthemimeral, trithemimeral
ἐξελάσαι μεγάροιο μενοινήσει’ ἐνὶ θυμῷ,	-uu- uu-u u--- uu --	dactylic hexameter	feminine penthemimeral, trithemimeral
οὔ κέν οἱ κεχάροιτο γυνή, μάλα περ χατέουσα,	- - - uu-u u- uu - uu--	dactylic hexameter	feminine penthemimeral, hepthemimeral, trithemimeral
ἐλθόντ’, ἀλλά κεν αὐτοῦ ἀεικέα πότμον ἐπίσποι,	-- -u u -u u-uu -u u--	dactylic hexameter	feminine penthemimeral
εἰ πλεόνεσσι μάχοιτο· σὺ δ’οὐ κατὰ μοῖραν ἔειπες.	- uu-u u-u u - uu -u u--	dactylic hexameter	feminine penthemimeral, hepthemimeral
ἀλλ’ ἄγε, λαοὶ μὲν σκίδνασθ’ ἐπὶ ἔργα ἕκαστος,	- uu -- - -- uu -u u--	dactylic hexameter	masculine penthemimeral, hepthemimeral
τούτῳ δ’ὀτρυνέει Μέντωρ ὁδὸν ἠδ’ Ἁλιθέρσης,	-- -uu- -- uu - uu--	dactylic hexameter	masculine penthemimeral, hepthemimeral
οἵ τέ οἱ ἐξ ἀρχῆς πατρώιοί εἰσιν ἑταῖροι.	- u u - -- --uu -u u--	dactylic hexameter	masculine penthemimeral, trithemimeral
ἀλλ’ ὀίω, καὶ δηθὰ καθήμενος ἀγγελιάων	- uu- - -u u-uu -uu--	dactylic hexameter	feminine penthemimeral, trithemimeral
πεύσεται εἰν Ἰθάκῃ, τελέει δ’ὁδὸν οὔ ποτε ταύτην.	-uu - uu- uu- uu - uu --	dactylic hexameter	masculine penthemimeral, hepthemimeral, trithemimeral
ὣς ἄρ’ ἐφώνησεν, λῦσεν δ’ἀγορὴν αἰψηρήν.	- u u--- -- uu- ---	dactylic hexameter	masculine penthemimeral, hepthemimeral
οἱ μὲν ἄρ’ ἐσκίδναντο ἑὰ πρὸς δώμαθ’ ἕκαστος,	- u u ---u u- - -u u--	dactylic hexameter	feminine penthemimeral, hepthemimeral
μνηστῆρες δ’ἐς δώματ’ ἴσαν θείου Ὀδυσῆος.	--- - -u u- -- uu--	dactylic hexameter	feminine penthemimeral, hepthemimeral, trithemimeral
Τηλέμαχος δ’ἀπάνευθε κιὼν ἐπὶ θῖνα θαλάσσης,	-uu- uu-u u- uu -u u--	dactylic hexameter	feminine penthemimeral, hepthemimeral, trithemimeral
χεῖρας νιψάμενος πολιῆς ἁλὸς εὔχετ’ Ἀθήνῃ·	-- -uu- uu- uu -u u--	dactylic hexameter	masculine penthemimeral, hepthemimeral
κλῦθί μευ, ὃ χθιζὸς θεὸς ἤλυθες ἡμέτερον δῶ	-u u - -- uu -uu -uu- -	dactylic hexameter	masculine penthemimeral, trithemimeral
καὶ μ’ἐν νηὶ κέλευσας ἐπ’ ἠεροειδέα πόντον	- - -u u-u u -uu-uu --	dactylic hexameter	feminine penthemimeral
νόστον πευσόμενον πατρὸς δὴν οἰχομένοιο	-- -uu- -- - -uu--	dactylic hexameter	masculine penthemimeral, hepthemimeral
ἔρχεσθαι· τὰ δὲ πάντα διατρίβουσιν Ἀχαιοί,	--- u u -u u---u u--	dactylic hexameter	feminine penthemimeral, trithemimeral
μνηστῆρες δὲ μάλιστα κακῶς ὑπερηνορέοντες.	--- u u-u u- uu-uu--	dactylic hexameter	feminine penthemimeral, hepthemimeral, trithemimeral
ὣς ἔφατ’ εὐχόμενος, σχεδόθεν δέ οἱ ἦλθεν Ἀθήνη,	- uu -uu- uu- u u -u u--	dactylic hexameter	masculine penthemimeral, hepthemimeral
Μέντορι εἰδομένη ἠμὲν δέμας ἠδὲ καὶ αὐδήν,	-uu -uu- -- uu -u u --	dactylic hexameter	masculine penthemimeral, hepthemimeral
καί μιν φωνήσασ’ ἔπεα πτερόεντα προσηύδα·	- - --- uu- uu-u u--	dactylic hexameter	masculine penthemimeral, hepthemimeral
Τηλέμαχ’, οὐδ’ ὄπιθεν κακὸς ἔσσεαι οὐδ’ ἀνοήμων,	-uu - uu- uu -uu - uu--	dactylic hexameter	masculine penthemimeral, trithemimeral
εἰ δή τοι σοῦ πατρὸς ἐνέστακται μένος ἠύ,	- - - - -u u--- uu --	dactylic hexameter	feminine penthemimeral, trithemimeral
οἷος κεῖνος ἔην τελέσαι ἔργον τε ἔπος τε·	-- -u u- uu- -- u u- -	dactylic hexameter	masculine penthemimeral, hepthemimeral
οὔ τοι ἔπειθ’ ἁλίη ὁδὸς ἔσσεται οὐδ’ ἀτέλεστος.	- u u- uu- uu -uu - uu--	dactylic hexameter	masculine penthemimeral, trithemimeral
εἰ δ’οὐ κείνου γ’ἐσσὶ γόνος καὶ Πηνελοπείης,	- - -- -u u- - -uu--	dactylic hexameter	feminine penthemimeral, hepthemimeral
οὐ σέ γ’ἔπειτα ἔολπα τελευτήσειν, ἃ μενοινᾷς.	- u u-u u-u u--- u u--	dactylic hexameter	feminine penthemimeral
παῦροι γάρ τοι παῖδες ὁμοῖοι πατρὶ πέλονται,	-- - - -u u-- -u u--	dactylic hexameter	feminine penthemimeral, trithemimeral
οἱ πλέονες κακίους, παῦροι δέ τε πατρὸς ἀρείους.	- uu- uu- -- u u -u u--	dactylic hexameter	masculine penthemimeral, hepthemimeral, trithemimeral
ἀλλ’ ἐπεὶ οὐδ’ ὄπιθεν κακὸς ἔσσεαι οὐδ’ ἀνοήμων,	- uu - uu- uu -uu - uu--	dactylic hexameter	masculine penthemimeral, trithemimeral
οὐδέ σε πάγχυ γε μῆτις Ὀδυσσῆος προλέλοιπεν,	-u u -u u -u u--- uu--	dactylic hexameter	feminine penthemimeral
ἐλπωρή τοι ἔπειτα τελευτῆσαι τάδε ἔργα.	--- u u-u u--- uu --	dactylic hexameter	feminine penthemimeral, trithemimeral
τῶ νῦν μνηστήρων μὲν ἔα βουλήν τε νόον τε	- - --- u u- -- u u- -	dactylic hexameter	masculine penthemimeral, hepthemimeral
ἀφραδέων, ἐπεὶ οὔ τι νοήμονες οὐδὲ δίκαιοι·	-uu- uu - u u-uu -u u--	dactylic hexameter	masculine penthemimeral, trithemimeral
οὐδέ τι ἴσασιν θάνατον καὶ κῆρα μέλαιναν,	-u u --- uu- - -u u--	dactylic hexameter	masculine penthemimeral, hepthemimeral
ὃς δή σφι σχεδόν ἐστιν, ἐπ’ ἤματι πάντας ὀλέσθαι.	- - - uu -u u -uu -u u--	dactylic hexameter	feminine penthemimeral, trithemimeral
σοὶ δ’ὁδὸς οὐκέτι δηρὸν ἀπέσσεται ἣν σὺ μενοινᾷς·	- uu -uu -u u-uu - u u--	dactylic hexameter	feminine penthemimeral
τοῖος γάρ τοι ἑταῖρος ἐγὼ πατρώιός εἰμι,	-- - u u-u u- --uu --	dactylic hexameter	feminine penthemimeral, hepthemimeral, trithemimeral
ὅς τοι νῆα θοὴν στελέω καὶ ἅμ’ ἕψομαι αὐτός.	- - -u u- uu- u u -uu --	dactylic hexameter	masculine penthemimeral, hepthemimeral
ἀλλὰ σὺ μὲν πρὸς δώματ’ ἰὼν μνηστῆρσιν ὁμίλει,	-u u - - -u u- --u u--	dactylic hexameter	feminine penthemimeral, hepthemimeral, trithemimeral
ὅπλισσόν τ’ἤια καὶ ἄγγεσιν ἄρσον ἅπαντα,	--- --u u -uu -u u--	dactylic hexameter	feminine penthemimeral, trithemimeral
οἶνον ἐν ἀμφιφορεῦσι, καὶ ἄλφιτα, μυελὸν ἀνδρῶν,	-u u -uu-u u -uu -uu --	dactylic hexameter	feminine penthemimeral
δέρμασιν ἐν πυκινοῖσιν· ἐγὼ δ’ἀνὰ δῆμον ἑταίρους	-uu - uu-u u- uu -u u--	dactylic hexameter	feminine penthemimeral, hepthemimeral, trithemimeral
αἶψ’ ἐθελοντῆρας συλλέξομαι. εἰσὶ δὲ νῆες	- uu--- --uu -u u --	dactylic hexameter	masculine penthemimeral
πολλαὶ ἐν ἀμφιάλῳ Ἰθάκῃ, νέαι ἠδὲ παλαιαί·	-u u -uu- uu- uu -u u--	dactylic hexameter	masculine penthemimeral, hepthemimeral
τάων μέν τοι ἐγὼν ἐπιόψομαι ἥ τις ἀρίστη,	-- - u u- uu-uu - u u--	dactylic hexameter	masculine penthemimeral, trithemimeral
ὦκα δ’ἐφοπλίσσαντες ἐνήσομεν εὐρέι πόντῳ.	-u u---u u-uu -uu --	dactylic hexameter	feminine penthemimeral
ὣς φάτ’ Ἀθηναίη κούρη Διός· οὐδ’ ἄρ’ ἔτι δὴν	- u u--- -- uu - u u- -	dactylic hexameter	masculine penthemimeral, hepthemimeral
Τηλέμαχος παρέμιμνεν, ἐπεὶ θεοῦ ἔκλυεν αὐδήν.	-uu- uu-u u- uu -uu --	dactylic hexameter	feminine penthemimeral, hepthemimeral, trithemimeral
βῆ δ’ἰέναι πρὸς δῶμα, φίλον τετιημένος ἦτορ,	- uu- - -u u- uu-uu --	dactylic hexameter	feminine penthemimeral, hepthemimeral, trithemimeral
εὗρε δ’ἄρα μνηστῆρας ἀγήνορας ἐν μεγάροισιν,	-u u- --u u-uu - uu--	dactylic hexameter	feminine penthemimeral, trithemimeral
αἶγας ἀνιεμένους σιάλους θ’εὕοντας ἐν αὐλῇ.	-u u-uu- uu- --u u --	dactylic hexameter	masculine penthemimeral, hepthemimeral
Ἀντίνοος δ’ἰθὺς γελάσας κίε Τηλεμάχοιο,	-uu- -- uu- uu -uu--	dactylic hexameter	masculine penthemimeral, hepthemimeral, trithemimeral
ἔν τ’ἄρα οἱ φῦ χειρί, ἔπος τ’ἔφατ’ ἔκ τ’ὀνόμαζε·	- uu - - -u u- uu - uu--	dactylic hexameter	feminine penthemimeral, hepthemimeral, trithemimeral
Τηλέμαχ’ ὑψαγόρη, μένος ἄσχετε, μή τί τοι ἄλλο	-uu -uu- uu -uu - u u --	dactylic hexameter	masculine penthemimeral
ἐν στήθεσσι κακὸν μελέτω ἔργον τε ἔπος τε,	- --u u- uu- -- u u- -	dactylic hexameter	masculine penthemimeral, hepthemimeral
ἀλλά μοι ἐσθιέμεν καὶ πινέμεν, ὡς τὸ πάρος περ.	-u u -uu- - -uu - u u- -	dactylic hexameter	masculine penthemimeral
ταῦτα δέ τοι μάλα πάντα τελευτήσουσιν Ἀχαιοί,	-u u - uu -u u---u u--	dactylic hexameter	feminine penthemimeral, trithemimeral
νῆα καὶ ἐξαίτους ἐρέτας, ἵνα θᾶσσον ἵκηαι	-u u --- uu- uu -u u--	dactylic hexameter	masculine penthemimeral, hepthemimeral
ἐς Πύλον ἠγαθέην μετ’ ἀγαυοῦ πατρὸς ἀκουήν.	- uu -uu- u u-- -u u--	dactylic hexameter	masculine penthemimeral
τὸν δ’αὖ Τηλέμαχος πεπνυμένος ἀντίον ηὔδα·	- - -uu- --uu -uu --	dactylic hexameter	masculine penthemimeral
Ἀντίνο’, οὔ πως ἔστιν ὑπερφιάλοισι μεθ’ ὑμῖν	-uu - - -u u-uu-u u --	dactylic hexameter	feminine penthemimeral, trithemimeral
δαίνυσθαί τ’ἀκέοντα καὶ εὐφραίνεσθαι ἕκηλον.	--- uu-u u ---u u--	dactylic hexameter	feminine penthemimeral, trithemimeral
ἦ οὐχ ἅλις ὡς τὸ πάροιθεν ἐκείρετε πολλὰ καὶ ἐσθλὰ	- uu - u u-u u-uu -u u --	dactylic hexameter	feminine penthemimeral, trithemimeral
κτήματ’ ἐμά, μνηστῆρες, ἐγὼ δ’ἔτι νήπιος ἦα;	-u u- --u u- uu -uu --	dactylic hexameter	feminine penthemimeral, hepthemimeral, trithemimeral
νῦν δ’ὅτε δὴ μέγας εἰμὶ καὶ ἄλλων μῦθον ἀκούων	- uu - uu -u u -- -u u--	dactylic hexameter	feminine penthemimeral, trithemimeral
πυνθάνομαι, καὶ δή μοι ἀέξεται ἔνδοθι θυμός,	-uu- - - u u-uu -uu --	dactylic hexameter	masculine penthemimeral, trithemimeral
πειρήσω, ὥς κ’ὔμμι κακὰς ἐπὶ κῆρας ἰήλω,	--- - -u u- uu -u u--	dactylic hexameter	feminine penthemimeral, hepthemimeral, trithemimeral
ἠὲ Πύλονδ’ ἐλθών, ἢ αὐτοῦ τῷδ’ ἐνὶ δήμῳ.	-u u- -- - -- - uu --	dactylic hexameter	masculine penthemimeral, trithemimeral
εἶμι μέν, οὐδ’ ἁλίη ὁδὸς ἔσσεται ἣν ἀγορεύω,	-u u - uu- uu -uu - uu--	dactylic hexameter	masculine penthemimeral, trithemimeral
ἔμπορος· οὐ γὰρ νηὸς ἐπήβολος οὐδ’ ἐρετάων	-uu - - -u u-uu - uu--	dactylic hexameter	feminine penthemimeral, trithemimeral
γίγνομαι· ὥς νύ που ὔμμιν ἐείσατο κέρδιον εἶναι.	-uu - u u -u u-uu -uu --	dactylic hexameter	feminine penthemimeral, trithemimeral
ἦ ῥα, καὶ ἐκ χειρὸς χεῖρα σπάσατ’ Ἀντινόοιο	- u u - -- -- uu -uu--	dactylic hexameter	masculine penthemimeral, hepthemimeral, trithemimeral
ῥεῖα· μνηστῆρες δὲ δόμον κάτα δαῖτα πένοντο.	-- --- u u- uu -u u--	dactylic hexameter	masculine penthemimeral, hepthemimeral
οἱ δ’ἐπελώβευον καὶ ἐκερτόμεον ἐπέεσσιν.	- uu--- u u-uu- uu--	dactylic hexameter	masculine penthemimeral
ὧδε δέ τις εἴπεσκε νέων ὑπερηνορεόντων·	-u u - --u u- uu-uu--	dactylic hexameter	feminine penthemimeral, hepthemimeral, trithemimeral
ἦ μάλα Τηλέμαχος φόνον ἡμῖν μερμηρίζει.	- uu -uu- uu -- ----	dactylic hexameter	masculine penthemimeral
ἤ τινας ἐκ Πύλου ἄξει ἀμύντορας ἠμαθόεντος	- uu - uu -u u-uu -uu--	dactylic hexameter	feminine penthemimeral, trithemimeral
ἢ ὅ γε καὶ Σπάρτηθεν, ἐπεί νύ περ ἵεται αἰνῶς·	- u u - --u u- u u -uu --	dactylic hexameter	feminine penthemimeral, hepthemimeral, trithemimeral
ἠὲ καὶ εἰς Ἐφύρην ἐθέλει, πίειραν ἄρουραν,	-u u - uu- uu- --u u--	dactylic hexameter	masculine penthemimeral, hepthemimeral, trithemimeral
ἐλθεῖν, ὄφρ’ ἔνθεν θυμοφθόρα φάρμακ’ ἐνείκῃ,	-- - -- --uu -u u--	dactylic hexameter	masculine penthemimeral, trithemimeral
ἐν δὲ βάλῃ κρητῆρι καὶ ἡμέας πάντας ὀλέσσῃ.	- u u- --u u -- -u u--	dactylic hexameter	feminine penthemimeral, trithemimeral
ἄλλος δ’αὖτ’ εἴπεσκε νέων ὑπερηνορεόντων·	-- - --u u- uu-uu--	dactylic hexameter	feminine penthemimeral, hepthemimeral, trithemimeral
τίς δ’οἶδ’, εἴ κε καὶ αὐτὸς ἰὼν κοίλης ἐπὶ νηὸς	- - - u u -u u- -- uu --	dactylic hexameter	feminine penthemimeral, hepthemimeral, trithemimeral
τῆλε φίλων ἀπόληται ἀλώμενος ὥς περ Ὀδυσσεύς;	-u u- uu-u u-uu - u u--	dactylic hexameter	feminine penthemimeral, trithemimeral
οὕτω κεν καὶ μᾶλλον ὀφέλλειεν πόνον ἄμμιν·	-- - - -u u--- uu --	dactylic hexameter	feminine penthemimeral, trithemimeral
κτήματα γάρ κεν πάντα δασαίμεθα, οἰκία δ’αὖτε	-uu - - -u u-uu -uu --	dactylic hexameter	feminine penthemimeral, trithemimeral
τούτου μητέρι δοῖμεν ἔχειν ἠδ’ ὅς τις ὀπυίοι.	-- -uu -u u- - - u u--	dactylic hexameter	feminine penthemimeral, hepthemimeral
ὣς φάν, ὁ δ’ὑψόροφον θάλαμον κατεβήσετο πατρὸς	- u u -uu- uu- uu-uu --	dactylic hexameter	masculine penthemimeral, hepthemimeral
εὐρύν, ὅθι νητὸς χρυσὸς καὶ χαλκὸς ἔκειτο	-u u- -- -- - -u u--	dactylic hexameter	masculine penthemimeral, hepthemimeral, trithemimeral
ἐσθής τ’ἐν χηλοῖσιν ἅλις τ’ἐυῶδες ἔλαιον·	-- - --u u- uu-u u--	dactylic hexameter	feminine penthemimeral, hepthemimeral, trithemimeral
ἐν δὲ πίθοι οἴνοιο παλαιοῦ ἡδυπότοιο	- u u- --u u-- -uu--	dactylic hexameter	feminine penthemimeral, trithemimeral
ἕστασαν, ἄκρητον θεῖον ποτὸν ἐντὸς ἔχοντες,	-uu --- -- uu -u u--	dactylic hexameter	masculine penthemimeral, hepthemimeral
ἑξείης ποτὶ τοῖχον ἀρηρότες, εἴ ποτ’ Ὀδυσσεὺς	--- uu -u u-uu - u u--	dactylic hexameter	feminine penthemimeral, trithemimeral
οἴκαδε νοστήσειε καὶ ἄλγεα πολλὰ μογήσας.	-uu ---u u -uu -u u--	dactylic hexameter	feminine penthemimeral
κληισταὶ δ’ἔπεσαν σανίδες πυκινῶς ἀραρυῖαι,	--- uu- uu- uu- uu--	dactylic hexameter	masculine penthemimeral, hepthemimeral, trithemimeral
δικλίδες· ἐν δὲ γυνὴ ταμίη νύκτας τε καὶ ἦμαρ	-uu - u u- uu- -- u u --	dactylic hexameter	masculine penthemimeral, hepthemimeral, trithemimeral
ἔσχ’, ἣ πάντ’ ἐφύλασσε νόου πολυϊδρείῃσιν,	- - - uu-u u- uu----	dactylic hexameter	feminine penthemimeral, hepthemimeral, trithemimeral
Εὐρύκλει’, Ὦπος θυγάτηρ Πεισηνορίδαο.	--- -- uu- --uu--	dactylic hexameter	masculine penthemimeral, hepthemimeral, trithemimeral
τὴν τότε Τηλέμαχος προσέφη θαλαμόνδε καλέσσας·	- uu -uu- uu- uu-u u--	dactylic hexameter	masculine penthemimeral, hepthemimeral
μαῖ’, ἄγε δή μοι οἶνον ἐν ἀμφιφορεῦσιν ἄφυσσον	- uu - - -u u -uu-u u--	dactylic hexameter	feminine penthemimeral, trithemimeral
ἡδύν, ὅτις μετὰ τὸν λαρώτατος ὃν σὺ φυλάσσεις	-u u- uu - --uu - u u--	dactylic hexameter	masculine penthemimeral, trithemimeral
κεῖνον ὀιομένη τὸν κάμμορον, εἴ ποθεν ἔλθοι	-u u-uu- - -uu - uu --	dactylic hexameter	masculine penthemimeral
διογενὴς Ὀδυσεὺς θάνατον καὶ κῆρας ἀλύξας.	-uu- uu- uu- - -u u--	dactylic hexameter	masculine penthemimeral, hepthemimeral, trithemimeral
δώδεκα δ’ἔμπλησον καὶ πώμασιν ἄρσον ἅπαντας.	-uu --- - -uu -u u--	dactylic hexameter	masculine penthemimeral
ἐν δέ μοι ἄλφιτα χεῦον ἐϋρραφέεσσι δοροῖσιν·	- u u -uu -u u-uu-u u--	dactylic hexameter	feminine penthemimeral
εἴκοσι δ’ἔστω μέτρα μυληφάτου ἀλφίτου ἀκτῆς.	-uu -- -u u-uu -uu --	dactylic hexameter	feminine penthemimeral
αὐτὴ δ’οἴη ἴσθι· τὰ δ’ἁθρόα πάντα τετύχθω·	-- -- -u u -uu -u u--	dactylic hexameter	feminine penthemimeral
ἑσπέριος γὰρ ἐγὼν αἱρήσομαι, ὁππότε κεν δὴ	-uu- u u- --uu -uu - -	dactylic hexameter	masculine penthemimeral, trithemimeral
μήτηρ εἰς ὑπερῷ’ ἀναβῇ κοίτου τε μέδηται.	-- - uu- uu- -- u u--	dactylic hexameter	masculine penthemimeral, hepthemimeral, trithemimeral
εἶμι γὰρ ἐς Σπάρτην τε καὶ ἐς Πύλον ἠμαθόεντα	-u u - -- u u - uu -uu--	dactylic hexameter	masculine penthemimeral, hepthemimeral, trithemimeral
νόστον πευσόμενος πατρὸς φίλου, ἤν που ἀκούσω.	-- -uu- -- uu - u u--	dactylic hexameter	masculine penthemimeral, hepthemimeral
ὣς φάτο, κώκυσεν δὲ φίλη τροφὸς Εὐρύκλεια,	- uu --- u u- uu ----	dactylic hexameter	masculine penthemimeral, hepthemimeral
καί ῥ’ὀλοφυρομένη ἔπεα πτερόεντα προσηύδα·	- uu-uu- uu- uu-u u--	dactylic hexameter	masculine penthemimeral, hepthemimeral
τίπτε δέ τοι, φίλε τέκνον, ἐνὶ φρεσὶ τοῦτο νόημα	-u u - uu -u u- uu -u u--	dactylic hexameter	feminine penthemimeral, hepthemimeral, trithemimeral
ἔπλετο; πῇ δ’ἐθέλεις ἰέναι πολλὴν ἐπὶ γαῖαν	-uu - uu- uu- -- uu --	dactylic hexameter	masculine penthemimeral, hepthemimeral, trithemimeral
μοῦνος ἐὼν ἀγαπητός; ὁ δ’ὤλετο τηλόθι πάτρης	-u u- uu-u u -uu -uu --	dactylic hexameter	feminine penthemimeral, trithemimeral
διογενὴς Ὀδυσεὺς ἀλλογνώτῳ ἐνὶ δήμῳ.	-uu- uu- ---- uu --	dactylic hexameter	masculine penthemimeral, trithemimeral
οἱ δέ τοι αὐτίκ’ ἰόντι κακὰ φράσσονται ὀπίσσω,	- u u -u u-u u- --u u--	dactylic hexameter	feminine penthemimeral, hepthemimeral
ὥς κε δόλῳ φθίῃς, τάδε δ’αὐτοὶ πάντα δάσονται.	- u u- -- uu -- -u u--	dactylic hexameter	masculine penthemimeral, trithemimeral
ἀλλὰ μέν’ αὖθ’ ἐπὶ σοῖσι καθήμενος· οὐδέ τί σε χρὴ	-u u - uu -u u-uu -u u - -	dactylic hexameter	feminine penthemimeral, trithemimeral
πόντον ἐπ’ ἀτρύγετον κακὰ πάσχειν οὐδ’ ἀλάλησθαι.	-u u -uu- uu -- - uu--	dactylic hexameter	masculine penthemimeral
τὴν δ’αὖ Τηλέμαχος πεπνυμένος ἀντίον ηὔδα·	- - -uu- --uu -uu --	dactylic hexameter	masculine penthemimeral
θάρσει, μαῖ’, ἐπεὶ οὔ τοι ἄνευ θεοῦ ἥδε γε βουλή.	-- - uu - u u- uu -u u --	dactylic hexameter	masculine penthemimeral, hepthemimeral, trithemimeral
ἀλλ’ ὄμοσον μὴ μητρὶ φίλῃ τάδε μυθήσασθαι,	- uu- - -u u- uu ----	dactylic hexameter	feminine penthemimeral, hepthemimeral, trithemimeral
πρίν γ’ὅτ’ ἂν ἑνδεκάτη τε δυωδεκάτη τε γένηται,	- u u -uu- u u-uu- u u--	dactylic hexameter	masculine penthemimeral
ἢ αὐτὴν ποθέσαι καὶ ἀφορμηθέντος ἀκοῦσαι,	- -- uu- u u---u u--	dactylic hexameter	masculine penthemimeral, trithemimeral
ὡς ἂν μὴ κλαίουσα κατὰ χρόα καλὸν ἰάπτῃ.	- - - --u u- uu -u u--	dactylic hexameter	feminine penthemimeral, hepthemimeral, trithemimeral
ὣς ἄρ’ ἔφη, γρῆυς δὲ θεῶν μέγαν ὅρκον ἀπώμνυ.	- u u- -- u u- uu -u u--	dactylic hexameter	masculine penthemimeral, hepthemimeral, trithemimeral
αὐτὰρ ἐπεί ῥ’ὄμοσέν τε τελεύτησέν τε τὸν ὅρκον,	-u u- uu- u u--- u u --	dactylic hexameter	masculine penthemimeral, trithemimeral
αὐτίκ’ ἔπειτά οἱ οἶνον ἐν ἀμφιφορεῦσιν ἄφυσσεν,	-u u-u u -u u -uu-u u--	dactylic hexameter	feminine penthemimeral
ἐν δέ οἱ ἄλφιτα χεῦεν ἐϋρραφέεσσι δοροῖσι.	- u u -uu -u u-uu-u u--	dactylic hexameter	feminine penthemimeral
Τηλέμαχος δ’ἐς δώματ’ ἰὼν μνηστῆρσιν ὁμίλει.	-uu- - -u u- --u u--	dactylic hexameter	feminine penthemimeral, hepthemimeral, trithemimeral
ἔνθ’ αὖτ’ ἄλλ’ ἐνόησε θεά, γλαυκῶπις Ἀθήνη.	- - - uu-u u- --u u--	dactylic hexameter	feminine penthemimeral, hepthemimeral, trithemimeral
Τηλεμάχῳ ἐικυῖα κατὰ πτόλιν ᾤχετο πάντῃ,	-uu- uu-u u- uu -uu --	dactylic hexameter	feminine penthemimeral, hepthemimeral, trithemimeral
καί ῥα ἑκάστῳ φωτὶ παρισταμένη φάτο μῦθον,	- u u-- -u u-uu- uu --	dactylic hexameter	feminine penthemimeral
ἑσπερίους δ’ἐπὶ νῆα θοὴν ἀγέρεσθαι ἀνώγει.	-uu- uu -u u- uu-u u--	dactylic hexameter	feminine penthemimeral, hepthemimeral, trithemimeral
ἡ δ’αὖτε Φρονίοιο Νοήμονα φαίδιμον υἱὸν	- -- uu-u u-uu -uu --	dactylic hexameter	feminine penthemimeral, trithemimeral
ᾔτεε νῆα θοήν· ὁ δέ οἱ πρόφρων ὑπέδεκτο.	-uu -u u- u u - -- uu--	dactylic hexameter	masculine penthemimeral, hepthemimeral
καὶ τότε νῆα θοὴν ἅλαδ’ εἴρυσε, πάντα δ’ἐν αὐτῇ	- uu -u u- uu -uu -u u --	dactylic hexameter	masculine penthemimeral
ὅπλ’ ἐτίθει, τά τε νῆες ἐύσσελμοι φορέουσι.	- uu- u u -u u--- uu--	dactylic hexameter	feminine penthemimeral, trithemimeral
στῆσε δ’ἐπ’ ἐσχατιῇ λιμένος, περὶ δ’ἐσθλοὶ ἑταῖροι	-u u -uu- uu- uu -u u--	dactylic hexameter	masculine penthemimeral, hepthemimeral
ἁθρόοι ἠγερέθοντο· θεὰ δ’ὤτρυνεν ἕκαστον.	-uu -uu-u u- --u u--	dactylic hexameter	feminine penthemimeral, hepthemimeral
ἔνθ’ αὖτ’ ἄλλ’ ἐνόησε θεά, γλαυκῶπις Ἀθήνη.	- - - uu-u u- --u u--	dactylic hexameter	feminine penthemimeral, hepthemimeral, trithemimeral
βῆ ἰέναι πρὸς δώματ’ Ὀδυσσῆος θείοιο·	- uu- - -u u--- ---	dactylic hexameter	feminine penthemimeral, trithemimeral
ἔνθα μνηστήρεσσιν ἐπὶ γλυκὺν ὕπνον ἔχευε,	-- ---u u- uu -u u--	dactylic hexameter	feminine penthemimeral, hepthemimeral
πλάζε δὲ πίνοντας, χειρῶν δ’ἔκβαλλε κύπελλα.	-u u --- -- --u u--	dactylic hexameter	masculine penthemimeral, hepthemimeral
οἱ δ’εὕδειν ὤρνυντο κατὰ πτόλιν, οὐδ’ ἄρ’ ἔτι δὴν	- -- --u u- uu - u u- -	dactylic hexameter	feminine penthemimeral, hepthemimeral, trithemimeral
ἥατ’, ἐπεί σφισιν ὕπνος ἐπὶ βλεφάροισιν ἔπιπτεν.	-u u- uu -u u- uu-u u--	dactylic hexameter	feminine penthemimeral, hepthemimeral, trithemimeral
αὐτὰρ Τηλέμαχον προσέφη γλαυκῶπις Ἀθήνη	-- -uu- uu- --u u--	dactylic hexameter	masculine penthemimeral, hepthemimeral
ἐκπροκαλεσσαμένη μεγάρων ἐὺ ναιεταόντων,	-uu-uu- uu- uu -uu--	dactylic hexameter	masculine penthemimeral, hepthemimeral
Μέντορι εἰδομένη ἠμὲν δέμας ἠδὲ καὶ αὐδήν·	-uu -uu- -- uu -u u --	dactylic hexameter	masculine penthemimeral, hepthemimeral
Τηλέμαχ’, ἤδη μέν τοι ἐυκνήμιδες ἑταῖροι	-uu -- - u u---u u--	dactylic hexameter	masculine penthemimeral
ἥατ’ ἐπήρετμοι τὴν σὴν ποτιδέγμενοι ὁρμήν·	-u u--- - - uu-uu --	dactylic hexameter	masculine penthemimeral, hepthemimeral
ἀλλ’ ἴομεν, μὴ δηθὰ διατρίβωμεν ὁδοῖο.	- uu- - -u u---u u--	dactylic hexameter	feminine penthemimeral, trithemimeral
ὣς ἄρα φωνήσασ’ ἡγήσατο Παλλὰς Ἀθήνη	- uu --- --uu -u u--	dactylic hexameter	masculine penthemimeral
καρπαλίμως· ὁ δ’ἔπειτα μετ’ ἴχνια βαῖνε θεοῖο.	-uu- u u-u u -uu -u u--	dactylic hexameter	feminine penthemimeral, trithemimeral
αὐτὰρ ἐπεί ῥ’ἐπὶ νῆα κατήλυθον ἠδὲ θάλασσαν,	-u u- uu -u u-uu -u u--	dactylic hexameter	feminine penthemimeral, trithemimeral
εὗρον ἔπειτ’ ἐπὶ θινὶ κάρη κομόωντας ἑταίρους.	-u u- uu -u u- uu-u u--	dactylic hexameter	feminine penthemimeral, hepthemimeral, trithemimeral
τοῖσι δὲ καὶ μετέειφ’ ἱερὴ ἲς Τηλεμάχοιο·	-u u - uu- uu- - -uu--	dactylic hexameter	masculine penthemimeral, hepthemimeral, trithemimeral
δεῦτε, φίλοι, ἤια φερώμεθα· πάντα γὰρ ἤδη	-u u- --u u-uu -u u --	dactylic hexameter	feminine penthemimeral, trithemimeral
ἁθρό’ ἐνὶ&nbnbsp;μεγάρῳ. μήτηρ δ’ἐμὴ οὔ τι πέπυσται,	-u u-uu- -- uu - u u--	dactylic hexameter	masculine penthemimeral, hepthemimeral
οὐδ’ ἄλλαι δμωαί, μία δ’οἴη μῦθον ἄκουσεν.	- -- -- uu -- -u u--	dactylic hexameter	masculine penthemimeral, trithemimeral
ὣς ἄρα φωνήσας ἡγήσατο, τοὶ δ’ἅμ’ ἕποντο.	- uu --- --uu - u u--	dactylic hexameter	masculine penthemimeral
οἱ δ’ἄρα πάντα φέροντες ἐυσσέλμῳ ἐπὶ νηὶ	- uu -u u-u u--- uu --	dactylic hexameter	feminine penthemimeral
κάτθεσαν, ὡς ἐκέλευσεν Ὀδυσσῆος φίλος υἱός.	-uu - uu-u u--- uu --	dactylic hexameter	feminine penthemimeral, trithemimeral
ἂν δ’ἄρα Τηλέμαχος νηὸς βαῖν’, ἦρχε δ’Ἀθήνη,	- uu -uu- -- - -u u--	dactylic hexameter	masculine penthemimeral, hepthemimeral
νηὶ δ’ἐνὶ πρυμνῇ κατ’ ἄρ’ ἕζετο· ἄγχι δ’ἄρ’ αὐτῆς	-u u- -- u u -uu -u u --	dactylic hexameter	masculine penthemimeral, trithemimeral
ἕζετο Τηλέμαχος. τοὶ δὲ πρυμνήσι’ ἔλυσαν,	-uu -uu- - - --u u--	dactylic hexameter	masculine penthemimeral, hepthemimeral
ἂν δὲ καὶ αὐτοὶ βάντες ἐπὶ κληῖσι καθῖζον.	- u u -- -u u- --u u--	dactylic hexameter	feminine penthemimeral, hepthemimeral
τοῖσιν δ’ἴκμενον οὖρον ἵει γλαυκῶπις Ἀθήνη,	-- -uu -u u- --u u--	dactylic hexameter	feminine penthemimeral, hepthemimeral
ἀκραῆ Ζέφυρον, κελάδοντ’ ἐπὶ οἴνοπα πόντον.	--- uu- uu- uu -uu --	dactylic hexameter	masculine penthemimeral, hepthemimeral, trithemimeral
Τηλέμαχος δ’ἑτάροισιν ἐποτρύνας ἐκέλευσεν	-uu- uu-u u--- uu--	dactylic hexameter	feminine penthemimeral, trithemimeral
ὅπλων ἅπτεσθαι· τοὶ δ’ὀτρύνοντος ἄκουσαν.	-- --- - ---u u--	dactylic hexameter	masculine penthemimeral
ἱστὸν δ’εἰλάτινον κοίλης ἔντοσθε μεσόδμης	-- -uu- -- --u u--	dactylic hexameter	masculine penthemimeral, hepthemimeral
στῆσαν ἀείραντες, κατὰ δὲ προτόνοισιν ἔδησαν,	-u u--- uu - uu-u u--	dactylic hexameter	masculine penthemimeral, hepthemimeral
ἕλκον δ’ἱστία λευκὰ ἐυστρέπτοισι βοεῦσιν.	-- -uu -u u---u u--	dactylic hexameter	feminine penthemimeral
ἔπρησεν δ’ἄνεμος μέσον ἱστίον, ἀμφὶ δὲ κῦμα	--- uu- uu -uu -u u --	dactylic hexameter	masculine penthemimeral, trithemimeral
στείρῃ πορφύρεον μεγάλ’ ἴαχε νηὸς ἰούσης·	-- -uu- uu -uu -u u--	dactylic hexameter	masculine penthemimeral
ἡ δ’ἔθεεν κατὰ κῦμα διαπρήσσουσα κέλευθον.	- uu- uu -u u---u u--	dactylic hexameter	feminine penthemimeral, trithemimeral
δησάμενοι δ’ἄρα ὅπλα θοὴν ἀνὰ νῆα μέλαιναν	-uu- uu -u u- uu -u u--	dactylic hexameter	feminine penthemimeral, hepthemimeral, trithemimeral
στήσαντο κρητῆρας ἐπιστεφέας οἴνοιο,	--- --u u-uu- ---	dactylic hexameter	feminine penthemimeral, trithemimeral
λεῖβον δ’ἀθανάτοισι θεοῖς αἰειγενέτῃσιν,	-- -uu-u u- --uu--	dactylic hexameter	feminine penthemimeral, hepthemimeral
ἐκ πάντων δὲ μάλιστα Διὸς γλαυκώπιδι κούρῃ.	- -- u u-u u- --uu --	dactylic hexameter	feminine penthemimeral, hepthemimeral, trithemimeral
παννυχίη μέν ῥ’ἥ γε καὶ ἠῶ πεῖρε κέλευθον.	-uu- - - u u -- -u u--	dactylic hexameter	masculine penthemimeral, trithemimeral
