ἠὼς δ’ἐκ λεχέων παρ’ ἀγαυοῦ Τιθωνοῖο	-- - uu- u u-- ----	dactylic hexameter	masculine penthemimeral, trithemimeral
ὤρνυθ’, ἵν’ ἀθανάτοισι φόως φέροι ἠδὲ βροτοῖσιν·	-u u -uu-u u- uu -u u--	dactylic hexameter	feminine penthemimeral, hepthemimeral
οἱ δὲ θεοὶ θῶκόνδε καθίζανον, ἐν δ’ἄρα τοῖσι	- u u- --u u-uu - uu --	dactylic hexameter	feminine penthemimeral, trithemimeral
Ζεὺς ὑψιβρεμέτης, οὗ τε κράτος ἐστὶ μέγιστον.	- --uu- - - uu -u u--	dactylic hexameter	masculine penthemimeral, hepthemimeral
τοῖσι δ’Ἀθηναίη λέγε κήδεα πόλλ’ Ὀδυσῆος	-u u--- uu -uu - uu--	dactylic hexameter	masculine penthemimeral
μνησαμένη· μέλε γάρ οἱ ἐὼν ἐν δώμασι νύμφης·	-uu- uu - u u- - -uu --	dactylic hexameter	masculine penthemimeral, hepthemimeral, trithemimeral
Ζεῦ πάτερ ἠδ’ ἄλλοι μάκαρες θεοὶ αἰὲν ἐόντες,	- uu - -- uu- uu -u u--	dactylic hexameter	masculine penthemimeral, hepthemimeral, trithemimeral
μή τις ἔτι πρόφρων ἀγανὸς καὶ ἤπιος ἔστω	- u u- -- uu- - -uu --	dactylic hexameter	masculine penthemimeral, hepthemimeral, trithemimeral
σκηπτοῦχος βασιλεύς, μηδὲ φρεσὶν αἴσιμα εἰδώς,	--- uu- -- uu -uu --	dactylic hexameter	masculine penthemimeral, hepthemimeral, trithemimeral
ἀλλ’ αἰεὶ χαλεπός τ’εἴη καὶ αἴσυλα ῥέζοι·	- -- uu- -- - -uu --	dactylic hexameter	masculine penthemimeral, hepthemimeral, trithemimeral
ὡς οὔ τις μέμνηται Ὀδυσσῆος θείοιο	- - - --u u--- ---	dactylic hexameter	feminine penthemimeral, trithemimeral
λαῶν οἷσιν ἄνασσε, πατὴρ δ’ὣς ἤπιος ἦεν.	-- -u u-u u- - -uu --	dactylic hexameter	feminine penthemimeral, hepthemimeral
ἀλλ’ ὁ μὲν ἐν νήσῳ κεῖται κρατέρ’ ἄλγεα πάσχων	- u u - -- -- uu -uu --	dactylic hexameter	masculine penthemimeral, hepthemimeral, trithemimeral
νύμφης ἐν μεγάροισι Καλυψοῦς, ἥ μιν ἀνάγκῃ	-- - uu-u u-- - u u--	dactylic hexameter	feminine penthemimeral, trithemimeral
ἴσχει· ὁ δ’οὐ δύναται ἣν πατρίδα γαῖαν ἱκέσθαι·	-u u - uu- - -uu -u u--	dactylic hexameter	masculine penthemimeral, trithemimeral
οὐ γάρ οἱ πάρα νῆες ἐπήρετμοι καὶ ἑταῖροι,	- - - uu -u u--- u u--	dactylic hexameter	feminine penthemimeral, trithemimeral
οἵ κέν μιν πέμποιεν ἐπ’ εὐρέα νῶτα θαλάσσης.	- - - --u u -uu -u u--	dactylic hexameter	feminine penthemimeral, trithemimeral
νῦν αὖ παῖδ’ ἀγαπητὸν ἀποκτεῖναι μεμάασιν	- - - uu-u u--- uu--	dactylic hexameter	feminine penthemimeral, trithemimeral
οἴκαδε νισόμενον· ὁ δ’ἔβη μετὰ πατρὸς ἀκουὴν	-uu -uu- u u- uu -u u--	dactylic hexameter	masculine penthemimeral, hepthemimeral
ἐς Πύλον ἠγαθέην ἠδ’ ἐς Λακεδαίμονα δῖαν.	- uu -uu- - - uu-uu --	dactylic hexameter	masculine penthemimeral, hepthemimeral
τὴν δ’ἀπαμειβόμενος προσέφη νεφεληγερέτα Ζεύς·	- uu-uu- uu- uu-uu- -	dactylic hexameter	masculine penthemimeral, hepthemimeral
τέκνον ἐμόν, ποῖόν σε ἔπος φύγεν ἕρκος ὀδόντων.	-u u- -- u u- uu -u u--	dactylic hexameter	masculine penthemimeral, hepthemimeral, trithemimeral
οὐ γὰρ δὴ τοῦτον μὲν ἐβούλευσας νόον αὐτή,	- - - -- u u--- uu --	dactylic hexameter	masculine penthemimeral, trithemimeral
ὡς ἤτοι κείνους Ὀδυσεὺς ἀποτίσεται ἐλθών;	- -- -- uu- uu-uu --	dactylic hexameter	masculine penthemimeral, hepthemimeral, trithemimeral
Τηλέμαχον δὲ σὺ πέμψον ἐπισταμένως, δύνασαι γάρ,	-uu- u u -u u-uu- uu- -	dactylic hexameter	feminine penthemimeral, trithemimeral
ὥς κε μάλ’ ἀσκηθὴς ἣν πατρίδα γαῖαν ἵκηται,	- u u --- - -uu -u u--	dactylic hexameter	masculine penthemimeral
μνηστῆρες δ’ἐν νηὶ· παλιμπετὲς ἀπονέωνται.	--- - -u u-uu -uu--	dactylic hexameter	feminine penthemimeral, trithemimeral
ἦ ῥα καὶ Ἑρμείαν, υἱὸν φίλον, ἀντίον ηὔδα·	- u u --- -- uu -uu --	dactylic hexameter	masculine penthemimeral, hepthemimeral
Ἑρμεία, σὺ γὰρ αὖτε τά τ’ἄλλα περ ἄγγελός ἐσσι,	--- u u -u u -u u -uu --	dactylic hexameter	feminine penthemimeral, trithemimeral
νύμφῃ ἐυπλοκάμῳ εἰπεῖν νημερτέα βουλήν,	-u u-uu- -- --uu --	dactylic hexameter	masculine penthemimeral, hepthemimeral
νόστον Ὀδυσσῆος ταλασίφρονος, ὥς κε νέηται	-u u--- uu-uu - u u--	dactylic hexameter	masculine penthemimeral
οὔτε θεῶν πομπῇ οὔτε θνητῶν ἀνθρώπων·	-u u- -- -- -- ---	dactylic hexameter	masculine penthemimeral, hepthemimeral, trithemimeral
ἀλλ’ ὅ γ’ἐπὶ σχεδίης πολυδέσμου πήματα πάσχων	- u u- uu- uu-- -uu --	dactylic hexameter	masculine penthemimeral, trithemimeral
ἤματί κ’εἰκοστῷ Σχερίην ἐρίβωλον ἵκοιτο,	-uu --- uu- uu-u u--	dactylic hexameter	masculine penthemimeral, hepthemimeral
Φαιήκων ἐς γαῖαν, οἳ ἀγχίθεοι γεγάασιν,	--- - -u u -uu- uu--	dactylic hexameter	feminine penthemimeral, trithemimeral
οἵ κέν μιν περὶ κῆρι θεὸν ὣς τιμήσουσι,	- - - uu -u u- - ----	dactylic hexameter	feminine penthemimeral, hepthemimeral, trithemimeral
πέμψουσιν δ’ἐν νηὶ φίλην ἐς πατρίδα γαῖαν,	--- - -u u- - -uu --	dactylic hexameter	feminine penthemimeral, hepthemimeral, trithemimeral
χαλκόν τε χρυσόν τε ἅλις ἐσθῆτά τε δόντες,	-- - -- u u- --u u --	dactylic hexameter	masculine penthemimeral, hepthemimeral, trithemimeral
πόλλ’, ὅσ’ ἂν οὐδέ ποτε Τροίης ἐξήρατ’ Ὀδυσσεύς,	- u u -u u- -- --u u--	dactylic hexameter	masculine penthemimeral, hepthemimeral
εἴ περ ἀπήμων ἦλθε, λαχὼν ἀπὸ ληίδος αἶσαν.	- u u-- -u u- uu -uu --	dactylic hexameter	feminine penthemimeral, hepthemimeral
ὣς γάρ οἱ μοῖρ’ ἐστὶ φίλους τ’ἰδέειν καὶ ἱκέσθαι	- - - - -u u- uu- u u--	dactylic hexameter	feminine penthemimeral, hepthemimeral, trithemimeral
οἶκον ἐς ὑψόροφον καὶ ἑὴν ἐς πατρίδα γαῖαν.	-u u -uu- u u- - -uu --	dactylic hexameter	masculine penthemimeral, hepthemimeral
ὣς ἔφατ’, οὐδ’ ἀπίθησε διάκτορος ἀργεϊφόντης.	- uu - uu-u u-uu -uu--	dactylic hexameter	feminine penthemimeral, trithemimeral
αὐτίκ’ ἔπειθ’ ὑπὸ ποσσὶν ἐδήσατο καλὰ πέδιλα,	-u u- uu -u u-uu -u u--	dactylic hexameter	feminine penthemimeral, trithemimeral
ἀμβρόσια χρύσεια, τά μιν φέρον ἠμὲν ἐφ’ ὑγρὴν	-uu- --u u - uu -u u --	dactylic hexameter	feminine penthemimeral, hepthemimeral, trithemimeral
ἠδ’ ἐπ’ ἀπείρονα γαῖαν ἅμα πνοιῇς ἀνέμοιο.	- u u-uu -u u- -- uu--	dactylic hexameter	feminine penthemimeral, hepthemimeral
εἵλετο δὲ ῥάβδον, τῇ τ’ἀνδρῶν ὄμματα θέλγει,	-uu - -- - -- -uu --	dactylic hexameter	masculine penthemimeral, trithemimeral
ὧν ἐθέλει, τοὺς δ’αὖτε καὶ ὑπνώοντας ἐγείρει.	- uu- - -u u ---u u--	dactylic hexameter	feminine penthemimeral, trithemimeral
τὴν μετὰ χερσὶν ἔχων πέτετο κρατὺς ἀργεϊφόντης.	- uu -u u- uu- uu -uu--	dactylic hexameter	masculine penthemimeral, hepthemimeral
Πιερίην δ’ἐπιβὰς ἐξ αἰθέρος ἔμπεσε πόντῳ·	-uu- uu- - -uu -uu --	dactylic hexameter	masculine penthemimeral, trithemimeral
σεύατ’ ἔπειτ’ ἐπὶ κῦμα λάρῳ ὄρνιθι ἐοικώς,	-u u- uu -u u- --u u--	dactylic hexameter	feminine penthemimeral, hepthemimeral, trithemimeral
ὅς τε κατὰ δεινοὺς κόλπους ἁλὸς ἀτρυγέτοιο	- u u- -- -- uu -uu--	dactylic hexameter	masculine penthemimeral, hepthemimeral, trithemimeral
ἰχθῦς ἀγρώσσων πυκινὰ πτερὰ δεύεται ἅλμῃ·	-- --- uu- uu -uu --	dactylic hexameter	masculine penthemimeral, hepthemimeral
τῷ ἴκελος πολέεσσιν ὀχήσατο κύμασιν Ἑρμῆς.	- uu- uu-u u-uu -uu --	dactylic hexameter	feminine penthemimeral, trithemimeral
ἀλλ’ ὅτε δὴ τὴν νῆσον ἀφίκετο τηλόθ’ ἐοῦσαν,	- uu - - -u u-uu -u u--	dactylic hexameter	feminine penthemimeral, trithemimeral
ἔνθ’ ἐκ πόντου βὰς ἰοειδέος ἤπειρόνδε	- - -- - uu-uu ----	dactylic hexameter	masculine penthemimeral
ἤιεν, ὄφρα μέγα σπέος ἵκετο, τῷ ἔνι νύμφη	-uu -u u- uu -uu - uu --	dactylic hexameter	masculine penthemimeral
ναῖεν ἐυπλόκαμος· τὴν δ’ἔνδοθι τέτμεν ἐοῦσαν.	-u u-uu- - -uu -u u--	dactylic hexameter	masculine penthemimeral
πῦρ μὲν ἐπ’ ἐσχαρόφιν μέγα καίετο, τηλόσε δ’ὀδμὴ	- u u -uu- uu -uu -uu --	dactylic hexameter	masculine penthemimeral
κέδρου τ’εὐκεάτοιο θύου τ’ἀνὰ νῆσον ὀδώδει	-- -uu-u u- uu -u u--	dactylic hexameter	feminine penthemimeral, hepthemimeral
δαιομένων· ἡ δ’ἔνδον ἀοιδιάουσ’ ὀπὶ καλῇ	-uu- - -u u-uu- uu --	dactylic hexameter	feminine penthemimeral, trithemimeral
ἱστὸν ἐποιχομένη χρυσείῃ κερκίδ’ ὕφαινεν.	-u u-uu- --- -u u--	dactylic hexameter	masculine penthemimeral
ὕλη δὲ σπέος ἀμφὶ πεφύκει τηλεθόωσα,	-- - uu -u u-- -uu--	dactylic hexameter	feminine penthemimeral, trithemimeral
κλήθρη τ’αἴγειρός τε καὶ εὐώδης κυπάρισσος.	-- --- u u --- uu--	dactylic hexameter	masculine penthemimeral
ἔνθα δέ τ’ὄρνιθες τανυσίπτεροι εὐνάζοντο,	-u u --- uu-uu ----	dactylic hexameter	masculine penthemimeral
σκῶπές τ’ἴρηκές τε τανύγλωσσοί τε κορῶναι	-- --- u u--- u u--	dactylic hexameter	masculine penthemimeral
εἰνάλιαι, τῇσίν τε θαλάσσια ἔργα μέμηλεν.	-uu- -- u u-uu -u u--	dactylic hexameter	masculine penthemimeral, trithemimeral
ἡ δ’αὐτοῦ τετάνυστο περὶ σπείους γλαφυροῖο	- -- uu-u u- -- uu--	dactylic hexameter	feminine penthemimeral, hepthemimeral, trithemimeral
ἡμερὶς ἡβώωσα, τεθήλει δὲ σταφυλῇσι.	-uu ---u u-- - uu--	dactylic hexameter	feminine penthemimeral
κρῆναι δ’ἑξείης πίσυρες ῥέον ὕδατι λευκῷ,	-- --- uu- uu -uu --	dactylic hexameter	masculine penthemimeral, hepthemimeral
πλησίαι ἀλλήλων τετραμμέναι ἄλλυδις ἄλλη.	-uu --- --uu -uu --	dactylic hexameter	masculine penthemimeral
ἀμφὶ δὲ λειμῶνες μαλακοὶ ἴου ἠδὲ σελίνου	-u u --- uu- uu -u u--	dactylic hexameter	masculine penthemimeral, hepthemimeral
θήλεον. ἔνθα κ’ἔπειτα καὶ ἀθάνατός περ ἐπελθὼν	-uu -u u-u u -uu- u u--	dactylic hexameter	feminine penthemimeral
θηήσαιτο ἰδὼν καὶ τερφθείη φρεσὶν ᾗσιν.	---u u- - --- uu --	dactylic hexameter	masculine penthemimeral
ἔνθα στὰς θηεῖτο διάκτορος ἀργεϊφόντης.	-- - --u u-uu -uu--	dactylic hexameter	feminine penthemimeral, trithemimeral
αὐτὰρ ἐπεὶ δὴ πάντα ἑῷ θηήσατο θυμῷ,	-u u- - -- - --uu --	dactylic hexameter	hepthemimeral, trithemimeral
αὐτίκ’ ἄρ’ εἰς εὐρὺ σπέος ἤλυθεν. οὐδέ μιν ἄντην	-u u - -- uu -uu -u u --	dactylic hexameter	masculine penthemimeral, trithemimeral
ἠγνοίησεν ἰδοῦσα Καλυψώ, δῖα θεάων·	---u u-u u-- -u u--	dactylic hexameter	feminine penthemimeral
οὐ γάρ τ’ἀγνῶτες θεοὶ ἀλλήλοισι πέλονται	- - --- uu ---u u--	dactylic hexameter	masculine penthemimeral
ἀθάνατοι, οὐδ’ εἴ τις ἀπόπροθι δώματα ναίει.	-uu- - - u u-uu -uu --	dactylic hexameter	masculine penthemimeral, trithemimeral
οὐδ’ ἄρ’ Ὀδυσσῆα μεγαλήτορα ἔνδον ἔτετμεν,	- u u--- uu-uu -u u--	dactylic hexameter	masculine penthemimeral
ἀλλ’ ὅ γ’ἐπ’ ἀκτῆς κλαῖε καθήμενος, ἔνθα πάρος περ,	- u u -- -u u-uu -u u- -	dactylic hexameter	feminine penthemimeral
δάκρυσι καὶ στοναχῇσι καὶ ἄλγεσι θυμὸν ἐρέχθων.	-uu - uu-u u -uu -u u--	dactylic hexameter	feminine penthemimeral, trithemimeral
πόντον ἐπ’ ἀτρύγετον δερκέσκετο δάκρυα λείβων.	-u u -uu- --uu -uu --	dactylic hexameter	masculine penthemimeral
Ἑρμείαν δ’ἐρέεινε Καλυψώ, δῖα θεάων,	--- uu-u u-- -u u--	dactylic hexameter	feminine penthemimeral, trithemimeral
ἐν θρόνῳ ἱδρύσασα φαεινῷ σιγαλόεντι·	- uu ---u u-- -uu--	dactylic hexameter	feminine penthemimeral
τίπτε μοι, Ἑρμεία χρυσόρραπι, εἰλήλουθας	-u u --- --uu ----	dactylic hexameter	masculine penthemimeral
αἰδοῖός τε φίλος τε; πάρος γε μὲν οὔ τι θαμίζεις.	--- u u- u u- u u - u u--	dactylic hexameter	masculine penthemimeral, hepthemimeral, trithemimeral
αὔδα ὅ τι φρονέεις· τελέσαι δέ με θυμὸς ἄνωγεν,	-u u - uu- uu- u u -u u--	dactylic hexameter	masculine penthemimeral, hepthemimeral, trithemimeral
εἰ δύναμαι τελέσαι γε καὶ εἰ τετελεσμένον ἐστίν.	- uu- uu- u u - uu-uu --	dactylic hexameter	masculine penthemimeral, hepthemimeral, trithemimeral
ἀλλ’ ἕπεο προτέρω, ἵνα τοι πὰρ ξείνια θείω.	- uu- uu- uu - - -uu --	dactylic hexameter	masculine penthemimeral, hepthemimeral, trithemimeral
ὥς ἄρα φωνήσασα θεὰ παρέθηκε τράπεζαν	- uu ---u u- uu-u u--	dactylic hexameter	feminine penthemimeral, hepthemimeral
ἀμβροσίης πλήσασα, κέρασσε δὲ νέκταρ ἐρυθρόν.	-uu- --u u-u u -u u--	dactylic hexameter	feminine penthemimeral, trithemimeral
αὐτὰρ ὁ πῖνε καὶ ἦσθε διάκτορος ἀργεϊφόντης.	-u u -u u -u u-uu -uu--	dactylic hexameter	feminine penthemimeral
αὐτὰρ ἐπεὶ δείπνησε καὶ ἤραρε θυμὸν ἐδωδῇ,	-u u- --u u -uu -u u--	dactylic hexameter	feminine penthemimeral, trithemimeral
καὶ τότε δή μιν ἔπεσσιν ἀμειβόμενος προσέειπεν·	- uu - u u-u u-uu- uu--	dactylic hexameter	feminine penthemimeral, trithemimeral
εἰρωτᾷς μ’ἐλθόντα θεὰ θεόν· αὐτὰρ ἐγώ τοι	--- --u u- uu -u u- -	dactylic hexameter	feminine penthemimeral, hepthemimeral, trithemimeral
νημερτέως τὸν μῦθον ἐνισπήσω· κέλεαι γάρ.	--- - -u u--- uu- -	dactylic hexameter	feminine penthemimeral, trithemimeral
Ζεὺς ἐμέ γ’ἠνώγει δεῦρ’ ἐλθέμεν οὐκ ἐθέλοντα·	- uu --- - -uu - uu--	dactylic hexameter	masculine penthemimeral
τίς δ’ἂν ἑκὼν τοσσόνδε διαδράμοι ἁλμυρὸν ὕδωρ	- u u- --u u-uu -uu --	dactylic hexameter	feminine penthemimeral, trithemimeral
ἄσπετον; οὐδέ τις ἄγχι βροτῶν πόλις, οἵ τε θεοῖσιν	-uu -u u -u u- uu - u u--	dactylic hexameter	feminine penthemimeral, hepthemimeral
ἱερά τε ῥέζουσι καὶ ἐξαίτους ἑκατόμβας.	-uu - --u u --- uu--	dactylic hexameter	feminine penthemimeral, trithemimeral
ἀλλὰ μάλ’ οὔ πως ἔστι Διὸς νόον αἰγιόχοιο	-u u - - -u u- uu -uu--	dactylic hexameter	feminine penthemimeral, hepthemimeral, trithemimeral
οὔτε παρεξελθεῖν ἄλλον θεὸν οὔθ’ ἁλιῶσαι.	-u u--- -- uu - uu--	dactylic hexameter	masculine penthemimeral, hepthemimeral
φησί τοι ἄνδρα παρεῖναι ὀιζυρώτατον ἄλλων,	-u u -u u-u u---uu --	dactylic hexameter	feminine penthemimeral
τῶν ἀνδρῶν, οἳ ἄστυ πέρι Πριάμοιο μάχοντο	- -- - -u u- uu-u u--	dactylic hexameter	feminine penthemimeral, hepthemimeral, trithemimeral
εἰνάετες, δεκάτῳ δὲ πόλιν πέρσαντες ἔβησαν	-uu- uu- u u- --u u--	dactylic hexameter	masculine penthemimeral, hepthemimeral, trithemimeral
οἴκαδ’· ἀτὰρ ἐν νόστῳ Ἀθηναίην ἀλίτοντο,	-u u- - -u u--- uu--	dactylic hexameter	feminine penthemimeral, trithemimeral
ἥ σφιν ἐπῶρσ’ ἄνεμόν τε κακὸν καὶ κύματα μακρά.	- u u- uu- u u- - -uu --	dactylic hexameter	masculine penthemimeral, hepthemimeral, trithemimeral
ἔνθ’ ἄλλοι μὲν πάντες ἀπέφθιθεν ἐσθλοὶ ἑταῖροι,	- -- - -u u-uu -u u--	dactylic hexameter	feminine penthemimeral, trithemimeral
τὸν δ’ἄρα δεῦρ’ ἄνεμός τε φέρων καὶ κῦμα πέλασσε.	- uu - uu- u u- - -u u--	dactylic hexameter	masculine penthemimeral, hepthemimeral, trithemimeral
τὸν νῦν σ’ἠνώγει ἀποπεμπέμεν ὅττι τάχιστα·	- - --- uu-uu -u u--	dactylic hexameter	masculine penthemimeral
οὐ γάρ οἱ τῇδ’ αἶσα φίλων ἀπονόσφιν ὀλέσθαι,	- - - - -u u- uu-u u--	dactylic hexameter	feminine penthemimeral, hepthemimeral, trithemimeral
ἀλλ’ ἔτι οἱ μοῖρ’ ἐστὶ φίλους τ’ἰδέειν καὶ ἱκέσθαι	- uu - - -u u- uu- u u--	dactylic hexameter	feminine penthemimeral, hepthemimeral, trithemimeral
οἶκον ἐς ὑψόροφον καὶ ἑὴν ἐς πατρίδα γαῖαν.	-u u -uu- u u- - -uu --	dactylic hexameter	masculine penthemimeral, hepthemimeral
ὣς φάτο, ῥίγησεν δὲ Καλυψώ, δῖα θεάων,	- uu --- u u-- -u u--	dactylic hexameter	masculine penthemimeral
καί μιν φωνήσασ’ ἔπεα πτερόεντα προσηύδα·	- - --- uu- uu-u u--	dactylic hexameter	masculine penthemimeral, hepthemimeral
σχέτλιοί ἐστε, θεοί, ζηλήμονες ἔξοχον ἄλλων,	-uu -u u- --uu -uu --	dactylic hexameter	masculine penthemimeral
οἵ τε θεαῖς ἀγάασθε παρ’ ἀνδράσιν εὐνάζεσθαι	- u u- uu-u u -uu ----	dactylic hexameter	feminine penthemimeral, trithemimeral
ἀμφαδίην, ἤν τίς τε φίλον ποιήσετ’ ἀκοίτην.	-uu- - - u u- --u u--	dactylic hexameter	masculine penthemimeral, hepthemimeral, trithemimeral
ὣς μὲν ὅτ’ Ὠρίων’ ἕλετο ῥοδοδάκτυλος Ἠώς,	- u u --- uu- uu-uu --	dactylic hexameter	masculine penthemimeral, hepthemimeral
τόφρα οἱ ἠγάασθε θεοὶ ῥεῖα ζώοντες,	-u u ---u u- -- ---	dactylic hexameter	feminine penthemimeral, hepthemimeral
ἕως μιν ἐν Ὀρτυγίῃ χρυσόθρονος Ἄρτεμις ἁγνὴ	- u u -uu- --uu -uu --	dactylic hexameter	masculine penthemimeral
οἷς ἀγανοῖς βελέεσσιν ἐποιχομένη κατέπεφνεν.	- uu- uu-u u-uu- uu--	dactylic hexameter	feminine penthemimeral, trithemimeral
ὣς δ’ὁπότ’ Ἰασίωνι ἐυπλόκαμος Δημήτηρ,	- uu -uu-u u-uu- ---	dactylic hexameter	feminine penthemimeral
ᾧ θυμῷ εἴξασα, μίγη φιλότητι καὶ εὐνῇ	- -- --u u- uu-u u --	dactylic hexameter	feminine penthemimeral, hepthemimeral, trithemimeral
νειῷ ἔνι τριπόλῳ· οὐδὲ δὴν ἦεν ἄπυστος	-u u- uu- -- - -u u--	dactylic hexameter	masculine penthemimeral, hepthemimeral, trithemimeral
Ζεύς, ὅς μιν κατέπεφνε βαλὼν ἀργῆτι κεραυνῷ.	- - - uu-u u- --u u--	dactylic hexameter	feminine penthemimeral, hepthemimeral, trithemimeral
ὥς δ’αὖ νῦν μοι ἄγασθε, θεοί, βροτὸν ἄνδρα παρεῖναι.	- - - u u-u u- uu -u u--	dactylic hexameter	feminine penthemimeral, hepthemimeral, trithemimeral
τὸν μὲν ἐγὼν ἐσάωσα περὶ τρόπιος βεβαῶτα	- u u- uu-u u- uu- uu--	dactylic hexameter	feminine penthemimeral, hepthemimeral, trithemimeral
οἶον, ἐπεί οἱ νῆα θοὴν ἀργῆτι κεραυνῷ	-u u- - -u u- --u u--	dactylic hexameter	feminine penthemimeral, hepthemimeral, trithemimeral
Ζεὺς ἐλάσας ἐκέασσε μέσῳ ἐνὶ οἴνοπι πόντῳ.	- uu- uu-u u- uu -uu --	dactylic hexameter	feminine penthemimeral, hepthemimeral, trithemimeral
ἔνθ’ ἄλλοι μὲν πάντες ἀπέφθιθεν ἐσθλοὶ ἑταῖροι,	- -- - -u u-uu -u u--	dactylic hexameter	feminine penthemimeral, trithemimeral
τὸν δ’ἄρα δεῦρ’ ἄνεμός τε φέρων καὶ κῦμα πέλασσε.	- uu - uu- u u- - -u u--	dactylic hexameter	masculine penthemimeral, hepthemimeral, trithemimeral
τὸν μὲν ἐγὼ φίλεόν τε καὶ ἔτρεφον, ἠδὲ ἔφασκον	- u u- uu- u u -uu -u u--	dactylic hexameter	masculine penthemimeral, trithemimeral
θήσειν ἀθάνατον καὶ ἀγήραον ἤματα πάντα.	-- -uu- u u-uu -uu --	dactylic hexameter	masculine penthemimeral
ἀλλ’ ἐπεὶ οὔ πως ἔστι Διὸς νόον αἰγιόχοιο	- uu - - -u u- uu -uu--	dactylic hexameter	feminine penthemimeral, hepthemimeral, trithemimeral
οὔτε παρεξελθεῖν ἄλλον θεὸν οὔθ’ ἁλιῶσαι,	-u u--- -- uu - uu--	dactylic hexameter	masculine penthemimeral, hepthemimeral
ἐρρέτω, εἴ μιν κεῖνος ἐποτρύνει καὶ ἀνώγει,	-uu - - -u u--- u u--	dactylic hexameter	feminine penthemimeral, trithemimeral
πόντον ἐπ’ ἀτρύγετον· πέμψω δέ μιν οὔ πῃ ἔγωγε·	-u u -uu- -- u u - u u--	dactylic hexameter	masculine penthemimeral, hepthemimeral
οὐ γάρ μοι πάρα νῆες ἐπήρετμοι καὶ ἑταῖροι,	- - - uu -u u--- u u--	dactylic hexameter	feminine penthemimeral, trithemimeral
οἵ κέν μιν πέμποιεν ἐπ’ εὐρέα νῶτα θαλάσσης.	- - - --u u -uu -u u--	dactylic hexameter	feminine penthemimeral, trithemimeral
αὐτάρ οἱ πρόφρων ὑποθήσομαι, οὐδ’ ἐπικεύσω,	-- - -- uu-uu - uu--	dactylic hexameter	masculine penthemimeral, trithemimeral
ὥς κε μάλ’ ἀσκηθὴς ἣν πατρίδα γαῖαν ἵκηται.	- u u --- - -uu -u u--	dactylic hexameter	masculine penthemimeral
τὴν δ’αὖτε προσέειπε διάκτορος ἀργεϊφόντης·	- -- uu-u u-uu -uu--	dactylic hexameter	feminine penthemimeral, trithemimeral
οὕτω νῦν ἀπόπεμπε, Διὸς δ’ἐποπίζεο μῆνιν,	-- - uu-u u- uu-uu --	dactylic hexameter	feminine penthemimeral, hepthemimeral, trithemimeral
μή πώς τοι μετόπισθε κοτεσσάμενος χαλεπήνῃ.	- - - uu-u u-uu- uu--	dactylic hexameter	feminine penthemimeral, trithemimeral
ὣς ἄρα φωνήσας ἀπέβη κρατὺς ἀργεϊφόντης·	- uu --- uu- uu -uu--	dactylic hexameter	masculine penthemimeral, hepthemimeral
ἡ δ’ἐπ’ Ὀδυσσῆα μεγαλήτορα πότνια νύμφη	- u u--- uu-uu -uu --	dactylic hexameter	masculine penthemimeral
ἤι’, ἐπεὶ δὴ Ζηνὸς ἐπέκλυεν ἀγγελιάων.	-u u- - -u u-uu -uu--	dactylic hexameter	feminine penthemimeral, trithemimeral
τὸν δ’ἄρ’ ἐπ’ ἀκτῆς εὗρε καθήμενον· οὐδέ ποτ’ ὄσσε	- u u -- -u u-uu -u u --	dactylic hexameter	feminine penthemimeral
δακρυόφιν τέρσοντο, κατείβετο δὲ γλυκὺς αἰὼν	-uu- --u u-uu - uu --	dactylic hexameter	feminine penthemimeral, trithemimeral
νόστον ὀδυρομένῳ, ἐπεὶ οὐκέτι ἥνδανε νύμφη.	-u u-uu- uu -uu -uu --	dactylic hexameter	masculine penthemimeral
ἀλλ’ ἤτοι νύκτας μὲν ἰαύεσκεν καὶ ἀνάγκῃ	- -- -- u u--- u u--	dactylic hexameter	masculine penthemimeral, trithemimeral
ἐν σπέσσι γλαφυροῖσι παρ’ οὐκ ἐθέλων ἐθελούσῃ·	- -- uu-u u - uu- uu--	dactylic hexameter	feminine penthemimeral, hepthemimeral, trithemimeral
ἤματα δ’ἐν πέτρῃσι καὶ ἠιόνεσσι καθίζων	-uu - --u u -uu-u u--	dactylic hexameter	feminine penthemimeral, trithemimeral
δάκρυσι καὶ στοναχῇσι καὶ ἄλγεσι θυμὸν ἐρέχθων	-uu - uu-u u -uu -u u--	dactylic hexameter	feminine penthemimeral, trithemimeral
πόντον ἐπ’ ἀτρύγετον δερκέσκετο δάκρυα λείβων.	-u u -uu- --uu -uu --	dactylic hexameter	masculine penthemimeral
ἀγχοῦ δ’ἱσταμένη προσεφώνεε δῖα θεάων·	-- -uu- uu-uu -u u--	dactylic hexameter	masculine penthemimeral
κάμμορε, μή μοι ἔτ’ ἐνθάδ’ ὀδύρεο, μηδέ τοι αἰὼν	-uu - u u -u u-uu -u u --	dactylic hexameter	feminine penthemimeral, trithemimeral
φθινέτω· ἤδη γάρ σε μάλα πρόφρασσ’ ἀποπέμψω.	-uu -- - u u- -- uu--	dactylic hexameter	masculine penthemimeral, hepthemimeral
ἀλλ’ ἄγε δούρατα μακρὰ ταμὼν ἁρμόζεο χαλκῷ	- uu -uu -u u- --uu --	dactylic hexameter	feminine penthemimeral, hepthemimeral
εὐρεῖαν σχεδίην· ἀτὰρ ἴκρια πῆξαι ἐπ’ αὐτῆς	--- uu- uu -uu -u u --	dactylic hexameter	masculine penthemimeral, trithemimeral
ὑψοῦ, ὥς σε φέρῃσιν ἐπ’ ἠεροειδέα πόντον.	-- - u u-u u -uu-uu --	dactylic hexameter	feminine penthemimeral, trithemimeral
αὐτὰρ ἐγὼ σῖτον καὶ ὕδωρ καὶ οἶνον ἐρυθρὸν	-u u- -- u u- - -u u--	dactylic hexameter	masculine penthemimeral, hepthemimeral, trithemimeral
ἐνθήσω μενοεικέ’, ἅ κέν τοι λιμὸν ἐρύκοι,	--- uu-u u - - -u u--	dactylic hexameter	feminine penthemimeral, hepthemimeral, trithemimeral
εἵματά τ’ἀμφιέσω· πέμψω δέ τοι οὖρον ὄπισθεν,	-uu -uu- -- u u -u u--	dactylic hexameter	masculine penthemimeral, hepthemimeral
ὥς κε μάλ’ ἀσκηθὴς σὴν πατρίδα γαῖαν ἵκηαι,	- u u --- - -uu -u u--	dactylic hexameter	masculine penthemimeral
αἴ κε θεοί γ’ἐθέλωσι, τοὶ οὐρανὸν εὐρὺν ἔχουσιν,	- u u- uu-u u -uu -u u--	dactylic hexameter	feminine penthemimeral, trithemimeral
οἵ μευ φέρτεροί εἰσι νοῆσαί τε κρῆναί τε.	- - -uu -u u-- - -- -	dactylic hexameter	feminine penthemimeral
ὣς φάτο, ῥίγησεν δὲ πολύτλας δῖος Ὀδυσσεύς,	- uu --- u u-- -u u--	dactylic hexameter	masculine penthemimeral
καί μιν φωνήσας ἔπεα πτερόεντα προσηύδα·	- - --- uu- uu-u u--	dactylic hexameter	masculine penthemimeral, hepthemimeral
ἄλλο τι δὴ σύ, θεά, τόδε μήδεαι, οὐδέ τι πομπήν,	-u u - u u- uu -uu -u u --	dactylic hexameter	masculine penthemimeral, trithemimeral
ἥ με κέλεαι σχεδίῃ περάαν μέγα λαῖτμα θαλάσσης,	- u u- uu- uu- uu -u u--	dactylic hexameter	masculine penthemimeral, hepthemimeral, trithemimeral
δεινόν τ’ἀργαλέον τε· τὸ δ’οὐδ’ ἐπὶ νῆες ἐῖσαι	-- -uu- u u - uu -u u--	dactylic hexameter	masculine penthemimeral, hepthemimeral
ὠκύποροι περόωσιν, ἀγαλλόμεναι Διὸς οὔρῳ.	-uu- uu-u u-uu- uu --	dactylic hexameter	feminine penthemimeral, trithemimeral
οὐδ’ ἂν ἔγωγ’ ἀέκητι σέθεν σχεδίης ἐπιβαίην,	- u u- uu-u u- uu- uu--	dactylic hexameter	feminine penthemimeral, hepthemimeral, trithemimeral
εἰ μή μοι τλαίης γε, θεά, μέγαν ὅρκον ὀμόσσαι	- - - -- u u- uu -u u--	dactylic hexameter	masculine penthemimeral, hepthemimeral, trithemimeral
μή τί μοι αὐτῷ πῆμα κακὸν βουλευσέμεν ἄλλο.	- u u -- -u u- --uu --	dactylic hexameter	feminine penthemimeral, hepthemimeral
ὣς φάτο, μείδησεν δὲ Καλυψὼ δῖα θεάων,	- uu --- u u-- -u u--	dactylic hexameter	masculine penthemimeral
χειρί τέ μιν κατέρεξεν ἔπος τ’ἔφατ’ ἔκ τ’ὀνόμαζεν·	-u u - uu-u u- uu - uu--	dactylic hexameter	feminine penthemimeral, hepthemimeral, trithemimeral
ἦ δὴ ἀλιτρός γ’ἐσσὶ καὶ οὐκ ἀποφώλια εἰδώς,	- u u-- -u u - uu-uu --	dactylic hexameter	feminine penthemimeral, hepthemimeral
οἷον δὴ τὸν μῦθον ἐπεφράσθης ἀγορεῦσαι.	-- - - -u u--- uu--	dactylic hexameter	feminine penthemimeral, trithemimeral
ἴστω νῦν τόδε γαῖα καὶ οὐρανὸς εὐρὺς ὕπερθε	-- - uu -u u -uu -u u--	dactylic hexameter	feminine penthemimeral, trithemimeral
καὶ τὸ κατειβόμενον Στυγὸς ὕδωρ, ὅς τε μέγιστος	- u u-uu- uu -- - u u--	dactylic hexameter	masculine penthemimeral
ὅρκος δεινότατός τε πέλει μακάρεσσι θεοῖσι,	-- -uu- u u- uu-u u--	dactylic hexameter	masculine penthemimeral, hepthemimeral
μή τί τοι αὐτῷ πῆμα κακὸν βουλευσέμεν ἄλλο.	- u u -- -u u- --uu --	dactylic hexameter	feminine penthemimeral, hepthemimeral
ἀλλὰ τὰ μὲν νοέω καὶ φράσσομαι, ἅσσ’ ἂν ἐμοί περ	-u u - uu- - -uu - u u- -	dactylic hexameter	masculine penthemimeral, trithemimeral
αὐτῇ μηδοίμην, ὅτε με χρειὼ τόσον ἵκοι·	-- --- uu - -- uu --	dactylic hexameter	masculine penthemimeral, hepthemimeral
καὶ γὰρ ἐμοὶ νόος ἐστὶν ἐναίσιμος, οὐδέ μοι αὐτῇ	- u u- uu -u u-uu -u u --	dactylic hexameter	feminine penthemimeral, trithemimeral
θυμὸς ἐνὶ στήθεσσι σιδήρεος, ἀλλ’ ἐλεήμων.	-u u- --u u-uu - uu--	dactylic hexameter	feminine penthemimeral, trithemimeral
ὣς ἄρα φωνήσασ’ ἡγήσατο δῖα θεάων	- uu --- --uu -u u--	dactylic hexameter	masculine penthemimeral
καρπαλίμως· ὁ δ’ἔπειτα μετ’ ἴχνια βαῖνε θεοῖο.	-uu- u u-u u -uu -u u--	dactylic hexameter	feminine penthemimeral, trithemimeral
ἷξον δὲ σπεῖος γλαφυρὸν θεὸς ἠδὲ καὶ ἀνήρ,	-- - -- uu- uu -u u --	dactylic hexameter	masculine penthemimeral, hepthemimeral, trithemimeral
καί ῥ’ὁ μὲν ἔνθα καθέζετ’ ἐπὶ θρόνου ἔνθεν ἀνέστη	- u u -u u-u u- uu -u u--	dactylic hexameter	feminine penthemimeral, hepthemimeral
Ἑρμείας, νύμφη δ’ἐτίθει πάρα πᾶσαν ἐδωδήν,	--- -- uu- uu -u u--	dactylic hexameter	masculine penthemimeral, hepthemimeral, trithemimeral
ἔσθειν καὶ πίνειν, οἷα βροτοὶ ἄνδρες ἔδουσιν·	-- - -- -- uu -u u--	dactylic hexameter	masculine penthemimeral, hepthemimeral, trithemimeral
αὐτὴ δ’ἀντίον ἷζεν Ὀδυσσῆος θείοιο,	-- -uu -u u--- ---	dactylic hexameter	feminine penthemimeral
τῇ δὲ παρ’ ἀμβροσίην δμῳαὶ καὶ νέκταρ ἔθηκαν.	- u u -uu- -- - -u u--	dactylic hexameter	masculine penthemimeral, hepthemimeral
οἱ δ’ἐπ’ ὀνείαθ’ ἑτοῖμα προκείμενα χεῖρας ἴαλλον.	- u u-u u-u u-uu -u u--	dactylic hexameter	feminine penthemimeral
αὐτὰρ ἐπεὶ τάρπησαν ἐδητύος ἠδὲ ποτῆτος,	-u u- --u u-uu -u u--	dactylic hexameter	feminine penthemimeral, trithemimeral
τοῖς ἄρα μύθων ἦρχε Καλυψώ, δῖα θεάων·	- uu -- -u u-- -u u--	dactylic hexameter	feminine penthemimeral
διογενὲς Λαερτιάδη, πολυμήχαν’ Ὀδυσσεῦ,	-uu- --uu- uu-u u--	dactylic hexameter	hepthemimeral, trithemimeral
οὕτω δὴ οἶκόνδε φίλην ἐς πατρίδα γαῖαν	-- - --u u- - -uu --	dactylic hexameter	feminine penthemimeral, hepthemimeral, trithemimeral
αὐτίκα νῦν ἐθέλεις ἰέναι; σὺ δὲ χαῖρε καὶ ἔμπης.	-uu - uu- uu- u u -u u --	dactylic hexameter	masculine penthemimeral, hepthemimeral, trithemimeral
εἴ γε μὲν εἰδείης σῇσι φρεσὶν ὅσσα τοι αἶσα	- u u --- -- uu -u u --	dactylic hexameter	masculine penthemimeral, hepthemimeral
κήδε’ ἀναπλῆσαι, πρὶν πατρίδα γαῖαν ἱκέσθαι,	-u u--- - -uu -u u--	dactylic hexameter	masculine penthemimeral
ἐνθάδε κ’αὖθι μένων σὺν ἐμοὶ τόδε δῶμα φυλάσσοις	-uu -u u- u u- uu -u u--	dactylic hexameter	masculine penthemimeral, hepthemimeral
ἀθάνατός τ’εἴης, ἱμειρόμενός περ ἰδέσθαι	-uu- -- --uu- u u--	dactylic hexameter	masculine penthemimeral, trithemimeral
σὴν ἄλοχον, τῆς τ’αἰὲν ἐέλδεαι ἤματα πάντα.	- uu- - -u u-uu -uu --	dactylic hexameter	feminine penthemimeral, trithemimeral
οὐ μέν θην κείνης γε χερείων εὔχομαι εἶναι,	- - - -- u u-- -uu --	dactylic hexameter	masculine penthemimeral, trithemimeral
οὐ δέμας οὐδὲ φυήν, ἐπεὶ οὔ πως οὐδὲ ἔοικε	- uu -u u- uu - - -u u--	dactylic hexameter	masculine penthemimeral, hepthemimeral
θνητὰς ἀθανάτῃσι δέμας καὶ εἶδος ἐρίζειν.	-- -uu-u u- - -u u--	dactylic hexameter	feminine penthemimeral, hepthemimeral
τὴν δ’ἀπαμειβόμενος προσέφη πολύμητις Ὀδυσσεύς·	- uu-uu- uu- uu-u u--	dactylic hexameter	masculine penthemimeral, hepthemimeral
πότνα θεά, μή μοι τόδε χώεο· οἶδα καὶ αὐτὸς	-u u- - - uu -uu -u u --	dactylic hexameter	masculine penthemimeral, trithemimeral
πάντα μάλ’, οὕνεκα σεῖο περίφρων Πηνελόπεια	-u u -uu -u u-- -uu--	dactylic hexameter	feminine penthemimeral
εἶδος ἀκιδνοτέρη μέγεθός τ’εἰσάντα ἰδέσθαι·	-u u-uu- uu- --u u--	dactylic hexameter	masculine penthemimeral, hepthemimeral
ἡ μὲν γὰρ βροτός ἐστι, σὺ δ’ἀθάνατος καὶ ἀγήρως.	- - - uu -u u -uu- u u--	dactylic hexameter	feminine penthemimeral, trithemimeral
ἀλλὰ καὶ ὣς ἐθέλω καὶ ἐέλδομαι ἤματα πάντα	-u u - uu- u u-uu -uu --	dactylic hexameter	masculine penthemimeral, trithemimeral
οἴκαδέ τ’ἐλθέμεναι καὶ νόστιμον ἦμαρ ἰδέσθαι.	-uu -uu- - -uu -u u--	dactylic hexameter	masculine penthemimeral
εἰ δ’αὖ τις ῥαίῃσι θεῶν ἐνὶ οἴνοπι πόντῳ,	- - - --u u- uu -uu --	dactylic hexameter	feminine penthemimeral, hepthemimeral, trithemimeral
τλήσομαι ἐν στήθεσσιν ἔχων ταλαπενθέα θυμόν·	-uu - --u u- uu-uu --	dactylic hexameter	feminine penthemimeral, hepthemimeral, trithemimeral
ἤδη γὰρ μάλα πόλλ’ ἔπαθον καὶ πόλλ’ ἐμόγησα	-- - uu - uu- - - uu--	dactylic hexameter	masculine penthemimeral, hepthemimeral, trithemimeral
κύμασι καὶ πολέμῳ· μετὰ καὶ τόδε τοῖσι γενέσθω.	-uu - uu- uu - uu -u u--	dactylic hexameter	masculine penthemimeral, hepthemimeral, trithemimeral
ὣς ἔφατ’, ἠέλιος δ’ἄρ’ ἔδυ καὶ ἐπὶ κνέφας ἦλθεν·	- uu -uu- u u- u u- uu --	dactylic hexameter	masculine penthemimeral, hepthemimeral
ἐλθόντες δ’ἄρα τώ γε μυχῷ σπείους γλαφυροῖο	--- uu - u u- -- uu--	dactylic hexameter	masculine penthemimeral, hepthemimeral, trithemimeral
τερπέσθην φιλότητι, παρ’ ἀλλήλοισι μένοντες.	--- uu-u u ---u u--	dactylic hexameter	feminine penthemimeral, trithemimeral
ἦμος δ’ἠριγένεια φάνη ῥοδοδάκτυλος Ἠώς,	-- -uu-u u- uu-uu --	dactylic hexameter	feminine penthemimeral, hepthemimeral
αὐτίχ’ ὁ μὲν χλαῖνάν τε χιτῶνά τε ἕννυτ’ Ὀδυσσεύς,	-u u - -- u u-u u -u u--	dactylic hexameter	masculine penthemimeral, trithemimeral
αὐτὴ δ’ἀργύφεον φᾶρος μέγα ἕννυτο νύμφη,	-- -uu- -- uu -uu --	dactylic hexameter	masculine penthemimeral, hepthemimeral
λεπτὸν καὶ χαρίεν, περὶ δὲ ζώνην βάλετ’ ἰξυῖ	-- - uu- uu - -- uu --	dactylic hexameter	masculine penthemimeral, hepthemimeral, trithemimeral
καλὴν χρυσείην, κεφαλῇ δ’ἐπέθηκε καλύπτρην.	-- --- uu- uu-u u--	dactylic hexameter	masculine penthemimeral, hepthemimeral
καὶ τότ’ Ὀδυσσῆι μεγαλήτορι μήδετο πομπήν·	- u u--- uu-uu -uu --	dactylic hexameter	masculine penthemimeral
δῶκε μέν οἱ πέλεκυν μέγαν, ἄρμενον ἐν παλάμῃσι,	-u u - uu- uu -uu - uu--	dactylic hexameter	masculine penthemimeral, trithemimeral
χάλκεον, ἀμφοτέρωθεν ἀκαχμένον· αὐτὰρ ἐν αὐτῷ	-uu -uu-u u-uu -u u --	dactylic hexameter	feminine penthemimeral
στειλειὸν περικαλλὲς ἐλάινον, εὖ ἐναρηρός·	--- uu-u u-uu - uu--	dactylic hexameter	feminine penthemimeral, trithemimeral
δῶκε δ’ἔπειτα σκέπαρνον ἐύξοον· ἦρχε δ’ὁδοῖο	-u u-u u-u u-uu -u u--	dactylic hexameter	feminine penthemimeral
νήσου ἐπ’ ἐσχατιήν, ὅθι δένδρεα μακρὰ πεφύκει,	-u u -uu- uu -uu -u u--	dactylic hexameter	masculine penthemimeral
κλήθρη τ’αἴγειρός τ’,ἐλάτη τ’ἦν οὐρανομήκης,	-- --- uu- - -uu--	dactylic hexameter	masculine penthemimeral, hepthemimeral
αὖα πάλαι, περίκηλα, τά οἱ πλώοιεν ἐλαφρῶς.	-u u- uu-u u - --u u--	dactylic hexameter	feminine penthemimeral, hepthemimeral, trithemimeral
αὐτὰρ ἐπεὶ δὴ δεῖξ’, ὅθι δένδρεα μακρὰ πεφύκει,	-u u- - - uu -uu -u u--	dactylic hexameter	masculine penthemimeral, trithemimeral
ἡ μὲν ἔβη πρὸς δῶμα Καλυψώ, δῖα θεάων,	- u u- - -u u-- -u u--	dactylic hexameter	feminine penthemimeral, trithemimeral
αὐτὰρ ὁ τάμνετο δοῦρα· θοῶς δέ οἱ ἤνυτο ἔργον.	-u u -uu -u u- u u -uu --	dactylic hexameter	feminine penthemimeral, hepthemimeral
εἴκοσι δ’ἔκβαλε πάντα, πελέκκησεν δ’ἄρα χαλκῷ,	-uu -uu -u u--- uu --	dactylic hexameter	feminine penthemimeral
ξέσσε δ’ἐπισταμένως καὶ ἐπὶ στάθμην ἴθυνε.	-u u-uu- u u- -- ---	dactylic hexameter	masculine penthemimeral, hepthemimeral
τόφρα δ’ἔνεικε τέρετρα Καλυψώ, δῖα θεάων·	-u u-u u-u u-- -u u--	dactylic hexameter	feminine penthemimeral
τέτρηνεν δ’ἄρα πάντα καὶ ἥρμοσεν ἀλλήλοισι,	--- uu -u u -uu ----	dactylic hexameter	feminine penthemimeral, trithemimeral
γόμφοισιν δ’ἄρα τήν γε καὶ ἁρμονίῃσιν ἄρασσεν.	--- uu - u u -uu-u u--	dactylic hexameter	masculine penthemimeral, trithemimeral
ὅσσον τίς τ’ἔδαφος νηὸς τορνώσεται ἀνὴρ	-- - uu- -- --uu --	dactylic hexameter	masculine penthemimeral, hepthemimeral, trithemimeral
φορτίδος εὐρείης, ἐὺ εἰδὼς τεκτοσυνάων,	-uu --- uu -- -uu--	dactylic hexameter	masculine penthemimeral
τόσσον ἔπ’ εὐρεῖαν σχεδίην ποιήσατ’ Ὀδυσσεύς.	-u u --- uu- --u u--	dactylic hexameter	masculine penthemimeral, hepthemimeral
ἴκρια δὲ στήσας, ἀραρὼν θαμέσι σταμίνεσσι,	-uu - -- uu- uu- uu--	dactylic hexameter	masculine penthemimeral, hepthemimeral, trithemimeral
ποίει· ἀτὰρ μακρῇσιν ἐπηγκενίδεσσι τελεύτα.	-u u- --u u-uu-u u--	dactylic hexameter	feminine penthemimeral, trithemimeral
ἐν δ’ἱστὸν ποίει καὶ ἐπίκριον ἄρμενον αὐτῷ·	- -- -- u u-uu -uu --	dactylic hexameter	masculine penthemimeral, trithemimeral
πρὸς δ’ἄρα πηδάλιον ποιήσατο, ὄφρ’ ἰθύνοι.	- uu -uu- --uu - ---	dactylic hexameter	masculine penthemimeral
φράξε δέ μιν ῥίπεσσι διαμπερὲς οἰσυΐνῃσι	-u u - --u u-uu -uu--	dactylic hexameter	feminine penthemimeral, trithemimeral
κύματος εἶλαρ ἔμεν· πολλὴν δ’ἐπεχεύατο ὕλην.	-uu -u u- -- uu-uu --	dactylic hexameter	masculine penthemimeral, hepthemimeral
τόφρα δὲ φάρε’ ἔνεικε Καλυψώ, δῖα θεάων,	-u u -u u-u u-- -u u--	dactylic hexameter	feminine penthemimeral
ἱστία ποιήσασθαι· ὁ δ’εὖ τεχνήσατο καὶ τά.	-uu ---u u - --uu - -	dactylic hexameter	feminine penthemimeral, hepthemimeral
ἐν δ’ὑπέρας τε κάλους τε πόδας τ’ἐνέδησεν ἐν αὐτῇ,	- uu- u u- u u- uu-u u --	dactylic hexameter	masculine penthemimeral, hepthemimeral, trithemimeral
μοχλοῖσιν δ’ἄρα τήν γε κατείρυσεν εἰς ἅλα δῖαν.	--- uu - u u-uu - uu --	dactylic hexameter	masculine penthemimeral, trithemimeral
τέτρατον ἦμαρ ἔην, καὶ τῷ τετέλεστο ἅπαντα·	-uu -u u- - - uu-u u--	dactylic hexameter	masculine penthemimeral, hepthemimeral
τῷ δ’ἄρα πέμπτῳ πέμπ’ ἀπὸ νήσου δῖα Καλυψώ,	- uu -- - uu -- -u u--	dactylic hexameter	masculine penthemimeral
εἵματά τ’ἀμφιέσασα θυώδεα καὶ λούσασα.	-uu -uu-u u-uu - ---	dactylic hexameter	feminine penthemimeral
ἐν δέ οἱ ἀσκὸν ἔθηκε θεὰ μέλανος οἴνοιο	- u u -u u-u u- uu- ---	dactylic hexameter	feminine penthemimeral, hepthemimeral
τὸν ἕτερον, ἕτερον δ’ὕδατος μέγαν, ἐν δὲ καὶ ηἴα	- uu- uu- uu- uu - u u --	dactylic hexameter	masculine penthemimeral, hepthemimeral, trithemimeral
κωρύκῳ· ἐν δέ οἱ ὄψα τίθει μενοεικέα πολλά·	-uu - u u -u u- uu-uu --	dactylic hexameter	feminine penthemimeral, hepthemimeral, trithemimeral
οὖρον δὲ προέηκεν ἀπήμονά τε λιαρόν τε.	-- - uu-u u-uu - uu- -	dactylic hexameter	feminine penthemimeral, trithemimeral
γηθόσυνος δ’οὔρῳ πέτασ’ ἱστία δῖος Ὀδυσσεύς.	-uu- -- uu -uu -u u--	dactylic hexameter	masculine penthemimeral, trithemimeral
αὐτὰρ ὁ πηδαλίῳ ἰθύνετο τεχνηέντως	-u u -uu- --uu ----	dactylic hexameter	masculine penthemimeral
ἥμενος, οὐδέ οἱ ὕπνος ἐπὶ βλεφάροισιν ἔπιπτε	-uu -u u -u u- uu-u u--	dactylic hexameter	feminine penthemimeral, hepthemimeral
Πληιάδας τ’ἐσορῶντι καὶ ὀψὲ δύοντα Βοώτην	-uu- uu-u u -u u-u u--	dactylic hexameter	feminine penthemimeral, trithemimeral
Ἄρκτον θ’,ἣν καὶ ἄμαξαν ἐπίκλησιν καλέουσιν,	-- - u u-u u--- uu--	dactylic hexameter	feminine penthemimeral, trithemimeral
ἥ τ’αὐτοῦ στρέφεται καί τ’Ὠρίωνα δοκεύει,	- -- uu- - ---u u--	dactylic hexameter	masculine penthemimeral, trithemimeral
οἴη δ’ἄμμορός ἐστι λοετρῶν Ὠκεανοῖο·	-- -uu -u u-- -uu--	dactylic hexameter	feminine penthemimeral
τὴν γὰρ δή μιν ἄνωγε Καλυψώ, δῖα θεάων,	- - - u u-u u-- -u u--	dactylic hexameter	feminine penthemimeral, trithemimeral
ποντοπορευέμεναι ἐπ’ ἀριστερὰ χειρὸς ἔχοντα.	-uu-uu- u u-uu -u u--	dactylic hexameter	masculine penthemimeral
ἑπτὰ δὲ καὶ δέκα μὲν πλέεν ἤματα ποντοπορεύων,	-u u - uu - uu -uu -uu--	dactylic hexameter	masculine penthemimeral, trithemimeral
ὀκτωκαιδεκάτῃ δ’ἐφάνη ὄρεα σκιόεντα	---uu- uu- uu- uu--	dactylic hexameter	masculine penthemimeral, hepthemimeral
γαίης Φαιήκων, ὅθι τ’ἄγχιστον πέλεν αὐτῷ·	-- --- uu --- uu --	dactylic hexameter	masculine penthemimeral
εἴσατο δ’ὡς ὅτε ῥινὸν ἐν ἠεροειδέι πόντῳ.	-uu - uu -u u -uu-uu --	dactylic hexameter	feminine penthemimeral, trithemimeral
τὸν δ’ἐξ Αἰθιόπων ἀνιὼν κρείων ἐνοσίχθων	- - -uu- uu- -- uu--	dactylic hexameter	masculine penthemimeral, hepthemimeral
τηλόθεν ἐκ Σολύμων ὀρέων ἴδεν· εἴσατο γάρ οἱ	-uu - uu- uu- uu -uu - -	dactylic hexameter	masculine penthemimeral, hepthemimeral, trithemimeral
πόντον ἐπιπλείων. ὁ δ’ἐχώσατο κηρόθι μᾶλλον,	-u u--- u u-uu -uu --	dactylic hexameter	masculine penthemimeral
κινήσας δὲ κάρη προτὶ ὃν μυθήσατο θυμόν·	--- u u- uu - --uu --	dactylic hexameter	masculine penthemimeral, hepthemimeral, trithemimeral
ὢ πόποι, ἦ μάλα δὴ μετεβούλευσαν θεοὶ ἄλλως	- uu - uu - uu--- uu --	dactylic hexameter	masculine penthemimeral, trithemimeral
ἀμφ’ Ὀδυσῆι ἐμεῖο μετ’ Αἰθιόπεσσιν ἐόντος,	- uu-u u-u u -uu-u u--	dactylic hexameter	feminine penthemimeral
καὶ δὴ Φαιήκων γαίης σχεδόν, ἔνθα οἱ αἶσα	- - --- -- uu -u u --	dactylic hexameter	masculine penthemimeral, hepthemimeral
ἐκφυγέειν μέγα πεῖραρ ὀιζύος, ἥ μιν ἱκάνει.	-uu- uu -u u-uu - u u--	dactylic hexameter	feminine penthemimeral, trithemimeral
ἀλλ’ ἔτι μέν μίν φημι ἅδην ἐλάαν κακότητος.	- uu - - -u u- uu- uu--	dactylic hexameter	feminine penthemimeral, hepthemimeral, trithemimeral
ὣς εἰπὼν σύναγεν νεφέλας, ἐτάραξε δὲ πόντον	- -- uu- uu- uu-u u --	dactylic hexameter	masculine penthemimeral, hepthemimeral, trithemimeral
χερσὶ τρίαιναν ἑλών· πάσας δ’ὀρόθυνεν ἀέλλας	-u u-u u- -- uu-u u--	dactylic hexameter	masculine penthemimeral, hepthemimeral
παντοίων ἀνέμων, σὺν δὲ νεφέεσσι κάλυψε	--- uu- - - uu-u u--	dactylic hexameter	masculine penthemimeral, hepthemimeral, trithemimeral
γαῖαν ὁμοῦ καὶ πόντον· ὀρώρει δ’οὐρανόθεν νύξ.	-u u- - -u u-- -uu- -	dactylic hexameter	feminine penthemimeral, trithemimeral
σὺν δ’Εὖρός τε Νότος τ’ἔπεσον Ζέφυρός τε δυσαὴς	- -- u u- uu- uu- u u--	dactylic hexameter	masculine penthemimeral, hepthemimeral, trithemimeral
καὶ Βορέης αἰθρηγενέτης, μέγα κῦμα κυλίνδων.	- uu- --uu- uu -u u--	dactylic hexameter	hepthemimeral, trithemimeral
καὶ τότ’ Ὀδυσσῆος λύτο γούνατα καὶ φίλον ἦτορ,	- u u--- uu -uu - uu --	dactylic hexameter	masculine penthemimeral
ὀχθήσας δ’ἄρα εἶπε πρὸς ὃν μεγαλήτορα θυμόν·	--- uu -u u - uu-uu --	dactylic hexameter	feminine penthemimeral, hepthemimeral, trithemimeral
ὤ μοι ἐγὼ δειλός, τί νύ μοι μήκιστα γένηται;	- u u- -- u u - --u u--	dactylic hexameter	masculine penthemimeral, hepthemimeral, trithemimeral
δείδω μὴ δὴ πάντα θεὰ νημερτέα εἶπεν,	-- - - -u u- --uu --	dactylic hexameter	feminine penthemimeral, hepthemimeral, trithemimeral
ἥ μ’ἔφατ’ ἐν πόντῳ, πρὶν πατρίδα γαῖαν ἱκέσθαι,	- uu - -- - -uu -u u--	dactylic hexameter	masculine penthemimeral, trithemimeral
ἄλγε’ ἀναπλήσειν· τάδὲ δὴ νῦν πάντα τελεῖται.	-u u--- uu - - -u u--	dactylic hexameter	masculine penthemimeral, hepthemimeral
οἵοισιν νεφέεσσι περιστέφει οὐρανὸν εὐρὺν	--- uu-u u-uu -uu --	dactylic hexameter	feminine penthemimeral, trithemimeral
Ζεύς, ἐτάραξε δὲ πόντον, ἐπισπέρχουσι δ’ἄελλαι	- uu-u u -u u---u u--	dactylic hexameter	feminine penthemimeral
παντοίων ἀνέμων. νῦν μοι σῶς αἰπὺς ὄλεθρος.	--- uu- - - - -u u--	dactylic hexameter	masculine penthemimeral, hepthemimeral, trithemimeral
τρὶς μάκαρες Δαναοὶ καὶ τετράκις, οἳ τότ’ ὄλοντο	- uu- uu- - -uu - u u--	dactylic hexameter	masculine penthemimeral, trithemimeral
Τροίῃ ἐν εὐρείῃ χάριν Ἀτρεΐδῃσι φέροντες.	-u u --- uu -uu-u u--	dactylic hexameter	masculine penthemimeral
ὡς δὴ ἔγωγ’ ὄφελον θανέειν καὶ πότμον ἐπισπεῖν	- u u- uu- uu- - -u u--	dactylic hexameter	masculine penthemimeral, hepthemimeral, trithemimeral
ἤματι τῷ ὅτε μοι πλεῖστοι χαλκήρεα δοῦρα	-uu - uu - -- --uu --	dactylic hexameter	masculine penthemimeral, hepthemimeral, trithemimeral
Τρῶες ἐπέρριψαν περὶ Πηλεΐωνι θανόντι.	-u u--- uu -uu-u u--	dactylic hexameter	masculine penthemimeral
τῶ κ’ἔλαχον κτερέων, καί μευ κλέος ἦγον Ἀχαιοί·	- uu- uu- - - uu -u u--	dactylic hexameter	masculine penthemimeral, hepthemimeral, trithemimeral
νῦν δέ με λευγαλέῳ θανάτῳ εἵμαρτο ἁλῶναι.	- u u -uu- uu- --u u--	dactylic hexameter	masculine penthemimeral, hepthemimeral
ὣς ἄρα μιν εἰπόντ’ ἔλασεν μέγα κῦμα κατ’ ἄκρης	- uu - -- uu- uu -u u --	dactylic hexameter	masculine penthemimeral, hepthemimeral, trithemimeral
δεινὸν ἐπεσσύμενον, περὶ δὲ σχεδίην ἐλέλιξε.	-u u-uu- uu - uu- uu--	dactylic hexameter	masculine penthemimeral, hepthemimeral
τῆλε δ’ἀπὸ σχεδίης αὐτὸς πέσε, πηδάλιον δὲ	-u u- uu- -- uu -uu- -	dactylic hexameter	masculine penthemimeral, hepthemimeral, trithemimeral
ἐκ χειρῶν προέηκε· μέσον δέ οἱ ἱστὸν ἔαξε	- -- uu-u u- u u -u u--	dactylic hexameter	feminine penthemimeral, hepthemimeral, trithemimeral
δεινὴ μισγομένων ἀνέμων ἐλθοῦσα θύελλα,	-- -uu- uu- --u u--	dactylic hexameter	masculine penthemimeral, hepthemimeral
τηλοῦ δὲ σπεῖρον καὶ ἐπίκριον ἔμπεσε πόντῳ.	-- - -- u u-uu -uu --	dactylic hexameter	masculine penthemimeral, trithemimeral
τὸν δ’ἄρ’ ὑπόβρυχα θῆκε πολὺν χρόνον, οὐδὲ δυνάσθη	- u u-uu -u u- uu -u u--	dactylic hexameter	feminine penthemimeral, hepthemimeral
αἶψα μάλ’ ἀνσχεθέειν μεγάλου ὑπὸ κύματος ὁρμῆς·	-u u -uu- uu- uu -uu --	dactylic hexameter	masculine penthemimeral, hepthemimeral
εἵματα γάρ ἐβάρυνε, τά οἱ πόρε δῖα Καλυψώ.	-uu - uu-u u - uu -u u--	dactylic hexameter	feminine penthemimeral, hepthemimeral, trithemimeral
ὀψὲ δὲ δή ῥ’ἀνέδυ, στόματος δ’ἐξέπτυσεν ἅλμην	-u u - uu- uu- --uu --	dactylic hexameter	masculine penthemimeral, hepthemimeral, trithemimeral
πικρήν, ἥ οἱ πολλὴ ἀπὸ κρατὸς κελάρυζεν.	-- - - -u u- -- uu--	dactylic hexameter	feminine penthemimeral, hepthemimeral, trithemimeral
ἀλλ’ οὐδ’ ὣς σχεδίης ἐπελήθετο, τειρόμενός περ,	- - - uu- uu-uu -uu- -	dactylic hexameter	masculine penthemimeral, trithemimeral
ἀλλὰ μεθορμηθεὶς ἐνὶ κύμασιν ἐλλάβετ’ αὐτῆς,	-u u--- uu -uu -uu --	dactylic hexameter	masculine penthemimeral
ἐν μέσσῃ δ’ἐκαθῖζε τέλος θανάτου ἀλεείνων.	- -- uu-u u- uu- uu--	dactylic hexameter	feminine penthemimeral, hepthemimeral, trithemimeral
τὴν δ’ἐφόρει μέγα κῦμα κατὰ ῥόον ἔνθα καὶ ἔνθα.	- uu- uu -u u- uu -u u --	dactylic hexameter	feminine penthemimeral, hepthemimeral, trithemimeral
ὡς δ’ὅτ’ ὀπωρινὸς Βορέης φορέῃσιν ἀκάνθας	- u u--- uu- uu-u u--	dactylic hexameter	masculine penthemimeral, hepthemimeral
ἂμ πεδίον, πυκιναὶ δὲ πρὸς ἀλλήλῃσιν ἔχονται,	- uu- uu- u u ---u u--	dactylic hexameter	masculine penthemimeral, trithemimeral
ὣς τὴν ἂμ πέλαγος ἄνεμοι φέρον ἔνθα καὶ ἔνθα·	- - - uu- uu- uu -u u --	dactylic hexameter	masculine penthemimeral, hepthemimeral, trithemimeral
ἄλλοτε μέν τε Νότος Βορέῃ προβάλεσκε φέρεσθαι,	-uu - u u- uu- uu-u u--	dactylic hexameter	masculine penthemimeral, hepthemimeral, trithemimeral
ἄλλοτε δ’αὖτ’ Εὖρος Ζεφύρῳ εἴξασκε διώκειν.	-uu - -- uu- --u u--	dactylic hexameter	masculine penthemimeral, hepthemimeral, trithemimeral
τὸν δὲ ἴδεν Κάδμου θυγάτηρ, καλλίσφυρος Ἰνώ,	- u u- -- uu- --uu --	dactylic hexameter	masculine penthemimeral, hepthemimeral, trithemimeral
Λευκοθέη, ἣ πρὶν μὲν ἔην βροτὸς αὐδήεσσα,	-uu- - - u u- uu ----	dactylic hexameter	masculine penthemimeral, hepthemimeral, trithemimeral
νῦν δ’ἁλὸς ἐν πελάγεσσι θεῶν ἒξ ἔμμορε τιμῆς.	- uu - uu-u u- - -uu --	dactylic hexameter	feminine penthemimeral, hepthemimeral, trithemimeral
ἥ ῥ’Ὀδυσῆ’ ἐλέησεν ἀλώμενον, ἄλγε’ ἔχοντα,	- uu- uu-u u-uu -u u--	dactylic hexameter	feminine penthemimeral, trithemimeral
αἰθυίῃ δ’ἐικυῖα ποτῇ ἀνεδύσατο λίμνης,	--- uu-u u- uu-uu --	dactylic hexameter	feminine penthemimeral, hepthemimeral, trithemimeral
ἷζε δ’ἐπὶ σχεδίης καί μιν πρὸς μῦθον ἔειπε·	-u u- uu- - - - -u u--	dactylic hexameter	masculine penthemimeral, hepthemimeral, trithemimeral
κάμμορε, τίπτε τοι ὧδε Ποσειδάων ἐνοσίχθων	-uu -u u -u u--- uu--	dactylic hexameter	feminine penthemimeral
ὠδύσατ’ ἐκπάγλως, ὅτι τοι κακὰ πολλὰ φυτεύει;	-uu --- uu - uu -u u--	dactylic hexameter	masculine penthemimeral, hepthemimeral
οὐ μὲν δή σε καταφθίσει μάλα περ μενεαίνων.	- - - u u--- uu - uu--	dactylic hexameter	hepthemimeral, trithemimeral
ἀλλὰ μάλ’ ὧδ’ ἔρξαι, δοκέεις δέ μοι οὐκ ἀπινύσσειν·	-u u - -- uu- u u - uu--	dactylic hexameter	masculine penthemimeral, hepthemimeral, trithemimeral
εἵματα ταῦτ’ ἀποδὺς σχεδίην ἀνέμοισι φέρεσθαι	-uu - uu- uu- uu-u u--	dactylic hexameter	masculine penthemimeral, hepthemimeral, trithemimeral
κάλλιπ’, ἀτὰρ χείρεσσι νέων ἐπιμαίεο νόστου	-u u- --u u- uu-uu --	dactylic hexameter	feminine penthemimeral, hepthemimeral, trithemimeral
γαίης Φαιήκων, ὅθι τοι μοῖρ’ ἐστὶν ἀλύξαι.	-- --- uu - - -u u--	dactylic hexameter	masculine penthemimeral, hepthemimeral
τῆ δέ, τόδε κρήδεμνον ὑπὸ στέρνοιο τανύσσαι	- u u- --u u- --u u--	dactylic hexameter	feminine penthemimeral, hepthemimeral, trithemimeral
ἄμβροτον· οὐδέ τί τοι παθέειν δέος οὐδ’ ἀπολέσθαι.	-uu -u u - uu- uu - uu--	dactylic hexameter	masculine penthemimeral, hepthemimeral
αὐτὰρ ἐπὴν χείρεσσιν ἐφάψεαι ἠπείροιο,	-u u- --u u-uu ----	dactylic hexameter	feminine penthemimeral, trithemimeral
ἂψ ἀπολυσάμενος βαλέειν εἰς οἴνοπα πόντον	- uu-uu- uu- - -uu --	dactylic hexameter	masculine penthemimeral, hepthemimeral
πολλὸν ἀπ’ ἠπείρου, αὐτὸς δ’ἀπονόσφι τραπέσθαι.	-u u --- -- uu-u u--	dactylic hexameter	masculine penthemimeral, hepthemimeral
ὣς ἄρα φωνήσασα θεὰ κρήδεμνον ἔδωκεν,	- uu ---u u- --u u--	dactylic hexameter	feminine penthemimeral, hepthemimeral
αὐτὴ δ’ἂψ ἐς πόντον ἐδύσατο κυμαίνοντα	-- - - -u u-uu ----	dactylic hexameter	feminine penthemimeral, trithemimeral
αἰθυίῃ ἐικυῖα· μέλαν δέ ἑ κῦμ’ ἐκάλυψεν.	--- uu-u u- u u - uu--	dactylic hexameter	feminine penthemimeral, hepthemimeral, trithemimeral
αὐτὰρ ὁ μερμήριξε πολύτλας δῖος Ὀδυσσεύς,	-u u ---u u-- -u u--	dactylic hexameter	feminine penthemimeral
ὀχθήσας δ’ἄρα εἶπε πρὸς ὃν μεγαλήτορα θυμόν·	--- uu -u u - uu-uu --	dactylic hexameter	feminine penthemimeral, hepthemimeral, trithemimeral
ὤ μοι ἐγώ, μή τίς μοι ὑφαίνῃσιν δόλον αὖτε	- u u- - - u u--- uu --	dactylic hexameter	masculine penthemimeral, trithemimeral
ἀθανάτων, ὅτε με σχεδίης ἀποβῆναι ἀνώγει.	-uu- uu - uu- uu-u u--	dactylic hexameter	masculine penthemimeral, hepthemimeral, trithemimeral
ἀλλὰ μάλ’ οὔ πω πείσομ’, ἐπεὶ ἑκὰς ὀφθαλμοῖσι	-u u - - -u u- uu ----	dactylic hexameter	feminine penthemimeral, hepthemimeral, trithemimeral
γαῖαν ἐγὼν ἰδόμην, ὅθι μοι φάτο φύξιμον εἶναι.	-u u- uu- uu - uu -uu --	dactylic hexameter	masculine penthemimeral, hepthemimeral, trithemimeral
ἀλλὰ μάλ’ ὧδ’ ἔρξω, δοκέει δέ μοι εἶναι ἄριστον·	-u u - -- uu- u u -u u--	dactylic hexameter	masculine penthemimeral, hepthemimeral, trithemimeral
ὄφρ’ ἂν μέν κεν δούρατ’ ἐν ἁρμονίῃσιν ἀρήρῃ,	- - - - -u u -uu-u u--	dactylic hexameter	feminine penthemimeral, trithemimeral
τόφρ’ αὐτοῦ μενέω καὶ τλήσομαι ἄλγεα πάσχων·	- -- uu- - -uu -uu --	dactylic hexameter	masculine penthemimeral, trithemimeral
αὐτὰρ ἐπὴν δή μοι σχεδίην διὰ κῦμα τινάξῃ,	-u u- - - uu- uu -u u--	dactylic hexameter	masculine penthemimeral, hepthemimeral, trithemimeral
νήξομ’, ἐπεὶ οὐ μέν τι πάρα προνοῆσαι ἄμεινον.	-u u- - - u u- uu-u u--	dactylic hexameter	masculine penthemimeral, hepthemimeral, trithemimeral
ἦος ὁ ταῦθ’ ὥρμαινε κατὰ φρένα καὶ κατὰ θυμόν,	-u u - --u u- uu - uu --	dactylic hexameter	feminine penthemimeral, hepthemimeral, trithemimeral
ὦρσε δ’ἐπὶ μέγα κῦμα Ποσειδάων ἐνοσίχθων,	-u u- uu -u u--- uu--	dactylic hexameter	feminine penthemimeral, trithemimeral
δεινόν τ’ἀργαλέον τε, κατηρεφές, ἤλασε δ’αὐτόν.	-- -uu- u u-uu -uu --	dactylic hexameter	masculine penthemimeral
ὡς δ’ἄνεμος ζαὴς ηἴων θημῶνα τινάξῃ	- uu- -- -- --u u--	dactylic hexameter	masculine penthemimeral, hepthemimeral, trithemimeral
καρφαλέων· τὰ μὲν ἄρ τε διεσκέδασ’ ἄλλυδις ἄλλῃ·	-uu- u u - u u-uu -uu --	dactylic hexameter	masculine penthemimeral, trithemimeral
ὣς τῆς δούρατα μακρὰ διεσκέδασ’. αὐτὰρ Ὀδυσσεὺς	- - -uu -u u-uu -u u--	dactylic hexameter	feminine penthemimeral
ἀμφ’ ἑνὶ δούρατι βαῖνε, κέληθ’ ὡς ἵππον ἐλαύνων,	- uu -uu -u u- - -u u--	dactylic hexameter	feminine penthemimeral, hepthemimeral
εἵματα δ’ἐξαπέδυνε, τά οἱ πόρε δῖα Καλυψώ.	-uu -uu-u u - uu -u u--	dactylic hexameter	feminine penthemimeral, hepthemimeral
αὐτίκα δὲ κρήδεμνον ὑπὸ στέρνοιο τάνυσσεν,	-uu - --u u- --u u--	dactylic hexameter	feminine penthemimeral, hepthemimeral, trithemimeral
αὐτὸς δὲ πρηνὴς ἁλὶ κάππεσε, χεῖρε πετάσσας,	-- - -- uu -uu -u u--	dactylic hexameter	masculine penthemimeral, trithemimeral
νηχέμεναι μεμαώς. ἴδε δὲ κρείων ἐνοσίχθων,	-uu- uu- uu - -- uu--	dactylic hexameter	masculine penthemimeral, hepthemimeral, trithemimeral
κινήσας δὲ κάρη προτὶ ὃν μυθήσατο θυμόν·	--- u u- uu - --uu --	dactylic hexameter	masculine penthemimeral, hepthemimeral, trithemimeral
οὕτω νῦν κακὰ πολλὰ παθὼν ἀλόω κατὰ πόντον,	-- - uu -u u- uu- uu --	dactylic hexameter	feminine penthemimeral, hepthemimeral, trithemimeral
εἰς ὅ κεν ἀνθρώποισι διοτρεφέεσσι μιγήῃς.	- u u ---u u-uu-u u--	dactylic hexameter	feminine penthemimeral
ἀλλ’ οὐδ’ ὥς σε ἔολπα ὀνόσσεσθαι κακότητος.	- - - u u-u u--- uu--	dactylic hexameter	feminine penthemimeral, trithemimeral
ὣς ἄρα φωνήσας ἵμασεν καλλίτριχας ἵππους,	- uu --- uu- --uu --	dactylic hexameter	masculine penthemimeral, hepthemimeral
ἵκετο δ’εἰς Αἰγάς, ὅθι οἱ κλυτὰ δώματ’ ἔασιν.	-uu - -- uu - uu -u u--	dactylic hexameter	masculine penthemimeral, hepthemimeral, trithemimeral
αὐτὰρ Ἀθηναίη κούρη Διὸς ἄλλ’ ἐνόησεν.	-u u--- -- uu - uu--	dactylic hexameter	masculine penthemimeral, hepthemimeral
ἤτοι τῶν ἄλλων ἀνέμων κατέδησε κελεύθους,	-- - -- uu- uu-u u--	dactylic hexameter	masculine penthemimeral, hepthemimeral, trithemimeral
παύσασθαι δ’ἐκέλευσε καὶ εὐνηθῆναι ἅπαντας·	--- uu-u u ---u u--	dactylic hexameter	feminine penthemimeral, trithemimeral
ὦρσε δ’ἐπὶ κραιπνὸν Βορέην, πρὸ δὲ κύματ’ ἔαξεν,	-u u- -- uu- u u -u u--	dactylic hexameter	masculine penthemimeral, hepthemimeral, trithemimeral
ἕως ὅ γε Φαιήκεσσι φιληρέτμοισι μιγείη	- u u ---u u---u u--	dactylic hexameter	feminine penthemimeral
διογενὴς Ὀδυσεὺς θάνατον καὶ κῆρας ἀλύξας.	-uu- uu- uu- - -u u--	dactylic hexameter	masculine penthemimeral, hepthemimeral, trithemimeral
ἔνθα δύω νύκτας δύο τ’ἤματα κύματι πηγῷ	-u u- -- uu -uu -uu --	dactylic hexameter	masculine penthemimeral, trithemimeral
πλάζετο, πολλὰ δέ οἱ κραδίη προτιόσσετ’ ὄλεθρον.	-uu -u u - uu- uu-u u--	dactylic hexameter	masculine penthemimeral, hepthemimeral
ἀλλ’ ὅτε δὴ τρίτον ἦμαρ ἐυπλόκαμος τέλεσ’ Ἠώς,	- uu - uu -u u-uu- uu --	dactylic hexameter	feminine penthemimeral, trithemimeral
καὶ τότ’ ἔπειτ’ ἄνεμος μὲν ἐπαύσατο ἠδὲ γαλήνη	- u u- uu- u u-uu -u u--	dactylic hexameter	masculine penthemimeral, trithemimeral
ἔπλετο νηνεμίη· ὁ δ’ἄρα σχεδὸν εἴσιδε γαῖαν	-uu -uu- u u- uu -uu --	dactylic hexameter	masculine penthemimeral, hepthemimeral
ὀξὺ μάλα προϊδών, μεγάλου ὑπὸ κύματος ἀρθείς.	-u u- uu- uu- uu -uu --	dactylic hexameter	masculine penthemimeral, hepthemimeral, trithemimeral
ὡς δ’ὅτ’ ἂν ἀσπάσιος βίοτος παίδεσσι φανήῃ	- u u -uu- uu- --u u--	dactylic hexameter	masculine penthemimeral, hepthemimeral
πατρός, ὃς ἐν νούσῳ κεῖται κρατέρ’ ἄλγεα πάσχων,	-u u - -- -- uu -uu --	dactylic hexameter	masculine penthemimeral, hepthemimeral, trithemimeral
δηρὸν τηκόμενος, στυγερὸς δέ οἱ ἔχραε δαίμων,	-- -uu- uu- u u -uu --	dactylic hexameter	masculine penthemimeral, hepthemimeral
ἀσπάσιον δ’ἄρα τόν γε θεοὶ κακότητος ἔλυσαν,	-uu- uu - u u- uu-u u--	dactylic hexameter	masculine penthemimeral, hepthemimeral, trithemimeral
ὣς Ὀδυσῆ’ ἀσπαστὸν ἐείσατο γαῖα καὶ ὕλη,	- uu- --u u-uu -u u --	dactylic hexameter	feminine penthemimeral, trithemimeral
νῆχε δ’ἐπειγόμενος ποσὶν ἠπείρου ἐπιβῆναι.	-u u-uu- uu --- uu--	dactylic hexameter	masculine penthemimeral
ἀλλ’ ὅτε τόσσον ἀπῆν ὅσσον τε γέγωνε βοήσας,	- uu -u u- -- u u-u u--	dactylic hexameter	masculine penthemimeral, hepthemimeral
καὶ δὴ δοῦπον ἄκουσε ποτὶ σπιλάδεσσι θαλάσσης·	- - -u u-u u- uu-u u--	dactylic hexameter	feminine penthemimeral, hepthemimeral
ῥόχθει γὰρ μέγα κῦμα ποτὶ ξερὸν ἠπείροιο	-- - uu -u u- uu ----	dactylic hexameter	feminine penthemimeral, hepthemimeral, trithemimeral
δεινὸν ἐρευγόμενον, εἴλυτο δὲ πάνθ’ ἁλὸς ἄχνῃ·	-u u-uu- --u u - uu --	dactylic hexameter	masculine penthemimeral
οὐ γὰρ ἔσαν λιμένες νηῶν ὄχοι, οὐδ’ ἐπιωγαί.	- u u- uu- -- uu - uu--	dactylic hexameter	masculine penthemimeral, hepthemimeral, trithemimeral
ἀλλ’ ἀκταὶ προβλῆτες ἔσαν σπιλάδες τε πάγοι τε·	- -- --u u- uu- u u- -	dactylic hexameter	feminine penthemimeral, hepthemimeral, trithemimeral
καὶ τότ’ Ὀδυσσῆος λύτο γούνατα καὶ φίλον ἦτορ,	- u u--- uu -uu - uu --	dactylic hexameter	masculine penthemimeral
ὀχθήσας δ’ἄρα εἶπε πρὸς ὃν μεγαλήτορα θυμόν·	--- uu -u u - uu-uu --	dactylic hexameter	feminine penthemimeral, hepthemimeral, trithemimeral
ὤ μοι, ἐπεὶ δὴ γαῖαν ἀελπέα δῶκεν ἰδέσθαι	- u u- - -u u-uu -u u--	dactylic hexameter	feminine penthemimeral, trithemimeral
Ζεύς, καὶ δὴ τόδε λαῖτμα διατμήξας ἐτέλεσσα,	- - - uu -u u--- uu--	dactylic hexameter	feminine penthemimeral, trithemimeral
ἔκβασις οὔ πῃ φαίνεθ’ ἁλὸς πολιοῖο θύραζε·	-uu - - -u u- uu-u u--	dactylic hexameter	feminine penthemimeral, hepthemimeral, trithemimeral
ἔκτοσθεν μὲν γὰρ πάγοι ὀξέες, ἀμφὶ δὲ κῦμα	--- - - uu -uu -u u --	dactylic hexameter	masculine penthemimeral, trithemimeral
βέβρυχεν ῥόθιον, λισσὴ δ’ἀναδέδρομε πέτρη,	--- uu- -- uu-uu --	dactylic hexameter	masculine penthemimeral, hepthemimeral, trithemimeral
ἀγχιβαθὴς δὲ θάλασσα, καὶ οὔ πως ἔστι πόδεσσι	-uu- u u-u u - - -u u--	dactylic hexameter	feminine penthemimeral, hepthemimeral, trithemimeral
στήμεναι ἀμφοτέροισι καὶ ἐκφυγέειν κακότητα·	-uu -uu-u u -uu- uu--	dactylic hexameter	feminine penthemimeral
μή πώς μ’ἐκβαίνοντα βάλῃ λίθακι ποτὶ πέτρῃ	- - ---u u- uu- uu --	dactylic hexameter	feminine penthemimeral, hepthemimeral
κῦμα μέγ’ ἁρπάξαν· μελέη δέ μοι ἔσσεται ὁρμή.	-u u --- uu- u u -uu --	dactylic hexameter	masculine penthemimeral, hepthemimeral
εἰ δέ κ’ἔτι προτέρω παρανήξομαι, ἤν που ἐφεύρω	- u u- uu- uu-uu - u u--	dactylic hexameter	masculine penthemimeral, trithemimeral
ἠιόνας τε παραπλῆγας λιμένας τε θαλάσσης,	-uu- u u--- uu- u u--	dactylic hexameter	hepthemimeral, trithemimeral
δείδω μή μ’ἐξαῦτις ἀναρπάξασα θύελλα	-- - --u u---u u--	dactylic hexameter	feminine penthemimeral, trithemimeral
πόντον ἐπ’ ἰχθυόεντα φέρῃ βαρέα στενάχοντα,	-u u -uu-u u- uu- uu--	dactylic hexameter	feminine penthemimeral, hepthemimeral
ἠέ τί μοι καὶ κῆτος ἐπισσεύῃ μέγα δαίμων	-u u - - -u u--- uu --	dactylic hexameter	feminine penthemimeral, trithemimeral
ἐξ ἁλός, οἷά τε πολλὰ τρέφει κλυτὸς Ἀμφιτρίτη·	- uu -u u -u u- uu ----	dactylic hexameter	feminine penthemimeral, hepthemimeral
οἶδα γάρ, ὥς μοι ὀδώδυσται κλυτὸς ἐννοσίγαιος.	-u u - u u--- uu -uu--	dactylic hexameter	hepthemimeral, trithemimeral
ἦος ὁ ταῦθ’ ὥρμαινε κατὰ φρένα καὶ κατὰ θυμόν,	-u u - --u u- uu - uu --	dactylic hexameter	feminine penthemimeral, hepthemimeral, trithemimeral
τόφρα δέ μιν μέγα κῦμα φέρεν τρηχεῖαν ἐπ’ ἀκτήν.	-u u - uu -u u- --u u --	dactylic hexameter	feminine penthemimeral, hepthemimeral, trithemimeral
ἔνθα κ’ἀπὸ ῥινοὺς δρύφθη, σὺν δ’ὀστέ’ ἀράχθη,	-- -u u- -- - -u u--	dactylic hexameter	masculine penthemimeral, hepthemimeral
εἰ μὴ ἐπὶ φρεσὶ θῆκε θεά, γλαυκῶπις Ἀθήνη·	- u u- uu -u u- --u u--	dactylic hexameter	feminine penthemimeral, hepthemimeral, trithemimeral
ἀμφοτέρῃσι δὲ χερσὶν ἐπεσσύμενος λάβε πέτρης,	-uu-u u -u u-uu- uu --	dactylic hexameter	feminine penthemimeral
τῆς ἔχετο στενάχων, εἵως μέγα κῦμα παρῆλθε.	- uu- uu- -- uu -u u--	dactylic hexameter	masculine penthemimeral, hepthemimeral, trithemimeral
καὶ τὸ μὲν ὣς ὑπάλυξε, παλιρρόθιον δέ μιν αὖτις	- u u - uu-u u-uu- u u --	dactylic hexameter	feminine penthemimeral, trithemimeral
πλῆξεν ἐπεσσύμενον, τηλοῦ δέ μιν ἔμβαλε πόντῳ.	-u u-uu- -- u u -uu --	dactylic hexameter	masculine penthemimeral, hepthemimeral
ὡς δ’ὅτε πουλύποδος θαλάμης ἐξελκομένοιο	- uu -uu- uu- --uu--	dactylic hexameter	masculine penthemimeral, hepthemimeral
πρὸς κοτυληδονόφιν πυκιναὶ λάιγγες ἔχονται,	- uu-uu- uu- --u u--	dactylic hexameter	masculine penthemimeral, hepthemimeral
ὣς τοῦ πρὸς πέτρῃσι θρασειάων ἀπὸ χειρῶν	- - - --u u--- uu --	dactylic hexameter	feminine penthemimeral, trithemimeral
ῥινοὶ ἀπέδρυφθεν· τὸν δὲ μέγα κῦμ’ ἐκάλυψεν.	-u u--- - - uu - uu--	dactylic hexameter	masculine penthemimeral, hepthemimeral
ἔνθα κε δὴ δύστηνος ὑπὲρ μόρον ὤλετ’ Ὀδυσσεύς,	-u u - --u u- uu -u u--	dactylic hexameter	feminine penthemimeral, hepthemimeral, trithemimeral
εἰ μὴ ἐπιφροσύνην δῶκε γλαυκῶπις Ἀθήνη.	- u u-uu- -- --u u--	dactylic hexameter	masculine penthemimeral, hepthemimeral
κύματος ἐξαναδύς, τά τ’ἐρεύγεται ἤπειρόνδε,	-uu -uu- u u-uu ----	dactylic hexameter	masculine penthemimeral
νῆχε παρέξ, ἐς γαῖαν ὁρώμενος, εἴ που ἐφεύροι	-u u- - -u u-uu - u u--	dactylic hexameter	feminine penthemimeral, trithemimeral
ἠιόνας τε παραπλῆγας λιμένας τε θαλάσσης.	-uu- u u--- uu- u u--	dactylic hexameter	hepthemimeral, trithemimeral
ἀλλ’ ὅτε δὴ ποταμοῖο κατὰ στόμα καλλιρόοιο	- uu - uu-u u- uu -uu--	dactylic hexameter	feminine penthemimeral, hepthemimeral, trithemimeral
ἷξε νέων, τῇ δή οἱ ἐείσατο χῶρος ἄριστος,	-u u- - - u u-uu -u u--	dactylic hexameter	masculine penthemimeral, trithemimeral
λεῖος πετράων, καὶ ἐπὶ σκέπας ἦν ἀνέμοιο,	-- --- u u- uu - uu--	dactylic hexameter	masculine penthemimeral, hepthemimeral
ἔγνω δὲ προρέοντα καὶ εὔξατο ὃν κατὰ θυμόν·	-- - uu-u u -uu - uu --	dactylic hexameter	feminine penthemimeral, trithemimeral
κλῦθι, ἄναξ, ὅτις ἐσσί· πολύλλιστον δέ σ’ἱκάνω,	-u u- uu -u u--- u u--	dactylic hexameter	feminine penthemimeral, trithemimeral
φεύγων ἐκ πόντοιο Ποσειδάωνος ἐνιπάς.	-- - --u u---u u--	dactylic hexameter	feminine penthemimeral, trithemimeral
αἰδοῖος μέν τ’ἐστὶ καὶ ἀθανάτοισι θεοῖσιν	--- - -u u -uu-u u--	dactylic hexameter	feminine penthemimeral, trithemimeral
ἀνδρῶν ὅς τις ἵκηται ἀλώμενος, ὡς καὶ ἐγὼ νῦν	-- - u u-u u-uu - u u- -	dactylic hexameter	feminine penthemimeral, trithemimeral
σόν τε ῥόον σά τε γούναθ’ ἱκάνω πολλὰ μογήσας.	- u u- u u -u u-- -u u--	dactylic hexameter	feminine penthemimeral, trithemimeral
ἀλλ’ ἐλέαιρε, ἄναξ· ἱκέτης δέ τοι εὔχομαι εἶναι.	- uu-u u- uu- u u -uu --	dactylic hexameter	masculine penthemimeral, hepthemimeral
ὣς φάθ’, ὁ δ’αὐτίκα παῦσεν ἑὸν ῥόον, ἔσχε δὲ κῦμα,	- u u -uu -u u- uu -u u --	dactylic hexameter	feminine penthemimeral, hepthemimeral
πρόσθε δέ οἱ ποίησε γαλήνην, τὸν δ’ἐσάωσεν	-u u - --u u-- - uu--	dactylic hexameter	feminine penthemimeral, trithemimeral
ἐς ποταμοῦ προχοάς. ὁ δ’ἄρ’ ἄμφω γούνατ’ ἔκαμψε	- uu- uu- u u -- -u u--	dactylic hexameter	masculine penthemimeral, trithemimeral
χεῖράς τε στιβαράς. ἁλὶ γὰρ δέδμητο φίλον κῆρ.	-- - uu- uu - --u u- -	dactylic hexameter	masculine penthemimeral, hepthemimeral, trithemimeral
ᾤδεε δὲ χρόα πάντα, θάλασσα δὲ κήκιε πολλὴ	-uu - uu -u u-u u -uu --	dactylic hexameter	feminine penthemimeral, trithemimeral
ἂν στόμα τε ῥῖνάς θ’·ὁ δ’ἄρ’ ἄπνευστος καὶ ἄναυδος	- uu - -- u u --- u u--	dactylic hexameter	masculine penthemimeral, trithemimeral
κεῖτ’ ὀλιγηπελέων, κάματος δέ μιν αἰνὸς ἵκανεν.	- uu-uu- uu- u u -u u--	dactylic hexameter	masculine penthemimeral, hepthemimeral
ἀλλ’ ὅτε δή ῥ’ἄμπνυτο καὶ ἐς φρένα θυμὸς ἀγέρθη,	- uu - --u u - uu -u u--	dactylic hexameter	feminine penthemimeral, hepthemimeral, trithemimeral
καὶ τότε δὴ κρήδεμνον ἀπὸ ἕο λῦσε θεοῖο.	- uu - --u u- uu -u u--	dactylic hexameter	feminine penthemimeral, hepthemimeral, trithemimeral
καὶ τὸ μὲν ἐς ποταμὸν ἁλιμυρήεντα μεθῆκεν,	- u u - uu- uu---u u--	dactylic hexameter	masculine penthemimeral, trithemimeral
ἂψ δ’ἔφερεν μέγα κῦμα κατὰ ῥόον, αἶψα δ’ἄρ’ Ἰνὼ	- uu- uu -u u- uu -u u --	dactylic hexameter	feminine penthemimeral, hepthemimeral, trithemimeral
δέξατο χερσὶ φίλῃσιν· ὁ δ’ἐκ ποταμοῖο λιασθεὶς	-uu -u u-u u - uu-u u--	dactylic hexameter	feminine penthemimeral, hepthemimeral
σχοίνῳ ὑπεκλίνθη, κύσε δὲ ζείδωρον ἄρουραν.	-u u--- uu - --u u--	dactylic hexameter	masculine penthemimeral, hepthemimeral
ὀχθήσας δ’ἄρα εἶπε πρὸς ὃν μεγαλήτορα θυμόν·	--- uu -u u - uu-uu --	dactylic hexameter	feminine penthemimeral, hepthemimeral, trithemimeral
ὤ μοι ἐγώ, τί πάθω; τί νύ μοι μήκιστα γένηται;	- u u- u u- u u - --u u--	dactylic hexameter	masculine penthemimeral, hepthemimeral, trithemimeral
εἰ μέν κ’ἐν ποταμῷ δυσκηδέα νύκτα φυλάσσω,	- - - uu- --uu -u u--	dactylic hexameter	masculine penthemimeral, trithemimeral
μή μ’ἄμυδις στίβη τε κακὴ καὶ θῆλυς ἐέρση	- uu- -- u u- - -u u--	dactylic hexameter	masculine penthemimeral, hepthemimeral, trithemimeral
ἐξ ὀλιγηπελίης δαμάσῃ κεκαφηότα θυμόν·	- uu-uu- uu- uu-uu --	dactylic hexameter	masculine penthemimeral, hepthemimeral
αὔρη δ’ἐκ ποταμοῦ ψυχρὴ πνέει ἠῶθι πρό.	-- - uu- -- uu --- -	dactylic hexameter	masculine penthemimeral, hepthemimeral, trithemimeral
εἰ δέ κεν ἐς κλιτὺν ἀναβὰς καὶ δάσκιον ὕλην	- u u - -- uu- - -uu --	dactylic hexameter	masculine penthemimeral, hepthemimeral, trithemimeral
θάμνοις ἐν πυκινοῖσι καταδράθω, εἴ με μεθείη	-- - uu-u u-uu - u u--	dactylic hexameter	feminine penthemimeral, trithemimeral
ῥῖγος καὶ κάματος, γλυκερὸς δέ μοι ὕπνος ἐπέλθῃ,	-- - uu- uu- u u -u u--	dactylic hexameter	masculine penthemimeral, hepthemimeral, trithemimeral
δείδω, μὴ θήρεσσιν ἕλωρ καὶ κύρμα γένωμαι.	-- - --u u- - -u u--	dactylic hexameter	feminine penthemimeral, hepthemimeral, trithemimeral
ὣς ἄρα οἱ φρονέοντι δοάσσατο κέρδιον εἶναι·	- uu - uu-u u-uu -uu --	dactylic hexameter	feminine penthemimeral, trithemimeral
βῆ ῥ’ἴμεν εἰς ὕλην· τὴν δὲ σχεδὸν ὕδατος εὗρεν	- uu - -- - - uu -uu --	dactylic hexameter	masculine penthemimeral, hepthemimeral, trithemimeral
ἐν περιφαινομένῳ· δοιοὺς δ’ἄρ’ ὑπήλυθε θάμνους,	- uu-uu- -- u u-uu --	dactylic hexameter	masculine penthemimeral, hepthemimeral
ἐξ ὁμόθεν πεφυῶτας· ὁ μὲν φυλίης, ὁ δ’ἐλαίης.	- uu- uu-u u - uu- u u--	dactylic hexameter	feminine penthemimeral, hepthemimeral, trithemimeral
τοὺς μὲν ἄρ’ οὔτ’ ἀνέμων διάη μένος ὑγρὸν ἀέντων,	- u u - uu- uu- uu -u u--	dactylic hexameter	masculine penthemimeral, hepthemimeral, trithemimeral
οὐδέ ποτ’ ἠέλιος φαέθων ἀκτῖσιν ἔβαλλεν,	-u u -uu- uu- --u u--	dactylic hexameter	masculine penthemimeral, hepthemimeral
οὔτ’ ὄμβρος περάασκε διαμπερές· ὣς ἄρα πυκνοὶ	- -- uu-u u-uu - uu --	dactylic hexameter	feminine penthemimeral, trithemimeral
ἀλλήλοισιν ἔφυν ἐπαμοιβαδίς· οὓς ὑπ’ Ὀδυσσεὺς	---u u- uu-uu - u u--	dactylic hexameter	masculine penthemimeral
δύσετ’. ἄφαρ δ’εὐνὴν ἐπαμήσατο χερσὶ φίλῃσιν	-u u- -- uu-uu -u u--	dactylic hexameter	masculine penthemimeral, trithemimeral
εὐρεῖαν· φύλλων γὰρ ἔην χύσις ἤλιθα πολλή,	--- -- u u- uu -uu --	dactylic hexameter	masculine penthemimeral, hepthemimeral, trithemimeral
ὅσσον τ’ἠὲ δύω ἠὲ τρεῖς ἄνδρας ἔρυσθαι	-- -u u- -- - -u u--	dactylic hexameter	masculine penthemimeral, hepthemimeral
ὥρῃ χειμερίῃ, εἰ καὶ μάλα περ χαλεπαίνοι.	-- -uu- - - uu - uu--	dactylic hexameter	masculine penthemimeral, hepthemimeral
τὴν μὲν ἰδὼν γήθησε πολύτλας δῖος Ὀδυσσεύς,	- u u- --u u-- -u u--	dactylic hexameter	feminine penthemimeral, trithemimeral
ἐν δ’ἄρα μέσσῃ λέκτο, χύσιν δ’ἐπεχεύατο φύλλων.	- uu -- -u u- uu-uu --	dactylic hexameter	feminine penthemimeral, hepthemimeral
ὡς δ’ὅτε τις δαλὸν σποδιῇ ἐνέκρυψε μελαίνῃ	- uu - -- uu- uu-u u--	dactylic hexameter	masculine penthemimeral, hepthemimeral, trithemimeral
ἀγροῦ ἐπ’ ἐσχατιῆς, ᾧ μὴ πάρα γείτονες ἄλλοι,	-u u -uu- - - uu -uu --	dactylic hexameter	masculine penthemimeral, hepthemimeral
σπέρμα πυρὸς σῴζων, ἵνα μή ποθεν ἄλλοθεν αὔοι,	-u u- -- uu - uu -uu --	dactylic hexameter	masculine penthemimeral, hepthemimeral, trithemimeral
ὣς Ὀδυσεὺς φύλλοισι καλύψατο· τῷ δ’ἄρ’ Ἀθήνη	- uu- --u u-uu - u u--	dactylic hexameter	feminine penthemimeral, trithemimeral
ὕπνον ἐπ’ ὄμμασι χεῦ’, ἵνα μιν παύσειε τάχιστα	-u u -uu - uu - --u u--	dactylic hexameter	masculine penthemimeral, hepthemimeral
δυσπονέος καμάτοιο φίλα βλέφαρ’ ἀμφικαλύψας.	-uu- uu-u u- uu -uu--	dactylic hexameter	feminine penthemimeral, hepthemimeral, trithemimeral
