Ἠέλιος δ’ἀνόρουσε, λιπὼν περικαλλέα λίμνην,	-uu- uu-u u- uu-uu --	dactylic hexameter	feminine penthemimeral, hepthemimeral, trithemimeral
οὐρανὸν ἐς πολύχαλκον, ἵν’ ἀθανάτοισι φαείνοι	-uu - uu-u u -uu-u u--	dactylic hexameter	feminine penthemimeral, trithemimeral
καὶ θνητοῖσι βροτοῖσιν ἐπὶ ζείδωρον ἄρουραν·	- --u u-u u- --u u--	dactylic hexameter	feminine penthemimeral, hepthemimeral
οἱ δὲ Πύλον, Νηλῆος ἐυκτίμενον πτολίεθρον,	- u u- --u u-uu- uu--	dactylic hexameter	feminine penthemimeral, trithemimeral
ἷξον· τοὶ δ’ἐπὶ θινὶ θαλάσσης ἱερὰ ῥέζον,	-- - uu -u u-- -uu --	dactylic hexameter	feminine penthemimeral, trithemimeral
ταύρους παμμέλανας, ἐνοσίχθονι κυανοχαίτῃ.	-- -uu- uu-uu -uu--	dactylic hexameter	masculine penthemimeral
ἐννέα δ’ἕδραι ἔσαν, πεντακόσιοι δ’ἐν ἑκάστῃ	-uu -u u- --uu- u u--	dactylic hexameter	masculine penthemimeral
ἥατο καὶ προύχοντο ἑκάστοθι ἐννέα ταύρους.	-uu - --u u-uu -uu --	dactylic hexameter	feminine penthemimeral, trithemimeral
εὖθ’ οἱ σπλάγχνα πάσαντο, θεῷ δ’ἐπὶ μηρί’ ἔκαιον,	- - -u u-u u- uu -u u--	dactylic hexameter	feminine penthemimeral, hepthemimeral
οἱ δ’ἰθὺς κατάγοντο ἰδ’ ἱστία νηὸς ἐίσης	- -- uu-u u -uu -u u--	dactylic hexameter	feminine penthemimeral, trithemimeral
στεῖλαν ἀείραντες, τὴν δ’ὥρμισαν, ἐκ δ’ἔβαν αὐτοί·	-u u--- - -uu - uu --	dactylic hexameter	masculine penthemimeral
ἐκ δ’ἄρα Τηλέμαχος νηὸς βαῖν’, ἦρχε δ’Ἀθήνη.	- uu -uu- -- - -u u--	dactylic hexameter	masculine penthemimeral, hepthemimeral
τὸν προτέρη προσέειπε θεά, γλαυκῶπις Ἀθήνη·	- uu- uu-u u- --u u--	dactylic hexameter	feminine penthemimeral, hepthemimeral, trithemimeral
Τηλέμαχ’, οὐ μέν σε χρὴ ἔτ’ αἰδοῦς, οὐδ’ ἠβαιόν·	-uu - - - u u -- - ---	dactylic hexameter	masculine penthemimeral, trithemimeral
τοὔνεκα γὰρ καὶ πόντον ἐπέπλως, ὄφρα πύθηαι	-uu - - -u u-- -u u--	dactylic hexameter	feminine penthemimeral, trithemimeral
πατρός, ὅπου κύθε γαῖα καὶ ὅν τινα πότμον ἐπέσπεν.	-u u- uu -u u - uu -u u--	dactylic hexameter	feminine penthemimeral, hepthemimeral, trithemimeral
ἀλλ’ ἄγε νῦν ἰθὺς κίε Νέστορος ἱπποδάμοιο·	- uu - -- uu -uu -uu--	dactylic hexameter	masculine penthemimeral, trithemimeral
εἴδομεν ἥν τινα μῆτιν ἐνὶ στήθεσσι κέκευθε.	-uu - uu -u u- --u u--	dactylic hexameter	feminine penthemimeral, hepthemimeral, trithemimeral
λίσσεσθαι δέ μιν αὐτός, ὅπως νημερτέα εἴπῃ·	--- u u -u u- --uu --	dactylic hexameter	feminine penthemimeral, hepthemimeral, trithemimeral
ψεῦδος δ’οὐκ ἐρέει· μάλα γὰρ πεπνυμένος ἐστί.	-- - uu- uu - --uu --	dactylic hexameter	masculine penthemimeral, hepthemimeral, trithemimeral
τὴν δ’αὖ Τηλέμαχος πεπνυμένος ἀντίον ηὔδα·	- - -uu- --uu -uu --	dactylic hexameter	masculine penthemimeral
Μέντορ, πῶς τ’ἄρ’ ἴω; πῶς τ’ἂρ προσπτύξομαι αὐτόν;	-- - u u- - - --uu --	dactylic hexameter	masculine penthemimeral, hepthemimeral, trithemimeral
οὐδέ τί πω μύθοισι πεπείρημαι πυκινοῖσιν·	-u u - --u u--- uu--	dactylic hexameter	feminine penthemimeral, trithemimeral
αἰδὼς δ’αὖ νέον ἄνδρα γεραίτερον ἐξερέεσθαι.	-- - uu -u u-uu -uu--	dactylic hexameter	feminine penthemimeral, trithemimeral
τὸν δ’αὖτε προσέειπε θεά, γλαυκῶπις Ἀθήνη·	- -- uu-u u- --u u--	dactylic hexameter	feminine penthemimeral, hepthemimeral, trithemimeral
Τηλέμαχ’, ἄλλα μὲν αὐτὸς ἐνὶ φρεσὶ σῇσι νοήσεις,	-uu -u u -u u- uu -u u--	dactylic hexameter	feminine penthemimeral, hepthemimeral
ἄλλα δὲ καὶ δαίμων ὑποθήσεται· οὐ γὰρ ὀίω	-u u - -- uu-uu - u u--	dactylic hexameter	masculine penthemimeral, trithemimeral
οὔ σε θεῶν ἀέκητι γενέσθαι τε τραφέμεν τε.	- u u- uu-u u-- - uu- -	dactylic hexameter	feminine penthemimeral, trithemimeral
ὣς ἄρα φωνήσασ’ ἡγήσατο Παλλὰς Ἀθήνη	- uu --- --uu -u u--	dactylic hexameter	masculine penthemimeral
καρπαλίμως· ὁ δ’ἔπειτα μετ’ ἴχνια βαῖνε θεοῖο.	-uu- u u-u u -uu -u u--	dactylic hexameter	feminine penthemimeral, trithemimeral
ἷξον δ’ἐς Πυλίων ἀνδρῶν ἄγυρίν τε καὶ ἕδρας,	-- - uu- -- uu- u u --	dactylic hexameter	masculine penthemimeral, hepthemimeral, trithemimeral
ἔνθ’ ἄρα Νέστωρ ἧστο σὺν υἱάσιν, ἀμφὶ δ’ἑταῖροι	- uu -- -u u -uu -u u--	dactylic hexameter	feminine penthemimeral
δαῖτ’ ἐντυνόμενοι κρέα τ’ὤπτων ἄλλα τ’ἔπειρον.	- --uu- uu -- -u u--	dactylic hexameter	masculine penthemimeral
οἱ δ’ὡς οὖν ξείνους ἴδον, ἁθρόοι ἦλθον ἅπαντες,	- - - -- uu -uu -u u--	dactylic hexameter	masculine penthemimeral, trithemimeral
χερσίν τ’ἠσπάζοντο καὶ ἑδριάασθαι ἄνωγον.	-- ---u u -uu-u u--	dactylic hexameter	feminine penthemimeral
πρῶτος Νεστορίδης Πεισίστρατος ἐγγύθεν ἐλθὼν	-- -uu- --uu -uu --	dactylic hexameter	masculine penthemimeral
ἀμφοτέρων ἕλε χεῖρα καὶ ἵδρυσεν παρὰ δαιτὶ	-uu- uu -u u --- uu --	dactylic hexameter	feminine penthemimeral, trithemimeral
κώεσιν ἐν μαλακοῖσιν ἐπὶ ψαμάθοις ἁλίῃσιν	-uu - uu-u u- uu- uu--	dactylic hexameter	feminine penthemimeral, hepthemimeral, trithemimeral
πάρ τε κασιγνήτῳ Θρασυμήδεϊ καὶ πατέρι ᾧ·	- u u--- uu-uu - uu- -	dactylic hexameter	masculine penthemimeral
δῶκε δ’ἄρα σπλάγχνων μοίρας, ἐν δ’οἶνον ἔχευεν	-u u- -- -- - -u u--	dactylic hexameter	masculine penthemimeral, hepthemimeral, trithemimeral
χρυσείῳ δέπαϊ· δειδισκόμενος δὲ προσηύδα	--- uu- --uu- u u--	dactylic hexameter	masculine penthemimeral, trithemimeral
Παλλάδ’ Ἀθηναίην κούρην Διὸς αἰγιόχοιο·	-u u--- -- uu -uu--	dactylic hexameter	masculine penthemimeral, hepthemimeral
εὔχεο νῦν, ὦ ξεῖνε, Ποσειδάωνι ἄνακτι·	-uu - - -u u---u u--	dactylic hexameter	feminine penthemimeral, trithemimeral
τοῦ γὰρ καὶ δαίτης ἠντήσατε δεῦρο μολόντες.	- - - -- --uu -u u--	dactylic hexameter	masculine penthemimeral, trithemimeral
αὐτὰρ ἐπὴν σπείσῃς τε καὶ εὔξεαι, ἣ θέμις ἐστί,	-u u- -- u u -uu - uu --	dactylic hexameter	masculine penthemimeral, trithemimeral
δὸς καὶ τούτῳ ἔπειτα δέπας μελιηδέος οἴνου	- - -u u-u u- uu-uu --	dactylic hexameter	feminine penthemimeral, hepthemimeral
σπεῖσαι, ἐπεὶ καὶ τοῦτον ὀίομαι ἀθανάτοισιν	-u u- - -u u-uu -uu--	dactylic hexameter	feminine penthemimeral, trithemimeral
εὔχεσθαι· πάντες δὲ θεῶν χατέουσ’ ἄνθρωποι.	--- -- u u- uu- ---	dactylic hexameter	masculine penthemimeral, hepthemimeral, trithemimeral
ἀλλὰ νεώτερός ἐστιν, ὁμηλικίη δ’ἐμοὶ αὐτῷ·	-u u-uu -u u-uu- uu --	dactylic hexameter	feminine penthemimeral
τοὔνεκα σοὶ προτέρῳ δώσω χρύσειον ἄλεισον.	-uu - uu- -- --u u--	dactylic hexameter	masculine penthemimeral, hepthemimeral, trithemimeral
ὣς εἰπὼν ἐν χειρὶ τίθει δέπας ἡδέος οἴνου·	- -- - -u u- uu -uu --	dactylic hexameter	feminine penthemimeral, hepthemimeral, trithemimeral
χαῖρε δ’Ἀθηναίη πεπνυμένῳ ἀνδρὶ δικαίῳ,	-u u--- --uu -u u--	dactylic hexameter	masculine penthemimeral
οὕνεκα οἷ προτέρῃ δῶκε χρύσειον ἄλεισον·	-uu - uu- -- --u u--	dactylic hexameter	masculine penthemimeral, hepthemimeral, trithemimeral
αὐτίκα δ’εὔχετο πολλὰ Ποσειδάωνι ἄνακτι·	-uu -uu -u u---u u--	dactylic hexameter	feminine penthemimeral
κλῦθι, Ποσείδαον γαιήοχε, μηδὲ μεγήρῃς	-u u--- --uu -u u--	dactylic hexameter	masculine penthemimeral
ἡμῖν εὐχομένοισι τελευτῆσαι τάδε ἔργα.	-- -uu-u u--- uu --	dactylic hexameter	feminine penthemimeral
Νέστορι μὲν πρώτιστα καὶ υἱάσι κῦδος ὄπαζε,	-uu - --u u -uu -u u--	dactylic hexameter	feminine penthemimeral, trithemimeral
αὐτὰρ ἔπειτ’ ἄλλοισι δίδου χαρίεσσαν ἀμοιβὴν	-u u- --u u- uu-u u--	dactylic hexameter	feminine penthemimeral, hepthemimeral, trithemimeral
σύμπασιν Πυλίοισιν ἀγακλειτῆς ἑκατόμβης.	--- uu-u u--- uu--	dactylic hexameter	feminine penthemimeral, trithemimeral
δὸς δ’ἔτι Τηλέμαχον καὶ ἐμὲ πρήξαντα νέεσθαι,	- uu -uu- u u- --u u--	dactylic hexameter	masculine penthemimeral, hepthemimeral
οὕνεκα δεῦρ’ ἱκόμεσθα θοῇ σὺν νηὶ μελαίνῃ.	-uu - uu-u u- - -u u--	dactylic hexameter	feminine penthemimeral, hepthemimeral, trithemimeral
ὣς ἄρ’ ἔπειτ’ ἠρᾶτο καὶ αὐτὴ πάντα τελεύτα.	- u u- --u u -- -u u--	dactylic hexameter	feminine penthemimeral, trithemimeral
δῶκε δὲ Τηλεμάχῳ καλὸν δέπας ἀμφικύπελλον·	-u u -uu- -- uu -uu--	dactylic hexameter	masculine penthemimeral, hepthemimeral
ὣς δ’αὔτως ἠρᾶτο Ὀδυσσῆος φίλος υἱός.	- -- --u u--- uu --	dactylic hexameter	feminine penthemimeral, trithemimeral
οἱ δ’ἐπεί ὤπτησαν κρέ’ ὑπέρτερα καὶ ἐρύσαντο,	- uu --- u u-uu - uu--	dactylic hexameter	masculine penthemimeral
μοίρας δασσάμενοι δαίνυντ’ ἐρικυδέα δαῖτα.	-- -uu- -- uu-uu --	dactylic hexameter	masculine penthemimeral, hepthemimeral
αὐτὰρ ἐπεὶ πόσιος καὶ ἐδητύος ἐξ ἔρον ἕντο,	-u u- uu- u u-uu - uu --	dactylic hexameter	masculine penthemimeral, trithemimeral
τοῖς ἄρα μύθων ἦρχε Γερήνιος ἱππότα Νέστωρ·	- uu -- -u u-uu -uu --	dactylic hexameter	feminine penthemimeral
νῦν δὴ κάλλίον ἐστι μεταλλῆσαι καὶ ἐρέσθαι	- - -uu -u u--- u u--	dactylic hexameter	feminine penthemimeral
ξείνους, οἱ τινές εἰσιν, ἐπεὶ τάρπησαν ἐδωδῆς.	-- - uu -u u- --u u--	dactylic hexameter	feminine penthemimeral, hepthemimeral, trithemimeral
ὦ ξεῖνοι, τίνες ἐστέ; πόθεν πλεῖθ’ ὑγρὰ κέλευθα;	- -- uu -u u- - -u u--	dactylic hexameter	feminine penthemimeral, hepthemimeral, trithemimeral
ἤ τι κατά πρῆξιν ἦ μαψιδίως ἀλάλησθε	- u u- -- - -uu- uu--	dactylic hexameter	masculine penthemimeral, trithemimeral
οἷά τε ληιστῆρες ὑπεὶρ ἅλα, τοί τ’ἀλόωνται	-u u ---u u- uu - uu--	dactylic hexameter	feminine penthemimeral, hepthemimeral
ψυχὰς παρθέμενοι κακὸν ἀλλοδαποῖσι πέροντες;	-- -uu- uu -uu-u u--	dactylic hexameter	masculine penthemimeral
τὸν δ’αὖ Τηλέμαχος πεπνυμένος ἀντίον ηὔδα	- - -uu- --uu -uu --	dactylic hexameter	masculine penthemimeral
θαρσήσας· αὐτὴ γὰρ ἐνὶ φρεσὶ θάρσος Ἀθήνη	--- -- u u- uu -u u--	dactylic hexameter	masculine penthemimeral, hepthemimeral, trithemimeral
θῆχ’, ἵνα μιν περὶ πατρὸς ἀποιχομένοιο ἔροιτο	- uu - uu -u u-uu-u u--	dactylic hexameter	feminine penthemimeral, trithemimeral
ἠδ’ ἵνα μιν κλέος ἐσθλὸν ἐν ἀνθρώποισιν ἔχῃσιν·	- uu - uu -u u ---u u--	dactylic hexameter	feminine penthemimeral, trithemimeral
ὦ Νέστορ Νηληϊάδη, μέγα κῦδος Ἀχαιῶν,	- -- --uu- uu -u u--	dactylic hexameter	hepthemimeral, trithemimeral
εἴρεαι ὁππόθεν εἰμέν· ἐγὼ δέ κέ τοι καταλέξω.	-uu -uu -u u- u u - uu--	dactylic hexameter	feminine penthemimeral, hepthemimeral
ἡμεῖς ἐξ Ἰθάκης ὑπονηίου εἰλήλουθμεν·	-- - uu- uu-uu ----	dactylic hexameter	masculine penthemimeral, trithemimeral
πρῆξις δ’ἥδ’ ἰδίη, οὐ δήμιος, ἣν ἀγορεύω.	-- - uu- - -uu - uu--	dactylic hexameter	masculine penthemimeral, trithemimeral
πατρὸς ἐμοῦ κλέος εὐρὺ μετέρχομαι, ἤν που ἀκούσω,	-u u- uu -u u-uu - u u--	dactylic hexameter	feminine penthemimeral, trithemimeral
δίου Ὀδυσσῆος ταλασίφρονος, ὅν ποτέ φασι	-u u--- uu-uu - uu --	dactylic hexameter	masculine penthemimeral
σὺν σοὶ μαρνάμενον Τρώων πόλιν ἐξαλαπάξαι.	- - -uu- -- uu -uu--	dactylic hexameter	masculine penthemimeral, hepthemimeral
ἄλλους μὲν γὰρ πάντας, ὅσοι Τρωσὶν πολέμιξον,	-- - - -u u- -- uu--	dactylic hexameter	feminine penthemimeral, hepthemimeral, trithemimeral
πευθόμεθ’, ἧχι ἕκαστος ἀπώλετο λυγρῷ ὀλέθρῳ,	-uu -u u-u u-uu -u u--	dactylic hexameter	feminine penthemimeral
κείνου δ’αὖ καὶ ὄλεθρον ἀπευθέα θῆκε Κρονίων.	-- - u u-u u-uu -u u--	dactylic hexameter	feminine penthemimeral, trithemimeral
οὐ γάρ τις δύναται σάφα εἰπέμεν ὁππόθ’ ὄλωλεν,	- - - uu- uu -uu -u u--	dactylic hexameter	masculine penthemimeral, trithemimeral
εἴθ’ ὅ γ’ἐπ’ ἠπείρου δάμη ἀνδράσι δυσμενέεσσιν,	- u u --- uu -uu -uu--	dactylic hexameter	masculine penthemimeral
εἴτε καὶ ἐν πελάγει μετὰ κύμασιν Ἀμφιτρίτης.	-u u - uu- uu -uu ----	dactylic hexameter	masculine penthemimeral, trithemimeral
τοὔνεκα νῦν τὰ σὰ γούναθ’ ἱκάνομαι, αἴ κ’ἐθέλῃσθα	-uu - u u -u u-uu - uu--	dactylic hexameter	feminine penthemimeral, trithemimeral
κείνου λυγρὸν ὄλεθρον ἐνισπεῖν, εἴ που ὄπωπας	-- -u u-u u-- - u u--	dactylic hexameter	feminine penthemimeral
ὀφθαλμοῖσι τεοῖσιν ἢ ἄλλου μῦθον ἄκουσας	---u u-u u -- -u u--	dactylic hexameter	feminine penthemimeral
πλαζομένου· πέρι γάρ μιν ὀιζυρὸν τέκε μήτηρ.	-uu- uu - u u--- uu --	dactylic hexameter	masculine penthemimeral, trithemimeral
μηδέ τί μ’αἰδόμενος μειλίσσεο μηδ’ ἐλεαίρων,	-u u -uu- --uu - uu--	dactylic hexameter	masculine penthemimeral
ἀλλ’ εὖ μοι κατάλεξον ὃπως ἤντησας ὀπωπῆς.	- - - uu-u u- --u u--	dactylic hexameter	feminine penthemimeral, hepthemimeral, trithemimeral
λίσσομαι, εἴ ποτέ τοί τι πατὴρ ἐμός, ἐσθλὸς Ὀδυσσεύς,	-uu - uu - u u- uu -u u--	dactylic hexameter	masculine penthemimeral, hepthemimeral, trithemimeral
ἢ ἔπος ἠέ τι ἔργον ὑποστὰς ἐξετέλεσσε	- uu -u u -u u-- -uu--	dactylic hexameter	feminine penthemimeral
δήμῳ ἔνι Τρώων, ὅθι πάσχετε πήματ’ Ἀχαιοί,	-u u- -- uu -uu -u u--	dactylic hexameter	masculine penthemimeral, trithemimeral
τῶν νῦν μοι μνῆσαι, καί μοι νημερτὲς ἐνίσπες.	- - - -- - - --u u--	dactylic hexameter	masculine penthemimeral, hepthemimeral, trithemimeral
τὸν δ’ἠμείβετ’ ἔπειτα Γερήνιος ἱππότα Νέστωρ·	- --u u-u u-uu -uu --	dactylic hexameter	feminine penthemimeral
ὦ φίλ’, ἐπεί μ’ἔμνησας ὀιζύος, ἥν ἐν ἐκείνῳ	- u u- --u u-uu - u u--	dactylic hexameter	feminine penthemimeral, trithemimeral
δήμῳ ἀνέτλημεν μένος ἄσχετοι υἷες Ἀχαιῶν,	-u u--- uu -uu -u u--	dactylic hexameter	masculine penthemimeral
ἠμέν ὅσα ξὺν νηυσίν ἐπ’ ἠεροειδέα πόντον	-u u- - -u u -uu-uu --	dactylic hexameter	feminine penthemimeral, trithemimeral
πλαζόμενοι κατὰ ληίδ’, ὅπῃ ἄρξειεν Ἀχιλλεύς,	-uu- uu -u u- --u u--	dactylic hexameter	feminine penthemimeral, hepthemimeral, trithemimeral
ἠδ’ ὅσα καὶ περί ἄστυ μέγα Πριάμοιο ἄνακτος	- uu - uu -u u- uu-u u--	dactylic hexameter	feminine penthemimeral, hepthemimeral, trithemimeral
μαρνάμεθ’· ἔνθα δ’ἔπειτα κατέκταθεν ὅσσοι ἄριστοι.	-uu -u u-u u-uu -u u--	dactylic hexameter	feminine penthemimeral
ἔνθα μὲν Αἴας κεῖται ἀρήιος, ἔνθα δ’Ἀχιλλεύς,	-u u -- -u u-uu -u u--	dactylic hexameter	feminine penthemimeral
ἔνθα δὲ Πάτροκλος, θεόφιν μήστωρ ἀτάλαντος,	-u u --- uu- -- uu--	dactylic hexameter	masculine penthemimeral, hepthemimeral
ἔνθα δ’ἐμὸς φίλος υἱός, ἅμα κρατερὸς καὶ ἀμύμων,	-u u- uu -u u- uu- u u--	dactylic hexameter	feminine penthemimeral, hepthemimeral, trithemimeral
Ἀντίλοχος, πέρι μὲν θείειν ταχὺς ἠδὲ μαχητής·	-uu- uu - -- uu -u u--	dactylic hexameter	masculine penthemimeral, hepthemimeral, trithemimeral
ἄλλα τε πόλλ’ ἐπὶ τοῖς πάθομεν κακά· τίς κεν ἐκεῖνα	-u u - uu - uu- uu - u u--	dactylic hexameter	masculine penthemimeral, hepthemimeral, trithemimeral
πάντα γε μυθήσαιτο καταθνητῶν ἀνθρώπων;	-u u ---u u--- ---	dactylic hexameter	feminine penthemimeral
οὐδ’ εἰ πεντάετές γε καὶ ἑξάετες παραμίμνων	- - -uu- u u -uu- uu--	dactylic hexameter	masculine penthemimeral
ἐξερέοις ὅσα κεῖθι πάθον κακὰ δῖοι Ἀχαιοί·	-uu- uu -u u- uu -u u--	dactylic hexameter	feminine penthemimeral, hepthemimeral, trithemimeral
πρίν κεν ἀνιηθεὶς σὴν πατρίδα γαῖαν ἵκοιο.	- u u--- - -uu -u u--	dactylic hexameter	masculine penthemimeral
εἰνάετες γάρ σφιν κακὰ ῥάπτομεν ἀμφιέποντες	-uu- - - uu -uu -uu--	dactylic hexameter	masculine penthemimeral, trithemimeral
παντοίοισι δόλοισι, μόγις δ’ἐτέλεσσε Κρονίων.	---u u-u u- uu-u u--	dactylic hexameter	feminine penthemimeral, hepthemimeral
ἔνθ’ οὔ τίς ποτε μῆτιν ὁμοιωθήμεναι ἄντην	- - - uu -u u---uu --	dactylic hexameter	feminine penthemimeral, trithemimeral
ἤθελ’, ἐπεὶ μάλα πολλὸν ἐνίκα δῖος Ὀδυσσεὺς	-u u- uu -u u-- -u u--	dactylic hexameter	feminine penthemimeral, trithemimeral
παντοίοισι δόλοισι, πατὴρ τεός, εἰ ἐτεόν γε	---u u-u u- uu - uu- -	dactylic hexameter	feminine penthemimeral, hepthemimeral
κείνου ἔκγονός ἐσσι· σέβας μ’ἔχει εἰσορόωντα.	-- -uu -u u- uu -uu--	dactylic hexameter	feminine penthemimeral, hepthemimeral
ἦ τοι γὰρ μῦθοί γε ἐοικότες, οὐδέ κε φαίης	- - - -- u u-uu -u u --	dactylic hexameter	masculine penthemimeral, trithemimeral
ἄνδρα νεώτερον ὧδε ἐοικότα μυθήσασθαι.	-u u-uu -u u-uu ----	dactylic hexameter	feminine penthemimeral
ἔνθ’ ἦ τοι ἧος μὲν ἐγὼ καὶ δῖος Ὀδυσσεὺς	- - - -- u u- - -u u--	dactylic hexameter	masculine penthemimeral, hepthemimeral, trithemimeral
οὔτε ποτ’ εἰν ἀγορῇ δίχ’ ἐβάζομεν οὔτ’ ἐνὶ βουλῇ,	-u u - uu- u u-uu - uu --	dactylic hexameter	masculine penthemimeral, trithemimeral
ἀλλ’ ἕνα θυμὸν ἔχοντε νόω καὶ ἐπίφρονι βουλῇ	- uu -u u-u u- u u-uu --	dactylic hexameter	feminine penthemimeral, hepthemimeral
φραζόμεθ’ Ἀργείοισιν ὅπως ὄχ’ ἄριστα γένοιτο.	-uu ---u u- u u-u u--	dactylic hexameter	feminine penthemimeral, hepthemimeral
αὐτὰρ ἐπεὶ Πριάμοιο πόλιν διεπέρσαμεν αἰπήν,	-u u- uu-u u- uu-uu --	dactylic hexameter	feminine penthemimeral, hepthemimeral, trithemimeral
βῆμεν δ’ἐν νήεσσι, θεὸς δ’ἐσκέδασσεν Ἀχαιούς,	-- - --u u- uu-u u--	dactylic hexameter	feminine penthemimeral, hepthemimeral, trithemimeral
καὶ τότε δὴ Ζεὺς λυγρὸν ἐνὶ φρεσὶ μήδετο νόστον	- uu - - -u u- uu -uu --	dactylic hexameter	feminine penthemimeral, hepthemimeral, trithemimeral
Ἀργείοις, ἐπεὶ οὔ τι νοήμονες οὐδὲ δίκαιοι	--- uu - u u-uu -u u--	dactylic hexameter	masculine penthemimeral, trithemimeral
πάντες ἔσαν· τῶ σφεων πολέες κακὸν οἶτον ἐπέσπον	-u u- - - uu- uu -u u--	dactylic hexameter	masculine penthemimeral, hepthemimeral, trithemimeral
μήνιος ἐξ ὀλοῆς γλαυκώπιδος ὀβριμοπάτρης.	-uu - uu- --uu -uu--	dactylic hexameter	masculine penthemimeral, trithemimeral
ἥ τ’ἔριν Ἀτρεΐδῃσι μετ’ ἀμφοτέροισιν ἔθηκε.	- uu -uu-u u -uu-u u--	dactylic hexameter	feminine penthemimeral
τὼ δὲ καλεσσαμένω ἀγορὴν ἐς πάντας Ἀχαιούς,	- u u-uu- uu- - -u u--	dactylic hexameter	masculine penthemimeral, hepthemimeral
μάψ, ἀτὰρ οὐ κατὰ κόσμον, ἐς ἠέλιον καταδύντα,	- uu - uu -u u -uu- uu--	dactylic hexameter	feminine penthemimeral, trithemimeral
οἱ ἦλθον οἴνῳ βεβαρηότες υἷες Ἀχαιῶν,	- -- -- uu-uu -u u--	dactylic hexameter	masculine penthemimeral, trithemimeral
μῦθον μυθείσθην, τοῦ εἵνεκα λαὸν ἄγειραν.	-- --- - -uu -u u--	dactylic hexameter	masculine penthemimeral
ἔνθ’ ἤ τοι Μενέλαος ἀνώγει πάντας Ἀχαιοὺς	- - - uu-u u-- -u u--	dactylic hexameter	feminine penthemimeral, trithemimeral
νόστου μιμνήσκεσθαι ἐπ’ εὐρέα νῶτα θαλάσσης,	-- ---u u -uu -u u--	dactylic hexameter	feminine penthemimeral
οὐδ’ Ἀγαμέμνονι πάμπαν ἑήνδανε· βούλετο γάρ ῥα	- uu-uu -u u-uu -uu - -	dactylic hexameter	feminine penthemimeral
λαὸν ἐρυκακέειν ῥέξαι θ’ἱερὰς ἑκατόμβας,	-u u-uu- -- uu- uu--	dactylic hexameter	masculine penthemimeral, hepthemimeral
ὡς τὸν Ἀθηναίης δεινὸν χόλον ἐξακέσαιτο,	- u u--- -- uu -uu--	dactylic hexameter	masculine penthemimeral, hepthemimeral
νήπιος, οὐδὲ τὸ ᾔδη, ὃ οὐ πείσεσθαι ἔμελλεν·	-uu -u u -u u - --u u--	dactylic hexameter	feminine penthemimeral, hepthemimeral
οὐ γάρ τ’αἶψα θεῶν τρέπεται νόος αἰέν ἐόντων.	- - -u u- uu- uu -u u--	dactylic hexameter	masculine penthemimeral, hepthemimeral
ὣς τὼ μὲν χαλεποῖσιν ἀμειβομένω ἐπέεσσιν	- - - uu-u u-uu- uu--	dactylic hexameter	feminine penthemimeral, trithemimeral
ἕστασαν· οἱ δ’ἀνόρουσαν ἐυκνήμιδες Ἀχαιοὶ	-uu - uu-u u---u u--	dactylic hexameter	feminine penthemimeral, trithemimeral
ἠχῇ θεσπεσίῃ, δίχα δέ σφισιν ἥνδανε βουλή.	-- -uu- uu - uu -uu --	dactylic hexameter	masculine penthemimeral, hepthemimeral
νύκτα μὲν ἀέσαμεν χαλεπὰ φρεσὶν ὁρμαίνοντες	-u u -uu- uu- uu ----	dactylic hexameter	masculine penthemimeral, hepthemimeral
ἀλλήλοις· ἐπὶ γὰρ Ζεὺς ἤρτυε πῆμα κακοῖο·	--- uu - - -uu -u u--	dactylic hexameter	masculine penthemimeral, trithemimeral
ἠῶθεν δ’οἱ μὲν νέας ἕλκομεν εἰς ἅλα δῖαν	--- - - uu -uu - uu --	dactylic hexameter	masculine penthemimeral, trithemimeral
κτήματά τ’ἐντιθέμεσθα βαθυζώνους τε γυναῖκας.	-uu -uu-u u--- u u--	dactylic hexameter	feminine penthemimeral
ἡμίσεες δ’ἄρα λαοὶ ἐρητύοντο μένοντες	-uu- uu -u u---u u--	dactylic hexameter	feminine penthemimeral, trithemimeral
αὖθι παρ’ Ἀτρεΐδῃ Ἀγαμέμνονι, ποιμένι λαῶν·	-u u -uu- uu-uu -uu --	dactylic hexameter	masculine penthemimeral
ἡμίσεες δ’ἀναβάντες ἐλαύνομεν· αἱ δὲ μάλ’ ὦκα	-uu- uu-u u-uu - u u --	dactylic hexameter	feminine penthemimeral, trithemimeral
ἔπλεον, ἐστόρεσεν δέ θεὸς μεγακήτεα πόντον.	-uu -uu- u u- uu-uu --	dactylic hexameter	masculine penthemimeral, hepthemimeral
ἐς Τένεδον δ’ἐλθόντες ἐρέξαμεν ἱρὰ θεοῖσιν,	- uu- --u u-uu -u u--	dactylic hexameter	feminine penthemimeral, trithemimeral
οἴκαδε ἱέμενοι· Ζεὺς δ’οὔ πω μήδετο νόστον,	-uu -uu- - - - -uu --	dactylic hexameter	masculine penthemimeral, hepthemimeral
σχέτλιος, ὅς ῥ’ἔριν ὦρσε κακήν ἔπι δεύτερον αὖτις.	-uu - uu -u u- uu -uu --	dactylic hexameter	feminine penthemimeral, hepthemimeral, trithemimeral
οἱ μὲν ἀποστρέψαντες ἔβαν νέας ἀμφιελίσσας	- u u---u u- uu -uu--	dactylic hexameter	feminine penthemimeral, hepthemimeral
ἀμφ’ Ὀδυσῆα ἄνακτα δαΐφρονα, ποικιλομήτην,	- uu-u u-u u-uu -uu--	dactylic hexameter	feminine penthemimeral
αὖτις ἐπ’ Ἀτρεΐδῃ Ἀγαμέμνονι ἦρα φέροντες·	-u u -uu- uu-uu -u u--	dactylic hexameter	masculine penthemimeral
αὐτὰρ ἐγὼ σὺν νηυσὶν ἀολλέσιν, αἵ μοι ἕποντο,	-u u- - -u u-uu - u u--	dactylic hexameter	feminine penthemimeral, trithemimeral
φεῦγον, ἐπεὶ γίγνωσκον, ὃδὴ κακὰ μήδετο δαίμων.	-u u- --u u- uu -uu --	dactylic hexameter	feminine penthemimeral, hepthemimeral, trithemimeral
φεῦγε δὲ Τυδέος υἱὸς ἀρήιος, ὦρσε δ’ἑταίρους.	-u u -uu -u u-uu -u u--	dactylic hexameter	feminine penthemimeral
ὀψὲ δὲ δὴ μετὰ νῶι κίε ξανθὸς Μενέλαος,	-u u - uu -u u- -- uu--	dactylic hexameter	feminine penthemimeral, hepthemimeral, trithemimeral
ἐν Λέσβῳ δ’ἔκιχεν δολιχὸν πλόον ὁρμαίνοντας,	- -- uu- uu- uu ----	dactylic hexameter	masculine penthemimeral, hepthemimeral, trithemimeral
ἢ καθύπερθε Χίοιο νεοίμεθα παιπαλοέσσης,	- uu-u u-u u-uu -uu--	dactylic hexameter	feminine penthemimeral
νήσου ἔπι Ψυρίης, αὐτὴν ἐπ’ ἀριστέρ’ ἔχοντες,	-u u- uu- -- u u-u u--	dactylic hexameter	masculine penthemimeral, hepthemimeral, trithemimeral
ἦ ὑπένερθε Χίοιο, παρ’ ἠνεμόεντα Μίμαντα.	- uu-u u-u u -uu-u u--	dactylic hexameter	feminine penthemimeral
ᾐτέομεν δὲ θεὸν φῆναι τέρας· αὐτὰρ ὅ γ’ἡμῖν	-uu- u u- -- uu -u u --	dactylic hexameter	masculine penthemimeral, hepthemimeral, trithemimeral
δεῖξε, καὶ ἠνώγει πέλαγος μέσον εἰς Εὔβοιαν	-u u --- uu- uu - ---	dactylic hexameter	masculine penthemimeral, hepthemimeral
τέμνειν, ὄφρα τάχιστα ὑπὲκ κακότητα φύγοιμεν.	-- -u u-u u- uu-u u--	dactylic hexameter	feminine penthemimeral, hepthemimeral
ὦρτο δ’ἐπὶ λιγὺς οὖρος ἀήμεναι· αἱ δὲ μάλ’ ὦκα	-u u- uu -u u-uu - u u --	dactylic hexameter	feminine penthemimeral, trithemimeral
ἰχθυόεντα κέλευθα διέδραμον, ἐς δὲ Γεραιστὸν	-uu-u u-u u-uu - u u--	dactylic hexameter	feminine penthemimeral
ἐννύχιαι κατάγοντο· Ποσειδάωνι δὲ ταύρων	-uu- uu-u u---u u --	dactylic hexameter	feminine penthemimeral, trithemimeral
πόλλ’ ἐπὶ μῆρ’ ἔθεμεν, πέλαγος μέγα μετρήσαντες.	- uu - uu- uu- uu ----	dactylic hexameter	masculine penthemimeral, hepthemimeral, trithemimeral
τέτρατον ἦμαρ ἔην, ὅτ’ ἐν Ἄργεϊ νῆας ἐίσας	-uu -u u- u u -uu -u u--	dactylic hexameter	masculine penthemimeral
Τυδεΐδεω ἕταροι Διομήδεος ἱπποδάμοιο	-uu- uu- uu-uu -uu--	dactylic hexameter	masculine penthemimeral, trithemimeral
ἵστασαν· αὐτάρ ἐγώ γε Πύλονδ’ ἔχον, οὐδέ ποτ’ ἔσβη	-uu -u u- u u- uu -u u --	dactylic hexameter	masculine penthemimeral, hepthemimeral
οὖρος, ἐπεὶ δὴ πρῶτα θεὸς προέηκεν ἀῆναι.	-u u- - -u u- uu-u u--	dactylic hexameter	feminine penthemimeral, hepthemimeral, trithemimeral
ὣς ἦλθον, φίλε τέκνον, ἀπευθής, οὐδέ τι οἶδα	- -- uu -u u-- -u u --	dactylic hexameter	feminine penthemimeral, trithemimeral
κείνων, οἵ τ’ἐσάωθεν Ἀχαιῶν οἵ τ’ἀπόλοντο.	-- - uu-u u-- - uu--	dactylic hexameter	feminine penthemimeral, trithemimeral
ὅσσα δ’ἐνὶ μεγάροισι καθήμενος ἡμετέροισι	-u u- uu-u u-uu -uu--	dactylic hexameter	feminine penthemimeral, trithemimeral
πεύθομαι, ἣ θέμις ἐστί, δαήσεαι, κοὐδέ σε κεύσω.	-uu - uu -u u-- -u u --	dactylic hexameter	feminine penthemimeral, trithemimeral
εὖ μὲν Μυρμιδόνας φάσ’ ἐλθέμεν ἐγχεσιμώρους,	- - -uu- - -uu -uu--	dactylic hexameter	masculine penthemimeral
οὓς ἄγ’ Ἀχιλλῆος μεγαθύμου φαίδιμος υἱός,	- u u--- uu-- -uu --	dactylic hexameter	masculine penthemimeral
εὖ δὲ Φιλοκτήτην, Ποιάντιον ἀγλαὸν υἱόν.	- u u--- --uu -uu --	dactylic hexameter	masculine penthemimeral
πάντας δ’Ἰδομενεὺς Κρήτην εἰσήγαγ’ ἑταίρους,	-- -uu- -- --u u--	dactylic hexameter	masculine penthemimeral, hepthemimeral
οἳ φύγον ἐκ πολέμου, πόντος δέ οἱ οὔ τιν’ ἀπηύρα.	- uu - uu- -- u u - u u--	dactylic hexameter	masculine penthemimeral, hepthemimeral, trithemimeral
Ἀτρεΐδην δὲ καὶ αὐτοὶ ἀκούετε, νόσφιν ἐόντες,	-uu- u u -u u-uu -u u--	dactylic hexameter	feminine penthemimeral, trithemimeral
ὥς τ’ἦλθ’, ὥς τ’Αἴγισθος ἐμήσατο λυγρὸν ὄλεθρον.	- - - --u u-uu -u u--	dactylic hexameter	feminine penthemimeral, trithemimeral
ἀλλ’ ἦ τοι κεῖνος μὲν ἐπισμυγερῶς ἀπέτισεν·	- - - -- u u-uu- uu--	dactylic hexameter	masculine penthemimeral, trithemimeral
ὡς ἀγαθὸν καὶ παῖδα καταφθιμένοιο λιπέσθαι	- uu- - -u u-uu-u u--	dactylic hexameter	feminine penthemimeral, trithemimeral
ἀνδρός, ἐπεὶ καὶ κεῖνος ἐτίσατο πατροφονῆα,	-u u- - -u u-uu -uu--	dactylic hexameter	feminine penthemimeral, trithemimeral
Αἴγισθον δολόμητιν, ὅ οἱ πατέρα κλυτὸν ἔκτα.	--- uu-u u - uu- uu --	dactylic hexameter	feminine penthemimeral, hepthemimeral, trithemimeral
καὶ σὺ φίλος, μάλα γάρ σ’ὁρόω καλόν τε μέγαν τε,	- u u- uu - uu- -- u u- -	dactylic hexameter	masculine penthemimeral, hepthemimeral, trithemimeral
ἄλκιμος ἔσσ’, ἵνα τίς σε καὶ ὀψιγόνων ἐὺ εἴπῃ.	-uu - uu - u u -uu- uu --	dactylic hexameter	masculine penthemimeral, trithemimeral
τὸν δ’αὖ Τηλέμαχος πεπνυμένος ἀντίον ηὔδα·	- - -uu- --uu -uu --	dactylic hexameter	masculine penthemimeral
ὦ Νέστορ Νηληϊάδη, μέγα κῦδος Ἀχαιῶν,	- -- --uu- uu -u u--	dactylic hexameter	hepthemimeral, trithemimeral
καὶ λίην κεῖνος μὲν ἐτίσατο, καί οἱ Ἀχαιοὶ	- -- -- u u-uu - u u--	dactylic hexameter	masculine penthemimeral, trithemimeral
οἴσουσι κλέος εὐρὺ καὶ ἐσσομένοισι πυθέσθαι·	--- uu -u u -uu-u u--	dactylic hexameter	feminine penthemimeral, trithemimeral
αἲ γὰρ ἐμοὶ τοσσήνδε θεοὶ δύναμιν περιθεῖεν,	- u u- --u u- uu- uu--	dactylic hexameter	feminine penthemimeral, hepthemimeral, trithemimeral
τίσασθαι μνηστῆρας ὑπερβασίης ἀλεγεινῆς,	--- --u u-uu- uu--	dactylic hexameter	feminine penthemimeral, trithemimeral
οἵ τέ μοι ὑβρίζοντες ἀτάσθαλα μηχανόωνται.	- u u ---u u-uu -uu--	dactylic hexameter	feminine penthemimeral
ἀλλ’ οὔ μοι τοιοῦτον ἐπέκλωσαν θεοὶ ὄλβον,	- - - --u u--- uu --	dactylic hexameter	feminine penthemimeral, trithemimeral
πατρί τ’ἐμῷ καὶ ἐμοί· νῦν δὲ χρὴ τετλάμεν ἔμπης.	-u u- u u- - - - -uu --	dactylic hexameter	masculine penthemimeral, hepthemimeral, trithemimeral
τὸν δ’ἠμείβετ’ ἔπειτα Γερήνιος ἱππότα Νέστωρ·	- --u u-u u-uu -uu --	dactylic hexameter	feminine penthemimeral
ὦ φίλ’, ἐπεὶ δὴ ταῦτά μ’ ἀνέμνησας καὶ ἔειπες,	- u u- - -u u--- u u--	dactylic hexameter	feminine penthemimeral, trithemimeral
φασὶ μνηστῆρας σῆς μητέρος εἵνεκα πολλοὺς	-- --- - -uu -uu --	dactylic hexameter	masculine penthemimeral
ἐν μεγάροις ἀέκητι σέθεν κακὰ μηχανάασθαι·	- uu- uu-u u- uu -uu--	dactylic hexameter	feminine penthemimeral, hepthemimeral, trithemimeral
εἰπέ μοι, ἠὲ ἑκὼν ὑποδάμνασαι, ἦ σέ γε λαοὶ	-u u -u u- uu-uu - u u --	dactylic hexameter	masculine penthemimeral
ἐχθαίρουσ’ ἀνὰ δῆμον, ἐπισπόμενοι θεοῦ ὀμφῇ.	--- uu -u u-uu- uu --	dactylic hexameter	feminine penthemimeral, trithemimeral
τίς δ’οἶδ’ εἴ κέ ποτέ σφι βίας ἀποτίσεται ἐλθών,	- - - u u- u u- uu-uu --	dactylic hexameter	masculine penthemimeral, hepthemimeral, trithemimeral
ἢ ὅ γε μοῦνος ἐὼν ἢ καὶ σύμπαντες Ἀχαιοί;	- u u -u u- - - --u u--	dactylic hexameter	masculine penthemimeral, hepthemimeral
εἰ γάρ σ’ὣς ἐθέλοι φιλέειν γλαυκῶπις Ἀθήνη,	- - - uu- uu- --u u--	dactylic hexameter	masculine penthemimeral, hepthemimeral, trithemimeral
ὡς τότ’ Ὀδυσσῆος περικήδετο κυδαλίμοιο	- u u--- uu-uu -uu--	dactylic hexameter	masculine penthemimeral
δήμῳ ἔνι Τρώων, ὅθι πάσχομεν ἄλγε’ Ἀχαιοί--	-u u- -- uu -uu -u u--	dactylic hexameter	masculine penthemimeral, trithemimeral
οὐ γάρ πω ἴδον ὧδε θεοὺς ἀναφανδὰ φιλεῦντας,	- - - uu -u u- uu-u u--	dactylic hexameter	feminine penthemimeral, hepthemimeral, trithemimeral
ὡς κείνῳ ἀναφανδὰ παρίστατο Παλλὰς Ἀθήνη--	- -- uu-u u-uu -u u--	dactylic hexameter	feminine penthemimeral, trithemimeral
εἴ σ’οὕτως ἐθέλοι φιλέειν κήδοιτό τε θυμῷ,	- -- uu- uu- --u u --	dactylic hexameter	masculine penthemimeral, hepthemimeral, trithemimeral
τῶ κέν τις κείνων γε καὶ ἐκλελάθοιτο γάμοιο.	- - - -- u u -uu-u u--	dactylic hexameter	masculine penthemimeral, trithemimeral
τὸν δ’αὖ Τηλέμαχος πεπνυμένος ἀντίον ηὔδα·	- - -uu- --uu -uu --	dactylic hexameter	masculine penthemimeral
ὦ γέρον, οὔ πω τοῦτο ἔπος τελέεσθαι ὀίω·	- uu - - -u u- uu-u u--	dactylic hexameter	feminine penthemimeral, hepthemimeral, trithemimeral
λίην γὰρ μέγα εἶπες· ἄγη μ’ἔχει. οὐκ ἂν ἐμοί γε	-- - uu -u u- uu - u u- -	dactylic hexameter	feminine penthemimeral, hepthemimeral, trithemimeral
ἐλπομένω τὰ γένοιτ’, οὐδ’ εἰ θεοὶ ὣς ἐθέλοιεν.	-uu- u u- - - uu - uu--	dactylic hexameter	masculine penthemimeral, hepthemimeral, trithemimeral
τὸν δ’αὖτε προσέειπε θεά, γλαυκῶπις Ἀθήνη·	- -- uu-u u- --u u--	dactylic hexameter	feminine penthemimeral, hepthemimeral, trithemimeral
Τηλέμαχε, ποῖόν σε ἔπος φύγεν ἕρκος ὀδόντων.	-uu- -- u u- uu -u u--	dactylic hexameter	masculine penthemimeral, hepthemimeral, trithemimeral
ῥεῖα θεός γ’ἐθέλων καὶ τηλόθεν ἄνδρα σαώσαι.	-u u- uu- - -uu -u u--	dactylic hexameter	masculine penthemimeral, trithemimeral
βουλοίμην δ’ἂν ἐγώ γε καὶ ἄλγεα πολλὰ μογήσας	--- u u- u u -uu -u u--	dactylic hexameter	masculine penthemimeral, trithemimeral
οἴκαδέ τ’ἐλθέμεναι καὶ νόστιμον ἦμαρ ἰδέσθαι,	-uu -uu- - -uu -u u--	dactylic hexameter	masculine penthemimeral
ἢ ἐλθὼν ἀπολέσθαι ἐφέστιος, ὡς Ἀγαμέμνων	- -- uu-u u-uu - uu--	dactylic hexameter	feminine penthemimeral, trithemimeral
ὤλεθ’ ὑπ’ Αἰγίσθοιο δόλῳ καὶ ἧς ἀλόχοιο.	-u u ---u u- - - uu--	dactylic hexameter	feminine penthemimeral, hepthemimeral
ἀλλ’ ἦ τοι θάνατον μὲν ὁμοίιον οὐδὲ θεοί περ	- - - uu- u u-uu -u u- -	dactylic hexameter	masculine penthemimeral, trithemimeral
καὶ φίλῳ ἀνδρὶ δύνανται ἀλαλκέμεν, ὁππότε κεν δὴ	- uu -u u-u u-uu -uu - -	dactylic hexameter	feminine penthemimeral
μοῖρ’ ὀλοὴ καθέλῃσι τανηλεγέος θανάτοιο.	- uu- uu-u u-uu- uu--	dactylic hexameter	feminine penthemimeral, trithemimeral
τὴν δ’αὖ Τηλέμαχος πεπνυμένος ἀντίον ηὔδα·	- - -uu- --uu -uu --	dactylic hexameter	masculine penthemimeral
Μέντορ, μηκέτι ταῦτα λεγώμεθα κηδόμενοί περ·	-- -uu -u u-uu -uu- -	dactylic hexameter	feminine penthemimeral
κείνῳ δ’οὐκέτι νόστος ἐτήτυμος, ἀλλά οἱ ἤδη	-- -uu -u u-uu -u u --	dactylic hexameter	feminine penthemimeral
φράσσαντ’ ἀθάνατοι θάνατον καὶ κῆρα μέλαιναν.	-- -uu- uu- - -u u--	dactylic hexameter	masculine penthemimeral, hepthemimeral
νῦν δ’ἐθέλω ἔπος ἄλλο μεταλλῆσαι καὶ ἐρέσθαι	- uu- uu -u u--- u u--	dactylic hexameter	feminine penthemimeral, trithemimeral
Νέστορ’, ἐπεὶ περὶ οἶδε δίκας ἠδὲ φρόνιν ἄλλων·	-u u- uu -u u- -- uu --	dactylic hexameter	feminine penthemimeral, hepthemimeral, trithemimeral
τρὶς γὰρ δή μίν φασιν ἀνάξασθαι γένε’ ἀνδρῶν·	- - - - -u u--- uu --	dactylic hexameter	feminine penthemimeral, trithemimeral
ὥς τέ μοι ἀθάνατος ἰνδάλλεται εἰσοράασθαι.	- u u -uu- --uu -uu--	dactylic hexameter	masculine penthemimeral
ὦ Νέστορ Νηληϊάδη, σὺ δ’ἀληθὲς ἐνίσπες·	- -- --uu- u u-u u--	dactylic hexameter	hepthemimeral, trithemimeral
πῶς ἔθαν’ Ἀτρεΐδης εὐρὺ κρείων Ἀγαμέμνων;	- uu -uu- -- -- uu--	dactylic hexameter	masculine penthemimeral, hepthemimeral
ποῦ Μενέλαος ἔην; τίνα δ’αὐτῷ μήσατ’ ὄλεθρον	- uu-u u- uu -- -u u--	dactylic hexameter	masculine penthemimeral
Αἴγισθος δολόμητις, ἐπεὶ κτάνε πολλὸν ἀρείω;	--- uu-u u- uu -u u--	dactylic hexameter	feminine penthemimeral, hepthemimeral, trithemimeral
ἦ οὐκ Ἄργεος ἦεν Ἀχαιικοῦ, ἀλλά πῃ ἄλλῃ	- - -uu -u u-uu -u u --	dactylic hexameter	feminine penthemimeral
πλάζετ’ ἐπ’ ἀνθρώπους, ὁ δὲ θαρσήσας κατέπεφνε;	-u u --- u u --- uu--	dactylic hexameter	masculine penthemimeral
τὸν δ’ἠμείβετ’ ἔπειτα Γερήνιος ἱππότα Νέστωρ·	- --u u-u u-uu -uu --	dactylic hexameter	feminine penthemimeral
τοιγὰρ ἐγώ τοι, τέκνον, ἀληθέα πάντ’ ἀγορεύσω.	-u u- - -u u-uu - uu--	dactylic hexameter	feminine penthemimeral, trithemimeral
ἦ τοι μὲν τάδε καὐτὸς ὀίεαι, ὥς κεν ἐτύχθη,	- - - uu -u u-uu - u u--	dactylic hexameter	feminine penthemimeral, trithemimeral
εἰ ζωόν γ’Αἴγισθον ἐνὶ μεγάροισιν ἔτετμεν	- -- --u u- uu-u u--	dactylic hexameter	feminine penthemimeral, hepthemimeral, trithemimeral
Ἀτρεΐδης Τροίηθεν ἰών, ξανθὸς Μενέλαος·	-uu- --u u- -- uu--	dactylic hexameter	feminine penthemimeral, hepthemimeral, trithemimeral
τῶ κέ οἱ οὐδὲ θανόντι χυτὴν ἐπὶ γαῖαν ἔχευαν,	- u u -u u-u u- uu -u u--	dactylic hexameter	feminine penthemimeral, hepthemimeral
ἀλλ’ ἄρα τόν γε κύνες τε καὶ οἰωνοὶ κατέδαψαν	- uu - u u- u u --- uu--	dactylic hexameter	masculine penthemimeral, trithemimeral
κείμενον ἐν πεδίῳ ἑκὰς ἄστεος, οὐδέ κέ τίς μιν	-uu - uu- uu -uu -u u - -	dactylic hexameter	masculine penthemimeral, trithemimeral
κλαῦσεν Ἀχαιιάδων· μάλα γὰρ μέγα μήσατο ἔργον.	-u u-uu- uu - uu -uu --	dactylic hexameter	masculine penthemimeral, hepthemimeral
ἡμεῖς μὲν γὰρ κεῖθι πολέας τελέοντες ἀέθλους	-- - - -u u- uu-u u--	dactylic hexameter	feminine penthemimeral, hepthemimeral, trithemimeral
ἥμεθ’· ὁ δ’εὔκηλος μυχῷ Ἄργεος ἱπποβότοιο	-u u --- uu -uu -uu--	dactylic hexameter	masculine penthemimeral
πόλλ’ Ἀγαμεμνονέην ἄλοχον θέλγεσκ’ ἐπέεσσιν.	- uu-uu- uu- -- uu--	dactylic hexameter	masculine penthemimeral, hepthemimeral
ἡ δ’ἦ τοι τὸ πρὶν μὲν ἀναίνετο ἔργον ἀεικὲς	- - - - - u u-uu -u u--	dactylic hexameter	masculine penthemimeral, trithemimeral
δῖα Κλυταιμνήστρη· φρεσὶ γὰρ κέχρητ’ ἀγαθῇσι·	-u u--- uu - -- uu--	dactylic hexameter	masculine penthemimeral, hepthemimeral
πὰρ δ’ἄρ’ ἔην καὶ ἀοιδὸς ἀνήρ, ᾧ πόλλ’ ἐπέτελλεν	- u u- u u-u u- - - uu--	dactylic hexameter	feminine penthemimeral, hepthemimeral, trithemimeral
Ἀτρεΐδης Τροίηνδε κιὼν ἔρυσασθαι ἄκοιτιν.	-uu- --u u- uu-u u--	dactylic hexameter	feminine penthemimeral, hepthemimeral, trithemimeral
ἀλλ’ ὅτε δή μιν μοῖρα θεῶν ἐπέδησε δαμῆναι,	- uu - - -u u- uu-u u--	dactylic hexameter	feminine penthemimeral, hepthemimeral, trithemimeral
δὴ τότε τὸν μὲν ἀοιδὸν ἄγων ἐς νῆσον ἐρήμην	- uu - u u-u u- - -u u--	dactylic hexameter	feminine penthemimeral, hepthemimeral, trithemimeral
κάλλιπεν οἰωνοῖσιν ἕλωρ καὶ κύρμα γενέσθαι,	-uu ---u u- - -u u--	dactylic hexameter	feminine penthemimeral, hepthemimeral
τὴν δ’ἐθέλων ἐθέλουσαν ἀνήγαγεν ὅνδε δόμονδε.	- uu- uu-u u-uu -u u--	dactylic hexameter	feminine penthemimeral, trithemimeral
πολλὰ δὲ μηρί’ ἔκηε θεῶν ἱεροῖς ἐπὶ βωμοῖς,	-u u -u u-u u- uu- uu --	dactylic hexameter	feminine penthemimeral, hepthemimeral
πολλὰ δ’ἀγάλματ’ ἀνῆψεν, ὑφάσματά τε χρυσόν τε,	-u u-u u-u u-uu - -- -	dactylic hexameter	feminine penthemimeral
ἐκτελέσας μέγα ἔργον, ὃ οὔ ποτε ἔλπετο θυμῷ.	-uu- uu -u u - uu -uu --	dactylic hexameter	feminine penthemimeral, hepthemimeral, trithemimeral
ἡμεῖς μὲν γὰρ ἅμα πλέομεν Τροίηθεν ἰόντες,	-- - u u- uu- --u u--	dactylic hexameter	masculine penthemimeral, hepthemimeral, trithemimeral
Ἀτρεΐδης καὶ ἐγώ, φίλα εἰδότες ἀλλήλοισιν·	-uu- u u- uu -uu ----	dactylic hexameter	masculine penthemimeral, trithemimeral
ἀλλ’ ὅτε Σούνιον ἱρὸν ἀφικόμεθ’, ἄκρον Ἀθηνέων,	- uu -uu -u u-uu -u u--	dactylic hexameter	feminine penthemimeral
ἔνθα κυβερνήτην Μενελάου Φοῖβος Ἀπόλλων	-u u--- uu-- -u u--	dactylic hexameter	masculine penthemimeral
οἷς ἀγανοῖς βελέεσσιν ἐποιχόμενος κατέπεφνε,	- uu- uu-u u-uu- uu--	dactylic hexameter	feminine penthemimeral, trithemimeral
πηδάλιον μετὰ χερσὶ θεούσης νηὸς ἔχοντα,	-uu- uu -u u-- -u u--	dactylic hexameter	feminine penthemimeral, trithemimeral
Φρόντιν Ὀνητορίδην, ὃς ἐκαίνυτο φῦλ’ ἀνθρώπων	-u u-uu- u u-uu - ---	dactylic hexameter	masculine penthemimeral
νῆα κυβερνῆσαι, ὁπότε σπέρχοιεν ἄελλαι.	-u u--- uu- --u u--	dactylic hexameter	masculine penthemimeral, hepthemimeral
ὣς ὁ μὲν ἔνθα κατέσχετ’, ἐπειγόμενός περ ὁδοῖο,	- u u -u u-u u-uu- u u--	dactylic hexameter	feminine penthemimeral
ὄφρ’ ἕταρον θάπτοι καὶ ἐπὶ κτέρεα κτερίσειεν.	- uu- -- u u- uu- uu--	dactylic hexameter	masculine penthemimeral, hepthemimeral, trithemimeral
ἀλλ’ ὅτε δὴ καὶ κεῖνος ἰὼν ἐπὶ οἴνοπα πόντον	- uu - - -u u- uu -uu --	dactylic hexameter	feminine penthemimeral, hepthemimeral, trithemimeral
ἐν νηυσὶ γλαφυρῇσι Μαλειάων ὄρος αἰπὺ	- -- uu-u u--- uu --	dactylic hexameter	feminine penthemimeral, trithemimeral
ἷξε θέων, τότε δὴ στυγερὴν ὁδὸν εὐρύοπα Ζεὺς	-u u- uu - uu- uu -uu- -	dactylic hexameter	masculine penthemimeral, hepthemimeral, trithemimeral
ἐφράσατο, λιγέων δ’ἀνέμων ἐπ’ ἀυτμένα χεῦε,	-uu- uu- uu- u u-uu --	dactylic hexameter	masculine penthemimeral, hepthemimeral, trithemimeral
κύματά τε τροφέοντο πελώρια, ἶσα ὄρεσσιν.	-uu - uu-u u-uu -u u--	dactylic hexameter	feminine penthemimeral, trithemimeral
ἔνθα διατμήξας τὰς μὲν Κρήτῃ ἐπέλασσεν,	-u u--- - - -- uu--	dactylic hexameter	masculine penthemimeral, hepthemimeral
ἧχι Κύδωνες ἔναιον Ἰαρδάνου ἀμφὶ ῥέεθρα.	-u u-u u-u u-uu -u u--	dactylic hexameter	feminine penthemimeral
ἔστι δέ τις λισσὴ αἰπεῖά τε εἰς ἅλα πέτρη	-u u - -- --u u - uu --	dactylic hexameter	masculine penthemimeral, trithemimeral
ἐσχατιῇ Γόρτυνος ἐν ἠεροειδέι πόντῳ·	-uu- --u u -uu-uu --	dactylic hexameter	feminine penthemimeral, trithemimeral
ἔνθα Νότος μέγα κῦμα ποτὶ σκαιὸν ῥίον ὠθεῖ,	-u u- uu -u u- -- uu --	dactylic hexameter	feminine penthemimeral, hepthemimeral, trithemimeral
ἐς Φαιστόν, μικρὸς δὲ λίθος μέγα κῦμ’ ἀποέργει.	- -- -- u u- uu - uu--	dactylic hexameter	masculine penthemimeral, hepthemimeral, trithemimeral
αἱ μὲν ἄρ’ ἔνθ’ ἦλθον, σπουδῇ δ’ἤλυξαν ὄλεθρον	- u u - -- -- --u u--	dactylic hexameter	masculine penthemimeral, hepthemimeral, trithemimeral
ἄνδρες, ἀτὰρ νῆάς γε ποτὶ σπιλάδεσσιν ἔαξαν	-u u- -- u u- uu-u u--	dactylic hexameter	masculine penthemimeral, hepthemimeral, trithemimeral
κύματ’· ἀτὰρ τὰς πέντε νέας κυανοπρῳρείους	-u u- - -u u- uu----	dactylic hexameter	feminine penthemimeral, hepthemimeral, trithemimeral
Αἰγύπτῳ ἐπέλασσε φέρων ἄνεμός τε καὶ ὕδωρ.	--- uu-u u- uu- u u --	dactylic hexameter	feminine penthemimeral, hepthemimeral, trithemimeral
ὣς ὁ μὲν ἔνθα πολὺν βίοτον καὶ χρυσὸν ἀγείρων	- u u -u u- uu- - -u u--	dactylic hexameter	masculine penthemimeral, hepthemimeral
ἠλᾶτο ξὺν νηυσὶ κατ’ ἀλλοθρόους ἀνθρώπους·	--- - -u u -uu- ---	dactylic hexameter	feminine penthemimeral, trithemimeral
τόφρα δὲ ταῦτ’ Αἴγισθος ἐμήσατο οἴκοθι λυγρά.	-u u - --u u-uu -uu --	dactylic hexameter	feminine penthemimeral, trithemimeral
ἑπτάετες δ’ἤνασσε πολυχρύσοιο Μυκήνης,	-uu- --u u---u u--	dactylic hexameter	feminine penthemimeral, trithemimeral
κτείνας Ἀτρεΐδην, δέδμητο δὲ λαὸς ὑπ’ αὐτῷ.	-- -uu- --u u -u u --	dactylic hexameter	masculine penthemimeral
τῷ δέ οἱ ὀγδοάτῳ κακὸν ἤλυθε δῖος Ὀρέστης	- u u -uu- uu -uu -u u--	dactylic hexameter	masculine penthemimeral
ἂψ ἀπ’ Ἀθηνάων, κατὰ δ’ἔκτανε πατροφονῆα,	- u u--- uu -uu -uu--	dactylic hexameter	masculine penthemimeral
Αἴγισθον δολόμητιν, ὅ οἱ πατέρα κλυτὸν ἔκτα.	--- uu-u u - uu- uu --	dactylic hexameter	feminine penthemimeral, hepthemimeral, trithemimeral
ἦ τοι ὁ τὸν κτείνας δαίνυ τάφον Ἀργείοισιν	- u u - -- -- uu ----	dactylic hexameter	masculine penthemimeral, hepthemimeral, trithemimeral
μητρός τε στυγερῆς καὶ ἀνάλκιδος Αἰγίσθοιο·	-- - uu- u u-uu ----	dactylic hexameter	masculine penthemimeral, trithemimeral
αὐτῆμαρ δέ οἱ ἦλθε βοὴν ἀγαθὸς Μενέλαος	--- u u -u u- uu- uu--	dactylic hexameter	feminine penthemimeral, hepthemimeral, trithemimeral
πολλὰ κτήματ’ ἄγων, ὅσα οἱ νέες ἄχθος ἄειραν.	-- -u u- uu - uu -u u--	dactylic hexameter	masculine penthemimeral, hepthemimeral
καὶ σύ, φίλος, μὴ δηθὰ δόμων ἄπο τῆλ’ ἀλάλησο,	- u u- - -u u- uu - uu--	dactylic hexameter	feminine penthemimeral, hepthemimeral, trithemimeral
κτήματά τε προλιπὼν ἄνδρας τ’ἐν σοῖσι δόμοισιν	-uu - uu- -- - -u u--	dactylic hexameter	masculine penthemimeral, hepthemimeral, trithemimeral
οὕτω ὑπερφιάλους, μή τοι κατὰ πάντα φάγωσιν	-u u-uu- - - uu -u u--	dactylic hexameter	masculine penthemimeral, hepthemimeral
κτήματα δασσάμενοι, σὺ δὲ τηϋσίην ὁδὸν ἔλθῃς.	-uu -uu- u u -uu- uu --	dactylic hexameter	masculine penthemimeral
ἀλλ’ ἐς μὲν Μενέλαον ἐγὼ κέλομαι καὶ ἄνωγα	- - - uu-u u- uu- u u--	dactylic hexameter	feminine penthemimeral, hepthemimeral, trithemimeral
ἐλθεῖν· κεῖνος γὰρ νέον ἄλλοθεν εἰλήλουθεν,	-- -- - uu -uu ----	dactylic hexameter	masculine penthemimeral
ἐκ τῶν ἀνθρώπων, ὅθεν οὐκ ἔλποιτό γε θυμῷ	- - --- uu - --u u --	dactylic hexameter	masculine penthemimeral, hepthemimeral
ἐλθέμεν, ὅν τινα πρῶτον ἀποσφήλωσιν ἄελλαι	-uu - uu -u u---u u--	dactylic hexameter	feminine penthemimeral, trithemimeral
ἐς πέλαγος μέγα τοῖον, ὅθεν τέ περ οὐδ’ οἰωνοὶ	- uu- uu -u u- u u - ---	dactylic hexameter	feminine penthemimeral, hepthemimeral, trithemimeral
αὐτόετες οἰχνεῦσιν, ἐπεὶ μέγα τε δεινόν τε.	-uu- --u u- uu - -- -	dactylic hexameter	feminine penthemimeral, hepthemimeral, trithemimeral
ἀλλ’ ἴθι νῦν σὺν νηί τε σῇ καὶ σοῖς ἑτάροισιν·	- uu - - -u u - - - uu--	dactylic hexameter	feminine penthemimeral, hepthemimeral, trithemimeral
εἰ δ’ἐθέλεις πεζός, πάρα τοι δίφρος τε καὶ ἵπποι,	- uu- -- uu - -- u u --	dactylic hexameter	masculine penthemimeral, hepthemimeral, trithemimeral
πὰρ δὲ τοι υἷες ἐμοί, οἵ τοι πομπῆες ἔσονται	- u u -u u- - - --u u--	dactylic hexameter	masculine penthemimeral, hepthemimeral
ἐς Λακεδαίμονα δῖαν, ὅθι ξανθὸς Μενέλαος.	- uu-uu -u u- -- uu--	dactylic hexameter	feminine penthemimeral, hepthemimeral
λίσσεσθαι δέ μιν αὐτός, ἵνα νημερτὲς ἐνίσπῃ·	--- u u -u u- --u u--	dactylic hexameter	feminine penthemimeral, hepthemimeral, trithemimeral
ψεῦδος δ’οὐκ ἐρέει· μάλα γὰρ πεπνυμένος ἐστίν.	-- - uu- uu - --uu --	dactylic hexameter	masculine penthemimeral, hepthemimeral, trithemimeral
ὣς ἔφατ’, ἠέλιος δ’ἄρ’ ἔδυ καὶ ἐπὶ κνέφας ἦλθε.	- uu -uu- u u- u u- uu --	dactylic hexameter	masculine penthemimeral, hepthemimeral
τοῖσι δὲ καὶ μετέειπε θεά, γλαυκῶπις Ἀθήνη·	-u u - uu-u u- --u u--	dactylic hexameter	feminine penthemimeral, hepthemimeral, trithemimeral
ὦ γέρον, ἦ τοι ταῦτα κατὰ μοῖραν κατέλεξας·	- uu - - -u u- -- uu--	dactylic hexameter	feminine penthemimeral, hepthemimeral, trithemimeral
ἀλλ’ ἄγε τάμνετε μὲν γλώσσας, κεράασθε δὲ οἶνον,	- uu -uu - -- uu-u u --	dactylic hexameter	masculine penthemimeral, hepthemimeral
ὄφρα Ποσειδάωνι καὶ ἄλλοις ἀθανάτοισιν	-u u---u u -- -uu--	dactylic hexameter	feminine penthemimeral
σπείσαντες κοίτοιο μεδώμεθα· τοῖο γὰρ ὥρη.	--- --u u-uu -u u --	dactylic hexameter	feminine penthemimeral, trithemimeral
ἤδη γὰρ φάος οἴχεθ’ ὑπὸ ζόφον, οὐδὲ ἔοικεν·	-- - uu -u u- uu -u u--	dactylic hexameter	feminine penthemimeral, hepthemimeral, trithemimeral
δηθὰ θεῶν ἐν δαιτὶ θαασσέμεν, ἀλλὰ νέεσθαι.	-u u- - -u u-uu -u u--	dactylic hexameter	feminine penthemimeral, trithemimeral
ἦ ῥα Διὸς θυγάτηρ, οἱ δ’ἔκλυον αὐδησάσης.	- u u- uu- - -uu ----	dactylic hexameter	masculine penthemimeral, trithemimeral
τοῖσι δὲ κήρυκες μὲν ὕδωρ ἐπὶ χεῖρας ἔχευαν,	-u u --- u u- uu -u u--	dactylic hexameter	masculine penthemimeral, hepthemimeral
κοῦροι δὲ κρητῆρας ἐπεστέψαντο ποτοῖο,	-- - --u u---u u--	dactylic hexameter	feminine penthemimeral, trithemimeral
νώμησαν δ’ἄρα πᾶσιν ἐπαρξάμενοι δεπάεσσι·	--- uu -u u-uu- uu--	dactylic hexameter	feminine penthemimeral, trithemimeral
γλώσσας δ’ἐν πυρὶ βάλλον, ἀνιστάμενοι δ’ἐπέλειβον.	-- - uu -u u-uu- uu--	dactylic hexameter	feminine penthemimeral, trithemimeral
αὐτὰρ ἐπεὶ σπεῖσάν τ’ἔπιον θ’,ὅσον ἤθελε θυμός,	-u u- -- uu- uu -uu --	dactylic hexameter	masculine penthemimeral, hepthemimeral, trithemimeral
δὴ τότ’ Ἀθηναίη καὶ Τηλέμαχος θεοειδὴς	- u u--- - -uu- uu--	dactylic hexameter	masculine penthemimeral
ἄμφω ἱέσθην κοίλην ἐπὶ νῆα νέεσθαι.	-- --- -- uu -u u--	dactylic hexameter	masculine penthemimeral, hepthemimeral
Νέστωρ δ’αὖ κατέρυκε καθαπτόμενος ἐπέεσσιν·	-- - uu-u u-uu- uu--	dactylic hexameter	feminine penthemimeral, trithemimeral
Ζεὺς τό γ’ἀλεξήσειε καὶ ἀθάνατοι θεοὶ ἄλλοι,	- u u---u u -uu- uu --	dactylic hexameter	feminine penthemimeral
ὡς ὑμεῖς παρ’ ἐμεῖο θοὴν ἐπὶ νῆα κίοιτε	- -- u u-u u- uu -u u--	dactylic hexameter	feminine penthemimeral, hepthemimeral, trithemimeral
ὥς τέ τευ ἦ παρὰ πάμπαν ἀνείμονος ἠδὲ πενιχροῦ,	- u u - uu -u u-uu -u u--	dactylic hexameter	feminine penthemimeral, trithemimeral
ᾧ οὔ τι χλαῖναι καὶ ῥήγεα πόλλ’ ἐνὶ οἴκῳ,	- - - -- - -uu - uu --	dactylic hexameter	masculine penthemimeral, trithemimeral
οὔτ’ αὐτῷ μαλακῶς οὔτε ξείνοισιν ἐνεύδειν.	- -- uu- -- --u u--	dactylic hexameter	masculine penthemimeral, hepthemimeral, trithemimeral
αὐτὰρ ἐμοὶ πάρα μὲν χλαῖναι καὶ ῥήγεα καλά.	-u u- uu - -- - -uu --	dactylic hexameter	masculine penthemimeral, hepthemimeral, trithemimeral
οὔ θην δὴ τοῦδ’ ἀνδρὸς Ὀδυσσῆος φίλος υἱὸς	- - - - -u u--- uu --	dactylic hexameter	feminine penthemimeral, trithemimeral
νηὸς ἐπ’ ἰκριόφιν καταλέξεται, ὄφρ’ ἂν ἐγώ γε	-u u -uu- uu-uu - u u- -	dactylic hexameter	masculine penthemimeral
ζώω, ἔπειτα δὲ παῖδες ἐνὶ μεγάροισι λίπωνται,	-u u-u u -u u- uu-u u--	dactylic hexameter	feminine penthemimeral, hepthemimeral
ξείνους ξεινίζειν, ὅς τίς κ’ἐμὰ δώμαθ’ ἵκηται.	-- --- - - uu -u u--	dactylic hexameter	masculine penthemimeral, hepthemimeral
τὸν δ’αὖτε προσέειπε θεά, γλαυκῶπις Ἀθήνη·	- -- uu-u u- --u u--	dactylic hexameter	feminine penthemimeral, hepthemimeral, trithemimeral
εὖ δὴ ταῦτά γ’ἔφησθα, γέρον φίλε· σοὶ δὲ ἔοικεν	- - -u u-u u- uu - u u--	dactylic hexameter	feminine penthemimeral, hepthemimeral
Τηλέμαχον πείθεσθαι, ἐπεὶ πολὺ κάλλιον οὕτως.	-uu- --u u- uu -uu --	dactylic hexameter	feminine penthemimeral, hepthemimeral, trithemimeral
ἀλλ’ οὗτος μὲν νῦν σοὶ ἅμ’ ἕψεται, ὄφρα κεν εὕδῃ	- -- - - u u -uu -u u --	dactylic hexameter	masculine penthemimeral, trithemimeral
σοῖσιν ἐνὶ μεγάροισιν· ἐγὼ δ’ἐπὶ νῆα μέλαιναν	-u u- uu-u u- uu -u u--	dactylic hexameter	feminine penthemimeral, hepthemimeral, trithemimeral
εἶμ’, ἵνα θαρσύνω θ’ἑτάρους εἴπω τε ἕκαστα.	- uu --- uu- -- u u--	dactylic hexameter	masculine penthemimeral, hepthemimeral
οἶος γὰρ μετὰ τοῖσι γεραίτερος εὔχομαι εἶναι·	-- - uu -u u-uu -uu --	dactylic hexameter	feminine penthemimeral, trithemimeral
οἱ δ’ἄλλοι φιλότητι νεώτεροι ἄνδρες ἕπονται,	- -- uu-u u-uu -u u--	dactylic hexameter	feminine penthemimeral, trithemimeral
πάντες ὁμηλικίη μεγαθύμου Τηλεμάχοιο.	-u u-uu- uu-- -uu--	dactylic hexameter	masculine penthemimeral
ἔνθα κε λεξαίμην κοίλῃ παρὰ νηὶ μελαίνῃ	-u u --- -- uu -u u--	dactylic hexameter	masculine penthemimeral, hepthemimeral
νῦν· ἀτὰρ ἠῶθεν μετὰ Καύκωνας μεγαθύμους	- uu --- uu --- uu--	dactylic hexameter	masculine penthemimeral
εἶμ’ ἔνθα χρεῖός μοι ὀφέλλεται, οὔ τι νέον γε	- -- -- u u-uu - u u- -	dactylic hexameter	masculine penthemimeral, trithemimeral
οὐδ’ ὀλίγον. σὺ δὲ τοῦτον, ἐπεὶ τεὸν ἵκετο δῶμα,	- uu- u u -u u- uu -uu --	dactylic hexameter	feminine penthemimeral, hepthemimeral, trithemimeral
πέμψον σὺν δίφρῳ τε καὶ υἱέι· δὸς δέ οἱ ἵππους,	-- - -- u u -uu - u u --	dactylic hexameter	masculine penthemimeral, trithemimeral
οἵ τοι ἐλαφρότατοι θείειν καὶ κάρτος ἄριστοι.	- u u-uu- -- - -u u--	dactylic hexameter	masculine penthemimeral, hepthemimeral
ὣς ἄρα φωνήσασ’ ἀπέβη γλαυκῶπις Ἀθήνη	- uu --- uu- --u u--	dactylic hexameter	masculine penthemimeral, hepthemimeral
φήνῃ εἰδομένη· θάμβος δ’ἕλε πάντας ἰδόντας.	-- -uu- -- uu -u u--	dactylic hexameter	masculine penthemimeral, hepthemimeral
θαύμαζεν δ’ὁ γεραιός, ὅπως ἴδεν ὀφθαλμοῖσιν·	--- u u-u u- uu ----	dactylic hexameter	feminine penthemimeral, hepthemimeral, trithemimeral
Τηλεμάχου δ’ἕλε χεῖρα, ἔπος τ’ἔφατ’ ἔκ τ’ὀνόμαζεν·	-uu- uu -u u- uu - uu--	dactylic hexameter	feminine penthemimeral, hepthemimeral, trithemimeral
ὦ φίλος, οὔ σε ἔολπα κακὸν καὶ ἄναλκιν ἔσεσθαι,	- uu - u u-u u- u u-u u--	dactylic hexameter	feminine penthemimeral, hepthemimeral, trithemimeral
εἰ δή τοι νέῳ ὧδε θεοὶ πομπῆες ἕπονται.	- - - uu -u u- --u u--	dactylic hexameter	feminine penthemimeral, hepthemimeral, trithemimeral
οὐ μὲν γάρ τις ὅδ’ ἄλλος Ὀλύμπια δώματ’ ἐχόντων,	- - - u u -u u-uu -u u--	dactylic hexameter	feminine penthemimeral, trithemimeral
ἀλλὰ Διὸς θυγάτηρ, κυδίστη Τριτογένεια,	-u u- uu- --- -uu--	dactylic hexameter	masculine penthemimeral, trithemimeral
ἥ τοι καὶ πατέρ’ ἐσθλὸν ἐν Ἀργείοισιν ἐτίμα.	- - - uu -u u ---u u--	dactylic hexameter	feminine penthemimeral, trithemimeral
ἀλλὰ ἄνασσ’ ἵληθι, δίδωθι δέ μοι κλέος ἐσθλόν,	-u u- --u u-u u - uu --	dactylic hexameter	feminine penthemimeral, trithemimeral
αὐτῷ καὶ παίδεσσι καὶ αἰδοίῃ παρακοίτι·	-- - --u u --- uu--	dactylic hexameter	feminine penthemimeral, trithemimeral
σοὶ δ’αὖ ἐγὼ ῥέξω βοῦν ἦνιν εὐρυμέτωπον	- u u- -- - -- -uu--	dactylic hexameter	masculine penthemimeral, trithemimeral
ἀδμήτην, ἣν οὔ πω ὕπὸ ζυγὸν ἤγαγεν ἀνήρ·	--- - - u u- uu -uu --	dactylic hexameter	masculine penthemimeral, hepthemimeral, trithemimeral
τήν τοι ἐγὼ ῥέξω χρυσὸν κέρασιν περιχεύας.	- u u- -- -- uu- uu--	dactylic hexameter	masculine penthemimeral, hepthemimeral, trithemimeral
ὣς ἔφατ’ εὐχόμενος, τοῦ δ’ἔκλυε Παλλὰς Ἀθήνη.	- uu -uu- - -uu -u u--	dactylic hexameter	masculine penthemimeral
τοῖσιν δ’ἡγεμόνευε Γερήνιος ἱππότα Νέστωρ,	-- -uu-u u-uu -uu --	dactylic hexameter	feminine penthemimeral
υἱάσι καὶ γαμβροῖσιν, ἑὰ πρὸς δώματα καλά.	-uu - --u u- - -uu --	dactylic hexameter	feminine penthemimeral, hepthemimeral, trithemimeral
ἀλλ’ ὅτε δώμαθ’ ἵκοντο ἀγακλυτὰ τοῖο ἄνακτος,	- uu -u u-u u-uu -u u--	dactylic hexameter	feminine penthemimeral
ἑξείης ἕζοντο κατὰ κλισμούς τε θρόνους τε·	--- --u u- -- u u- -	dactylic hexameter	feminine penthemimeral, hepthemimeral, trithemimeral
τοῖς δ’ὁ γέρων ἐλθοῦσιν ἀνὰ κρητῆρα κέρασσεν	- u u- --u u- --u u--	dactylic hexameter	feminine penthemimeral, hepthemimeral, trithemimeral
οἴνου ἡδυπότοιο, τὸν ἑνδεκάτῳ ἐνιαυτῷ	-- -uu-u u -uu- uu--	dactylic hexameter	feminine penthemimeral
ὤιξεν ταμίη καὶ ἀπὸ κρήδεμνον ἔλυσε·	--- uu- u u- --u u--	dactylic hexameter	masculine penthemimeral, hepthemimeral, trithemimeral
τοῦ ὁ γέρων κρητῆρα κεράσσατο, πολλὰ δ’Ἀθήνῃ	- u u- --u u-uu -u u--	dactylic hexameter	feminine penthemimeral, trithemimeral
εὔχετ’ ἀποσπένδων, κούρῃ Διὸς αἰγιόχοιο.	-u u--- -- uu -uu--	dactylic hexameter	masculine penthemimeral, hepthemimeral
αὐτὰρ ἐπεὶ σπεῖσάν τ’ἔπιον θ’,ὅσον ἤθελε θυμός,	-u u- -- uu- uu -uu --	dactylic hexameter	masculine penthemimeral, hepthemimeral, trithemimeral
οἱ μὲν κακκείοντες ἔβαν οἶκόνδε ἕκαστος,	- - ---u u- --u u--	dactylic hexameter	feminine penthemimeral, hepthemimeral
τὸν δ’αὐτοῦ κοίμησε Γερήνιος ἱππότα Νέστωρ,	- -- --u u-uu -uu --	dactylic hexameter	feminine penthemimeral, trithemimeral
Τηλέμαχον, φίλον υἱὸν Ὀδυσσῆος θείοιο,	-uu- uu -u u--- ---	dactylic hexameter	feminine penthemimeral, trithemimeral
τρητοῖς ἐν λεχέεσσιν ὑπ’ αἰθούσῃ ἐριδούπῳ,	-- - uu-u u --- uu--	dactylic hexameter	feminine penthemimeral, trithemimeral
πὰρ’ δ’ἄρ’ ἐυμμελίην Πεισίστρατον, ὄρχαμον ἀνδρῶν,	- u u-uu- --uu -uu --	dactylic hexameter	masculine penthemimeral
ὅς οἱ ἔτ’ ἠίθεος παίδων ἦν ἐν μεγάροισιν·	- u u -uu- -- - - uu--	dactylic hexameter	masculine penthemimeral, hepthemimeral
αὐτὸς δ’αὖτε καθεῦδε μυχῷ δόμου ὑψηλοῖο,	-- -u u-u u- uu ----	dactylic hexameter	feminine penthemimeral, hepthemimeral
τῷ δ’ἄλοχος δέσποινα λέχος πόρσυνε καὶ εὐνήν.	- uu- --u u- --u u --	dactylic hexameter	feminine penthemimeral, hepthemimeral, trithemimeral
ἦμος δ’ἠριγένεια φάνη ῥοδοδάκτυλος Ἠώς,	-- -uu-u u- uu-uu --	dactylic hexameter	feminine penthemimeral, hepthemimeral
ὤρνυτ’ ἄρ’ ἐξ εὐνῆφι Γερήνιος ἱππότα Νέστωρ,	-u u - --u u-uu -uu --	dactylic hexameter	feminine penthemimeral, trithemimeral
ἐκ δ’ἐλθὼν κατ’ ἄρ’ ἕζετ’ ἐπὶ ξεστοῖσι λίθοισιν,	- -- u u -u u- --u u--	dactylic hexameter	feminine penthemimeral, hepthemimeral, trithemimeral
οἵ οἱ ἔσαν προπάροιθε θυράων ὑψηλάων,	- u u- uu-u u-- ----	dactylic hexameter	feminine penthemimeral, trithemimeral
λευκοί, ἀποστίλβοντες ἀλείφατος· οἷς ἔπι μὲν πρὶν	-u u---u u-uu - uu - -	dactylic hexameter	feminine penthemimeral
Νηλεὺς ἵζεσκεν, θεόφιν μήστωρ ἀτάλαντος·	-- --- uu- -- uu--	dactylic hexameter	masculine penthemimeral, hepthemimeral
ἀλλ’ ὁ μὲν ἤδη κηρὶ δαμεὶς Ἄϊδόσδε βεβήκει,	- u u -- -u u- uu-u u--	dactylic hexameter	feminine penthemimeral, hepthemimeral
Νέστωρ αὖ τότ’ ἐφῖζε Γερήνιος, οὖρος Ἀχαιῶν,	-- - u u-u u-uu -u u--	dactylic hexameter	feminine penthemimeral, trithemimeral
σκῆπτρον ἔχων. περὶ δ’υἷες ἀολλέες ἠγερέθοντο	-u u- uu -u u-uu -uu--	dactylic hexameter	feminine penthemimeral, trithemimeral
ἐκ θαλάμων ἐλθόντες, Ἐχέφρων τε Στρατίος τε	- uu- --u u-- - uu- -	dactylic hexameter	feminine penthemimeral, trithemimeral
Περσεύς τ’Ἄρητός τε καὶ ἀντίθεος Θρασυμήδης.	-- --- u u -uu- uu--	dactylic hexameter	masculine penthemimeral
τοῖσι δ’ἔπειθ’ ἕκτος Πεισίστρατος ἤλυθεν ἥρως,	-u u- -- --uu -uu --	dactylic hexameter	masculine penthemimeral, trithemimeral
πὰρ δ’ἄρα Τηλέμαχον θεοείκελον εἷσαν ἄγοντες.	- uu -uu- uu-uu -u u--	dactylic hexameter	masculine penthemimeral
τοῖσι δὲ μύθων ἦρχε Γερήνιος ἱππότα Νέστωρ·	-u u -- -u u-uu -uu --	dactylic hexameter	feminine penthemimeral
καρπαλίμως μοι, τέκνα φίλα, κρηήνατ’ ἐέλδωρ,	-uu- - -u u- --u u--	dactylic hexameter	feminine penthemimeral, hepthemimeral, trithemimeral
ὄφρ’ ἦ τοι πρώτιστα θεῶν ἱλάσσομ’ Ἀθήνην,	- - - --u u- --u u--	dactylic hexameter	feminine penthemimeral, hepthemimeral, trithemimeral
ἥ μοι ἐναργὴς ἦλθε θεοῦ ἐς δαῖτα θάλειαν.	- u u-- -u u- - -u u--	dactylic hexameter	feminine penthemimeral, hepthemimeral
ἀλλ’ ἄγ’ ὁ μὲν πεδίονδ’ ἐπὶ βοῦν, ἴτω, ὄφρα τάχιστα	- u u - uu- uu - uu -u u--	dactylic hexameter	masculine penthemimeral, hepthemimeral, trithemimeral
ἔλθῃσιν, ἐλάσῃ δὲ βοῶν ἐπιβουκόλος ἀνήρ·	--- uu- u u- uu-uu --	dactylic hexameter	masculine penthemimeral, hepthemimeral, trithemimeral
εἷς δ’ἐπὶ Τηλεμάχου μεγαθύμου νῆα μέλαιναν	- uu -uu- uu-- -u u--	dactylic hexameter	masculine penthemimeral
πάντας ἰὼν ἑτάρους ἀγέτω, λιπέτω δὲ δύ’ οἴους·	-u u- uu- uu- uu- u u --	dactylic hexameter	masculine penthemimeral, hepthemimeral, trithemimeral
εἷς δ’αὖ χρυσοχόον Λαέρκεα δεῦρο κελέσθω	- - -uu- --uu -u u--	dactylic hexameter	masculine penthemimeral
ἐλθεῖν, ὄφρα βοὸς χρυσὸν κέρασιν περιχεύῃ.	-- -u u- -- uu- uu--	dactylic hexameter	masculine penthemimeral, hepthemimeral
οἱ δ’ἄλλοι μένετ’ αὐτοῦ ἀολλέες, εἴπατε δ’εἴσω	- -- uu -u u-uu -uu --	dactylic hexameter	feminine penthemimeral, trithemimeral
δμῳῇσιν κατὰ δώματ’ ἀγακλυτὰ δαῖτα πένεσθαι,	--- uu -u u-uu -u u--	dactylic hexameter	feminine penthemimeral, trithemimeral
ἕδρας τε ξύλα τ’ἀμφὶ καὶ ἀγλαὸν οἰσέμεν ὕδωρ.	-- - uu -u u -uu -uu --	dactylic hexameter	feminine penthemimeral, trithemimeral
ὣς ἔφαθ’, οἱ δ’ἄρα πάντες ἐποίπνυον. ἦλθε μὲν ἂρ βοῦς	- uu - uu -u u-uu -u u - -	dactylic hexameter	feminine penthemimeral, trithemimeral
ἐκ πεδίου, ἦλθον δὲ θοῆς παρὰ νηὸς ἐίσης	- uu- -- u u- uu -u u--	dactylic hexameter	masculine penthemimeral, hepthemimeral, trithemimeral
Τηλεμάχου ἕταροι μεγαλήτορος, ἦλθε δὲ χαλκεὺς	-uu- uu- uu-uu -u u --	dactylic hexameter	masculine penthemimeral, trithemimeral
ὅπλ’ ἐν χερσὶν ἔχων χαλκήια, πείρατα τέχνης,	- - -u u- --uu -uu --	dactylic hexameter	masculine penthemimeral
ἄκμονά τε σφῦραν τ’ἐυποίητόν τε πυράγρην,	-uu - -- uu--- u u--	dactylic hexameter	masculine penthemimeral, trithemimeral
οἷσίν τε χρυσὸν εἰργάζετο· ἦλθε δ’Ἀθήνη	-- - -- --uu -u u--	dactylic hexameter	masculine penthemimeral, trithemimeral
ἱρῶν ἀντιόωσα. γέρων δ’ἱππηλάτα Νέστωρ	-- -uu-u u- --uu --	dactylic hexameter	feminine penthemimeral, hepthemimeral
χρυσὸν ἔδωχ’· ὁ δ’ἔπειτα βοὸς κέρασιν περίχευεν	-u u- u u-u u- uu- uu--	dactylic hexameter	feminine penthemimeral, hepthemimeral, trithemimeral
ἀσκήσας, ἵν’ ἄγαλμα θεὰ κεχάροιτο ἰδοῦσα.	--- u u-u u- uu-u u--	dactylic hexameter	feminine penthemimeral, hepthemimeral, trithemimeral
βοῦν δ’ἀγέτην κεράων Στρατίος καὶ δῖος Ἐχέφρων.	- uu- uu- uu- - -u u--	dactylic hexameter	masculine penthemimeral, hepthemimeral, trithemimeral
χέρνιβα δέ σφ’Ἄρητος ἐν ἀνθεμόεντι λέβητι	-uu - --u u -uu-u u--	dactylic hexameter	feminine penthemimeral, trithemimeral
ἤλυθεν ἐκ θαλάμοιο φέρων, ἑτέρῃ δ’ἔχεν οὐλὰς	-uu - uu-u u- uu- uu --	dactylic hexameter	feminine penthemimeral, hepthemimeral, trithemimeral
ἐν κανέῳ πέλεκυν δὲ μενεπτόλεμος Θρασυμήδης	- uu- uu- u u-uu- uu--	dactylic hexameter	masculine penthemimeral, trithemimeral
ὀξὺν ἔχων ἐν χειρὶ παρίστατο βοῦν ἐπικόψων.	-u u- - -u u-uu - uu--	dactylic hexameter	feminine penthemimeral, trithemimeral
Περσεὺς δ’ἀμνίον εἶχε· γέρων δ’ἱππηλάτα Νέστωρ	-- -uu -u u- --uu --	dactylic hexameter	feminine penthemimeral, hepthemimeral
χέρνιβά τ’οὐλοχύτας τε κατήρχετο, πολλὰ δ’Ἀθήνῃ	-uu -uu- u u-uu -u u--	dactylic hexameter	masculine penthemimeral
εὔχετ’ ἀπαρχόμενος, κεφαλῆς τρίχας ἐν πυρὶ βάλλων.	-u u-uu- uu- uu - uu --	dactylic hexameter	masculine penthemimeral, hepthemimeral
αὐτὰρ ἐπεί ῥ’εὔξαντο καὶ οὐλοχύτας προβάλοντο,	-u u- --u u -uu- uu--	dactylic hexameter	feminine penthemimeral, trithemimeral
αὐτίκα Νέστορος υἱὸς ὑπέρθυμος Θρασυμήδης	-uu -uu -u u--- uu--	dactylic hexameter	feminine penthemimeral
ἤλασεν ἄγχι στάς· πέλεκυς δ’ἀπέκοψε τένοντας	-uu -- - uu- uu-u u--	dactylic hexameter	masculine penthemimeral, hepthemimeral
αὐχενίους, λῦσεν δὲ βοὸς μένος. αἱ δ’ὀλόλυξαν	-uu- -- u u- uu - uu--	dactylic hexameter	masculine penthemimeral, hepthemimeral, trithemimeral
θυγατέρες τε νυοί τε καὶ αἰδοίη παράκοιτις	-uu- u u- u u --- uu--	dactylic hexameter	masculine penthemimeral, trithemimeral
Νέστορος, Εὐρυδίκη, πρέσβα Κλυμένοιο θυγατρῶν.	-uu -uu- -- uu-u u--	dactylic hexameter	masculine penthemimeral, hepthemimeral
οἱ μὲν ἔπειτ’ ἀνελόντες ἀπὸ χθονὸς εὐρυοδείης	- u u- uu-u u- uu -uu--	dactylic hexameter	feminine penthemimeral, hepthemimeral, trithemimeral
ἔσχον· ἀτὰρ σφάξεν Πεισίστρατος, ὄρχαμος ἀνδρῶν.	-u u- -- --uu -uu --	dactylic hexameter	masculine penthemimeral, trithemimeral
τῆς δ’ἐπεὶ ἐκ μέλαν αἷμα ῥύη, λίπε δ’ὀστέα θυμός,	- uu - uu -u u- uu -uu --	dactylic hexameter	feminine penthemimeral, hepthemimeral, trithemimeral
αἶψ’ ἄρα μιν διέχευαν, ἄφαρ δ’ἐκ μηρία τάμνον	- uu - uu-u u- - -uu --	dactylic hexameter	feminine penthemimeral, hepthemimeral, trithemimeral
πάντα κατὰ μοῖραν, κατά τε κνίσῃ ἐκάλυψαν	-u u- -- uu - -- uu--	dactylic hexameter	masculine penthemimeral, hepthemimeral, trithemimeral
δίπτυχα ποιήσαντες, ἐπ’ αὐτῶν δ’ὠμοθέτησαν.	-uu ---u u -- -uu--	dactylic hexameter	feminine penthemimeral
καῖε δ’ἐπὶ σχίζῃς ὁ γέρων, ἐπὶ δ’αἴθοπα οἶνον	-u u- -- u u- uu -uu --	dactylic hexameter	masculine penthemimeral, hepthemimeral, trithemimeral
λεῖβε· νέοι δὲ παρ’ αὐτὸν ἔχον πεμπώβολα χερσίν.	-u u- u u -u u- --uu --	dactylic hexameter	feminine penthemimeral, hepthemimeral, trithemimeral
αὐτὰρ ἐπεὶ κατὰ μῆρ’ ἐκάη καὶ σπλάγχνα πάσαντο,	-u u- uu - uu- - -u u--	dactylic hexameter	masculine penthemimeral, hepthemimeral, trithemimeral
μίστυλλόν τ’ἄρα τἆλλα καὶ ἀμφ’ ὀβελοῖσιν ἔπειραν,	--- uu -u u - uu-u u--	dactylic hexameter	feminine penthemimeral, hepthemimeral, trithemimeral
ὤπτων δ’ἀκροπόρους ὀβελοὺς ἐν χερσὶν ἔχοντες.	-- -uu- uu- - -u u--	dactylic hexameter	masculine penthemimeral, hepthemimeral
τόφρα δὲ Τηλέμαχον λοῦσεν καλὴ Πολυκάστη,	-u u -uu- -- -- uu--	dactylic hexameter	masculine penthemimeral, hepthemimeral
Νέστορος ὁπλοτάτη θυγάτηρ Νηληϊάδαο.	-uu -uu- uu- --uu--	dactylic hexameter	masculine penthemimeral, hepthemimeral
αὐτὰρ ἐπεὶ λοῦσέν τε καὶ ἔχρισεν λίπ’ ἐλαίῳ,	-u u- -- u u --- u u--	dactylic hexameter	masculine penthemimeral, trithemimeral
ἀμφὶ δέ μιν φᾶρος καλὸν βάλεν ἠδὲ χιτῶνα,	-u u - -- -- uu -u u--	dactylic hexameter	masculine penthemimeral, hepthemimeral, trithemimeral
ἔκ ῥ’ἀσαμίνθου βῆ δέμας ἀθανάτοισιν ὁμοῖος·	- uu-- - uu -uu-u u--	dactylic hexameter	masculine penthemimeral
πὰρ δ’ὅ γε Νέστορ’ ἰὼν κατ’ ἄρ’ ἕζετο, ποιμένα λαῶν.	- u u -u u- u u -uu -uu --	dactylic hexameter	masculine penthemimeral
οἱ δ’ἐπεὶ ὤπτησαν κρέ’ ὑπέρτερα καὶ ἐρύσαντο,	- uu --- u u-uu - uu--	dactylic hexameter	masculine penthemimeral
δαίνυνθ’ ἑζόμενοι· ἐπὶ δ’ἀνέρες ἐσθλοὶ ὄροντο	-- -uu- uu -uu -u u--	dactylic hexameter	masculine penthemimeral
οἶνον οἰνοχοεῦντες ἐνὶ χρυσέοις δεπάεσσιν.	-- -uu-u u- -- uu--	dactylic hexameter	feminine penthemimeral, hepthemimeral
αὐτὰρ ἐπεὶ πόσιος καὶ ἐδητύος ἐξ ἔρον ἕντο,	-u u- uu- u u-uu - uu --	dactylic hexameter	masculine penthemimeral, trithemimeral
τοῖσι δὲ μύθων ἦρχε Γερήνιος ἱππότα Νέστωρ·	-u u -- -u u-uu -uu --	dactylic hexameter	feminine penthemimeral
παῖδες ἐμοί, ἄγε Τηλεμάχῳ καλλίτριχας ἵππους	-u u- uu -uu- --uu --	dactylic hexameter	hepthemimeral, trithemimeral
ζεύξαθ’ ὑφ’ ἅρματ’ ἄγοντες, ἵνα πρήσσῃσιν ὁδοῖο.	-u u -u u-u u- --u u--	dactylic hexameter	feminine penthemimeral, hepthemimeral
ὣς ἔφαθ’, οἱ δ’ἄρα τοῦ μάλα μὲν κλύον ἠδ’ ἐπίθοντο,	- uu - uu - uu - uu - uu--	dactylic hexameter	masculine penthemimeral, hepthemimeral, trithemimeral
καρπαλίμως δ’ἔζευξαν ὑφ’ ἅρμασιν ὠκέας ἵππους.	-uu- --u u -uu -uu --	dactylic hexameter	feminine penthemimeral, trithemimeral
ἐν δὲ γυνὴ ταμίη σῖτον καὶ οἶνον ἔθηκεν	- u u- uu- -- - -u u--	dactylic hexameter	masculine penthemimeral, hepthemimeral, trithemimeral
ὄψα τε, οἷα ἔδουσι διοτρεφέες βασιλῆες.	-u u -u u-u u-uu- uu--	dactylic hexameter	feminine penthemimeral
ἂν δ’ἄρα Τηλέμαχος περικαλλέα βήσετο δίφρον·	- uu -uu- uu-uu -uu --	dactylic hexameter	masculine penthemimeral
πὰρ δ’ἄρα Νεστορίδης Πεισίστρατος, ὄρχαμος ἀνδρῶν,	- uu -uu- --uu -uu --	dactylic hexameter	masculine penthemimeral
ἐς δίφρον τ’ἀνέβαινε καὶ ἡνία λάζετο χερσί,	- -- uu-u u -uu -uu --	dactylic hexameter	feminine penthemimeral, trithemimeral
μάστιξεν δ’ἐλάαν, τὼ δ’οὐκ ἀέκοντε πετέσθην	--- uu- - - uu-u u--	dactylic hexameter	masculine penthemimeral, hepthemimeral, trithemimeral
ἐς πεδίον, λιπέτην δὲ Πύλου αἰπὺ πτολίεθρον.	- uu- uu- u u- -- uu--	dactylic hexameter	masculine penthemimeral, hepthemimeral, trithemimeral
οἱ δὲ πανημέριοι σεῖον ζυγὸν ἀμφὶς ἔχοντες.	- u u-uu- -- uu -u u--	dactylic hexameter	masculine penthemimeral, hepthemimeral
δύσετό τ’ἠέλιος σκιόωντό τε πᾶσαι ἀγυιαί,	-uu -uu- uu-u u -u u--	dactylic hexameter	masculine penthemimeral
ἐς Φηρὰς δ’ἵκοντο Διοκλῆος ποτὶ δῶμα,	- -- --u u--- uu --	dactylic hexameter	feminine penthemimeral, trithemimeral
υἱέος Ὀρτιλόχοιο, τὸν Ἀλφειὸς τέκε παῖδα.	-uu -uu-u u --- uu --	dactylic hexameter	feminine penthemimeral
ἔνθα δὲ νύκτ’ ἄεσαν, ὁ δὲ τοῖς πὰρ ξείνια θῆκεν.	-u u - uu- u u - - -uu --	dactylic hexameter	masculine penthemimeral, hepthemimeral, trithemimeral
ἦμος δ’ἠριγένεια φάνη ῥοδοδάκτυλος Ἠώς,	-- -uu-u u- uu-uu --	dactylic hexameter	feminine penthemimeral, hepthemimeral
ἵππους τε ζεύγνυντ’ ἀνά θ’ἅρματα ποικίλ’ ἔβαινον·	-- - -- uu -uu -u u--	dactylic hexameter	masculine penthemimeral, trithemimeral
ἐκ δ’ἔλασαν προθύροιο καὶ αἰθούσης ἐριδούπου·	- uu- uu-u u --- uu--	dactylic hexameter	feminine penthemimeral, trithemimeral
μάστιξεν δ’ἐλάαν, τὼ δ’οὐκ ἀέκοντε πετέσθην.	--- uu- - - uu-u u--	dactylic hexameter	masculine penthemimeral, hepthemimeral, trithemimeral
ἷξον δ’ἐς πεδίον πυρηφόρον, ἔνθα δ’ἔπειτα	-- - uu- --uu -u u--	dactylic hexameter	masculine penthemimeral, trithemimeral
ἦνον ὁδόν· τοῖον γὰρ ὑπέκφερον ὠκέες ἵπποι.	-u u- -- u u-uu -uu --	dactylic hexameter	masculine penthemimeral, trithemimeral
δύσετό τ’ἠέλιος σκιόωντό τε πᾶσαι ἀγυιαί.	-uu -uu- uu-u u -u u--	dactylic hexameter	masculine penthemimeral
