Ἑρμῆς δὲ ψυχὰς Κυλλήνιος ἐξεκαλεῖτο	-- - -- --uu -uu--	dactylic hexameter	masculine penthemimeral, trithemimeral
ἀνδρῶν μνηστήρων· ἔχε δὲ ῥάβδον μετὰ χερσὶ	-- --- uu - -- uu --	dactylic hexameter	masculine penthemimeral, hepthemimeral
καλὴν χρυσείην, τῇ τ’ἀνδρῶν ὄμματα θέλγει	-- --- - -- -uu --	dactylic hexameter	masculine penthemimeral
ὦν ἐθέλει, τοὺς δ’αὖτε καὶ ὑπνώοντας ἐγείρει·	- uu- - -u u ---u u--	dactylic hexameter	feminine penthemimeral, trithemimeral
τῇ ῥ’ἄγε κινήσας, ταὶ δὲ τρίζουσαι ἕποντο.	- uu --- - - --u u--	dactylic hexameter	masculine penthemimeral, hepthemimeral
ὡς δ’ὅτε νυκτερίδες μυχῷ ἄντρου θεσπεσίοιο	- uu -uu- uu -- -uu--	dactylic hexameter	masculine penthemimeral
τρίζουσαι ποτέονται, ἐπεί κέ τις ἀποπέσῃσιν	--- uu-u u- u u -uu--	dactylic hexameter	feminine penthemimeral, hepthemimeral, trithemimeral
ὁρμαθοῦ ἐκ πέτρης, ἀνά τ’ἀλλήλῃσιν ἔχονται,	-uu - -- uu ---u u--	dactylic hexameter	masculine penthemimeral, trithemimeral
ὣς αἱ τετριγυῖαι ἅμ’ ἤϊσαν· ἦρχε δ’ἄρα σφιν	- - ---u u -uu -u u- -	dactylic hexameter	feminine penthemimeral
Ἑρμείας ἀκάκητα κατ’ εὐρώεντα κέλευθα.	--- uu-u u ---u u--	dactylic hexameter	feminine penthemimeral, trithemimeral
πὰρ δ’ἴσαν Ὠκεανοῦ τε ῥοὰς καὶ Λευκάδα πέτρην,	- uu -uu- u u- - -uu --	dactylic hexameter	masculine penthemimeral, hepthemimeral
ἠδὲ παρ’ Ἠελίοιο πύλας καὶ δῆμον ὀνείρων	-u u -uu-u u- - -u u--	dactylic hexameter	feminine penthemimeral, hepthemimeral
ἤϊσαν· αἶψα δ’ἵκοντο κατ’ ἀσφοδελὸν λειμῶνα,	-uu -u u-u u -uu- ---	dactylic hexameter	feminine penthemimeral
ἔνθα τε ναίουσι ψυχαί, εἴδωλα καμόντων.	-u u --- -- --u u--	dactylic hexameter	masculine penthemimeral, hepthemimeral
εὗρον δὲ ψυχὴν Πηληϊάδεω Ἀχιλῆος	-- - -- --uu- uu--	dactylic hexameter	masculine penthemimeral, trithemimeral
καὶ Πατροκλῆος καὶ ἀμύμονος Ἀντιλόχοιο	- ---- u u-uu -uu--	dactylic hexameter	masculine penthemimeral
Αἴαντός θ’,ὃς ἄριστος ἔην εἶδός τε δέμας τε	--- u u-u u- -- u u- -	dactylic hexameter	feminine penthemimeral, hepthemimeral, trithemimeral
τῶν ἄλλων Δαναῶν μετ’ ἀμύμονα Πηλεΐωνα.	- -- uu- u u-uu -uu--	dactylic hexameter	masculine penthemimeral, trithemimeral
ὣς οἱ μὲν περὶ κεῖνον ὁμίλεον· ἀγχίμολον δὲ	- - - uu -u u-uu -uu- -	dactylic hexameter	feminine penthemimeral, trithemimeral
ἤλυθ’ ἔπι ψυχὴ Ἀγαμέμνονος Ἀτρεΐδαο	-u u- -- uu-uu -uu--	dactylic hexameter	masculine penthemimeral, trithemimeral
ἀχνυμένη· περὶ δ’ἄλλαι ἀγηγέραθ’, ὅσσοι ἅμ’ αὐτῷ	-uu- uu -u u-uu -u u --	dactylic hexameter	feminine penthemimeral, trithemimeral
οἴκῳ ἐν Αἰγίσθοιο θάνον καὶ πότμον ἐπέσπον.	-u u ---u u- - -u u--	dactylic hexameter	feminine penthemimeral, hepthemimeral
τὸν προτέρη ψυχὴ προσεφώνεε Πηλεΐωνος·	- uu- -- uu-uu -uu--	dactylic hexameter	masculine penthemimeral, trithemimeral
Ἀτρεΐδη, περὶ μέν σε φάμεν Διῒ τερπικεραύνῳ	-uu- uu - u u- uu -uu--	dactylic hexameter	masculine penthemimeral, hepthemimeral, trithemimeral
ἀνδρῶν ἡρώων φίλον ἔμμεναι ἤματα πάντα,	-- --- uu -uu -uu --	dactylic hexameter	masculine penthemimeral
οὕνεκα πολλοῖσίν τε καὶ ἰφθίμοισιν ἄνασσες	-uu --- u u ---u u--	dactylic hexameter	masculine penthemimeral
δήμῳ ἔνι Τρώων, ὅθι πάσχομεν ἄλγε’ Ἀχαιοί.	-u u- -- uu -uu -u u--	dactylic hexameter	masculine penthemimeral, trithemimeral
ἦ τ’ἄρα καὶ σοὶ πρῶϊ παραστήσεσθαι ἔμελλε	- uu - - -u u---u u--	dactylic hexameter	feminine penthemimeral, trithemimeral
μοῖρ’ ὀλοή, τὴν οὔ τις ἀλεύεται ὅς κε γένηται.	- uu- - - u u-uu - u u--	dactylic hexameter	masculine penthemimeral, trithemimeral
ὡς ὄφελες τιμῆς ἀπονήμενος, ἧς περ ἄνασσες,	- uu- -- uu-uu - u u--	dactylic hexameter	masculine penthemimeral, trithemimeral
δήμῳ ἔνι Τρώων θάνατον καὶ πότμον ἐπισπεῖν·	-u u- -- uu- - -u u--	dactylic hexameter	masculine penthemimeral, hepthemimeral, trithemimeral
τῶ κέν τοι τύμβον μὲν ἐποίησαν Παναχαιοί,	- - - -- u u--- uu--	dactylic hexameter	masculine penthemimeral, trithemimeral
ἠδέ κε καὶ σῷ παιδὶ μέγα κλέος ἤρα’ ὀπίσσω·	-u u - - -u u- uu -u u--	dactylic hexameter	feminine penthemimeral, hepthemimeral, trithemimeral
νῦν δ’ἄρα σ’οἰκτίστῳ θανάτῳ εἵμαρτο ἁλῶναι.	- uu --- uu- --u u--	dactylic hexameter	masculine penthemimeral, hepthemimeral
τὸν δ’αὖτε ψυχὴ προσεφώνεεν Ἀτρεΐδαο·	- -- -- uu-uu -uu--	dactylic hexameter	masculine penthemimeral, trithemimeral
ὄλβιε Πηλέος υἱέ, θεοῖς ἐπιείκελ’ Ἀχιλλεῦ,	-uu -uu -u u- uu-u u--	dactylic hexameter	feminine penthemimeral, hepthemimeral
ὃς θάνες ἐν Τροίῃ ἑκὰς Ἄργεος· ἀμφὶ δέ σ’ἄλλοι	- uu - -- uu -uu -u u --	dactylic hexameter	masculine penthemimeral, trithemimeral
κτείνοντο Τρώων καὶ Ἀχαιῶν υἷες ἄριστοι,	--- -- u u-- -u u--	dactylic hexameter	masculine penthemimeral, trithemimeral
μαρνάμενοι περὶ σεῖο· σὺ δὲ στροφάλιγγι κονίης	-uu- uu -u u - uu-u u--	dactylic hexameter	feminine penthemimeral, hepthemimeral, trithemimeral
κεῖσο μέγας μεγαλωστί, λελασμένος ἱπποσυνάων.	-u u- uu-u u-uu -uu--	dactylic hexameter	feminine penthemimeral, trithemimeral
ἡμεῖς δὲ πρόπαν ἦμαρ ἐμαρνάμεθ’· οὐδέ κε πάμπαν	-- - uu -u u-uu -u u --	dactylic hexameter	feminine penthemimeral, trithemimeral
παυσάμεθα πτολέμου, εἰ μὴ Ζεὺς λαίλαπι παῦσεν.	-uu- uu- - - - -uu --	dactylic hexameter	masculine penthemimeral, hepthemimeral, trithemimeral
αὐτὰρ ἐπεί σ’ἐπὶ νῆας ἐνείκαμεν ἐκ πολέμοιο,	-u u- uu -u u-uu - uu--	dactylic hexameter	feminine penthemimeral, trithemimeral
κάτθεμεν ἐν λεχέεσσι, καθήραντες χρόα καλὸν	-uu - uu-u u--- uu --	dactylic hexameter	feminine penthemimeral, trithemimeral
ὕδατί τε λιαρῷ καὶ ἀλείφατι· πολλὰ δέ σ’ἀμφὶ	-uu - uu- u u-uu -u u --	dactylic hexameter	masculine penthemimeral, trithemimeral
δάκρυα θερμὰ χέον Δαναοὶ κείραντό τε χαίτας.	-uu -u u- uu- --u u --	dactylic hexameter	masculine penthemimeral, hepthemimeral
μήτηρ δ’ἐξ ἁλὸς ἦλθε σὺν ἀθανάτῃς ἁλίῃσιν	-- - uu -u u -uu- uu--	dactylic hexameter	feminine penthemimeral, trithemimeral
ἀγγελίης ἀΐουσα· βοὴ δ’ἐπὶ πόντον ὀρώρει	-uu- uu-u u- uu -u u--	dactylic hexameter	feminine penthemimeral, hepthemimeral, trithemimeral
θεσπεσίη, ὑπὸ δὲ τρόμος ἔλλαβε πάντας Ἀχαιούς·	-uu- uu - uu -uu -u u--	dactylic hexameter	masculine penthemimeral, trithemimeral
καί νύ κ’ἀναΐξαντες ἔβαν κοίλας ἐπὶ νῆας,	- u u---u u- -- uu --	dactylic hexameter	feminine penthemimeral, hepthemimeral
εἰ μὴ ἀνὴρ κατέρυκε παλαιά τε πολλά τε εἰδώς,	- u u- uu-u u-u u -u u --	dactylic hexameter	feminine penthemimeral, trithemimeral
Νέστωρ, οὗ καὶ πρόσθεν ἀρίστη φαίνετο βουλή·	-- - - -u u-- -uu --	dactylic hexameter	feminine penthemimeral, trithemimeral
ὅ σφιν ἐῢ φρονέων ἀγορήσατο καὶ μετέειπεν·	- u u- uu- uu-uu - uu--	dactylic hexameter	masculine penthemimeral, trithemimeral
ἴσχεσθ’, Ἀργεῖοι, μὴ φεύγετε, κοῦροι Ἀχαιῶν·	-- --- - -uu -u u--	dactylic hexameter	masculine penthemimeral
μήτηρ ἐξ ἁλὸς ἥδε σὺν ἀθανάτῃς ἁλίῃσιν	-- - uu -u u -uu- uu--	dactylic hexameter	feminine penthemimeral, trithemimeral
ἔρχεται, οὗ παιδὸς τεθνηότος ἀντιόωσα.	-uu - -- --uu -uu--	dactylic hexameter	masculine penthemimeral, trithemimeral
ὣς ἔφαθ’, οἱ δ’ἔσχοντο φόβου μεγάθυμοι Ἀχαιοί·	- uu - --u u- uu-u u--	dactylic hexameter	feminine penthemimeral, hepthemimeral, trithemimeral
ἀμφὶ δέ σ’ἔστησαν κοῦραι ἁλίοιο γέροντος	-u u --- -- uu-u u--	dactylic hexameter	masculine penthemimeral, hepthemimeral
οἴκτρ’ ὀλοφυρόμεναι, περὶ δ’ἄμβροτα εἵματα ἕσσαν.	- uu-uu- uu -uu -uu --	dactylic hexameter	masculine penthemimeral
Μοῦσαι δ’ἐννέα πᾶσαι ἀμειβόμεναι ὀπὶ καλῇ	-- -uu -u u-uu- uu --	dactylic hexameter	feminine penthemimeral
θρήνεον· ἔνθα κεν οὔ τιν’ ἀδάκρυτόν γ’ἐνόησας	-- -u u - u u--- uu--	dactylic hexameter	masculine penthemimeral
Ἀργείων· τοῖον γὰρ ἐπώρορε Μοῦσα λίγεια.	--- -- u u-uu -u u--	dactylic hexameter	masculine penthemimeral, trithemimeral
ἑπτὰ δὲ καὶ δέκα μέν σε ὁμῶς νύκτας τε καὶ ἦμαρ	-u u - uu - u u- -- u u --	dactylic hexameter	masculine penthemimeral, hepthemimeral, trithemimeral
κλαίομεν ἀθάνατοί τε θεοὶ θνητοί τ’ἄνθρωποι·	-uu -uu- u u- -- ---	dactylic hexameter	masculine penthemimeral, hepthemimeral
ὀκτωκαιδεκάτῃ δ’ἔδομεν πυρί, πολλὰ δ’ἐπ’ αὐτῷ	---uu- uu- uu -u u --	dactylic hexameter	masculine penthemimeral, hepthemimeral
μῆλα κατεκτάνομεν μάλα πίονα καὶ ἕλικας βοῦς.	-u u-uu- uu -uu - uu- -	dactylic hexameter	masculine penthemimeral
καίεο δ’ἔν τ’ἐσθῆτι θεῶν καὶ ἀλείφατι πολλῷ	-uu - --u u- u u-uu --	dactylic hexameter	feminine penthemimeral, hepthemimeral, trithemimeral
καὶ μέλιτι γλυκερῷ· πολλοὶ δ’ἥρωες Ἀχαιοὶ	- uu- uu- -- --u u--	dactylic hexameter	masculine penthemimeral, hepthemimeral, trithemimeral
τεύχεσιν ἐρρώσαντο πυρὴν πέρι καιομένοιο,	-uu ---u u- uu -uu--	dactylic hexameter	feminine penthemimeral, hepthemimeral
πεζοί θ’ἱππῆές τε· πολὺς δ’ὀρυμαγδὸς ὀρώρει	-- --- u u- uu-u u--	dactylic hexameter	masculine penthemimeral, hepthemimeral
αὐτὰρ ἐπεὶ δή σε φλὸξ ἤνυσεν Ἡφαίστοιο,	-u u- - - - -uu ----	dactylic hexameter	masculine penthemimeral, trithemimeral
ἠῶθεν δή τοι λέγομεν λεύκ’ ὀστέ’, Ἀχιλλεῦ,	--- - - uu- - -u u--	dactylic hexameter	masculine penthemimeral, hepthemimeral, trithemimeral
οἴνῳ ἐν ἀκρήτῳ καὶ ἀλείφατι· δῶκε δὲ μήτηρ	-u u --- u u-uu -u u --	dactylic hexameter	masculine penthemimeral
χρύσεον ἀμφιφορῆα· Διωνύσοιο δὲ δῶρον	-uu -uu-u u---u u --	dactylic hexameter	feminine penthemimeral
φάσκ’ ἔμεναι, ἔργον δὲ περικλυτοῦ Ἡφαίστοιο.	- uu- -- u u-uu ----	dactylic hexameter	masculine penthemimeral, trithemimeral
ἐν τῷ τοι κεῖται λεύκ’ ὀστέα, φαίδιμ’ Ἀχιλλεῦ,	- - - -- - -uu -u u--	dactylic hexameter	masculine penthemimeral, trithemimeral
μίγδα δὲ Πατρόκλοιο Μενοιτιάδαο θανόντος,	-u u ---u u-uu-u u--	dactylic hexameter	feminine penthemimeral
χωρὶς δ’Ἀντιλόχοιο, τὸν ἔξοχα τῖες ἁπάντων	-- -uu-u u -uu -u u--	dactylic hexameter	feminine penthemimeral
τῶν ἄλλων ἑτάρων, μετὰ Πάτροκλόν γε θανόντα.	- -- uu- uu --- u u--	dactylic hexameter	masculine penthemimeral, trithemimeral
ἀμφ’ αὐτοῖσι δ’ἔπειτα μέγαν καὶ ἀμύμονα τύμβον	- --u u-u u- u u-uu --	dactylic hexameter	feminine penthemimeral, hepthemimeral
χεύαμεν Ἀργείων ἱερὸς στρατὸς αἰχμητάων	-uu --- uu- uu ----	dactylic hexameter	masculine penthemimeral, hepthemimeral
ἀκτῇ ἔπι προὐχούσῃ, ἐπὶ πλατεῖ Ἑλλησπόντῳ,	-u u- --u u- uu ----	dactylic hexameter	feminine penthemimeral, hepthemimeral, trithemimeral
ὥς κεν τηλεφανὴς ἐκ ποντόφιν ἀνδράσιν εἴη	- - -uu- - -uu -uu --	dactylic hexameter	masculine penthemimeral
τοῖς οἳ νῦν γεγάασι καὶ οἳ μετόπισθεν ἔσονται.	- - - uu-u u - uu-u u--	dactylic hexameter	feminine penthemimeral, hepthemimeral, trithemimeral
μήτηρ δ’αἰτήσασα θεοὺς περικαλλέ’ ἄεθλα	-- ---u u- uu-u u--	dactylic hexameter	feminine penthemimeral, hepthemimeral
θῆκε μέσῳ ἐν ἀγῶνι ἀριστήεσσιν Ἀχαιῶν.	-u u- u u-u u---u u--	dactylic hexameter	feminine penthemimeral, trithemimeral
ἤδη μὲν πολέων τάφῳ ἀνδρῶν ἀντεβόλησα	-- - uu- uu -- -uu--	dactylic hexameter	masculine penthemimeral, trithemimeral
ἡρώων, ὅτε κέν ποτ’ ἀποφθιμένου βασιλῆος	--- uu - u u-uu- uu--	dactylic hexameter	masculine penthemimeral, trithemimeral
ζώννυνταί τε νέοι καὶ ἐπεντύνονται ἄεθλα·	--- u u- u u---u u--	dactylic hexameter	masculine penthemimeral, trithemimeral
ἀλλά κε κεῖνα μάλιστα ἰδὼν θηήσαο θυμῷ,	-u u -u u-u u- --uu --	dactylic hexameter	feminine penthemimeral, hepthemimeral
οἷ’ ἐπὶ σοὶ κατέθηκε θεὰ περικαλλέ’ ἄεθλα,	- uu - uu-u u- uu-u u--	dactylic hexameter	feminine penthemimeral, hepthemimeral, trithemimeral
ἀργυρόπεζα Θέτις· μάλα γὰρ φίλος ἦσθα θεοῖσιν.	-uu-u u- uu - uu -u u--	dactylic hexameter	masculine penthemimeral, hepthemimeral
ὣς σὺ μὲν οὐδὲ θανὼν ὄνομ’ ὤλεσας, ἀλλά τοι αἰεὶ	- u u -u u- uu -uu -u u --	dactylic hexameter	masculine penthemimeral
πάντας ἐπ’ ἀνθρώπους κλέος ἔσσεται ἐσθλόν, Ἀχιλλεῦ,	-u u --- uu -uu -u u--	dactylic hexameter	masculine penthemimeral
αὐτὰρ ἐμοὶ τί τόδ’ ἦδος, ἐπεὶ πόλεμον τολύπευσα;	-u u- u u -u u- uu- uu--	dactylic hexameter	feminine penthemimeral, hepthemimeral, trithemimeral
ἐν νόστῳ γάρ μοι Ζεὺς μήσατο λυγρὸν ὄλεθρον	- -- - - - -uu -u u--	dactylic hexameter	masculine penthemimeral, trithemimeral
Αἰγίσθου ὑπὸ χερσὶ καὶ οὐλομένης ἀλόχοιο.	--- uu -u u -uu- uu--	dactylic hexameter	feminine penthemimeral, trithemimeral
ὣς οἱ μὲν τοιαῦτα πρὸς ἀλλήλους ἀγόρευον,	- - - --u u --- uu--	dactylic hexameter	feminine penthemimeral, trithemimeral
ἀγχίμολον δέ σφ’ἦλθε διάκτορος ἀργεϊφόντης,	-uu- - -u u-uu -uu--	dactylic hexameter	feminine penthemimeral, trithemimeral
ψυχὰς μνηστήρων κατάγων Ὀδυσῆϊ δαμέντων,	-- --- uu- uu-u u--	dactylic hexameter	masculine penthemimeral, hepthemimeral
τὼ δ’ἄρα θαμβήσαντ’ ἰθὺς κίον, ὡς ἐσιδέσθην.	- uu --- -- uu - uu--	dactylic hexameter	masculine penthemimeral, hepthemimeral
ἔγνω δὲ ψυχὴ Ἀγαμέμνονος Ἀτρεΐδαο	-- - -- uu-uu -uu--	dactylic hexameter	masculine penthemimeral, trithemimeral
παῖδα φίλον Μελανῆος, ἀγακλυτὸν Ἀμφιμέδοντα·	-u u- uu-u u-uu -uu--	dactylic hexameter	feminine penthemimeral, trithemimeral
ξεῖνος γάρ οἱ ἔην Ἰθάκῃ ἔνι οἰκία ναίων.	-- - u u- uu- uu -uu --	dactylic hexameter	masculine penthemimeral, hepthemimeral, trithemimeral
τὸν προτέρη ψυχὴ προσεφώνεεν Ἀτρεΐδαο·	- uu- -- uu-uu -uu--	dactylic hexameter	masculine penthemimeral, trithemimeral
Ἀμφίμεδον, τί παθόντες ἐρεμνὴν γαῖαν ἔδυτε	-uu- u u-u u-- -u u--	dactylic hexameter	feminine penthemimeral, trithemimeral
πάντες κεκριμένοι καὶ ὁμήλικες; οὐδέ κεν ἄλλως	-- -uu- u u-uu -u u --	dactylic hexameter	masculine penthemimeral
κρινάμενος λέξαιτο κατὰ πτόλιν ἄνδρας ἀρίστους.	-uu- --u u- uu -u u--	dactylic hexameter	feminine penthemimeral, hepthemimeral, trithemimeral
ἦ ὔμμ’ ἐν νήεσσι Ποσειδάων ἐδάμασσεν,	- - - --u u--- uu--	dactylic hexameter	feminine penthemimeral, trithemimeral
ὄρσας ἀργαλέους ἀνέμους καὶ κύματα μακρά;	-- -uu- uu- - -uu --	dactylic hexameter	masculine penthemimeral, hepthemimeral
ἦ που ἀνάρσιοι ἄνδρες ἐδηλήσαντ’ ἐπὶ χέρσου	- u u-uu -u u--- uu --	dactylic hexameter	feminine penthemimeral
βοῦς περιταμνομένους ἠδ’ οἰῶν πώεα καλά,	- uu-uu- - -- -uu --	dactylic hexameter	masculine penthemimeral
ἠὲ περὶ πτόλιος μαχεούμενοι ἠδὲ γυναικῶν;	-u u- uu- uu-uu -u u--	dactylic hexameter	masculine penthemimeral, trithemimeral
εἰπέ μοι εἰρομένῳ· ξεῖνος δέ τοι εὔχομαι εἶναι.	-u u -uu- -- u u -uu --	dactylic hexameter	masculine penthemimeral, hepthemimeral
ἦ οὐ μέμνῃ ὅτε κεῖσε κατήλυθον ὑμέτερον δῶ,	- -- uu -u u--u -uu- -	lyric	
ὀτρυνέων Ὀδυσῆα σὺν ἀντιθέῳ Μενελάῳ	--- uu-u u -uu- uu--	dactylic hexameter	feminine penthemimeral, trithemimeral
Ἴλιον εἰς ἅμ’ ἕπεσθαι ἐϋσσέλμων ἐπὶ νηῶν;	-uu - u u-u u--- uu --	dactylic hexameter	feminine penthemimeral, trithemimeral
μηνὶ δ’ἄρ’ οὔλῳ πάντα περήσαμεν εὐρέα πόντον,	-u u -- -u u-uu -uu --	dactylic hexameter	feminine penthemimeral
σπουδῇ παρπεπιθόντες Ὀδυσσῆα πτολίπορθον.	-- -uu-u u--- uu--	dactylic hexameter	feminine penthemimeral
τὸν δ’αὖτε ψυχὴ προσεφώνεεν Ἀμφιμέδοντος·	- -- -- uu-uu -uu--	dactylic hexameter	masculine penthemimeral, trithemimeral
Ἀτρεΐδη κύδιστε, ἄναξ ἀνδρῶν Ἀγάμεμνον,	-uu- --u u- -- uu--	dactylic hexameter	feminine penthemimeral, hepthemimeral, trithemimeral
μέμνημαι τάδε πάντα, διοτρεφές, ὡς ἀγορεύεις·	--- uu -u u-uu - uu--	dactylic hexameter	feminine penthemimeral, trithemimeral
σοὶ δ’ἐγὼ εὖ μάλα πάντα καὶ ἀτρεκέως καταλέξω,	- uu - uu -u u -uu- uu--	dactylic hexameter	feminine penthemimeral, trithemimeral
ἡμετέρου θανάτοιο κακὸν τέλος, οἷον ἐτύχθη.	-uu- uu-u u- uu -u u--	dactylic hexameter	feminine penthemimeral, hepthemimeral, trithemimeral
μνώμεθ’ Ὀδυσσῆος δὴν οἰχομένοιο δάμαρτα·	-u u--- - -uu-u u--	dactylic hexameter	masculine penthemimeral
ἡ δ’οὔτ’ ἠρνεῖτο στυγερὸν γάμον οὔτε τελεύτα,	- - --- uu- uu -u u--	dactylic hexameter	masculine penthemimeral, hepthemimeral
ἡμῖν φραζομένη θάνατον καὶ κῆρα μέλαιναν,	-- -uu- uu- - -u u--	dactylic hexameter	masculine penthemimeral, hepthemimeral
ἀλλὰ δόλον τόνδ’ ἄλλον ἐνὶ φρεσὶ μερμήριξε·	-u u- - -u u- uu ----	dactylic hexameter	feminine penthemimeral, hepthemimeral, trithemimeral
στησαμένη μέγαν ἱστὸν ἐνὶ μεγάροισιν ὕφαινε,	-uu- uu -u u- uu-u u--	dactylic hexameter	feminine penthemimeral, hepthemimeral, trithemimeral
λεπτὸν καὶ περίμετρον· ἄφαρ δ’ἡμῖν μετέειπε·	-- - uu-u u- -- uu--	dactylic hexameter	feminine penthemimeral, hepthemimeral, trithemimeral
κοῦροι ἐμοὶ μνηστῆρες, ἐπεὶ θάνε δῖος Ὀδυσσεύς,	-u u- --u u- uu -u u--	dactylic hexameter	feminine penthemimeral, hepthemimeral, trithemimeral
μίμνετ’ ἐπειγόμενοι τὸν ἐμὸν γάμον, εἰς ὅ κε φᾶρος	-u u-uu- u u- uu - u u --	dactylic hexameter	masculine penthemimeral, hepthemimeral
ἐκτελέσω, μή μοι μεταμώνια νήματ’ ὄληται,	-uu- - - uu-uu -u u--	dactylic hexameter	masculine penthemimeral, trithemimeral
Λαέρτῃ ἥρωϊ ταφήϊον, εἰς ὅτε κέν μιν	--- --u u-uu - uu - -	dactylic hexameter	feminine penthemimeral, trithemimeral
μοῖρ’ ὀλοὴ καθέλῃσι τανηλεγέος θανάτοιο,	- uu- uu-u u-uu- uu--	dactylic hexameter	feminine penthemimeral, trithemimeral
μή τίς μοι κατὰ δῆμον Ἀχαιϊάδων νεμεσήσῃ,	- - - uu -u u-uu- uu--	dactylic hexameter	feminine penthemimeral, trithemimeral
αἴ κεν ἄτερ σπείρου κεῖται πολλὰ κτεατίσσας.	- u u- -- -- -- uu--	dactylic hexameter	masculine penthemimeral, hepthemimeral, trithemimeral
ὣς ἔφαθ’, ἡμῖν δ’αὖτ’ ἐπεπείθετο θυμὸς ἀγήνωρ.	- uu -- - uu-uu -u u--	dactylic hexameter	masculine penthemimeral
ἔνθα καὶ ἠματίη μὲν ὑφαίνεσκεν μέγαν ἱστόν,	-u u -uu- u u--- uu --	dactylic hexameter	masculine penthemimeral
νύκτας δ’ἀλλύεσκεν, ἐπὴν δαΐδας παραθεῖτο.	-- ---u u- uu- uu--	dactylic hexameter	feminine penthemimeral, hepthemimeral
ὣς τρίετες μὲν ἔληθε δόλῳ καὶ ἔπειθεν Ἀχαιούς·	- uu- u u-u u- u u-u u--	dactylic hexameter	feminine penthemimeral, hepthemimeral, trithemimeral
ἀλλ’ ὅτε τέτρατον ἦλθεν ἔτος καὶ ἐπήλυθον ὦραι,	- uu -uu -u u- u u-uu --	dactylic hexameter	feminine penthemimeral, hepthemimeral
μηνῶν φθινόντων, περὶ δ’ἤματα πόλλ’ ἐτελέσθη,	-- --- uu -uu - uu--	dactylic hexameter	masculine penthemimeral
καὶ τότε δή τις ἔειπε γυναικῶν, ἣ σάφα ᾔδη,	- uu - u u-u u-- - uu --	dactylic hexameter	feminine penthemimeral, trithemimeral
καὶ τήν γ’ἀλλύουσαν ἐφεύρομεν ἀγλαὸν ἱστόν.	- - ---u u-uu -uu --	dactylic hexameter	feminine penthemimeral
ὣς τὸ μὲν ἐξετέλεσσε καὶ οὐκ ἐθέλουσ’, ὑπ’ ἀνάγκης.	- u u -uu-u u - uu- u u--	dactylic hexameter	feminine penthemimeral, hepthemimeral
εὖθ’ ἡ φᾶρος ἔδειξεν, ὑφήνασα μέγαν ἱστόν,	- - -u u-u u--- uu --	dactylic hexameter	feminine penthemimeral
πλύνασ’, ἠελίῳ ἐναλίγκιον ἠὲ σελήνῃ,	-- -uu- uu-uu -u u--	dactylic hexameter	masculine penthemimeral
καὶ τότε δή ῥ’Ὀδυσῆα κακός ποθεν ἤγαγε δαίμων	- uu - uu-u u- uu -uu --	dactylic hexameter	feminine penthemimeral, hepthemimeral, trithemimeral
ἀγροῦ ἐπ’ ἐσχατιήν, ὅθι δώματα ναῖε συβώτης.	-u u -uu- uu -uu -u u--	dactylic hexameter	masculine penthemimeral
ἔνθ’ ἦλθεν φίλος υἱὸς Ὀδυσσῆος θείοιο,	- -- uu -u u--- ---	dactylic hexameter	feminine penthemimeral, trithemimeral
ἐκ Πύλου ἠμαθόεντος ἰὼν σὺν νηῒ μελαίνῃ·	- uu -uu-u u- - -u u--	dactylic hexameter	feminine penthemimeral, hepthemimeral
τὼ δὲ μνηστῆρσιν θάνατον κακὸν ἀρτύναντε	- - --- uu- uu ----	dactylic hexameter	masculine penthemimeral, hepthemimeral
ἵκοντο προτὶ ἄστυ περικλυτόν, ἤτοι Ὀδυσσεὺς	--- uu -u u-uu -u u--	dactylic hexameter	feminine penthemimeral, trithemimeral
ὕστερος, αὐτὰρ Τηλέμαχος πρόσθ’ ἡγεμόνευε.	-uu -- -uu- - -uu--	dactylic hexameter	hepthemimeral
τὸν δὲ συβώτης ἦγε κακὰ χροῒ εἵματ’ ἔχοντα,	- u u-- -u u- uu -u u--	dactylic hexameter	feminine penthemimeral, hepthemimeral
πτωχῷ λευγαλέῳ ἐναλίγκιον ἠδὲ γέροντι	-- -uu- uu-uu -u u--	dactylic hexameter	masculine penthemimeral
σκηπτόμενον· τὰ δὲ λυγρὰ περὶ χροῒ εἵματα ἕστο·	-uu- u u -u u- uu -uu --	dactylic hexameter	feminine penthemimeral, hepthemimeral, trithemimeral
οὐδέ τις ἡμείων δύνατο γνῶναι τὸν ἐόντα	-u u --- uu- -- u u--	dactylic hexameter	masculine penthemimeral, hepthemimeral
ἐξαπίνης προφανέντ’, οὐδ’ οἳ προγενέστεροι ἦσαν,	-uu- uu- - - uu-uu --	dactylic hexameter	masculine penthemimeral, hepthemimeral, trithemimeral
ἀλλ’ ἔπεσίν τε κακοῖσιν ἐνίσσομεν ἠδὲ βολῇσιν.	- uu- u u-u u-uu -u u--	dactylic hexameter	feminine penthemimeral, trithemimeral
αὐτὰρ ὁ τέως μὲν ἐτόλμα ἐνὶ μεγάροισιν ἑοῖσι	-u u - u u-u u- uu-u u--	dactylic hexameter	feminine penthemimeral, hepthemimeral, trithemimeral
βαλλόμενος καὶ ἐνισσόμενος τετληότι θυμῷ·	-uu- u u-uu- --uu --	dactylic hexameter	hepthemimeral, trithemimeral
ἀλλ’ ὅτε δή μιν ἔγειρε Διὸς νοός αἰγιόχοιο,	- uu - u u-u u- uu -uu--	dactylic hexameter	feminine penthemimeral, hepthemimeral, trithemimeral
σὺν μὲν Τηλεμάχῳ περικαλλέα τεύχε’ ἀείρας	- - -uu- uu-uu -u u--	dactylic hexameter	masculine penthemimeral
ἐς θάλαμον κατέθηκε καὶ ἐκλήϊσεν ὀχῆας,	- uu- uu-u u ---u u--	dactylic hexameter	feminine penthemimeral, trithemimeral
αὐτὰρ ὁ ἣν ἄλοχον πολυκερδίῃσιν ἄνωγε	-u u - uu- uu---u u--	dactylic hexameter	masculine penthemimeral, trithemimeral
τόξον μνηστήρεσσι θέμεν πολιόν τε σίδηρον,	-- ---u u- uu- u u--	dactylic hexameter	feminine penthemimeral, hepthemimeral
ἡμῖν αἰνομόροισιν ἀέθλια καὶ φόνου ἀρχήν.	-- -uu-u u-uu - uu --	dactylic hexameter	feminine penthemimeral
οὐδέ τις ἡμείων δύνατο κρατεροῖο βιοῖο	-u u --- uu- uu-u u--	dactylic hexameter	masculine penthemimeral, hepthemimeral
νευρὴν ἐντανύσαι, πολλὸν δ’ἐπιδευέες ἦμεν.	-- -uu- -- uu-uu --	dactylic hexameter	masculine penthemimeral, hepthemimeral
ἀλλ’ ὅτε χεῖρας ἵκανεν Ὀδυσσῆος μέγα τόξον,	- uu -u u-u u--- uu --	dactylic hexameter	feminine penthemimeral
ἔνθ’ ἡμεῖς μὲν πάντες ὁμοκλέομεν ἐπέεσσι	- -- - -u u--- uu--	dactylic hexameter	feminine penthemimeral, trithemimeral
τόξον μὴ δόμεναι, μηδ’ εἰ μάλα πόλλ’ ἀγορεύοι·	-- - uu- - - uu - uu--	dactylic hexameter	masculine penthemimeral, hepthemimeral, trithemimeral
Τηλέμαχος δέ μιν οἶος ἐποτρύνων ἐκέλευσεν.	-uu- u u -u u--- uu--	dactylic hexameter	feminine penthemimeral, trithemimeral
αὐτὰρ ὁ δέξατο χειρὶ πολύτλας δῖος Ὀδυσσεύς,	-u u -uu -u u-- -u u--	dactylic hexameter	feminine penthemimeral
ῥηϊδίως δ’ἐτάνυσσε βιόν, διὰ δ’ἧκε σιδήρου,	-uu- uu-u u- uu -u u--	dactylic hexameter	feminine penthemimeral, hepthemimeral, trithemimeral
στῆ δ’ἄρ’ ἐπ’ οὐδὸν ἰών, ταχέας δ’ἐκχεύατ’ ὀϊστοὺς	- u u -u u- uu- --u u--	dactylic hexameter	masculine penthemimeral, hepthemimeral
δεινὸν παπταίνων, βάλε δ’Ἀντίνοον βασιλῆα.	-- --- uu -uu- uu--	dactylic hexameter	masculine penthemimeral
αὐτὰρ ἔπειτ’ ἄλλοις ἐφίει βέλεα στονόεντα,	-u u- -- uu- uu- uu--	dactylic hexameter	masculine penthemimeral, hepthemimeral, trithemimeral
ἄντα τιτυσκόμενος· τοὶ δ’ἀγχιστῖνοι ἔπιπτον.	-u u-uu- - ---u u--	dactylic hexameter	masculine penthemimeral
γνωτὸν δ’ἦν ὅ ῥά τίς σφι θεῶν ἐπιτάρροθος ἦεν·	-- - u u - u u- uu-uu --	dactylic hexameter	masculine penthemimeral, hepthemimeral, trithemimeral
αὐτίκα γὰρ κατὰ δώματ’ ἐπισπόμενοι μένεϊ σφῷ	-uu - uu -u u-uu- uu- -	dactylic hexameter	feminine penthemimeral, trithemimeral
κτεῖνον ἐπιστροφάδην, τῶν δὲ στόνος ὤρνυτ’ ἀεικὴς	-u u-uu- - - uu -u u--	dactylic hexameter	masculine penthemimeral, hepthemimeral
κράτων τυπτομένων, δάπεδον δ’ἅπαν αἵματι θῦεν.	-- -uu- uu- uu -uu --	dactylic hexameter	masculine penthemimeral, hepthemimeral
ὣς ἡμεῖς, Ἀγάμεμνον, ἀπωλόμεθ’, ὦν ἔτι καὶ νῦν	- -- uu-u u-uu - uu - -	dactylic hexameter	feminine penthemimeral, trithemimeral
σώματ’ ἀκηδέα κεῖται ἐνὶ μεγάροις Ὀδυσῆος·	-u u-uu -u u- uu- uu--	dactylic hexameter	feminine penthemimeral, hepthemimeral
οὐ γάρ πω ἴσασι φίλοι κατὰ δώμαθ’ ἑκάστου,	- - - --u u- uu -u u--	dactylic hexameter	feminine penthemimeral, hepthemimeral, trithemimeral
οἵ κ’ἀπονίψαντες μέλανα βρότον ἐξ ὠτειλέων	- uu--- uu- uu - ---	dactylic hexameter	masculine penthemimeral, hepthemimeral
κατθέμενοι γοάοιεν· ὃ γὰρ γέρας ἐστὶ θανόντων.	-uu- uu-u u - uu -u u--	dactylic hexameter	feminine penthemimeral, hepthemimeral, trithemimeral
τὸν δ’αὖτε ψυχὴ προσεφώνεεν Ἀτρεΐδαο·	- -- -- uu-uu -uu--	dactylic hexameter	masculine penthemimeral, trithemimeral
ὄλβιε Λαέρταο πάϊ, πολυμήχαν’ Ὀδυσσεῦ,	-uu ---u u- uu-u u--	dactylic hexameter	feminine penthemimeral, hepthemimeral
ἦ ἄρα σὺν μεγάλῃ ἀρετῇ ἐκτήσω ἄκοιτιν.	- uu - uu- uu- --u u--	dactylic hexameter	masculine penthemimeral, hepthemimeral, trithemimeral
ὡς ἀγαθαὶ φρένες ἦσαν ἀμύμονι Πηνελοπείῃ,	- uu- uu -u u-uu -uu--	dactylic hexameter	feminine penthemimeral, trithemimeral
κούρῃ Ἰκαρίου· ὡς εὖ μέμνητ’ Ὀδυσῆος,	-- -uu- - - -- uu--	dactylic hexameter	masculine penthemimeral, hepthemimeral
ἀνδρὸς κουριδίου· τῶ οἱ κλέος οὔ ποτ’ ὀλεῖται	-- -uu- - - uu - u u--	dactylic hexameter	masculine penthemimeral, hepthemimeral
ἧς ἀρετῆς, τεύξουσι δ’ ἐπιχθονίοισιν ἀοιδὴν	- uu- --u u-uu-u u--	dactylic hexameter	feminine penthemimeral, trithemimeral
ἀθάνατοι χαρίεσσαν ἐχέφρονι Πηνελοπείῃ,	-uu- uu-u u-uu -uu--	dactylic hexameter	feminine penthemimeral, trithemimeral
οὐχ ὡς Τυνδαρέου κούρη κακὰ μήσατο ἔργα,	- - -uu- -- uu -uu --	dactylic hexameter	masculine penthemimeral, hepthemimeral
κουρίδιον κτείνασα πόσιν, στυγερὴ δέ τ’ἀοιδὴ	-uu- --u u- uu- u u--	dactylic hexameter	feminine penthemimeral, hepthemimeral, trithemimeral
ἔσσετ’ ἐπ’ ἀνθρώπους, χαλεπὴν δέ τε φῆμιν ὀπάσσει	-u u --- uu- u u -u u--	dactylic hexameter	masculine penthemimeral, hepthemimeral
θηλυτέρῃσι γυναιξί, καὶ ἥ κ’εὐεργὸς ἔῃσιν.	-uu-u u-u u - --u u--	dactylic hexameter	feminine penthemimeral, hepthemimeral
ὣς οἱ μὲν τοιαῦτα πρὸς ἀλλήλους ἀγόρευον,	- - - --u u --- uu--	dactylic hexameter	feminine penthemimeral, trithemimeral
ἑσταότ’ εἰν Ἀΐδαο δόμοις, ὑπὸ κεύθεσι γαίης·	-uu - uu-u u- uu -uu --	dactylic hexameter	feminine penthemimeral, hepthemimeral, trithemimeral
οἱ δ’ἐπεὶ ἐκ πόλιος κατέβαν, τάχα δ’ἀγρὸν ἵκοντο	- uu - uu- uu- uu -u u--	dactylic hexameter	masculine penthemimeral, hepthemimeral, trithemimeral
καλὸν Λαέρταο τετυγμένον, ὅν ῥά ποτ’ αὐτὸς	-- ---u u-uu - u u --	dactylic hexameter	feminine penthemimeral
Λαέρτης κτεάτισσεν, ἐπεὶ μάλα πόλλ’ ἐμόγησεν.	--- uu-u u- uu - uu--	dactylic hexameter	feminine penthemimeral, hepthemimeral, trithemimeral
ἔνθα οἱ οἶκος ἔην, περὶ δὲ κλίσιον θέε πάντῃ,	-u u -u u- uu - uu- uu --	dactylic hexameter	masculine penthemimeral, hepthemimeral
ἐν τῷ σιτέσκοντο καὶ ἵζανον ἠδὲ ἴαυον	- - ---u u -uu -u u--	dactylic hexameter	feminine penthemimeral
δμῶες ἀναγκαῖοι, τοί οἱ φίλα ἐργάζοντο.	-u u--- - - uu ----	dactylic hexameter	masculine penthemimeral, hepthemimeral
ἐν δὲ γυνὴ Σικελὴ γρηῢς πέλεν, ἥ ῥα γέροντα	- u u- uu- -- uu - u u--	dactylic hexameter	masculine penthemimeral, hepthemimeral, trithemimeral
ἐνδυκέως κομέεσκεν ἐπ’ ἀγροῦ, νόσφι πόληος.	-uu- uu-u u -- -u u--	dactylic hexameter	feminine penthemimeral, trithemimeral
ἔνθ’ Ὀδυσεὺς δμώεσσι καὶ υἱέϊ μῦθον ἔειπεν·	- uu- --u u -uu -u u--	dactylic hexameter	feminine penthemimeral, trithemimeral
ὑμεῖς μὲν νῦν ἔλθετ’ ἐϋκτίμενον δόμον εἴσω,	-- - - -u u-uu- uu --	dactylic hexameter	feminine penthemimeral, trithemimeral
δεῖπνον δ’αἶψα συῶν ἱερεύσατε ὅς τις ἄριστος·	-- -u u- uu-uu - u u--	dactylic hexameter	masculine penthemimeral
αὐτὰρ ἐγὼ πατρὸς πειρήσομαι ἡμετέροιο,	-u u- -- --uu -uu--	dactylic hexameter	masculine penthemimeral, trithemimeral
αἴ κέ μ’ἐπιγνώῃ καὶ φράσσεται ὀφθαλμοῖσιν,	- u u--- - -uu ----	dactylic hexameter	masculine penthemimeral
ἦέ κεν ἀγνοιῇσι, πολὺν χρόνον ἀμφὶς ἐόντα.	-u u ---u u- uu -u u--	dactylic hexameter	feminine penthemimeral, hepthemimeral
ὣς εἰπὼν δμώεσσιν ἀρήϊα τεύχε’ ἔδωκεν.	- -- --u u-uu -u u--	dactylic hexameter	feminine penthemimeral, trithemimeral
οἱ μὲν ἔπειτα δόμονδε θοῶς κίον, αὐτὰρ Ὀδυσσεὺς	- u u-u u-u u- uu -u u--	dactylic hexameter	feminine penthemimeral, hepthemimeral
ἆσσον ἴεν πολυκάρπου ἀλωῆς πειρητίζων.	-u u- uu-u u-- ----	dactylic hexameter	feminine penthemimeral, trithemimeral
οὐδ’ εὗρεν Δολίον, μέγαν ὄρχατον ἐσκαταβαίνων,	- -- uu- uu -uu -uu--	dactylic hexameter	masculine penthemimeral, trithemimeral
οὐδέ τινα δμώων οὐδ’ υἱέων· ἀλλ’ ἄρα τοί γε	-u u- -- - -- - uu - -	dactylic hexameter	masculine penthemimeral, trithemimeral
αἱμασιὰς λέξοντες ἀλωῆς ἔμμεναι ἕρκος	-uu- --u u-- -uu --	dactylic hexameter	feminine penthemimeral, trithemimeral
ᾤχοντ’, αὐτὰρ ὁ τοῖσι γέρων ὁδὸν ἡγεμόνευε.	-- -u u -u u- uu -uu--	dactylic hexameter	feminine penthemimeral, hepthemimeral
τὸν δ’οἶον πατέρ’ εὗρεν ἐϋκτιμένῃ ἐν ἀλωῇ,	- -- uu -u u-uu- u u--	dactylic hexameter	feminine penthemimeral, trithemimeral
λιστρεύοντα φυτόν· ῥυπόωντα δὲ ἕστο χιτῶνα	---u u- uu-u u -u u--	dactylic hexameter	masculine penthemimeral
ῥαπτὸν ἀεικέλιον, περὶ δὲ κνήμῃσι βοείας	-u u-uu- uu - --u u--	dactylic hexameter	masculine penthemimeral, hepthemimeral
κνημῖδας ῥαπτὰς δέδετο, γραπτῦς ἀλεείνων,	--- -- uu- -- uu--	dactylic hexameter	masculine penthemimeral, hepthemimeral, trithemimeral
χειρῖδάς τ’ἐπὶ χερσὶ βάτων ἕνεκ’· αὐτὰρ ὕπερθεν	--- uu -u u- uu -u u--	dactylic hexameter	feminine penthemimeral, hepthemimeral, trithemimeral
αἰγείην κυνέην κεφαλῇ ἔχε, πένθος ἀέξων.	--- uu- uu- uu -u u--	dactylic hexameter	masculine penthemimeral, hepthemimeral, trithemimeral
τὸν δ’ὡς οὖν ἐνόησε πολύτλας δῖος Ὀδυσσεὺς	- - - uu-u u-- -u u--	dactylic hexameter	feminine penthemimeral, trithemimeral
γήραϊ τειρόμενον, μέγα δὲ φρεσὶ πένθος ἔχοντα,	-uu -uu- uu - uu -u u--	dactylic hexameter	masculine penthemimeral, hepthemimeral
στὰς ἄρ’ ὑπὸ βλωθρὴν ὄγχνην κατὰ δάκρυον εἶβε.	- u u- -- -- uu -uu --	dactylic hexameter	masculine penthemimeral, hepthemimeral, trithemimeral
μερμήριξε δ’ἔπειτα κατὰ φρένα καὶ κατὰ θυμὸν	---u u-u u- uu - uu --	dactylic hexameter	feminine penthemimeral, hepthemimeral
κύσσαι καὶ περιφῦναι ἑὸν πατέρ’, ἠδὲ ἕκαστα	-- - uu-u uu uu -u u--	lyric	
εἰπεῖν, ὡς ἔλθοι καὶ ἵκοιτ’ ἐς πατρίδα γαῖαν,	-- - -- u u- - -uu --	dactylic hexameter	masculine penthemimeral, hepthemimeral, trithemimeral
ἦ πρῶτ’ ἐξερέοιτο ἕκαστά τε πειρήσαιτο.	- - -uu-u u-u u ----	dactylic hexameter	feminine penthemimeral
ὦδε δέ οἱ φρονέοντι δοάσσατο κέρδιον εἶναι,	-u u - uu-u u-uu -uu --	dactylic hexameter	feminine penthemimeral, trithemimeral
πρῶτον κερτομίοις ἐπέεσσιν πειρηθῆναι.	-- -uu- uu-- ----	dactylic hexameter	masculine penthemimeral
τὰ φρονέων ἰθὺς κίεν αὐτοῦ δῖος Ὀδυσσεύς.	- uu- -- uu -- -u u--	dactylic hexameter	masculine penthemimeral, trithemimeral
ἤτοι ὁ μὲν κατέχων κεφαλὴν φυτὸν ἀμφελάχαινε·	-u u - uu- uu- uu -uu--	dactylic hexameter	masculine penthemimeral, hepthemimeral, trithemimeral
τὸν δὲ παριστάμενος προσεφώνεε φαίδιμος υἱός·	- u u-uu- uu-uu -uu --	dactylic hexameter	masculine penthemimeral
ὧ γέρον, οὐκ ἀδαημονίη σ’ἔχει ἀμφιπολεύειν	- uu - uu-uu- uu -uu--	dactylic hexameter	hepthemimeral, trithemimeral
ὄρχατον, ἀλλ’ εὖ τοι κομιδὴ ἔχει, οὐδέ τι πάμπαν,	-uu - - - uu- uu -u u --	dactylic hexameter	masculine penthemimeral, hepthemimeral, trithemimeral
οὐ φυτόν, οὐ συκῆ, οὐκ ἄμπελος, οὐ μὲν ἐλαίη,	- uu - -- - -uu - u u--	dactylic hexameter	masculine penthemimeral, trithemimeral
οὐκ ὄγχνη οὐ πρασιή τοι ἄν ευ κομιδῆς κατὰ κῆπον.	- -- uu- u u - uu- uu -u	lyric	
ἄλλο δέ τοι ἐρέω, σὺ δὲ μὴ χόλον ἔνθεο θυμῷ	-u u - uu- u u - uu -uu --	dactylic hexameter	masculine penthemimeral, hepthemimeral, trithemimeral
αὐτόν σ’οὐκ ἀγαθὴ κομιδὴ ἔχει, ἀλλ’ ἅμα γῆρας	-- - uu- uu- uu - uu --	dactylic hexameter	masculine penthemimeral, hepthemimeral, trithemimeral
λυγρὸν ἔχεις αὐχμεῖς τε κακῶς καὶ ἀεικέα ἕσσαι.	-u u- -- u u- u u-uu --	dactylic hexameter	masculine penthemimeral, hepthemimeral, trithemimeral
οὐ μὲν ἀεργίης γε ἄναξ ἕνεκ’ οὔ σε κομίζει,	- u u--- u u- uu - u u--	dactylic hexameter	masculine penthemimeral, hepthemimeral
οὐδέ τί τοι δούλειον ἐπιπρέπει εἰσοράασθαι	-u u - --u u-uu -uu--	dactylic hexameter	feminine penthemimeral, trithemimeral
εἶδος καὶ μέγεθος· βασιλῆϊ γὰρ ἀνδρὶ ἔοικας.	-- - uu- uu-u u -u u--	dactylic hexameter	masculine penthemimeral, trithemimeral
τοιούτῳ δὲ ἔοικας, ἐπεὶ λούσαιτο φάγοι τε,	--- u u-u u- --u u- -	dactylic hexameter	feminine penthemimeral, hepthemimeral, trithemimeral
εὑδέμεναι μαλακῶς· ἡ γὰρ δίκη ἐστὶ γερόντων.	-uu- uu- - - uu -u u--	dactylic hexameter	masculine penthemimeral, hepthemimeral, trithemimeral
ἀλλ’ ἄγε μοι τόδε εἰπὲ καὶ ἀτρεκέως κατάλεξον,	- uu - uu -u u -uu- uu--	dactylic hexameter	feminine penthemimeral, trithemimeral
τεῦ δμὼς εἶς ἀνδρῶν; τεῦ δ’ὄρχατον ἀμφιπολεύεις;	- - - -- - -uu -uu--	dactylic hexameter	masculine penthemimeral, trithemimeral
καὶ μοι τοῦτ’ ἀγόρευσον ἐτήτυμον, ὄφρ’ ἐῢ εἰδῶ,	- - - uu-u u-uu - uu --	dactylic hexameter	feminine penthemimeral, trithemimeral
εἰ ἐτεόν γ’Ἰθάκην τήνδ’ ἱκόμεθ’, ὥς μοι ἔειπεν	- uu- uu- - -uu - u u--	dactylic hexameter	masculine penthemimeral, trithemimeral
οὗτος ἀνὴρ νῦν δὴ ξυμβλήμενος ἐνθάδ’ ἰόντι,	-u u- - - --uu -u u--	dactylic hexameter	masculine penthemimeral, trithemimeral
οὔ τι μάλ’ ἀρτίφρων, ἐπεὶ οὐ τόλμησεν ἕκαστα	- u u --- uu - --u u--	dactylic hexameter	masculine penthemimeral, hepthemimeral
εἰπεῖν ἠδ’ ἐπακοῦσαι ἐμὸν ἔπος, ὡς ἐρέεινον	-- - uu-u u- uu - uu--	dactylic hexameter	feminine penthemimeral, hepthemimeral, trithemimeral
ἀμφὶ ξείνῳ ἐμῷ, εἴ που ζώει τε καὶ ἔστιν	-- -u u- - - -- u u --	dactylic hexameter	masculine penthemimeral, hepthemimeral
ἦ ἤδη τέθνηκε καὶ εἰν Ἀΐδαο δόμοισιν.	- -- --u u - uu-u u--	dactylic hexameter	feminine penthemimeral, hepthemimeral, trithemimeral
ἐκ γάρ τοι ἐρέω, σὺ δὲ σύνθεο καί μευ ἄκουσον·	- - - uu- u u -uu - u u--	dactylic hexameter	masculine penthemimeral, trithemimeral
ἄνδρα ποτ’ ἐξείνισσα φίλῃ ἐν πατρίδι γαίῃ	-u u ---u u- - -uu --	dactylic hexameter	feminine penthemimeral, hepthemimeral
ἡμέτερόνδ’ ἐλθόντα, καὶ οὔ πω τις βροτὸς ἄλλος	-uu- --u u - - - uu --	dactylic hexameter	feminine penthemimeral, hepthemimeral, trithemimeral
ξείνων τηλεδαπῶν φιλίων ἐμὸν ἵκετο δῶμα·	-- -uu- uu- uu -uu --	dactylic hexameter	masculine penthemimeral, hepthemimeral
εὔχετο δ’ἐξ Ἰθάκης γένος ἔμμεναι, αὐτὰρ ἔφασκε	-uu - uu- uu -uu -u u--	dactylic hexameter	masculine penthemimeral, trithemimeral
Λαέρτην Ἀρκεισιάδην πατέρ’ ἔμμεναι αὐτῷ.	--- --uu- uu -uu --	dactylic hexameter	hepthemimeral, trithemimeral
τὸν μὲν ἐγὼ πρὸς δώματ’ ἄγων ἐῢ ἐξείνισσα,	- u u- - -u u- uu ----	dactylic hexameter	feminine penthemimeral, hepthemimeral, trithemimeral
ἐνδυκέως φιλέων, πολλῶν κατὰ οἶκον ἐόντων,	-uu- uu- -- uu -u u--	dactylic hexameter	masculine penthemimeral, hepthemimeral, trithemimeral
καί οἱ δῶρα πόρον ξεινήϊα, οἷα ἐῴκει.	- - -u u- --uu -u u--	dactylic hexameter	masculine penthemimeral
χρυσοῦ μέν οἱ δῶκ’ εὐεργέος ἑπτὰ τάλαντα,	-- - - - --uu -u u--	dactylic hexameter	masculine penthemimeral, trithemimeral
δῶκα δέ οἱ κρητῆρα πανάργυρον ἀνθεμόεντα,	-u u - --u u-uu -uu--	dactylic hexameter	feminine penthemimeral, trithemimeral
δώδεκα δ’ἁπλοΐδας χλαίνας, τόσσους δὲ τάπητας,	-uu -uu- -- -- u u--	dactylic hexameter	masculine penthemimeral, hepthemimeral
τόσσα δὲ φάρεα καλά, τόσους δ’ἐπὶ τοῖσι χιτῶνας,	-u u -uu -u u- uu -u u--	dactylic hexameter	feminine penthemimeral, hepthemimeral
χωρὶς δ’αὖτε γυναῖκας, ἀμύμονα ἔργ’ εἰδυίας,	-- -u u-u u-uu - ---	dactylic hexameter	feminine penthemimeral
τέσσαρας εἰδαλίμας, ἃς ἤθελεν αὐτὸς ἑλέσθαι.	-uu -uu- - -uu -u u--	dactylic hexameter	masculine penthemimeral
τὸν δ’ἠμείβετ’ ἔπειτα πατὴρ κατὰ δάκρυον εἴβων·	- --u u-u u- uu -uu --	dactylic hexameter	feminine penthemimeral, hepthemimeral
ξεῖν’, ἤτοι μὲν γαῖαν ἱκάνεις, ἣν ἐρεείνεις,	- -- - -u u-- - uu--	dactylic hexameter	feminine penthemimeral, trithemimeral
ὑβρισταὶ δ’αὐτὴν καὶ ἀτάσθαλοι ἄνδρες ἔχουσι·	--- -- u u-uu -u u--	dactylic hexameter	masculine penthemimeral, trithemimeral
δῶρα δ’ἐτώσια ταῦτα χαρίζεο, μυρί’ ὀπάζων·	-u u-uu -u u-uu -u u--	dactylic hexameter	feminine penthemimeral
εἰ γάρ μιν ζωόν γε κίχεις Ἰθάκης ἐνὶ δήμῳ,	- - - -- u u- uu- uu --	dactylic hexameter	masculine penthemimeral, hepthemimeral, trithemimeral
τῶ κέν σ’εὖ δώροισιν ἀμειψάμενος ἀπέπεμψε	- - - --u u-uu- uu--	dactylic hexameter	feminine penthemimeral, trithemimeral
καὶ ξενίῃ ἀγαθῇ ἡ γὰρ θέμις, ὅς τις ὑπάρξῃ.	- uu- uu- - - uu - u u--	dactylic hexameter	masculine penthemimeral, hepthemimeral, trithemimeral
ἀλλ’ ἄγε μοι τόδε εἰπὲ καὶ ἀτρεκέως κατάλεξον,	- uu - uu -u u -uu- uu--	dactylic hexameter	feminine penthemimeral, trithemimeral
πόστον δὴ ἔτος ἐστίν, ὅτε ξείνισσας ἐκεῖνον	-- - uu -u u- --u u--	dactylic hexameter	feminine penthemimeral, hepthemimeral, trithemimeral
σὸν ξεῖνον δύστηνον, ἐμὸν παῖδ’, εἴ ποτ’ ἔην γε,	- -- --u u- - - u u- -	dactylic hexameter	feminine penthemimeral, hepthemimeral, trithemimeral
δύσμορον; ὅν που τῆλε φίλων καὶ πατρίδος αἴης	-uu - - -u u- - -uu --	dactylic hexameter	feminine penthemimeral, hepthemimeral, trithemimeral
ἠέ που ἐν πόντῳ φάγον ἰχθύες, ἢ ἐπὶ χέρσου	-u u - -- uu -uu - uu --	dactylic hexameter	masculine penthemimeral, trithemimeral
θηρσὶ καὶ οἰωνοῖσιν ἕλωρ γένετ’· οὐδέ ἑ μήτηρ	-u u ---u u- uu -u u --	dactylic hexameter	feminine penthemimeral, hepthemimeral
κλαῦσε περιστείλασα πατήρ θ’,οἵ μιν τεκόμεσθα·	-u u---u u- - - uu--	dactylic hexameter	feminine penthemimeral, hepthemimeral
οὐδ’ ἄλοχος πολύδωρος, ἐχέφρων Πηνελόπεια,	- uu- uu-u u-- -uu--	dactylic hexameter	feminine penthemimeral, trithemimeral
κώκυσ’ ἐν λεχέεσσιν ἑὸν πόσιν, ὡς ἐπεῴκει,	-- - uu-u u- uu - uu--	dactylic hexameter	feminine penthemimeral, hepthemimeral, trithemimeral
ὀφθαλμοὺς καθελοῦσα· τὸ γὰρ γέρας ἐστὶ θανόντων.	--- uu-u u - uu -u u--	dactylic hexameter	feminine penthemimeral, hepthemimeral, trithemimeral
καί μοι τοῦτ’ ἀγόρευσον ἐτήτυμον, ὄφρ’ ἐῢ εἰδῶ·	- - - uu-u u-uu - uu --	dactylic hexameter	feminine penthemimeral, trithemimeral
τίς πόθεν εἶς ἀνδρῶν; πόθι τοι πόλις ἠδὲ τοκῆες;	- uu - -- uu - uu -u u--	dactylic hexameter	masculine penthemimeral, hepthemimeral, trithemimeral
ποῦ δαὶ νηῦς ἕστηκε θοή, ἥ σ’ἤγαγε δεῦρο	- - - --u u- - -uu --	dactylic hexameter	feminine penthemimeral, hepthemimeral, trithemimeral
ἀντιθέους θ’ἑτάρους; ἦ ἔμπορος εἰλήλουθας	-uu- uu- - -uu ----	dactylic hexameter	masculine penthemimeral, trithemimeral
νηὸς ἐπ’ ἀλλοτρίης, οἱ δ’ἐκβήσαντες ἔβησαν;	-u u -uu- - ---u u--	dactylic hexameter	masculine penthemimeral
τὸν δ’ἀπαμειβόμενος προσέφη πολύμητις Ὀδυσσεύς·	- uu-uu- uu- uu-u u--	dactylic hexameter	masculine penthemimeral, hepthemimeral
τοιγὰρ ἐγώ τοι πάντα μάλ’ ἀτρεκέως καταλέξω.	-u u- - -u u -uu- uu--	dactylic hexameter	feminine penthemimeral, trithemimeral
εἰμὶ μὲν ἐξ Ἀλύβαντος, ὅθι κλυτὰ δώματα ναίω,	-u u - uu-u u- uu -uu --	dactylic hexameter	feminine penthemimeral, hepthemimeral, trithemimeral
υἱὸς Ἀφείδαντος Πολυπημονίδαο ἄνακτος·	-u u--- uu-uu-u u--	dactylic hexameter	masculine penthemimeral
αὐτὰρ ἐμοί γ’ὄνομ’ ἐστὶν Ἐπήριτος· ἀλλά με δαίμων	-u u- uu -u u-uu -u u --	dactylic hexameter	feminine penthemimeral, trithemimeral
πλάγξ’ ἀπὸ Σικανίης δεῦρ’ ἐλθέμεν οὐκ ἐθέλοντα·	- uu -uu- - -uu - uu--	dactylic hexameter	masculine penthemimeral
νηῦς δέ μοι ἥδ’ ἕστηκεν ἐπ’ ἀγροῦ νόσφι πόληος.	- u u - --u u -- -u u--	dactylic hexameter	feminine penthemimeral, trithemimeral
αὐτὰρ Ὀδυσσῆϊ τόδε δὴ πέμπτον ἔτος ἐστίν,	-u u--- uu - -- uu --	dactylic hexameter	masculine penthemimeral, hepthemimeral
ἐξ οὗ κεῖθεν ἔβη καὶ ἐμῆς ἀπελήλυθε πάτρης,	- - -u u- u u- uu-uu --	dactylic hexameter	masculine penthemimeral, hepthemimeral
δύσμορος· ἦ τέ οἱ ἐσθλοὶ ἔσαν ὄρνιθες ἰόντι,	-uu - u u -u u- --u u--	dactylic hexameter	feminine penthemimeral, hepthemimeral, trithemimeral
δεξιοί, οἷς χαίρων μὲν ἐγὼν ἀπέπεμπον ἐκεῖνον,	-uu - -- u u- uu-u u--	dactylic hexameter	masculine penthemimeral, hepthemimeral, trithemimeral
χαῖρε δὲ κεῖνος ἰών· θυμὸς δ’ἔτι νῶϊν ἐώλπει	-u u -u u- -- uu -u u--	dactylic hexameter	masculine penthemimeral, hepthemimeral
μίξεσθαι ξενίῃ ἠδ’ ἀγλαὰ δῶρα διδώσειν.	--- uu- - -uu -u u--	dactylic hexameter	masculine penthemimeral, trithemimeral
ὣς φάτο, τὸν δ’ἄχεος νεφέλη ἐκάλυψε μέλαινα·	- uu - uu- uu- uu-u u--	dactylic hexameter	masculine penthemimeral, hepthemimeral, trithemimeral
ἀμφοτέρῃσι δὲ χερσὶν ἑλὼν κόνιν αἰθαλόεσσαν	-uu-u u -u u- uu -uu--	dactylic hexameter	feminine penthemimeral, hepthemimeral
χεύατο κὰκ κεφαλῆς πολιῆς, ἁδινὰ στεναχίζων.	-uu - uu- uu- uu- uu--	dactylic hexameter	masculine penthemimeral, hepthemimeral, trithemimeral
τοῦ δ’ὠρίνετο θυμός, ἀνὰ ῥῖνας δέ οἱ ἤδη	- --uu -u u- -- u u --	dactylic hexameter	feminine penthemimeral, hepthemimeral
δριμὺ μένος προὔτυψε φίλον πατέρ’ εἰσορόωντι.	-u u- --u u- uu -uu--	dactylic hexameter	feminine penthemimeral, hepthemimeral, trithemimeral
κύσσε δέ μιν περιφὺς ἐπιάλμενος, ἠδὲ προσηύδα·	-u u - uu- uu-uu -u u--	dactylic hexameter	masculine penthemimeral, trithemimeral
κεῖνος μέν τοι ὅδ’ αὐτὸς ἐγώ, πάτερ, ὃν σὺ μεταλλᾷς,	-- - u u -u u- uu - u u--	dactylic hexameter	feminine penthemimeral, hepthemimeral, trithemimeral
ἤλυθον εἰκοστῷ ἔτεϊ ἐς πατρίδα γαῖαν.	-uu --- uu- - -uu --	dactylic hexameter	masculine penthemimeral, hepthemimeral
ἀλλ’ ἴσχεο κλαυθμοῖο γόοιό τε δακρυόεντος.	- -- --u u-u u -uu--	dactylic hexameter	feminine penthemimeral, trithemimeral
ἐκ γάρ τοι ἐρέω· μάλα δὲ χρὴ σπευδέμεν ἔμπης·	- - - uu- uu - - -uu --	dactylic hexameter	masculine penthemimeral, hepthemimeral, trithemimeral
μνηστῆρας κατέπεφνον ἐν ἡμετέροισι δόμοισι,	--- uu-u u -uu-u u--	dactylic hexameter	feminine penthemimeral, trithemimeral
λώβην τινύμενος θυμαλγέα καὶ κακὰ ἔργα.	-- -uu- --uu - uu --	dactylic hexameter	masculine penthemimeral
τὸν δ’αὖ Λαέρτης ἀπαμείβετο φώνησέν τε·	- - --- uu-uu --- -	dactylic hexameter	masculine penthemimeral
εἰ μὲν δὴ Ὀδυσεύς γε ἐμὸς πάϊς ἐνθάδ’ ἱκάνεις,	- - - uu- u u- uu -u u--	dactylic hexameter	masculine penthemimeral, hepthemimeral, trithemimeral
σῆμά τί μοι νῦν εἰπὲ ἀριφραδές, ὄφρα πεποίθω.	-u u - - -u u-uu -u u--	dactylic hexameter	feminine penthemimeral, trithemimeral
τὸν δ’ἀπαμειβόμενος προσέφη πολύμητις Ὀδυσσεύς·	- uu-uu- uu- uu-u u--	dactylic hexameter	masculine penthemimeral, hepthemimeral
οὐλὴν μὲν πρῶτον τήνδε φράσαι ὀφθαλμοῖσι,	-- - -- -- uu ----	dactylic hexameter	masculine penthemimeral, hepthemimeral, trithemimeral
τὴν ἐν Παρνησῷ μ’ἔλασεν σῦς λευκῷ ὀδόντι	- - --- uu- - -u u--	dactylic hexameter	masculine penthemimeral, hepthemimeral
οἰχόμενον· σὺ δέ με προΐεις καὶ πότνια μήτηρ	-uu- u u - uu- - -uu --	dactylic hexameter	masculine penthemimeral, hepthemimeral, trithemimeral
ἐς πατέρ’ Αὐτόλυκον μητρὸς φίλον, ὄφρ’ ἂν ἑλοίμην	- uu -uu- -- uu - u u--	dactylic hexameter	masculine penthemimeral, hepthemimeral
δῶρα, τὰ δεῦρο μολών μοι ὑπέσχετο καὶ κατένευσεν.	-u u -u u- u u-uu - uu--	dactylic hexameter	masculine penthemimeral
εἰ δ’ἄγε τοι καὶ δένδρε’ ἐϋκτιμένην κατ’ ἀλωὴν	- uu - - -u u-uu- u u--	dactylic hexameter	feminine penthemimeral, trithemimeral
εἴπω, ἅ μοί ποτ’ ἔδωκας, ἐγὼ δ’ᾔτεόν σε ἕκαστα	-u u - u u-u u- -- u u--	dactylic hexameter	feminine penthemimeral, hepthemimeral, trithemimeral
παιδνὸς ἐών, κατὰ κῆπον ἐπισπόμενος· διὰ δ’αὐτῶν	-u u- uu -u u-uu- uu --	dactylic hexameter	feminine penthemimeral, trithemimeral
ἱκνεύμεσθα, σὺ δ’ὠνόμασας καὶ ἔειπες ἕκαστα.	---u u -uu- u u-u u--	dactylic hexameter	hepthemimeral
ὄγχνας μοι δῶκας τρισκαίδεκα καὶ δέκα μηλέας,	-- - -- --uu - uu --	dactylic hexameter	masculine penthemimeral, trithemimeral
συκέας τεσσαράκοντ’· ὄρχους δέ μοι ὦδ’ ὀνόμηνας	-- -uu- -- u u - uu--	dactylic hexameter	masculine penthemimeral, hepthemimeral
δώσειν πεντήκοντα, διατρύγιος δὲ ἕκαστος	-- ---u u-uu- u u--	dactylic hexameter	feminine penthemimeral
ἤην· ἔνθα δ’ἀνὰ σταφυλαὶ παντοῖαι ἔασιν	-- -u u- uu- --u u--	dactylic hexameter	masculine penthemimeral, hepthemimeral
ὁππότε δὴ Διὸς ὦραι ἐπιβρίσειαν ὕπερθεν.	-uu - uu -u u---u u--	dactylic hexameter	feminine penthemimeral, trithemimeral
ὣς φάτο, τοῦ δ’αὐτοῦ λύτο γούνατα καὶ φίλον ἦτορ,	- uu - -- uu -uu - uu --	dactylic hexameter	masculine penthemimeral, trithemimeral
σήματ’ ἀναγνόντος τά οἱ ἔμπεδα πέφραδ’ Ὀδυσσεύς.	-u u--- u u -uu -u u--	dactylic hexameter	masculine penthemimeral
ἀμφὶ δὲ παιδὶ φίλῳ βάλε πήχεε· τὸν δὲ προτὶ οἷ	-u u -u u- uu -uu - u u- -	dactylic hexameter	masculine penthemimeral
εἷλεν ἀποψύχοντα πολύτλας δῖος Ὀδυσσεύς.	-u u---u u-- -u u--	dactylic hexameter	feminine penthemimeral
αὐτὰρ ἐπεί ῥ’ἄμπνυτο καὶ ἐς φρένα θυμὸς ἀγέρθη,	-u u- --u u - uu -u u--	dactylic hexameter	feminine penthemimeral, hepthemimeral, trithemimeral
ἐξαῦτις μύθοισιν ἀμειβόμενος προσέειπε·	--- --u u-uu- uu--	dactylic hexameter	feminine penthemimeral, trithemimeral
Ζεῦ πάτερ, ἦ ῥα ἔτ’ ἔστε θεοὶ κατὰ μακρὸν Ὄλυμπον,	- uu - u u -u u- uu -u u--	dactylic hexameter	feminine penthemimeral, hepthemimeral, trithemimeral
εἰ ἐτεὸν μνηστῆρες ἀτάσθαλον ὕβριν ἔτισαν.	- uu- --u u-uu -u u--	dactylic hexameter	feminine penthemimeral, trithemimeral
νῦν δ’αἰνῶς δείδοικα κατὰ φρένα μὴ τάχα πάντες	- -- --u u- uu - uu --	dactylic hexameter	feminine penthemimeral, hepthemimeral, trithemimeral
ἐνθάδ’ ἐπέλθωσιν Ἰθακήσιοι, ἀγγελίας δὲ	-u u--- uu-uu -uu- -	dactylic hexameter	masculine penthemimeral
πάντῃ ἐποτρύνωσι Κεφαλλήνων πολίεσσι.	-u u---u u--- uu--	dactylic hexameter	feminine penthemimeral
τὸν δ’ἀπαμειβόμενος προσέφη πολύμητις Ὀδυσσεύς·	- uu-uu- uu- uu-u u--	dactylic hexameter	masculine penthemimeral, hepthemimeral
θάρσει, μή τοι ταῦτα μετὰ φρεσὶ σῇσι μελόντων.	-- - - -u u- uu -u u--	dactylic hexameter	feminine penthemimeral, hepthemimeral, trithemimeral
ἀλλ’ ἴομεν προτὶ οἶκον, ὃς ὀρχάτου ἐγγύθι κεῖται·	- uu- uu -u u -uu -uu --	dactylic hexameter	feminine penthemimeral, trithemimeral
ἔνθα δὲ Τηλέμαχον καὶ βουκόλον ἠδὲ συβώτην	-u u -uu- - -uu -u u--	dactylic hexameter	masculine penthemimeral
προὔπεμψ’, ὡς ἂν δεῖπνον ἐφοπλίσσωσι τάχιστα.	-- - - -u u---u u--	dactylic hexameter	feminine penthemimeral, trithemimeral
ὣς ἄρα φωνήσαντε βάτην πρὸς δώματα καλά.	- uu ---u u- - -uu --	dactylic hexameter	feminine penthemimeral, hepthemimeral
οἱ δ’ὅτε δή ῥ’ἵκοντο δόμους εὖ ναιετάοντας,	- uu - --u u- - -uu--	dactylic hexameter	feminine penthemimeral, hepthemimeral, trithemimeral
εὗρον Τηλέμαχον καὶ βουκόλον ἠδὲ συβώτην	-- -uu- - -uu -u u--	dactylic hexameter	masculine penthemimeral
ταμνομένους κρέα πολλὰ κερῶντάς τ’αἴθοπα οἶνον.	-uu- uu -u u-- -uu --	dactylic hexameter	feminine penthemimeral, trithemimeral
τόφρα δὲ Λαέρτην μεγαλήτορα ᾧ ἐνὶ οἴκῳ	-u u --- uu-uu - uu --	dactylic hexameter	masculine penthemimeral
ἀμφίπολος Σικελὴ λοῦσεν καὶ χρῖσεν ἐλαίῳ,	-uu- uu- -- - -u u--	dactylic hexameter	masculine penthemimeral, hepthemimeral, trithemimeral
ἀμφὶ δ’ἄρα χλαῖναν καλὴν βάλεν· αὐτὰρ Ἀθήνη	-u u- -- -- uu -u u--	dactylic hexameter	masculine penthemimeral, hepthemimeral, trithemimeral
ἄγχι παρισταμένη μέλε’ ἤλδανε ποιμένι λαῶν,	-u u-uu- uu -uu -uu --	dactylic hexameter	masculine penthemimeral
μείζονα δ’ἠὲ πάρος καὶ πάσσονα θῆκεν ἰδέσθαι.	-uu -u u- - -uu -u u--	dactylic hexameter	masculine penthemimeral
ἐκ δ’ἀσαμίνθου βῆ· θαύμαζε δέ μιν φίλος υἱός,	- uu-- - --u u - uu --	dactylic hexameter	masculine penthemimeral
ὡς ἴδεν ἀθανάτοισι θεοῖς ἐναλίγκιον ἄντην·	- uu -uu-u u- uu-uu --	dactylic hexameter	feminine penthemimeral, hepthemimeral
καί μιν φωνήσας ἔπεα πτερόεντα προσηύδα·	- - --- uu- uu-u u--	dactylic hexameter	masculine penthemimeral, hepthemimeral
ὧ πάτερ, ἦ μάλα τίς σε θεῶν αἰειγενετάων	- uu - uu - u u- --uu--	dactylic hexameter	masculine penthemimeral, hepthemimeral, trithemimeral
εἶδός τε μέγεθός τε ἀμείνονα θῆκεν ἰδέσθαι.	-- - uu- u u-uu -u u--	dactylic hexameter	masculine penthemimeral, trithemimeral
τὸν δ’αὖ Λαέρτης πεπνυμένος ἀντίον ηὔδα·	- - --- --uu -uu --	dactylic hexameter	masculine penthemimeral
αἲ γάρ, Ζεῦ τε πάτερ καὶ Ἀθηναίη καὶ Ἄπολλον,	- - - u u- u u--- u u--	dactylic hexameter	masculine penthemimeral, trithemimeral
οἷος Νήρικον εἷλον, ἐϋκτίμενον πτολίεθρον,	-- -uu -u u-uu- uu--	dactylic hexameter	feminine penthemimeral
ἀκτὴν ἠπείροιο, Κεφαλλήνεσσιν ἀνάσσων,	-- ---u u---u u--	dactylic hexameter	feminine penthemimeral
τοῖος ἐών τοι χθιζὸς ἐν ἡμετέροισι δόμοισι,	-u u- - -u u -uu-u u--	dactylic hexameter	feminine penthemimeral, trithemimeral
τεύχε’ ἔχων ὤμοισιν, ἐφεστάμεναι καὶ ἀμύνειν	-u u- --u u-uu- u u--	dactylic hexameter	feminine penthemimeral, trithemimeral
ἄνδρας μνηστῆρας· τῶ κε σφέων γούνατ’ ἔλυσα	-- --- - - - -u u--	dactylic hexameter	masculine penthemimeral, hepthemimeral
πολλῶν ἐν μεγάροισι, σὺ δὲ φρένας ἔνδον ἐγήθεις.	-- - uu-u u - uu -u u--	dactylic hexameter	feminine penthemimeral, hepthemimeral, trithemimeral
ὣς οἱ μὲν τοιαῦτα πρὸς ἀλλήλους ἀγόρευον.	- - - --u u --- uu--	dactylic hexameter	feminine penthemimeral, trithemimeral
οἱ δ’ἐπεὶ οὖν παύσαντο πόνου τετύκοντό τε δαῖτα,	- uu - --u u- uu-u u --	dactylic hexameter	feminine penthemimeral, hepthemimeral, trithemimeral
ἑξείης ἕζοντο κατὰ κλισμούς τε θρόνους τε·	--- --u u- -- u u- -	dactylic hexameter	feminine penthemimeral, hepthemimeral, trithemimeral
ἔνθ’ οἱ μὲν δείπνῳ ἐπεχείρεον, ἀγχίμολον δὲ	- - - -- uu-uu -uu- -	dactylic hexameter	masculine penthemimeral, trithemimeral
ἦλθ’ ὁ γέρων Δολίος, σὺν δ’υἱεῖς τοῖο γέροντος,	- u u- uu- - -- -u u--	dactylic hexameter	masculine penthemimeral, trithemimeral
ἐξ ἔργων μογέοντες, ἐπεὶ προμολοῦσα κάλεσσε	- -- uu-u u- uu-u u--	dactylic hexameter	feminine penthemimeral, hepthemimeral, trithemimeral
μήτηρ γρηῦς Σικελή, ἥ σφεας τρέφε καί ῥα γέροντα	-- - uu- - - uu - u u--	dactylic hexameter	masculine penthemimeral, hepthemimeral, trithemimeral
ἐνδυκέως κομέεσκεν, ἐπεὶ κατὰ γῆρας ἔμαρψεν.	-uu- uu-u u- uu -u u--	dactylic hexameter	feminine penthemimeral, hepthemimeral, trithemimeral
οἱ δ’ὡς οὖν Ὀδυσῆα ἴδον φράσσαντό τε θυμῷ,	- - - uu-u u- --u u --	dactylic hexameter	feminine penthemimeral, hepthemimeral, trithemimeral
ἔσταν ἐνὶ μεγάροισι τεθηπότες· αὐτὰρ Ὀδυσσεὺς	-u u- uu-u u-uu -u u--	dactylic hexameter	feminine penthemimeral, trithemimeral
μειλιχίοις ἐπέεσσι καθαπτόμενος προσέειπεν·	-uu- uu-u u-uu- uu--	dactylic hexameter	feminine penthemimeral, trithemimeral
ὧ γέρον, ἵζ’ ἐπὶ δεῖπνον, ἀπεκλελάθεσθε δὲ θάμβευς·	- uu - uu -u u-uu-u u --	dactylic hexameter	feminine penthemimeral, trithemimeral
δηρὸν γὰρ σίτῳ ἐπιχειρήσειν μεμαῶτες	-- - -- uu--- uu--	dactylic hexameter	masculine penthemimeral, trithemimeral
μίμνομεν ἐν μεγάροις, ὑμέας ποτιδέγμενοι αἰεί.	-uu - uu- uu- uu-uu --	dactylic hexameter	masculine penthemimeral, hepthemimeral, trithemimeral
ὣς ἄρ’ ἔφη, Δολίος δ’ἰθὺς κίε χεῖρε πετάσσας	- u u- uu- -- uu -u u--	dactylic hexameter	masculine penthemimeral, hepthemimeral, trithemimeral
ἀμφοτέρας, Ὀδυσεῦς δὲ λαβὼν κύσε χεῖρ’ ἐπὶ καρπῷ,	-uu- uu- u u- uu - uu --	dactylic hexameter	masculine penthemimeral, hepthemimeral, trithemimeral
καί μιν φωνήσας ἔπεα πτερόεντα προσηύδα·	- - --- uu- uu-u u--	dactylic hexameter	masculine penthemimeral, hepthemimeral
ὧ φίλ’, ἐπεὶ νόστησας ἐελδομένοισι μάλ’ ἡμῖν	- u u- --u u-uu-u u --	dactylic hexameter	feminine penthemimeral, trithemimeral
οὐδ’ ἔτ’ ὀϊομένοισι, θεοὶ δέ σε ἤγαγον αὐτοί,	- u u-uu-u u- u u -uu --	dactylic hexameter	feminine penthemimeral, hepthemimeral
οὖλέ τε καὶ μέγα χαῖρε, θεοὶ δέ τοι ὄλβια δοῖεν.	-u u - uu -u u- u u -uu --	dactylic hexameter	feminine penthemimeral, hepthemimeral, trithemimeral
καί μοι τοῦτ’ ἀγόρευσον ἐτήτυμον, ὄφρ’ ἐῢ εἰδῶ,	- - - uu-u u-uu - uu --	dactylic hexameter	feminine penthemimeral, trithemimeral
ἢ ἤδη σάφα οἶδε περίφρων Πηνελόπεια	- -- uu -u u-- -uu--	dactylic hexameter	feminine penthemimeral, trithemimeral
νοστήσαντά σε δεῦρ’, ἦ ἄγγελον ὀτρύνωμεν.	---u u - - -uu ----	dactylic hexameter	masculine penthemimeral
τὸν δ’ἀπαμειβόμενος προσέφη πολύμητις Ὀδυσσεύς·	- uu-uu- uu- uu-u u--	dactylic hexameter	masculine penthemimeral, hepthemimeral
ὧ γέρον, ἤδη οἶδε· τί σε χρὴ ταῦτα πένεσθαι;	- uu -- -u u - - -u u--	dactylic hexameter	feminine penthemimeral, hepthemimeral
ὣς φάθ’, ὁ δ’αὖτις ἄρ’ ἕζετ’ ἐϋξέστου ἐπὶ δίφρου.	- u u -u u -u u--- uu --	dactylic hexameter	feminine penthemimeral
ὣς δ’αὔτως παῖδες Δολίου κλυτὸν ἀμφ’ Ὀδυσῆα	- -- -- uu- uu - uu--	dactylic hexameter	masculine penthemimeral, hepthemimeral, trithemimeral
δεικανόωντ’ ἐπέεσσι καὶ ἐν χείρεσσι φύοντο,	-uu- uu-u u - --u u--	dactylic hexameter	feminine penthemimeral, hepthemimeral, trithemimeral
ἑξείης δ’ἕζοντο παραὶ Δολίον, πατέρα σφόν.	--- --u u- uu- uu- -	dactylic hexameter	feminine penthemimeral, hepthemimeral, trithemimeral
ὣς οἱ μὲν περὶ δεῖπνον ἐνὶ μεγάροισι πένοντο·	- - - uu -u u- uu-u u--	dactylic hexameter	feminine penthemimeral, hepthemimeral, trithemimeral
Ὄσσα δ’ἄρ’ ἄγγελος ὧκα κατὰ πτόλιν ᾤχετο πάντῃ,	-u u -uu -u u- uu -uu --	dactylic hexameter	feminine penthemimeral, hepthemimeral
μνηστήρων στυγερὸν θάνατον καὶ κῆρ’ ἐνέπουσα.	--- uu- uu- - - uu--	dactylic hexameter	masculine penthemimeral, hepthemimeral, trithemimeral
οἱ δ’ἄρ’ ὁμῶς ἀΐοντες ἐφοίτων ἄλλοθεν ἄλλος	- u u- uu-u u-- -uu --	dactylic hexameter	feminine penthemimeral, trithemimeral
μυχμῷ τε στοναχῇ τε δόμων προπάροιθ’ Ὀδυσῆος,	-- - uu- u u- uu- uu--	dactylic hexameter	masculine penthemimeral, hepthemimeral, trithemimeral
ἐκ δὲ νέκυς οἴκων φόρεον καὶ θάπτον ἕκαστοι,	- u u- -- uu- - -u u--	dactylic hexameter	masculine penthemimeral, hepthemimeral, trithemimeral
τοὺς δ’ἐξ ἀλλάων πολίων οἶκόνδε ἕκαστον	- - --- uu- --u u--	dactylic hexameter	masculine penthemimeral, hepthemimeral
πέμπον ἄγειν ἁλιεῦσι θοῇς ἐπὶ νηυσὶ τιθέντες·	-u u- uu-u u- uu -u u--	dactylic hexameter	feminine penthemimeral, hepthemimeral, trithemimeral
αὐτοὶ δ’εἰς ἀγορὴν κίον ἀθρόοι, ἀχνύμενοι κῆρ.	-- - uu- uu -uu -uu- -	dactylic hexameter	masculine penthemimeral, trithemimeral
αὐτὰρ ἐπεί ῥ’ἤγερθεν ὁμηγερέες τ’ἐγένοντο,	-u u- --u u-uu- uu--	dactylic hexameter	feminine penthemimeral, trithemimeral
τοῖσιν δ’Εὐπείθης ἀνά θ’ἵστατο καὶ μετέειπε·	-- --- uu -uu - uu--	dactylic hexameter	masculine penthemimeral
παιδὸς γάρ οἱ ἄλαστον ἐνὶ φρεσὶ πένθος ἔκειτο,	-- - u u-u u- uu -u u--	dactylic hexameter	feminine penthemimeral, hepthemimeral, trithemimeral
Ἀντινόου, τὸν πρῶτον ἐνήρατο δῖος Ὀδυσσεύς·	-uu- - -u u-uu -u u--	dactylic hexameter	feminine penthemimeral, trithemimeral
τοῦ ὅ γε δάκρυ χέων ἀγορήσατο καὶ μετέειπεν·	- u u -u u- uu-uu - uu--	dactylic hexameter	masculine penthemimeral
ὧ φίλοι, ἦ μέγα ἔργον ἀνὴρ ὅδε μήσατ’ Ἀχαιούς·	- uu - uu -u u- uu -u u--	dactylic hexameter	feminine penthemimeral, hepthemimeral, trithemimeral
τοὺς μὲν σὺν νήεσσιν ἄγων πολέας τε καὶ ἐσθλοὺς	- - - --u u- uu- u u --	dactylic hexameter	feminine penthemimeral, hepthemimeral, trithemimeral
ὤλεσε μὲν νῆας γλαφυράς, ἀπὸ δ’ὤλεσε λαούς·	-uu - -- uu- uu -uu --	dactylic hexameter	masculine penthemimeral, hepthemimeral, trithemimeral
τοὺς δ’ἐλθὼν ἔκτεινε Κεφαλλήνων ὄχ’ ἀρίστους,	- -- --u u--- u u--	dactylic hexameter	feminine penthemimeral, trithemimeral
ἀλλ’ ἄγετε, πρὶν τοῦτον ἢ ἐς Πύλον ὧκα ἱκέσθαι	- uu- - -u u - uu -u u--	dactylic hexameter	feminine penthemimeral, hepthemimeral, trithemimeral
ἢ καὶ ἐς Ἤλιδα δῖαν, ὅθι κρατέουσιν Ἐπειοί,	- u u -uu -u u- uu-u u--	dactylic hexameter	feminine penthemimeral, hepthemimeral
ἴομεν· ἦ καὶ ἔπειτα κατηφέες ἐσσόμεθ’ αἰεί·	-uu - u u-u u-uu -uu --	dactylic hexameter	feminine penthemimeral, trithemimeral
λώβη γὰρ τάδε γ’ἐστὶ καὶ ἐσσομένοισι πυθέσθαι,	-- - uu -u u -uu-u u--	dactylic hexameter	feminine penthemimeral, trithemimeral
εἰ δὴ μὴ παίδων τε κασιγνήτων τε φονῆας	- - - -- u u--- u u--	dactylic hexameter	masculine penthemimeral, trithemimeral
τισόμεθ’. οὐκ ἂν ἔμοιγε μετὰ φρεσὶν ἡδὺ γένοιτο	-uu - u u-u u- uu -u u--	dactylic hexameter	feminine penthemimeral, hepthemimeral, trithemimeral
ζωέμεν, ἀλλὰ τάχιστα θανὼν φθιμένοισι μετείην.	-uu -u u-u u- uu-u u--	dactylic hexameter	feminine penthemimeral, hepthemimeral
ἀλλ’ ἴομεν, μὴ φθέωσι περαιωθέντες ἐκεῖνοι.	- uu- - -u u---u u--	dactylic hexameter	feminine penthemimeral, trithemimeral
ὣς φάτο δάκρυ χέων, οἶκτος δ’ἕλε πάντας Ἀχαιούς.	- uu -u u- -- uu -u u--	dactylic hexameter	masculine penthemimeral, hepthemimeral
ἀγχίμολον δέ σφ’ἦλθε Μέδων καὶ θεῖος ἀοιδὸς	-uu- - -u u- - -u u--	dactylic hexameter	feminine penthemimeral, hepthemimeral, trithemimeral
ἐκ μεγάρων Ὀδυσῆος, ἐπεί σφεας ὕπνος ἀνῆκεν,	- uu- uu-u u- uu -u u--	dactylic hexameter	feminine penthemimeral, hepthemimeral, trithemimeral
ἔσταν δ’ἐν μέσσοισι· τάφος δ’ἕλεν ἄνδρα ἕκαστον.	-- - --u u- uu -u u--	dactylic hexameter	feminine penthemimeral, hepthemimeral, trithemimeral
τοῖσι δὲ καὶ μετέειπε Μέδων πεπνυμένα εἰδώς·	-u u - uu-u u- --uu --	dactylic hexameter	feminine penthemimeral, hepthemimeral, trithemimeral
κέκλυτε δὴ νῦν μευ, Ἰθακήσιοι· οὐ γὰρ Ὀδυσσεὺς	-uu - - - uu-uu - u u--	dactylic hexameter	masculine penthemimeral, trithemimeral
ἀθανάτων ἀέκητι θεῶν τάδε μήσατο ἔργα·	-uu- uu-u u- uu -uu --	dactylic hexameter	feminine penthemimeral, hepthemimeral, trithemimeral
αὐτὸς ἐγὼν εἶδον θεὸν ἄμβροτον, ὅς ῥ’Ὀδυσῆος	-u u- -- uu -uu - uu--	dactylic hexameter	masculine penthemimeral, trithemimeral
ἐγγύθεν εἱστήκει καὶ Μέντορι πάντα ἐῴκει.	-uu --- - -uu -u u--	dactylic hexameter	masculine penthemimeral
ἀθάνατος δὲ θεὸς τοτὲ μὲν προπάροιθ’ Ὀδυσῆος	-uu- u u- uu - uu- uu--	dactylic hexameter	masculine penthemimeral, hepthemimeral, trithemimeral
φαίνετο θαρσύνων, τοτὲ δὲ μνηστῆρας ὀρίνων	-uu --- uu - --u u--	dactylic hexameter	masculine penthemimeral, hepthemimeral
θῦνε κατὰ μέγαρον· τοὶ δ’ἀγχιστῖνοι ἔπιπτον.	-u u- uu- - ---u u--	dactylic hexameter	masculine penthemimeral, trithemimeral
ὣς φάτο, τοὺς δ’ἄρα πάντας ὑπὸ χλωρὸν δέος ᾕρει.	- uu - uu -u u- -- uu --	dactylic hexameter	feminine penthemimeral, hepthemimeral, trithemimeral
τοῖσι δὲ καὶ μετέειπε γέρων ἥρως Ἁλιθέρσης	-u u - uu-u u- -- uu--	dactylic hexameter	feminine penthemimeral, hepthemimeral, trithemimeral
Μαστορίδης· ὁ γὰρ οἶος ὅρα πρόσσω καὶ ὀπίσσω·	-uu- u u -u u- -- u u--	dactylic hexameter	feminine penthemimeral, hepthemimeral, trithemimeral
ὅ σφιν ἐῢ φρονέων ἀγορήσατο καὶ μετέειπε·	- u u- uu- uu-uu - uu--	dactylic hexameter	masculine penthemimeral, trithemimeral
κέκλυτε δὴ νῦν μευ, Ἰθακήσιοι, ὅττι κεν εἴπω·	-uu - - - uu-uu -u u --	dactylic hexameter	masculine penthemimeral, trithemimeral
ὑμετέρῃ κακότητι, φίλοι, τάδε ἔργα γένοντο·	-uu- uu-u u- uu -u u--	dactylic hexameter	feminine penthemimeral, hepthemimeral, trithemimeral
οὐ γὰρ ἐμοὶ πείθεσθ’, οὐ Μέντορι ποιμένι λαῶν,	- u u- -- - -uu -uu --	dactylic hexameter	masculine penthemimeral, trithemimeral
ὑμετέρους παῖδας καταπαυέμεν ἀφροσυνάων,	-uu- -- uu-uu -uu--	dactylic hexameter	masculine penthemimeral, trithemimeral
οἳ μέγα ἔργον ἔρεξαν ἀτασθαλίῃσι κακῇσι,	- uu -u u-u u-uu-u u--	dactylic hexameter	feminine penthemimeral
κτήματα κείροντες καὶ ἀτιμάζοντες ἄκοιτιν	-uu --- u u---u u--	dactylic hexameter	masculine penthemimeral
ἀνδρὸς ἀριστῆος· τὸν δ’οὐκέτι φάντο νέεσθαι.	-u u--- - -uu -u u--	dactylic hexameter	masculine penthemimeral
καὶ νῦν ὦδε γένοιτο. πίθεσθέ μοι ὡς ἀγορεύω·	- - -u u-u u-u u - uu--	dactylic hexameter	feminine penthemimeral
μὴ ἴομεν, μή πού τις ἐπίσπαστον κακὸν εὕρῃ.	- uu- - - u u--- uu --	dactylic hexameter	masculine penthemimeral, trithemimeral
ὣς ἔφαθ’, οἱ δ’ἄρ’ ἀνήϊξαν μεγάλῳ ἀλαλητῷ	- uu - u u--- uu- uu--	dactylic hexameter	hepthemimeral, trithemimeral
ἡμίσεων πλείους· τοὶ δ’ἀθρόοι αὐτόθι μεῖναν·	-uu- -- - -uu -uu --	dactylic hexameter	masculine penthemimeral, trithemimeral
οὐ γὰρ σφιν ἅδε μῦθος ἐνὶ φρεσίν, ἀλλ’ Εὐπείθει	- - - uu -u u- uu - ---	dactylic hexameter	feminine penthemimeral, hepthemimeral, trithemimeral
πείθοντ’· αἶψα δ’ἔπειτ’ ἐπὶ τεύχεα ἐσσεύοντο.	-- -u u- uu -uu ----	dactylic hexameter	masculine penthemimeral
αὐτὰρ ἐπεί ῥ’ἕσσαντο περὶ χροῒ νώροπα χαλκόν,	-u u- --u u- uu -uu --	dactylic hexameter	feminine penthemimeral, hepthemimeral, trithemimeral
ἀθρόοι ἠγερέθοντο πρὸ ἄστεος εὐρυχόροιο.	-uu -uu-u u -uu -uu--	dactylic hexameter	feminine penthemimeral
τοῖσιν δ’Εὐπείθης ἡγήσατο νηπιέῃσι·	-- --- --uu -uu--	dactylic hexameter	masculine penthemimeral
φῆ δ’ὅ γε τίσεσθαι παιδὸς φόνον, οὐδ’ ἄρ’ ἔμελλεν	- u u --- -- uu - u u--	dactylic hexameter	masculine penthemimeral, hepthemimeral
ἂψ ἀπονοστήσειν, ἀλλ’ αὐτοῦ πότμον ἐφέψειν.	- uu--- - -- -u u--	dactylic hexameter	masculine penthemimeral
αὐτὰρ Ἀθηναίη Ζῆνα Κρονίωνα προσηύδα·	-u u--- -- uu-u u--	dactylic hexameter	masculine penthemimeral, hepthemimeral
ὧ πάτερ ἡμέτερε, Κρονίδη, ὕπατε κρειόντων,	- uu -uu- uu- uu- ---	dactylic hexameter	masculine penthemimeral, hepthemimeral
εἰπέ μοι εἰρομένῃ, τί νύ τοι νόος ἔνδοθι κεύθει;	-u u -uu- u u - uu -uu --	dactylic hexameter	masculine penthemimeral, hepthemimeral
ἢ προτέρω πόλεμόν τε κακὸν καὶ φύλοπιν αἰνὴν	- uu- uu- u u- - -uu --	dactylic hexameter	masculine penthemimeral, hepthemimeral, trithemimeral
τεύξεις, ἦ φιλότητα μετ’ ἀμφοτέροισι τίθησθα;	-- - uu-u u -uu-u u--	dactylic hexameter	feminine penthemimeral, trithemimeral
τὴν δ’ἀπαμειβόμενος προσέφη νεφεληγερέτα Ζεύς·	- uu-uu- uu- uu-uu- -	dactylic hexameter	masculine penthemimeral, hepthemimeral
τέκνον ἐμόν, τί με ταῦτα διείρεαι ἠδὲ μεταλλᾷς;	-u u- u u -u u-uu -u u--	dactylic hexameter	feminine penthemimeral, trithemimeral
οὐ γὰρ δὴ τοῦτον μὲν ἐβούλευσας νόον αὐτή,	- - - -- u u--- uu --	dactylic hexameter	masculine penthemimeral, trithemimeral
ὡς ἤτοι κείνους Ὀδυσεὺς ἀποτίσεται ἐλθών;	- -- -- uu- uu-uu --	dactylic hexameter	masculine penthemimeral, hepthemimeral, trithemimeral
ἔρξον ὅπως ἐθέλεις· ἐρέω δέ τοι ὡς ἐπέοικεν.	-u u- uu- uu- u u - uu--	dactylic hexameter	masculine penthemimeral, hepthemimeral, trithemimeral
ἐπεὶ δὴ μνηστῆρας ἐτίσατο δῖος Ὀδυσσεύς,	-- - --u u-uu -u u--	dactylic hexameter	feminine penthemimeral, trithemimeral
ὅρκια πιστὰ ταμόντες ὁ μὲν βασιλευέτω αἰεί,	-uu -u u-u u - uu-uu --	dactylic hexameter	feminine penthemimeral, hepthemimeral
ἡμεῖς δ’αὖ παίδων τε κασιγνήτων τε φόνοιο	-- - -- u u--- u u--	dactylic hexameter	masculine penthemimeral, trithemimeral
ἔκλησιν θέωμεν· τοὶ δ’ἀλλήλους φιλεόντων	--- -- - --- uu--	dactylic hexameter	masculine penthemimeral, trithemimeral
ὡς τὸ πάρος, πλοῦτος δὲ καὶ εἰρήνη ἅλις ἔστω.	- u u- -- u u --- uu --	dactylic hexameter	masculine penthemimeral, trithemimeral
ὣς εἰπὼν ὤτρυνε πάρος μεμαυῖαν Ἀθήνην,	- -- --u u- uu-u u--	dactylic hexameter	feminine penthemimeral, hepthemimeral, trithemimeral
βῆ δὲ κατ’ Οὐλύμποιο καρήνων ἀΐξασα.	- u u ---u u-- ----	dactylic hexameter	feminine penthemimeral
οἱ δ’ἐπεὶ οὖν σίτοιο μελίφρονος ἐξ ἔρον ἕντο,	- uu - --u u-uu - uu --	dactylic hexameter	feminine penthemimeral, trithemimeral
τοῖς ἄρα μύθων ἦρχε πολύτλας δῖος Ὀδυσσεύς·	- uu -- -u u-- -u u--	dactylic hexameter	feminine penthemimeral
ἐξελθών τις ἴδοι μὴ δὴ σχεδὸν ὧσι κιόντες.	--- u u- - - uu -u u--	dactylic hexameter	masculine penthemimeral, hepthemimeral, trithemimeral
ὣς ἔφατ’· ἐκ δ’υἱὸς Δολίου κίεν, ὡς ἐκέλευε·	- uu - -- uu- uu - uu--	dactylic hexameter	masculine penthemimeral, hepthemimeral, trithemimeral
στῆ δ’ἄρ’ ἐπ’ οὐδὸν ἰών, τοὺς δὲ σχεδὸν εἴσιδε πάντας·	- u u -u u- - - uu -uu --	dactylic hexameter	masculine penthemimeral, hepthemimeral
αἶψα δ’Ὀδυσσῆα ἔπεα πτερόεντα προσηύδα·	-u u--- uu- uu-u u--	dactylic hexameter	masculine penthemimeral, hepthemimeral
οἵδε δὴ ἐγγὺς ἔασ’· ἀλλ’ ὁπλιζώμεθα θᾶσσον.	-u u -u u- - ---uu --	dactylic hexameter	masculine penthemimeral
ὣς ἔφαθ’, οἱ δ’ὤρνυντο καὶ ἐν τεύχεσσι δύοντο,	- uu - --u u - --u u--	dactylic hexameter	feminine penthemimeral, hepthemimeral, trithemimeral
τέσσαρες ἀμφ’ Ὀδυσῆα, ἓξ δ’υἱεῖς οἱ Δολίοιο·	-uu - uu- - -- - uu--	dactylic hexameter	masculine penthemimeral, trithemimeral
ἐν δ’ἄρα Λαέρτης Δολίος τ’ἐς τεύχε’ ἔδυνον,	- uu --- uu- - -u u--	dactylic hexameter	masculine penthemimeral, hepthemimeral
καὶ πολιοί περ ἐόντες, ἀναγκαῖοι πολεμισταί.	- uu- u u-u u--- uu--	dactylic hexameter	feminine penthemimeral, trithemimeral
αὐτὰρ ἐπεί ῥ’ἕσσαντο περὶ χροῒ νώροπα χαλκόν,	-u u- --u u- uu -uu --	dactylic hexameter	feminine penthemimeral, hepthemimeral, trithemimeral
ὤϊξάν ῥα θύρας, ἐκ δ’ἤϊον, ἤρχε δ’Ὀδυσσεύς.	--- u u- - -uu -u u--	dactylic hexameter	masculine penthemimeral, trithemimeral
τοῖσι δ’ἐπ’ ἀγχίμολον θυγάτηρ Διὸς ἦλθεν Ἀθήνη	-u u -uu- uu- uu -u u--	dactylic hexameter	masculine penthemimeral, hepthemimeral
Μέντορι εἰδομένη ἠμὲν δέμας ἠδὲ καὶ αὐδήν.	-uu -uu- -- uu -u u --	dactylic hexameter	masculine penthemimeral, hepthemimeral
τὴν μὲν ἰδὼν γήθησε πολύτλας δῖος Ὀδυσσεύς·	- u u- --u u-- -u u--	dactylic hexameter	feminine penthemimeral, trithemimeral
αἶψα δὲ Τηλέμαχον προσεφώνεεν ὃν φίλον υἱόν·	-u u -uu- uu-uu - uu --	dactylic hexameter	masculine penthemimeral
Τηλέμαχ’, ἤδη μὲν τόδε γ’εἴσεαι αὐτὸς ἐπελθών,	-uu -- - uu -uu -u u--	dactylic hexameter	masculine penthemimeral
ἀνδρῶν μαρναμένων ἵνα τε κρίνονται ἄριστοι,	-- -uu- uu - --u u--	dactylic hexameter	masculine penthemimeral, hepthemimeral
μή τι καταισχύνειν πατέρων γένος, οἳ τὸ πάρος περ	- u u--- uu- uu - u u- -	dactylic hexameter	masculine penthemimeral, hepthemimeral
ἀλκῇ τ’ἠνορέῃ τε κεκάσμεθα πᾶσαν ἐπ’ αἶαν.	-- -uu- u u-uu -u u --	dactylic hexameter	masculine penthemimeral
τὸν δ’αὖ Τηλέμαχος πεπνυμένος ἀντίον ηὔδα·	- - -uu- --uu -uu --	dactylic hexameter	masculine penthemimeral
ὄψεαι, αἴ κ’ἐθέλῃσθα, πάτερ φίλε, τῷδ’ ἐνὶ θυμῷ	-uu - uu-u u- uu - uu --	dactylic hexameter	feminine penthemimeral, hepthemimeral, trithemimeral
οὔ τι καταισχύνοντα τεὸν γένος, ὡς ἀγορεύεις.	- u u---u u- uu - uu--	dactylic hexameter	feminine penthemimeral, hepthemimeral
ὣς φάτο, Λαέρτης δ’ἐχάρη καὶ μῦθον ἔειπε·	- uu --- uu- - -u u--	dactylic hexameter	masculine penthemimeral, hepthemimeral
τίς νύ μοι ἡμέρη ἥδε, θεοὶ φίλοι; ἦ μάλα χαίρω·	- u u -uu -u u- uu - uu --	dactylic hexameter	feminine penthemimeral, hepthemimeral
υἱός θ’υἱωνός τ’ἀρετῆς πέρι δῆριν ἔχουσι.	-- --- uu- uu -u u--	dactylic hexameter	masculine penthemimeral, hepthemimeral
τὸν δὲ παρισταμένη προσέφη γλαυκῶπις Ἀθήνη·	- u u-uu- uu- --u u--	dactylic hexameter	masculine penthemimeral, hepthemimeral
ὧ Ἀρκεισιάδη, πάντων πολὺ φίλταθ’ ἑταίρων,	- --uu- -- uu -u u--	dactylic hexameter	masculine penthemimeral, hepthemimeral
εὐξάμενος κούρῃ γλαυκώπιδι καὶ Διῒ πατρί,	-uu- -- --uu - uu --	dactylic hexameter	masculine penthemimeral, trithemimeral
αἶψα μάλ’ ἀμπεπαλὼν προΐει δολιχόσκιον ἔγχος.	-u u -uu- uu- uu-uu --	dactylic hexameter	masculine penthemimeral, hepthemimeral
ὣς φάτο, καί ῥ’ἔμπνευσε μένος μέγα Παλλὰς Ἀθήνη	- uu - --u u- uu -u u--	dactylic hexameter	feminine penthemimeral, hepthemimeral, trithemimeral
εὐξάμενος δ’ἄρ’ ἔπειτα Διὸς κούρῃ μεγάλοιο,	-uu- u u-u u- -- uu--	dactylic hexameter	feminine penthemimeral, hepthemimeral, trithemimeral
αἶψα μάλ’ ἀμπεπαλὼν προΐει δολιχόσκιον ἔγχος,	-u u -uu- uu- uu-uu --	dactylic hexameter	masculine penthemimeral, hepthemimeral
καὶ βάλεν Εὐπείθεα κόρυθος διὰ χαλκοπαρήου.	- uu --- uu- uu -uu--	dactylic hexameter	masculine penthemimeral, hepthemimeral
ἡ δ’οὐκ ἔγχος ἔρυτο, διαπρὸ δὲ εἴσατο χαλκός,	- - -u u-u u-u u -uu --	dactylic hexameter	feminine penthemimeral
δούπησεν δὲ πεσών, ἀράβησε δὲ τεύχε’ ἐπ’ αὐτῷ.	--- u u- uu-u u -u u --	dactylic hexameter	masculine penthemimeral, trithemimeral
ἐν δ’ἔπεσον προμάχοις Ὀδυσεὺς καὶ φαίδιμος υἱός,	- uu- uu- uu- - -uu --	dactylic hexameter	masculine penthemimeral, hepthemimeral, trithemimeral
τύπτον δὲ ξίφεσίν τε καὶ ἔγχεσιν ἀμφιγύοισι.	-- - uu- u u -uu -uu--	dactylic hexameter	masculine penthemimeral, trithemimeral
καί νύ κε δὴ πάντας ὄλεσαν καὶ ἔθηκαν ἀνόστους,	- u u - -- uu- u u-u u--	dactylic hexameter	masculine penthemimeral, hepthemimeral, trithemimeral
εἰ μὴ Ἀθηναίη, κούρη Διὸς αἰγιόχοιο,	- u u--- -- uu -uu--	dactylic hexameter	masculine penthemimeral, hepthemimeral
ἤϋσεν φωνῇ, κατὰ δ’ἔσχεθε λαὸν ἅπαντα.	--- -- uu -uu -u u--	dactylic hexameter	masculine penthemimeral, trithemimeral
ἴσχεσθε πτολέμου, Ἰθακήσιοι, ἀργαλέοιο,	--- uu- uu-uu -uu--	dactylic hexameter	masculine penthemimeral, trithemimeral
ὥς κεν ἀναιμωτί γε διακρινθῆτε τάχιστα.	- u u--- u u---u u--	dactylic hexameter	masculine penthemimeral
ὣς φάτ’ Ἀθηναίη, τοὺς δὲ χλωρὸν δέος εἷλε·	- u u--- - - -- uu --	dactylic hexameter	masculine penthemimeral, hepthemimeral
τῶν δ’ἄρα δεισάντων ἐκ χειρῶν ἔπτατο τεύχεα,	- uu --- - -- -uu --	dactylic hexameter	masculine penthemimeral
πάντα δ’ἐπὶ χθονὶ πῖπτε, θεᾶς ὄπα φωνησάσης·	-u u- uu -u u- uu ----	dactylic hexameter	feminine penthemimeral, hepthemimeral, trithemimeral
πρὸς δὲ πόλιν τρωπῶντο λιλαιόμενοι βιότοιο.	- u u- --u u-uu- uu--	dactylic hexameter	feminine penthemimeral, trithemimeral
σμερδαλέον δ’ἐβόησε πολύτλας δῖος Ὀδυσσεύς,	-uu- uu-u u-- -u u--	dactylic hexameter	feminine penthemimeral, trithemimeral
οἴμησεν δὲ ἀλεὶς ὥς τ’αἰετὸς ὑψιπετήεις.	--- u u- - -uu -uu--	dactylic hexameter	masculine penthemimeral, trithemimeral
καὶ τότε δὴ Κρονίδης ἀφίει ψολόεντα κεραυνόν,	- uu - uu- uu- uu-u u--	dactylic hexameter	masculine penthemimeral, hepthemimeral, trithemimeral
κὰδ δ’ἔπεσε πρόσθε γλαυκώπιδος ὀβριμοπάτρης.	- uu- -- --uu -uu--	dactylic hexameter	masculine penthemimeral, trithemimeral
δὴ τότ’ Ὀδυσσῆα προσέφη γλαυκῶπις Ἀθήνη·	- u u--- uu- --u u--	dactylic hexameter	masculine penthemimeral, hepthemimeral
διογενὲς Λαερτιάδη, πολυμήχαν’ Ὀδυσσεῦ,	-uu- --uu- uu-u u--	dactylic hexameter	hepthemimeral, trithemimeral
ἴσχεο, παῦε δὲ νεῖκος ὁμοιΐου πτολέμοιο,	-uu -u u -u u--- uu--	dactylic hexameter	feminine penthemimeral
μή πως τοι Κρονίδης κεχολώσεται εὐρύοπα Ζεύς.	- - - uu- uu-uu -uu- -	dactylic hexameter	masculine penthemimeral, trithemimeral
ὣς φάτ’ Ἀθηναίη, ὁ δ’ἐπείθετο, χαῖρε δὲ θυμῷ.	- u u--- u u-uu -u u --	dactylic hexameter	masculine penthemimeral
ὅρκια δ’αὖ κατόπισθε μετ’ ἀμφοτέροισιν ἔθηκε	-uu - uu-u u -uu-u u--	dactylic hexameter	feminine penthemimeral, trithemimeral
Παλλὰς Ἀθηναίη, κούρη Διὸς αἰγιόχοιο,	-u u--- -- uu -uu--	dactylic hexameter	masculine penthemimeral, hepthemimeral
Μέντορι εἰδομένη ἠμὲν δέμας ἠδὲ καὶ αὐδήν.	-uu -uu- -- uu -u u --	dactylic hexameter	masculine penthemimeral, hepthemimeral
