τὼ δ’αὖτ’ ἐν κλισίῃ Ὀδυσεὺς καὶ δῖος ὑφορβὸς	- - - uu- uu- - -u u--	dactylic hexameter	masculine penthemimeral, hepthemimeral, trithemimeral
ἐντύνοντ’ ἄριστον ἅμ’ ἠοῖ, κειαμένω πῦρ,	--- --u u -- -uu- -	dactylic hexameter	feminine penthemimeral, trithemimeral
ἔκπεμψάν τε νομῆας ἅμ’ ἀγρομένοισι σύεσσι·	--- u u-u u -uu-u u--	dactylic hexameter	feminine penthemimeral, trithemimeral
Τηλέμαχον δὲ περίσσαινον κύνες ὑλακόμωροι,	-uu- u u--- uu -uu--	dactylic hexameter	hepthemimeral, trithemimeral
οὐδ’ ὕλαον προσιόντα. νόησε δὲ δῖος Ὀδυσσεὺς	- uu- uu-u u-u u -u u--	dactylic hexameter	feminine penthemimeral, trithemimeral
σαίνοντάς τε κύνας, περί τε κτύπος ἦλθε ποδοῖϊν.	--- u u- uu - uu -u u--	dactylic hexameter	masculine penthemimeral, hepthemimeral, trithemimeral
αἶψα δ’ἄρ’ Εὔμαιον ἔπεα πτερόεντα προσηύδα·	-u u --- uu- uu-u u--	dactylic hexameter	masculine penthemimeral, hepthemimeral
Εὔμαι’, ἦ μάλα τίς τοι ἐλεύσεται ἐνθάδ’ ἑταῖρος	-- - uu - u u-uu -u u--	dactylic hexameter	masculine penthemimeral, trithemimeral
ἢ καὶ γνώριμος ἄλλος, ἐπεὶ κύνες οὐχ ὑλάουσιν,	- - -uu -u u- uu - uu--	dactylic hexameter	feminine penthemimeral, hepthemimeral
ἀλλὰ περισσαίνουσι· ποδῶν δ’ὑπὸ δοῦπον ἀκούω.	-u u---u u- uu -u u--	dactylic hexameter	feminine penthemimeral, hepthemimeral
οὔ πω πᾶν εἴρητο ἔπος, ὅτε οἱ φίλος υἱὸς	- - - --u u- uu - uu --	dactylic hexameter	feminine penthemimeral, hepthemimeral, trithemimeral
ἔστη ἐνὶ προθύροισι. ταφὼν δ’ἀνόρουσε συβώτης,	-u u- uu-u u- uu-u u--	dactylic hexameter	feminine penthemimeral, hepthemimeral, trithemimeral
ἐκ δ’ἄρα οἱ χειρῶν πέσεν ἄγγεα, τοῖς ἐπονεῖτο,	- uu - -- uu -uu - uu--	dactylic hexameter	masculine penthemimeral, trithemimeral
κιρνὰς αἴθοπα οἶνον. ὁ δ’ἀντίος ἤλυθ’ ἄνακτος,	-- -uu -u u -uu -u u--	dactylic hexameter	feminine penthemimeral
κύσσε δέ μιν κεφαλήν τε καὶ ἄμφω φάεα καλὰ	-u u - uu- u u -- -uu --	dactylic hexameter	masculine penthemimeral, trithemimeral
χεῖράς τ’ἀμφοτέρας· θαλερὸν δέ οἱ ἔκπεσε δάκρυ.	-- -uu- uu- u u -uu --	dactylic hexameter	masculine penthemimeral, hepthemimeral
ὡς δὲ πατὴρ ὃν παῖδα φίλα φρονέων ἀγαπάζῃ	- u u- - -u u- uu- uu--	dactylic hexameter	feminine penthemimeral, hepthemimeral, trithemimeral
ἐλθόντ’ ἐξ ἀπίης γαίης δεκάτῳ ἐνιαυτῷ,	-- - uu- -- uu- uu--	dactylic hexameter	masculine penthemimeral, hepthemimeral, trithemimeral
μοῦνον τηλύγετον, τῷ ἔπ’ ἄλγεα πολλὰ μογήσῃ,	-- -uu- u u -uu -u u--	dactylic hexameter	masculine penthemimeral
ὣς τότε Τηλέμαχον θεοειδέα δῖος ὑφορβὸς	- uu -uu- uu-uu -u u--	dactylic hexameter	masculine penthemimeral
πάντα κύσεν περιφύς, ὡς ἐκ θανάτοιο φυγόντα·	-u u- uu- - - uu-u u--	dactylic hexameter	masculine penthemimeral, hepthemimeral, trithemimeral
καί ῥ’ὀλοφυρόμενος ἔπεα πτερόεντα προσηύδα·	- uu-uu- uu- uu-u u--	dactylic hexameter	masculine penthemimeral, hepthemimeral
ἦλθες, Τηλέμαχε, γλυκερὸν φάος. οὔ σ’ἔτ’ ἔγωγε	-- -uu- uu- uu - u u--	dactylic hexameter	masculine penthemimeral, hepthemimeral
ὄψεσθαι ἐφάμην, ἐπεὶ ᾤχεο νηῒ Πύλονδε.	--- uu- uu -uu -u u--	dactylic hexameter	masculine penthemimeral, trithemimeral
ἀλλ’ ἄγε νῦν εἴσελθε, φίλον τέκος, ὄφρα σε θυμῷ	- uu - --u u- uu -u u --	dactylic hexameter	feminine penthemimeral, hepthemimeral, trithemimeral
τέρψομαι εἰσορόων νέον ἄλλοθεν ἔνδον ἐόντα.	-uu -uu- uu -uu -u u--	dactylic hexameter	masculine penthemimeral
οὐ μὲν γάρ τι θάμ’ ἀγρὸν ἐπέρχεαι οὐδὲ νομῆας,	- - - u u -u u-uu -u u--	dactylic hexameter	feminine penthemimeral, trithemimeral
ἀλλ’ ἐπιδημεύεις· ὣς γάρ νύ τοι εὔαδε θυμῷ,	- uu--- - - u u -uu --	dactylic hexameter	masculine penthemimeral, hepthemimeral
ἀνδρῶν μνηστήρων ἐσορᾶν ἀΐδηλον ὅμιλον.	-- --- uu- uu-u u--	dactylic hexameter	masculine penthemimeral, hepthemimeral
τὸν δ’αὖ Τηλέμαχος πεπνυμένος ἀντίον ηὔδα·	- - -uu- --uu -uu --	dactylic hexameter	masculine penthemimeral
ἔσσεται οὕτως, ἄττα· σέθεν δ’ἕνεκ’ ἐνθάδ’ ἱκάνω,	-uu -- -u u- uu -u u--	dactylic hexameter	feminine penthemimeral, hepthemimeral
ὄφρα σέ τ’ὀφθαλμοῖσιν ἴδω καὶ μῦθον ἀκούσω,	-u u ---u u- - -u u--	dactylic hexameter	feminine penthemimeral, hepthemimeral
εἴ μοι ἔτ’ ἐν μεγάροις μήτηρ μένει, ἦέ τις ἤδη	- u u - uu- -- uu -u u --	dactylic hexameter	masculine penthemimeral, hepthemimeral, trithemimeral
ἀνδρῶν ἄλλος ἔγημεν, Ὀδυσσῆος δέ που εὐνὴ	-- -u u-u u--- u u --	dactylic hexameter	feminine penthemimeral
χήτει ἐνευναίων κάκ’ ἀράχνια κεῖται ἔχουσα.	-u u--- u u-uu -u u--	dactylic hexameter	masculine penthemimeral
τὸν δ’αὖτε προσέειπε συβώτης, ὄρχαμος ἀνδρῶν·	- -- uu-u u-- -uu --	dactylic hexameter	feminine penthemimeral, trithemimeral
καὶ λίην κείνη γε μένει τετληότι θυμῷ	- -- -- u u- --uu --	dactylic hexameter	masculine penthemimeral, hepthemimeral, trithemimeral
σοῖσιν ἐνὶ μεγάροισιν· ὀϊζυραὶ δέ οἱ αἰεὶ	-u u- uu-u u--- u u --	dactylic hexameter	feminine penthemimeral, trithemimeral
φθίνουσιν νύκτες τε καὶ ἤματα δάκρυ χεούσῃ.	--- -- u u -uu -u u--	dactylic hexameter	masculine penthemimeral, trithemimeral
ὣς ἄρα φωνήσας οἱ ἐδέξατο χάλκεον ἔγχος·	- uu --- u u-uu -uu --	dactylic hexameter	masculine penthemimeral
αὐτὰρ ὅ γ’εἴσω ἴεν καὶ ὑπέρβη λάϊνον οὐδόν.	-u u -u u- u u-- -uu --	dactylic hexameter	masculine penthemimeral
τῷ δ’ἕδρης ἐπιόντι πατὴρ ὑπόειξεν Ὀδυσσεύς·	- -- uu-u u- uu-u u--	dactylic hexameter	feminine penthemimeral, hepthemimeral, trithemimeral
Τηλέμαχος δ’ἑτέρωθεν ἐρήτυε φώνησέν τε·	-uu- uu-u u-uu --- -	dactylic hexameter	feminine penthemimeral, trithemimeral
ἧσο, ξεῖν’· ἡμεῖς δὲ καὶ ἄλλοθι δήομεν ἕδρην	-- - -- u u -uu -uu --	dactylic hexameter	masculine penthemimeral, trithemimeral
σταθμῷ ἐν ἡμετέρῳ· πάρα δ’ἀνὴρ ὃς καταθήσει.	-u u -uu- uu -- - uu--	dactylic hexameter	masculine penthemimeral
ὣς φάθ’, ὁ δ’αὖτις ἰὼν κατ’ ἄρ’ ἕζετο· τῷ δὲ συβώτης.	- u u -u u- u u -uu - u u--	dactylic hexameter	masculine penthemimeral
χεῦεν ὕπο χλωρὰς ῥῶπας καὶ κῶας ὕπερθεν·	-u u- -- -- - -u u--	dactylic hexameter	masculine penthemimeral, hepthemimeral, trithemimeral
ἔνθα καθέζετ’ ἔπειτα Ὀδυσσῆος φίλος υἱός.	-u u-u u-u u--- uu --	dactylic hexameter	feminine penthemimeral
τοῖσιν δὲ κρειῶν πίνακας παρέθηκε συβώτης	-- - -- uu- uu-u u--	dactylic hexameter	masculine penthemimeral, hepthemimeral, trithemimeral
ὀπταλέων, ἅ ῥα τῇ προτέρῃ ὑπέλειπον ἔδοντες,	-uu- u u - uu- uu-u u--	dactylic hexameter	masculine penthemimeral, hepthemimeral, trithemimeral
σῖτον δ’ἐσσυμένως παρενήνεεν ἐν κανέοισιν,	-- -uu- uu-uu - uu--	dactylic hexameter	masculine penthemimeral
ἐν δ’ἄρα κισσυβίῳ κίρνη μελιηδέα οἶνον·	- uu -uu- -- uu-uu --	dactylic hexameter	masculine penthemimeral, hepthemimeral
αὐτὸς δ’ἀντίον ἷζεν Ὀδυσσῆος θείοιο.	-- -uu -u u--- ---	dactylic hexameter	feminine penthemimeral
οἱ δ’ἐπ’ ὀνείαθ’ ἑτοῖμα προκείμενα χεῖρας ἴαλλον.	- u u-u u-u u-uu -u u--	dactylic hexameter	feminine penthemimeral
αὐτὰρ ἐπεὶ πόσιος καὶ ἐδητύος ἐξ ἔρον ἕντο,	-u u- uu- u u-uu - uu --	dactylic hexameter	masculine penthemimeral, trithemimeral
δὴ τότε Τηλέμαχος προσεφώνεε δῖον ὑφορβόν·	- uu -uu- uu-uu -u u--	dactylic hexameter	masculine penthemimeral
ἄττα, πόθεν τοι ξεῖνος ὅδ’ ἵκετο; πῶς δέ ἑ ναῦται	-u u- - -u u -uu - u u --	dactylic hexameter	feminine penthemimeral, trithemimeral
ἤγαγον εἰς Ἰθάκην; τίνες ἔμμεναι εὐχετόωντο;	-uu - uu- uu -uu -uu--	dactylic hexameter	masculine penthemimeral, trithemimeral
οὐ μὲν γάρ τί ἑ πεζὸν ὀΐομαι ἐνθάδ’ ἱκέσθαι.	- - - u u -u u-uu -u u--	dactylic hexameter	feminine penthemimeral, trithemimeral
τὸν δ’ἀπαμειβόμενος προσέφης, Εὔμαιε συβῶτα·	- uu-uu- uu- --u u--	dactylic hexameter	masculine penthemimeral, hepthemimeral
τοιγὰρ ἐγώ τοι, τέκνον, ἀληθέα πάντ’ ἀγορεύσω.	-u u- - -u u-uu - uu--	dactylic hexameter	feminine penthemimeral, trithemimeral
ἐκ μὲν Κρητάων γένος εὔχεται εὐρειάων,	- - --- uu -uu ----	dactylic hexameter	masculine penthemimeral
φησὶ δὲ πολλὰ βροτῶν ἐπὶ ἄστεα δινηθῆναι	-u u -u u- uu -uu ----	dactylic hexameter	masculine penthemimeral
πλαζόμενος· ὣς γάρ οἱ ἐπέκλωσεν τά γε δαίμων.	-uu- - - u u--- u u --	dactylic hexameter	masculine penthemimeral, trithemimeral
νῦν αὖ Θεσπρωτῶν ἀνδρῶν παρὰ νηὸς ἀποδρὰς	- - --- -- uu -u u--	dactylic hexameter	masculine penthemimeral, hepthemimeral
ἤλυθ’ ἐμὸν πρὸς σταθμόν, ἐγὼ δέ τοι ἐγγυαλίξω·	-u u- - -u u- u u -uu--	dactylic hexameter	feminine penthemimeral, hepthemimeral, trithemimeral
ἔρξον ὅπως ἐθέλεις· ἱκέτης δέ τοι εὔχεται εἶναι.	-u u- uu- uu- u u -uu --	dactylic hexameter	masculine penthemimeral, hepthemimeral, trithemimeral
τὸν δ’αὖ Τηλέμαχος πεπνυμένος ἀντίον ηὔδα·	- - -uu- --uu -uu --	dactylic hexameter	masculine penthemimeral
Εὔμαι’, ἦ μάλα τοῦτο ἔπος θυμαλγὲς ἔειπες·	-- - uu -u u- --u u--	dactylic hexameter	feminine penthemimeral, hepthemimeral, trithemimeral
πῶς γὰρ δὴ τὸν ξεῖνον ἐγὼν ὑποδέξομαι οἴκῳ;	- - - - -u u- uu-uu --	dactylic hexameter	feminine penthemimeral, hepthemimeral, trithemimeral
αὐτὸς μὲν νέος εἰμὶ καὶ οὔ πω χερσὶ πέποιθα	-- - uu -u u - - -u u--	dactylic hexameter	feminine penthemimeral, hepthemimeral, trithemimeral
ἄνδρ’ ἀπαμύνασθαι, ὅτε τις πρότερος χαλεπήνῃ·	- uu--- uu - uu- uu--	dactylic hexameter	masculine penthemimeral, hepthemimeral
μητρὶ δ’ἐμῇ δίχα θυμὸς ἐνὶ φρεσὶ μερμηρίζει,	-u u- uu -u u- uu ----	dactylic hexameter	feminine penthemimeral, hepthemimeral, trithemimeral
ἢ αὐτοῦ παρ’ ἐμοί τε μένῃ καὶ δῶμα κομίζῃ,	- -- u u- u u- - -u u--	dactylic hexameter	masculine penthemimeral, hepthemimeral, trithemimeral
εὐνήν τ’αἰδομένη πόσιος δήμοιό τε φῆμιν,	-- -uu- uu- --u u --	dactylic hexameter	masculine penthemimeral, hepthemimeral
ἦ ἤδη ἅμ’ ἕπηται Ἀχαιῶν ὅς τις ἄριστος	- -- u u-u u-- - u u--	dactylic hexameter	feminine penthemimeral, trithemimeral
μνᾶται ἐνὶ μεγάροισιν ἀνὴρ καὶ πλεῖστα πόρῃσιν.	-u u- uu-u u- - -u u--	dactylic hexameter	feminine penthemimeral, hepthemimeral, trithemimeral
ἀλλ’ ἤτοι τὸν ξεῖνον, ἐπεὶ τεὸν ἵκετο δῶμα,	- -- - -u u- uu -uu --	dactylic hexameter	feminine penthemimeral, hepthemimeral, trithemimeral
ἕσσω μιν χλαῖνάν τε χιτῶνά τε, εἵματα καλά,	-- - -- u u-u u -uu --	dactylic hexameter	masculine penthemimeral, trithemimeral
δώσω δὲ ξίφος ἄμφηκες καὶ ποσσὶ πέδιλα,	-- - uu --- - -u u--	dactylic hexameter	hepthemimeral, trithemimeral
πέμψω δ’ὅππῃ μιν κραδίη θυμός τε κελεύει.	-- -- - uu- -- u u--	dactylic hexameter	masculine penthemimeral, hepthemimeral
εἰ δ’ἐθέλεις, σὺ κόμισσον ἐνὶ σταθμοῖσιν ἐρύξας·	- uu- u u-u u- --u u--	dactylic hexameter	feminine penthemimeral, hepthemimeral, trithemimeral
εἵματα δ’ἐνθάδ’ ἐγὼ πέμψω καὶ σῖτον ἅπαντα	-uu -u u- -- - -u u--	dactylic hexameter	masculine penthemimeral, hepthemimeral
ἔδμεναι, ὡς ἂν μή σε κατατρύχῃ καὶ ἑταίρους.	-uu - - - u u--- u u--	dactylic hexameter	masculine penthemimeral, trithemimeral
κεῖσε δ’ἂν οὔ μιν ἔγωγε μετὰ μνηστῆρας ἐῷμι	-u u - u u-u u- --u u--	dactylic hexameter	feminine penthemimeral, hepthemimeral, trithemimeral
ἔρχεσθαι· λίην γὰρ ἀτάσθαλον ὕβριν ἔχουσι·	--- -- u u-uu -u u--	dactylic hexameter	masculine penthemimeral, trithemimeral
μή μιν κερτομέωσιν, ἐμοὶ δ’ἄχος ἔσσεται αἰνόν.	- - -uu-u u- uu -uu --	dactylic hexameter	feminine penthemimeral, hepthemimeral
πρῆξαι δ’ἀργαλέον τι μετὰ πλεόνεσσιν ἐόντα	-- -uu- u u- uu-u u--	dactylic hexameter	masculine penthemimeral, hepthemimeral
ἄνδρα καὶ ἴφθιμον, ἐπεὶ ἦ πολὺ φέρτεροί εἰσι.	-u u --- uu - uu -uu --	dactylic hexameter	masculine penthemimeral, hepthemimeral
τὸν δ’αὖτε προσέειπε πολύτλας δῖος Ὀδυσσεύς·	- -- uu-u u-- -u u--	dactylic hexameter	feminine penthemimeral, trithemimeral
ὧ φίλ’, ἐπεί θήν μοι καὶ ἀμείψασθαι θέμις ἐστίν,	- u u- - - u u--- uu --	dactylic hexameter	masculine penthemimeral, trithemimeral
ἦ μάλα μευ καταδάπτετ’ ἀκούοντος φίλον ἦτορ,	- uu - uu-u u--- uu --	dactylic hexameter	feminine penthemimeral, trithemimeral
οἷά φατε μνηστῆρας ἀτάσθαλα μηχανάασθαι	-u u- --u u-uu -uu--	dactylic hexameter	feminine penthemimeral, trithemimeral
ἐν μεγάροις, ἀέκητι σέθεν τοιούτου ἐόντος.	- uu- uu-u u- --u u--	dactylic hexameter	feminine penthemimeral, hepthemimeral, trithemimeral
εἰπέ μοι ἠὲ ἑκὼν ὑποδάμνασαι, ἦ σέ γε λαοὶ	-u u -u u- uu-uu - u u --	dactylic hexameter	masculine penthemimeral
ἐχθαίρουσ’ ἀνὰ δῆμον, ἐπισπόμενοι θεοῦ ὀμφῇ,	--- uu -u u-uu- uu --	dactylic hexameter	feminine penthemimeral, trithemimeral
ἦ τι κασιγνήτοις ἐπιμέμφεαι, οἷσί περ ἀνὴρ	- u u--- uu-uu -u u --	dactylic hexameter	masculine penthemimeral
μαρναμένοισι πέποιθε, καὶ εἰ μέγα νεῖκος ὄρηται.	-uu-u u-u u - uu -u u--	dactylic hexameter	feminine penthemimeral, hepthemimeral
αἲ γάρ ἐγὼν οὕτω νέος εἴην τῷδ’ ἐπὶ θυμῷ,	- u u- -- uu -- - uu --	dactylic hexameter	masculine penthemimeral, trithemimeral
ἢ παῖς ἐξ Ὀδυσῆος ἀμύμονος ἠὲ καὶ αὐτός·	- - - uu-u u-uu -u u --	dactylic hexameter	feminine penthemimeral, trithemimeral
ἔλθοι ἀλητεύων ἔτι γὰρ καὶ ἐλπίδος αἶσα·	-u u--- uu - - -uu --	dactylic hexameter	masculine penthemimeral, hepthemimeral
αὐτίκ’ ἔπειτ’ ἀπ’ ἐμεῖο κάρη τάμοι ἀλλότριος φώς,	-u u- u u-u u- uu -uu- -	dactylic hexameter	feminine penthemimeral, hepthemimeral, trithemimeral
εἰ μὴ ἐγὼ κείνοισι κακὸν πάντεσσι γενοίμην,	- u u- --u u- --u u--	dactylic hexameter	feminine penthemimeral, hepthemimeral, trithemimeral
ἐλθὼν ἐς μέγαρον Λαερτιάδεω Ὀδυσῆος.	-- - uu- --uu- uu--	dactylic hexameter	masculine penthemimeral, trithemimeral
εἰ δ’αὖ με πληθυῖ δαμασαίατο μοῦνον ἐόντα,	- - - -- uu-uu -u u--	dactylic hexameter	masculine penthemimeral, trithemimeral
βουλοίμην κ’ἐν ἐμοῖσι κατακτάμενος μεγάροισι	--- u u-u u-uu- uu--	dactylic hexameter	feminine penthemimeral, trithemimeral
τεθνάμεν ἢ τάδε γ’αἰὲν ἀεικέα ἔργ’ ὁράασθαι,	-uu - uu -u u-uu - uu--	dactylic hexameter	feminine penthemimeral, trithemimeral
ξείνους τε στυφελιζομένους δμῳάς τε γυναῖκας	-- - uu-uu- -- u u--	dactylic hexameter	hepthemimeral, trithemimeral
ῥυστάζοντας ἀεικελίως κατὰ δώματα καλά,	---u u-uu- uu -uu --	dactylic hexameter	hepthemimeral
καὶ οἶνον διαφυσσόμενον, καὶ σῖτον ἔδοντας	- -- uu-uu- - -u u--	dactylic hexameter	hepthemimeral, trithemimeral
μὰψ αὔτως, ἀτέλεστον, ἀνηνύστῳ ἐπὶ ἔργῳ.	- -- uu-u u--- uu --	dactylic hexameter	feminine penthemimeral, trithemimeral
τὸν δ’αὖ Τηλέμαχος πεπνυμένος ἀντίον ηὔδα·	- - -uu- --uu -uu --	dactylic hexameter	masculine penthemimeral
τοιγὰρ ἐγώ τοι, ξεῖνε, μάλ’ ἀτρεκέως ἀγορεύσω.	-u u- - -u u -uu- uu--	dactylic hexameter	feminine penthemimeral, trithemimeral
οὔτε τί μοι πᾶς δῆμος ἀπεχθόμενος χαλεπαίνει,	-u u - - -u u-uu- uu--	dactylic hexameter	feminine penthemimeral, trithemimeral
οὔτε κασιγνήτοις ἐπιμέμφομαι, οἷσί περ ἀνὴρ	-u u--- uu-uu -u u --	dactylic hexameter	masculine penthemimeral
μαρναμένοισι πέποιθε, καὶ εἰ μέγα νεῖκος ὄρηται.	-uu-u u-u u - uu -u u--	dactylic hexameter	feminine penthemimeral, hepthemimeral
ὦδε γὰρ ἡμετέρην γενεὴν μούνωσε Κρονίων·	-u u -uu- uu- --u u--	dactylic hexameter	masculine penthemimeral, hepthemimeral
μοῦνον Λαέρτην Ἀρκείσιος υἱὸν ἔτικτε,	-- --- --uu -u u--	dactylic hexameter	masculine penthemimeral
μοῦνον δ’αὖτ’ Ὀδυσῆα πατὴρ τέκεν· αὐτὰρ Ὀδυσσεὺς	-- - uu-u u- uu -u u--	dactylic hexameter	feminine penthemimeral, hepthemimeral, trithemimeral
μοῦνον ἔμ’ ἐν μεγάροισι τεκὼν λίπεν οὐδ’ ἀπόνητο.	-u u - uu-u u- uu - uu--	dactylic hexameter	feminine penthemimeral, hepthemimeral, trithemimeral
τῶ νῦν δυσμενέες μάλα μυρίοι εἴσ’ ἐνὶ οἴκῳ.	- - -uu- uu -uu - uu --	dactylic hexameter	masculine penthemimeral
ὅσσοι γὰρ νήσοισιν ἐπικρατέουσιν ἄριστοι,	-- - --u u-uu-u u--	dactylic hexameter	feminine penthemimeral, trithemimeral
Δουλιχίῳ τε Σάμῃ τε καὶ ὑλήεντι Ζακύνθῳ,	-uu- u u- u u ---u u--	dactylic hexameter	masculine penthemimeral, trithemimeral
ἠδ’ ὅσσοι κραναὴν Ἰθάκην κάτα κοιρανέουσι,	- -- uu- uu- uu -uu--	dactylic hexameter	masculine penthemimeral, hepthemimeral, trithemimeral
τόσσοι μητέρ’ ἐμὴν μνῶνται, τρύχουσι δὲ οἶκον.	-- -u u- -- --u u --	dactylic hexameter	masculine penthemimeral, hepthemimeral
ἡ δ’οὔτ’ ἀρνεῖται στυγερὸν γάμον οὔτε τελευτὴν	- - --- uu- uu -u u--	dactylic hexameter	masculine penthemimeral, hepthemimeral
ποιῆσαι δύναται· τοὶ δὲ φθινύθουσιν ἔδοντες	--- uu- - - uu-u u--	dactylic hexameter	masculine penthemimeral, hepthemimeral, trithemimeral
οἶκον ἐμόν· τάχα δή με διαρραίσουσι καὶ αὐτόν.	-u u- uu - u u---u u --	dactylic hexameter	masculine penthemimeral, trithemimeral
ἀλλ’ ἤτοι μὲν ταῦτα θεῶν ἐν γούνασι κεῖται·	- -- - -u u- - -uu --	dactylic hexameter	feminine penthemimeral, hepthemimeral, trithemimeral
ἄττα, σὺ δ’ἔρχεο θᾶσσον, ἐχέφρονι Πηνελοπείῃ	-u u -uu -u u-uu -uu--	dactylic hexameter	feminine penthemimeral
εἴφ’ ὅτι οἱ σῶς εἰμὶ καὶ ἐκ Πύλου εἰλήλουθα.	- uu - - -u u - uu ----	dactylic hexameter	feminine penthemimeral, hepthemimeral, trithemimeral
αὐτὰρ ἐγὼν αὐτοῦ μενέω, σὺ δὲ δεῦρο νέεσθαι,	-u u- -- uu- u u -u u--	dactylic hexameter	masculine penthemimeral, hepthemimeral, trithemimeral
οἴῃ ἀπαγγείλας· τῶν δ’ἄλλων μή τις Ἀχαιῶν	-u u--- - -- - u u--	dactylic hexameter	masculine penthemimeral
πευθέσθω· πολλοὶ γὰρ ἐμοὶ κακὰ μηχανόωνται.	--- -- u u- uu -uu--	dactylic hexameter	masculine penthemimeral, hepthemimeral, trithemimeral
τὸν δ’ἀπαμειβόμενος προσέφης, Εὔμαιε συβῶτα·	- uu-uu- uu- --u u--	dactylic hexameter	masculine penthemimeral, hepthemimeral
γινώσκω, φρονέω· τά γε δὴ νοέοντι κελεύεις.	--- uu- u u - uu-u u--	dactylic hexameter	masculine penthemimeral, hepthemimeral, trithemimeral
ἀλλ’ ἄγε μοι τόδε εἰπὲ καὶ ἀτρεκέως κατάλεξον,	- uu - uu -u u -uu- uu--	dactylic hexameter	feminine penthemimeral, trithemimeral
εἰ καὶ Λαέρτῃ αὐτὴν ὁδὸν ἄγγελος ἔλθω	- - --- -- uu -uu --	dactylic hexameter	masculine penthemimeral, hepthemimeral
δυσμόρῳ, ὃς τείως μὲν Ὀδυσσῆος μέγ’ ἀχεύων	-uu - -- u u--- u u--	dactylic hexameter	masculine penthemimeral, trithemimeral
ἔργα τ’ἐποπτεύεσκε μετὰ δμώων τ’ἐνὶ οἴκῳ	-u u---u u- -- uu --	dactylic hexameter	feminine penthemimeral, hepthemimeral
πῖνε καὶ ἦσθ’, ὅτε θυμὸς ἐνὶ στήθεσσιν ἀνώγοι·	-u u - uu -u u- --u u--	dactylic hexameter	feminine penthemimeral, hepthemimeral, trithemimeral
αὐτὰρ νῦν, ἐξ οὗ σύ γε ᾤχεο νηῒ Πύλονδε,	-- - - - u u -uu -u u--	dactylic hexameter	masculine penthemimeral, trithemimeral
οὔ πω μίν φασιν φαγέμεν καὶ πιέμεν αὔτως,	- - - -- uu- - -uu --	dactylic hexameter	masculine penthemimeral, hepthemimeral, trithemimeral
οὐδ’ ἐπὶ ἔργα ἰδεῖν, ἀλλὰ στοναχῇ τε γόῳ τε	- uu -u u- -- uu- u u- -	dactylic hexameter	masculine penthemimeral, hepthemimeral
ἧσται ὀδυρόμενος, φθινύθει δ’ἀμφ’ ὀστεόφιν χρώς.	-u u-uu- uu- - -uu- -	dactylic hexameter	masculine penthemimeral, hepthemimeral
τὸν δ’αὖ Τηλέμαχος πεπνυμένος ἀντίον ηὔδα·	- - -uu- --uu -uu --	dactylic hexameter	masculine penthemimeral
ἄλγιον, ἀλλ’ ἔμπης μιν ἐάσομεν, ἀχνύμενοί περ·	-uu - -- u u-uu -uu- -	dactylic hexameter	masculine penthemimeral, trithemimeral
εἰ γὰρ πως εἴη αὐτάγρετα πάντα βροτοῖσι,	- - - -- --uu -u u--	dactylic hexameter	masculine penthemimeral, trithemimeral
πρῶτόν κεν τοῦ πατρὸς ἑλοίμεθα νόστιμον ἦμαρ.	-- - - -u u-uu -uu --	dactylic hexameter	feminine penthemimeral, trithemimeral
ἀλλὰ σύ γ’ἀγγείλας ὀπίσω κίε, μηδὲ κατ’ ἀγροὺς	-u u --- uu- uu -u u --	dactylic hexameter	masculine penthemimeral, hepthemimeral
πλάζεσθαι μετ’ ἐκεῖνον· ἀτὰρ πρὸς μητέρα εἰπεῖν	--- u u-u u- - -uu --	dactylic hexameter	feminine penthemimeral, hepthemimeral, trithemimeral
ἀμφίπολον ταμίην ὀτρυνέμεν ὅττι τάχιστα	-uu- uu- --uu -u u--	dactylic hexameter	masculine penthemimeral, trithemimeral
κρύβδην· κείνη γὰρ κεν ἀπαγγείλειε γέροντι.	-- -- - u u---u u--	dactylic hexameter	masculine penthemimeral
ἦ ῥα καὶ ὧρσε συφορβόν· ὁ δ’εἵλετο χερσὶ πέδιλα,	- u u -u u-u u -uu -u u--	dactylic hexameter	feminine penthemimeral
δησάμενος δ’ὑπὸ ποσσὶ πόλινδ’ ἴεν. οὐδ’ ἄρ’ Ἀθήνην	-uu- uu -u u- uu - u u--	dactylic hexameter	feminine penthemimeral, hepthemimeral, trithemimeral
λῆθεν ἀπὸ σταθμοῖο κιὼν Εὔμαιος ὑφορβός,	-u u- --u u- --u u--	dactylic hexameter	feminine penthemimeral, hepthemimeral, trithemimeral
ἀλλ’ ἥ γε σχεδὸν ἦλθε· δέμας δ’ἤϊκτο γυναικὶ	- - - uu -u u- --u u--	dactylic hexameter	feminine penthemimeral, hepthemimeral, trithemimeral
καλῇ τε μεγάλῃ τε καὶ ἀγλαὰ ἔργ’ εἰδυίῃ.	-- - uu- u u -uu - ---	dactylic hexameter	masculine penthemimeral, trithemimeral
στῆ δὲ κατ’ ἀντίθυρον κλισίης Ὀδυσῆϊ φανεῖσα·	- u u -uu- uu- uu-u u--	dactylic hexameter	masculine penthemimeral, hepthemimeral
οὐδ’ ἄρα Τηλέμαχος ἴδεν ἀντίον οὐδ’ ἐνόησεν,	- uu -uu- uu -uu - uu--	dactylic hexameter	masculine penthemimeral
οὐ γὰρ πως πάντεσσι θεοὶ φαίνονται ἐναργεῖς,	- - - --u u- --u u--	dactylic hexameter	feminine penthemimeral, hepthemimeral, trithemimeral
ἀλλ’ Ὀδυσεύς τε κύνες τε ἴδον, καί ῥ’οὐχ ὑλάοντο	- uu- u u- u u- - - uu--	dactylic hexameter	masculine penthemimeral, hepthemimeral, trithemimeral
κνυζηθμῷ δ’ἑτέρωσε διὰ σταθμοῖο φόβηθεν.	--- uu-u u- --u u--	dactylic hexameter	feminine penthemimeral, hepthemimeral, trithemimeral
ἡ δ’ἄρ’ ἐπ’ ὀφρύσι νεῦσε· νόησε δὲ δῖος Ὀδυσσεύς,	- u u -uu -u u-u u -u u--	dactylic hexameter	feminine penthemimeral
ἐκ δ’ἦλθεν μεγάροιο παρὲκ μέγα τειχίον αὐλῆς,	- -- uu-u u- uu -uu --	dactylic hexameter	feminine penthemimeral, hepthemimeral, trithemimeral
στῆ δὲ πάροιθ’ αὐτῆς· τὸν δὲ προσέειπεν Ἀθήνη·	- u u- -- - - uu-u u--	dactylic hexameter	masculine penthemimeral, hepthemimeral, trithemimeral
διογενὲς Λαερτιάδη, πολυμήχαν’ Ὀδυσσεῦ.	-uu- --uu- uu-u u--	dactylic hexameter	hepthemimeral, trithemimeral
ἤδη νῦν σῷ παιδὶ ἔπος φάο μηδ’ ἐπίκευθε,	-- - - -u u- uu - uu--	dactylic hexameter	feminine penthemimeral, hepthemimeral, trithemimeral
ὡς ἄν μνηστῆρσιν θάνατον καὶ κῆρ’ ἀραρόντε	- - --- uu- - - uu--	dactylic hexameter	masculine penthemimeral, hepthemimeral
ἔρχησθον προτὶ ἄστυ περικλυτόν· οὐδ’ ἐγὼ αὐτὴ	--- uu -u u-uu - uu --	dactylic hexameter	feminine penthemimeral, trithemimeral
δηρὸν ἀπὸ σφῶϊν ἔσομαι μεμαυῖα μάχεσθαι.	-u u- -- uu- uu-u u--	dactylic hexameter	masculine penthemimeral, hepthemimeral, trithemimeral
ἦ καὶ χρυσείῃ ῥάβδῳ ἐπεμάσσατ’ Ἀθήνη.	- - --- -- uu-u u--	dactylic hexameter	masculine penthemimeral, hepthemimeral
φᾶρος μέν οἱ πρῶτον ἐϋπλυνὲς ἠδὲ χιτῶνα	-- - - -u u-uu -u u--	dactylic hexameter	feminine penthemimeral, trithemimeral
θῆκ’ ἀμφὶ στήθεσφι, δέμας δ’ὤφελλε καὶ ἥβην.	- -- --u u- --u u --	dactylic hexameter	feminine penthemimeral, hepthemimeral, trithemimeral
ἂψ δὲ μελαγχροιὴς γένετο, γναθμοὶ δ’ἐτάνυσθεν,	- u u--- uu- -- uu--	dactylic hexameter	masculine penthemimeral, hepthemimeral
κυάνεαι δ’ἐγένοντο γενειάδες ἀμφὶ γένειον.	-uu- uu-u u-uu -u u--	dactylic hexameter	feminine penthemimeral, trithemimeral
ἡ μὲν ἄρ’ ὣς ἔρξασα πάλιν κίεν· αὐτὰρ Ὀδυσσεὺς	- u u - --u u- uu -u u--	dactylic hexameter	feminine penthemimeral, hepthemimeral, trithemimeral
ἤϊεν ἐς κλισίην· θάμβησε δέ μιν φίλος υἱός,	-uu - uu- --u u - uu --	dactylic hexameter	masculine penthemimeral, trithemimeral
ταρβήσας δ’ἑτέρωσε βάλ’ ὄμματα, μὴ θεὸς εἴη,	--- uu-u u -uu - uu --	dactylic hexameter	feminine penthemimeral, trithemimeral
καί μιν φωνήσας ἔπεα πτερόεντα προσηύδα·	- - --- uu- uu-u u--	dactylic hexameter	masculine penthemimeral, hepthemimeral
ἀλλοῖός μοι, ξεῖνε, φάνης νέον ἠὲ πάροιθεν,	--- - -u u- uu -u u--	dactylic hexameter	feminine penthemimeral, hepthemimeral, trithemimeral
ἄλλα δὲ εἵματ’ ἔχεις, καί τοι χρὼς οὐκέθ’ ὁμοῖος.	-u u -u u- - - - -u u--	dactylic hexameter	masculine penthemimeral, hepthemimeral
ἦ μάλα τις θεός ἐσσι, τοὶ οὐρανὸν εὐρὺν ἔχουσιν·	- uu - uu -u u -uu -u u--	dactylic hexameter	feminine penthemimeral, trithemimeral
ἀλλ’ ἵληθ’, ἵνα τοι κεχαρισμένα δώομεν ἱρὰ	- -- uu - uu-uu -uu --	dactylic hexameter	masculine penthemimeral, trithemimeral
ἠδὲ χρύσεα δῶρα, τετυγμένα· φείδεο δ’ἡμέων	-- -uu -u u-uu -uu --	dactylic hexameter	feminine penthemimeral
τὸν δ’ἠμείβετ’ ἔπειτα πολύτλας δῖος Ὀδυσσεύς·	- --u u-u u-- -u u--	dactylic hexameter	feminine penthemimeral
οὔ τίς τοι θεός εἰμι· τί μ’ἀθανάτοισιν ἐΐσκεις;	- - - uu -u u -uu-u u--	dactylic hexameter	feminine penthemimeral, trithemimeral
ἀλλὰ πατὴρ τεός εἰμι, τοῦ εἵνεκα σὺ στεναχίζων	-u u- uu -u u -uu - uu--	dactylic hexameter	feminine penthemimeral, trithemimeral
πάσχεις ἄλγεα πολλά, βίας ὑποδέγμενος ἀνδρῶν.	-- -uu -u u- uu-uu --	dactylic hexameter	feminine penthemimeral, hepthemimeral
ὣς ἄρα φωνήσας υἱὸν κύσε, κὰδ δὲ παρειῶν	- uu --- -- uu - u u--	dactylic hexameter	masculine penthemimeral, hepthemimeral
δάκρυον ἧκε χαμᾶζε· πάρος δ’ἔχε νωλεμὲς αἰεί.	-uu -u u-u u- uu -uu --	dactylic hexameter	feminine penthemimeral, hepthemimeral
Τηλέμαχος δ’, οὐ γάρ πω ἐπείθετο ὃν πατέρ’ εἶναι,	-uu- - - u u-uu - uu --	dactylic hexameter	masculine penthemimeral, trithemimeral
ἐξαῦτίς μιν ἔπεσσιν ἀμειβόμενος προσέειπεν·	--- u u-u u-uu- uu--	dactylic hexameter	feminine penthemimeral, trithemimeral
οὐ σύ γ’Ὀδυσσεύς ἐσσι, πατὴρ ἐμός, ἀλλά με δαίμων	- u u-- -u u- uu -u u --	dactylic hexameter	feminine penthemimeral, hepthemimeral
θέλγει, ὄφρ’ ἔτι μᾶλλον ὀδυρόμενος στεναχίζω.	-- - uu -u u-uu- uu--	dactylic hexameter	feminine penthemimeral, trithemimeral
οὐ γάρ πως ἂν θνητὸς ἀνὴρ τάδε μηχανόῳτο	- - - - -u u- uu -uu--	dactylic hexameter	feminine penthemimeral, hepthemimeral, trithemimeral
ᾧ αὐτοῦ γε νόῳ, ὅτε μὴ θεὸς αὐτὸς ἐπελθὼν	- -- u u- uu - uu -u u--	dactylic hexameter	masculine penthemimeral, hepthemimeral, trithemimeral
ῥηϊδίως ἐθέλων θείη νέον ἠὲ γέροντα.	-uu- uu- -- uu -u u--	dactylic hexameter	masculine penthemimeral, hepthemimeral, trithemimeral
ἦ γάρ τοι νέον ἦσθα γέρων καὶ ἀεικέα ἕσσο·	- - - uu -u u- u u-uu --	dactylic hexameter	feminine penthemimeral, hepthemimeral, trithemimeral
νῦν δὲ θεοῖσιν ἔοικας, οἳ οὐρανὸν εὐρὺν ἔχουσι.	- u u-u u-u u -uu -u u--	dactylic hexameter	feminine penthemimeral
τὸν δ’ἀπαμειβόμενος προσέφη πολύμητις Ὀδυσσεύς·	- uu-uu- uu- uu-u u--	dactylic hexameter	masculine penthemimeral, hepthemimeral
Τηλέμαχ’, οὔ σε ἔοικε φίλον πατέρ’ ἔνδον ἐόντα	-uu - u u-u u- uu -u u--	dactylic hexameter	feminine penthemimeral, hepthemimeral, trithemimeral
οὔτε τι θαυμάζειν περιώσιον οὔτ’ ἀγάασθαι·	-u u --- uu-uu - uu--	dactylic hexameter	masculine penthemimeral
οὐ μὲν γάρ τοι ἔτ’ ἄλλος ἐλεύσεται ἐνθάδ’ Ὀδυσσεύς,	- - - u u -u u-uu -u u--	dactylic hexameter	feminine penthemimeral, trithemimeral
ἀλλ’ ὅδ’ ἐγὼ τοιόσδε, παθὼν κακά, πολλὰ δ’ἀληθείς,	- u u- --u u- uu -u u--	dactylic hexameter	feminine penthemimeral, hepthemimeral, trithemimeral
ἤλυθον εἰκοστῷ ἔτεϊ ἐς πατρίδα γαῖαν.	-uu --- uu- - -uu --	dactylic hexameter	masculine penthemimeral, hepthemimeral
αὐτάρ τοι τόδε ἔργον Ἀθηναίης ἀγελείης,	-- - uu -u u--- uu--	dactylic hexameter	feminine penthemimeral, trithemimeral
ἥ τέ με τοῖον ἔθηκεν, ὅπως ἐθέλει, δύναται γὰρ,	- u u -u u-u u- uu- uu- -	dactylic hexameter	feminine penthemimeral, hepthemimeral
ἄλλοτε μὲν πτωχῷ ἐναλίγκιον, ἄλλοτε δ’αὖτε	-uu - -- uu-uu -uu --	dactylic hexameter	masculine penthemimeral, trithemimeral
ἀνδρὶ νέῳ καὶ καλὰ περὶ χροῒ εἵματ’ ἔχοντι.	-u u- - -u u- uu -u u--	dactylic hexameter	feminine penthemimeral, hepthemimeral, trithemimeral
ῥηΐδιον δὲ θεοῖσι, τοὶ οὐρανὸν εὐρὺν ἔχουσιν,	-uu- u u-u u -uu -u u--	dactylic hexameter	feminine penthemimeral, trithemimeral
ἠμὲν κυδῆναι θνητὸν βροτὸν ἠδὲ κακῶσαι.	-- --- -- uu -u u--	dactylic hexameter	masculine penthemimeral, hepthemimeral
ὣς ἄρα φωνήσας κατ’ ἄρ’ ἕζετο, Τηλέμαχος δὲ	- uu --- u u -uu -uu- -	dactylic hexameter	masculine penthemimeral
ἀμφιχυθεὶς πατέρ’ ἐσθλὸν ὀδύρετο, δάκρυα λείβων,	-uu- uu -u u-uu -uu --	dactylic hexameter	feminine penthemimeral, trithemimeral
ἀμφοτέροισι δὲ τοῖσιν ὑφ’ ἵμερος ὧρτο γόοιο·	-uu-u u -u u -uu -u u--	dactylic hexameter	feminine penthemimeral
κλαῖον δὲ λιγέως, ἀδινώτερον ἤ τ’οἰωνοί,	-- - uu- uu-uu - ---	dactylic hexameter	masculine penthemimeral, trithemimeral
φῆναι ἢ αἰγυπιοὶ γαμψώνυχες, οἷσί τε τέκνα	-u u -uu- --uu -u u --	dactylic hexameter	masculine penthemimeral
ἀγρόται ἐξείλοντο πάρος πετεηνὰ γενέσθαι·	-uu ---u u- uu-u u--	dactylic hexameter	feminine penthemimeral, hepthemimeral
ὣς ἄρα τοί γ’ἐλεεινὸν ὑπ’ ὀφρύσι δάκρυον εἶβον.	- uu - uu-u u -uu -uu --	dactylic hexameter	feminine penthemimeral, trithemimeral
καί νύ κ’ὀδυρομένοισιν ἔδυ φάος ἠελίοιο,	- u u-uu-u u- uu -uu--	dactylic hexameter	feminine penthemimeral, hepthemimeral
εἰ μὴ Τηλέμαχος προσεφώνεεν ὃν πατέρ’ αἶψα·	- - -uu- uu-uu - uu --	dactylic hexameter	masculine penthemimeral
ποίῃ γὰρ νῦν δεῦρο, πάτερ φίλε, νηΐ σε ναῦται	-- - - -u u- uu -u u --	dactylic hexameter	feminine penthemimeral, hepthemimeral, trithemimeral
ἤγαγον εἰς Ἰθάκην; τίνες ἔμμεναι εὐχετόωνται;	-uu - uu- uu -uu -uu--	dactylic hexameter	masculine penthemimeral, trithemimeral
οὐ μὲν γάρ τί σε πεζὸν ὀΐομαι ἐνθάδ’ ἱκέσθαι.	- - - u u -u u-uu -u u--	dactylic hexameter	feminine penthemimeral, trithemimeral
τὸν δ’αὖτε προσέειπε πολύτλας δῖος Ὀδυσσεύς·	- -- uu-u u-- -u u--	dactylic hexameter	feminine penthemimeral, trithemimeral
τοιγὰρ ἐγώ τοι, τέκνον, ἀληθείην καταλέξω.	-u u- - -u u--- uu--	dactylic hexameter	feminine penthemimeral, trithemimeral
Φαίηκές μ’ἄγαγον ναυσίκλυτοι, οἵ τε καὶ ἄλλους	--- uu- --uu - u u --	dactylic hexameter	masculine penthemimeral, trithemimeral
ἀνθρώπους πέμπουσιν, ὅτις σφέας εἰσαφίκηται·	--- --u u- uu -uu--	dactylic hexameter	feminine penthemimeral, hepthemimeral, trithemimeral
καί μ’εὕδοντ’ ἐν νηῒ θοῇ ἐπὶ πόντον ἄγοντες	- -- - -u u- uu -u u--	dactylic hexameter	feminine penthemimeral, hepthemimeral, trithemimeral
κάτθεσαν εἰς Ἰθάκην, ἔπορον δέ μοι ἀγλαὰ δῶρα,	-uu - uu- uu- u u -uu --	dactylic hexameter	masculine penthemimeral, hepthemimeral, trithemimeral
χαλκόν τε χρυσόν τε ἅλις ἐσθῆτά θ’ὑφαντήν.	-- - -- u u- --u u--	dactylic hexameter	masculine penthemimeral, hepthemimeral, trithemimeral
καὶ τὰ μὲν ἐν σπήεσσι θεῶν ἰότητι κέονται·	- u u - --u u- uu-u u--	dactylic hexameter	feminine penthemimeral, hepthemimeral, trithemimeral
νῦν αὖ δεῦρ’ ἱκόμην ὑποθημοσύνῃσιν Ἀθήνης,	- - - uu- uu-uu-u u--	dactylic hexameter	masculine penthemimeral, trithemimeral
ὄφρα κε δυσμενέεσσι φόνου πέρι βουλεύσωμεν.	-u u -uu-u u- uu ----	dactylic hexameter	feminine penthemimeral, hepthemimeral
ἀλλ’ ἄγε μοι μνηστῆρας ἀριθμήσας κατάλεξον,	- uu - --u u--- uu--	dactylic hexameter	feminine penthemimeral, trithemimeral
ὄφρ’ εἰδέω ὅσσοι τε καὶ οἵ τινες ἀνέρες εἰσί·	- -- -- u u - uu -uu --	dactylic hexameter	masculine penthemimeral, hepthemimeral, trithemimeral
καί κεν ἐμὸν κατὰ θυμὸν ἀμύμονα μερμηρίξας	- u u- uu -u u-uu ----	dactylic hexameter	feminine penthemimeral, trithemimeral
φράσσομαι, εἴ κεν νῶϊ δυνησόμεθ’ ἀντιφέρεσθαι	-uu - - -u u-uu -uu--	dactylic hexameter	feminine penthemimeral, trithemimeral
μούνω ἄνευθ’ ἄλλων, ἦ καὶ διζησόμεθ’ ἄλλους.	-u u- -- - - --uu --	dactylic hexameter	masculine penthemimeral, hepthemimeral, trithemimeral
τὸν δ’αὖ Τηλέμαχος πεπνυμένος ἀντίον ηὔδα·	- - -uu- --uu -uu --	dactylic hexameter	masculine penthemimeral
ὧ πάτερ, ἤτοι σεῖο μέγα κλέος αἰὲν ἄκουον,	- uu -- -u u- uu -u u--	dactylic hexameter	feminine penthemimeral, hepthemimeral
χεῖράς τ’αἰχμητὴν ἔμεναι καὶ ἐπίφρονα βουλήν·	-- --- uu- u u-uu --	dactylic hexameter	masculine penthemimeral, hepthemimeral
ἀλλὰ λίην μέγα εἶπες· ἄγη μ’ἔχει· οὐδέ κεν εἴη	-u u- uu -u u- uu -u u --	dactylic hexameter	feminine penthemimeral, hepthemimeral, trithemimeral
ἄνδρε δύω πολλοῖσι καὶ ἰφθίμοισι μάχεσθαι.	-u u- --u u ---u u--	dactylic hexameter	feminine penthemimeral, trithemimeral
μνηστήρων δ’οὔτ’ ἂρ δεκὰς ἀτρεκὲς οὔτε δύ’ οἶαι,	--- - - uu -uu -u u --	dactylic hexameter	masculine penthemimeral, trithemimeral
ἀλλὰ πολὺ πλέονες· τάχα δ’εἴσεαι ἐνθάδ’ ἀριθμόν.	-u u- uu- uu -uu -u u--	dactylic hexameter	masculine penthemimeral, trithemimeral
ἐκ μὲν Δουλιχίοιο δύω καὶ πεντήκοντα	- - -uu-u u- - ----	dactylic hexameter	feminine penthemimeral, hepthemimeral
κοῦροι κεκριμένοι, ἓξ δὲ δρηστῆρες ἕπονται·	-- -uu- - - --u u--	dactylic hexameter	masculine penthemimeral, hepthemimeral
ἐκ δὲ Σάμης πίσυρές τε καὶ εἴκοσι φῶτες ἔασιν,	- u u- uu- u u -uu -u u--	dactylic hexameter	masculine penthemimeral, trithemimeral
ἐκ δὲ Ζακύνθου ἔασιν ἐείκοσι κοῦροι Ἀχαιῶν,	- u u-u u-u u-uu -u u--	dactylic hexameter	feminine penthemimeral
ἐκ δ’αὐτῆς Ἰθάκης δυοκαίδεκα πάντες ἄριστοι,	- -- uu- uu-uu -u u--	dactylic hexameter	masculine penthemimeral, trithemimeral
καί σφιν ἅμ’ ἐστὶ Μέδων κῆρυξ καὶ θεῖος ἀοιδὸς	- u u -u u- -- - -u u--	dactylic hexameter	masculine penthemimeral, hepthemimeral
καὶ δοιὼ θεράποντε, δαήμονε δαιτροσυνάων.	- -- uu-u u-uu -uu--	dactylic hexameter	feminine penthemimeral, trithemimeral
τῶν εἴ κεν πάντων ἀντήσομεν ἔνδον ἐόντων,	- - - -- --uu -u u--	dactylic hexameter	masculine penthemimeral, trithemimeral
μὴ πολύπικρα καὶ αἰνὰ βίας ἀποτίσεαι ἐλθών.	- uu-u u -u u- uu-uu --	dactylic hexameter	feminine penthemimeral, hepthemimeral
ἀλλὰ σύ γ’,εἰ δύνασαί τιν’ ἀμύντορα μερμηρίξαι,	-u u - uu- u u-uu ----	dactylic hexameter	masculine penthemimeral, trithemimeral
φράζευ, ὅ κέν τις νῶϊν ἀμύνοι πρόφρονι θυμῷ.	-u u - - -u u-- -uu --	dactylic hexameter	feminine penthemimeral, trithemimeral
τὸν δ’αὖτε προσέειπε πολύτλας δῖος Ὀδυσσεύς·	- -- uu-u u-- -u u--	dactylic hexameter	feminine penthemimeral, trithemimeral
τοιγὰρ ἐγὼν ἐρέω, σὺ δὲ σύνθεο καί μευ ἄκουσον·	-u u- uu- u u -uu - u u--	dactylic hexameter	masculine penthemimeral, trithemimeral
καὶ φράσαι εἴ κεν νῶϊν Ἀθήνη σὺν Διῒ πατρὶ	- uu - - -u u-- - uu --	dactylic hexameter	feminine penthemimeral, trithemimeral
ἀρκέσει, ἦέ τιν’ ἄλλον ἀμύντορα μερμηρίξω.	-uu -u u -u u-uu ----	dactylic hexameter	feminine penthemimeral
τὸν δ’αὖ Τηλέμαχος πεπνυμένος ἀντίον ηὔδα·	- - -uu- --uu -uu --	dactylic hexameter	masculine penthemimeral
ἐσθλώ τοι τούτω γ’ἐπαμύντορε, τοὺς ἀγορεύεις,	-- - -- uu-uu - uu--	dactylic hexameter	masculine penthemimeral, trithemimeral
ὕψι περ ἐν νεφέεσσι καθημένω· ὥ τε καὶ ἄλλοις	-u u - uu-u u-uu - u u --	dactylic hexameter	feminine penthemimeral, trithemimeral
ἀνδράσι τε κρατέουσι καὶ ἀθανάτοισι θεοῖσι.	-uu - uu-u u -uu-u u--	dactylic hexameter	feminine penthemimeral, trithemimeral
τὸν δ’αὖτε προσέειπε πολύτλας δῖος Ὀδυσσεύς·	- -- uu-u u-- -u u--	dactylic hexameter	feminine penthemimeral, trithemimeral
οὐ μέν τοι κείνω γε πολὺν χρόνον ἀμφὶς ἔσεσθον	- - - -- u u- uu -u u--	dactylic hexameter	masculine penthemimeral, hepthemimeral, trithemimeral
φυλόπιδος κρατερῆς, ὁπότε μνηστῆρσι καὶ ἡμῖν	-uu- uu- uu- --u u --	dactylic hexameter	masculine penthemimeral, hepthemimeral, trithemimeral
ἐν μεγάροισιν ἐμοῖσι μένος κρίνηται Ἄρηος.	- uu-u u-u u- --u u--	dactylic hexameter	feminine penthemimeral, hepthemimeral
ἀλλὰ σὺ μὲν νῦν ἔρχευ ἅμ’ ἠοῖ φαινομένηφι	-u u - - -u u -- -uu--	dactylic hexameter	feminine penthemimeral, trithemimeral
οἴκαδε, καὶ μνηστῆρσιν ὑπερφιάλοισιν ὁμίλει·	-uu - --u u-uu-u u--	dactylic hexameter	feminine penthemimeral, trithemimeral
αὐτὰρ ἐμὲ προτὶ ἄστυ συβώτης ὕστερον ἄξει,	-u u- uu -u u-- -uu --	dactylic hexameter	feminine penthemimeral, trithemimeral
πτωχῷ λευγαλέῳ ἐναλίγκιον ἠδὲ γέροντι.	-- -uu- uu-uu -u u--	dactylic hexameter	masculine penthemimeral
εἰ δέ μ’ἀτιμήσουσι δόμον κάτα, σὸν δὲ φίλον κῆρ	- u u---u u- uu - u u- -	dactylic hexameter	feminine penthemimeral, hepthemimeral
τετλάτω ἐν στήθεσσι κακῶς πάσχοντος ἐμεῖο,	-uu - --u u- --u u--	dactylic hexameter	feminine penthemimeral, hepthemimeral, trithemimeral
ἤν περ καὶ διὰ δῶμα ποδῶν ἕλκωσι θύραζε	- - - uu -u u- --u u--	dactylic hexameter	feminine penthemimeral, hepthemimeral, trithemimeral
ἢ βέλεσιν βάλλωσι· σὺ δ’εἰσορόων ἀνέχεσθαι.	- uu- --u u -uu- uu--	dactylic hexameter	feminine penthemimeral, trithemimeral
ἀλλ’ ἤτοι παύεσθαι ἀνωγέμεν ἀφροσυνάων,	- -- --u u-uu -uu--	dactylic hexameter	feminine penthemimeral, trithemimeral
μειλιχίοις ἐπέεσσι παραυδῶν· οἱ δέ τοι οὔ τι	-uu- uu-u u-- - u u - -	dactylic hexameter	feminine penthemimeral, trithemimeral
πείσονται· δὴ γάρ σφι παρίσταται αἴσιμον ἦμαρ.	--- - - u u-uu -uu --	dactylic hexameter	masculine penthemimeral, trithemimeral
ἄλλο δέ τοι ἐρέω, σὺ δ’ἐνὶ φρεσὶ βάλλεο σῇσιν·	-u u - uu- u u- uu -uu --	dactylic hexameter	masculine penthemimeral, hepthemimeral, trithemimeral
ὁππότε κεν πολύβουλος ἐνὶ φρεσὶ θῇσιν Ἀθήνη,	-uu - uu-u u- uu -u u--	dactylic hexameter	feminine penthemimeral, hepthemimeral, trithemimeral
νεύσω μέν τοι ἐγὼ κεφαλῇ, σὺ δ’ἔπειτα νοήσας	-- - u u- uu- u u-u u--	dactylic hexameter	masculine penthemimeral, hepthemimeral, trithemimeral
ὅσσα τοι ἐν μεγάροισιν ἀρήϊα τεύχεα κεῖται	-u u - uu-u u-uu -uu --	dactylic hexameter	feminine penthemimeral, trithemimeral
ἐς μυχὸν ὑψηλοῦ θαλάμου καταθεῖναι ἀείρας	- uu --- uu- uu-u u--	dactylic hexameter	masculine penthemimeral, hepthemimeral
πάντα μάλ’· αὐτὰρ μνηστῆρας μαλακοῖς ἐπέεσσι	-u u -- --- uu- uu--	dactylic hexameter	hepthemimeral
παρφάσθαι, ὅτε κέν σε μεταλλῶσιν ποθέοντες·	--- uu - u u--- uu--	dactylic hexameter	masculine penthemimeral, trithemimeral
ἐκ καπνοῦ κατέθηκ’, ἐπεὶ οὐκέτι τοῖσιν ἐῴκει	- -- uu- uu -uu -u u--	dactylic hexameter	masculine penthemimeral, trithemimeral
οἷά ποτε Τροίηνδε κιὼν κατέλειπεν Ὀδυσσεύς,	-u u- --u u- uu-u u--	dactylic hexameter	feminine penthemimeral, hepthemimeral, trithemimeral
ἀλλὰ κατῄκισται, ὅσσον πυρὸς ἵκετ’ ἀϋτμή.	-u u--- -- uu -u u--	dactylic hexameter	masculine penthemimeral, hepthemimeral
πρὸς δ’ἔτι καὶ τόδε μεῖζον ἐνὶ φρεσὶ θῆκε Κρονίων,	- uu - uu -u u- uu -u u--	dactylic hexameter	feminine penthemimeral, hepthemimeral, trithemimeral
μή πως οἰνωθέντες, ἔριν στήσαντες ἐν ὑμῖν,	- - ---u u- --u u --	dactylic hexameter	feminine penthemimeral, hepthemimeral
ἀλλήλους τρώσητε καταισχύνητέ τε δαῖτα	--- --u u---u u --	dactylic hexameter	feminine penthemimeral, trithemimeral
καὶ μνηστύν· αὐτὸς γὰρ ἐφέλκεται ἄνδρα σίδηρος.	- -- -- u u-uu -u u--	dactylic hexameter	masculine penthemimeral, trithemimeral
νῶϊν δ’οἴοισιν δύο φάσγανα καὶ δύο δοῦρε	-- --- uu -uu - uu --	dactylic hexameter	masculine penthemimeral
καλλιπέειν καὶ δοιὰ βοάγρια χερσὶν ἑλέσθαι,	-uu- - -u u-uu -u u--	dactylic hexameter	feminine penthemimeral, trithemimeral
ὡς ἂν ἐπιθύσαντες ἑλοίμεθα· τοὺς δέ κ’ἔπειτα	- u u---u u-uu - u u--	dactylic hexameter	feminine penthemimeral
Παλλὰς Ἀθηναίη θέλξει καὶ μητίετα Ζεύς.	-u u--- -- - -uu- -	dactylic hexameter	masculine penthemimeral, hepthemimeral
ἄλλο δέ τοι ἐρέω, σὺ δ’ἐνὶ φρεσὶ βάλλεο σῇσιν·	-u u - uu- u u- uu -uu --	dactylic hexameter	masculine penthemimeral, hepthemimeral, trithemimeral
εἰ ἐτεόν γ’ἐμός ἐσσι καὶ αἵματος ἡμετέροιο,	- uu- uu -u u -uu -uu--	dactylic hexameter	feminine penthemimeral, trithemimeral
μή τις ἔπειτ’ Ὀδυσῆος ἀκουσάτω ἔνδον ἐόντος,	- u u- uu-u u-uu -u u--	dactylic hexameter	feminine penthemimeral, trithemimeral
μήτ’ οὖν Λαέρτης ἴστω τό γε μήτε συβώτης	- - --- -- u u -u u--	dactylic hexameter	masculine penthemimeral, hepthemimeral
μήτε τις οἰκήων μήτ’ αὐτὴ Πηνελόπεια,	-u u --- - -- -uu--	dactylic hexameter	masculine penthemimeral
ἀλλ’ οἶοι σύ τ’ἐγώ τε γυναικῶν γνώομεν ἰθύν·	- -- u u- u u-- -uu --	dactylic hexameter	masculine penthemimeral, trithemimeral
καί κέ τεο δμώων ἀνδρῶν ἔτι πειρηθεῖμεν,	- u u- -- -- uu ----	dactylic hexameter	masculine penthemimeral, hepthemimeral, trithemimeral
ἠμὲν ὅ που τις νῶϊ τίει καὶ δείδιε θυμῷ,	-u u - - -u u- - -uu --	dactylic hexameter	feminine penthemimeral, hepthemimeral, trithemimeral
ἠδ’ ὅτις οὐκ ἀλέγει, σὲ δ’ἀτιμᾷ τοῖον ἐόντα.	- uu - uu- u u-- -u u--	dactylic hexameter	masculine penthemimeral, trithemimeral
τὸν δ’ἀπαμειβόμενος προσεφώνεε φαίδιμος υἱός	- uu-uu- uu-uu -uu --	dactylic hexameter	masculine penthemimeral
ὧ πάτερ, ἤτοι ἐμὸν θυμὸν καὶ ἔπειτά γ’,ὀΐω,	- uu -u u- -- u u-u u--	dactylic hexameter	masculine penthemimeral, hepthemimeral
γνώσεαι· οὐ μὲν γάρ τι χαλιφροσύναι γέ μ’ἔχουσιν·	-uu - - - u u-uu- u u--	dactylic hexameter	masculine penthemimeral, trithemimeral
ἀλλ’ οὔ τοι τόδε κέρδος ἐγὼν ἔσσεσθαι ὀΐω	- - - uu -u u- --u u--	dactylic hexameter	feminine penthemimeral, hepthemimeral, trithemimeral
ἡμῖν ἀμφοτέροισι· σὲ δὲ φράζεσθαι ἄνωγα.	-- -uu-u u - --u u--	dactylic hexameter	feminine penthemimeral, hepthemimeral
δηθὰ γὰρ αὔτως εἴσῃ ἑκάστου πειρητίζων,	-u u -- -u u-- ----	dactylic hexameter	feminine penthemimeral
ἔργα μετερχόμενος· τοὶ δ’ἐν μεγάροισιν ἕκηλοι	-u u-uu- - - uu-u u--	dactylic hexameter	masculine penthemimeral, hepthemimeral
χρήματα δαρδάπτουσιν ὑπέρβιον οὐδ’ ἔπι φειδώ.	-uu ---u u-uu - uu --	dactylic hexameter	feminine penthemimeral
ἀλλ’ ἤτοί σε γυναῖκας ἐγὼ δεδάασθαι ἄνωγα,	- -- u u-u u- uu-u u--	dactylic hexameter	feminine penthemimeral, hepthemimeral, trithemimeral
αἵ τέ σ’ἀτιμάζουσι καὶ αἳ νηλιτεῖς εἰσιν·	- u u---u u - --- --	dactylic hexameter	feminine penthemimeral, hepthemimeral
ἀνδρῶν δ’οὐκ ἂν ἔγωγε κατὰ σταθμοὺς ἐθέλοιμι	-- - u u-u u- -- uu--	dactylic hexameter	feminine penthemimeral, hepthemimeral, trithemimeral
ἡμέας πειράζειν, ἀλλ’ ὕστερα ταῦτα πένεσθαι,	-- --- - -uu -u u--	dactylic hexameter	masculine penthemimeral
εἰ ἐτεόν γέ τι οἶσθα Διὸς τέρας αἰγιόχοιο.	- uu- u u -u u- uu -uu--	dactylic hexameter	feminine penthemimeral, hepthemimeral, trithemimeral
ὣς οἱ μὲν τοιαῦτα πρὸς ἀλλήλους ἀγόρευον,	- - - --u u --- uu--	dactylic hexameter	feminine penthemimeral, trithemimeral
ἡ δ’ἄρ’ ἔπειτ’ Ἰθάκηνδε κατήγετο νηῦς εὐεργής,	- u u- uu-u u-uu - ---	dactylic hexameter	feminine penthemimeral, trithemimeral
ἣ φέρε Τηλέμαχον Πυλόθεν καὶ πάντας ἑταίρους.	- uu -uu- uu- - -u u--	dactylic hexameter	masculine penthemimeral, hepthemimeral
οἱ δ’ὅτε δὴ λιμένος πολυβενθέος ἐντὸς ἵκοντο,	- uu - uu- uu-uu -u u--	dactylic hexameter	masculine penthemimeral, trithemimeral
νῆα μὲν οἵ γε μέλαιναν ἐπ’ ἠπείροιο ἔρυσσαν,	-u u - u u-u u ---u u--	dactylic hexameter	feminine penthemimeral, trithemimeral
τεύχεα δέ σφ’ἀπένεικαν ὑπέρθυμοι θεράποντες,	-uu - uu-u u--- uu--	dactylic hexameter	feminine penthemimeral, trithemimeral
αὐτίκα δ’ἐς Κλυτίοιο φέρον περικαλλέα δῶρα.	-uu - uu-u u- uu-uu --	dactylic hexameter	feminine penthemimeral, hepthemimeral, trithemimeral
αὐτὰρ κήρυκα πρόεσαν δόμον εἰς Ὀδυσῆος,	-- --- uu- uu - uu--	dactylic hexameter	masculine penthemimeral, hepthemimeral
ἀγγελίην ἐρέοντα περίφρονι Πηνελοπείῃ,	-uu- uu-u u-uu -uu--	dactylic hexameter	feminine penthemimeral, trithemimeral
οὕνεκα Τηλέμαχος μὲν ἐπ’ ἀγροῦ, νῆα δ’ἀνώγει	-uu -uu- u u -- -u u--	dactylic hexameter	masculine penthemimeral
ἄστυδ’ ἀποπλείειν, ἵνα μὴ δείσασ’ ἐνὶ θυμῷ	-u u--- uu - -- uu --	dactylic hexameter	masculine penthemimeral, hepthemimeral
ἰφθίμη βασίλεια τέρεν κατὰ δάκρυον εἴβοι	--- uu-u u- uu -uu --	dactylic hexameter	feminine penthemimeral, hepthemimeral, trithemimeral
τὼ δὲ συναντήτην κῆρυξ καὶ δῖος ὑφορβὸς	- u u--- -- - -u u--	dactylic hexameter	masculine penthemimeral, hepthemimeral
τῆς αὐτῆς ἕνεκ’ ἀγγελίης, ἐρέοντε γυναικί.	- -- uu -uu- uu-u u--	dactylic hexameter	hepthemimeral, trithemimeral
ἀλλ’ ὅτε δή ῥ’ἵκοντο δόμον θείου βασιλῆος,	- uu - --u u- -- uu--	dactylic hexameter	feminine penthemimeral, hepthemimeral, trithemimeral
κῆρυξ μέν ῥα μέσῃσι μετὰ δμῳῇσιν ἔειπεν·	-- - u u-u u- --u u--	dactylic hexameter	feminine penthemimeral, hepthemimeral, trithemimeral
ἤδη τοι, βασίλεια, φίλος πάϊς εἰλήλουθε.	-- - uu-u u- uu ----	dactylic hexameter	feminine penthemimeral, hepthemimeral, trithemimeral
Πηνελοπείῃ δ’εἶπε συβώτης ἄγχι παραστὰς	-uu-- -u u-- -u u--	dactylic hexameter	feminine penthemimeral
πάνθ’ ὅσα οἱ φίλος υἱὸς ἀνώγει μυθήσασθαι.	- uu - uu -u u-- ----	dactylic hexameter	feminine penthemimeral, trithemimeral
αὐτὰρ ἐπεὶ δὴ πᾶσαν ἐφημοσύνην ἀπέειπε,	-u u- - -u u-uu- uu--	dactylic hexameter	feminine penthemimeral, trithemimeral
βῆ ῥ’ἴμεναι μεθ’ ὕας, λίπε δ’ἕρκεά τε μέγαρόν τε.	- uu- u u- uu -uu - uu- -	dactylic hexameter	masculine penthemimeral, trithemimeral
μνηστῆρες δ’ἀκάχοντο κατήφησάν τ’ἐνὶ θυμῷ,	--- uu-u u--- uu --	dactylic hexameter	feminine penthemimeral, trithemimeral
ἐκ δ’ἦλθον μεγάροιο παρὲκ μέγα τειχίον αὐλῆς,	- -- uu-u u- uu -uu --	dactylic hexameter	feminine penthemimeral, hepthemimeral, trithemimeral
αὐτοῦ δὲ προπάροιθε θυράων ἑδριόωντο.	-- - uu-u u-- -uu--	dactylic hexameter	feminine penthemimeral, trithemimeral
τοῖσιν δ’Εὐρύμαχος, Πολύβου πάϊς, ἦρχ’ ἀγορεύειν·	-- -uu- uu- uu - uu--	dactylic hexameter	masculine penthemimeral, hepthemimeral
ὧ φίλοι, ἦ μέγα ἔργον ὑπερφιάλως τετέλεσται	- uu - uu -u u-uu- uu--	dactylic hexameter	feminine penthemimeral, trithemimeral
Τηλεμάχῳ ὁδὸς ἥδε· φάμεν δέ οἱ οὐ τελέεσθαι.	-uu- uu -u u- u u - uu--	dactylic hexameter	feminine penthemimeral, hepthemimeral, trithemimeral
ἀλλ’ ἄγε νῆα μέλαιναν ἐρύσσομεν ἥ τις ἀρίστη,	- uu -u u-u u-uu - u u--	dactylic hexameter	feminine penthemimeral
ἐς δ’ἐρέτας ἁλιῆας ἀγείρομεν, οἵ κε τάχιστα	- uu- uu-u u-uu - u u--	dactylic hexameter	feminine penthemimeral, trithemimeral
κείνοις ἀγγείλωσι θοῶς οἶκόνδε νέεσθαι.	-- ---u u- --u u--	dactylic hexameter	feminine penthemimeral, hepthemimeral
οὔ πω πᾶν εἴρηθ’, ὅτ’ ἄρ’ Ἀμφίνομος ἴδε νῆα,	- - - -- u u -uu- uu --	dactylic hexameter	masculine penthemimeral, trithemimeral
στρεφθεὶς ἐκ χώρης, λιμένος πολυβενθέος ἐντός,	-- - -- uu- uu-uu --	dactylic hexameter	masculine penthemimeral, hepthemimeral, trithemimeral
ἱστία τε στέλλοντας ἐρετμά τε χερσὶν ἔχοντας.	-uu - --u u-u u -u u--	dactylic hexameter	feminine penthemimeral, trithemimeral
ἡδὺ δ’ἄρ’ ἐκγελάσας μετεφώνεεν οἷς ἑτάροισι·	-u u -uu- uu-uu - uu--	dactylic hexameter	masculine penthemimeral
μή τιν’ ἔτ’ ἀγγελίην ὀτρύνομεν· οἵδε γὰρ ἔνδον.	- u u -uu- --uu -u u --	dactylic hexameter	masculine penthemimeral
ἤ τίς σφιν τόδ’ ἔειπε θεῶν, ἢ εἴσιδον αὐτοὶ	- - - u u-u u- - -uu --	dactylic hexameter	feminine penthemimeral, hepthemimeral, trithemimeral
νῆα παρερχομένην, τὴν δ’οὐκ ἐδύναντο κιχῆναι.	-u u-uu- - - uu-u u--	dactylic hexameter	masculine penthemimeral, hepthemimeral
ὣς ἔφαθ’, οἱ δ’ἀνστάντες ἔβαν ἐπὶ θῖνα θαλάσσης,	- uu - --u u- uu -u u--	dactylic hexameter	feminine penthemimeral, hepthemimeral, trithemimeral
αἶψα δὲ νῆα μέλαιναν ἐπ’ ἠπείροιο ἔρυσσαν,	-u u -u u-u u ---u u--	dactylic hexameter	feminine penthemimeral
τεύχεα δέ σφ’ἀπένεικαν ὑπέρθυμοι θεράποντες.	-uu - uu-u u--- uu--	dactylic hexameter	feminine penthemimeral, trithemimeral
αὐτοὶ δ’εἰς ἀγορὴν κίον ἀθρόοι, οὐδέ τιν’ ἄλλον	-- - uu- uu -uu -u u --	dactylic hexameter	masculine penthemimeral, trithemimeral
εἴων οὔτε νέων μεταΐζειν οὔτε γερόντων.	-- -u u- uu-- -u u--	dactylic hexameter	masculine penthemimeral
τοῖσιν δ’Ἀντίνοος μετέφη, Εὐπείθεος υἱός·	-- -uu- uu- --uu --	dactylic hexameter	masculine penthemimeral, hepthemimeral
ὢ πόποι, ὡς τόνδ’ ἄνδρα θεοὶ κακότητος ἔλυσαν.	- uu - - -u u- uu-u u--	dactylic hexameter	feminine penthemimeral, hepthemimeral, trithemimeral
ἤματα μὲν σκοποὶ ἷζον ἐπ’ ἄκριας ἠνεμοέσσας	-uu - uu -u u -uu -uu--	dactylic hexameter	feminine penthemimeral, trithemimeral
αἰὲν ἐπασσύτεροι· ἅμα δ’ἠελίῳ καταδύντι	-u u-uu- uu -uu- uu--	dactylic hexameter	masculine penthemimeral
οὔ ποτ’ ἐπ’ ἠπείρου νύκτ’ ἄσαμεν, ἀλλ’ ἐνὶ πόντῳ	- u u --- - -uu - uu --	dactylic hexameter	masculine penthemimeral
νηῒ θοῇ πλείοντες ἐμίμνομεν Ἠῶ δῖαν,	-u u- --u u-uu -- --	dactylic hexameter	feminine penthemimeral, trithemimeral
Τηλέμαχον λοχόωντες, ἵνα φθίσωμεν ἑλόντες	-uu- uu-u u- --u u--	dactylic hexameter	feminine penthemimeral, hepthemimeral, trithemimeral
αὐτόν· τὸν δ’ἄρα τέως μὲν ἀπήγαγεν οἴκαδε δαίμων,	-- - uu - u u-uu -uu --	dactylic hexameter	masculine penthemimeral, trithemimeral
ἡμεῖς δ’ἐνθάδε οἱ φραζώμεθα λυγρὸν ὄλεθρον	-- -uu - --uu -u u--	dactylic hexameter	masculine penthemimeral
Τηλεμάχῳ, μηδ’ ἧμας ὑπεκφύγοι· οὐ γὰρ ὀΐω	-uu- - -u u-uu - u u--	dactylic hexameter	feminine penthemimeral, trithemimeral
τούτου γε ζώοντος ἀνύσσεσθαι τάδε ἔργα.	-- - --u u--- uu --	dactylic hexameter	feminine penthemimeral, trithemimeral
αὐτὸς μὲν γὰρ ἐπιστήμων βουλῇ τε νόῳ τε,	-- - u u--- -- u u- -	dactylic hexameter	hepthemimeral, trithemimeral
λαοὶ δ’οὐκέτι πάμπαν ἐφ’ ἡμῖν ἦρα φέρουσιν.	-- -uu -u u -- -u u--	dactylic hexameter	feminine penthemimeral
ἀλλ’ ἄγετε, πρὶν κεῖνον ὁμηγυρίσασθαι Ἀχαιοὺς	- uu- - -u u-uu-u u--	dactylic hexameter	feminine penthemimeral, trithemimeral
εἰς ἀγορήν οὐ γάρ τι μεθησέμεναί μιν ὀΐω,	- uu- - - u u-uu- u u--	dactylic hexameter	masculine penthemimeral, trithemimeral
ἀλλ’ ἀπομηνίσει, ἐρέει δ’ἐν πᾶσιν ἀναστὰς	- uu--- uu- - -u u--	dactylic hexameter	masculine penthemimeral, hepthemimeral
οὕνεκά οἱ φόνον αἰπὺν ἐράπτομεν οὐδ’ ἐκίχημεν·	-uu - uu -u u-uu - uu--	dactylic hexameter	feminine penthemimeral, trithemimeral
οἱ δ’οὐκ αἰνήσουσιν ἀκούοντες κακὰ ἔργα·	- - ---u u--- uu --	dactylic hexameter	feminine penthemimeral
μή τι κακὸν ῥέξωσι καὶ ἡμέας ἐξελάσωσι	- u u- --u u -uu -uu--	dactylic hexameter	feminine penthemimeral, trithemimeral
γαίης ἡμετέρης, ἄλλων δ’ἀφικώμεθα δῆμον·	-- -uu- -- uu-uu --	dactylic hexameter	masculine penthemimeral, hepthemimeral
ἀλλὰ φθέωμεν ἑλόντες ἐπ’ ἀγροῦ νόσφι πόληος	-- -u u-u u -- -u u--	dactylic hexameter	feminine penthemimeral
ἢ ἐν ὁδῷ· βίοτον δ’αὐτοὶ καὶ κτήματ’ ἔχωμεν,	- u u- uu- -- - -u u--	dactylic hexameter	masculine penthemimeral, hepthemimeral, trithemimeral
δασσάμενοι κατὰ μοῖραν ἐφ’ ἡμέας, οἰκία δ’αὖτε	-uu- uu -u u -uu -uu --	dactylic hexameter	feminine penthemimeral, trithemimeral
κείνου μητέρι δοῖμεν ἔχειν ἠδ’ ὅς τις ὀπυίοι.	-- -uu -u u- - - u u--	dactylic hexameter	feminine penthemimeral, hepthemimeral
εἰ δ’ὑμῖν ὅδε μῦθος ἀφανδάνει, ἀλλὰ βόλεσθε	- -- uu -u u-uu -u u--	dactylic hexameter	feminine penthemimeral, trithemimeral
αὐτόν τε ζώειν καὶ ἔχειν πατρώϊα πάντα,	-- - -- u u- --uu --	dactylic hexameter	masculine penthemimeral, hepthemimeral, trithemimeral
μή οἱ χρήματ’ ἔπειτα ἅλις θυμηδέ’ ἔδωμεν	- - -u u-u u- --u u--	dactylic hexameter	feminine penthemimeral, hepthemimeral
ἐνθάδ’ ἀγειρόμενοι, ἀλλ’ ἐκ μεγάροιο ἕκαστος	-u u-uu- - - uu-u u--	dactylic hexameter	masculine penthemimeral, hepthemimeral
μνάσθω ἐέδνοισιν διζήμενος· ἡ δέ κ’ἔπειτα	-u u--- --uu - u u--	dactylic hexameter	masculine penthemimeral
γήμαιθ’ ὅς κε πλεῖστα πόροι καὶ μόρσιμος ἔλθοι.	-- - - -u u- - -uu --	dactylic hexameter	feminine penthemimeral, hepthemimeral, trithemimeral
ὣς ἔφαθ’, οἱ δ’ἄρα πάντες ἀκὴν ἐγένοντο σιωπῇ.	- uu - uu -u u- uu-u u--	dactylic hexameter	feminine penthemimeral, hepthemimeral, trithemimeral
τοῖσιν δ’Ἀμφίνομος ἀγορήσατο καὶ μετέειπε,	-- -uu- uu-uu - uu--	dactylic hexameter	masculine penthemimeral
Νίσου φαίδιμος υἱός, Ἀρητιάδαο ἄνακτος,	-- -uu -u u-uu-u u--	dactylic hexameter	feminine penthemimeral
ὅς ῥ’ἐκ Δουλιχίου πολυπύρου, ποιήεντος,	- - -uu- uu-- ----	dactylic hexameter	masculine penthemimeral
ἡγεῖτο μνηστῆρσι, μάλιστα δὲ Πηνελοπείῃ	--- --u u-u u -uu--	dactylic hexameter	feminine penthemimeral, trithemimeral
ἥνδανε μύθοισι· φρεσὶ γὰρ κέχρητ’ ἀγαθῇσιν·	-uu --- uu - -- uu--	dactylic hexameter	masculine penthemimeral, hepthemimeral
ὅ σφιν ἐῢ φρονέων ἀγορήσατο καὶ μετέειπεν·	- u u- uu- uu-uu - uu--	dactylic hexameter	masculine penthemimeral, trithemimeral
ὧ φίλοι, οὐκ ἂν ἔγωγε κατακτείνειν ἐθέλοιμι	- uu - u u-u u--- uu--	dactylic hexameter	feminine penthemimeral, trithemimeral
Τηλέμαχον· δεινὸν δὲ γένος βασιλήϊόν ἐστι	-uu- -- u u- uu-uu --	dactylic hexameter	masculine penthemimeral, hepthemimeral, trithemimeral
κτείνειν· ἀλλὰ πρῶτα θεῶν εἰρώμεθα βουλάς.	-- -- -u u- --uu --	dactylic hexameter	feminine penthemimeral, hepthemimeral
εἰ μέν κ’αἰνήσωσι Διὸς μεγάλοιο θέμιστες,	- - ---u u- uu-u u--	dactylic hexameter	feminine penthemimeral, hepthemimeral
αὐτός τε κτενέω τούς τ’ἄλλους πάντας ἀνώξω·	-- - uu- - -- -u u--	dactylic hexameter	masculine penthemimeral, trithemimeral
εἰ δέ κ’ἀποτρωπῶσι θεοί, παύσασθαι ἄνωγα.	- u u---u u- --u u--	dactylic hexameter	feminine penthemimeral, hepthemimeral
ὣς ἔφατ’ Ἀμφίνομος, τοῖσιν δ’ἐπιήνδανε μῦθος.	- uu -uu- -- uu-uu --	dactylic hexameter	masculine penthemimeral, hepthemimeral
αὐτίκ’ ἔπειτ’ ἀνστάντες ἔβαν δόμον εἰς Ὀδυσῆος,	-u u- --u u- uu - uu--	dactylic hexameter	feminine penthemimeral, hepthemimeral, trithemimeral
ἐλθόντες δ’ἐκαθῖζον ἐπὶ ξεστοῖσι θρόνοισιν.	--- uu-u u- --u u--	dactylic hexameter	feminine penthemimeral, hepthemimeral, trithemimeral
ἡ δ’αὖτ’ ἄλλ’ ἐνόησε περίφρων Πηνελόπεια,	- - - uu-u u-- -uu--	dactylic hexameter	feminine penthemimeral, trithemimeral
μνηστήρεσσι φανῆναι ὑπέρβιον ὕβριν ἔχουσι.	---u u-u u-uu -u u--	dactylic hexameter	feminine penthemimeral
πεύθετο γὰρ οὗ παιδὸς ἐνὶ μεγάροισιν ὄλεθρον·	-uu - - -u u- uu-u u--	dactylic hexameter	feminine penthemimeral, hepthemimeral, trithemimeral
κῆρυξ γὰρ οἱ ἔειπε Μέδων, ὃς ἐπεύθετο βουλάς.	-- - u u-u u- u u-uu --	dactylic hexameter	feminine penthemimeral, hepthemimeral, trithemimeral
βῆ δ’ἰέναι μέγαρόνδε σὺν ἀμφιπόλοισι γυναιξίν.	- uu- uu-u u -uu-u u--	dactylic hexameter	feminine penthemimeral, trithemimeral
ἀλλ’ ὅτε δὴ μνηστῆρας ἀφίκετο δῖα γυναικῶν,	- uu - --u u-uu -u u--	dactylic hexameter	feminine penthemimeral, trithemimeral
στῆ ῥα παρὰ σταθμὸν τέγεος πύκα ποιητοῖο,	- u u- -- uu- uu ----	dactylic hexameter	masculine penthemimeral, hepthemimeral, trithemimeral
ἄντα παρειάων σχομένη λιπαρὰ κρήδεμνα,	-u u--- uu- uu- ---	dactylic hexameter	masculine penthemimeral, hepthemimeral
Ἀντίνοον δ’ἐνένιπεν ἔπος τ’ἔφατ’ ἔκ τ’ὀνόμαζεν·	-uu- uu-u u- uu - uu--	dactylic hexameter	feminine penthemimeral, hepthemimeral, trithemimeral
Ἀντίνο’, ὕβριν ἔχων, κακομήχανε, καὶ δέ σέ φασιν	-uu -u u- uu-uu - u u --	dactylic hexameter	masculine penthemimeral
ἐν δήμῳ Ἰθάκης μεθ’ ὁμήλικας ἔμμεν ἄριστον	- -- uu- u u-uu -u u--	dactylic hexameter	masculine penthemimeral, trithemimeral
βουλῇ καὶ μύθοισι· σὺ δ’οὐκ ἄρα τοῖος ἔησθα.	-- - --u u - uu -u u--	dactylic hexameter	feminine penthemimeral, hepthemimeral, trithemimeral
μάργε, τίη δὲ σὺ Τηλεμάχῳ θάνατόν τε μόρον τε	-u u- u u -uu- uu- u u- -	dactylic hexameter	hepthemimeral, trithemimeral
ῥάπτεις, οὐδ’ ἱκέτας ἐμπάζεαι, οἷσιν ἄρα Ζεὺς	-- - uu- --uu -u u- -	dactylic hexameter	masculine penthemimeral, trithemimeral
μάρτυρος; οὐδ’ ὁσίη κακὰ ῥάπτειν ἀλλήλοισιν.	-uu - uu- uu -- ----	dactylic hexameter	masculine penthemimeral, trithemimeral
ἦ οὐκ οἶσθ’ ὅτε δεῦρο πατὴρ τεὸς ἵκετο φεύγων,	- - - uu -u u- uu -uu --	dactylic hexameter	feminine penthemimeral, hepthemimeral, trithemimeral
δῆμον ὑποδδείσας; δὴ γὰρ κεχολώατο λίην,	-u u--- - - uu-uu --	dactylic hexameter	masculine penthemimeral, hepthemimeral
οὕνεκα ληϊστῆρσιν ἐπισπόμενος Ταφίοισιν	-uu ---u u-uu- uu--	dactylic hexameter	feminine penthemimeral
ἤκαχε Θεσπρωτούς· οἱ δ’ἡμῖν ἄρθμιοι ἦσαν·	-uu --- - -- -uu --	dactylic hexameter	masculine penthemimeral
τόν ῥ’ἔθελον φθῖσαι καὶ ἀπορραῖσαι φίλον ἦτορ	- uu- -- u u--- uu --	dactylic hexameter	masculine penthemimeral, trithemimeral
ἠδὲ κατὰ nbsp;ζωὴν φαγέειν μενοεικέα πολλήν·	-u u--- uu- uu-uu --	dactylic hexameter	masculine penthemimeral, hepthemimeral
ἀλλ’ Ὀδυσεὺς κατέρυκε καὶ ἔσχεθεν ἱεμένους περ.	- uu- uu-u u -uu -uu- -	dactylic hexameter	feminine penthemimeral, trithemimeral
τοῦ νῦν οἶκον ἄτιμον ἔδεις, μνάᾳ δὲ γυναῖκα	- - -u u-u u- -- u u--	dactylic hexameter	feminine penthemimeral, hepthemimeral
παῖδά τ’ἀποκτείνεις, ἐμὲ δὲ μεγάλως ἀκαχίζεις·	-u u--- uu - uu- uu--	dactylic hexameter	masculine penthemimeral, hepthemimeral
ἀλλά σε παύεσθαι κέλομαι καὶ ἀνωγέμεν ἄλλους.	-u u --- uu- u u-uu --	dactylic hexameter	masculine penthemimeral, hepthemimeral
τὴν δ’αὖτ’ Εὐρύμαχος, Πολύβου πάϊς, ἀντίον ηὔδα·	- - -uu- uu- uu -uu --	dactylic hexameter	masculine penthemimeral, hepthemimeral
κούρη Ἰκαρίοιο, περίφρων Πηνελόπεια,	-- -uu-u u-- -uu--	dactylic hexameter	feminine penthemimeral
θάρσει· μή τοι ταῦτα μετὰ φρεσὶ σῇσι μελόντων.	-- - - -u u- uu -u u--	dactylic hexameter	feminine penthemimeral, hepthemimeral, trithemimeral
οὐκ ἔσθ’ οὗτος ἀνὴρ οὐδ’ ἔσσεται οὐδὲ γένηται,	- - -u u- - -uu -u u--	dactylic hexameter	masculine penthemimeral
ὅς κεν Τηλεμάχῳ σῷ υἱέϊ χεῖρας ἐποίσει	- - -uu- - -uu -u u--	dactylic hexameter	masculine penthemimeral
ζώοντός γ’ἐμέθεν καὶ ἐπὶ χθονὶ δερκομένοιο.	--- uu- u u- uu -uu--	dactylic hexameter	masculine penthemimeral, hepthemimeral, trithemimeral
ὦδε γὰρ ἐξερέω, καὶ μὴν τετελεσμένον ἔσται·	-u u -uu- - - uu-uu --	dactylic hexameter	masculine penthemimeral, hepthemimeral
αἶψά οἱ αἷμα κελαινὸν ἐρωήσει περὶ δουρὶ	-u u -u u-u u--- uu --	dactylic hexameter	feminine penthemimeral
ἡμετέρῳ, ἐπεὶ ἦ καὶ ἐμὲ πτολίπορθος Ὀδυσσεὺς	-uu- uu - u u- uu-u u--	dactylic hexameter	masculine penthemimeral, hepthemimeral, trithemimeral
πολλάκι γούνασιν οἷσιν ἐφεσσάμενος κρέας ὀπτὸν	-uu -uu -u u-uu- uu --	dactylic hexameter	feminine penthemimeral
ἐν χείρεσσιν ἔθηκεν, ἐπέσχε τε οἶνον ἐρυθρόν.	- --u u-u u-u u -u u--	dactylic hexameter	feminine penthemimeral
τῶ μοι Τηλέμαχος πάντων πολὺ φίλτατός ἐστιν	- - -uu- -- uu -uu --	dactylic hexameter	masculine penthemimeral, hepthemimeral
ἀνδρῶν, οὐδέ τί μιν θάνατον τρομέεσθαι ἄνωγα	-- -u u - uu- uu-u u--	dactylic hexameter	masculine penthemimeral, hepthemimeral
ἔκ γε μνηστήρων· θεόθεν δ’οὐκ ἔστ’ ἀλέασθαι.	- - --- uu- - - uu--	dactylic hexameter	masculine penthemimeral, hepthemimeral
ὣς φάτο θαρσύνων, τῷ δ’ἤρτυεν αὐτὸς ὄλεθρον.	- uu --- - -uu -u u--	dactylic hexameter	masculine penthemimeral
ἡ μὲν ἄρ’ εἰσαναβᾶσ’ ὑπερώϊα σιγαλόεντα	- u u -uu- uu-uu -uu--	dactylic hexameter	masculine penthemimeral
κλαῖεν ἔπειτ’ Ὀδυσῆα, φίλον πόσιν, ὄφρα οἱ ὕπνον	-u u- uu-u u- uu -u u --	dactylic hexameter	feminine penthemimeral, hepthemimeral, trithemimeral
ἡδὺν ἐπὶ βλεφάροισι βάλε γλαυκῶπις Ἀθήνη.	-u u- uu-u u- --u u--	dactylic hexameter	feminine penthemimeral, hepthemimeral, trithemimeral
ἑσπέριος δ’Ὀδυσῆϊ καὶ υἱέϊ δῖος ὑφορβὸς	-uu- uu-u u -uu -u u--	dactylic hexameter	feminine penthemimeral, trithemimeral
ἤλυθεν· οἱ δ’ἄρα δόρπον ἐπισταδὸν ὡπλίζοντο,	-uu - uu -u u-uu ----	dactylic hexameter	feminine penthemimeral, trithemimeral
σῦν ἱερεύσαντες ἐνιαύσιον. αὐτὰρ Ἀθήνη,	- uu--- uu-uu -u u--	dactylic hexameter	masculine penthemimeral
ἄγχι παρισταμένη, Λαερτιάδην Ὀδυσῆα	-u u-uu- --uu- uu--	dactylic hexameter	masculine penthemimeral
ῥάβδῳ πεπληγυῖα πάλιν ποίησε γέροντα,	-- ---u u- --u u--	dactylic hexameter	feminine penthemimeral, hepthemimeral
λυγρὰ δὲ εἵματα ἕσσε περὶ χροΐ, μή ἑ συβώτης	-u u -uu -u u- uu - u u--	dactylic hexameter	feminine penthemimeral, hepthemimeral
γνοίη ἐσάντα ἰδὼν καὶ ἐχέφρονι Πηνελοπείῃ	-u u-u u- u u-uu -uu--	dactylic hexameter	masculine penthemimeral
ἔλθοι ἀπαγγέλλων μηδὲ φρεσὶν εἰρύσσαιτο.	-u u--- -- uu ----	dactylic hexameter	masculine penthemimeral, hepthemimeral
τὸν καὶ Τηλέμαχος πρότερος πρὸς μῦθον ἔειπεν·	- - -uu- uu- - -u u--	dactylic hexameter	masculine penthemimeral, hepthemimeral
ἦλθες, δῖ’ Εὔμαιε. τί δὴ κλέος ἔστ’ ἀνὰ ἄστυ;	-- - --u u - uu - uu --	dactylic hexameter	feminine penthemimeral, hepthemimeral, trithemimeral
ἦ ῥ’ἤδη μνηστῆρες ἀγήνορες ἔνδον ἔασιν	- -- --u u-uu -u u--	dactylic hexameter	feminine penthemimeral, trithemimeral
ἐκ λόχου, ἦ ἔτι μ’αὖθ’ εἰρύαται οἴκαδ’ ἰόντα;	- uu - uu - --uu -u u--	dactylic hexameter	masculine penthemimeral, trithemimeral
τὸν δ’ἀπαμειβόμενος προσέφης, Εὔμαιε συβῶτα·	- uu-uu- uu- --u u--	dactylic hexameter	masculine penthemimeral, hepthemimeral
οὐκ ἔμελέν μοι ταῦτα μεταλλῆσαι καὶ ἐρέσθαι	- uu- - -u u--- u u--	dactylic hexameter	feminine penthemimeral, trithemimeral
ἄστυ καταβλώσκοντα· τάχιστά με θυμὸς ἄνωγεν	-u u---u u-u u -u u--	dactylic hexameter	feminine penthemimeral
ἀγγελίην εἰπόντα πάλιν δεῦρ’ ἀπονέεσθαι.	-uu- --u u- - -uu--	dactylic hexameter	feminine penthemimeral, hepthemimeral, trithemimeral
ὡμήρησε δέ μοι παρ’ ἑταίρων ἄγγελος ὠκύς,	---u u - u u-- -uu --	dactylic hexameter	masculine penthemimeral
κῆρυξ, ὃς δὴ πρῶτος ἔπος σῇ μητρὶ ἔειπεν.	-- - - -u u- - -u u--	dactylic hexameter	feminine penthemimeral, hepthemimeral, trithemimeral
ἄλλο δέ τοι τόδε οἶδα· τὸ γὰρ ἴδον ὀφθαλμοῖσιν.	-u u - uu -u u - uu ----	dactylic hexameter	feminine penthemimeral, hepthemimeral, trithemimeral
ἤδη ὑπὲρ πόλιος, ὅθι Ἕρμαιος λόφος ἐστίν,	-u u- uu- uu --- uu --	dactylic hexameter	masculine penthemimeral, trithemimeral
ἦα κιών, ὅτε νῆα θοὴν ἰδόμην κατιοῦσαν	-u u- uu -u u- uu- uu--	dactylic hexameter	feminine penthemimeral, hepthemimeral, trithemimeral
ἐς λιμέν’ ἡμέτερον· πολλοὶ δ’ἔσαν ἄνδρες ἐν αὐτῇ,	- uu -uu- -- uu -u u --	dactylic hexameter	masculine penthemimeral, hepthemimeral
βεβρίθει δὲ σάκεσσι καὶ ἔγχεσιν ἀμφιγύοισι·	--- u u-u u -uu -uu--	dactylic hexameter	feminine penthemimeral, trithemimeral
καὶ σφέας ὠΐσθην τοὺς ἔμμεναι, οὐδέ τι οἶδα.	- uu --- - -uu -u u --	dactylic hexameter	masculine penthemimeral
ὣς φάτο, μείδησεν δ’ἱερὴ ἲς Τηλεμάχοιο	- uu --- uu- - -uu--	dactylic hexameter	masculine penthemimeral, hepthemimeral
ἐς πατέρ’ ὀφθαλμοῖσιν ἰδών, ἀλέεινε δ’ὑφορβόν.	- uu ---u u- uu-u u--	dactylic hexameter	feminine penthemimeral, hepthemimeral
οἱ δ’ἐπεὶ οὖν παύσαντο πόνου τετύκοντό τε δαῖτα,	- uu - --u u- uu-u u --	dactylic hexameter	feminine penthemimeral, hepthemimeral, trithemimeral
δαίνυντ’, οὐδέ τι θυμὸς ἐδεύετο δαιτὸς ἐΐσης.	-- -u u -u u-uu -u u--	dactylic hexameter	feminine penthemimeral
αὐτὰρ ἐπεὶ πόσιος καὶ ἐδητύος ἐξ ἔρον ἕντο,	-u u- uu- u u-uu - uu --	dactylic hexameter	masculine penthemimeral, trithemimeral
κοίτου τε μνήσαντο καὶ ὕπνου δῶρον ἕλοντο.	-- - --u u -- -u u--	dactylic hexameter	feminine penthemimeral, trithemimeral
