τὸν δ’ἀπαμειβόμενος προσέφη πολύμητις Ὀδυσσεύς·	- uu-uu- uu- uu-u u--	dactylic hexameter	masculine penthemimeral, hepthemimeral
Ἀλκίνοε κρεῖον, πάντων ἀριδείκετε λαῶν,	-uu- -- -- uu-uu --	dactylic hexameter	masculine penthemimeral, hepthemimeral, trithemimeral
ἤτοι μὲν τόδε καλὸν ἀκουέμεν ἐστὶν ἀοιδοῦ	-- - uu -u u-uu -u u--	dactylic hexameter	feminine penthemimeral, trithemimeral
τοιοῦδ’ οἷος ὅδ’ ἐστί, θεοῖς ἐναλίγκιος αὐδήν.	-- -u u -u u- uu-uu --	dactylic hexameter	feminine penthemimeral, hepthemimeral
οὐ γὰρ ἔγωγέ τί φημι τέλος χαριέστερον εἶναι	- u u-u u -u u- uu-uu --	dactylic hexameter	feminine penthemimeral, hepthemimeral
ἢ ὅτ’ ἐϋφροσύνη μὲν ἔχῃ κάτα δῆμον ἅπαντα,	- u u-uu- u u- uu -u u--	dactylic hexameter	masculine penthemimeral, hepthemimeral
δαιτυμόνες δ’ἀνὰ δώματ’ ἀκουάζωνται ἀοιδοῦ	-uu- uu -u u---u u--	dactylic hexameter	feminine penthemimeral, trithemimeral
ἥμενοι ἑξείης, παρὰ δὲ πλήθωσι τράπεζαι	-uu --- uu - --u u--	dactylic hexameter	masculine penthemimeral, hepthemimeral
σίτου καὶ κρειῶν, μέθυ δ’ἐκ κρητῆρος ἀφύσσων	-- - -- uu - --u u--	dactylic hexameter	masculine penthemimeral, hepthemimeral, trithemimeral
οἰνοχόος φορέῃσι καὶ ἐγχείῃ δεπάεσσι·	-uu- uu-u u --- uu--	dactylic hexameter	feminine penthemimeral, trithemimeral
τοῦτό τί μοι κάλλιστον ἐνὶ φρεσὶν εἴδεται εἶναι.	-u u - --u u- uu -uu --	dactylic hexameter	feminine penthemimeral, hepthemimeral, trithemimeral
σοὶ δ’ἐμὰ κήδεα θυμὸς ἐπετράπετο στονόεντα	- uu -uu -u u-uu- uu--	dactylic hexameter	feminine penthemimeral
εἴρεσθ’, ὄφρ’ ἔτι μᾶλλον ὀδυρόμενος στεναχίζω·	-- - uu -u u-uu- uu--	dactylic hexameter	feminine penthemimeral, trithemimeral
τί πρῶτόν τοι ἔπειτα, τί δ’ὑστάτιον καταλέξω;	- -- u u-u u -uu- uu--	dactylic hexameter	feminine penthemimeral, trithemimeral
κήδε’ ἐπεί μοι πολλὰ δόσαν θεοὶ Οὐρανίωνες.	-u u- - -u u- uu -uu--	dactylic hexameter	feminine penthemimeral, hepthemimeral, trithemimeral
νῦν δ’ὄνομα πρῶτον μυθήσομαι, ὄφρα καὶ ὑμεῖς	- uu- -- --uu -u u --	dactylic hexameter	masculine penthemimeral, trithemimeral
εἴδετ’, ἐγὼ δ’ἂν ἔπειτα φυγὼν ὕπο νηλεὲς ἦμαρ	-u u- u u-u u- uu -uu --	dactylic hexameter	feminine penthemimeral, hepthemimeral, trithemimeral
ὑμῖν ξεῖνος ἔω καὶ ἀπόπροθι δώματα ναίων.	-- -u u- u u-uu -uu --	dactylic hexameter	masculine penthemimeral
εἴμ’ Ὀδυσεὺς Λαερτιάδης, ὃς πᾶσι δόλοισιν	- uu- --uu- - -u u--	dactylic hexameter	hepthemimeral, trithemimeral
ἀνθρώποισι μέλω, καί μευ κλέος οὐρανὸν ἵκει.	---u u- - - uu -uu --	dactylic hexameter	masculine penthemimeral, hepthemimeral
ναιετάω δ’Ἰθάκην εὐδείελον· ἐν δ’ὄρος αὐτῇ	-uu- uu- --uu - uu --	dactylic hexameter	masculine penthemimeral, trithemimeral
Νήριτον εἰνοσίφυλλον, ἀριπρεπές· ἀμφὶ δὲ νῆσοι	-uu -uu-u u-uu -u u --	dactylic hexameter	feminine penthemimeral
πολλαὶ ναιετάουσι μάλα σχεδὸν ἀλλήλῃσι,	-- -uu-u u- uu ----	dactylic hexameter	feminine penthemimeral, hepthemimeral
Δουλίχιόν τε Σάμη τε καὶ ὑλήεσσα Ζάκυνθος.	-uu- u u- u u ---u u--	dactylic hexameter	masculine penthemimeral, trithemimeral
αὐτὴ δὲ χθαμαλὴ πανυπερτάτη εἰν ἁλὶ κεῖται	-- - uu- uu-uu - uu --	dactylic hexameter	masculine penthemimeral, trithemimeral
πρὸς ζόφον, αἱ δέ τ’ἄνευθε πρὸς ἠῶ τ’ἠέλιόν τε,	- uu - u u-u u -- -uu- -	dactylic hexameter	feminine penthemimeral, trithemimeral
τρηχεῖ’, ἀλλ’ ἀγαθὴ κουροτρόφος· οὔ τι ἔγωγε	-- - uu- --uu - u u--	dactylic hexameter	masculine penthemimeral, trithemimeral
ἧς γαίης δύναμαι γλυκερώτερον ἄλλο ἰδέσθαι.	- -- uu- uu-uu -u u--	dactylic hexameter	masculine penthemimeral, trithemimeral
ἦ μέν μ’αὐτόθ’ ἔρυκε Καλυψώ, δῖα θεάων,	- - -u u-u u-- -u u--	dactylic hexameter	feminine penthemimeral
ἐν σπέσσι γλαφυροῖσι, λιλαιομένη πόσιν εἶναι·	- -- uu-u u-uu- uu --	dactylic hexameter	feminine penthemimeral, trithemimeral
ὣς δ’αὔτως Κίρκη κατερήτυεν ἐν μεγάροισιν	- -- -- uu-uu - uu--	dactylic hexameter	masculine penthemimeral, trithemimeral
Αἰαίη δολόεσσα, λιλαιομένη πόσιν εἶναι·	--- uu-u u-uu- uu --	dactylic hexameter	feminine penthemimeral, trithemimeral
ἀλλ’ ἐμὸν οὔ ποτε θυμὸν ἐνὶ στήθεσσιν ἔπειθεν.	- uu - uu -u u- --u u--	dactylic hexameter	feminine penthemimeral, hepthemimeral, trithemimeral
ὣς οὐδὲν γλύκιον ἧς πατρίδος οὐδὲ τοκήων	- -- uu- - -uu -u u--	dactylic hexameter	masculine penthemimeral, trithemimeral
γίνεται, εἴ περ καί τις ἀπόπροθι πίονα οἶκον	-uu - - - u u-uu -uu --	dactylic hexameter	masculine penthemimeral, trithemimeral
γαίῃ ἐν ἀλλοδαπῇ ναίει ἀπάνευθε τοκήων.	-u u -uu- -- uu-u u--	dactylic hexameter	masculine penthemimeral, hepthemimeral
εἰ δ’ἄγε τοι καὶ νόστον ἐμὸν πολυκηδέ’ ἐνίσπω,	- uu - - -u u- uu-u u--	dactylic hexameter	feminine penthemimeral, hepthemimeral, trithemimeral
ὅν μοι Ζεὺς ἐφέηκεν ἀπὸ Τροίηθεν ἰόντι.	- - - uu-u u- --u u--	dactylic hexameter	feminine penthemimeral, hepthemimeral, trithemimeral
Ἰλιόθεν με φέρων ἄνεμος Κικόνεσσι πέλασσεν,	-uu- u u- uu- uu-u u--	dactylic hexameter	masculine penthemimeral, hepthemimeral, trithemimeral
Ἰσμάρῳ. ἔνθα δ’ἐγὼ πόλιν ἔπραθον, ὤλεσα δ’αὐτούς·	-uu -u u- uu -uu -uu --	dactylic hexameter	masculine penthemimeral
ἐκ πόλιος δ’ἀλόχους καὶ κτήματα πολλὰ λαβόντες	- uu- uu- - -uu -u u--	dactylic hexameter	masculine penthemimeral, trithemimeral
δασσάμεθ’, ὡς μή τίς μοι ἀτεμβόμενος κίοι ἴσης.	-uu - - - u u-uu- uu --	dactylic hexameter	masculine penthemimeral, trithemimeral
ἔνθ’ ἤτοι μὲν ἐγὼ διερῷ ποδὶ φευγέμεν ἡμέας	- -- u u- uu- uu -uu --	dactylic hexameter	masculine penthemimeral, hepthemimeral, trithemimeral
ἠνώγεα, τοὶ δὲ μέγα νήπιοι οὐκ ἐπίθοντο.	--- - - uu -uu - uu--	dactylic hexameter	masculine penthemimeral, trithemimeral
ἔνθα δὲ πολλὸν μὲν μέθυ πίνετο, πολλὰ δὲ μῆλα	-u u -- - uu -uu -u u --	dactylic hexameter	masculine penthemimeral
ἔσφαζον παρὰ θῖνα καὶ εἰλίποδας ἕλικας βοῦς·	--- uu -u u -uu- uu- -	dactylic hexameter	feminine penthemimeral, trithemimeral
τόφρα δ’ἄρ’ οἰχόμενοι Κίκονες Κικόνεσσι γεγώνευν,	-u u -uu- uu- uu-u u--	dactylic hexameter	masculine penthemimeral, hepthemimeral
οἵ σφιν γείτονες ἦσαν, ἅμα πλέονες καὶ ἀρείους,	- - -uu -u u- uu- u u--	dactylic hexameter	feminine penthemimeral, hepthemimeral
ἤπειρον ναίοντες, ἐπιστάμενοι μὲν ἀφ’ ἵππων	--- --u u-uu- u u --	dactylic hexameter	feminine penthemimeral, trithemimeral
ἀνδράσι μάρνασθαι καὶ ὅθι χρὴ πεζὸν ἐόντα.	-uu --- u u- - -u u--	dactylic hexameter	masculine penthemimeral, hepthemimeral
ἦλθον ἔπειθ’ ὅσα φύλλα καὶ ἄνθεα γίνεται ὥρῃ,	-u u- uu -u u -uu -uu --	dactylic hexameter	feminine penthemimeral, trithemimeral
ἠέριοι· τότε δή ῥα κακὴ Διὸς αἶσα παρέστη	-uu- uu - u u- uu -u u--	dactylic hexameter	masculine penthemimeral, hepthemimeral, trithemimeral
ἡμῖν αἰνομόροισιν, ἵν’ ἄλγεα πολλὰ πάθοιμεν.	-- -uu-u u -uu -u u--	dactylic hexameter	feminine penthemimeral
στησάμενοι δ’ἐμάχοντο μάχην παρὰ νηυσὶ θοῇσι,	-uu- uu-u u- uu -u u--	dactylic hexameter	feminine penthemimeral, hepthemimeral, trithemimeral
βάλλον δ’ἀλλήλους χαλκήρεσιν ἐγχείῃσιν.	-- --- --uu ----	dactylic hexameter	masculine penthemimeral
ὄφρα μὲν ἠὼς ἦν καὶ ἀέξετο ἱερὸν ἦμαρ,	-u u -- - u u-uu -uu --	dactylic hexameter	masculine penthemimeral
τόφρα δ’ἀλεξόμενοι μένομεν πλέονάς περ ἐόντας.	-u u-uu- uu- uu- u u--	dactylic hexameter	masculine penthemimeral, hepthemimeral
ἦμος δ’ἠέλιος μετενίσετο βουλυτόνδε,	-- -uu- uu-uu ----	dactylic hexameter	masculine penthemimeral
καὶ τότε δὴ Κίκονες κλῖναν δαμάσαντες Ἀχαιούς.	- uu - uu- -- uu-u u--	dactylic hexameter	masculine penthemimeral, hepthemimeral, trithemimeral
ἓξ δ’ἀφ’ ἑκάστης νηὸς ἐϋκνήμιδες ἑταῖροι	- u u-- -u u---u u--	dactylic hexameter	feminine penthemimeral
ὤλονθ’· οἱ δ’ἄλλοι φύγομεν θάνατόν τε μόρον τε.	-- - -- uu- uu- u u- -	dactylic hexameter	masculine penthemimeral, hepthemimeral, trithemimeral
ἔνθεν δὲ προτέρω πλέομεν ἀκαχήμενοι ἦτορ,	-- - uu- uu- uu-uu --	dactylic hexameter	masculine penthemimeral, hepthemimeral, trithemimeral
ἄσμενοι ἐκ θανάτοιο, φίλους ὀλέσαντες ἑταίρους.	-uu - uu-u u- uu-u u--	dactylic hexameter	feminine penthemimeral, hepthemimeral, trithemimeral
οὐδ’ ἄρα μοι προτέρω νῆες κίον ἀμφιέλισσαι,	- uu - uu- -- uu -uu--	dactylic hexameter	masculine penthemimeral, hepthemimeral, trithemimeral
πρίν τινα τῶν δειλῶν ἑτάρων τρὶς ἕκαστον ἀῧσαι,	- uu - -- uu- u u-u u--	dactylic hexameter	masculine penthemimeral, hepthemimeral, trithemimeral
οἳ θάνον ἐν πεδίῳ Κικόνων ὕπο δῃωθέντες.	- uu - uu- uu- uu ----	dactylic hexameter	masculine penthemimeral, hepthemimeral, trithemimeral
νηυσὶ δ’ἐπῶρσ’ ἄνεμον Βορέην νεφεληγερέτα Ζεὺς	-u u- uu- uu- uu-uu- -	dactylic hexameter	masculine penthemimeral, hepthemimeral, trithemimeral
λαίλαπι θεσπεσίῃ, σὺν δὲ νεφέεσσι κάλυψε	-uu -uu- - - uu-u u--	dactylic hexameter	masculine penthemimeral, hepthemimeral
γαῖαν ὁμοῦ καὶ πόντον· ὀρώρει δ’οὐρανόθεν νύξ.	-u u- - -u u-- -uu- -	dactylic hexameter	feminine penthemimeral, trithemimeral
αἱ μὲν ἔπειτ’ ἐφέροντ’ ἐπικάρσιαι, ἱστία δέ σφιν	- u u- uu- uu-uu -uu - -	dactylic hexameter	masculine penthemimeral, trithemimeral
τριχθά τε καὶ τετραχθὰ διέσχισεν ἲς ἀνέμοιο.	-u u - --u u-uu - uu--	dactylic hexameter	feminine penthemimeral, trithemimeral
καὶ τὰ μὲν ἐς νῆας κάθεμεν, δείσαντες ὄλεθρον,	- u u - -- uu- --u u--	dactylic hexameter	masculine penthemimeral, hepthemimeral, trithemimeral
αὐτὰς δ’ἐσσυμένως προερέσσαμεν ἤπειρόνδε.	-- -uu- uu-uu ----	dactylic hexameter	masculine penthemimeral
ἔνθα δύω νύκτας δύο τ’ἤματα συνεχὲς αἰεὶ	-u u- -- uu -uu -uu --	dactylic hexameter	masculine penthemimeral, trithemimeral
κείμεθ’, ὁμοῦ καμάτῳ τε καὶ ἄλγεσι θυμὸν ἔδοντες.	-u u- uu- u u -uu -u u--	dactylic hexameter	masculine penthemimeral, trithemimeral
ἀλλ’ ὅτε δὴ τρίτον ἦμαρ ἐϋπλόκαμος τέλεσ’ Ἠώς,	- uu - uu -u u-uu- uu --	dactylic hexameter	feminine penthemimeral, trithemimeral
ἱστοὺς στησάμενοι ἀνά θ’ἱστία λεύκ’ ἐρύσαντες	-- -uu- uu -uu - uu--	dactylic hexameter	masculine penthemimeral
ἥμεθα, τὰς δ’ἄνεμός τε κυβερνῆταί τ’ἴθυνον.	-uu - uu- u u--- ---	dactylic hexameter	masculine penthemimeral, trithemimeral
καί νύ κεν ἀσκηθὴς ἱκόμην ἐς πατρίδα γαῖαν·	- u u --- uu- - -uu --	dactylic hexameter	masculine penthemimeral, hepthemimeral
ἀλλά με κῦμα ῥόος τε περιγνάμπτοντα Μάλειαν	-u u -u u- u u---u u--	dactylic hexameter	masculine penthemimeral
καὶ Βορέης ἀπέωσε, παρέπλαγξεν δὲ Κυθήρων.	- uu- uu-u u--- u u--	dactylic hexameter	feminine penthemimeral, trithemimeral
ἔνθεν δ’ἐννῆμαρ φερόμην ὀλοοῖς ἀνέμοισι	-- --- uu- uu- uu--	dactylic hexameter	masculine penthemimeral, hepthemimeral
πόντον ἐπ’ ἰχθυόεντα· ἀτὰρ δεκάτῃ ἐπέβημεν	-u u -uu-u u- uu- uu--	dactylic hexameter	feminine penthemimeral, hepthemimeral
γαίης Λωτοφάγων, οἵ τ’ἄνθινον εἶδαρ ἔδουσιν.	-- -uu- - -uu -u u--	dactylic hexameter	masculine penthemimeral
ἔνθα δ’ἐπ’ ἠπείρου βῆμεν καὶ ἀφυσσάμεθ’ ὕδωρ,	-u u --- -- u u-uu --	dactylic hexameter	masculine penthemimeral, hepthemimeral
αἶψα δὲ δεῖπνον ἕλοντο θοῇς παρὰ νηυσὶν ἑταῖροι.	-u u -u u-u u- uu -u u--	dactylic hexameter	feminine penthemimeral, hepthemimeral
αὐτὰρ ἐπεὶ σίτοιό τ’ ἐπασσάμεθ’ ἠδὲ ποτῆτος,	-u u- --u u-uu -u u--	dactylic hexameter	feminine penthemimeral, trithemimeral
δὴ τοτ’ ἐγὼν ἑτάρους προΐειν πεύθεσθαι ἰόντας,	- u u- uu- uu- --u u--	dactylic hexameter	masculine penthemimeral, hepthemimeral, trithemimeral
οἵ τινες ἀνέρες εἶεν ἐπὶ χθονὶ σῖτον ἔδοντες	- uu -uu -u u- uu -u u--	dactylic hexameter	feminine penthemimeral, hepthemimeral
ἄνδρε δύω κρίνας, τρίτατον κήρυχ’ ἅμ’ ὀπάσσας.	-u u- -- uu- -- u u--	dactylic hexameter	masculine penthemimeral, hepthemimeral, trithemimeral
οἱ δ’αἶψ’ οἰχόμενοι μίγεν ἀνδράσι Λωτοφάγοισιν·	- - -uu- uu -uu -uu--	dactylic hexameter	masculine penthemimeral
οὐδ’ ἄρα Λωτοφάγοι μήδονθ’ ἑτάροισιν ὄλεθρον	- uu -uu- -- uu-u u--	dactylic hexameter	masculine penthemimeral, hepthemimeral
ἡμετέροις, ἀλλά σφι δόσαν λωτοῖο πάσασθαι.	-uu- -- u u- --u u--	dactylic hexameter	masculine penthemimeral, hepthemimeral, trithemimeral
τῶν δ’ὅς τις λωτοῖο φάγοι μελιηδέα καρπόν,	- - - --u u- uu-uu --	dactylic hexameter	feminine penthemimeral, hepthemimeral, trithemimeral
οὐκέτ’ ἀπαγγεῖλαι πάλιν ἤθελεν οὐδὲ νέεσθαι,	-u u--- uu -uu -u u--	dactylic hexameter	masculine penthemimeral
ἀλλ’ αὐτοῦ βούλοντο μετ’ ἀνδράσι Λωτοφάγοισι	- -- --u u -uu -uu--	dactylic hexameter	feminine penthemimeral, trithemimeral
λωτὸν ἐρεπτόμενοι μενέμεν νόστου τε λαθέσθαι.	-u u-uu- uu- -- u u--	dactylic hexameter	masculine penthemimeral, hepthemimeral
τοὺς μὲν ἐγὼν ἐπὶ νῆας ἄγον κλαίοντας ἀνάγκῃ,	- u u- uu -u u- --u u--	dactylic hexameter	feminine penthemimeral, hepthemimeral, trithemimeral
νηυσὶ δ’ἐνὶ γλαφυρῇσιν ὑπὸ ζυγὰ δῆσα ἐρύσσας.	-u u- uu-u u- uu -u u--	dactylic hexameter	feminine penthemimeral, hepthemimeral, trithemimeral
αὐτὰρ τοὺς ἄλλους κελόμην ἐρίηρας ἑταίρους	-- - -- uu- uu-u u--	dactylic hexameter	masculine penthemimeral, hepthemimeral, trithemimeral
σπερχομένους νηῶν ἐπιβαινέμεν ὠκειάων,	-uu- -- uu-uu ----	dactylic hexameter	masculine penthemimeral, trithemimeral
μή πώς τις λωτοῖο φαγὼν νόστοιο λάθηται.	- - - --u u- --u u--	dactylic hexameter	feminine penthemimeral, hepthemimeral, trithemimeral
οἱ δ’αἶψ’ εἴσβαινον καὶ ἐπὶ κληῗσι καθῖζον,	- - --- u u- --u u--	dactylic hexameter	masculine penthemimeral, hepthemimeral
ἑξῆς δ’ἑζόμενοι πολιὴν ἅλα τύπτον ἐρετμοῖς.	-- -uu- uu- uu -u u--	dactylic hexameter	masculine penthemimeral, hepthemimeral
ἔνθεν δὲ προτέρω πλέομεν ἀκαχήμενοι ἦτορ·	-- - uu- uu- uu-uu --	dactylic hexameter	masculine penthemimeral, hepthemimeral, trithemimeral
Κυκλώπων δ’ἐς γαῖαν ὑπερφιάλων ἀθεμίστων	--- - -u u-uu- uu--	dactylic hexameter	feminine penthemimeral, trithemimeral
ἱκόμεθ’, οἵ ῥα θεοῖσι πεποιθότες ἀθανάτοισιν	-uu - u u-u u-uu -uu--	dactylic hexameter	feminine penthemimeral, trithemimeral
οὔτε φυτεύουσιν χερσὶν φυτὸν οὔτ’ ἀρόωσιν,	-u u--- -- uu - uu--	dactylic hexameter	masculine penthemimeral, hepthemimeral
ἀλλὰ τά γ’ἄσπαρτα καὶ ἀνήροτα πάντα φύονται,	-u u --- u u-uu -u u--	dactylic hexameter	masculine penthemimeral
πυροὶ καὶ κριθαὶ ἠδ’ ἄμπελοι, αἵ τε φέρουσιν	-- - -- - -uu - u u--	dactylic hexameter	masculine penthemimeral, trithemimeral
οἶνον ἐριστάφυλον, καί σφιν Διὸς ὄμβρος ἀέξει.	-u u-uu- - - uu -u u--	dactylic hexameter	masculine penthemimeral, hepthemimeral
τοῖσιν δ’οὔτ’ ἀγοραὶ βουληφόροι οὔτε θέμιστες,	-- - uu- --uu -u u--	dactylic hexameter	masculine penthemimeral, trithemimeral
ἀλλ’ οἵ γ’ὑψηλῶν ὀρέων ναίουσι κάρηνα	- - --- uu- --u u--	dactylic hexameter	masculine penthemimeral, hepthemimeral
ἐν σπέσσι γλαφυροῖσι, θεμιστεύει δὲ ἕκαστος	- -- uu-u u--- u u--	dactylic hexameter	feminine penthemimeral, trithemimeral
παίδων ἠδ’ ἀλόχων, οὐδ’ ἀλλήλων ἀλέγουσι.	-- - uu- - --- uu--	dactylic hexameter	masculine penthemimeral, trithemimeral
νῆσος ἔπειτα λάχεια παρὲκ λιμένος τετάνυσται,	-u u-u u-u u- uu- uu--	dactylic hexameter	feminine penthemimeral, hepthemimeral
γαίης Κυκλώπων οὔτε σχεδὸν οὔτ’ ἀποτηλοῦ,	-- --- -- uu - uu--	dactylic hexameter	masculine penthemimeral, hepthemimeral
ὑλήεσσ’· ἐν δ’αἶγες ἀπειρέσιαι γεγάασιν	--- - -u u-uu- uu--	dactylic hexameter	feminine penthemimeral, trithemimeral
ἄγριαι· οὐ μὲν γὰρ πάτος ἀνθρώπων ἀπερύκει,	-uu - - - uu --- uu--	dactylic hexameter	masculine penthemimeral, trithemimeral
οὐδέ μιν εἰσοιχνεῦσι κυνηγέται, οἵ τε καθ’ ὕλην	-u u ---u u-uu - u u --	dactylic hexameter	feminine penthemimeral
ἄλγεα πάσχουσιν κορυφὰς ὀρέων ἐφέποντες.	-uu --- uu- uu- uu--	dactylic hexameter	masculine penthemimeral, hepthemimeral
οὔτ’ ἄρα ποίμνῃσιν καταΐσχεται οὔτ’ ἀρότοισιν,	- uu --- uu-uu - uu--	dactylic hexameter	masculine penthemimeral
ἀλλ’ ἥ γ’ἄσπαρτος καὶ ἀνήροτος ἤματα πάντα	- - --- u u-uu -uu --	dactylic hexameter	masculine penthemimeral
ἀνδρῶν χηρεύει, βόσκει δέ τε μηκάδας αἶγας.	-- --- -- u u -uu --	dactylic hexameter	masculine penthemimeral, hepthemimeral
οὐ γὰρ Κυκλώπεσσι νέες πάρα μιλτοπάρηοι,	- - ---u u- uu -uu--	dactylic hexameter	feminine penthemimeral, hepthemimeral
οὐδ’ ἄνδρες νηῶν ἔνι τέκτονες, οἵ κε κάμοιεν	- -- -- uu -uu - u u--	dactylic hexameter	masculine penthemimeral, trithemimeral
νῆας ἐϋσσέλμους, αἵ κεν τελέοιεν ἕκαστα	-u u--- - - uu-u u--	dactylic hexameter	masculine penthemimeral, hepthemimeral
ἄστε’ ἐπ’ ἀνθρώπων ἱκνεύμεναι, οἷά τε πολλὰ	-u u --- --uu -u u --	dactylic hexameter	masculine penthemimeral
ἄνδρες ἐπ’ ἀλλήλους νηυσὶ περόωσι θάλασσαν·	-u u --- -- uu-u u--	dactylic hexameter	masculine penthemimeral, hepthemimeral
οἵ κέ σφιν καὶ νῆσον ἐϋκτιμένην ἐκάμοντο.	- - - - -u u-uu- uu--	dactylic hexameter	feminine penthemimeral, trithemimeral
οὐ μὲν γάρ τι κακή γε, φέροι δέ κεν ὥρια πάντα·	- - - u u- u u- u u -uu --	dactylic hexameter	masculine penthemimeral, hepthemimeral, trithemimeral
ἐν μὲν γὰρ λειμῶνες ἁλὸς πολιοῖο παρ’ ὄχθας	- - - --u u- uu-u u --	dactylic hexameter	feminine penthemimeral, hepthemimeral, trithemimeral
ὑδρηλοὶ μαλακοί· μάλα κ’ἄφθιτοι ἄμπελοι εἶεν.	--- uu- uu -uu -uu --	dactylic hexameter	masculine penthemimeral, trithemimeral
ἐν δ’ἄροσις λείη· μάλα κεν βαθὺ λήϊον αἰεὶ	- uu- -- uu - uu -uu --	dactylic hexameter	masculine penthemimeral, hepthemimeral, trithemimeral
εἰς ὥρας ἀμῷεν, ἐπεὶ μάλα πῖαρ ὑπ’ οὖδας.	- -- --u u- uu -u u --	dactylic hexameter	feminine penthemimeral, hepthemimeral, trithemimeral
ἐν δὲ λιμὴν ἐύορμος, ἵν’ οὐ χρεὼ πείσματός ἐστιν,	- u u- uu-u u - - -uu --	dactylic hexameter	feminine penthemimeral, hepthemimeral, trithemimeral
οὔτ’ εὐνὰς βαλέειν οὔτε πρυμνήσι’ ἀνάψαι,	- -- uu- -- --u u--	dactylic hexameter	masculine penthemimeral, hepthemimeral, trithemimeral
ἀλλ’ ἐπικέλσαντας μεῖναι χρόνον εἰς ὅ κε ναυτέων	- uu--- -- uu - u u --	dactylic hexameter	masculine penthemimeral, hepthemimeral
θυμὸς ἐποτρύνῃ καὶ ἐπιπνεύσωσιν ἀῆται.	-u u--- u u---u u--	dactylic hexameter	masculine penthemimeral
αὐτὰρ ἐπὶ κρατὸς λιμένος ῥέει ἀγλαὸν ὕδωρ,	-u u- -- uu- uu -uu --	dactylic hexameter	masculine penthemimeral, hepthemimeral, trithemimeral
κρήνη ὑπὸ σπείους· περὶ δ’αἴγειροι πεφύασιν.	-u u- -- uu --- uu--	dactylic hexameter	masculine penthemimeral, trithemimeral
ἔνθα κατεπλέομεν, καί τις θεὸς ἡγεμόνευε	-u u-uu- - - uu -uu--	dactylic hexameter	masculine penthemimeral, hepthemimeral
νύκτα δι’ ὀρφναίην, οὐδὲ προυφαίνετ’ ἰδέσθαι·	-u u --- -- --u u--	dactylic hexameter	masculine penthemimeral, hepthemimeral
ἀὴρ γὰρ περὶ νηυσὶ βαθεῖ’ ἦν, οὐδὲ σελήνη	-- - uu -u u- - -u u--	dactylic hexameter	feminine penthemimeral, hepthemimeral, trithemimeral
οὐρανόθεν προύφαινε, κατείχετο δὲ νεφέεσσιν.	-uu- --u u-uu - uu--	dactylic hexameter	feminine penthemimeral, trithemimeral
ἔνθ’ οὔ τις τὴν νῆσον ἐσέδρακεν ὀφθαλμοῖσιν,	- - - - -u u-uu ----	dactylic hexameter	feminine penthemimeral, trithemimeral
οὔτ’ οὖν κύματα μακρὰ κυλινδόμενα ποτὶ χέρσον	- - -uu -u u-uu- uu --	dactylic hexameter	feminine penthemimeral
εἰσίδομεν, πρὶν νῆας ἐϋσσέλμους ἐπικέλσαι.	-uu- - -u u--- uu--	dactylic hexameter	feminine penthemimeral, trithemimeral
κελσάσῃσι δὲ νηυσὶ καθείλομεν ἱστία πάντα,	---u u -u u-uu -uu --	dactylic hexameter	feminine penthemimeral
ἐκ δὲ καὶ αὐτοὶ βῆμεν ἐπὶ ῥηγμῖνι θαλάσσης·	- u u -- -u u- --u u--	dactylic hexameter	feminine penthemimeral, hepthemimeral
ἔνθα δ’ἀποβρίξαντες ἐμείναμεν Ἠῶ δῖαν.	-u u---u u-uu -- --	dactylic hexameter	feminine penthemimeral
ἦμος δ’ἠριγένεια φάνη ῥοδοδάκτυλος Ἠώς,	-- -uu-u u- uu-uu --	dactylic hexameter	feminine penthemimeral, hepthemimeral
νῆσον θαυμάζοντες ἐδινεόμεσθα κατ’ αὐτήν.	-- ---u u-uu-u u --	dactylic hexameter	feminine penthemimeral
ὦρσαν δὲ νύμφαι, κοῦραι Διὸς αἰγιόχοιο,	-- - -- -- uu -uu--	dactylic hexameter	masculine penthemimeral, hepthemimeral, trithemimeral
αἶγας ὀρεσκῴους, ἵνα δειπνήσειαν ἑταῖροι.	-u u--- uu ---u u--	dactylic hexameter	masculine penthemimeral
αὐτίκα καμπύλα τόξα καὶ αἰγανέας δολιχαύλους	-uu -uu -u u -uu- uu--	dactylic hexameter	feminine penthemimeral
εἱλόμεθ’ ἐκ νηῶν, διὰ δὲ τρίχα κοσμηθέντες	-uu - -- uu - uu ----	dactylic hexameter	masculine penthemimeral, hepthemimeral, trithemimeral
βάλλομεν· αἶψα δὲ δῶκε θεὸς μενοεικέα θήρην.	-uu -u u -u u- uu-uu --	dactylic hexameter	feminine penthemimeral, hepthemimeral
νῆες μέν μοι ἕποντο δυώδεκα, ἐς δὲ ἑκάστην	-- - u u-u u-uu - u u--	dactylic hexameter	feminine penthemimeral, trithemimeral
ἐννέα λάγχανον αἶγες· ἐμοὶ δὲ δέκ’ ἔξελον οἴῳ.	-uu -uu -u u- u u -uu --	dactylic hexameter	feminine penthemimeral, hepthemimeral
ὣς τότε μὲν πρόπαν ἦμαρ ἐς ἠέλιον καταδύντα	- uu - uu -u u -uu- uu--	dactylic hexameter	feminine penthemimeral, trithemimeral
ἥμεθα δαινύμενοι κρέα τ’ἄσπετα καὶ μέθυ ἡδύ·	-uu -uu- uu -uu - uu --	dactylic hexameter	masculine penthemimeral
οὐ γάρ πω νηῶν ἐξέφθιτο οἶνος ἐρυθρός,	- - - -- --uu -u u--	dactylic hexameter	masculine penthemimeral, trithemimeral
ἀλλ’ ἐνέην· πολλὸν γὰρ ἐν ἀμφιφορεῦσιν ἕκαστοι	- uu- -- u u -uu-u u--	dactylic hexameter	masculine penthemimeral, trithemimeral
ἠφύσαμεν Κικόνων. ἱερὸν πτολίεθρον ἑλόντες.	-uu- uu- uu- uu-u u--	dactylic hexameter	masculine penthemimeral, hepthemimeral, trithemimeral
Κυκλώπων δ’ἐς γαῖαν ἐλεύσσομεν ἐγγὺς ἐόντων,	--- - -u u-uu -u u--	dactylic hexameter	feminine penthemimeral, trithemimeral
καπνόν τ’αὐτῶν τε φθογγὴν ὀΐων τε καὶ αἰγῶν.	-- -- - -- uu- u u --	dactylic hexameter	masculine penthemimeral, hepthemimeral
ἦμος δ’ἠέλιος κατέδυ καὶ ἐπὶ κνέφας ἦλθε,	-- -uu- uu- u u- uu --	dactylic hexameter	masculine penthemimeral, hepthemimeral
δὴ τότε κοιμήθημεν ἐπὶ ῥηγμῖνι θαλάσσης.	- uu ---u u- --u u--	dactylic hexameter	feminine penthemimeral, hepthemimeral
ἦμος δ’ἠριγένεια φάνη ῥοδοδάκτυλος Ἠώς,	-- -uu-u u- uu-uu --	dactylic hexameter	feminine penthemimeral, hepthemimeral
καὶ τότ’ ἐγὼν ἀγορὴν θέμενος μετὰ πᾶσιν ἔειπον·	- u u- uu- uu- uu -u u--	dactylic hexameter	masculine penthemimeral, hepthemimeral, trithemimeral
ἄλλοι μὲν νῦν μίμνετ’, ἐμοὶ ἐρίηρες ἑταῖροι·	-- - - -u u- uu-u u--	dactylic hexameter	feminine penthemimeral, hepthemimeral, trithemimeral
αὐτὰρ ἐγὼ σὺν νηΐ τ’ ἐμῇ καὶ ἐμοῖς ἑτάροισιν	-u u- - -u u- u u- uu--	dactylic hexameter	feminine penthemimeral, hepthemimeral, trithemimeral
ἐλθὼν τῶνδ’ ἀνδρῶν πειρήσομαι, οἵ τινές εἰσιν,	-- - -- --uu - uu --	dactylic hexameter	masculine penthemimeral, trithemimeral
ἤ ῥ’οἵ γ’ὑβρισταί τε καὶ ἄγριοι οὐδὲ δίκαιοι,	- - --- u u -uu -u u--	dactylic hexameter	masculine penthemimeral
ἦε φιλόξεινοι, καί σφιν νόος ἐστὶ θεουδής.	-u u--- - - uu -u u--	dactylic hexameter	masculine penthemimeral, hepthemimeral
ὣς εἰπὼν ἀνὰ νηὸς ἔβην, ἐκέλευσα δ’ἑταίρους	- -- uu -u u- uu-u u--	dactylic hexameter	feminine penthemimeral, hepthemimeral, trithemimeral
αὐτούς τ’ἀμβαίνειν ἀνά τε πρυμνήσια λῦσαι.	-- --- uu - --uu --	dactylic hexameter	masculine penthemimeral, hepthemimeral
οἱ δ’αἶψ’ εἴσβαινον καὶ ἐπὶ κληῗσι καθῖζον,	- - --- u u- --u u--	dactylic hexameter	masculine penthemimeral, hepthemimeral
ἑξῆς δ’ἑζόμενοι πολιὴν ἅλα τύπτον ἐρετμοῖς.	-- -uu- uu- uu -u u--	dactylic hexameter	masculine penthemimeral, hepthemimeral
ἀλλ’ ὅτε δὴ τὸν χῶρον ἀφικόμεθ’ ἐγγὺς ἐόντα,	- uu - - -u u-uu -u u--	dactylic hexameter	feminine penthemimeral, trithemimeral
ἔνθα δ’ἐπ’ ἐσχατιῇ σπέος εἴδομεν ἄγχι θαλάσσης,	-u u -uu- uu -uu -u u--	dactylic hexameter	masculine penthemimeral
ὑψηλόν, δάφνῃσι κατηρεφές. ἔνθα δὲ πολλὰ	--- --u u-uu -u u --	dactylic hexameter	feminine penthemimeral, trithemimeral
μῆλ’, ὄϊές τε καὶ αἶγες, ἰαύεσκον· περὶ δ’αὐλὴ	- uu- u u -u u--- uu --	dactylic hexameter	feminine penthemimeral, trithemimeral
ὑψηλὴ δέδμητο κατωρυχέεσσι λίθοισι	--- --u u-uu-u u--	dactylic hexameter	feminine penthemimeral, trithemimeral
μακρῇσίν τε πίτυσσιν ἰδὲ δρυσὶν ὑψικόμοισιν.	--- u u-u u- uu -uu--	dactylic hexameter	feminine penthemimeral, hepthemimeral, trithemimeral
ἔνθα δ’ἀνὴρ ἐνίαυε πελώριος, ὅς ῥα τὰ μῆλα	-u u- uu-u u-uu - u u --	dactylic hexameter	feminine penthemimeral, trithemimeral
οἶος ποιμαίνεσκεν ἀπόπροθεν· οὐδὲ μετ’ ἄλλους	-- ---u u-uu -u u --	dactylic hexameter	feminine penthemimeral
πωλεῖτ’, ἀλλ’ ἀπάνευθεν ἐὼν ἀθεμίστια ᾔδη.	-- - uu-u u- uu-uu --	dactylic hexameter	feminine penthemimeral, hepthemimeral, trithemimeral
καὶ γὰρ θαῦμ’ ἐτέτυκτο πελώριον, οὐδὲ ἐῴκει	- - - uu-u u-uu -u u--	dactylic hexameter	feminine penthemimeral, trithemimeral
ἀνδρί γε σιτοφάγῳ, ἀλλὰ ῥίῳ ὑλήεντι	-u u -uu- -- uu ----	dactylic hexameter	masculine penthemimeral, hepthemimeral
ὑψηλῶν ὀρέων, ὅ τε φαίνεται οἶον ἀπ’ ἄλλων.	--- uu- u u -uu -u u --	dactylic hexameter	masculine penthemimeral, trithemimeral
δὴ τότε τοὺς ἄλλους κελόμην ἐρίηρας ἑταίρους	- uu - -- uu- uu-u u--	dactylic hexameter	masculine penthemimeral, hepthemimeral, trithemimeral
αὐτοῦ πὰρ&nnbsp;νηΐ τε μένειν καὶ νῆα ἔρυσθαι,	-- --- u u- - -u u--	dactylic hexameter	masculine penthemimeral, hepthemimeral
αὐτὰρ ἐγὼ κρίνας ἑτάρων δυοκαίδεκ’ ἀρίστους	-u u- -- uu- uu-u u--	dactylic hexameter	masculine penthemimeral, hepthemimeral, trithemimeral
βῆν· ἀτὰρ αἴγεον ἀσκὸν ἔχον μέλανος οἴνοιο	- uu -uu -u u- uu- ---	dactylic hexameter	feminine penthemimeral, hepthemimeral
ἡδέος, ὅν μοι ἔδωκε Μάρων, Εὐάνθεος υἱός,	-uu - u u-u u- --uu --	dactylic hexameter	feminine penthemimeral, hepthemimeral, trithemimeral
ἱρεὺς Ἀπόλλωνος, ὃς Ἴσμαρον ἀμφιβεβήκει,	-- ---u u -uu -uu--	dactylic hexameter	feminine penthemimeral
οὕνεκά μιν σὺν παιδὶ περισχόμεθ’ ἠδὲ γυναικὶ	-uu - - -u u-uu -u u--	dactylic hexameter	feminine penthemimeral, trithemimeral
ἁζόμενοι· ᾤκει γὰρ ἐν ἄλσεϊ δενδρήεντι	-uu- -- u u -uu ----	dactylic hexameter	masculine penthemimeral, trithemimeral
Φοίβου Ἀπόλλωνος. ὁ δέ μοι πόρεν ἀγλαὰ δῶρα·	-u u--- u u - uu -uu --	dactylic hexameter	masculine penthemimeral, hepthemimeral
χρυσοῦ μέν μοι δῶκ’ εὐεργέος ἑπτὰ τάλαντα,	-- - - - --uu -u u--	dactylic hexameter	masculine penthemimeral, trithemimeral
δῶκε δέ μοι κρητῆρα πανάργυρον, αὐτὰρ ἔπειτα	-u u - --u u-uu -u u--	dactylic hexameter	feminine penthemimeral, trithemimeral
οἶνον ἐν ἀμφιφορεῦσι δυώδεκα πᾶσιν ἀφύσσας	-u u -uu-u u-uu -u u--	dactylic hexameter	feminine penthemimeral
ἡδὺν ἀκηράσιον, θεῖον ποτόν· οὐδέ τις αὐτὸν	-u u-uu- -- uu -u u --	dactylic hexameter	masculine penthemimeral, hepthemimeral
ἠείδει δμώων οὐδ’ ἀμφιπόλων ἐνὶ οἴκῳ,	--- -- - -uu- uu --	dactylic hexameter	masculine penthemimeral, trithemimeral
ἀλλ’ αὐτὸς ἄλοχός τε φίλη ταμίη τε μί’ οἴη.	- -- uu- u u- uu- u u --	dactylic hexameter	masculine penthemimeral, hepthemimeral, trithemimeral
τὸν δ’ὅτε πίνοιεν μελιηδέα οἶνον ἐρυθρόν,	- uu --- uu-uu -u u--	dactylic hexameter	masculine penthemimeral
ἓν δέπας ἐμπλήσας ὕδατος ἀνὰ εἴκοσι μέτρα	- uu --- uu- uu -uu --	dactylic hexameter	masculine penthemimeral, hepthemimeral
χεῦ’, ὀδμὴ δ’ἡδεῖα ἀπὸ κρητῆρος ὀδώδει	- -- --u u- --u u--	dactylic hexameter	feminine penthemimeral, hepthemimeral, trithemimeral
θεσπεσίη· τότ’ ἂν οὔ τοι ἀποσχέσθαι φίλον ἦεν.	-uu- u u - u u--- uu --	dactylic hexameter	masculine penthemimeral, trithemimeral
τοῦ φέρον ἐμπλήσας ἀσκὸν μέγαν, ἐν δὲ καὶ ᾖα	- uu --- -- uu - u u --	dactylic hexameter	masculine penthemimeral, hepthemimeral
κωρύκῳ· αὐτίκα γάρ μοι ὀΐσατο θυμὸς ἀγήνωρ	-uu -uu - u u-uu -u u--	dactylic hexameter	masculine penthemimeral
ἄνδρ’ ἐπελεύσεσθαι μεγάλην ἐπιειμένον ἀλκήν,	- uu--- uu- uu-uu --	dactylic hexameter	masculine penthemimeral, hepthemimeral
ἄγριον, οὔτε δίκας ἐῢ εἰδότα οὔτε θέμιστας.	-uu -u u- uu -uu -u u--	dactylic hexameter	masculine penthemimeral
καρπαλίμως δ’εἰς ἄντρον ἀφικόμεθ’, οὐδέ μιν ἔνδον	-uu- - -u u-uu -u u --	dactylic hexameter	feminine penthemimeral, trithemimeral
εὕρομεν, ἀλλ’ ἐνόμευε νομὸν κάτα πίονα μῆλα.	-uu - uu-u u- uu -uu --	dactylic hexameter	feminine penthemimeral, hepthemimeral, trithemimeral
ἐλθόντες δ’εἰς ἄντρον ἐθηεύμεσθα ἕκαστα.	--- - -u u---u u--	dactylic hexameter	feminine penthemimeral, trithemimeral
ταρσοὶ μὲν τυρῶν βρῖθον, στείνοντο δὲ σηκοὶ	-- - -- -- --u u --	dactylic hexameter	masculine penthemimeral, hepthemimeral, trithemimeral
ἀρνῶν ἠδ’ ἐρίφων· διακεκριμέναι δὲ ἕκασται	-- - uu- uu-uu- u u--	dactylic hexameter	masculine penthemimeral, trithemimeral
ἔρχατο, χωρὶς μὲν πρόγονοι, χωρὶς δὲ μέτασσαι,	-uu -- - uu- -- u u--	dactylic hexameter	masculine penthemimeral, hepthemimeral
χωρὶς δ’αὖθ’ ἕρσαι. ναῖον δ’ὀρῷ ἄγγεα πάντα,	-- - -- -- uu -uu --	dactylic hexameter	masculine penthemimeral, hepthemimeral, trithemimeral
γαυλοί τε σκαφίδες τε, τετυγμένα, τοῖς ἐνάμελγεν.	-- - uu- u u-uu - uu--	dactylic hexameter	masculine penthemimeral, trithemimeral
ἔνθ’ ἐμὲ μὲν πρώτισθ’ ἕταροι λίσσοντ’ ἐπέεσσι	- uu - -- uu- -- uu--	dactylic hexameter	masculine penthemimeral, hepthemimeral, trithemimeral
τυρῶν αἰνυμένους ἰέναι πάλιν, αὐτὰρ ἔπειτα	-- -uu- uu- uu -u u--	dactylic hexameter	masculine penthemimeral, hepthemimeral
καρπαλίμως ἐπὶ νῆα θοὴν ἐρίφους τε καὶ ἄρνας	-uu- uu -u u- uu- u u --	dactylic hexameter	feminine penthemimeral, hepthemimeral, trithemimeral
σηκῶν ἐξελάσαντας ἐπιπλεῖν ἁλμυρὸν ὕδωρ·	-- -uu-u u-- -uu --	dactylic hexameter	feminine penthemimeral
ἀλλ’ ἐγὼ οὐ πιθόμην, ἦ τ’ἂν πολὺ κέρδιον ἦεν,	- uu - uu- - - uu -uu --	dactylic hexameter	masculine penthemimeral, hepthemimeral, trithemimeral
ὄφρ’ αὐτόν τε ἴδοιμι, καὶ εἴ μοι ξείνια δοίη.	- -- u u-u u - - -uu --	dactylic hexameter	feminine penthemimeral, hepthemimeral, trithemimeral
οὐδ’ ἄρ’ ἔμελλ’ ἑτάροισι φανεὶς ἐρατεινὸς ἔσεσθαι.	- u u- uu-u u- uu-u u--	dactylic hexameter	feminine penthemimeral, hepthemimeral, trithemimeral
ἔνθα δὲ πῦρ κείαντες ἐθύσαμεν ἠδὲ καὶ αὐτοὶ	-u u - --u u-uu -u u --	dactylic hexameter	feminine penthemimeral, trithemimeral
τυρῶν αἰνύμενοι φάγομεν, μένομέν τέ μιν ἔνδον	-- -uu- uu- uu- u u --	dactylic hexameter	masculine penthemimeral, hepthemimeral
ἥμενοι, ἦος ἐπῆλθε νέμων. φέρε δ’ὄβριμον ἄχθος	-uu -u u-u u- uu -uu --	dactylic hexameter	feminine penthemimeral, hepthemimeral
ὕλης ἀζαλέης, ἵνα οἱ ποτιδόρπιον εἴη,	-- -uu- uu - uu-uu --	dactylic hexameter	masculine penthemimeral, hepthemimeral
ἔκτοσθεν δ’ἄντροιο βαλὼν ὀρυμαγδὸν ἔθηκεν·	--- --u u- uu-u u--	dactylic hexameter	feminine penthemimeral, hepthemimeral, trithemimeral
ἡμεῖς δὲ δείσαντες ἀπεσσύμεθ’ ἐς μυχὸν ἄντρου.	-- - --u u-uu - uu --	dactylic hexameter	feminine penthemimeral, trithemimeral
αὐτὰρ ὅ γ’εἰς εὐρὺ σπέος ἤλασε πίονα μῆλα	-u u - -- uu -uu -uu --	dactylic hexameter	masculine penthemimeral, trithemimeral
πάντα μάλ’ ὅσσ’ ἤμελγε, τὰ δ’ἄρσενα λεῖπε θύρηφι,	-u u - --u u -uu -u u--	dactylic hexameter	feminine penthemimeral, trithemimeral
ἀρνειούς τε τράγους τε, βαθείης ἔκτοθεν αὐλῆς.	--- u u- u u-- -uu --	dactylic hexameter	masculine penthemimeral, trithemimeral
αὐτὰρ ἔπειτ’ ἐπέθηκε θυρεὸν μέγαν ὑψόσ’ ἀείρας,	-u u- uu-u u- uu -u u--	dactylic hexameter	feminine penthemimeral, hepthemimeral, trithemimeral
ὄβριμον· οὐκ ἂν τόν γε δύω καὶ εἴκοσ’ ἄμαξαι	-uu - - - u u- - -u u--	dactylic hexameter	masculine penthemimeral, hepthemimeral, trithemimeral
ἐσθλαὶ τετράκυκλοι ἀπ’ οὔδεος ὀχλίσσειαν·	-- -uu- - -uu ----	dactylic hexameter	masculine penthemimeral
τόσσην ἠλίβατον πέτρην ἐπέθηκε θύρῃσιν.	-- -uu- -- uu-u u--	dactylic hexameter	masculine penthemimeral, hepthemimeral
ἑζόμενος δ’ἤμελγεν ὄϊς καὶ μηκάδας αἶγας,	-uu- --u u- - -uu --	dactylic hexameter	feminine penthemimeral, hepthemimeral, trithemimeral
πάντα κατὰ μοῖραν, καὶ ὑπ’ ἔμβρυον ἧκεν ἑκάστῃ.	-u u- -- u u -uu -u u--	dactylic hexameter	masculine penthemimeral, trithemimeral
αὐτίκα δ’ἥμισυ μὲν θρέψας λευκοῖο γάλακτος	-uu -uu - -- --u u--	dactylic hexameter	masculine penthemimeral, hepthemimeral
πλεκτοῖς ἐν ταλάροισιν ἀμησάμενος κατέθηκεν,	-- - uu-u u-uu- uu--	dactylic hexameter	feminine penthemimeral, trithemimeral
ἥμισυ δ’αὖτ’ ἔστησεν ἐν ἄγγεσιν, ὄφρα οἱ εἴη	-uu - --u u -uu -u u --	dactylic hexameter	feminine penthemimeral, trithemimeral
πίνειν αἰνυμένῳ καί οἱ ποτιδόρπιον εἴη.	-- -uu- - - uu-uu --	dactylic hexameter	masculine penthemimeral, hepthemimeral
αὐτὰρ ἐπεὶ δὴ σπεῦσε πονησάμενος τὰ ἃ ἔργα,	-u u- - -u u-uu- u u --	dactylic hexameter	feminine penthemimeral, trithemimeral
καὶ τότε πῦρ ἀνέκαιε καὶ εἴσιδεν, εἴρετο δ’ἡμέας·	- uu - uu-u u -uu -uu --	dactylic hexameter	feminine penthemimeral, trithemimeral
ὦ ξεῖνοι, τίνες ἐστέ; πόθεν πλεῖθ’ ὑγρὰ κέλευθα;	- -- uu -u u- - -u u--	dactylic hexameter	feminine penthemimeral, hepthemimeral, trithemimeral
ἤ τι κατὰ πρῆξιν ἦ μαψιδίως ἀλάλησθε,	- u u- -- - -uu- uu--	dactylic hexameter	masculine penthemimeral, trithemimeral
οἷά τε ληϊστῆρες, ὑπεὶρ ἅλα, τοί τ’ἀλόωνται	-u u ---u u- uu - uu--	dactylic hexameter	feminine penthemimeral, hepthemimeral
ψυχὰς παρθέμενοι κακὸν ἀλλοδαποῖσι φέροντες;	-- -uu- uu -uu-u u--	dactylic hexameter	masculine penthemimeral
ὣς ἔφαθ’, ἡμῖν δ’αὖτε κατεκλάσθη φίλον ἦτορ,	- uu -- -u u--- uu --	dactylic hexameter	feminine penthemimeral
δεισάντων φθόγγον τε βαρὺν αὐτόν τε πέλωρον.	--- -- u u- -- u u--	dactylic hexameter	masculine penthemimeral, hepthemimeral, trithemimeral
ἀλλὰ καὶ ὥς μιν ἔπεσσιν ἀμειβόμενος προσέειπον·	-u u - u u-u u-uu- uu--	dactylic hexameter	feminine penthemimeral, trithemimeral
ἡμεῖς τοι Τροίηθεν ἀποπλαγχθέντες Ἀχαιοὶ	-- - --u u---u u--	dactylic hexameter	feminine penthemimeral, trithemimeral
παντοίοις ἀνέμοισιν ὑπὲρ μέγα λαῖτμα θαλάσσης,	--- uu-u u- uu -u u--	dactylic hexameter	feminine penthemimeral, hepthemimeral, trithemimeral
οἴκαδε ἱέμενοι, ἄλλην ὁδὸν ἄλλα κέλευθα	-uu -uu- -- uu -u u--	dactylic hexameter	masculine penthemimeral, hepthemimeral
ἤλθομεν· οὕτω που Ζεὺς ἤθελε μητίσασθαι.	-uu -- - - -uu ----	dactylic hexameter	masculine penthemimeral
λαοὶ δ’Ἀτρεΐδεω Ἀγαμέμνονος εὐχόμεθ’ εἶναι,	-- -uu- uu-uu -uu --	dactylic hexameter	masculine penthemimeral
τοῦ δὴ νῦν γε μέγιστον ὑπουράνιον κλέος ἐστί·	- - - u u-u u-uu- uu --	dactylic hexameter	feminine penthemimeral, trithemimeral
τόσσην γὰρ διέπερσε πόλιν καὶ ἀπώλεσε λαοὺς	-- - uu-u u- u u-uu --	dactylic hexameter	feminine penthemimeral, hepthemimeral, trithemimeral
πολλούς. ἡμεῖς δ’αὖτε κιχανόμενοι τὰ σὰ γοῦνα	-- -- -u u-uu- u u --	dactylic hexameter	feminine penthemimeral
ἱκόμεθ’, εἴ τι πόροις ξεινήϊον ἠὲ καὶ ἄλλως	-uu - u u- --uu -u u --	dactylic hexameter	masculine penthemimeral, trithemimeral
δοίης δωτίνην, ἥ τε ξείνων θέμις ἐστίν.	-- --- - - -- uu --	dactylic hexameter	masculine penthemimeral, hepthemimeral
ἀλλ’ αἰδεῖο, φέριστε, θεούς· ἱκέται δέ τοί εἰμεν,	- --u u-u u- uu- u u --	dactylic hexameter	feminine penthemimeral, hepthemimeral
Ζεὺς δ’ἐπιτιμήτωρ ἱκετάων τε ξείνων τε,	- uu--- uu-- - -- -	dactylic hexameter	masculine penthemimeral
ξείνιος, ὃς ξείνοισιν ἅμ’ αἰδοίοισιν ὀπηδεῖ.	-uu - --u u ---u u--	dactylic hexameter	feminine penthemimeral, trithemimeral
ὣς ἐφάμην, ὁ δέ μ’αὐτίκ’ ἀμείβετο νηλέϊ θυμῷ·	- uu- u u -u u-uu -uu --	dactylic hexameter	feminine penthemimeral, trithemimeral
νήπιός εἰς, ὦ ξεῖν’, ἢ τηλόθεν εἰλήλουθας,	-uu - - - - -uu ----	dactylic hexameter	masculine penthemimeral, trithemimeral
ὅς με θεοὺς κέλεαι ἢ δειδίμεν ἢ ἀλέασθαι·	- u u- uu- - -uu - uu--	dactylic hexameter	masculine penthemimeral, trithemimeral
οὐ γὰρ Κύκλωπες Διὸς αἰγιόχου ἀλέγουσιν	- - --- uu -uu- uu--	dactylic hexameter	masculine penthemimeral
οὐδὲ θεῶν μακάρων, ἐπεὶ ἦ πολὺ φέρτεροί εἰμεν·	-u u- uu- uu - uu -uu --	dactylic hexameter	masculine penthemimeral, hepthemimeral, trithemimeral
οὐδ’ ἂν ἐγὼ Διὸς ἔχθος ἀλευάμενος πεφιδοίμην	- u u- uu -u u-uu- uu--	dactylic hexameter	feminine penthemimeral, trithemimeral
οὔτε σεῦ οὔθ’ ἑτάρων, εἰ μὴ θυμός με κελεύοι.	-u u - uu- - - -- u u--	dactylic hexameter	masculine penthemimeral, hepthemimeral, trithemimeral
ἀλλά μοι εἴφ’ ὅπῃ ἔσχες ἰὼν εὐεργέα νῆα,	-u u - uu -u u- --uu --	dactylic hexameter	feminine penthemimeral, hepthemimeral, trithemimeral
ἤ που ἐπ’ ἐσχατιῆς, ἦ καὶ σχεδόν, ὄφρα δαείω.	- u u -uu- - - uu -u u--	dactylic hexameter	masculine penthemimeral, hepthemimeral
ὣς φάτο πειράζων, ἐμὲ δ’οὐ λάθεν εἰδότα πολλά,	- uu --- uu - uu -uu --	dactylic hexameter	masculine penthemimeral, hepthemimeral
ἀλλά μιν ἄψορρον προσέφην δολίοις ἐπέεσσι·	-u u --- uu- uu- uu--	dactylic hexameter	masculine penthemimeral, hepthemimeral
νέα μέν μοι κατέαξε Ποσειδάων ἐνοσίχθων	- - - uu-u u--- uu--	dactylic hexameter	feminine penthemimeral, trithemimeral
πρὸς πέτρῃσι βαλὼν ὑμῆς ἐπὶ πείρασι γαίης,	- --u u- -- uu -uu --	dactylic hexameter	masculine penthemimeral, hepthemimeral
ἄκρῃ προσπελάσας· ἄνεμος δ’ἐκ πόντου ἔνεικεν·	-- -uu- uu- - -u u--	dactylic hexameter	masculine penthemimeral, hepthemimeral
αὐτὰρ ἐγὼ σὺν τοῖσδε ὑπέκφυγον αἰπὺν ὄλεθρον.	-u u- - -u u-uu -u u--	dactylic hexameter	feminine penthemimeral, trithemimeral
ὣς ἐφάμην, ὁ δέ μ’οὐδὲν ἀμείβετο νηλέϊ θυμῷ,	- uu- u u -u u-uu -uu --	dactylic hexameter	feminine penthemimeral, trithemimeral
ἀλλ’ ὅ γ’ἀναΐξας ἑτάροις ἐπὶ χεῖρας ἴαλλε,	- u u--- uu- uu -u u--	dactylic hexameter	masculine penthemimeral, hepthemimeral
σὺν δὲ δύω μάρψας ὥς τε σκύλακας ποτὶ γαίῃ	- u u- -- - - uu- uu --	dactylic hexameter	masculine penthemimeral, hepthemimeral, trithemimeral
κόπτ’· ἐκ δ’ἐγκέφαλος χαμάδις ῥέε, δεῦε δὲ γαῖαν.	- - -uu- uu- uu -u u --	dactylic hexameter	masculine penthemimeral, hepthemimeral
τοὺς δὲ διὰ μελεϊστὶ ταμὼν ὡπλίσσατο δόρπον·	- u u- uu-u u- --uu --	dactylic hexameter	feminine penthemimeral, hepthemimeral, trithemimeral
ἤσθιε δ’ὥς τε λέων ὀρεσίτροφος, οὐδ’ ἀπέλειπεν,	-uu - u u- uu-uu - uu--	dactylic hexameter	masculine penthemimeral, trithemimeral
ἔγκατά τε σάρκας τε καὶ ὀστέα μυελόεντα.	-uu - -- u u -uu -uu--	dactylic hexameter	masculine penthemimeral, trithemimeral
ἡμεῖς δὲ κλαίοντες ἀνεσχέθομεν Διῒ χεῖρας,	-- - --u u-uu- uu --	dactylic hexameter	feminine penthemimeral, trithemimeral
σχέτλια ἔργ’ ὁρόωντες, ἀμηχανίη δ’ἔχε θυμόν.	-uu - uu-u u-uu- uu --	dactylic hexameter	feminine penthemimeral, trithemimeral
αὐτὰρ ἐπεὶ Κύκλωψ μεγάλην ἐμπλήσατο νηδὺν	-u u- -- uu- --uu --	dactylic hexameter	masculine penthemimeral, hepthemimeral, trithemimeral
ἀνδρόμεα κρέ’ ἔδων καὶ ἐπ’ ἄκρητον γάλα πίνων,	-uu- u u- u u --- uu --	dactylic hexameter	masculine penthemimeral, trithemimeral
κεῖτ’ ἔντοσθ’ ἄντροιο τανυσσάμενος διὰ μήλων.	- -- --u u-uu- uu --	dactylic hexameter	feminine penthemimeral, trithemimeral
τὸν μὲν ἐγὼ βούλευσα κατὰ μεγαλήτορα θυμὸν	- u u- --u u- uu-uu --	dactylic hexameter	feminine penthemimeral, hepthemimeral, trithemimeral
ἆσσον ἰών, ξίφος ὀξὺ ἐρυσσάμενος παρὰ μηροῦ,	-u u- uu -u u-uu- uu --	dactylic hexameter	feminine penthemimeral, trithemimeral
οὐτάμεναι πρὸς στῆθος, ὅθι φρένες ἧπαρ ἔχουσι,	-uu- - -u u- uu -u u--	dactylic hexameter	feminine penthemimeral, hepthemimeral, trithemimeral
χείρ’ ἐπιμασσάμενος· ἕτερος δέ με θυμὸς ἔρυκεν.	- uu-uu- uu- u u -u u--	dactylic hexameter	masculine penthemimeral, hepthemimeral
αὐτοῦ γάρ κε καὶ ἄμμες ἀπωλόμεθ’ αἰπὺν ὄλεθρον·	-- - u u -u u-uu -u u--	dactylic hexameter	feminine penthemimeral, trithemimeral
οὐ γάρ κεν δυνάμεσθα θυράων ὑψηλάων	- - - uu-u u-- ----	dactylic hexameter	feminine penthemimeral, trithemimeral
χερσὶν ἀπώσασθαι λίθον ὄβριμον, ὃν προσέθηκεν.	-u u--- uu -uu - uu--	dactylic hexameter	masculine penthemimeral
ὣς τότε μὲν στενάχοντες ἐμείναμεν Ἠῶ δῖαν.	- uu - uu-u u-uu -- --	dactylic hexameter	feminine penthemimeral, trithemimeral
ἦμος δ’ἠριγένεια φάνη ῥοδοδάκτυλος Ἠώς,	-- -uu-u u- uu-uu --	dactylic hexameter	feminine penthemimeral, hepthemimeral
καὶ τότε πῦρ ἀνέκαιε καὶ ἤμελγε κλυτὰ μῆλα,	- uu - uu-u u --- uu --	dactylic hexameter	feminine penthemimeral, trithemimeral
πάντα κατὰ μοῖραν, καὶ ὑπ’ ἔμβρυον ἧκεν ἑκάστῃ.	-u u- -- u u -uu -u u--	dactylic hexameter	masculine penthemimeral, trithemimeral
αὐτὰρ ἐπεὶ δὴ σπεῦσε πονησάμενος τὰ ἃ ἔργα,	-u u- - -u u-uu- u u --	dactylic hexameter	feminine penthemimeral, trithemimeral
σὺν δ’ὅ γε δ’αὖτε δύω μάρψας ὡπλίσσατο δεῖπνον.	- u u -u u- -- --uu --	dactylic hexameter	masculine penthemimeral, hepthemimeral
δειπνήσας δ’ἄντρου ἐξήλασε πίονα μῆλα,	--- -- --uu -uu --	dactylic hexameter	masculine penthemimeral, trithemimeral
ῥηϊδίως ἀφελὼν θυρεὸν μέγαν· αὐτὰρ ἔπειτα	-uu- uu- uu- uu -u u--	dactylic hexameter	masculine penthemimeral, hepthemimeral, trithemimeral
ἂψ ἐπέθηχ’, ὡς εἴ τε φαρέτρῃ πῶμ’ ἐπιθείη.	- uu- - - u u-- - uu--	dactylic hexameter	masculine penthemimeral, trithemimeral
πολλῇ δὲ ῥοίζῳ πρὸς ὄρος τρέπε πίονα μῆλα	-- - -- u u- uu -uu --	dactylic hexameter	masculine penthemimeral, hepthemimeral, trithemimeral
Κύκλωψ· αὐτὰρ ἐγὼ λιπόμην κακὰ βυσσοδομεύων,	-- -u u- uu- uu -uu--	dactylic hexameter	masculine penthemimeral, hepthemimeral
εἴ πως τισαίμην, δοίη δέ μοι εὖχος Ἀθήνη.	- - --- -- u u -u u--	dactylic hexameter	masculine penthemimeral, hepthemimeral
ἥδε δέ μοι κατὰ θυμὸν ἀρίστη φαίνετο βουλή.	-u u - uu -u u-- -uu --	dactylic hexameter	feminine penthemimeral, trithemimeral
Κύκλωπος γὰρ ἔκειτο μέγα ῥόπαλον παρὰ σηκῷ,	--- u u-u u- uu- uu --	dactylic hexameter	feminine penthemimeral, hepthemimeral, trithemimeral
χλωρὸν ἐλαΐνεον· τὸ μὲν ἔκταμεν, ὄφρα φοροίη	-u u-uu- u u -uu -u u--	dactylic hexameter	masculine penthemimeral
αὐανθέν. τὸ μὲν ἄμμες ἐΐσκομεν εἰσορόωντες	--- u u -u u-uu -uu--	dactylic hexameter	feminine penthemimeral, trithemimeral
ὅσσον θ’ἱστὸν νηὸς ἐεικοσόροιο μελαίνης,	-- -- -u u-uu-u u--	dactylic hexameter	feminine penthemimeral
φορτίδος εὐρείης, ἥ τ’ἐκπεράᾳ μέγα λαῖτμα·	-uu --- - -uu- uu --	dactylic hexameter	masculine penthemimeral
τόσσον ἔην μῆκος, τόσσον πάχος εἰσοράασθαι.	-u u- -- -- uu -uu--	dactylic hexameter	masculine penthemimeral, hepthemimeral, trithemimeral
τοῦ μὲν ὅσον τ’ὄργυιαν ἐγὼν ἀπέκοψα παραστὰς	- u u- --u u- uu-u u--	dactylic hexameter	feminine penthemimeral, hepthemimeral, trithemimeral
καὶ παρέθηχ’ ἑτάροισιν, ἀποξῦναι δ’ἐκέλευσα·	- uu- uu-u u--- uu--	dactylic hexameter	feminine penthemimeral, trithemimeral
οἱ δ’ὁμαλὸν ποίησαν· ἐγὼ δ’ἐθόωσα παραστὰς	- uu- --u u- uu-u u--	dactylic hexameter	feminine penthemimeral, hepthemimeral, trithemimeral
ἄκρον, ἄφαρ δὲ λαβὼν ἐπυράκτεον ἐν πυρὶ κηλέῳ.	-u u- u u- uu-uu - uu --	dactylic hexameter	masculine penthemimeral, trithemimeral
καὶ τὸ μὲν εὖ κατέθηκα κατακρύψας ὑπὸ κόπρῳ,	- u u - uu-u u--- uu --	dactylic hexameter	feminine penthemimeral, trithemimeral
ἥ ῥα κατὰ σπείους κέχυτο μεγάλ’ ἤλιθα πολλή·	- u u- -- uu- uu -uu --	dactylic hexameter	masculine penthemimeral, hepthemimeral, trithemimeral
αὐτὰρ τοὺς ἄλλους κλήρῳ πεπαλάχθαι ἄνωγον,	-- - -- -- uu-u u--	dactylic hexameter	masculine penthemimeral, hepthemimeral, trithemimeral
ὅς τις τολμήσειεν ἐμοὶ σὺν μοχλὸν ἀείρας	- - ---u u- - -u u--	dactylic hexameter	feminine penthemimeral, hepthemimeral
τρῖψαι ἐν ὀφθαλμῷ, ὅτε τὸν γλυκὺς ὕπνος ἱκάνοι.	-u u --- uu - uu -u u--	dactylic hexameter	masculine penthemimeral, hepthemimeral
οἱ δ’ἔλαχον τοὺς ἄν κε καὶ ἤθελον αὐτὸς ἑλέσθαι,	- uu- - - u u -uu -u u--	dactylic hexameter	masculine penthemimeral, trithemimeral
τέσσαρες, αὐτὰρ ἐγὼ πέμπτος μετὰ τοῖσιν ἐλέγμην.	-uu -u u- -- uu -u u--	dactylic hexameter	masculine penthemimeral, hepthemimeral
ἑσπέριος δ’ἦλθεν καλλίτριχα μῆλα νομεύων.	-uu- -- --uu -u u--	dactylic hexameter	masculine penthemimeral, trithemimeral
αὐτίκα δ’εἰς εὐρὺ σπέος ἤλασε πίονα μῆλα	-uu - -- uu -uu -uu --	dactylic hexameter	masculine penthemimeral, trithemimeral
πάντα μάλ’, οὐδέ τι λεῖπε βαθείης ἔκτοθεν αὐλῆς,	-u u -u u -u u-- -uu --	dactylic hexameter	feminine penthemimeral
ἤ τι ὀϊσάμενος, ἢ καὶ θεὸς ὣς ἐκέλευσεν.	- u u-uu- - - uu - uu--	dactylic hexameter	masculine penthemimeral, hepthemimeral
αὐτὰρ ἔπειτ’ ἐπέθηκε θυρεὸν μέγαν ὑψόσ’ ἀείρας,	-u u- uu-u u- uu -u u--	dactylic hexameter	feminine penthemimeral, hepthemimeral, trithemimeral
ἑζόμενος δ’ἤμελγεν ὄϊς καὶ μηκάδας αἶγας,	-uu- --u u- - -uu --	dactylic hexameter	feminine penthemimeral, hepthemimeral, trithemimeral
πάντα κατὰ μοῖραν, καὶ ὑπ’ ἔμβρυον ἧκεν ἑκάστῃ.	-u u- -- u u -uu -u u--	dactylic hexameter	masculine penthemimeral, trithemimeral
αὐτὰρ ἐπεὶ δὴ σπεῦσε πονησάμενος τὰ ἃ ἔργα,	-u u- - -u u-uu- u u --	dactylic hexameter	feminine penthemimeral, trithemimeral
σὺν δ’ὅ γε δ’αὖτε δύω μάρψας ὡπλίσσατο δόρπον.	- u u -u u- -- --uu --	dactylic hexameter	masculine penthemimeral, hepthemimeral
καὶ τότ’ ἐγὼ Κύκλωπα προσηύδων ἄγχι παραστάς,	- u u- --u u-- -u u--	dactylic hexameter	feminine penthemimeral, trithemimeral
κισσύβιον μετὰ χερσὶν ἔχων μέλανος οἴνοιο·	-uu- uu -u u- uu- ---	dactylic hexameter	feminine penthemimeral, hepthemimeral, trithemimeral
Κύκλωψ, τῆ, πίε οἶνον, ἐπεὶ φάγες ἀνδρόμεα κρέα,	-- - uu -u u- uu -uu- -	dactylic hexameter	feminine penthemimeral, hepthemimeral, trithemimeral
ὄφρ’ εἰδῇς οἷόν τι ποτὸν τόδε νηῦς ἐκεκεύθει	- -- -- u u- uu - uu--	dactylic hexameter	masculine penthemimeral, hepthemimeral, trithemimeral
ἡμετέρη. σοὶ δ’αὖ λοιβὴν φέρον, εἴ μ’ἐλεήσας	-uu- - - -- uu - uu--	dactylic hexameter	masculine penthemimeral, hepthemimeral, trithemimeral
οἴκαδε πέμψειας· σὺ δὲ μαίνεαι οὐκέτ’ ἀνεκτῶς.	-uu --- u u -uu -u u--	dactylic hexameter	masculine penthemimeral
σχέτλιε, πῶς κέν τίς σε καὶ ὕστερον ἄλλος ἵκοιτο	-uu - - - u u -uu -u u--	dactylic hexameter	masculine penthemimeral, trithemimeral
ἀνθρώπων πολέων, ἐπεὶ οὐ κατὰ μοῖραν ἔρεξας;	--- uu- uu - uu -u u--	dactylic hexameter	masculine penthemimeral, hepthemimeral, trithemimeral
ὣς ἐφάμην, ὁ δὲ δέκτο καὶ ἔκπιεν· ἥσατο δ’αἰνῶς	- uu- u u -u u -uu -uu --	dactylic hexameter	feminine penthemimeral, trithemimeral
ἡδὺ ποτὸν πίνων καὶ μ’ᾔτεε δεύτερον αὖτις·	-u u- -- - -uu -uu --	dactylic hexameter	masculine penthemimeral, trithemimeral
δός μοι ἔτι πρόφρων, καί μοι τεὸν οὔνομα εἰπὲ	- u u- -- - - uu -uu --	dactylic hexameter	masculine penthemimeral, hepthemimeral, trithemimeral
αὐτίκα νῦν, ἵνα τοι δῶ ξείνιον, ᾧ κε σὺ χαίρῃς·	-uu - uu - - -uu - u u --	dactylic hexameter	masculine penthemimeral, trithemimeral
καὶ γὰρ Κυκλώπεσσι φέρει ζείδωρος ἄρουρα	- - ---u u- --u u--	dactylic hexameter	feminine penthemimeral, hepthemimeral
οἶνον ἐριστάφυλον, καί σφιν Διὸς ὄμβρος ἀέξει·	-u u-uu- - - uu -u u--	dactylic hexameter	masculine penthemimeral, hepthemimeral
ἀλλὰ τόδ’ ἀμβροσίης καὶ νέκταρός ἐστιν ἀπορρώξ.	-u u -uu- - -uu -u u--	dactylic hexameter	masculine penthemimeral
ὣς ἔφατ’, αὐτάρ οἱ αὖτις ἐγὼ πόρον αἴθοπα οἶνον.	- uu -u u -u u- uu -uu --	dactylic hexameter	feminine penthemimeral, hepthemimeral
τρὶς μὲν ἔδωκα φέρων, τρὶς δ’ἔκπιεν ἀφραδίῃσιν.	- u u-u u- - -uu -uu--	dactylic hexameter	masculine penthemimeral
αὐτὰρ ἐπεὶ Κύκλωπα περὶ φρένας ἤλυθεν οἶνος,	-u u- --u u- uu -uu --	dactylic hexameter	feminine penthemimeral, hepthemimeral, trithemimeral
καὶ τότε δή μιν ἔπεσσι προσηύδων μειλιχίοισι·	- uu - u u-u u-- -uu--	dactylic hexameter	feminine penthemimeral, trithemimeral
Κύκλωψ, εἰρωτᾷς μ’ὄνομα κλυτόν, αὐτὰρ ἐγώ τοι	-- --- uu- uu -u u- -	dactylic hexameter	masculine penthemimeral, hepthemimeral
ἐξερέω· σὺ δέ μοι δὸς ξείνιον, ὥς περ ὑπέστης.	-uu- u u - - -uu - u u--	dactylic hexameter	masculine penthemimeral, trithemimeral
Οὖτις ἔμοιγ’ ὄνομα· Οὖτιν δέ με κικλήσκουσι	-u u- uu- -- u u ----	dactylic hexameter	masculine penthemimeral, hepthemimeral, trithemimeral
μήτηρ ἠδὲ πατὴρ ἠδ’ ἄλλοι πάντες ἑταῖροι.	-- -u u- - -- -u u--	dactylic hexameter	masculine penthemimeral
ὣς ἐφάμην, ὁ δέ μ’αὐτίκ’ ἀμείβετο νηλέϊ θυμῷ·	- uu- u u -u u-uu -uu --	dactylic hexameter	feminine penthemimeral, trithemimeral
Οὖτιν ἐγὼ πύματον ἔδομαι μετὰ οἷς ἑτάροισι,	-u u- uu- uu- uu - uu--	dactylic hexameter	masculine penthemimeral, hepthemimeral, trithemimeral
τοὺς δ’ἄλλους πρόσθεν· τὸ δέ τοι ξεινήϊον ἔσται.	- -- -- u u - --uu --	dactylic hexameter	masculine penthemimeral, hepthemimeral, trithemimeral
ἦ καὶ ἀνακλινθεὶς πέσεν ὕπτιος, αὐτὰρ ἔπειτα	- u u--- uu -uu -u u--	dactylic hexameter	masculine penthemimeral
κεῖτ’ ἀποδοχμώσας παχὺν αὐχένα, κὰδ δέ μιν ὕπνος	- uu--- uu -uu - u u --	dactylic hexameter	masculine penthemimeral
ᾕρει πανδαμάτωρ· φάρυγος δ’ἐξέσσυτο οἶνος	-- -uu- uu- --uu --	dactylic hexameter	masculine penthemimeral, hepthemimeral
ψωμοί τ’ἀνδρόμεοι· ὁ δ’ἐρεύγετο οἰνοβαρείων.	-- -uu- u u-uu -uu--	dactylic hexameter	masculine penthemimeral
καὶ τότ’ ἐγὼ τὸν μοχλὸν ὑπὸ σποδοῦ ἤλασα πολλῆς,	- u u- - -u u- uu -uu --	dactylic hexameter	feminine penthemimeral, hepthemimeral, trithemimeral
εἵως θερμαίνοιτο· ἔπεσσι δὲ πάντας ἑταίρους	-- ---u u-u u -u u--	dactylic hexameter	feminine penthemimeral
θάρσυνον, μή τίς μοι ὑποδδείσας ἀναδύη.	--- - - u u--- uu--	dactylic hexameter	masculine penthemimeral, trithemimeral
ἀλλ’ ὅτε δὴ τάχ’ ὁ μοχλὸς ἐλάϊνος ἐν πυρὶ μέλλεν	- uu - u u -u u-uu - uu --	dactylic hexameter	feminine penthemimeral, trithemimeral
ἅψεσθαι, χλωρός περ ἐών, διεφαίνετο δ’αἰνῶς,	--- -- u u- uu-uu --	dactylic hexameter	masculine penthemimeral, hepthemimeral, trithemimeral
καὶ τότ’ ἐγὼν ἆσσον φέρον ἐκ πυρός, ἀμφὶ δ’ἑταῖροι	- u u- -- uu - uu -u u--	dactylic hexameter	masculine penthemimeral, hepthemimeral, trithemimeral
ἵσταντ’· αὐτὰρ θάρσος ἐνέπνευσεν μέγα δαίμων.	-- -- -u u--- uu --	dactylic hexameter	feminine penthemimeral
οἱ μὲν μοχλὸν ἑλόντες ἐλάϊνον, ὀξὺν ἐπ’ ἄκρῳ,	- - -u u-u u-uu -u u --	dactylic hexameter	feminine penthemimeral
ὀφθαλμῷ ἐνέρεισαν· ἐγὼ δ’ἐφύπερθεν ἀερθεὶς	--- uu-u u- uu-u u--	dactylic hexameter	feminine penthemimeral, hepthemimeral, trithemimeral
δίνεον, ὡς ὅτε τις τρυπῷ δόρυ νήϊον ἀνὴρ	-uu - uu - -- uu -uu --	dactylic hexameter	masculine penthemimeral, hepthemimeral, trithemimeral
τρυπάνῳ, οἱ δέ τ’ἔνερθεν ὑποσσείουσιν ἱμάντι	-uu - u u-u u---u u--	dactylic hexameter	feminine penthemimeral, trithemimeral
ἁψάμενοι ἑκάτερθε, τὸ δὲ τρέχει ἐμμενὲς αἰεί.	-uu- uu-u u - uu -uu --	dactylic hexameter	feminine penthemimeral, hepthemimeral, trithemimeral
ὣς τοῦ ἐν ὀφθαλμῷ πυριήκεα μοχλὸν ἑλόντες	- u u --- uu-uu -u u--	dactylic hexameter	masculine penthemimeral
δινέομεν, τὸν δ’αἷμα περίρρεε θερμὸν ἐόντα.	-uu- - -u u-uu -u u--	dactylic hexameter	feminine penthemimeral, trithemimeral
πάντα δέ οἱ βλέφαρ’ ἀμφὶ καὶ ὀφρύας εὗσεν ἀϋτμὴ	-u u - uu -u u -uu -u u--	dactylic hexameter	feminine penthemimeral, trithemimeral
γλήνης καιομένης, σφαραγεῦντο δέ οἱ πυρὶ ῥίζαι.	-- -uu- uu-u u - uu --	dactylic hexameter	masculine penthemimeral
ὡς δ’ὅτ’ ἀνὴρ χαλκεὺς πέλεκυν μέγαν ἠὲ σκέπαρνον	- u u- -- uu- uu -u u--	dactylic hexameter	masculine penthemimeral, hepthemimeral, trithemimeral
εἰν ὕδατι ψυχρῷ βάπτῃ μεγάλα ἰάχοντα	- uu- -- -- uu- uu--	dactylic hexameter	masculine penthemimeral, hepthemimeral, trithemimeral
φαρμάσσων· τὸ γὰρ αὖτε σιδήρου γε κράτος ἐστίν	--- u u -u u-- - uu --	dactylic hexameter	feminine penthemimeral, trithemimeral
ὣς τοῦ σίζ’ ὀφθαλμὸς ἐλαϊνέῳ περὶ μοχλῷ.	- - - --u u-uu- uu --	dactylic hexameter	feminine penthemimeral, trithemimeral
σμερδαλέον δὲ μέγ’ ᾤμωξεν, περὶ δ’ἴαχε πέτρη,	-uu- u u --- uu -uu --	dactylic hexameter	hepthemimeral, trithemimeral
ἡμεῖς δὲ δείσαντες ἀπεσσύμεθ’· αὐτὰρ ὁ μοχλὸν	-- - --u u-uu -u u --	dactylic hexameter	feminine penthemimeral, trithemimeral
ἐξέρυσ’ ὀφθαλμοῖο πεφυρμένον αἵματι πολλῷ.	-uu ---u u-uu -uu --	dactylic hexameter	feminine penthemimeral
τὸν μὲν ἔπειτ’ ἔρριψεν ἀπὸ ἕο χερσὶν ἀλύων,	- u u- --u u- uu -u u--	dactylic hexameter	feminine penthemimeral, hepthemimeral, trithemimeral
αὐτὰρ ὁ Κύκλωπας μεγάλ’ ἤπυεν, οἵ ῥά μιν ἀμφὶς	-u u --- uu -uu - u u --	dactylic hexameter	masculine penthemimeral
ᾤκεον ἐν σπήεσσι δι’ ἄκριας ἠνεμοέσσας.	-uu - --u u -uu -uu--	dactylic hexameter	feminine penthemimeral, trithemimeral
οἱ δὲ βοῆς ἀΐοντες ἐφοίτων ἄλλοθεν ἄλλος,	- u u- uu-u u-- -uu --	dactylic hexameter	feminine penthemimeral, trithemimeral
ἱστάμενοι δ’εἴροντο περὶ σπέος ὅττι ἑ κήδοι·	-uu- --u u- uu -u u --	dactylic hexameter	feminine penthemimeral, hepthemimeral, trithemimeral
τίπτε τόσον, Πολύφημ’, ἀρημένος ὧδ’ ἐβόησας	-u u- uu- --uu - uu--	dactylic hexameter	masculine penthemimeral, trithemimeral
νύκτα δι’ ἀμβροσίην καὶ ἀΰπνους ἄμμε τίθησθα;	-u u -uu- u u-- -u u--	dactylic hexameter	masculine penthemimeral
ἦ μή τίς σευ μῆλα βροτῶν ἀέκοντος ἐλαύνει;	- - - - -u u- uu-u u--	dactylic hexameter	feminine penthemimeral, hepthemimeral, trithemimeral
ἦ μή τίς σ’αὐτὸν κτείνει δόλῳ ἠὲ βίηφι;	- - - -- -- uu -u u--	dactylic hexameter	masculine penthemimeral, hepthemimeral, trithemimeral
τοὺς δ’αὖτ’ ἐξ ἄντρου προσέφη κρατερὸς Πολύφημος·	- - - -- uu- uu- uu--	dactylic hexameter	masculine penthemimeral, hepthemimeral, trithemimeral
ὦ φίλοι, Οὖτίς με κτείνει δόλῳ οὐδὲ βίηφι.	- uu -- - -- uu -u u--	dactylic hexameter	masculine penthemimeral, hepthemimeral
οἱ δ’ἀπαμειβόμενοι ἔπεα πτερόεντ’ ἀγόρευον·	- uu-uu- uu- uu- uu--	dactylic hexameter	masculine penthemimeral, hepthemimeral
εἰ μὲν δὴ μή τίς σε βιάζεται οἶον ἐόντα,	- - - - - u u-uu -u u--	dactylic hexameter	masculine penthemimeral, trithemimeral
νοῦσον γ’οὔ πως ἔστι Διὸς μεγάλου ἀλέασθαι,	-- - - -u u- uu- uu--	dactylic hexameter	feminine penthemimeral, hepthemimeral, trithemimeral
ἀλλὰ σύ γ’εὔχεο πατρὶ Ποσειδάωνι ἄνακτι.	-u u -uu -u u---u u--	dactylic hexameter	feminine penthemimeral
ὣς ἄρ’ ἔφαν ἀπιόντες, ἐμὸν δ’ἐγέλασσε φίλον κῆρ,	- u u- uu-u u- uu-u u- -	dactylic hexameter	feminine penthemimeral, hepthemimeral, trithemimeral
ὡς ὄνομ’ ἐξαπάτησεν ἐμὸν καὶ μῆτις ἀμύμων.	- uu -uu-u u- - -u u--	dactylic hexameter	feminine penthemimeral, hepthemimeral
Κύκλωψ δὲ στενάχων τε καὶ ὠδίνων ὀδύνῃσι	-- - uu- u u --- uu--	dactylic hexameter	masculine penthemimeral, trithemimeral
χερσὶ ψηλαφόων ἀπὸ μὲν λίθον εἷλε θυράων,	-- -uu- uu - uu -u u--	dactylic hexameter	masculine penthemimeral, hepthemimeral
αὐτὸς δ’εἰνὶ θύρῃσι καθέζετο χεῖρε πετάσσας,	-- -u u-u u-uu -u u--	dactylic hexameter	feminine penthemimeral
εἴ τινά που μετ’ ὄεσσι λάβοι στείχοντα θύραζε·	- uu - u u-u u- --u u--	dactylic hexameter	feminine penthemimeral, hepthemimeral, trithemimeral
οὕτω γάρ πού μ’ἤλπετ’ ἐνὶ φρεσὶ νήπιον εἶναι.	-- - - -u u- uu -uu --	dactylic hexameter	feminine penthemimeral, hepthemimeral, trithemimeral
αὐτὰρ ἐγὼ βούλευον, ὅπως ὄχ’ ἄριστα γένοιτο,	-u u- --u u- u u-u u--	dactylic hexameter	feminine penthemimeral, hepthemimeral, trithemimeral
εἴ τιν’ ἑταίροισιν θανάτου λύσιν ἠδ’ ἐμοὶ αὐτῷ	- u u--- uu- uu - uu --	dactylic hexameter	masculine penthemimeral, hepthemimeral
εὑροίμην· πάντας δὲ δόλους καὶ μῆτιν ὕφαινον	--- -- u u- - -u u--	dactylic hexameter	masculine penthemimeral, hepthemimeral, trithemimeral
ὥς τε περὶ ψυχῆς· μέγα γὰρ κακὸν ἐγγύθεν ἦεν.	- u u- -- uu - uu -uu --	dactylic hexameter	masculine penthemimeral, hepthemimeral, trithemimeral
ἥδε δέ μοι κατὰ θυμὸν ἀρίστη φαίνετο βουλή.	-u u - uu -u u-- -uu --	dactylic hexameter	feminine penthemimeral, trithemimeral
ἄρσενες ὄϊες ἦσαν ἐϋτρεφέες, δασύμαλλοι,	-uu -uu -u u-uu- uu--	dactylic hexameter	feminine penthemimeral
καλοί τε μεγάλοι τε, ἰοδνεφὲς εἶρος ἔχοντες·	-- - uu- u u-uu -u u--	dactylic hexameter	masculine penthemimeral, trithemimeral
τοὺς ἀκέων συνέεργον ἐϋστρεφέεσσι λύγοισι,	- uu- uu-u u-uu-u u--	dactylic hexameter	feminine penthemimeral, trithemimeral
τῇς ἔπι Κύκλωψ εὗδε πέλωρ, ἀθεμίστια εἰδώς,	- uu -- -u u- uu-uu --	dactylic hexameter	feminine penthemimeral, hepthemimeral
σὺν τρεῖς αἰνύμενος· ὁ μὲν ἐν μέσῳ ἄνδρα φέρεσκε,	- - -uu- u u - uu -u u--	dactylic hexameter	masculine penthemimeral, hepthemimeral
τὼ δ’ἑτέρω ἑκάτερθεν ἴτην σώοντες ἑταίρους.	- uu- uu-u u- --u u--	dactylic hexameter	feminine penthemimeral, hepthemimeral, trithemimeral
τρεῖς δὲ ἕκαστον φῶτ’ ὄϊες φέρον· αὐτὰρ ἔγωγε	- u u-- - uu- uu -u u--	dactylic hexameter	masculine penthemimeral, hepthemimeral
ἀρνειὸς γὰρ ἔην μήλων ὄχ’ ἄριστος ἁπάντων,	--- u u- -- u u-u u--	dactylic hexameter	masculine penthemimeral, hepthemimeral, trithemimeral
τοῦ κατὰ νῶτα λαβών, λασίην ὑπὸ γαστέρ’ ἐλυσθεὶς	- uu -u u- uu- uu -u u--	dactylic hexameter	masculine penthemimeral, hepthemimeral
κείμην· αὐτὰρ χερσὶν ἀώτου θεσπεσίοιο	-- -- -u u-- -uu--	dactylic hexameter	feminine penthemimeral
νωλεμέως στρεφθεὶς ἐχόμην τετληότι θυμῷ.	-uu- -- uu- --uu --	dactylic hexameter	masculine penthemimeral, hepthemimeral, trithemimeral
ὣς τότε μὲν στενάχοντες ἐμείναμεν Ἠῶ δῖαν.	- uu - uu-u u-uu -- --	dactylic hexameter	feminine penthemimeral, trithemimeral
ἦμος δ’ἠριγένεια φάνη ῥοδοδάκτυλος Ἠώς,	-- -uu-u u- uu-uu --	dactylic hexameter	feminine penthemimeral, hepthemimeral
καὶ τότ’ ἔπειτα νομόνδ’ ἐξέσσυτο ἄρσενα μῆλα,	- u u-u u- --uu -uu --	dactylic hexameter	masculine penthemimeral
θήλειαι δὲ μέμηκον ἀνήμελκτοι περὶ σηκούς·	--- u u-u u--- uu --	dactylic hexameter	feminine penthemimeral, trithemimeral
οὔθατα γὰρ σφαραγεῦντο. ἄναξ δ’ὀδύνῃσι κακῇσι	-uu - uu-u u- uu-u u--	dactylic hexameter	feminine penthemimeral, hepthemimeral, trithemimeral
τειρόμενος πάντων ὀΐων ἐπεμαίετο νῶτα	-uu- -- uu- uu-uu --	dactylic hexameter	masculine penthemimeral, hepthemimeral, trithemimeral
ὀρθῶν ἑσταότων· τὸ δὲ νήπιος οὐκ ἐνόησεν,	-- -uu- u u -uu - uu--	dactylic hexameter	masculine penthemimeral
ὥς οἱ ὑπ’ εἰροπόκων ὀΐων στέρνοισι δέδεντο.	- u u -uu- uu- --u u--	dactylic hexameter	masculine penthemimeral, hepthemimeral
ὕστατος ἀρνειὸς μήλων ἔστειχε θύραζε	-uu --- -- --u u--	dactylic hexameter	masculine penthemimeral, hepthemimeral
λάχνῳ στεινόμενος καὶ ἐμοὶ πυκινὰ φρονέοντι.	-- -uu- u u- uu- uu--	dactylic hexameter	masculine penthemimeral, hepthemimeral
τὸν δ’ἐπιμασσάμενος προσέφη κρατερὸς Πολύφημος·	- uu-uu- uu- uu- uu--	dactylic hexameter	masculine penthemimeral, hepthemimeral
κριὲ πέπον, τί μοι ὧδε διὰ σπέος ἔσσυο μήλων	-u u- u u -u u- uu -uu --	dactylic hexameter	feminine penthemimeral, hepthemimeral, trithemimeral
ὕστατος; οὔ τι πάρος γε λελειμμένος ἔρχεαι οἰῶν,	-uu - u u- u u-uu -uu --	dactylic hexameter	masculine penthemimeral, trithemimeral
ἀλλὰ πολὺ πρῶτος νέμεαι τέρεν’ ἄνθεα ποίης	-u u- -- uu- uu -uu --	dactylic hexameter	masculine penthemimeral, hepthemimeral, trithemimeral
μακρὰ βιβάς, πρῶτος δὲ ῥοὰς ποταμῶν ἀφικάνεις,	-u u- -- u u- uu- uu--	dactylic hexameter	masculine penthemimeral, hepthemimeral, trithemimeral
πρῶτος δὲ σταθμόνδε λιλαίεαι ἀπονέεσθαι	-- - --u u-uu -uu--	dactylic hexameter	feminine penthemimeral, trithemimeral
ἑσπέριος· νῦν αὖτε πανύστατος. ἦ σύ γ’ἄνακτος	-uu- - -u u-uu - u u--	dactylic hexameter	feminine penthemimeral, trithemimeral
ὀφθαλμὸν ποθέεις, τὸν ἀνὴρ κακὸς ἐξαλάωσε	--- uu- u u- uu -uu--	dactylic hexameter	masculine penthemimeral, hepthemimeral, trithemimeral
σὺν λυγροῖς ἑτάροισι δαμασσάμενος φρένας οἴνῳ,	- -- uu-u u-uu- uu --	dactylic hexameter	feminine penthemimeral, trithemimeral
Οὖτις, ὃν οὔ πώ φημι πεφυγμένον εἶναι ὄλεθρον.	-u u - - -u u-uu -u u--	dactylic hexameter	feminine penthemimeral, trithemimeral
εἰ δὴ ὁμοφρονέοις ποτιφωνήεις τε γένοιο	- u u-uu- uu--- u u--	dactylic hexameter	masculine penthemimeral
εἰπεῖν ὅππῃ κεῖνος ἐμὸν μένος ἠλασκάζει·	-- -- -u u- uu ----	dactylic hexameter	feminine penthemimeral, hepthemimeral
τῶ κέ οἱ ἐγκέφαλός γε διὰ σπέος ἄλλυδις ἄλλῃ	- u u -uu- u u- uu -uu --	dactylic hexameter	masculine penthemimeral, hepthemimeral
θεινομένου ῥαίοιτο πρὸς οὔδεϊ, κὰδ δέ κ’ἐμὸν κῆρ	-uu- --u u -uu - u u- -	dactylic hexameter	feminine penthemimeral, trithemimeral
λωφήσειε κακῶν, τά μοι οὐτιδανὸς πόρεν Οὖτις.	---u u- u u -uu- uu --	dactylic hexameter	masculine penthemimeral
ὣς εἰπὼν τὸν κριὸν ἀπὸ ἕο πέμπε θύραζε.	- -- - -u u- uu -u u--	dactylic hexameter	feminine penthemimeral, hepthemimeral, trithemimeral
ἐλθόντες δ’ἠβαιὸν ἀπὸ σπείους τε καὶ αὐλῆς	--- --u u- -- u u --	dactylic hexameter	feminine penthemimeral, hepthemimeral, trithemimeral
πρῶτος ὑπ’ ἀρνειοῦ λυόμην, ὑπέλυσα δ’ἑταίρους.	-u u --- uu- uu-u u--	dactylic hexameter	masculine penthemimeral, hepthemimeral
καρπαλίμως δὲ τὰ μῆλα ταναύποδα, πίονα δημῷ,	-uu- u u -u u-uu -uu --	dactylic hexameter	feminine penthemimeral, trithemimeral
πολλὰ περιτροπέοντες ἐλαύνομεν, ὄφρ’ ἐπὶ νῆα	-u u-uu-u u-uu - uu --	dactylic hexameter	feminine penthemimeral
ἱκόμεθ’. ἀσπάσιοι δὲ φίλοις ἑτάροισι φάνημεν,	-uu -uu- u u- uu-u u--	dactylic hexameter	masculine penthemimeral, hepthemimeral
οἳ φύγομεν θάνατον, τοὺς δὲ στενάχοντο γοῶντες.	- uu- uu- - - uu-u u--	dactylic hexameter	masculine penthemimeral, hepthemimeral, trithemimeral
ἀλλ’ ἐγὼ οὐκ εἴων, ἀνὰ δ’ὀφρύσι νεῦον ἑκάστῳ,	- uu - -- uu -uu -u u--	dactylic hexameter	masculine penthemimeral, trithemimeral
κλαίειν, ἀλλ’ ἐκέλευσα θοῶς καλλίτριχα μῆλα	-- - uu-u u- --uu --	dactylic hexameter	feminine penthemimeral, hepthemimeral, trithemimeral
πόλλ’ ἐν νηὶ βαλόντας ἐπιπλεῖν ἁλμυρὸν ὕδωρ.	- - -u u-u u-- -uu --	dactylic hexameter	feminine penthemimeral
οἱ δ’αἶψ’ εἴσβαινον καὶ ἐπὶ κληῗσι καθῖζον,	- - --- u u- --u u--	dactylic hexameter	masculine penthemimeral, hepthemimeral
ἑξῆς δ’ἑζόμενοι πολιὴν ἅλα τύπτον ἐρετμοῖς.	-- -uu- uu- uu -u u--	dactylic hexameter	masculine penthemimeral, hepthemimeral
ἀλλ’ ὅτε τόσσον ἀπῆν, ὅσσον τε γέγωνε βοήσας,	- uu -u u- -- u u-u u--	dactylic hexameter	masculine penthemimeral, hepthemimeral
καὶ τότ’ ἐγὼ Κύκλωπα προσηύδων κερτομίοισι·	- u u- --u u-- -uu--	dactylic hexameter	feminine penthemimeral, trithemimeral
Κύκλωψ, οὐκ ἄρ’ ἔμελλες ἀνάλκιδος ἀνδρὸς ἑταίρους	-- - u u-u u-uu -u u--	dactylic hexameter	feminine penthemimeral, trithemimeral
ἔδμεναι ἐν σπῆϊ γλαφυρῷ κρατερῆφι βίηφι.	-uu - -- uu- uu-u u--	dactylic hexameter	masculine penthemimeral, hepthemimeral, trithemimeral
καὶ λίην σέ γ’ἔμελλε κιχήσεσθαι κακὰ ἔργα,	- -- u u-u u--- uu --	dactylic hexameter	feminine penthemimeral, trithemimeral
σχέτλι’, ἐπεὶ ξείνους οὐχ ἅζεο σῷ ἐνὶ οἴκῳ	-u u- -- - -uu - uu --	dactylic hexameter	masculine penthemimeral, trithemimeral
ἐσθέμεναι· τῶ σε Ζεὺς τίσατο καὶ θεοὶ ἄλλοι.	-uu- - - - -uu - uu --	dactylic hexameter	masculine penthemimeral, trithemimeral
ὣς ἐφάμην, ὁ δ’ἔπειτα χολώσατο κηρόθι μᾶλλον,	- uu- u u-u u-uu -uu --	dactylic hexameter	feminine penthemimeral, trithemimeral
ἧκε δ’ἀπορρήξας κορυφὴν ὄρεος μεγάλοιο,	-u u--- uu- uu- uu--	dactylic hexameter	masculine penthemimeral, hepthemimeral
κὰδ δ’ἔβαλε προπάροιθε νεὸς κυανοπρώροιο.	- uu- uu-u u- uu----	dactylic hexameter	feminine penthemimeral, hepthemimeral, trithemimeral
τυτθόν, ἐδεύησεν δ’οἰήϊον ἄκρον ἱκέσθαι	-u u--- --uu -u u--	dactylic hexameter	masculine penthemimeral
ἐκλύσθη δὲ θάλασσα κατερχομένης ὑπὸ πέτρης·	--- u u-u u-uu- uu --	dactylic hexameter	feminine penthemimeral, trithemimeral
τὴν δ’αἶψ’ ἤπειρόνδε παλιρρόθιον φέρε κῦμα,	- - ---u u-uu- uu --	dactylic hexameter	feminine penthemimeral
πλημμυρὶς ἐκ πόντοιο, θέμωσε δὲ χέρσον ἱκέσθαι.	-uu - --u u-u u -u u--	dactylic hexameter	feminine penthemimeral, trithemimeral
αὐτὰρ ἐγὼ χείρεσσι λαβὼν περιμήκεα κοντὸν	-u u- --u u- uu-uu --	dactylic hexameter	feminine penthemimeral, hepthemimeral, trithemimeral
ὦσα παρέξ, ἑτάροισι δ’ ἐποτρύνας ἐκέλευσα	-u u- uu-u u--- uu--	dactylic hexameter	feminine penthemimeral, trithemimeral
ἐμβαλέειν κώπῃς, ἵν’ ὑπὲκ κακότητα φύγοιμεν,	-uu- -- u u- uu-u u--	dactylic hexameter	masculine penthemimeral, hepthemimeral, trithemimeral
κρατὶ κατανεύων· οἱ δὲ προπεσόντες ἔρεσσον.	-u u--- - - uu-u u--	dactylic hexameter	masculine penthemimeral, hepthemimeral
ἀλλ’ ὅτε δὴ δὶς τόσσον ἅλα πρήσσοντες ἀπῆμεν,	- uu - - -u u- --u u--	dactylic hexameter	feminine penthemimeral, hepthemimeral, trithemimeral
καὶ τότ’ ἐγὼ Κύκλωπα προσηύδων· ἀμφὶ δ’ἑταῖροι	- u u- --u u-- -u u--	dactylic hexameter	feminine penthemimeral, trithemimeral
μειλιχίοις ἐπέεσσιν ἐρήτυον ἄλλοθεν ἄλλος·	-uu- uu-u u-uu -uu --	dactylic hexameter	feminine penthemimeral, trithemimeral
σχέτλιε, τίπτ’ ἐθέλεις ἐρεθιζέμεν ἄγριον ἄνδρα;	-uu - uu- uu-uu -uu --	dactylic hexameter	masculine penthemimeral, trithemimeral
ὃς καὶ νῦν πόντονδε βαλὼν βέλος ἤγαγε νῆα	- - - --u u- uu -uu --	dactylic hexameter	feminine penthemimeral, hepthemimeral, trithemimeral
αὖτις ἐς ἤπειρον, καὶ δὴ φάμεν αὐτόθ’ ὀλέσθαι.	-u u --- - - uu -u u--	dactylic hexameter	masculine penthemimeral, hepthemimeral
εἰ δὲ φθεγξαμένου τευ ἢ αὐδήσαντος ἄκουσε,	- - -uu- u u ---u u--	dactylic hexameter	masculine penthemimeral
σύν κεν ἄραξ’ ἡμέων κεφαλὰς καὶ νήϊα δοῦρα	- u u- -- uu- - -uu --	dactylic hexameter	masculine penthemimeral, hepthemimeral, trithemimeral
μαρμάρῳ ὀκριόεντι βαλών· τόσσον γὰρ ἵησιν.	-uu -uu-u u- -- u u--	dactylic hexameter	feminine penthemimeral, hepthemimeral
ὣς φάσαν, ἀλλ’ οὐ πεῖθον ἐμὸν μεγαλήτορα θυμόν,	- uu - - -u u- uu-uu --	dactylic hexameter	feminine penthemimeral, hepthemimeral, trithemimeral
ἀλλά μιν ἄψορρον προσέφην κεκοτηότι θυμῷ·	-u u --- uu- uu-uu --	dactylic hexameter	masculine penthemimeral, hepthemimeral
Κύκλωψ, αἴ κέν τίς σε καταθνητῶν ἀνθρώπων	-- - - - u u--- ---	dactylic hexameter	masculine penthemimeral, trithemimeral
ὀφθαλμοῦ εἴρηται ἀεικελίην ἀλαωτύν,	--- --u u-uu- uu--	dactylic hexameter	feminine penthemimeral, trithemimeral
φάσθαι Ὀδυσσῆα πτολιπόρθιον ἐξαλαῶσαι,	-u u--- uu-uu -uu--	dactylic hexameter	masculine penthemimeral
υἱὸν Λαέρτεω, Ἰθάκῃ ἔνι οἰκί’ ἔχοντα.	-- --- uu- uu -u u--	dactylic hexameter	masculine penthemimeral, hepthemimeral
ὣς ἐφάμην, ὁ δέ μ’οἰμώξας ἠμείβετο μύθῳ·	- uu- u u --- --uu --	dactylic hexameter	hepthemimeral, trithemimeral
ὢ πόποι, ἦ μάλα δή με παλαίφατα θέσφαθ’ ἱκάνει.	- uu - uu - u u-uu -u u--	dactylic hexameter	masculine penthemimeral, trithemimeral
ἔσκε τις ἐνθάδε μάντις ἀνὴρ ἠΰς τε μέγας τε,	-u u -uu -u u- -- u u- -	dactylic hexameter	feminine penthemimeral, hepthemimeral
Τήλεμος Εὐρυμίδης, ὃς μαντοσύνῃ ἐκέκαστο	-uu -uu- - -uu- uu--	dactylic hexameter	masculine penthemimeral
καὶ μαντευόμενος κατεγήρα Κυκλώπεσσιν·	- --uu- uu-- ----	dactylic hexameter	masculine penthemimeral
ὅς μοι ἔφη τάδε πάντα τελευτήσεσθαι ὀπίσσω,	- u u- uu -u u---u u--	dactylic hexameter	feminine penthemimeral, trithemimeral
χειρῶν ἐξ Ὀδυσῆος ἁμαρτήσεσθαι ὀπωπῆς.	-- - uu-u u---u u--	dactylic hexameter	feminine penthemimeral, trithemimeral
ἀλλ’ αἰεί τινα φῶτα μέγαν καὶ καλὸν ἐδέγμην	- -- uu -u u- - -u u--	dactylic hexameter	feminine penthemimeral, hepthemimeral, trithemimeral
ἐνθάδ’ ἐλεύσεσθαι, μεγάλην ἐπιειμένον ἀλκήν·	-u u--- uu- uu-uu --	dactylic hexameter	masculine penthemimeral, hepthemimeral
νῦν δέ μ’ἐὼν ὀλίγος τε καὶ οὐτιδανὸς καὶ ἄκικυς	- u u- uu- u u -uu- u u--	dactylic hexameter	masculine penthemimeral, trithemimeral
ὀφθαλμοῦ ἀλάωσεν, ἐπεί μ’ἐδαμάσσατο οἴνῳ.	--- uu-u u- uu-uu --	dactylic hexameter	feminine penthemimeral, hepthemimeral, trithemimeral
ἀλλ’ ἄγε δεῦρ’, Ὀδυσεῦ, ἵνα τοι πὰρ ξείνια θείω	- uu - uu- uu - - -uu --	dactylic hexameter	masculine penthemimeral, hepthemimeral, trithemimeral
πομπήν τ’ὀτρύνω δόμεναι κλυτὸν ἐννοσίγαιον·	-- --- uu- uu -uu--	dactylic hexameter	masculine penthemimeral, hepthemimeral
τοῦ γὰρ ἐγὼ πάϊς εἰμί, πατὴρ δ’ἐμὸς εὔχεται εἶναι.	- u u- uu -u u- uu -uu --	dactylic hexameter	feminine penthemimeral, hepthemimeral, trithemimeral
αὐτὸς δ’,αἴ κ’ἐθέλῃσ’, ἰήσεται, οὐδέ τις ἄλλος	-- - uu- --uu -u u --	dactylic hexameter	masculine penthemimeral, trithemimeral
οὔτε θεῶν μακάρων οὔτε θνητῶν ἀνθρώπων.	-u u- uu- -- -- ---	dactylic hexameter	masculine penthemimeral, hepthemimeral, trithemimeral
ὣς ἔφατ’, αὐτὰρ ἐγώ μιν ἀμειβόμενος προσέειπον·	- uu -u u- u u-uu- uu--	dactylic hexameter	masculine penthemimeral
αἲ γὰρ δὴ ψυχῆς τε καὶ αἰῶνός σε δυναίμην	- - - -- u u --- u u--	dactylic hexameter	masculine penthemimeral, trithemimeral
εὖνιν ποιήσας πέμψαι δόμον Ἄϊδος εἴσω,	-- --- -- uu -uu --	dactylic hexameter	masculine penthemimeral, hepthemimeral
ὡς οὐκ ὀφθαλμόν γ’ἰήσεται οὐδ’ ἐνοσίχθων.	- - --- --uu - uu--	dactylic hexameter	masculine penthemimeral
ὣς ἐφάμην, ὁ δ’ἔπειτα Ποσειδάωνι ἄνακτι	- uu- u u-u u---u u--	dactylic hexameter	feminine penthemimeral, trithemimeral
εὔχετο χεῖρ’ ὀρέγων εἰς οὐρανὸν ἀστερόεντα·	-uu - uu- - -uu -uu--	dactylic hexameter	masculine penthemimeral, trithemimeral
κλῦθι, Ποσείδαον γαιήοχε κυανοχαῖτα,	-u u--- --uu -uu--	dactylic hexameter	masculine penthemimeral
εἰ ἐτεόν γε σός εἰμι, πατὴρ δ’ἐμὸς εὔχεαι εἶναι,	- uu- u u -u u- uu -uu --	dactylic hexameter	feminine penthemimeral, hepthemimeral, trithemimeral
δὸς μὴ Ὀδυσσῆα πτολιπόρθιον οἴκαδ’ ἱκέσθαι	- u u--- uu-uu -u u--	dactylic hexameter	masculine penthemimeral
υἱὸν Λαέρτεω, Ἰθάκῃ ἔνι οἰκί’ ἔχοντα.	-- --- uu- uu -u u--	dactylic hexameter	masculine penthemimeral, hepthemimeral
ἀλλ’ εἴ οἱ μοῖρ’ ἐστὶ φίλους τ’ἰδέειν καὶ ἱκέσθαι	- - - - -u u- uu- u u--	dactylic hexameter	feminine penthemimeral, hepthemimeral, trithemimeral
οἶκον ἐϋκτίμενον καὶ ἑὴν ἐς πατρίδα γαῖαν,	-u u-uu- u u- - -uu --	dactylic hexameter	masculine penthemimeral, hepthemimeral
ὀψὲ κακῶς ἔλθοι, ὀλέσας ἄπο πάντας ἑταίρους,	-u u- -- uu- uu -u u--	dactylic hexameter	masculine penthemimeral, hepthemimeral, trithemimeral
νηὸς ἐπ’ ἀλλοτρίης, εὕροι δ’ἐν πήματα οἴκῳ.	-u u -uu- -- - -uu --	dactylic hexameter	masculine penthemimeral, hepthemimeral
ὣς ἔφατ’ εὐχόμενος, τοῦ δ’ἔκλυε κυανοχαίτης.	- uu -uu- - -uu -uu--	dactylic hexameter	masculine penthemimeral
αὐτὰρ ὅ γ’ἐξαῦτις πολὺ μείζονα λᾶαν ἀείρας	-u u --- uu -uu -u u--	dactylic hexameter	masculine penthemimeral
ἧκ’ ἐπιδινήσας, ἐπέρεισε δὲ ἶν’ ἀπέλεθρον,	- uu--- uu-u u - uu--	dactylic hexameter	masculine penthemimeral
κὰδ’ δ’ἔβαλεν μετόπισθε νεὸς κυανοπρώροιο	- uu- uu-u u- uu----	dactylic hexameter	feminine penthemimeral, hepthemimeral, trithemimeral
τυτθόν, ἐδεύησεν δ’οἰήϊον ἄκρον ἱκέσθαι.	-u u--- --uu -u u--	dactylic hexameter	masculine penthemimeral
ἐκλύσθη δὲ θάλασσα κατερχομένης ὑπὸ πέτρης·	--- u u-u u-uu- uu --	dactylic hexameter	feminine penthemimeral, trithemimeral
τὴν δὲ πρόσω φέρε κῦμα, θέμωσε δὲ χέρσον ἱκέσθαι.	- u u- uu -u u-u u -u u--	dactylic hexameter	feminine penthemimeral, trithemimeral
ἀλλ’ ὅτε δὴ τὴν νῆσον ἀφικόμεθ’, ἔνθα περ ἄλλαι	- uu - - -u u-uu -u u --	dactylic hexameter	feminine penthemimeral, trithemimeral
νῆες ἐΰσσελμοι μένον ἁθρόαι, ἀμφὶ δ’ἑταῖροι	-u u--- uu -uu -u u--	dactylic hexameter	masculine penthemimeral
εἵατ’ ὀδυρόμενοι, ἡμέας ποτιδέγμενοι αἰεί,	-u u-uu- -- uu-uu --	dactylic hexameter	masculine penthemimeral, hepthemimeral
νῆα μὲν ἔνθ’ ἐλθόντες ἐκέλσαμεν ἐν ψαμάθοισιν,	-u u - --u u-uu - uu--	dactylic hexameter	feminine penthemimeral, trithemimeral
ἐκ δὲ καὶ αὐτοὶ βῆμεν ἐπὶ ῥηγμῖνι θαλάσσης.	- u u -- -u u- --u u--	dactylic hexameter	feminine penthemimeral, hepthemimeral
μῆλα δὲ Κύκλωπος γλαφυρῆς ἐκ νηὸς ἑλόντες	-u u --- uu- - -u u--	dactylic hexameter	masculine penthemimeral, hepthemimeral
δασσάμεθ’, ὡς μή τίς μοι ἀτεμβόμενος κίοι ἴσης.	-uu - - - u u-uu- uu --	dactylic hexameter	masculine penthemimeral, trithemimeral
ἀρνειὸν δ’ἐμοὶ οἴῳ ἐϋκνήμιδες ἑταῖροι	--- uu -u u---u u--	dactylic hexameter	feminine penthemimeral, trithemimeral
μήλων δαιομένων δόσαν ἔξοχα· τὸν δ’ἐπὶ θινὶ	-- -uu- uu -uu - uu --	dactylic hexameter	masculine penthemimeral
Ζηνὶ κελαινεφέϊ Κρονίδῃ, ὃς πᾶσιν ἀνάσσει,	-u u-uu- uu- - -u u--	dactylic hexameter	masculine penthemimeral, hepthemimeral
ῥέξας μηρί’ ἔκαιον· ὁ δ’οὐκ ἐμπάζετο ἱρῶν,	-- -u u-u u - --uu --	dactylic hexameter	feminine penthemimeral, hepthemimeral
ἀλλ’ ὅ γε μερμήριζεν ὅπως ἀπολοίατο πᾶσαι	- u u ---u u- uu-uu --	dactylic hexameter	feminine penthemimeral, hepthemimeral
νῆες ἐΰσσελμοι καὶ ἐμοὶ ἐρίηρες ἑταῖροι.	-u u--- u u- uu-u u--	dactylic hexameter	masculine penthemimeral, hepthemimeral
ὣς τότε μὲν πρόπαν ἦμαρ ἐς ἠέλιον καταδύντα	- uu - uu -u u -uu- uu--	dactylic hexameter	feminine penthemimeral, trithemimeral
ἥμεθα δαινύμενοι κρέα τ’ἄσπετα καὶ μέθυ ἡδύ·	-uu -uu- uu -uu - uu --	dactylic hexameter	masculine penthemimeral
ἦμος δ’ἠέλιος κατέδυ καὶ ἐπὶ κνέφας ἦλθε,	-- -uu- uu- u u- uu --	dactylic hexameter	masculine penthemimeral, hepthemimeral
δὴ τότε κοιμήθημεν ἐπὶ ῥηγμῖνι θαλάσσης.	- uu ---u u- --u u--	dactylic hexameter	feminine penthemimeral, hepthemimeral
ἦμος δ’ἠριγένεια φάνη ῥοδοδάκτυλος Ἠώς,	-- -uu-u u- uu-uu --	dactylic hexameter	feminine penthemimeral, hepthemimeral
δὴ τότ’ ἐγὼν ἑτάροισιν ἐποτρύνας ἐκέλευσα	- u u- uu-u u--- uu--	dactylic hexameter	feminine penthemimeral, trithemimeral
αὐτούς τ’ἀμβαίνειν ἀνά τε πρυμνήσια λῦσαι·	-- --- uu - --uu --	dactylic hexameter	masculine penthemimeral, hepthemimeral
οἱ δ’αἶψ’ εἴσβαινον καὶ ἐπὶ κληῗσι καθῖζον,	- - --- u u- --u u--	dactylic hexameter	masculine penthemimeral, hepthemimeral
ἑξῆς δ’ἑζόμενοι πολιὴν ἅλα τύπτον ἐρετμοῖς.	-- -uu- uu- uu -u u--	dactylic hexameter	masculine penthemimeral, hepthemimeral
ἔνθεν δὲ προτέρω πλέομεν ἀκαχήμενοι ἦτορ,	-- - uu- uu- uu-uu --	dactylic hexameter	masculine penthemimeral, hepthemimeral, trithemimeral
ἄσμενοι ἐκ θανάτοιο, φίλους ὀλέσαντες ἑταίρους.	-uu - uu-u u- uu-u u--	dactylic hexameter	feminine penthemimeral, hepthemimeral, trithemimeral
