αὐτὰρ ἐπεί ῥ’ἐπὶ νῆα κατήλθομεν ἠδὲ θάλασσαν,	-u u- uu -u u-uu -u u--	dactylic hexameter	feminine penthemimeral, trithemimeral
νῆα μὲν ἂρ πάμπρωτον ἐρύσσαμεν εἰς ἅλα δῖαν,	-u u - --u u-uu - uu --	dactylic hexameter	feminine penthemimeral, trithemimeral
ἐν δ’ἱστὸν τιθέμεσθα καὶ ἱστία νηὶ μελαίνῃ,	- -- uu-u u -uu -u u--	dactylic hexameter	feminine penthemimeral, trithemimeral
ἐν δὲ τὰ μῆλα λαβόντες ἐβήσαμεν, ἂν δὲ καὶ αὐτοὶ	- u u -u u-u u-uu - u u --	dactylic hexameter	feminine penthemimeral
βαίνομεν ἀχνύμενοι θαλερὸν κατὰ δάκρυ χέοντες.	-uu -uu- uu- uu -u u--	dactylic hexameter	masculine penthemimeral, hepthemimeral
ἡμῖν δ’αὖ κατόπισθε νεὸς κυανοπρώροιο	-- - uu-u u- uu----	dactylic hexameter	feminine penthemimeral, hepthemimeral, trithemimeral
ἴκμενον οὖρον ἵει πλησίστιον, ἐσθλὸν ἑταῖρον,	-uu -u u- --uu -u u--	dactylic hexameter	masculine penthemimeral
Κίρκη ἐϋπλόκαμος, δεινὴ θεὸς αὐδήεσσα.	-u u-uu- -- uu ----	dactylic hexameter	masculine penthemimeral, hepthemimeral
ἡμεῖς δ’ὅπλα ἕκαστα πονησάμενοι κατὰ νῆα	-- -u u-u u-uu- uu --	dactylic hexameter	feminine penthemimeral
ἥμεθα· τὴν δ’ἄνεμός τε κυβερνήτης τ’ἴθυνε.	-uu - uu- u u--- ---	dactylic hexameter	masculine penthemimeral, trithemimeral
τῆς δὲ πανημερίης τέταθ’ ἱστία ποντοπορούσης·	- u u-uu- uu -uu -uu--	dactylic hexameter	masculine penthemimeral
δύσετό τ’ἠέλιος σκιόωντό τε πᾶσαι ἀγυιαί.	-uu -uu- uu-u u -u u--	dactylic hexameter	masculine penthemimeral
ἡ δ’ἐς πείραθ’ ἵκανε βαθυρρόου Ὠκεανοῖο.	- - -u u-u u-uu -uu--	dactylic hexameter	feminine penthemimeral
ἔνθα δὲ Κιμμερίων ἀνδρῶν δῆμός τε πόλις τε,	-u u -uu- -- -- u u- -	dactylic hexameter	masculine penthemimeral, hepthemimeral
ἠέρι καὶ νεφέλῃ κεκαλυμμένοι· οὐδέ ποτ’ αὐτοὺς	-uu - uu- uu-uu -u u --	dactylic hexameter	masculine penthemimeral, trithemimeral
ἠέλιος φαέθων ἐπιδέρκεται ἀκτίνεσσιν,	-uu- uu- uu-uu ----	dactylic hexameter	masculine penthemimeral, trithemimeral
οὔθ’ ὁπότ’ ἂν στείχῃσι πρὸς οὐρανὸν ἀστερόεντα,	- uu - --u u -uu -uu--	dactylic hexameter	feminine penthemimeral, trithemimeral
οὔθ’ ὅτ’ ἂν ἂψ ἐπὶ γαῖαν ἀπ’ οὐρανόθεν προτράπηται,	- u u - uu -u u -uu- uu--	dactylic hexameter	feminine penthemimeral, trithemimeral
ἀλλ’ ἐπὶ νὺξ ὀλοὴ τέταται δειλοῖσι βροτοῖσι.	- uu - uu- uu- --u u--	dactylic hexameter	masculine penthemimeral, hepthemimeral, trithemimeral
νῆα μὲν ἔνθ’ ἐλθόντες ἐκέλσαμεν, ἐκ δὲ τὰ μῆλα	-u u - --u u-uu - u u --	dactylic hexameter	feminine penthemimeral, trithemimeral
εἱλόμεθ’· αὐτοὶ δ’αὖτε παρὰ ῥόον Ὠκεανοῖο	-uu -- -u u- uu -uu--	dactylic hexameter	feminine penthemimeral, hepthemimeral
ᾔομεν, ὄφρ’ ἐς χῶρον ἀφικόμεθ’, ὃν φράσε Κίρκη.	-uu - - -u u-uu - uu --	dactylic hexameter	feminine penthemimeral, trithemimeral
ἔνθ’ ἱερήϊα μὲν Περιμήδης Εὐρύλοχός τε	- uu-uu - uu-- -uu- -	dactylic hexameter	masculine penthemimeral
ἔσχον· ἐγὼ δ’ἄορ ὀξὺ ἐρυσσάμενος παρὰ μηροῦ	-u u- uu -u u-uu- uu --	dactylic hexameter	feminine penthemimeral, trithemimeral
βόθρον ὄρυξ’ ὅσσον τε πυγούσιον ἔνθα καὶ ἔνθα,	-u u- -- u u-uu -u u --	dactylic hexameter	masculine penthemimeral, trithemimeral
ἀμφ’ αὐτῷ δὲ χοὴν χεόμην πᾶσιν νεκύεσσι,	- -- u u- uu- -- uu--	dactylic hexameter	masculine penthemimeral, hepthemimeral, trithemimeral
πρῶτα μελικρήτῳ, μετέπειτα δὲ ἡδέϊ οἴνῳ,	-u u--- uu-u u -uu --	dactylic hexameter	masculine penthemimeral
τὸ τρίτον αὖθ’ ὕδατι· ἐπὶ δ’ἄλφιτα λευκὰ πάλυνον.	- uu - uu- uu -uu -u u--	dactylic hexameter	masculine penthemimeral, trithemimeral
πολλὰ δὲ γουνούμην νεκύων ἀμενηνὰ κάρηνα,	-u u --- uu- uu-u u--	dactylic hexameter	masculine penthemimeral, hepthemimeral
ἐλθὼν εἰς Ἰθάκην στεῖραν βοῦν, ἥ τις ἀρίστη,	-- - uu- -- - - u u--	dactylic hexameter	masculine penthemimeral, hepthemimeral, trithemimeral
ῥέξειν ἐν μεγάροισι πυρήν τ’ἐμπλησέμεν ἐσθλῶν,	-- - uu-u u- --uu --	dactylic hexameter	feminine penthemimeral, hepthemimeral, trithemimeral
Τειρεσίῃ δ’ἀπάνευθεν ὄϊν ἱερευσέμεν οἴῳ	-uu- uu-u u- uu-uu --	dactylic hexameter	feminine penthemimeral, hepthemimeral, trithemimeral
παμμέλαν’, ὃς μήλοισι μεταπρέπει ἡμετέροισι.	-uu - --u u-uu -uu--	dactylic hexameter	feminine penthemimeral, trithemimeral
τοὺς δ’ἐπεὶ εὐχωλῇσι λιτῇσί τε, ἔθνεα νεκρῶν,	- uu ---u u-u u -uu --	dactylic hexameter	feminine penthemimeral
ἐλλισάμην, τὰ δὲ μῆλα λαβὼν ἀπεδειροτόμησα	-uu- u u -u u- uu-uu--	dactylic hexameter	feminine penthemimeral, hepthemimeral, trithemimeral
ἐς βόθρον, ῥέε δ’αἷμα κελαινεφές· αἱ δ’ἀγέροντο	- -- uu -u u-uu - uu--	dactylic hexameter	feminine penthemimeral, trithemimeral
ψυχαὶ ὑπὲξ Ἐρέβευς νεκύων κατατεθνηώτων.	-u u- uu- uu- uu----	dactylic hexameter	masculine penthemimeral, hepthemimeral, trithemimeral
νύμφαι τ’ἠΐθεοί τε πολύτλητοί τε γέροντες	-- -uu- u u--- u u--	dactylic hexameter	masculine penthemimeral
παρθενικαί τ’ἀταλαὶ νεοπενθέα θυμὸν ἔχουσαι,	-uu- uu- uu-uu -u u--	dactylic hexameter	masculine penthemimeral, trithemimeral
πολλοὶ δ’οὐτάμενοι χαλκήρεσιν ἐγχείῃσιν,	-- -uu- --uu ----	dactylic hexameter	masculine penthemimeral
ἄνδρες ἀρηΐφατοι βεβροτωμένα τεύχε’ ἔχοντες·	-u u-uu- uu-uu -u u--	dactylic hexameter	masculine penthemimeral
οἳ πολλοὶ περὶ βόθρον ἐφοίτων ἄλλοθεν ἄλλος	- -- uu -u u-- -uu --	dactylic hexameter	feminine penthemimeral, trithemimeral
θεσπεσίῃ ἰαχῇ· ἐμὲ δὲ χλωρὸν δέος ᾕρει.	-uu- uu- uu - -- uu --	dactylic hexameter	masculine penthemimeral, hepthemimeral, trithemimeral
δὴ τότ’ ἔπειθ’ ἑτάροισιν ἐποτρύνας ἐκέλευσα	- u u- uu-u u--- uu--	dactylic hexameter	feminine penthemimeral, trithemimeral
μῆλα, τὰ δὴ κατέκειτ’ ἐσφαγμένα νηλέϊ χαλκῷ,	-u u - uu- --uu -uu --	dactylic hexameter	masculine penthemimeral, trithemimeral
δείραντας κατακῆαι, ἐπεύξασθαι δὲ θεοῖσιν,	--- uu-u u--- u u--	dactylic hexameter	feminine penthemimeral, trithemimeral
ἰφθίμῳ τ’Ἀΐδῃ καὶ ἐπαινῇ Περσεφονείῃ·	--- uu- u u-- -uu--	dactylic hexameter	masculine penthemimeral, trithemimeral
αὐτὸς δὲ ξίφος ὀξὺ ἐρυσσάμενος παρὰ μηροῦ	-- - uu -u u-uu- uu --	dactylic hexameter	feminine penthemimeral, trithemimeral
ἥμην, οὐδ’ εἴων νεκύων ἀμενηνὰ κάρηνα	-- - -- uu- uu-u u--	dactylic hexameter	masculine penthemimeral, hepthemimeral, trithemimeral
αἵματος ἆσσον ἴμεν, πρὶν Τειρεσίαο πυθέσθαι.	-uu -u u- - -uu-u u--	dactylic hexameter	masculine penthemimeral
πρώτη δὲ ψυχὴ Ἐλπήνορος ἦλθεν ἑταίρου·	-- - -- --uu -u u--	dactylic hexameter	masculine penthemimeral, trithemimeral
οὐ γάρ πω ἐτέθαπτο ὑπὸ χθονὸς εὐρυοδείης·	- - - uu-u u- uu -uu--	dactylic hexameter	feminine penthemimeral, hepthemimeral, trithemimeral
σῶμα γὰρ ἐν Κίρκης μεγάρῳ κατελείπομεν ἡμεῖς	-u u - -- uu- uu-uu --	dactylic hexameter	masculine penthemimeral, hepthemimeral, trithemimeral
ἄκλαυτον καὶ ἄθαπτον, ἐπεὶ πόνος ἄλλος ἔπειγε.	--- u u-u u- uu -u u--	dactylic hexameter	feminine penthemimeral, hepthemimeral, trithemimeral
τὸν μὲν ἐγὼ δάκρυσα ἰδὼν ἐλέησά τε θυμῷ,	- u u- --u u- uu-u u --	dactylic hexameter	feminine penthemimeral, hepthemimeral, trithemimeral
καί μιν φωνήσας ἔπεα πτερόεντα προσηύδων·	- - --- uu- uu-u u--	dactylic hexameter	masculine penthemimeral, hepthemimeral
Ἐλπῆνορ, πῶς ἦλθες ὑπὸ ζόφον ἠερόεντα;	--- - -u u- uu -uu--	dactylic hexameter	feminine penthemimeral, hepthemimeral, trithemimeral
ἔφθης πεζὸς ἐὼν ἢ ἐγὼ σὺν νηὶ μελαίνῃ.	-- -u u- u u- - -u u--	dactylic hexameter	masculine penthemimeral, hepthemimeral
ὣς ἐφάμην, ὁ δέ μ’οἰμώξας ἠμείβετο μύθῳ·	- uu- u u --- --uu --	dactylic hexameter	hepthemimeral, trithemimeral
διογενὲς Λαερτιάδη, πολυμήχαν’ Ὀδυσσεῦ,	-uu- --uu- uu-u u--	dactylic hexameter	hepthemimeral, trithemimeral
ἆσέ με δαίμονος αἶσα κακὴ καὶ ἀθέσφατος οἶνος.	-u u -uu -u u- u u-uu --	dactylic hexameter	feminine penthemimeral, hepthemimeral
Κίρκης δ’ἐν μεγάρῳ καταλέγμενος οὐκ ἐνόησα	-- - uu- uu-uu - uu--	dactylic hexameter	masculine penthemimeral, trithemimeral
ἄψορρον καταβῆναι ἰὼν ἐς κλίμακα μακρήν,	--- uu-u u- - -uu --	dactylic hexameter	feminine penthemimeral, hepthemimeral, trithemimeral
ἀλλὰ κατ’ ἀντικρὺ τέγεος πέσον· ἐκ δέ μοι αὐχὴν	-u u --- uu- uu - u u --	dactylic hexameter	masculine penthemimeral, hepthemimeral
ἀστραγάλων ἐάγη, ψυχὴ δ’Ἄϊδόσδε κατῆλθε.	-uu- uu- -- uu-u u--	dactylic hexameter	masculine penthemimeral, hepthemimeral, trithemimeral
νῦν δέ σε τῶν ὄπιθεν γουνάζομαι, οὐ παρεόντων,	- u u - uu- --uu - uu--	dactylic hexameter	masculine penthemimeral, trithemimeral
πρός τ’ἀλόχου καὶ πατρός, ὅ σ’ἔτρεφε τυτθὸν ἐόντα,	- uu- - -u u -uu -u u--	dactylic hexameter	feminine penthemimeral, trithemimeral
Τηλεμάχου θ’,ὃν μοῦνον ἐνὶ μεγάροισιν ἔλειπες·	-uu- - -u u- uu-u u--	dactylic hexameter	feminine penthemimeral, hepthemimeral, trithemimeral
οἶδα γὰρ ὡς ἐνθένδε κιὼν δόμου ἐξ Ἀΐδαο	-u u - --u u- uu - uu--	dactylic hexameter	feminine penthemimeral, hepthemimeral, trithemimeral
νῆσον ἐς Αἰαίην σχήσεις εὐεργέα νῆα·	-u u --- -- --uu --	dactylic hexameter	masculine penthemimeral, hepthemimeral
ἔνθα σ’ἔπειτα, ἄναξ, κέλομαι μνήσασθαι ἐμεῖο.	-u u-u u- uu- --u u--	dactylic hexameter	masculine penthemimeral, hepthemimeral
μή μ’ἄκλαυτον ἄθαπτον ἰὼν ὄπιθεν καταλείπειν	- --u u-u u- uu- uu--	dactylic hexameter	feminine penthemimeral, hepthemimeral
νοσφισθείς, μή τοί τι θεῶν μήνιμα γένωμαι,	--- - - u u- --u u--	dactylic hexameter	masculine penthemimeral, hepthemimeral, trithemimeral
ἀλλά με κακκῆαι σὺν τεύχεσιν, ἅσσα μοι ἔστι,	-u u --- - -uu -u u --	dactylic hexameter	masculine penthemimeral
σῆμά τέ μοι χεῦαι πολιῆς ἐπὶ θινὶ θαλάσσης,	-u u - -- uu- uu -u u--	dactylic hexameter	masculine penthemimeral, hepthemimeral, trithemimeral
ἀνδρὸς δυστήνοιο καὶ ἐσσομένοισι πυθέσθαι.	-- ---u u -uu-u u--	dactylic hexameter	feminine penthemimeral
ταῦτά τέ μοι τελέσαι πῆξαί τ’ἐπὶ τύμβῳ ἐρετμόν,	-u u - uu- -- uu -u u--	dactylic hexameter	masculine penthemimeral, hepthemimeral, trithemimeral
τῷ καὶ ζωὸς ἔρεσσον ἐὼν μετ’ ἐμοῖς ἑτάροισιν.	- - -u u-u u- u u- uu--	dactylic hexameter	feminine penthemimeral, hepthemimeral
ὣς ἔφατ’, αὐτὰρ ἐγώ μιν ἀμειβόμενος προσέειπον·	- uu -u u- u u-uu- uu--	dactylic hexameter	masculine penthemimeral
ταῦτά τοι, ὦ δύστηνε, τελευτήσω τε καὶ ἔρξω.	-u u - --u u--- u u --	dactylic hexameter	feminine penthemimeral, trithemimeral
νῶϊ μὲν ὣς ἐπέεσσιν ἀμειβομένω στυγεροῖσιν	-u u - uu-u u-uu- uu--	dactylic hexameter	feminine penthemimeral, trithemimeral
ἥμεθ’, ἐγὼ μὲν ἄνευθεν ἐφ’ αἵματι φάσγανον ἴσχων,	-u u- u u-u u -uu -uu --	dactylic hexameter	feminine penthemimeral, trithemimeral
εἴδωλον δ’ἑτέρωθεν ἑταίρου πόλλ’ ἀγόρευεν·	--- uu-u u-- - uu--	dactylic hexameter	feminine penthemimeral, trithemimeral
ἦλθε δ’ἐπὶ ψυχὴ μητρὸς κατατεθνηυίης,	-u u- -- -- uu----	dactylic hexameter	masculine penthemimeral, hepthemimeral, trithemimeral
Αὐτολύκου θυγάτηρ μεγαλήτορος Ἀντίκλεια,	-uu- uu- uu-uu ----	dactylic hexameter	masculine penthemimeral, trithemimeral
τὴν ζωὴν κατέλειπον ἰὼν εἰς Ἴλιον ἱρήν.	- -- uu-u u- - -uu --	dactylic hexameter	feminine penthemimeral, hepthemimeral, trithemimeral
τὴν μὲν ἐγὼ δάκρυσα ἰδὼν ἐλέησά τε θυμῷ·	- u u- --u u- uu-u u --	dactylic hexameter	feminine penthemimeral, hepthemimeral, trithemimeral
ἀλλ’ οὐδ’ ὣς εἴων προτέρην, πυκινόν περ ἀχεύων,	- - - -- uu- uu- u u--	dactylic hexameter	masculine penthemimeral, hepthemimeral, trithemimeral
αἵματος ἆσσον ἴμεν, πρὶν Τειρεσίαο πυθέσθαι.	-uu -u u- - -uu-u u--	dactylic hexameter	masculine penthemimeral
ἦλθε δ’ἐπὶ ψυχὴ Θηβαίου Τειρεσίαο	-u u- -- --- -uu--	dactylic hexameter	masculine penthemimeral, trithemimeral
χρύσεον σκῆπτρον ἔχων, ἐμὲ δ’ἔγνω καὶ προσέειπε·	-- -u u- uu -- - uu--	dactylic hexameter	masculine penthemimeral
διογενὲς Λαερτιάδη, πολυμήχαν’ Ὀδυσσεῦ,	-uu- --uu- uu-u u--	dactylic hexameter	hepthemimeral, trithemimeral
τίπτ’ αὖτ’, ὦ δύστηνε, λιπὼν φάος ἠελίοιο	- - - --u u- uu -uu--	dactylic hexameter	feminine penthemimeral, hepthemimeral, trithemimeral
ἤλυθες, ὄφρα ἴδῃς νέκυας καὶ ἀτερπέα χῶρον;	-uu -u u- uu- u u-uu --	dactylic hexameter	masculine penthemimeral, hepthemimeral
ἀλλ’ ἀποχάζεο βόθρου, ἄπισχε δὲ φάσγανον ὀξύ,	- uu-uu -u u-u u -uu --	dactylic hexameter	feminine penthemimeral
αἵματος ὄφρα πίω καί τοι νημερτέα εἴπω.	-uu -u u- - - --uu --	dactylic hexameter	masculine penthemimeral, hepthemimeral
ὣς φάτ’, ἐγὼ δ’ἀναχασσάμενος ξίφος ἀργυρόηλον	- u u- uu-uu- uu -uu--	dactylic hexameter	hepthemimeral, trithemimeral
κουλεῷ ἐγκατέπηξ’. ὁ δ’ἐπεὶ πίεν αἷμα κελαινόν,	-uu -uu- u u- uu -u u--	dactylic hexameter	masculine penthemimeral, hepthemimeral
καὶ τότε δή μ’ἐπέεσσι προσηύδα μάντις ἀμύμων·	- uu - uu-u u-- -u u--	dactylic hexameter	feminine penthemimeral, trithemimeral
νόστον δίζηαι μελιηδέα, φαίδιμ’ Ὀδυσσεῦ·	-- --- uu-uu -u u--	dactylic hexameter	masculine penthemimeral
τὸν δέ τοι ἀργαλέον θήσει θεός· οὐ γὰρ ὀΐω	- u u -uu- -- uu - u u--	dactylic hexameter	masculine penthemimeral, hepthemimeral
λήσειν ἐννοσίγαιον, ὅ τοι κότον ἔνθετο θυμῷ	-- -uu-u u - uu -uu --	dactylic hexameter	feminine penthemimeral, hepthemimeral
χωόμενος ὅτι οἱ υἱὸν φίλον ἐξαλάωσας.	-uu- uu - -- uu -uu--	dactylic hexameter	masculine penthemimeral, hepthemimeral, trithemimeral
ἀλλ’ ἔτι μέν κε καὶ ὣς κακά περ πάσχοντες ἵκοισθε,	- uu - u u - uu - --u u--	dactylic hexameter	masculine penthemimeral, hepthemimeral, trithemimeral
αἴ κ’ἐθέλῃς σὸν θυμὸν ἐρυκακέειν καὶ ἑταίρων,	- uu- - -u u-uu- u u--	dactylic hexameter	feminine penthemimeral, trithemimeral
ὁππότε δὴ πρῶτον πελάσῃς εὐεργέα νῆα	-uu - -- uu- --uu --	dactylic hexameter	masculine penthemimeral, hepthemimeral, trithemimeral
Θρινακίῃ νήσῳ, προφυγὼν ἰοειδέα πόντον,	-uu- -- uu- uu-uu --	dactylic hexameter	masculine penthemimeral, hepthemimeral, trithemimeral
βοσκομένας δ’εὕρητε βόας καὶ ἴφια μῆλα	-uu- --u u- - -uu --	dactylic hexameter	feminine penthemimeral, hepthemimeral, trithemimeral
Ἠελίου, ὃς πάντ’ ἐφορᾷ καὶ πάντ’ ἐπακούει.	-uu- - - uu- - - uu--	dactylic hexameter	masculine penthemimeral, hepthemimeral, trithemimeral
τὰς εἰ μέν κ’ἀσινέας ἐάᾳς νόστου τε μέδηαι,	- - - uu- uu- -- u u--	dactylic hexameter	masculine penthemimeral, hepthemimeral, trithemimeral
καί κεν ἔτ’ εἰς Ἰθάκην κακά περ πάσχοντες ἵκοισθε·	- u u - uu- uu - --u u--	dactylic hexameter	masculine penthemimeral, hepthemimeral, trithemimeral
εἰ δέ κε σίνηαι, τότε τοι τεκμαίρομ’ ὄλεθρον,	- u u --- uu - --u u--	dactylic hexameter	masculine penthemimeral, hepthemimeral
νηΐ τε καὶ ἑτάροις. αὐτὸς δ’εἴ πέρ κεν ἀλύξῃς,	-u u - uu- -- - - u u--	dactylic hexameter	masculine penthemimeral, hepthemimeral, trithemimeral
ὀψὲ κακῶς νεῖαι, ὀλέσας ἄπο πάντας ἑταίρους,	-u u- -- uu- uu -u u--	dactylic hexameter	masculine penthemimeral, hepthemimeral, trithemimeral
νηὸς ἐπ’ ἀλλοτρίης· δήεις δ’ἐν πήματα οἴκῳ,	-u u -uu- -- - -uu --	dactylic hexameter	masculine penthemimeral, hepthemimeral
ἄνδρας ὑπερφιάλους, οἵ τοι βίοτον κατέδουσι	-u u-uu- - - uu- uu--	dactylic hexameter	masculine penthemimeral, hepthemimeral
μνώμενοι ἀντιθέην ἄλοχον καὶ ἕδνα διδόντες.	-uu -uu- uu- - -u u--	dactylic hexameter	masculine penthemimeral, hepthemimeral
ἀλλ’ ἤτοι κείνων γε βίας ἀποτίσεαι ἐλθών·	- -- -- u u- uu-uu --	dactylic hexameter	masculine penthemimeral, hepthemimeral, trithemimeral
αὐτὰρ ἐπὴν μνηστῆρας ἐνὶ μεγάροισι τεοῖσι	-u u- --u u- uu-u u--	dactylic hexameter	feminine penthemimeral, hepthemimeral, trithemimeral
κτείνῃς ἠὲ δόλῳ ἢ ἀμφαδὸν ὀξέϊ χαλκῷ,	-- -u u- - -uu -uu --	dactylic hexameter	masculine penthemimeral
ἔρχεσθαι δὴ ἔπειτα λαβὼν εὐῆρες ἐρετμόν,	--- u u-u u- --u u--	dactylic hexameter	feminine penthemimeral, hepthemimeral, trithemimeral
εἰς ὅ κε τοὺς ἀφίκηαι οἳ οὐκ ἴσασι θάλασσαν	- u u - uu-u u - --u u--	dactylic hexameter	feminine penthemimeral, hepthemimeral, trithemimeral
ἀνέρες, οὐδέ θ’ἅλεσσι μεμιγμένον εἶδαρ ἔδουσιν·	-uu -u u-u u-uu -u u--	dactylic hexameter	feminine penthemimeral
οὐδ’ ἄρα τοί γ’ἴσασι νέας φοινικοπαρήους	- uu - --u u- --uu--	dactylic hexameter	feminine penthemimeral, hepthemimeral, trithemimeral
οὐδ’ εὐήρε’ ἐρετμά, τά τε πτερὰ νηυσὶ πέλονται.	- --u u-u u - uu -u u--	dactylic hexameter	feminine penthemimeral, hepthemimeral
σῆμα δέ τοι ἐρέω μάλ’ ἀριφραδές, οὐδέ σε λήσει·	-u u - uu- u u-uu -u u --	dactylic hexameter	masculine penthemimeral, trithemimeral
ὁππότε κεν δή τοι ξυμβλήμενος ἄλλος ὁδίτης	-uu - - - --uu -u u--	dactylic hexameter	masculine penthemimeral, trithemimeral
φήῃ ἀθηρηλοιγὸν ἔχειν ἀνὰ φαιδίμῳ ὤμῳ,	-u u---u u- uu -uu --	dactylic hexameter	feminine penthemimeral, hepthemimeral
καὶ τότε δὴ γαίῃ πήξας εὐῆρες ἐρετμόν,	- uu - -- -- --u u--	dactylic hexameter	masculine penthemimeral, hepthemimeral, trithemimeral
ῥέξας ἱερὰ καλὰ Ποσειδάωνι ἄνακτι,	-- -uu -u u---u u--	dactylic hexameter	feminine penthemimeral
ἀρνειὸν ταῦρόν τε συῶν τ’ἐπιβήτορα κάπρον,	--- -- u u- uu-uu --	dactylic hexameter	masculine penthemimeral, hepthemimeral, trithemimeral
οἴκαδ’ ἀποστείχειν ἔρδειν θ’ἱερᾶς ἑκατόμβας	-u u--- -- uu- uu--	dactylic hexameter	masculine penthemimeral, hepthemimeral
ἀθανάτοισι θεοῖσι, τοὶ οὐρανὸν εὐρὺν ἔχουσι,	-uu-u u-u u -uu -u u--	dactylic hexameter	feminine penthemimeral
πᾶσι μάλ’ ἑξείης. θάνατος δέ τοι ἐξ ἁλὸς αὐτῷ	-u u --- uu- u u - uu --	dactylic hexameter	masculine penthemimeral, hepthemimeral
ἀβληχρὸς μάλα τοῖος ἐλεύσεται, ὅς κέ σε πέφνῃ	--- uu -u u-uu - u u --	dactylic hexameter	feminine penthemimeral, trithemimeral
γήρᾳ ὕπο λιπαρῷ ἀρημένον· ἀμφὶ δὲ λαοὶ	-u u- uu- --uu -u u --	dactylic hexameter	masculine penthemimeral, trithemimeral
ὄλβιοι ἔσσονται. τὰ δέ τοι νημερτέα εἴρω.	-uu --- u u - --uu --	dactylic hexameter	masculine penthemimeral, hepthemimeral
ὣς ἔφατ’, αὐτὰρ ἐγώ μιν ἀμειβόμενος προσέειπον·	- uu -u u- u u-uu- uu--	dactylic hexameter	masculine penthemimeral
Τειρεσίη, τὰ μὲν ἄρ που ἐπέκλωσαν θεοὶ αὐτοί.	-uu- u u - u u--- uu --	dactylic hexameter	masculine penthemimeral, trithemimeral
ἀλλ’ ἄγε μοι τόδε εἰπὲ καὶ ἀτρεκέως κατάλεξον·	- uu - uu -u u -uu- uu--	dactylic hexameter	feminine penthemimeral, trithemimeral
μητρὸς τήνδ’ ὁρόω ψυχὴν κατατεθνηυίης·	-- - uu- -- uu----	dactylic hexameter	masculine penthemimeral, hepthemimeral, trithemimeral
ἡ δ’ἀκέουσ’ ἧσται σχεδὸν αἵματος, οὐδ’ ἑὸν υἱὸν	- uu- -- uu -uu - uu --	dactylic hexameter	masculine penthemimeral, trithemimeral
ἔτλη ἐσάντα ἰδεῖν οὐδὲ προτιμυθήσασθαι.	-u u-u u- -- uu----	dactylic hexameter	masculine penthemimeral, hepthemimeral
εἰπέ, ἄναξ, πῶς κέν με ἀναγνοίη τὸν ἐόντα;	-u u- - - u u--- u u--	dactylic hexameter	masculine penthemimeral, trithemimeral
ὣς ἐφάμην, ὁ δέ μ’αὐτίκ’ ἀμειβόμενος προσέειπε·	- uu- u u -u u-uu- uu--	dactylic hexameter	feminine penthemimeral, trithemimeral
ῥηΐδιόν τοι ἔπος ἐρέω καὶ ἐπὶ φρεσὶ θήσω.	-uu- u u- uu- u u- uu --	dactylic hexameter	masculine penthemimeral, hepthemimeral, trithemimeral
ὅν τινα μέν κεν ἐᾷς νεκύων κατατεθνηώτων	- uu - u u- uu- uu----	dactylic hexameter	masculine penthemimeral, hepthemimeral, trithemimeral
αἵματος ἆσσον ἴμεν, ὁ δέ τοι νημερτὲς ἐνίψει·	-uu -u u- u u - --u u--	dactylic hexameter	masculine penthemimeral, hepthemimeral
ᾧ δέ κ’ἐπιφθονέοις, ὁ δέ τοι πάλιν εἶσιν ὀπίσσω.	- u u-uu- u u - uu -u u--	dactylic hexameter	masculine penthemimeral, hepthemimeral
ὣς φαμένη ψυχὴ μὲν ἔβη δόμον Ἄϊδος εἴσω	- uu- -- u u- uu -uu --	dactylic hexameter	masculine penthemimeral, hepthemimeral, trithemimeral
Τειρεσίαο ἄνακτος, ἐπεὶ κατὰ θέσφατ’ ἔλεξεν·	-uu-u u-u u- uu -u u--	dactylic hexameter	feminine penthemimeral, hepthemimeral
αὐτὰρ ἐγὼν αὐτοῦ μένον ἔμπεδον, ὄφρ’ ἐπὶ μήτηρ	-u u- -- uu -uu - uu --	dactylic hexameter	masculine penthemimeral, trithemimeral
ἤλυθε καὶ πίεν αἷμα κελαινεφές· αὐτίκα δ’ἔγνω,	-uu - uu -u u-uu -uu --	dactylic hexameter	feminine penthemimeral, trithemimeral
καί μ’ὀλοφυρομένη ἔπεα πτερόεντα προσηύδα·	- uu-uu- uu- uu-u u--	dactylic hexameter	masculine penthemimeral, hepthemimeral
τέκνον ἐμόν, πῶς ἦλθες ὑπὸ ζόφον ἠερόεντα	-u u- - -u u- uu -uu--	dactylic hexameter	feminine penthemimeral, hepthemimeral, trithemimeral
ζωὸς ἐών; χαλεπὸν δὲ τάδε ζωοῖσιν ὁρᾶσθαι.	-u u- uu- u u- --u u--	dactylic hexameter	masculine penthemimeral, hepthemimeral, trithemimeral
μέσσῳ γὰρ μεγάλοι ποταμοὶ καὶ δεινὰ ῥέεθρα,	-- - uu- uu- - -u u--	dactylic hexameter	masculine penthemimeral, hepthemimeral, trithemimeral
Ὠκεανὸς μὲν πρῶτα, τὸν οὔ πως ἔστι περῆσαι	-uu- - -u u - - -u u--	dactylic hexameter	feminine penthemimeral, hepthemimeral, trithemimeral
πεζὸν ἐόντ’, ἢν μή τις ἔχῃ εὐεργέα νῆα.	-u u- - - u u- --uu --	dactylic hexameter	masculine penthemimeral, hepthemimeral, trithemimeral
ἦ νῦν δὴ Τροίηθεν ἀλώμενος ἐνθάδ’ ἱκάνεις	- - - --u u-uu -u u--	dactylic hexameter	feminine penthemimeral, trithemimeral
νηΐ τε καὶ ἑτάροισι πολὺν χρόνον; οὐδέ πω ἦλθες	-u u - uu-u u- uu -u u --	dactylic hexameter	feminine penthemimeral, hepthemimeral, trithemimeral
εἰς Ἰθάκην, οὐδ’ εἶδες ἐνὶ μεγάροισι γυναῖκα;	- uu- - -u u- uu-u u--	dactylic hexameter	feminine penthemimeral, hepthemimeral, trithemimeral
ὣς ἔφατ’, αὐτὰρ ἐγώ μιν ἀμειβόμενος προσέειπον·	- uu -u u- u u-uu- uu--	dactylic hexameter	masculine penthemimeral
μῆτερ ἐμή, χρειώ με κατήγαγεν εἰς Ἀΐδαο	-u u- -- u u-uu - uu--	dactylic hexameter	masculine penthemimeral, trithemimeral
ψυχῇ χρησόμενον Θηβαίου Τειρεσίαο·	-- -uu- --- -uu--	dactylic hexameter	masculine penthemimeral
οὐ γάρ πω σχεδὸν ἦλθον Ἀχαιΐδος, οὐδέ πω ἁμῆς	- - - uu -u u-uu -u u --	dactylic hexameter	feminine penthemimeral, trithemimeral
γῆς ἐπέβην, ἀλλ’ αἰὲν ἔχων ἀλάλημαι ὀϊζύν,	- uu- - -u u- uu-u u--	dactylic hexameter	feminine penthemimeral, hepthemimeral, trithemimeral
ἐξ οὗ τὰ πρώτισθ’ ἑπόμην Ἀγαμέμνονι δίῳ	- - - -- uu- uu-uu --	dactylic hexameter	masculine penthemimeral, hepthemimeral, trithemimeral
Ἴλιον εἰς εὔπωλον, ἵνα Τρώεσσι μαχοίμην.	-uu - --u u- --u u--	dactylic hexameter	feminine penthemimeral, hepthemimeral, trithemimeral
ἀλλ’ ἄγε μοι τόδε εἰπὲ καὶ ἀτρεκέως κατάλεξον·	- uu - uu -u u -uu- uu--	dactylic hexameter	feminine penthemimeral, trithemimeral
τίς νύ σε κὴρ ἐδάμασσε τανηλεγέος θανάτοιο;	- u u - uu-u u-uu- uu--	dactylic hexameter	feminine penthemimeral, trithemimeral
ἢ δολιχὴ νοῦσος, ἦ Ἄρτεμις ἰοχέαιρα	- uu- -- - -uu -uu--	dactylic hexameter	masculine penthemimeral, trithemimeral
οἷς ἀγανοῖς βελέεσσιν ἐποιχομένη κατέπεφνεν;	- uu- uu-u u-uu- uu--	dactylic hexameter	feminine penthemimeral, trithemimeral
εἰπὲ δέ μοι πατρός τε καὶ υἱέος, ὃν κατέλειπον,	-u u - -- u u -uu - uu--	dactylic hexameter	masculine penthemimeral, trithemimeral
ἢ ἔτι πὰρ κείνοισιν ἐμὸν γέρας, ἦέ τις ἤδη	- uu - --u u- uu -u u --	dactylic hexameter	feminine penthemimeral, hepthemimeral, trithemimeral
ἀνδρῶν ἄλλος ἔχει, ἐμὲ δ’οὐκέτι φασὶ νέεσθαι.	-- -u u- uu -uu -u u--	dactylic hexameter	masculine penthemimeral
εἰπὲ δέ μοι μνηστῆς ἀλόχου βουλήν τε νόον τε,	-u u - -- uu- -- u u- -	dactylic hexameter	masculine penthemimeral, hepthemimeral, trithemimeral
ἠὲ μένει παρὰ παιδὶ καὶ ἔμπεδα πάντα φυλάσσει	-u u- uu -u u -uu -u u--	dactylic hexameter	feminine penthemimeral, trithemimeral
ἦ ἤδη μιν ἔγημεν Ἀχαιῶν ὅς τις ἄριστος.	- -- u u-u u-- - u u--	dactylic hexameter	feminine penthemimeral, trithemimeral
ὣς ἐφάμην, ἡ δ’αὐτίκ’ ἀμείβετο πότνια μήτηρ·	- uu- - -u u-uu -uu --	dactylic hexameter	feminine penthemimeral, trithemimeral
καὶ λίην κείνη γε μένει τετληότι θυμῷ	- -- -- u u- --uu --	dactylic hexameter	masculine penthemimeral, hepthemimeral, trithemimeral
σοῖσιν ἐνὶ μεγάροισιν· ὀϊζυραὶ δέ οἱ αἰεὶ	-u u- uu-u u--- u u --	dactylic hexameter	feminine penthemimeral, trithemimeral
φθίνουσιν νύκτες τε καὶ ἤματα δάκρυ χεούσῃ.	--- -- u u -uu -u u--	dactylic hexameter	masculine penthemimeral, trithemimeral
σὸν δ’οὔ πώ τις ἔχει καλὸν γέρας, ἀλλὰ ἕκηλος	- - - u u- -- uu -u u--	dactylic hexameter	masculine penthemimeral, hepthemimeral, trithemimeral
Τηλέμαχος τεμένη νέμεται καὶ δαῖτας ἐΐσας	-uu- uu- uu- - -u u--	dactylic hexameter	masculine penthemimeral, hepthemimeral, trithemimeral
δαίνυται, ἃς ἐπέοικε δικασπόλον ἄνδρ’ ἀλεγύνειν·	-uu - uu-u u-uu - uu--	dactylic hexameter	feminine penthemimeral, trithemimeral
πάντες γὰρ καλέουσι. πατὴρ δὲ σὸς αὐτόθι μίμνει	-- - uu-u u- u u -uu --	dactylic hexameter	feminine penthemimeral, hepthemimeral, trithemimeral
ἀγρῷ, οὐδὲ πόλινδε κατέρχεται. οὐδέ οἱ εὐναὶ	-- -u u-u u-uu -u u --	dactylic hexameter	feminine penthemimeral
δέμνια καὶ χλαῖναι καὶ ῥήγεα σιγαλόεντα,	-uu - -- - -uu -uu--	dactylic hexameter	masculine penthemimeral, trithemimeral
ἀλλ’ ὅ γε χεῖμα μὲν εὕδει ὅθι δμῶες ἐνὶ οἴκῳ,	- u u -u u -u u- -- uu --	dactylic hexameter	feminine penthemimeral, hepthemimeral
ἐν κόνι ἄγχι πυρός, κακὰ δὲ χροῒ εἵματα εἷται·	- uu -u u- uu - uu -uu --	dactylic hexameter	masculine penthemimeral, hepthemimeral
αὐτὰρ ἐπὴν ἔλθῃσι θέρος τεθαλυῖά τ’ὀπώρη,	-u u- --u u- uu-u u--	dactylic hexameter	feminine penthemimeral, hepthemimeral, trithemimeral
πάντῃ οἱ κατὰ γουνὸν ἀλωῆς οἰνοπέδοιο	-- - uu -u u-- -uu--	dactylic hexameter	feminine penthemimeral, trithemimeral
φύλλων κεκλιμένων χθαμαλαὶ βεβλήαται εὐναί.	-- -uu- uu- --uu --	dactylic hexameter	masculine penthemimeral, hepthemimeral
ἔνθ’ ὅ γε κεῖτ’ ἀχέων, μέγα δὲ φρεσὶ πένθος ἀέξει	- u u - uu- uu - uu -u u--	dactylic hexameter	masculine penthemimeral, hepthemimeral, trithemimeral
σὸν πότμον γοόων, χαλεπὸν δ’ἐπὶ γῆρας ἱκάνει.	- -- uu- uu- uu -u u--	dactylic hexameter	masculine penthemimeral, hepthemimeral, trithemimeral
οὕτω γὰρ καὶ ἐγὼν ὀλόμην καὶ πότμον ἐπέσπον·	-- - u u- uu- - -u u--	dactylic hexameter	masculine penthemimeral, hepthemimeral, trithemimeral
οὔτ’ ἐμέ γ’ἐν μεγάροισιν ἐΰσκοπος ἰοχέαιρα	- uu - uu-u u-uu -uu--	dactylic hexameter	feminine penthemimeral, trithemimeral
οἷς ἀγανοῖς βελέεσσιν ἐποιχομένη κατέπεφνεν,	- uu- uu-u u-uu- uu--	dactylic hexameter	feminine penthemimeral, trithemimeral
οὔτε τις οὖν μοι νοῦσος ἐπήλυθεν, ἥ τε μάλιστα	-u u - - -u u-uu - u u--	dactylic hexameter	feminine penthemimeral, trithemimeral
τηκεδόνι στυγερῇ μελέων ἐξείλετο θυμόν·	-uu- uu- uu- --uu --	dactylic hexameter	masculine penthemimeral, hepthemimeral, trithemimeral
ἀλλά με σός τε πόθος σά τε μήδεα, φαίδιμ’ Ὀδυσσεῦ,	-u u - u u- u u -uu -u u--	dactylic hexameter	masculine penthemimeral, trithemimeral
σή τ’ἀγανοφροσύνη μελιηδέα θυμὸν ἀπηύρα.	- uu-uu- uu-uu -u u--	dactylic hexameter	masculine penthemimeral
ὣς ἔφατ’, αὐτὰρ ἔγωγ’ ἔθελον φρεσὶ μερμηρίξας	- uu -u u- uu- uu ----	dactylic hexameter	masculine penthemimeral, hepthemimeral
μητρὸς ἐμῆς ψυχὴν ἑλέειν κατατεθνηυίης.	-u u- -- uu- uu----	dactylic hexameter	masculine penthemimeral, hepthemimeral, trithemimeral
τρὶς μὲν ἐφωρμήθην, ἑλέειν τέ με θυμὸς ἄνωγε,	- u u--- uu- u u -u u--	dactylic hexameter	masculine penthemimeral, hepthemimeral
τρὶς δέ μοι ἐκ χειρῶν σκιῇ εἴκελον ἢ καὶ ὀνείρῳ	- u u - -- uu -uu - u u--	dactylic hexameter	masculine penthemimeral, trithemimeral
ἔπτατ’. ἐμοὶ δ’ἄχος ὀξὺ γενέσκετο κηρόθι μᾶλλον,	-u u- uu -u u-uu -uu --	dactylic hexameter	feminine penthemimeral, trithemimeral
καί μιν φωνήσας ἔπεα πτερόεντα προσηύδων·	- - --- uu- uu-u u--	dactylic hexameter	masculine penthemimeral, hepthemimeral
μῆτερ ἐμή, τί νύ μ’οὐ μίμνεις ἑλέειν μεμαῶτα,	-u u- u u - -- uu- uu--	dactylic hexameter	masculine penthemimeral, hepthemimeral, trithemimeral
ὄφρα καὶ εἰν Ἀΐδαο φίλας περὶ χεῖρε βαλόντε	-u u - uu-u u- uu -u u--	dactylic hexameter	feminine penthemimeral, hepthemimeral, trithemimeral
ἀμφοτέρω κρυεροῖο τεταρπώμεσθα γόοιο;	-uu- uu-u u---u u--	dactylic hexameter	feminine penthemimeral, trithemimeral
ἦ τί μοι εἴδωλον τόδ’ ἀγαυὴ Περσεφόνεια	- u u --- u u-- -uu--	dactylic hexameter	masculine penthemimeral
ὤτρυν’, ὄφρ’ ἔτι μᾶλλον ὀδυρόμενος στεναχίζω;	-- - uu -u u-uu- uu--	dactylic hexameter	feminine penthemimeral, trithemimeral
ὣς ἐφάμην, ἡ δ’αὐτίκ’ ἀμείβετο πότνια μήτηρ·	- uu- - -u u-uu -uu --	dactylic hexameter	feminine penthemimeral, trithemimeral
ὤ μοι, τέκνον ἐμόν, περὶ πάντων κάμμορε φωτῶν,	- - -u u- uu -- -uu --	dactylic hexameter	masculine penthemimeral
οὔ τί σε Περσεφόνεια Διὸς θυγάτηρ ἀπαφίσκει,	- u u -uu-u u- uu- uu--	dactylic hexameter	feminine penthemimeral, hepthemimeral
ἀλλ’ αὕτη δίκη ἐστὶ βροτῶν, ὅτε τίς κε θάνῃσιν·	- -- uu -u u- uu - u u--	dactylic hexameter	feminine penthemimeral, hepthemimeral, trithemimeral
οὐ γὰρ ἔτι σάρκας τε καὶ ὀστέα ἶνες ἔχουσιν,	- u u- -- u u -uu -u u--	dactylic hexameter	masculine penthemimeral, trithemimeral
ἀλλὰ τὰ μέν τε πυρὸς κρατερὸν μένος αἰθομένοιο	-u u - u u- uu- uu -uu--	dactylic hexameter	masculine penthemimeral, hepthemimeral, trithemimeral
δαμνᾷ, ἐπεί κε πρῶτα λίπῃ λεύκ’ ὀστέα θυμός,	-u u- - -u u- - -uu --	dactylic hexameter	feminine penthemimeral, hepthemimeral, trithemimeral
ψυχὴ δ’ἠΰτ’ ὄνειρος ἀποπταμένη πεπότηται.	-- -u u-u u-uu- uu--	dactylic hexameter	feminine penthemimeral
ἀλλὰ φόωσδε τάχιστα λιλαίεο· ταῦτα δὲ πάντα	-u u-u u-u u-uu -u u --	dactylic hexameter	feminine penthemimeral
ἴσθ’, ἵνα καὶ μετόπισθε τεῇ εἴπῃσθα γυναικί.	- uu - uu-u u- --u u--	dactylic hexameter	feminine penthemimeral, hepthemimeral, trithemimeral
νῶϊ μὲν ὣς ἐπέεσσιν ἀμειβόμεθ’, αἱ δὲ γυναῖκες	-u u - uu-u u-uu - u u--	dactylic hexameter	feminine penthemimeral, trithemimeral
ἤλυθον, ὤτρυνεν γὰρ ἀγαυὴ Περσεφόνεια,	-uu --- u u-- -uu--	dactylic hexameter	masculine penthemimeral
ὅσσαι ἀριστήων ἄλοχοι ἔσαν ἠδὲ θύγατρες.	-u u--- uu- uu -u u--	dactylic hexameter	masculine penthemimeral, hepthemimeral
αἱ δ’ἀμφ’ αἷμα κελαινὸν ἀολλέες ἠγερέθοντο,	- - -u u-u u-uu -uu--	dactylic hexameter	feminine penthemimeral
αὐτὰρ ἐγὼ βούλευον ὅπως ἐρέοιμι ἑκάστην.	-u u- --u u- uu-u u--	dactylic hexameter	feminine penthemimeral, hepthemimeral, trithemimeral
ἥδε δέ μοι κατὰ θυμὸν ἀρίστη φαίνετο βουλή·	-u u - uu -u u-- -uu --	dactylic hexameter	feminine penthemimeral, trithemimeral
σπασσάμενος τανύηκες ἄορ παχέος παρὰ μηροῦ	-uu- uu-u u- uu- uu --	dactylic hexameter	feminine penthemimeral, hepthemimeral, trithemimeral
οὐκ εἴων πίνειν ἅμα πάσας αἷμα κελαινόν.	- -- -- uu -- -u u--	dactylic hexameter	masculine penthemimeral, trithemimeral
αἱ δὲ προμνηστῖναι ἐπήϊσαν, ἠδὲ ἑκάστη	- - ---u u-uu -u u--	dactylic hexameter	feminine penthemimeral
ὃν γόνον ἐξαγόρευεν· ἐγὼ δ’ἐρέεινον ἁπάσας.	- uu -uu-u u- uu-u u--	dactylic hexameter	feminine penthemimeral, hepthemimeral
ἔνθ’ ἤτοι πρώτην Τυρὼ ἴδον εὐπατέρειαν,	- -- -- -- uu -uu--	dactylic hexameter	masculine penthemimeral, hepthemimeral, trithemimeral
ἣ φάτο Σαλμωνῆος ἀμύμονος ἔκγονος εἶναι,	- uu ---u u-uu -uu --	dactylic hexameter	feminine penthemimeral
φῆ δὲ Κρηθῆος γυνὴ ἔμμεναι Αἰολίδαο·	- - --- uu -uu -uu--	dactylic hexameter	masculine penthemimeral
ἣ ποταμοῦ ἠράσσατ’ Ἐνιπῆος θείοιο,	- uu- --u u--- ---	dactylic hexameter	feminine penthemimeral, trithemimeral
ὃς πολὺ κάλλιστος ποταμῶν ἐπὶ γαῖαν ἵησι,	- uu --- uu- uu -u u--	dactylic hexameter	masculine penthemimeral, hepthemimeral
καί ῥ’ἐπ’ Ἐνιπῆος πωλέσκετο καλὰ ῥέεθρα.	- u u--- --uu -u u--	dactylic hexameter	masculine penthemimeral
τῷ δ’ἄρα εἰσάμενος γαιήοχος ἐννοσίγαιος	- uu -uu- --uu -uu--	dactylic hexameter	masculine penthemimeral
ἐν προχοῇς ποταμοῦ παρελέξατο δινήεντος·	- uu- uu- uu-uu ----	dactylic hexameter	masculine penthemimeral, trithemimeral
πορφύρεον δ’ἄρα κῦμα περιστάθη, οὔρεϊ ἶσον,	-uu- uu -u u-uu -uu --	dactylic hexameter	feminine penthemimeral, trithemimeral
κυρτωθέν, κρύψεν δὲ θεὸν θνητήν τε γυναῖκα.	--- -- u u- -- u u--	dactylic hexameter	masculine penthemimeral, hepthemimeral, trithemimeral
λῦσε δὲ παρθενίην ζώνην, κατὰ δ’ὕπνον ἔχευεν.	-u u -uu- -- uu -u u--	dactylic hexameter	masculine penthemimeral, hepthemimeral
αὐτὰρ ἐπεί ῥ’ἐτέλεσσε θεὸς φιλοτήσια ἔργα,	-u u- uu-u u- uu-uu --	dactylic hexameter	feminine penthemimeral, hepthemimeral, trithemimeral
ἔν τ’ἄρα οἱ φῦ χειρί, ἔπος τ’ἔφατ’ ἔκ τ’ὀνόμαζε·	- uu - - -u u- uu - uu--	dactylic hexameter	feminine penthemimeral, hepthemimeral, trithemimeral
χαῖρε, γύναι, φιλότητι· περιπλομένου δ’ἐνιαυτοῦ	-u u- uu-u u-uu- uu--	dactylic hexameter	feminine penthemimeral, trithemimeral
τέξεις ἀγλαὰ τέκν’, ἐπεὶ οὐκ ἀποφώλιοι εὐναὶ	-- -uu - uu - uu-uu --	dactylic hexameter	masculine penthemimeral, hepthemimeral
ἀθανάτων· σὺ δὲ τοὺς κομέειν ἀτιταλλέμεναί τε.	-uu- u u - uu- uu-uu- -	dactylic hexameter	masculine penthemimeral, hepthemimeral, trithemimeral
νῦν δ’ἔρχευ πρὸς δῶμα, καὶ ἴσχεο μηδ’ ὀνομήνῃς·	- -- - -u u -uu - uu--	dactylic hexameter	feminine penthemimeral, trithemimeral
αὐτὰρ ἐγώ τοί εἰμι Ποσειδάων ἐνοσίχθων.	-u u- - -u u--- uu--	dactylic hexameter	feminine penthemimeral, trithemimeral
ὣς εἰπὼν ὑπὸ πόντον ἐδύσατο κυμαίνοντα.	- -- uu -u u-uu ----	dactylic hexameter	feminine penthemimeral, trithemimeral
ἡ δ’ὑποκυσαμένη Πελίην τέκε καὶ Νηλῆα,	- uu-uu- uu- uu - ---	dactylic hexameter	masculine penthemimeral, hepthemimeral
τὼ κρατερὼ θεράποντε Διὸς μεγάλοιο γενέσθην	- uu- uu-u u- uu-u u--	dactylic hexameter	feminine penthemimeral, hepthemimeral, trithemimeral
ἀμφοτέρω· Πελίης μὲν ἐν εὐρυχόρῳ Ἰαωλκῷ	-uu- uu- u u -uu- uu--	dactylic hexameter	masculine penthemimeral, trithemimeral
ναῖε πολύρρηνος, ὁ δ’ἄρ’ ἐν Πύλῳ ἠμαθόεντι.	-u u--- u u - uu -uu--	dactylic hexameter	masculine penthemimeral, hepthemimeral
τοὺς δ’ἑτέρους Κρηθῆι τέκεν βασίλεια γυναικῶν,	- uu- --u u- uu-u u--	dactylic hexameter	feminine penthemimeral, hepthemimeral, trithemimeral
Αἴσονά τ’ἠδὲ Φέρητ’ Ἀμυθάονά θ’ἱππιοχάρμην.	-uu -u u- uu-uu -uu--	dactylic hexameter	masculine penthemimeral
τὴν δὲ μετ’ Ἀντιόπην ἴδον, Ἀσωποῖο θύγατρα,	- u u -uu- uu ---u u--	dactylic hexameter	masculine penthemimeral
ἣ δὴ καὶ Διὸς εὔχετ’ ἐν ἀγκοίνῃσιν ἰαῦσαι,	- - - uu -u u ---u u--	dactylic hexameter	feminine penthemimeral, trithemimeral
καί ῥ’ἔτεκεν δύο παῖδ’, Ἀμφίονά τε Ζῆθόν τε,	- uu- uu - --uu - -- -	dactylic hexameter	masculine penthemimeral, trithemimeral
οἳ πρῶτοι Θήβης ἕδος ἔκτισαν ἑπταπύλοιο,	- -- -- uu -uu -uu--	dactylic hexameter	masculine penthemimeral, trithemimeral
πύργωσάν τ’,ἐπεὶ οὐ μὲν ἀπύργωτόν γ’ἐδύναντο	--- uu - u u--- uu--	dactylic hexameter	masculine penthemimeral, trithemimeral
ναιέμεν εὐρύχορον Θήβην, κρατερώ περ ἐόντε.	-uu -uu- -- uu- u u--	dactylic hexameter	masculine penthemimeral, hepthemimeral
τὴν δὲ μετ’ Ἀλκμήνην ἴδον, Ἀμφιτρύωνος ἄκοιτιν,	- u u --- uu -uu-u u--	dactylic hexameter	masculine penthemimeral
ἥ ῥ’Ἡρακλῆα θρασυμέμνονα θυμολέοντα	- ---- uu-uu -uu--	dactylic hexameter	masculine penthemimeral
γείνατ’ ἐν ἀγκοίνῃσι Διὸς μεγάλοιο μιγεῖσα·	-u u ---u u- uu-u u--	dactylic hexameter	feminine penthemimeral, hepthemimeral
καὶ Μεγάρην, Κρείοντος ὑπερθύμοιο θύγατρα,	- uu- --u u---u u--	dactylic hexameter	feminine penthemimeral, trithemimeral
τὴν ἔχεν Ἀμφιτρύωνος υἱὸς μένος αἰὲν ἀτειρής.	- uu -uu-u u- uu -u u--	dactylic hexameter	feminine penthemimeral, hepthemimeral
μητέρα τ’Οἰδιπόδαο ἴδον, καλὴν Ἐπικάστην,	-uu -uu-u u- -- uu--	dactylic hexameter	feminine penthemimeral, hepthemimeral
ἣ μέγα ἔργον ἔρεξεν ἀϊδρείῃσι νόοιο	- uu -u u-u u---u u--	dactylic hexameter	feminine penthemimeral
γημαμένη ᾧ υἷι· ὁ δ’ὃν πατέρ’ ἐξεναρίξας	-uu- - -u u - uu -uu--	dactylic hexameter	feminine penthemimeral, hepthemimeral, trithemimeral
γῆμεν· ἄφαρ δ’ἀνάπυστα θεοὶ θέσαν ἀνθρώποισιν.	-u u- uu-u u- uu ----	dactylic hexameter	feminine penthemimeral, hepthemimeral, trithemimeral
ἀλλ’ ὁ μὲν ἐν Θήβῃ πολυηράτῳ ἄλγεα πάσχων	- u u - -- uu-uu -uu --	dactylic hexameter	masculine penthemimeral, trithemimeral
Καδμείων ἤνασσε θεῶν ὀλοὰς διὰ βουλάς·	--- --u u- uu- uu --	dactylic hexameter	feminine penthemimeral, hepthemimeral, trithemimeral
ἡ δ’ἔβη εἰς Ἀΐδαο πυλάρταο κρατεροῖο,	- uu - uu-u u--- uu--	dactylic hexameter	feminine penthemimeral, trithemimeral
ἁψαμένη βρόχον αἰπὺν ἀφ’ ὑψηλοῖο μελάθρου,	-uu- uu -u u ---u u--	dactylic hexameter	feminine penthemimeral, trithemimeral
ᾧ ἄχεϊ σχομένη· τῷ δ’ἄλγεα κάλλιπ’ ὀπίσσω	- uu- uu- - -uu -u u--	dactylic hexameter	masculine penthemimeral, trithemimeral
πολλὰ μάλ’, ὅσσα τε μητρὸς Ἐρινύες ἐκτελέουσι.	-u u -u u -u u-uu -uu--	dactylic hexameter	feminine penthemimeral
καὶ Χλῶριν εἶδον περικαλλέα, τήν ποτε Νηλεὺς	- -- -- uu-uu - uu --	dactylic hexameter	masculine penthemimeral, trithemimeral
γῆμεν ἑὸν διὰ κάλλος, ἐπεὶ πόρε μυρία ἕδνα,	-u u- uu -u u- uu -uu --	dactylic hexameter	feminine penthemimeral, hepthemimeral, trithemimeral
ὁπλοτάτην κούρην Ἀμφίονος Ἰασίδαο,	-uu- -- --uu -uu--	dactylic hexameter	masculine penthemimeral, trithemimeral
ὅς ποτ’ ἐν Ὀρχομενῷ Μινυείῳ ἶφι ἄνασσεν·	- u u -uu- uu-- -u u--	dactylic hexameter	masculine penthemimeral
ἡ δὲ Πύλου βασίλευε, τέκεν δέ οἱ ἀγλαὰ τέκνα,	- u u- uu-u u- u u -uu --	dactylic hexameter	feminine penthemimeral, hepthemimeral, trithemimeral
Νέστορά τε Χρόμιον τε Περικλύμενόν τ’ἀγέρωχον.	-uu - uu- u u-uu- uu--	dactylic hexameter	masculine penthemimeral, trithemimeral
τοῖσι δ’ἐπ’ ἰφθίμην Πηρὼ τέκε, θαῦμα βροτοῖσι,	-u u --- -- uu -u u--	dactylic hexameter	masculine penthemimeral, hepthemimeral
τὴν πάντες μνώοντο περικτίται· οὐδέ τι Νηλεὺς	- -- --u u-uu -u u --	dactylic hexameter	feminine penthemimeral, trithemimeral
τῷ ἐδίδου ὃς μὴ ἕλικας βόας εὐρυμετώπους	- uu- - - uu- uu -uu--	dactylic hexameter	masculine penthemimeral, hepthemimeral, trithemimeral
ἐκ Φυλάκης ἐλάσειε βίης Ἰφικληείης	- uu- uu-u u- -----	dactylic hexameter	feminine penthemimeral, hepthemimeral, trithemimeral
ἀργαλέας· τὰς δ’οἶος ὑπέσχετο μάντις ἀμύμων	-uu- - -u u-uu -u u--	dactylic hexameter	feminine penthemimeral, trithemimeral
ἐξελάαν· χαλεπὴ δὲ θεοῦ κατὰ μοῖρ’ ἐπέδησε,	-uu- uu- u u- uu - uu--	dactylic hexameter	masculine penthemimeral, hepthemimeral, trithemimeral
δεσμοί τ’ἀργαλέοι καὶ βουκόλοι ἀγροιῶται.	-- -uu- - -uu ----	dactylic hexameter	masculine penthemimeral
ἀλλ’ ὅτε δὴ μῆνές τε καὶ ἡμέραι ἐξετελεῦντο	- uu - -- u u -uu -uu--	dactylic hexameter	masculine penthemimeral, trithemimeral
ἂψ περιτελλομένου ἔτεος καὶ ἐπήλυθον ὧραι,	- uu-uu- uu- u u-uu --	dactylic hexameter	masculine penthemimeral, hepthemimeral
καὶ τότε δή μιν ἔλυσε βίη Ἰφικληείη,	- uu - u u-u u- -----	dactylic hexameter	feminine penthemimeral, hepthemimeral, trithemimeral
θέσφατα πάντ’ εἰπόντα· Διὸς δ’ἐτελείετο βουλή.	-uu - --u u- uu-uu --	dactylic hexameter	feminine penthemimeral, hepthemimeral, trithemimeral
καὶ Λήδην εἶδον, τὴν Τυνδαρέου παράκοιτιν,	- -- -- - -uu- uu--	dactylic hexameter	masculine penthemimeral, trithemimeral
ἥ ῥ’ὑπὸ Τυνδαρέῳ κρατερόφρονε γείνατο παῖδε,	- uu -uu- uu-uu -uu --	dactylic hexameter	masculine penthemimeral
Κάστορά θ’ἱππόδαμον καὶ πὺξ ἀγαθὸν Πολυδεύκεα,	-uu -uu- - - uu- uu--	dactylic hexameter	masculine penthemimeral, hepthemimeral
τοὺς ἄμφω ζωοὺς κατέχει φυσίζοος αἶα·	- -- -- uu- --uu --	dactylic hexameter	masculine penthemimeral, hepthemimeral, trithemimeral
οἳ καὶ νέρθεν γῆς τιμὴν πρὸς Ζηνὸς ἔχοντες	- - -- - -- - -u u--	dactylic hexameter	masculine penthemimeral, hepthemimeral
ἄλλοτε μὲν ζώουσ’ ἑτερήμεροι, ἄλλοτε δ’αὖτε	-uu - -- uu-uu -uu --	dactylic hexameter	masculine penthemimeral, trithemimeral
τεθνᾶσιν· τιμὴν δὲ λελόγχασιν ἶσα θεοῖσι.	--- -- u u-uu -u u--	dactylic hexameter	masculine penthemimeral, trithemimeral
τὴν δὲ μετ’ Ἰφιμέδειαν, Ἀλωῆος παράκοιτιν	- u u -uu-u u--- uu--	dactylic hexameter	feminine penthemimeral
εἴσιδον, ἣ δὴ φάσκε Ποσειδάωνι μιγῆναι,	-uu - - -u u---u u--	dactylic hexameter	feminine penthemimeral, trithemimeral
καί ῥ’ἔτεκεν δύο παῖδε, μινυνθαδίω δὲ γενέσθην,	- uu- uu -u u-uu- u u--	dactylic hexameter	feminine penthemimeral, trithemimeral
Ὦτόν τ’ἀντίθεον τηλεκλειτόν τ’Ἐφιάλτην,	-- -uu- ---- uu--	dactylic hexameter	masculine penthemimeral
οὓς δὴ μηκίστους θρέψε ζείδωρος ἄρουρα	- - --- -- --u u--	dactylic hexameter	masculine penthemimeral, hepthemimeral
καὶ πολὺ καλλίστους μετά γε κλυτὸν Ὠρίωνα·	- uu --- uu - uu ----	dactylic hexameter	masculine penthemimeral, hepthemimeral
ἐννέωροι γὰρ τοί γε καὶ ἐννεαπήχεες ἦσαν	--- - - u u -uu-uu --	dactylic hexameter	masculine penthemimeral, trithemimeral
εὖρος, ἀτὰρ μῆκός γε γενέσθην ἐννεόργυιοι.	-u u- -- u u-- ----	dactylic hexameter	masculine penthemimeral, trithemimeral
οἵ ῥα καὶ ἀθανάτοισιν ἀπειλήτην ἐν Ὀλύμπῳ	- u u -uu-u u--- u u--	dactylic hexameter	feminine penthemimeral
φυλόπιδα στήσειν πολυάϊκος πολέμοιο.	-uu- -- uu--- uu--	dactylic hexameter	masculine penthemimeral, trithemimeral
Ὄσσαν ἐπ’ Οὐλύμπῳ μέμασαν θέμεν, αὐτὰρ ἐπ’ Ὄσσῃ	-u u --- uu- uu -u u --	dactylic hexameter	masculine penthemimeral, hepthemimeral
Πήλιον εἰνοσίφυλλον, ἵν’ οὐρανὸς ἀμβατὸς εἴη.	-uu -uu-u u -uu -uu --	dactylic hexameter	feminine penthemimeral
καί νύ κεν ἐξετέλεσσαν, εἰ ἥβης μέτρον ἵκοντο·	- u u -uu-u u -- -u u--	dactylic hexameter	feminine penthemimeral
ἀλλ’ ὄλεσεν Διὸς υἱός, ὃν ἠΰκομος τέκε Λητώ,	- uu- uu -u u -uu- uu --	dactylic hexameter	feminine penthemimeral, trithemimeral
ἀμφοτέρω, πρίν σφωϊν ὑπὸ κροτάφοισιν ἰούλους	-uu- - -u u- uu-u u--	dactylic hexameter	feminine penthemimeral, hepthemimeral, trithemimeral
ἀνθῆσαι πυκάσαι τε γένυς εὐανθέϊ λάχνῃ.	--- uu- u u- --uu --	dactylic hexameter	masculine penthemimeral, hepthemimeral, trithemimeral
Φαίδρην τε Πρόκριν τε ἴδον καλήν τ’Ἀριάδνην,	-- - -- u u- -- uu--	dactylic hexameter	masculine penthemimeral, hepthemimeral, trithemimeral
κούρην Μίνωος ὀλοόφρονος, ἥν ποτε Θησεὺς	-- --- uu-uu - uu --	dactylic hexameter	masculine penthemimeral
ἐκ Κρήτης ἐς γουνὸν Ἀθηνάων ἱεράων	- -- - -u u--- uu--	dactylic hexameter	feminine penthemimeral, trithemimeral
ἦγε μέν, οὐδ’ ἀπόνητο· πάρος δέ μιν Ἄρτεμις ἔκτα	-u u - uu-u u- u u -uu --	dactylic hexameter	feminine penthemimeral, hepthemimeral, trithemimeral
Δίῃ ἐν ἀμφιρύτῃ Διονύσου μαρτυρίῃσι.	-u u -uu- uu-- -uu--	dactylic hexameter	masculine penthemimeral
Μαῖράν τε Κλυμένην τε ἴδον στυγερήν τ’Ἐριφύλην,	-- - uu- u u- uu- uu--	dactylic hexameter	masculine penthemimeral, hepthemimeral, trithemimeral
ἣ χρυσὸν φίλου ἀνδρὸς ἐδέξατο τιμήεντα.	- -- uu -u u-uu ----	dactylic hexameter	feminine penthemimeral, trithemimeral
πάσας δ’οὐκ ἂν ἐγὼ μυθήσομαι οὐδ’ ὀνομήνω,	-- - u u- --uu - uu--	dactylic hexameter	masculine penthemimeral, trithemimeral
ὅσσας ἡρώων ἀλόχους ἴδον ἠδὲ θύγατρας·	-- --- uu- uu -u u--	dactylic hexameter	masculine penthemimeral, hepthemimeral
πρὶν γάρ κεν καὶ νὺξ φθῖτ’ ἄμβροτος. ἀλλὰ καὶ ὥρη	- - - - - - -uu -u u --	dactylic hexameter	masculine penthemimeral, trithemimeral
εὕδειν, ἢ ἐπὶ νῆα θοὴν ἐλθόντ’ ἐς ἑταίρους	-- - uu -u u- -- u u--	dactylic hexameter	feminine penthemimeral, hepthemimeral, trithemimeral
ἢ αὐτοῦ· πομπὴ δὲ θεοῖς ὑμῖν τε μελήσει.	- -- -- u u- -- u u--	dactylic hexameter	masculine penthemimeral, hepthemimeral, trithemimeral
ὣς ἔφαθ’, οἱ δ’ἄρα πάντες ἀκὴν ἐγένοντο σιωπῇ,	- uu - uu -u u- uu-u u--	dactylic hexameter	feminine penthemimeral, hepthemimeral, trithemimeral
κηληθμῷ δ’ἔσχοντο κατὰ μέγαρα σκιόεντα.	--- --u u- uu- uu--	dactylic hexameter	feminine penthemimeral, hepthemimeral, trithemimeral
τοῖσιν δ’Ἀρήτη λευκώλενος ἤρχετο μύθων.	-- --- --uu -uu --	dactylic hexameter	masculine penthemimeral
Φαίηκες, πῶς ὔμμιν ἀνὴρ ὅδε φαίνεται εἶναι	--- - -u u- uu -uu --	dactylic hexameter	feminine penthemimeral, hepthemimeral, trithemimeral
εἶδός τε μέγεθός τε ἰδὲ φρένας ἔνδον ἐΐσας;	-- - uu- u u- uu -u u--	dactylic hexameter	masculine penthemimeral, hepthemimeral, trithemimeral
ξεῖνος δ’αὖτ’ ἐμός ἐστιν, ἕκαστος δ’ἔμμορε τιμῆς·	-- - uu -u u-- -uu --	dactylic hexameter	feminine penthemimeral, trithemimeral
τῶ μὴ ἐπειγόμενοι ἀποπέμπετε, μηδὲ τὰ δῶρα	- u u-uu- uu-uu -u u --	dactylic hexameter	masculine penthemimeral
οὕτω χρηΐζοντι κολούετε· πολλὰ γὰρ ὑμῖν	-- ---u u-uu -u u --	dactylic hexameter	feminine penthemimeral
κτήματ’ ἐνὶ μεγάροισι θεῶν ἰότητι κέονται.	-u u- uu-u u- uu-u u--	dactylic hexameter	feminine penthemimeral, hepthemimeral, trithemimeral
τοῖσι δὲ καὶ μετέειπε γέρων ἥρως Ἐχένηος,	-u u - uu-u u- -- uu--	dactylic hexameter	feminine penthemimeral, hepthemimeral, trithemimeral
ὃς δὴ Φαιήκων ἀνδρῶν προγενέστερος ἦεν·	- - --- -- uu-uu --	dactylic hexameter	masculine penthemimeral, hepthemimeral
ὦ φίλοι, οὐ μὰν ἧμιν ἀπὸ σκοποῦ οὐδ’ ἀπὸ δόξης	- uu - - -u u- uu - uu --	dactylic hexameter	feminine penthemimeral, hepthemimeral, trithemimeral
μυθεῖται βασίλεια περίφρων· ἀλλὰ πίθεσθε.	--- uu-u u-- -u u--	dactylic hexameter	feminine penthemimeral, trithemimeral
Ἀλκινόου δ’ἐκ τοῦδ’ ἔχεται ἔργον τε ἔπος τε.	-uu- - - uu- -- u u- -	dactylic hexameter	masculine penthemimeral, hepthemimeral, trithemimeral
τὸν δ’αὖτ’ Ἀλκίνοος ἀπαμείβετο φώνησέν τε·	- - -uu- uu-uu --- -	dactylic hexameter	masculine penthemimeral
τοῦτο μὲν οὕτω δὴ ἔσται ἔπος, αἴ κεν ἔγωγε	-u u -- - -- uu - u u--	dactylic hexameter	masculine penthemimeral, hepthemimeral
ζωὸς Φαιήκεσσι φιληρέτμοισιν ἀνάσσω·	-- ---u u---u u--	dactylic hexameter	feminine penthemimeral
ξεῖνος δὲ τλήτω μάλα περ νόστοιο χατίζων	-- - -- uu - --u u--	dactylic hexameter	masculine penthemimeral, hepthemimeral, trithemimeral
ἔμπης οὖν ἐπιμεῖναι ἐς αὔριον, εἰς ὅ κε πᾶσαν	-- - uu-u u -uu - u u --	dactylic hexameter	feminine penthemimeral, trithemimeral
δωτίνην τελέσω· πομπὴ δ’ἄνδρεσσι μελήσει	--- uu- -- --u u--	dactylic hexameter	masculine penthemimeral, hepthemimeral, trithemimeral
πᾶσι, μάλιστα δ’ἐμοί· τοῦ γὰρ κράτος ἔστ’ ἐνὶ δήμῳ.	-u u-u u- - - uu - uu --	dactylic hexameter	masculine penthemimeral, hepthemimeral
τὸν δ’ἀπαμειβόμενος προσέφη πολύμητις Ὀδυσσεύς·	- uu-uu- uu- uu-u u--	dactylic hexameter	masculine penthemimeral, hepthemimeral
Ἀλκίνοε κρεῖον, πάντων ἀριδείκετε λαῶν,	-uu- -- -- uu-uu --	dactylic hexameter	masculine penthemimeral, hepthemimeral, trithemimeral
εἴ με καὶ εἰς ἐνιαυτὸν ἀνώγοιτ’ αὐτόθι μίμνειν,	- u u - uu-u u-- -uu --	dactylic hexameter	feminine penthemimeral, trithemimeral
πομπήν τ’ὀτρύνοιτε καὶ ἀγλαὰ δῶρα διδοῖτε,	-- ---u u -uu -u u--	dactylic hexameter	feminine penthemimeral
καί κε τὸ βουλοίμην, καί κεν πολὺ κέρδιον εἴη,	- u u --- - - uu -uu --	dactylic hexameter	masculine penthemimeral, hepthemimeral
πλειοτέρῃ σὺν χειρὶ φίλην ἐς πατρίδ’ ἱκέσθαι·	-uu- - -u u- - -u u--	dactylic hexameter	feminine penthemimeral, hepthemimeral, trithemimeral
καί κ’αἰδοιότερος καὶ φίλτερος ἀνδράσιν εἴην	- --uu- - -uu -uu --	dactylic hexameter	masculine penthemimeral
πᾶσιν, ὅσοι μ’Ἰθάκηνδε ἰδοίατο νοστήσαντα.	-u u- uu-u u-uu ----	dactylic hexameter	feminine penthemimeral, trithemimeral
τὸν δ’αὖτ’ Ἀλκίνοος ἀπαμείβετο φώνησέν τε·	- - -uu- uu-uu --- -	dactylic hexameter	masculine penthemimeral
ὦ Ὀδυσεῦ, τὸ μὲν οὔ τί σ’ἐΐσκομεν εἰσορόωντες,	- uu- u u - u u-uu -uu--	dactylic hexameter	masculine penthemimeral, trithemimeral
ἠπεροπῆά τ’ἔμεν καὶ ἐπίκλοπον, οἷά τε πολλοὺς	-uu-u u- u u-uu -u u --	dactylic hexameter	masculine penthemimeral
βόσκει γαῖα μέλαινα πολυσπερέας ἀνθρώπους,	-- -u u-u u-uu- ---	dactylic hexameter	feminine penthemimeral
ψεύδεά τ’ἀρτύνοντας ὅθεν κέ τις οὐδὲ ἴδοιτο·	-uu ---u u- u u -u u--	dactylic hexameter	feminine penthemimeral, hepthemimeral
σοὶ δ’ἔπι μὲν μορφὴ ἐπέων, ἔνι δὲ φρένες ἐσθλαί.	- uu - -- uu- uu - uu --	dactylic hexameter	masculine penthemimeral, hepthemimeral, trithemimeral
μῦθον δ’ὡς ὅτ’ ἀοιδὸς ἐπισταμένως κατέλεξας,	-- - u u-u u-uu- uu--	dactylic hexameter	feminine penthemimeral, trithemimeral
πάντων Ἀργείων σέο τ’αὐτοῦ κήδεα λυγρά.	-- --- uu -- -uu --	dactylic hexameter	masculine penthemimeral
ἀλλ’ ἄγε μοι τόδε εἰπὲ καὶ ἀτρεκέως κατάλεξον,	- uu - uu -u u -uu- uu--	dactylic hexameter	feminine penthemimeral, trithemimeral
εἴ τινας ἀντιθέων ἑτάρων ἴδες, οἵ τοι ἅμ’ αὐτῷ	- uu -uu- uu- uu - u u --	dactylic hexameter	masculine penthemimeral, hepthemimeral
Ἴλιον εἰς ἅμ’ ἕποντο καὶ αὐτοῦ πότμον ἐπέσπον.	-uu - u u-u u -- -u u--	dactylic hexameter	feminine penthemimeral, trithemimeral
νὺξ δ’ἥδε μάλα μακρή, ἀθέσφατος· οὐδέ πω ὥρη	- -- uu -u u-uu -u u --	dactylic hexameter	feminine penthemimeral, trithemimeral
εὕδειν ἐν μεγάρῳ, σὺ δέ μοι λέγε θέσκελα ἔργα.	-- - uu- u u - uu -uu --	dactylic hexameter	masculine penthemimeral, hepthemimeral, trithemimeral
καί κεν ἐς ἠῶ δῖαν ἀνασχοίμην, ὅτε μοι σὺ	- u u -- -u u--- uu - -	dactylic hexameter	feminine penthemimeral
τλαίης ἐν μεγάρῳ τὰ σὰ κήδεα μυθήσασθαι.	-- - uu- u u -uu ----	dactylic hexameter	masculine penthemimeral, trithemimeral
τὸν δ’ἀπαμειβόμενος προσέφη πολύμητις Ὀδυσσεύς·	- uu-uu- uu- uu-u u--	dactylic hexameter	masculine penthemimeral, hepthemimeral
Ἀλκίνοε κρεῖον, πάντων ἀριδείκετε λαῶν,	-uu- -- -- uu-uu --	dactylic hexameter	masculine penthemimeral, hepthemimeral, trithemimeral
ὥρη μὲν πολέων μύθων, ὥρη δὲ καὶ ὕπνου·	-- - uu- -- -- u u --	dactylic hexameter	masculine penthemimeral, hepthemimeral, trithemimeral
εἰ δ’ἔτ’ ἀκουέμεναί γε λιλαίεαι, οὐκ ἂν ἔπειτα	- u u-uu- u u-uu - u u--	dactylic hexameter	masculine penthemimeral
τούτων σοι φθονέοιμι καὶ οἰκτρότερ’ ἄλλ’ ἀγορεύειν,	-- - uu-u u -uu - uu--	dactylic hexameter	feminine penthemimeral, trithemimeral
κήδε’ ἐμῶν ἑτάρων, οἳ δὴ μετόπισθεν ὄλοντο,	-u u- uu- - - uu-u u--	dactylic hexameter	masculine penthemimeral, hepthemimeral, trithemimeral
οἳ Τρώων μὲν ὑπεξέφυγον στονόεσσαν ἀϋτήν,	- -- u u-uu- uu-u u--	dactylic hexameter	hepthemimeral, trithemimeral
ἐν νόστῳ δ’ἀπόλοντο κακῆς ἰότητι γυναικός.	- -- uu-u u- uu-u u--	dactylic hexameter	feminine penthemimeral, hepthemimeral, trithemimeral
αὐτὰρ ἐπεὶ ψυχὰς μὲν ἀπεσκέδασ’ ἄλλυδις ἄλλῃ	-u u- -- u u-uu -uu --	dactylic hexameter	masculine penthemimeral, trithemimeral
ἁγνὴ Περσεφόνεια γυναικῶν θηλυτεράων,	-- -uu-u u-- -uu--	dactylic hexameter	feminine penthemimeral
ἦλθε δ’ἐπὶ ψυχὴ Ἀγαμέμνονος Ἀτρεΐδαο	-u u- -- uu-uu -uu--	dactylic hexameter	masculine penthemimeral, trithemimeral
ἀχνυμένη· περὶ δ’ἄλλαι ἀγηγέραθ’, ὅσσοι ἅμ’ αὐτῷ	-uu- uu -u u-uu -u u --	dactylic hexameter	feminine penthemimeral, trithemimeral
οἴκῳ ἐν Αἰγίσθοιο θάνον καὶ πότμον ἐπέσπον.	-u u ---u u- - -u u--	dactylic hexameter	feminine penthemimeral, hepthemimeral
ἔγνω δ’αἶψ’ ἐμὲ κεῖνος, ἐπεὶ ἴδεν ὀφθαλμοῖσι·	-- - uu -u u- uu ----	dactylic hexameter	feminine penthemimeral, hepthemimeral, trithemimeral
κλαῖε δ’ὅ γε λιγέως, θαλερὸν κατὰ δάκρυον εἴβων,	-u u - uu- uu- uu -uu --	dactylic hexameter	masculine penthemimeral, hepthemimeral, trithemimeral
πιτνὰς εἰς ἐμὲ χεῖρας, ὀρέξασθαι μενεαίνων·	-- - uu -u u--- uu--	dactylic hexameter	feminine penthemimeral, trithemimeral
ἀλλ’ οὐ γάρ οἱ ἔτ’ ἦν ἲς ἔμπεδος οὐδέ τι κῖκυς,	- - - u u - - -uu -u u --	dactylic hexameter	masculine penthemimeral, trithemimeral
οἵη περ πάρος ἔσκεν ἐνὶ γναμπτοῖσι μέλεσσι.	-- - uu -u u- --u u--	dactylic hexameter	feminine penthemimeral, hepthemimeral, trithemimeral
τὸν μὲν ἐγὼ δάκρυσα ἰδὼν ἐλέησά τε θυμῷ,	- u u- --u u- uu-u u --	dactylic hexameter	feminine penthemimeral, hepthemimeral, trithemimeral
καί μιν φωνήσας ἔπεα πτερόεντα προσηύδων·	- - --- uu- uu-u u--	dactylic hexameter	masculine penthemimeral, hepthemimeral
Ἀτρεΐδη κύδιστε, ἄναξ ἀνδρῶν Ἀγάμεμνον,	-uu- --u u- -- uu--	dactylic hexameter	feminine penthemimeral, hepthemimeral, trithemimeral
τίς νύ σε κὴρ ἐδάμασσε τανηλεγέος θανάτοιο;	- u u - uu-u u-uu- uu--	dactylic hexameter	feminine penthemimeral, trithemimeral
ἦε σέ γ’ἐν νήεσσι Ποσειδάων ἐδάμασσεν	-u u - --u u--- uu--	dactylic hexameter	feminine penthemimeral, trithemimeral
ὄρσας ἀργαλέων ἀνέμων ἀμέγαρτον ἀϋτμήν;	-- -uu- uu- uu-u u--	dactylic hexameter	masculine penthemimeral, hepthemimeral
ἦέ σ’ἀνάρσιοι ἄνδρες ἐδηλήσαντ’ ἐπὶ χέρσου	-u u-uu -u u--- uu --	dactylic hexameter	feminine penthemimeral
βοῦς περιταμνόμενον ἠδ’ οἰῶν πώεα καλά,	- uu-uu- - -- -uu --	dactylic hexameter	masculine penthemimeral
ἠὲ περὶ πτόλιος μαχεούμενον ἠδὲ γυναικῶν;	-u u- uu- uu-uu -u u--	dactylic hexameter	masculine penthemimeral, trithemimeral
ὣς ἐφάμην, ὁ δέ μ’αὐτίκ’ ἀμειβόμενος προσέειπε·	- uu- u u -u u-uu- uu--	dactylic hexameter	feminine penthemimeral, trithemimeral
διογενὲς Λαερτιάδη, πολυμήχαν’ Ὀδυσσεῦ,	-uu- --uu- uu-u u--	dactylic hexameter	hepthemimeral, trithemimeral
οὔτ’ ἐμέ γ’ἐν νήεσσι Ποσειδάων ἐδάμασσεν	- uu - --u u--- uu--	dactylic hexameter	feminine penthemimeral, trithemimeral
ὄρσας ἀργαλέων ἀνέμων ἀμέγαρτον ἀϋτμήν,	-- -uu- uu- uu-u u--	dactylic hexameter	masculine penthemimeral, hepthemimeral
οὔτε μ’ἀνάρσιοι ἄνδρες ἐδηλήσαντ’ ἐπὶ χέρσου,	-u u-uu -u u--- uu --	dactylic hexameter	feminine penthemimeral
ἀλλά μοι Αἴγισθος τεύξας θάνατόν τε μόρον τε	-u u --- -- uu- u u- -	dactylic hexameter	masculine penthemimeral, hepthemimeral
ἔκτα σὺν οὐλομένῃ ἀλόχῳ, οἶκόνδε καλέσσας,	-u u -uu- uu- --u u--	dactylic hexameter	masculine penthemimeral, hepthemimeral
δειπνίσσας, ὥς τίς τε κατέκτανε βοῦν ἐπὶ φάτνῃ.	--- - - u u-uu - uu --	dactylic hexameter	masculine penthemimeral, trithemimeral
ὣς θάνον οἰκτίστῳ θανάτῳ· περὶ δ’ἄλλοι ἑταῖροι	- uu --- uu- uu -u u--	dactylic hexameter	masculine penthemimeral, hepthemimeral
νωλεμέως κτείνοντο σύες ὣς ἀργιόδοντες,	-uu- --u u- - -uu--	dactylic hexameter	feminine penthemimeral, hepthemimeral, trithemimeral
οἵ ῥά τ’ἐν ἀφνειοῦ ἀνδρὸς μέγα δυναμένοιο	- u u --- -- uu -uu--	dactylic hexameter	masculine penthemimeral, hepthemimeral
ἢ γάμῳ ἢ ἐράνῳ ἢ εἰλαπίνῃ τεθαλυίῃ.	- uu - uu- - -uu- uu--	dactylic hexameter	masculine penthemimeral, trithemimeral
ἤδη μὲν πολέων φόνῳ ἀνδρῶν ἀντεβόλησας,	-- - uu- uu -- -uu--	dactylic hexameter	masculine penthemimeral, trithemimeral
μουνὰξ κτεινομένων καὶ ἐνὶ κρατερῇ ὑσμίνῃ·	-- -uu- u u- uu- ---	dactylic hexameter	masculine penthemimeral, hepthemimeral
ἀλλά κε κεῖνα μάλιστα ἰδὼν ὀλοφύραο θυμῷ,	-u u -u u-u u- uu-uu --	dactylic hexameter	feminine penthemimeral, hepthemimeral
ὡς ἀμφὶ κρητῆρα τραπέζας τε πληθούσας	- -- --u u-- - ---	dactylic hexameter	feminine penthemimeral, trithemimeral
κείμεθ’ ἐνὶ μεγάρῳ, δάπεδον δ’ἅπαν αἵματι θῦεν.	-u u- uu- uu- uu -uu --	dactylic hexameter	masculine penthemimeral, hepthemimeral, trithemimeral
οἰκτροτάτην δ’ἤκουσα ὄπα Πριάμοιο θυγατρός,	-uu- --u u- uu-u u--	dactylic hexameter	feminine penthemimeral, hepthemimeral, trithemimeral
Κασσάνδρης, τὴν κτεῖνε Κλυταιμνήστρη δολόμητις	--- - -u u--- uu--	dactylic hexameter	feminine penthemimeral, trithemimeral
ἀμφ’ ἐμοί, αὐτὰρ ἐγὼ ποτὶ γαίῃ χεῖρας ἀείρων	- uu -u u- uu -- -u u--	dactylic hexameter	masculine penthemimeral
βάλλον ἀποθνήσκων περὶ φασγάνῳ· ἡ δὲ κυνῶπις	-u u--- uu -uu - u u--	dactylic hexameter	masculine penthemimeral
νοσφίσατ’, οὐδέ μοι ἔτλη ἰόντι περ εἰς Ἀΐδαο	-uu -u u -u u-u u - uu--	dactylic hexameter	feminine penthemimeral
χερσὶ κατ’ ὀφθαλμοὺς ἑλέειν σύν τε στόμ’ ἐρεῖσαι.	-u u --- uu- - - u u--	dactylic hexameter	masculine penthemimeral, hepthemimeral
ὣς οὐκ αἰνότερον καὶ κύντερον ἄλλο γυναικός,	- - -uu- - -uu -u u--	dactylic hexameter	masculine penthemimeral
ἥ τις δὴ τοιαῦτα μετὰ φρεσὶν ἔργα βάληται·	- - - --u u- uu -u u--	dactylic hexameter	feminine penthemimeral, hepthemimeral, trithemimeral
οἷον δὴ καὶ κείνη ἐμήσατο ἔργον ἀεικές,	-- - - -u u-uu -u u--	dactylic hexameter	feminine penthemimeral, trithemimeral
κουριδίῳ τεύξασα πόσει φόνον. ἤτοι ἔφην γε	-uu- --u u- uu -u u- -	dactylic hexameter	feminine penthemimeral, hepthemimeral, trithemimeral
ἀσπάσιος παίδεσσιν ἰδὲ δμώεσσιν ἐμοῖσιν	-uu- --u u- --u u--	dactylic hexameter	feminine penthemimeral, hepthemimeral, trithemimeral
οἴκαδ’ ἐλεύσεσθαι· ἡ δ’ἔξοχα λύγρ’ εἰδυῖα	-u u--- - -uu - ---	dactylic hexameter	masculine penthemimeral
οἷ τε κατ’ αἶσχος ἔχευε καὶ ἐσσομένῃσιν ὀπίσσω	- u u -u u-u u -uu-u u--	dactylic hexameter	feminine penthemimeral
θηλυτέρῃσι γυναιξί, καὶ ἥ κ’εὐεργὸς ἔῃσιν.	-uu-u u-u u - --u u--	dactylic hexameter	feminine penthemimeral, hepthemimeral
ὣς ἔφατ’, αὐτὰρ ἐγώ μιν ἀμειβόμενος προσέειπον·	- uu -u u- u u-uu- uu--	dactylic hexameter	masculine penthemimeral
ὢ πόποι, ἦ μάλα δὴ γόνον Ἀτρέος εὐρύοπα Ζεὺς	- uu - uu - uu -uu -uu- -	dactylic hexameter	masculine penthemimeral, trithemimeral
ἐκπάγλως ἤχθηρε γυναικείας διὰ βουλὰς	--- --u u--- uu --	dactylic hexameter	feminine penthemimeral, trithemimeral
ἐξ ἀρχῆς· Ἑλένης μὲν ἀπωλόμεθ’ εἵνεκα πολλοί,	- -- uu- u u-uu -uu --	dactylic hexameter	masculine penthemimeral, trithemimeral
σοὶ δὲ Κλυταιμνήστρη δόλον ἤρτυε τηλόθ’ ἐόντι.	- u u--- uu -uu -u u--	dactylic hexameter	masculine penthemimeral
ὣς ἐφάμην, ὁ δέ μ’αὐτίκ’ ἀμειβόμενος προσέειπε·	- uu- u u -u u-uu- uu--	dactylic hexameter	feminine penthemimeral, trithemimeral
τῶ νῦν μή ποτε καὶ σὺ γυναικί περ ἤπιος εἶναι·	- - - uu - u u-u u -uu --	dactylic hexameter	masculine penthemimeral, trithemimeral
μηδ’ οἱ μῦθον ἅπαντα πιφαυσκέμεν, ὅν κ’ἐῢ εἰδῇς,	- - -u u-u u-uu - uu --	dactylic hexameter	feminine penthemimeral
ἀλλὰ τὸ μὲν φάσθαι, τὸ δὲ καὶ κεκρυμμένον εἶναι.	-u u - -- u u - --uu --	dactylic hexameter	masculine penthemimeral, hepthemimeral, trithemimeral
ἀλλ’ οὐ σοί γ’,Ὀδυσεῦ, φόνος ἔσσεται ἔκ γε γυναικός·	- - - uu- uu -uu - u u--	dactylic hexameter	masculine penthemimeral, trithemimeral
λίην γὰρ πινυτή τε καὶ εὖ φρεσὶ μήδεα οἶδε	-- - uu- u u - uu -uu --	dactylic hexameter	masculine penthemimeral, hepthemimeral, trithemimeral
κούρη Ἰκαρίοιο, περίφρων Πηνελόπεια.	-- -uu-u u-- -uu--	dactylic hexameter	feminine penthemimeral
ἦ μέν μιν νύμφην γε νέην κατελείπομεν ἡμεῖς	- - - -- u u- uu-uu --	dactylic hexameter	masculine penthemimeral, hepthemimeral, trithemimeral
ἐρχόμενοι πόλεμόνδε· πάϊς δέ οἱ ἦν ἐπὶ μαζῷ	-uu- uu-u u- u u - uu --	dactylic hexameter	feminine penthemimeral, hepthemimeral, trithemimeral
νήπιος, ὅς που νῦν γε μετ’ ἀνδρῶν ἵζει ἀριθμῷ,	-uu - - - u u -- -u u--	dactylic hexameter	masculine penthemimeral, trithemimeral
ὄλβιος· ἦ γὰρ τόν γε πατὴρ φίλος ὄψεται ἐλθών,	-uu - - - u u- uu -uu --	dactylic hexameter	masculine penthemimeral, hepthemimeral, trithemimeral
καὶ κεῖνος πατέρα προσπτύξεται, ἣ θέμις ἐστίν.	- -- uu- --uu - uu --	dactylic hexameter	masculine penthemimeral, trithemimeral
ἡ δ’ἐμὴ οὐδέ περ υἷος ἐνιπλησθῆναι ἄκοιτις	- uu -u u -u u---u u--	dactylic hexameter	feminine penthemimeral
ὀφθαλμοῖσιν ἔασε· πάρος δέ με πέφνε καὶ αὐτόν.	---u u-u u- u u -u u --	dactylic hexameter	feminine penthemimeral, hepthemimeral
ἄλλο δέ τοι ἐρέω, σὺ δ’ἐνὶ φρεσὶ βάλλεο σῇσι·	-u u - uu- u u- uu -uu --	dactylic hexameter	masculine penthemimeral, hepthemimeral, trithemimeral
κρύβδην, μηδ’ ἀναφανδά, φίλην ἐς πατρίδα γαῖαν	-- - uu-u u- - -uu --	dactylic hexameter	feminine penthemimeral, hepthemimeral, trithemimeral
νῆα κατισχέμεναι· ἐπεὶ οὐκέτι πιστὰ γυναιξίν.	-u u-uu- uu -uu -u u--	dactylic hexameter	masculine penthemimeral
ἀλλ’ ἄγε μοι τόδε εἰπὲ καὶ ἀτρεκέως κατάλεξον,	- uu - uu -u u -uu- uu--	dactylic hexameter	feminine penthemimeral, trithemimeral
εἴ που ἔτι ζώοντος ἀκούετε παιδὸς ἐμοῖο,	- u u- --u u-uu -u u--	dactylic hexameter	feminine penthemimeral, trithemimeral
ἤ που ἐν Ὀρχομενῷ ἢ ἐν Πύλῳ ἠμαθόεντι,	- u u -uu- - - uu -uu--	dactylic hexameter	masculine penthemimeral, hepthemimeral
ἤ που πὰρ Μενελάῳ ἐνὶ Σπάρτῃ εὐρείῃ·	- - - uu-u u- -- ---	dactylic hexameter	feminine penthemimeral, hepthemimeral, trithemimeral
οὐ γάρ πω τέθνηκεν ἐπὶ χθονὶ δῖος Ὀρέστης.	- - - --u u- uu -u u--	dactylic hexameter	feminine penthemimeral, hepthemimeral, trithemimeral
ὣς ἔφατ’, αὐτὰρ ἐγώ μιν ἀμειβόμενος προσέειπον·	- uu -u u- u u-uu- uu--	dactylic hexameter	masculine penthemimeral
Ἀτρεΐδη, τί με ταῦτα διείρεαι; οὐδέ τι οἶδα,	-uu- u u -u u-uu -u u --	dactylic hexameter	feminine penthemimeral, trithemimeral
ζώει ὅ γ’ἦ τέθνηκε· κακὸν δ’ἀνεμώλια βάζειν.	-u u - --u u- uu-uu --	dactylic hexameter	feminine penthemimeral, hepthemimeral, trithemimeral
νῶϊ μὲν ὣς ἐπέεσσιν ἀμειβομένω στυγεροῖσιν	-u u - uu-u u-uu- uu--	dactylic hexameter	feminine penthemimeral, trithemimeral
ἕσταμεν ἀχνύμενοι θαλερὸν κατὰ δάκρυ χέοντες·	-uu -uu- uu- uu -u u--	dactylic hexameter	masculine penthemimeral, hepthemimeral
ἦλθε δ’ἐπὶ ψυχὴ Πηληϊάδεω Ἀχιλῆος	-u u- -- --uu- uu--	dactylic hexameter	masculine penthemimeral, trithemimeral
καὶ Πατροκλῆος καὶ ἀμύμονος Ἀντιλόχοιο	- ---- u u-uu -uu--	dactylic hexameter	masculine penthemimeral
Αἴαντός θ’,ὃς ἄριστος ἔην εἶδός τε δέμας τε	--- u u-u u- -- u u- -	dactylic hexameter	feminine penthemimeral, hepthemimeral, trithemimeral
τῶν ἄλλων Δαναῶν μετ’ ἀμύμονα Πηλεΐωνα.	- -- uu- u u-uu -uu--	dactylic hexameter	masculine penthemimeral, trithemimeral
ἔγνω δὲ ψυχή με ποδώκεος Αἰακίδαο	-- - -- u u-uu -uu--	dactylic hexameter	masculine penthemimeral, trithemimeral
καί ῥ’ὀλοφυρομένη ἔπεα πτερόεντα προσηύδα·	- uu-uu- uu- uu-u u--	dactylic hexameter	masculine penthemimeral, hepthemimeral
διογενὲς Λαερτιάδη, πολυμήχαν’ Ὀδυσσεῦ,	-uu- --uu- uu-u u--	dactylic hexameter	hepthemimeral, trithemimeral
σχέτλιε, τίπτ’ ἔτι μεῖζον ἐνὶ φρεσὶ μήσεαι ἔργον;	-uu - uu -u u- uu -uu --	dactylic hexameter	feminine penthemimeral, hepthemimeral, trithemimeral
πῶς ἔτλης Ἄϊδόσδε κατελθέμεν, ἔνθα τε νεκροὶ	- -- uu-u u-uu -u u --	dactylic hexameter	feminine penthemimeral, trithemimeral
ἀφραδέες ναίουσι, βροτῶν εἴδωλα καμόντων;	-uu- --u u- --u u--	dactylic hexameter	feminine penthemimeral, hepthemimeral, trithemimeral
ὣς ἔφατ’, αὐτὰρ ἐγώ μιν ἀμειβόμενος προσέειπον·	- uu -u u- u u-uu- uu--	dactylic hexameter	masculine penthemimeral
ὦ Ἀχιλεῦ Πηλέως υἱέ, μέγα φέρτατ’ Ἀχαιῶν,	- uu- -- -- uu -u u--	dactylic hexameter	masculine penthemimeral, hepthemimeral, trithemimeral
ἦλθον Τειρεσίαο κατὰ χρέος, εἴ τινα βουλὴν	-- -uu-u u- uu - uu --	dactylic hexameter	feminine penthemimeral, hepthemimeral
εἴποι, ὅπως Ἰθάκην ἐς παιπαλόεσσαν ἱκοίμην·	-u u- uu- - -uu-u u--	dactylic hexameter	masculine penthemimeral, trithemimeral
οὐ γάρ πω σχεδὸν ἦλθον Ἀχαιΐδος, οὐδέ πω ἁμῆς	- - - uu -u u-uu -u u --	dactylic hexameter	feminine penthemimeral, trithemimeral
γῆς ἐπέβην, ἀλλ’ αἰὲν ἔχω κακά. σεῖο δ’,Ἀχιλλεῦ,	- uu- - -u u- uu -u u--	dactylic hexameter	feminine penthemimeral, hepthemimeral, trithemimeral
οὔ τις ἀνὴρ προπάροιθε μακάρτατος οὔτ’ ἄρ’ ὀπίσσω.	- u u- uu-u u-uu - u u--	dactylic hexameter	feminine penthemimeral, trithemimeral
πρὶν μὲν γάρ σε ζωὸν ἐτίομεν ἶσα θεοῖσιν	- - - - -u u-uu -u u--	dactylic hexameter	feminine penthemimeral, trithemimeral
Ἀργεῖοι, νῦν αὖτε μέγα κρατέεις νεκύεσσιν	--- - -u u- uu- uu--	dactylic hexameter	feminine penthemimeral, hepthemimeral, trithemimeral
ἐνθάδ’ ἐών· τῶ μή τι θανὼν ἀκαχίζευ, Ἀχιλλεῦ.	-u u- - - u u- uu-u u--	dactylic hexameter	masculine penthemimeral, hepthemimeral, trithemimeral
ὣς ἐφάμην, ὁ δέ μ’αὐτίκ’ ἀμειβόμενος προσέειπε·	- uu- u u -u u-uu- uu--	dactylic hexameter	feminine penthemimeral, trithemimeral
μὴ δή μοι θάνατόν γε παραύδα, φαίδιμ’ Ὀδυσσεῦ.	- - - uu- u u-- -u u--	dactylic hexameter	masculine penthemimeral, trithemimeral
βουλοίμην κ’ἐπάρουρος ἐὼν θητευέμεν ἄλλῳ,	--- uu-u u- --uu --	dactylic hexameter	feminine penthemimeral, hepthemimeral, trithemimeral
ἀνδρὶ παρ’ ἀκλήρῳ, ᾧ μὴ βίοτος πολὺς εἴη,	-u u --- - - uu- uu --	dactylic hexameter	masculine penthemimeral, hepthemimeral
ἢ πᾶσι νεκύεσσι καταφθιμένοισιν ἀνάσσειν.	- -- uu-u u-uu-u u--	dactylic hexameter	feminine penthemimeral, trithemimeral
ἀλλ’ ἄγε μοι τοῦ παιδὸς ἀγαυοῦ μῦθον ἐνίσπες,	- uu - - -u u-- -u u--	dactylic hexameter	feminine penthemimeral, trithemimeral
ἢ ἕπετ’ ἐς πόλεμον πρόμος ἔμμεναι, ἦε καὶ οὐκί.	- uu - uu- uu -uu -u u --	dactylic hexameter	masculine penthemimeral, trithemimeral
εἰπὲ δέ μοι Πηλῆος ἀμύμονος, εἴ τι πέπυσσαι,	-u u - --u u-uu - u u--	dactylic hexameter	feminine penthemimeral, trithemimeral
ἢ ἔτ’ ἔχει τιμὴν πολέσιν μετὰ Μυρμιδόνεσσιν,	- u u- -- uu- uu -uu--	dactylic hexameter	masculine penthemimeral, hepthemimeral, trithemimeral
ἦ μιν ἀτιμάζουσιν ἀν’ Ἑλλάδα τε Φθίην τε,	- u u---u u -uu - -- -	dactylic hexameter	feminine penthemimeral
οὕνεκά μιν κατὰ γῆρας ἔχει χεῖράς τε πόδας τε.	-uu - uu -u u- -- u u- -	dactylic hexameter	feminine penthemimeral, hepthemimeral, trithemimeral
οὐ γὰρ ἐγὼν ἐπαρωγὸς ὑπ’ αὐγὰς ἠελίοιο,	- u u- uu-u u -- -uu--	dactylic hexameter	feminine penthemimeral, trithemimeral
τοῖος ἐών, οἷός ποτ’ ἐνὶ Τροίῃ εὐρείῃ	-u u- -- u u- -- ---	dactylic hexameter	masculine penthemimeral, hepthemimeral, trithemimeral
πέφνον λαὸν ἄριστον, ἀμύνων Ἀργείοισιν·	-- -u u-u u-- ----	dactylic hexameter	feminine penthemimeral
εἰ τοιόσδ’ ἔλθοιμι μίνυνθά περ ἐς πατέρος δῶ·	- -- --u u-u u - uu- -	dactylic hexameter	feminine penthemimeral, trithemimeral
τῶ κέ τεῳ στύξαιμι μένος καὶ χεῖρας ἀάπτους,	- u u- --u u- - -u u--	dactylic hexameter	feminine penthemimeral, hepthemimeral, trithemimeral
οἳ κεῖνον βιόωνται ἐέργουσίν τ’ἀπὸ τιμῆς.	- -- uu-u u--- uu --	dactylic hexameter	feminine penthemimeral, trithemimeral
ὣς ἔφατ’, αὐτὰρ ἐγώ μιν ἀμειβόμενος προσέειπον·	- uu -u u- u u-uu- uu--	dactylic hexameter	masculine penthemimeral
ἤτοι μὲν Πηλῆος ἀμύμονος οὔ τι πέπυσμαι,	-- - --u u-uu - u u--	dactylic hexameter	feminine penthemimeral, trithemimeral
αὐτάρ τοι παιδός γε Νεοπτολέμοιο φίλοιο	-- - -- u u-uu-u u--	dactylic hexameter	masculine penthemimeral, trithemimeral
πᾶσαν ἀληθείην μυθήσομαι, ὥς με κελεύεις·	-u u--- --uu - u u--	dactylic hexameter	masculine penthemimeral
αὐτὸς γάρ μιν ἐγὼ κοίλης ἐπὶ νηὸς ἐΐσης	-- - u u- -- uu -u u--	dactylic hexameter	masculine penthemimeral, hepthemimeral, trithemimeral
ἤγαγον ἐκ Σκύρου μετ’ ἐϋκνήμιδας Ἀχαιούς.	-uu - -- u u---u u--	dactylic hexameter	masculine penthemimeral, trithemimeral
ἤτοι ὅτ’ ἀμφὶ πόλιν Τροίην φραζοίμεθα βουλάς,	-u u -u u- -- --uu --	dactylic hexameter	masculine penthemimeral, hepthemimeral
αἰεὶ πρῶτος ἔβαζε καὶ οὐχ ἡμάρτανε μύθων·	-- -u u-u u - --uu --	dactylic hexameter	feminine penthemimeral, hepthemimeral
Νέστωρ δ’ἀντίθεος καὶ ἐγὼ νικάσκομεν οἴω.	-- -uu- u u- --uu --	dactylic hexameter	masculine penthemimeral, hepthemimeral
αὐτὰρ ὅτ’ ἀμφὶ πόλιν Τροίην μαρνοίμεθ’ Ἀχαιοί,	-u u -u u- -- --u u--	dactylic hexameter	masculine penthemimeral, hepthemimeral
οὔ ποτ’ ἐνὶ πληθυῖ μένεν ἀνδρῶν οὐδ’ ἐν ὁμίλῳ,	- u u- -- uu -- - u u--	dactylic hexameter	masculine penthemimeral, trithemimeral
ἀλλὰ πολὺ προθέεσκε τὸ ὃν μένος οὐδενὶ εἴκων,	-u u- uu-u u - uu -uu --	dactylic hexameter	feminine penthemimeral, hepthemimeral, trithemimeral
πολλοὺς δ’ἄνδρας ἔπεφνεν ἐν αἰνῇ δηϊοτῆτι.	-- -u u-u u -- -uu--	dactylic hexameter	feminine penthemimeral
πάντας δ’οὐκ ἂν ἐγὼ μυθήσομαι οὐδ’ ὀνομήνω,	-- - u u- --uu - uu--	dactylic hexameter	masculine penthemimeral, trithemimeral
ὅσσον λαὸν ἔπεφνεν ἀμύνων Ἀργείοισιν,	-- -u u-u u-- ----	dactylic hexameter	feminine penthemimeral
ἀλλ’ οἷον τὸν Τηλεφίδην κατενήρατο χαλκῷ,	- -- - -uu- uu-uu --	dactylic hexameter	hepthemimeral, trithemimeral
ἥρω’ Εὐρύπυλον, πολλοὶ δ’ἀμφ’ αὐτὸν ἑταῖροι	-- -uu- -- - -u u--	dactylic hexameter	masculine penthemimeral, hepthemimeral
Κήτειοι κτείνοντο γυναίων εἵνεκα δώρων.	--- --u u-- -uu --	dactylic hexameter	feminine penthemimeral, trithemimeral
κεῖνον δὴ κάλλιστον ἴδον μετὰ Μέμνονα δῖον.	-- - --u u- uu -uu --	dactylic hexameter	feminine penthemimeral, hepthemimeral, trithemimeral
αὐτὰρ ὅτ’ εἰς ἵππον κατεβαίνομεν, ὃν κάμ’ Ἐπειός,	-u u - -- uu-uu - u u--	dactylic hexameter	masculine penthemimeral, trithemimeral
Ἀργείων οἱ ἄριστοι, ἐμοὶ δ’ἐπὶ πάντ’ ἐτέταλτο,	--- u u-u u- uu - uu--	dactylic hexameter	feminine penthemimeral, hepthemimeral, trithemimeral
ἠμὲν ἀνακλῖναι πυκινὸν λόχον ἠδ’ ἐπιθεῖναι,	-u u--- uu- uu - uu--	dactylic hexameter	masculine penthemimeral, hepthemimeral
ἔνθ’ ἄλλοι Δαναῶν ἡγήτορες ἠδὲ μέδοντες	- -- uu- --uu -u u--	dactylic hexameter	masculine penthemimeral, trithemimeral
δάκρυά τ’ὠμόργνυντο τρέμον θ’ὑπὸ γυῖα ἑκάστου·	-uu ---u u- uu -u u--	dactylic hexameter	feminine penthemimeral, hepthemimeral
κεῖνον δ’οὔ ποτε πάμπαν ἐγὼν ἴδον ὀφθαλμοῖσιν	-- - uu -u u- uu ----	dactylic hexameter	feminine penthemimeral, hepthemimeral, trithemimeral
οὔτ’ ὠχρήσαντα χρόα κάλλιμον οὔτε παρειῶν	- ---- uu -uu -u u--	dactylic hexameter	masculine penthemimeral
δάκρυ ὀμορξάμενον· ὁ δέ με μάλα πόλλ’ ἱκέτευεν	-u u-uu- u u - uu - uu--	dactylic hexameter	masculine penthemimeral, hepthemimeral
ἱππόθεν ἐξίμεναι, ξίφεος δ’ἐπεμαίετο κώπην	-uu -uu- uu- uu-uu --	dactylic hexameter	masculine penthemimeral, hepthemimeral
καὶ δόρυ χαλκοβαρές, κακὰ δὲ Τρώεσσι μενοίνα.	- uu -uu- uu - --u u--	dactylic hexameter	masculine penthemimeral, hepthemimeral
ἀλλ’ ὅτε δὴ Πριάμοιο πόλιν διεπέρσαμεν αἰπήν,	- uu - uu-u u- uu-uu --	dactylic hexameter	feminine penthemimeral, hepthemimeral, trithemimeral
μοῖραν καὶ γέρας ἐσθλὸν ἔχων ἐπὶ νηὸς ἔβαινεν	-- - uu -u u- uu -u u--	dactylic hexameter	feminine penthemimeral, hepthemimeral, trithemimeral
ἀσκηθής, οὔτ’ ἂρ βεβλημένος ὀξέϊ χαλκῷ	--- - - --uu -uu --	dactylic hexameter	masculine penthemimeral, trithemimeral
οὔτ’ αὐτοσχεδίην οὐτασμένος, οἷά τε πολλὰ	- --uu- --uu -u u --	dactylic hexameter	masculine penthemimeral
γίνεται ἐν πολέμῳ· ἐπιμὶξ δέ τε μαίνεται Ἄρης.	-uu - uu- uu- u u -uu --	dactylic hexameter	masculine penthemimeral, hepthemimeral, trithemimeral
ὣς ἐφάμην, ψυχὴ δὲ ποδώκεος Αἰακίδαο	- uu- -- u u-uu -uu--	dactylic hexameter	masculine penthemimeral, trithemimeral
φοίτα μακρὰ βιβῶσα κατ’ ἀσφοδελὸν λειμῶνα,	-- -u u-u u -uu- ---	dactylic hexameter	feminine penthemimeral
γηθοσύνῃ ὅ οἱ υἱὸν ἔφην ἀριδείκετον εἶναι.	-uu- u u -u u- uu-uu --	dactylic hexameter	feminine penthemimeral, hepthemimeral, trithemimeral
αἱ δ’ἄλλαι ψυχαὶ νεκύων κατατεθνηώτων	- -- -- uu- uu----	dactylic hexameter	masculine penthemimeral, hepthemimeral, trithemimeral
ἕστασαν ἀχνύμεναι, εἴροντο δὲ κήδε’ ἑκάστη.	-uu -uu- --u u -u u--	dactylic hexameter	masculine penthemimeral
οἴη δ’Αἴαντος ψυχὴ Τελαμωνιάδαο	-- --- -- uu-uu--	dactylic hexameter	masculine penthemimeral, hepthemimeral
νόσφιν ἀφειστήκει, κεχολωμένη εἵνεκα νίκης,	-u u--- uu-uu -uu --	dactylic hexameter	masculine penthemimeral
τήν μιν ἐγὼ νίκησα δικαζόμενος παρὰ νηυσὶ	- u u- --u u-uu- uu --	dactylic hexameter	feminine penthemimeral, trithemimeral
τεύχεσιν ἀμφ’ Ἀχιλῆος· ἔθηκε δὲ πότνια μήτηρ.	-uu - uu-u u-u u -uu --	dactylic hexameter	feminine penthemimeral, trithemimeral
παῖδες δὲ Τρώων δίκασαν καὶ Παλλὰς Ἀθήνη.	-- - -- uu- - -u u--	dactylic hexameter	masculine penthemimeral, hepthemimeral, trithemimeral
ὡς δὴ μὴ ὄφελον νικᾶν τοιῷδ’ ἐπ’ ἀέθλῳ·	- - - uu- -- -- u u--	dactylic hexameter	masculine penthemimeral, hepthemimeral, trithemimeral
τοίην γὰρ κεφαλὴν ἕνεκ’ αὐτῶν γαῖα κατέσχεν,	-- - uu- uu -- -u u--	dactylic hexameter	masculine penthemimeral, trithemimeral
Αἴανθ’, ὃς πέρι μὲν εἶδος, πέρι δ’ἔργα τέτυκτο	-- - uu - -- uu -u u--	dactylic hexameter	masculine penthemimeral, hepthemimeral, trithemimeral
τῶν ἄλλων Δαναῶν μετ’ ἀμύμονα Πηλεΐωνα.	- -- uu- u u-uu -uu--	dactylic hexameter	masculine penthemimeral, trithemimeral
τὸν μὲν ἐγὼν ἐπέεσσι προσηύδων μειλιχίοισιν·	- u u- uu-u u-- -uu--	dactylic hexameter	feminine penthemimeral, trithemimeral
Αἶαν, παῖ Τελαμῶνος ἀμύμονος, οὐκ ἄρ’ ἔμελλες	-- - uu-u u-uu - u u--	dactylic hexameter	feminine penthemimeral, trithemimeral
οὐδὲ θανὼν λήσεσθαι ἐμοὶ χόλου εἵνεκα τευχέων	-u u- --u u- uu -uu --	dactylic hexameter	feminine penthemimeral, hepthemimeral, trithemimeral
οὐλομένων; τὰ δὲ πῆμα θεοὶ θέσαν Ἀργείοισι,	-uu- u u -u u- uu ----	dactylic hexameter	feminine penthemimeral, hepthemimeral, trithemimeral
τοῖος γάρ σφιν πύργος ἀπώλεο· σεῖο δ’Ἀχαιοὶ	-- - - -u u-uu -u u--	dactylic hexameter	feminine penthemimeral, trithemimeral
ἶσον Ἀχιλλῆος κεφαλῇ Πηληϊάδαο	-u u--- uu- --uu--	dactylic hexameter	masculine penthemimeral, hepthemimeral
ἀχνύμεθα φθιμένοιο διαμπερές· οὐδέ τις ἄλλος	-uu- uu-u u-uu -u u --	dactylic hexameter	feminine penthemimeral, trithemimeral
αἴτιος, ἀλλὰ Ζεὺς Δαναῶν στρατὸν αἰχμητάων	-uu -- - uu- uu ----	dactylic hexameter	masculine penthemimeral, hepthemimeral
ἐκπάγλως ἤχθηρε, τεῒν δ’ἐπὶ μοῖραν ἔθηκεν.	--- --u u- uu -u u--	dactylic hexameter	feminine penthemimeral, hepthemimeral, trithemimeral
ἀλλ’ ἄγε δεῦρο, ἄναξ, ἵν’ ἔπος καὶ μῦθον ἀκούσῃς	- uu -u u- u u- - -u u--	dactylic hexameter	masculine penthemimeral, hepthemimeral
ἡμέτερον· δάμασον δὲ μένος καὶ ἀγήνορα θυμόν.	-uu- uu- u u- u u-uu --	dactylic hexameter	masculine penthemimeral, hepthemimeral, trithemimeral
ὣς ἐφάμην, ὁ δέ μ’οὐδὲν ἀμείβετο, βῆ δὲ μετ’ ἄλλας	- uu- u u -u u-uu - u u --	dactylic hexameter	feminine penthemimeral, trithemimeral
ψυχὰς εἰς Ἔρεβος νεκύων κατατεθνηώτων.	-- - uu- uu- uu----	dactylic hexameter	masculine penthemimeral, hepthemimeral, trithemimeral
ἔνθα χ’ὅμως προσέφη κεχολωμένος, ἤ κεν ἐγὼ τόν·	-u u- uu- uu-uu - u u- -	dactylic hexameter	masculine penthemimeral, trithemimeral
ἀλλά μοι ἤθελε θυμὸς ἐνὶ στήθεσσι φίλοισι	-u u -uu -u u- --u u--	dactylic hexameter	feminine penthemimeral, hepthemimeral
τῶν ἄλλων ψυχὰς ἰδέειν κατατεθνηώτων.	- -- -- uu- uu----	dactylic hexameter	masculine penthemimeral, hepthemimeral, trithemimeral
ἔνθ’ ἤτοι Μίνωα ἴδον, Διὸς ἀγλαὸν υἱόν,	- -- --u u- uu -uu --	dactylic hexameter	feminine penthemimeral, hepthemimeral, trithemimeral
χρύσεον σκῆπτρον ἔχοντα, θεμιστεύοντα νέκυσσιν,	-- -u u-u u---u u--	dactylic hexameter	feminine penthemimeral
ἥμενον, οἱ δέ μιν ἀμφὶ δίκας εἴροντο ἄνακτα,	-uu - u u -u u- --u u--	dactylic hexameter	feminine penthemimeral, hepthemimeral, trithemimeral
ἥμενοι ἑσταότες τε κατ’ εὐρυπυλὲς Ἄϊδος δῶ.	-uu -uu- u u -uu- uu- -	dactylic hexameter	masculine penthemimeral
τὸν δὲ μετ’ Ὠρίωνα πελώριον εἰσενόησα	- u u ---u u-uu -uu--	dactylic hexameter	feminine penthemimeral
θῆρας ὁμοῦ εἰλεῦντα κατ’ ἀσφοδελὸν λειμῶνα,	-u u- --u u -uu- ---	dactylic hexameter	feminine penthemimeral, trithemimeral
τοὺς αὐτὸς κατέπεφνεν ἐν οἰοπόλοισιν ὄρεσσι	- -- uu-u u -uu-u u--	dactylic hexameter	feminine penthemimeral, trithemimeral
χερσὶν ἔχων ῥόπαλον παγχάλκεον, αἰὲν ἀαγές.	-u u- uu- --uu -u u--	dactylic hexameter	masculine penthemimeral, trithemimeral
καὶ Τιτυὸν εἶδον, Γαίης ἐρικυδέος υἱόν,	- uu- -- -- uu-uu --	dactylic hexameter	masculine penthemimeral, hepthemimeral, trithemimeral
κείμενον ἐν δαπέδῳ· ὁ δ’ἐπ’ ἐννέα κεῖτο πέλεθρα,	-uu - uu- u u -uu -u u--	dactylic hexameter	masculine penthemimeral, trithemimeral
γῦπε δέ μιν ἑκάτερθε παρημένω ἧπαρ ἔκειρον,	-u u - uu-u u-uu -u u--	dactylic hexameter	feminine penthemimeral, trithemimeral
δέρτρον ἔσω δύνοντες, ὁ δ’οὐκ ἀπαμύνετο χερσί·	-u u- --u u - uu-uu --	dactylic hexameter	feminine penthemimeral, hepthemimeral, trithemimeral
Λητὼ γὰρ ἥλκησε, Διὸς κυδρὴν παράκοιτιν,	-- - --u u- -- uu--	dactylic hexameter	feminine penthemimeral, hepthemimeral, trithemimeral
Πυθώδ’ ἐρχομένην διὰ καλλιχόρου Πανοπῆος.	-- -uu- uu -uu- uu--	dactylic hexameter	masculine penthemimeral
καὶ μὴν Τάνταλον εἰσεῖδον κρατέρ’ ἄλγε’ ἔχοντα	- - -uu --- uu -u u--	dactylic hexameter	hepthemimeral
ἑσταότ’ ἐν λίμνῃ· ἡ δὲ προσέπλαζε γενείῳ·	-uu - -- - - uu-u u--	dactylic hexameter	masculine penthemimeral, hepthemimeral, trithemimeral
στεῦτο δὲ διψάων, πιέειν δ’οὐκ εἶχεν ἑλέσθαι·	-u u --- uu- - -u u--	dactylic hexameter	masculine penthemimeral, hepthemimeral
ὁσσάκι γὰρ κύψει’ ὁ γέρων πιέειν μενεαίνων,	-uu - -- u u- uu- uu--	dactylic hexameter	masculine penthemimeral, hepthemimeral, trithemimeral
τοσσάχ’ ὕδωρ ἀπολέσκετ’ ἀναβροχέν, ἀμφὶ δὲ ποσσὶ	-u u- uu-u u-uu -u u --	dactylic hexameter	feminine penthemimeral, trithemimeral
γαῖα μέλαινα φάνεσκε, καταζήνασκε δὲ δαίμων.	-u u-u u-u u---u u --	dactylic hexameter	feminine penthemimeral
δένδρεα δ’ὑψιπέτηλα κατὰ κρῆθεν χέε καρπόν,	-uu -uu-u u- -- uu --	dactylic hexameter	feminine penthemimeral, hepthemimeral
ὄγχναι καὶ ῥοιαὶ καὶ μηλέαι ἀγλαόκαρποι	-- - -- - -uu -uu--	dactylic hexameter	masculine penthemimeral, trithemimeral
συκέαι τε γλυκεραὶ καὶ ἐλαῖαι τηλεθόωσαι·	-- - uu- u u-- -uu--	dactylic hexameter	masculine penthemimeral, trithemimeral
τῶν ὁπότ’ ἰθύσει’ ὁ γέρων ἐπὶ χερσὶ μάσασθαι,	- uu --- u u- uu -u u--	dactylic hexameter	masculine penthemimeral, hepthemimeral
τὰς δ’ἄνεμος ῥίπτασκε ποτὶ νέφεα σκιόεντα.	- uu- --u u- uu- uu--	dactylic hexameter	feminine penthemimeral, hepthemimeral, trithemimeral
καὶ μὴν Σίσυφον εἰσεῖδον κρατέρ’ ἄλγε’ ἔχοντα	- - -uu --- uu -u u--	dactylic hexameter	hepthemimeral
λᾶαν βαστάζοντα πελώριον ἀμφοτέρῃσιν.	-- ---u u-uu -uu--	dactylic hexameter	feminine penthemimeral
ἤτοι ὁ μὲν σκηριπτόμενος χερσίν τε ποσίν τε	-u u - --uu- -- u u- -	dactylic hexameter	hepthemimeral, trithemimeral
λᾶαν ἄνω ὤθεσκε ποτὶ λόφον· ἀλλ’ ὅτε μέλλοι	-u u- --u u- uu - uu --	dactylic hexameter	feminine penthemimeral, hepthemimeral, trithemimeral
ἄκρον ὑπερβαλέειν, τότ’ ἀποστρέψασκε κραταιΐς·	-u u-uu- u u---u u--	dactylic hexameter	masculine penthemimeral
αὖτις ἔπειτα πέδονδε κυλίνδετο λᾶας ἀναιδής.	-u u-u u-u u-uu -u u--	dactylic hexameter	feminine penthemimeral
αὐτὰρ ὅ γ’ἂψ ὤσασκε τιταινόμενος, κατὰ δ’ἱδρὼς	-u u - --u u-uu- uu --	dactylic hexameter	feminine penthemimeral, trithemimeral
ἔρρεεν ἐκ μελέων, κονίη δ’ἐκ κρατὸς ὀρώρει.	-uu - uu- uu- - -u u--	dactylic hexameter	masculine penthemimeral, hepthemimeral, trithemimeral
τὸν δὲ μετ’ εἰσενόησα βίην Ἡρακληείην,	- u u -uu-u u- -----	dactylic hexameter	feminine penthemimeral, hepthemimeral
εἴδωλον· αὐτὸς δὲ μετ’ ἀθανάτοισι θεοῖσι	--- -- u u -uu-u u--	dactylic hexameter	masculine penthemimeral, trithemimeral
τέρπεται ἐν θαλίῃς καὶ ἔχει καλλίσφυρον Ἥβην,	-uu - uu- u u- --uu --	dactylic hexameter	masculine penthemimeral, hepthemimeral, trithemimeral
παῖδα Διὸς μεγάλοιο καὶ Ἥρης χρυσοπεδίλου.	-u u- uu-u u -- -uu--	dactylic hexameter	feminine penthemimeral, trithemimeral
ἀμφὶ δέ μιν κλαγγὴ νεκύων ἦν οἰωνῶν ὥς,	-u u - -- uu- - --- -	dactylic hexameter	masculine penthemimeral, hepthemimeral, trithemimeral
πάντοσ’ ἀτυζομένων· ὁ δ’ἐρεμνῇ νυκτὶ ἐοικώς,	-u u-uu- u u-- -u u--	dactylic hexameter	masculine penthemimeral
γυμνὸν τόξον ἔχων καὶ ἐπὶ νευρῆφιν ὀϊστόν,	-- -u u- u u- --u u--	dactylic hexameter	masculine penthemimeral, hepthemimeral
δεινὸν παπταίνων, αἰεὶ βαλέοντι ἐοικώς.	-- --- -- uu-u u--	dactylic hexameter	masculine penthemimeral, hepthemimeral
σμερδαλέος δέ οἱ ἀμφὶ περὶ στήθεσσιν ἀορτὴρ	-uu- u u -u u- --u u--	dactylic hexameter	feminine penthemimeral, hepthemimeral, trithemimeral
χρύσεος ἦν τελαμών, ἵνα θέσκελα ἔργα τέτυκτο,	-uu - uu- uu -uu -u u--	dactylic hexameter	masculine penthemimeral, trithemimeral
ἄρκτοι τ’ἀγρότεροί τε σύες χαροποί τε λέοντες,	-- -uu- u u- uu- u u--	dactylic hexameter	masculine penthemimeral, hepthemimeral
ὑσμῖναί τε μάχαι τε φόνοι τ’ἀνδροκτασίαι τε.	--- u u- u u- --uu- -	dactylic hexameter	masculine penthemimeral, hepthemimeral, trithemimeral
μὴ τεχνησάμενος μηδ’ ἄλλο τι τεχνήσαιτο,	- --uu- - -u u ----	dactylic hexameter	masculine penthemimeral
ὃς κεῖνον τελαμῶνα ἑῇ ἐγκάτθετο τέχνῃ.	- -- uu-u u- --uu --	dactylic hexameter	feminine penthemimeral, hepthemimeral, trithemimeral
ἔγνω δ’αἶψ’ ἐμὲ κεῖνος, ἐπεὶ ἴδεν ὀφθαλμοῖσι,	-- - uu -u u- uu ----	dactylic hexameter	feminine penthemimeral, hepthemimeral, trithemimeral
καί μ’ὀλοφυρόμενος ἔπεα πτερόεντα προσηύδα·	- uu-uu- uu- uu-u u--	dactylic hexameter	masculine penthemimeral, hepthemimeral
διογενὲς Λαερτιάδη, πολυμήχαν’ Ὀδυσσεῦ,	-uu- --uu- uu-u u--	dactylic hexameter	hepthemimeral, trithemimeral
ἆ δείλ’, ἦ τινὰ καὶ σὺ κακὸν μόρον ἡγηλάζεις,	- - - uu - u u- uu ----	dactylic hexameter	masculine penthemimeral, hepthemimeral, trithemimeral
ὅν περ ἐγὼν ὀχέεσκον ὑπ’ αὐγὰς ἠελίοιο.	- u u- uu-u u -- -uu--	dactylic hexameter	feminine penthemimeral, trithemimeral
Ζηνὸς μὲν πάϊς ἦα Κρονίονος, αὐτὰρ ὀϊζὺν	-- - uu -u u-uu -u u--	dactylic hexameter	feminine penthemimeral, trithemimeral
εἶχον ἀπειρεσίην· μάλα γὰρ πολὺ χείρονι φωτὶ	-u u-uu- uu - uu -uu --	dactylic hexameter	masculine penthemimeral, hepthemimeral
δεδμήμην, ὁ δέ μοι χαλεποὺς ἐπετέλλετ’ ἀέθλους.	--- u u - uu- uu-u u--	dactylic hexameter	masculine penthemimeral, hepthemimeral, trithemimeral
καί ποτέ μ’ἐνθάδ’ ἔπεμψε κύν’ ἄξοντ’· οὐ γὰρ ἔτ’ ἄλλον	- uu -u u-u u -- - u u --	dactylic hexameter	feminine penthemimeral
φράζετο τοῦδέ τί μοι κρατερώτερον εἶναι ἄεθλον·	-uu -u u - uu-uu -u u--	dactylic hexameter	masculine penthemimeral
τὸν μὲν ἐγὼν ἀνένεικα καὶ ἤγαγον ἐξ Ἀΐδαο·	- u u- uu-u u -uu - uu--	dactylic hexameter	feminine penthemimeral, trithemimeral
Ἑρμείας δέ μ’ἔπεμπεν ἰδὲ γλαυκῶπις Ἀθήνη.	--- u u-u u- --u u--	dactylic hexameter	feminine penthemimeral, hepthemimeral, trithemimeral
ὣς εἰπὼν ὁ μὲν αὖτις ἔβη δόμον Ἄϊδος εἴσω,	- -- u u -u u- uu -uu --	dactylic hexameter	feminine penthemimeral, hepthemimeral, trithemimeral
αὐτὰρ ἐγὼν αὐτοῦ μένον ἔμπεδον, εἴ τις ἔτ’ ἔλθοι	-u u- -- uu -uu - u u --	dactylic hexameter	masculine penthemimeral, trithemimeral
ἀνδρῶν ἡρώων, οἳ δὴ τὸ πρόσθεν ὄλοντο.	-- --- - - - -u u--	dactylic hexameter	masculine penthemimeral, hepthemimeral
καί νύ κ’ἔτι προτέρους ἴδον ἀνέρας, οὓς ἔθελόν περ,	- u u- uu- uu -uu - uu- -	dactylic hexameter	masculine penthemimeral, trithemimeral
Θησέα Πειρίθοόν τε, θεῶν ἐρικυδέα τέκνα·	-uu -uu- u u- uu-uu --	dactylic hexameter	masculine penthemimeral, hepthemimeral
ἀλλὰ πρὶν ἐπὶ ἔθνε’ ἀγείρετο μυρία νεκρῶν	-- - uu -u u-uu -uu --	dactylic hexameter	feminine penthemimeral, trithemimeral
ἠχῇ θεσπεσίῃ· ἐμὲ δὲ χλωρὸν δέος ᾕρει,	-- -uu- uu - -- uu --	dactylic hexameter	masculine penthemimeral, hepthemimeral
μή μοι Γοργείην κεφαλὴν δεινοῖο πελώρου	- - --- uu- --u u--	dactylic hexameter	masculine penthemimeral, hepthemimeral
ἐξ Ἄϊδος πέμψειεν ἀγαυὴ Περσεφόνεια.	- uu- --u u-- -uu--	dactylic hexameter	feminine penthemimeral, trithemimeral
αὐτίκ’ ἔπειτ’ ἐπὶ νῆα κιὼν ἐκέλευον ἑταίρους	-u u- uu -u u- uu-u u--	dactylic hexameter	feminine penthemimeral, hepthemimeral, trithemimeral
αὐτούς τ’ἀμβαίνειν ἀνά τε πρυμνήσια λῦσαι.	-- --- uu - --uu --	dactylic hexameter	masculine penthemimeral, hepthemimeral
οἱ δ’αἶψ’ εἴσβαινον καὶ ἐπὶ κληῗσι καθῖζον.	- - --- u u- --u u--	dactylic hexameter	masculine penthemimeral, hepthemimeral
τὴν δὲ κατ’ Ὠκεανὸν ποταμὸν φέρε κῦμα ῥόοιο,	- u u -uu- uu- uu -u u--	dactylic hexameter	masculine penthemimeral, hepthemimeral
πρῶτα μὲν εἰρεσίη, μετέπειτα δὲ κάλλιμος οὖρος.	-u u -uu- uu-u u -uu --	dactylic hexameter	masculine penthemimeral
