αὐτὰρ ὁ ἐν προδόμῳ εὐνάζετο δῖος Ὀδυσσεύς·	-u u - uu- --uu -u u--	dactylic hexameter	masculine penthemimeral, trithemimeral
κὰμ μὲν ἀδέψητον βοέην στόρεσ’, αὐτὰρ ὕπερθεν	- u u--- uu- uu -u u--	dactylic hexameter	masculine penthemimeral, hepthemimeral
κώεα πόλλ’ ὀΐων, τοὺς ἱρεύεσκον Ἀχαιοί·	-uu - uu- - ---u u--	dactylic hexameter	masculine penthemimeral, trithemimeral
Εὐρυνόμη δ’ἄρ’ ἐπὶ χλαῖναν βάλε κοιμηθέντι.	-uu- u u- -- uu ----	dactylic hexameter	masculine penthemimeral, hepthemimeral, trithemimeral
ἔνθ’ Ὀδυσεὺς μνηστῆρσι κακὰ φρονέων ἐνὶ θυμῷ	- uu- --u u- uu- uu --	dactylic hexameter	feminine penthemimeral, hepthemimeral, trithemimeral
κεῖτ’ ἐγρηγορόων· ταὶ δ’ἐκ μεγάροιο γυναῖκες	- --uu- - - uu-u u--	dactylic hexameter	masculine penthemimeral, hepthemimeral
ἤϊσαν, αἳ μνηστῆρσιν ἐμισγέσκοντο πάρος περ,	-uu - --u u---u u- -	dactylic hexameter	feminine penthemimeral, trithemimeral
ἀλλήλῃσι γέλω τε καὶ εὐφροσύνην παρέχουσαι.	---u u- u u -uu- uu--	dactylic hexameter	masculine penthemimeral
τοῦ δ’ὠρίνετο θυμὸς ἐνὶ στήθεσσι φίλοισι·	- --uu -u u- --u u--	dactylic hexameter	feminine penthemimeral, hepthemimeral
πολλὰ δὲ μερμήριζε κατὰ φρένα καὶ κατὰ θυμόν,	-u u ---u u- uu - uu --	dactylic hexameter	feminine penthemimeral, hepthemimeral
ἠὲ μεταΐξας θάνατον τεύξειεν ἑκάστῃ,	-u u--- uu- --u u--	dactylic hexameter	masculine penthemimeral, hepthemimeral
ἦ ἔτ’ ἐῷ μνηστῆρσιν ὑπερφιάλοισι μιγῆναι	- u u- --u u-uu-u u--	dactylic hexameter	feminine penthemimeral, trithemimeral
ὕστατα καὶ πύματα, κραδίη δέ οἱ ἔνδον ὑλάκτει.	-uu - uu- uu- u u -u u--	dactylic hexameter	masculine penthemimeral, hepthemimeral, trithemimeral
ὡς δὲ κύων ἀμαλῇσι περὶ σκυλάκεσσι βεβῶσα	- u u- uu-u u- uu-u u--	dactylic hexameter	feminine penthemimeral, hepthemimeral, trithemimeral
ἄνδρ’ ἀγνοιήσασ’ ὑλάει μέμονέν τε μάχεσθαι,	- ---- uu- uu- u u--	dactylic hexameter	masculine penthemimeral, hepthemimeral
ὥς ῥα τοῦ ἔνδον ὑλάκτει ἀγαιομένου κακὰ ἔργα·	- u u -u u-u u-uu- uu --	dactylic hexameter	feminine penthemimeral
στῆθος δὲ πλήξας κραδίην ἠνίπαπε μύθῳ·	-- - -- uu- --uu --	dactylic hexameter	masculine penthemimeral, hepthemimeral, trithemimeral
τέτλαθι δή, κραδίη· καὶ κύντερον ἄλλο ποτ’ ἔτλης.	-uu - uu- - -uu -u u --	dactylic hexameter	masculine penthemimeral, trithemimeral
ἤματι τῷ ὅτε μοι μένος ἄσχετος ἤσθιε Κύκλωψ	-uu - uu - uu -uu -uu --	dactylic hexameter	masculine penthemimeral, trithemimeral
ἰφθίμους ἑτάρους· σὺ δ’ἐτόλμας, ὄφρα σε μῆτις	--- uu- u u-- -u u --	dactylic hexameter	masculine penthemimeral, trithemimeral
ἐξάγαγ’ ἐξ ἄντροιο ὀϊόμενον θανέεσθαι.	-uu - --u u-uu- uu--	dactylic hexameter	feminine penthemimeral, trithemimeral
ὣς ἔφατ’, ἐν στήθεσσι καθαπτόμενος φίλον ἦτορ·	- uu - --u u-uu- uu --	dactylic hexameter	feminine penthemimeral, trithemimeral
τῷ δὲ μάλ’ ἐν πείσῃ κραδίη μένε τετληυῖα	- u u - -- uu- uu ----	dactylic hexameter	masculine penthemimeral, hepthemimeral, trithemimeral
νωλεμέως· ἀτὰρ αὐτὸς ἑλίσσετο ἔνθα καὶ ἔνθα.	-uu- uu -u u-uu -u u --	dactylic hexameter	feminine penthemimeral, trithemimeral
ὡς δ’ὅτε γαστέρ’ ἀνὴρ πολέος πυρὸς αἰθομένοιο,	- uu -u u- uu- uu -uu--	dactylic hexameter	masculine penthemimeral, hepthemimeral
ἐμπλείην κνίσης τε καὶ αἵματος, ἔνθα καὶ ἔνθα	--- -- u u -uu -u u --	dactylic hexameter	masculine penthemimeral, trithemimeral
αἰόλλῃ, μάλα δ’ὧκα λιλαίεται ὀπτηθῆναι,	--- uu -u u-uu ----	dactylic hexameter	feminine penthemimeral, trithemimeral
ὣς ἄρ’ ὅ γ’ἔνθα καὶ ἔνθα ἑλίσσετο, μερμηρίζων	- u u -u u -u u-uu ----	dactylic hexameter	feminine penthemimeral
ὅππως δὴ μνηστῆρσιν ἀναιδέσι χεῖρας ἐφήσει	-- - --u u-uu -u u--	dactylic hexameter	feminine penthemimeral, trithemimeral
μοῦνος ἐὼν πολέσι. σχεδόθεν δέ οἱ ἦλθεν Ἀθήνη	-u u- uu- uu- u u -u u--	dactylic hexameter	masculine penthemimeral, hepthemimeral, trithemimeral
οὐρανόθεν καταβᾶσα· δέμας δ’ἤϊκτο γυναικί·	-uu- uu-u u- --u u--	dactylic hexameter	feminine penthemimeral, hepthemimeral, trithemimeral
στῆ δ’ἄρ’ ὑπὲρ κεφαλῆς καί μιν πρὸς μῦθον ἔειπε·	- u u- uu- - - - -u u--	dactylic hexameter	masculine penthemimeral, hepthemimeral, trithemimeral
τίπτ’ αὖτ’ ἐγρήσσεις, πάντων περὶ κάμμορε φωτῶν;	- - --- -- uu -uu --	dactylic hexameter	masculine penthemimeral, hepthemimeral
οἶκος μέν τοι ὅδ’ ἐστί, γυνὴ δέ τοι ἥδ’ ἐνὶ οἴκῳ	-- - u u -u u- u u - uu --	dactylic hexameter	feminine penthemimeral, hepthemimeral, trithemimeral
καὶ, πάϊς, οἷόν πού τις ἐέλδεται ἔμμεναι υἷα.	- uu -- - u u-uu -uu --	dactylic hexameter	masculine penthemimeral
τὴν δ’ἀπαμειβόμενος προσέφη πολύμητις Ὀδυσσεύς·	- uu-uu- uu- uu-u u--	dactylic hexameter	masculine penthemimeral, hepthemimeral
ναὶ δὴ ταῦτά γε πάντα, θεά, κατὰ μοῖραν ἔειπες·	- - -u u -u u- uu -u u--	dactylic hexameter	feminine penthemimeral, hepthemimeral
ἀλλά τί μοι τόδε θυμὸς ἐνὶ φρεσὶ μερμηρίζει,	-u u - uu -u u- uu ----	dactylic hexameter	feminine penthemimeral, hepthemimeral, trithemimeral
ὅππως δὴ μνηστῆρσιν ἀναιδέσι χεῖρας ἐφήσω,	-- - --u u-uu -u u--	dactylic hexameter	feminine penthemimeral, trithemimeral
μοῦνος ἐών· οἱ δ’αἰὲν ἀολλέες ἔνδον ἔασι.	-u u- - -u u-uu -u u--	dactylic hexameter	feminine penthemimeral, trithemimeral
πρὸς δ’ἔτι καὶ τόδε μεῖζον ἐνὶ φρεσὶ μερμηρίζω·	- uu - uu -u u- uu ----	dactylic hexameter	feminine penthemimeral, hepthemimeral, trithemimeral
εἴ περ γὰρ κτείναιμι Διός τε σέθεν τε ἕκητι,	- - - --u u- u u- u u--	dactylic hexameter	feminine penthemimeral, hepthemimeral, trithemimeral
πῇ κεν ὑπεκπροφύγοιμι; τά σε φράζεσθαι ἄνωγα.	- u u-uu-u u - --u u--	dactylic hexameter	feminine penthemimeral, hepthemimeral
τὸν δ’αὖτε προσέειπε θεὰ γλαυκῶπις Ἀθήνη·	- -- uu-u u- --u u--	dactylic hexameter	feminine penthemimeral, hepthemimeral, trithemimeral
σχέτλιε, καὶ μέν τίς τε χερείονι πείθεθ’ ἑταίρῳ,	-uu - - - u u-uu -u u--	dactylic hexameter	masculine penthemimeral, trithemimeral
ὅς περ θνητός τ’ἐστὶ καὶ οὐ τόσα μήδεα οἶδεν·	- - -- -u u - uu -uu --	dactylic hexameter	feminine penthemimeral, hepthemimeral
αὐτὰρ ἐγὼ θεός εἰμι, διαμπερὲς ἥ σε φυλάσσω	-u u- uu -u u-uu - u u--	dactylic hexameter	feminine penthemimeral, trithemimeral
ἐν πάντεσσι πόνοις. ἐρέω δέ τοι ἐξαναφανδόν·	- --u u- uu- u u -uu--	dactylic hexameter	masculine penthemimeral, hepthemimeral
εἴ περ πεντήκοντα λόχοι μερόπων ἀνθρώπων	- - ---u u- uu- ---	dactylic hexameter	feminine penthemimeral, hepthemimeral
νῶϊ περισταῖεν, κτεῖναι μεμαῶτες Ἄρηϊ,	-u u--- -- uu-u u--	dactylic hexameter	masculine penthemimeral, hepthemimeral
καί κεν τῶν ἐλάσαιο βόας καὶ ἴφια μῆλα.	- - - uu-u u- - -uu --	dactylic hexameter	feminine penthemimeral, hepthemimeral, trithemimeral
ἀλλ’ ἑλέτω σε καὶ ὕπνος· ἀνίη καὶ τὸ φυλάσσειν	- uu- u u -u u-- - u u--	dactylic hexameter	feminine penthemimeral, trithemimeral
πάννυχον ἐγρήσσοντα, κακῶν δ’ὑποδύσεαι ἤδη.	-uu ---u u- uu-uu --	dactylic hexameter	feminine penthemimeral, hepthemimeral
ὣς φάτο, καί ῥά οἱ ὕπνον ἐπὶ βλεφάροισιν ἔχευεν,	- uu - u u -u u- uu-u u--	dactylic hexameter	feminine penthemimeral, hepthemimeral, trithemimeral
αὐτὴ δ’ἂψ ἐς Ὄλυμπον ἀφίκετο δῖα θεάων.	-- - u u-u u-uu -u u--	dactylic hexameter	feminine penthemimeral, trithemimeral
εὖτε τὸν ὕπνος ἔμαρπτε, λύων μελεδήματα θυμοῦ,	-u u -u u-u u- uu-uu --	dactylic hexameter	feminine penthemimeral, hepthemimeral
λυσιμελής, ἄλοχος δ’ἄρ’ ἐπέγρετο κέδν’ εἰδυῖα·	-uu- uu- u u-uu - ---	dactylic hexameter	masculine penthemimeral, trithemimeral
κλαῖε δ’ἄρ’ ἐν λέκτροισι καθεζομένη μαλακοῖσιν.	-u u - --u u-uu- uu--	dactylic hexameter	feminine penthemimeral, trithemimeral
αὐτὰρ ἐπεὶ κλαίουσα κορέσσατο ὃν κατὰ θυμόν,	-u u- --u u-uu - uu --	dactylic hexameter	feminine penthemimeral, trithemimeral
Ἀρτέμιδι πρώτιστον ἐπεύξατο δῖα γυναικῶν·	-uu- --u u-uu -u u--	dactylic hexameter	feminine penthemimeral, trithemimeral
Ἄρτεμι, πότνα θεά, θύγατερ Διός, αἴθε μοι ἤδη	-uu -u u- uu- uu -u u --	dactylic hexameter	masculine penthemimeral, hepthemimeral
ἰὸν ἐνὶ στήθεσσι βαλοῦσ’ ἐκ θυμὸν ἕλοιο	-u u- --u u- - -u u--	dactylic hexameter	feminine penthemimeral, hepthemimeral, trithemimeral
αὐτίκα νῦν, ἢ ἔπειτα μ’ ἀναρπάξασα θύελλα	-uu - u u-u u---u u--	dactylic hexameter	feminine penthemimeral, trithemimeral
οἴχοιτο προφέρουσα κατ’ ἠερόεντα κέλευθα,	--- uu-u u -uu-u u--	dactylic hexameter	feminine penthemimeral, trithemimeral
ἐν προχοῇς δὲ βάλοι ἀψορρόου Ὠκεανοῖο.	- uu- u u- --uu -uu--	dactylic hexameter	masculine penthemimeral, trithemimeral
ὡς δ’ὅτε Πανδαρέου κούρας ἀνέλοντο θύελλαι·	- uu -uu- -- uu-u u--	dactylic hexameter	masculine penthemimeral, hepthemimeral
τῇσι τοκῆας μὲν φθῖσαν θεοί, αἱ δ’ἐλίποντο	-u u-- - -- uu - uu--	dactylic hexameter	masculine penthemimeral, hepthemimeral
ὀρφαναὶ ἐν μεγάροισι, κόμισσε δὲ δῖ’ Ἀφροδίτη	-uu - uu-u u-u u - uu--	dactylic hexameter	feminine penthemimeral, trithemimeral
τυρῷ καὶ μέλιτι γλυκερῷ καὶ ἡδέϊ οἴνῳ·	-- - uu- uu- - -uu --	dactylic hexameter	masculine penthemimeral, hepthemimeral, trithemimeral
Ἥρη δ’αὐτῇσιν περὶ πασέων δῶκε γυναικῶν	-- --- uu -- -u u--	dactylic hexameter	masculine penthemimeral
εἶδος καὶ πινυτήν, μῆκος δ’ἔπορ’ Ἄρτεμις ἁγνή,	-- - uu- -- uu -uu --	dactylic hexameter	masculine penthemimeral, hepthemimeral, trithemimeral
ἔργα δ’Ἀθηναίη δέδαε κλυτὰ ἐργάζεσθαι.	-u u--- uu- uu ----	dactylic hexameter	masculine penthemimeral, hepthemimeral
εὖτ’ Ἀφροδίτη δῖα προσέστιχε μακρὸν Ὄλυμπον,	- uu-- -u u-uu -u u--	dactylic hexameter	feminine penthemimeral
κούρῃς αἰτήσουσα τέλος θαλεροῖο γάμοιο	-- ---u u- uu-u u--	dactylic hexameter	feminine penthemimeral, hepthemimeral
ἐς Δία τερπικέραυνον, ὁ γάρ τ’εὖ οἶδεν ἅπαντα,	- uu -uu-u u - - -u u--	dactylic hexameter	feminine penthemimeral, hepthemimeral
μοῖράν τ’ἀμμορίην τε καταθνητῶν ἀνθρώπων	-- -uu- u u--- ---	dactylic hexameter	masculine penthemimeral
τόφρα δὲ τὰς κούρας ἅρπυιαι ἀνηρείψαντο	-u u - -- --u u----	dactylic hexameter	masculine penthemimeral, trithemimeral
καί ῥ’ἔδοσαν στυγερῇσιν ἐρινύσιν ἀμφιπολεύειν·	- uu- uu-u u-uu -uu--	dactylic hexameter	feminine penthemimeral, trithemimeral
ὣς ἔμ’ ἀϊστώσειαν Ὀλύμπια δώματ’ ἔχοντες,	- u u---u u-uu -u u--	dactylic hexameter	feminine penthemimeral
ἠέ μ’ἐϋπλόκαμος βάλοι Ἄρτεμις, ὄφρ’ Ὀδυσῆα	-u u-uu- uu -uu - uu--	dactylic hexameter	masculine penthemimeral
ὀσσομένη καὶ γαῖαν ὕπο στυγερὴν ἀφικοίμην,	-uu- - -u u- uu- uu--	dactylic hexameter	feminine penthemimeral, hepthemimeral, trithemimeral
μηδέ τι χείρονος ἀνδρὸς ἐϋφραίνοιμι νόημα.	-u u -uu -u u---u u--	dactylic hexameter	feminine penthemimeral
ἀλλὰ τὸ μὲν καὶ ἀνεκτὸν ἔχειν κακόν, ὁππότε κέν τις	-u u - u u-u u- uu -uu - -	dactylic hexameter	feminine penthemimeral, hepthemimeral, trithemimeral
ἤματα μὲν κλαίῃ, πυκινῶς ἀκαχήμενος ἦτορ,	-uu - -- uu- uu-uu --	dactylic hexameter	masculine penthemimeral, hepthemimeral, trithemimeral
νύκτας δ’ὕπνος ἔχῃσιν ὁ γάρ τ’ἐπέλησεν ἁπάντων,	-- -u u-u u - uu-u u--	dactylic hexameter	feminine penthemimeral, hepthemimeral
ἐσθλῶν ἠδὲ κακῶν, ἐπεὶ ἄρ βλέφαρ’ ἀμφικαλύψῃ	-- -u u- uu - uu -uu--	dactylic hexameter	masculine penthemimeral, hepthemimeral
αὐτὰρ ἐμοὶ καὶ ὀνείρατ’ ἐπέσσευεν κακὰ δαίμων.	-u u- u u-u u--- uu --	dactylic hexameter	feminine penthemimeral, trithemimeral
τῇδε γὰρ αὖ μοι νυκτὶ παρέδραθεν εἴκελος αὐτῷ,	-u u - - -u u-uu -uu --	dactylic hexameter	feminine penthemimeral, trithemimeral
τοῖος ἐὼν οἷος ᾖεν ἅμα στρατῷ· αὐτὰρ ἐμὸν κῆρ	-u u- uu -u u- uu -u u- -	dactylic hexameter	feminine penthemimeral, hepthemimeral, trithemimeral
χαῖρ’, ἐπεὶ οὐκ ἐφάμην ὄναρ ἔμμεναι, ἀλλ’ ὕπαρ ἤδη.	- uu - uu- uu -uu - uu --	dactylic hexameter	masculine penthemimeral, trithemimeral
ὣς ἔφατ’, αὐτίκα δὲ χρυσόθρονος ἤλυθεν Ἠώς.	- uu -uu - --uu -uu --	dactylic hexameter	masculine penthemimeral
τῆς δ’ἄρα κλαιούσης ὄπα σύνθετο δῖος Ὀδυσσεύς·	- uu --- uu -uu -u u--	dactylic hexameter	masculine penthemimeral
μερμήριξε δ’ἔπειτα, δόκησε δέ οἱ κατὰ θυμὸν	---u u-u u-u u - uu --	dactylic hexameter	feminine penthemimeral
ἤδη γινώσκουσα παρεστάμεναι κεφαλῆφι.	-- ---u u-uu- uu--	dactylic hexameter	feminine penthemimeral
χλαῖναν μὲν συνελὼν καὶ κώεα, τοῖσιν ἐνεῦδεν,	-- - uu- - -uu -u u--	dactylic hexameter	masculine penthemimeral, trithemimeral
ἐς μέγαρον κατέθηκεν ἐπὶ θρόνου, ἐκ δὲ βοείην	- uu- uu-u u- uu - u u--	dactylic hexameter	feminine penthemimeral, hepthemimeral, trithemimeral
θῆκε θύραζε φέρων, Διῒ δ’εὔξατο χεῖρας ἀνασχών·	-u u-u u- uu -uu -u u--	dactylic hexameter	masculine penthemimeral
Ζεῦ πάτερ, εἴ μ’ἐθέλοντες ἐπὶ τραφερήν τε καὶ ὑγρὴν	- uu - uu-u u- uu- u u --	dactylic hexameter	feminine penthemimeral, hepthemimeral, trithemimeral
ἤγετ’ ἐμὴν ἐς γαῖαν, ἐπεί μ’ἐκακώσατε λίην,	-u u- - -u u- uu-uu --	dactylic hexameter	feminine penthemimeral, hepthemimeral, trithemimeral
φήμην τίς μοι φάσθω ἐγειρομένων ἀνθρώπων	-- - - -u u-uu- ---	dactylic hexameter	feminine penthemimeral, trithemimeral
ἔνδοθεν, ἔκτοσθεν δὲ Διὸς τέρας ἄλλο φανήτω.	-uu --- u u- uu -u u--	dactylic hexameter	masculine penthemimeral, hepthemimeral
ὣς ἔφατ’ εὐχόμενος· τοῦ δ’ἔκλυε μητίετα Ζεύς,	- uu -uu- - -uu -uu- -	dactylic hexameter	masculine penthemimeral
αὐτίκα δ’ἐβρόντησεν ἀπ’ αἰγλήεντος Ὀλύμπου,	-uu ---u u ---u u--	dactylic hexameter	feminine penthemimeral
ὑψόθεν ἐκ νεφέων· γήθησε δὲ δῖος Ὀδυσσεύς.	-uu - uu- --u u -u u--	dactylic hexameter	masculine penthemimeral, trithemimeral
φήμην δ’ἐξ οἴκοιο γυνὴ προέηκεν ἀλετρὶς	-- - --u u- uu-u u--	dactylic hexameter	feminine penthemimeral, hepthemimeral, trithemimeral
πλησίον, ἔνθ’ ἄρα οἱ μύλαι εἵατο ποιμένι λαῶν,	-uu - uu - uu -uu -uu --	dactylic hexameter	masculine penthemimeral, trithemimeral
τῇσιν δώδεκα πᾶσαι ἐπερρώοντο γυναῖκες	-- -uu -u u---u u--	dactylic hexameter	feminine penthemimeral
ἄλφιτα τεύχουσαι καὶ ἀλείατα, μυελὸν ἀνδρῶν.	-uu --- u u-uu -uu --	dactylic hexameter	masculine penthemimeral
αἱ μὲν ἄρ’ ἄλλαι εὗδον, ἐπεὶ κατὰ πυρὸν ἄλεσσαν,	- u u -- -u u- uu -u u--	dactylic hexameter	feminine penthemimeral, hepthemimeral
ἡ δὲ μί’ οὔ πω παύετ’, ἀφαυροτάτη δὲ τέτυκτο·	- u u - - -u u-uu- u u--	dactylic hexameter	feminine penthemimeral, trithemimeral
ἥ ῥα μύλην στήσασα ἔπος φάτο, σῆμα ἄνακτι·	- u u- --u u- uu -u u--	dactylic hexameter	feminine penthemimeral, hepthemimeral, trithemimeral
Ζεῦ πάτερ, ὅς τε θεοῖσι καὶ ἀνθρώποισιν ἀνάσσεις,	- uu - u u-u u ---u u--	dactylic hexameter	feminine penthemimeral, trithemimeral
ἦ μεγάλ’ ἐβρόντησας ἀπ’ οὐρανοῦ ἀστερόεντος,	- uu ---u u -uu -uu--	dactylic hexameter	feminine penthemimeral
οὐδέ ποθι νέφος ἐστί· τέρας νύ τεῳ τόδε φαίνεις.	-u u- uu -u u- u u- uu --	dactylic hexameter	feminine penthemimeral, hepthemimeral, trithemimeral
κρῆνον νῦν καὶ ἐμοὶ δειλῇ ἔπος, ὅττι κεν εἴπω·	-- - u u- -- uu -u u --	dactylic hexameter	masculine penthemimeral, hepthemimeral, trithemimeral
μνηστῆρες πύματόν τε καὶ ὕστατον ἤματι τῷδε	--- uu- u u -uu -uu --	dactylic hexameter	masculine penthemimeral, trithemimeral
ἐν μεγάροις Ὀδυσῆος ἑλοίατο δαῖτ’ ἐρατεινήν,	- uu- uu-u u-uu - uu--	dactylic hexameter	feminine penthemimeral, trithemimeral
οἳ δή μοι καμάτῳ θυμαλγέϊ· γούνατ’ ἔλυσαν	- - - uu- --uu -u u--	dactylic hexameter	masculine penthemimeral, trithemimeral
ἄλφιτα τευχούσῃ· νῦν ὕστατα δειπνήσειαν.	-uu --- - -uu ----	dactylic hexameter	masculine penthemimeral
ὣς ἄρ’ ἔφη, χαῖρεν δὲ κλεηδόνι δῖος Ὀδυσσεὺς	- u u- -- u u-uu -u u--	dactylic hexameter	masculine penthemimeral, trithemimeral
Ζηνός τε βροντῇ· φάτο γὰρ τίσασθαι ἀλείτας.	-- - -- uu - --u u--	dactylic hexameter	masculine penthemimeral, hepthemimeral, trithemimeral
αἱ δ’ἄλλαι δμῳαὶ κατὰ δώματα κάλ’ Ὀδυσῆος	- -- -- uu -uu - uu--	dactylic hexameter	masculine penthemimeral, trithemimeral
ἐγρόμεναι ἀνέκαιον ἐπ’ ἐσχάρῃ ἀκάματον πῦρ.	-uu- uu-u u -uu -uu- -	dactylic hexameter	feminine penthemimeral, trithemimeral
Τηλέμαχος δ’εὐνῆθεν ἀνίστατο, ἰσόθεος φώς,	-uu- --u u-uu -uu- -	dactylic hexameter	feminine penthemimeral, trithemimeral
εἵματα ἑσσάμενος· περὶ δὲ ξίφος ὀξὺ θέτ’ ὤμῳ·	-uu -uu- uu - uu -u u --	dactylic hexameter	masculine penthemimeral, hepthemimeral
ποσσὶ δ’ὑπὸ λιπαροῖσιν ἐδήσατο καλὰ πέδιλα,	-u u- uu-u u-uu -u u--	dactylic hexameter	feminine penthemimeral, trithemimeral
εἵλετο δ’ἄλκιμον ἔγχος, ἀκαχμένον ὀξέϊ· χαλκῷ·	-uu -uu -u u-uu -uu --	dactylic hexameter	feminine penthemimeral
στῆ δ’ἄρ’ ἐπ’ οὐδὸν ἰών, πρὸς δ’Εὐρύκλειαν ἔειπε·	- u u -u u- - ---u u--	dactylic hexameter	masculine penthemimeral
μαῖα φίλη, πῶς ξεῖνον ἐτιμήσασθ’ ἐνὶ οἴκῳ	-u u- - -u u--- uu --	dactylic hexameter	feminine penthemimeral, trithemimeral
εὐνῇ καὶ σίτῳ, ἦ αὔτως κεῖται ἀκηδής;	-- - -- - -- -u u--	dactylic hexameter	masculine penthemimeral, trithemimeral
τοιαύτη γὰρ ἐμὴ μήτηρ, πινυτή περ ἐοῦσα·	--- u u- -- uu- u u--	dactylic hexameter	masculine penthemimeral, hepthemimeral, trithemimeral
ἐμπλήγδην ἕτερόν γε τίει μερόπων ἀνθρώπων	--- uu- u u- uu- ---	dactylic hexameter	masculine penthemimeral, hepthemimeral, trithemimeral
χείρονα, τὸν δέ τ’ἀρείον’ ἀτιμήσασ’ ἀποπέμπει.	-uu - u u-u u--- uu--	dactylic hexameter	feminine penthemimeral, trithemimeral
τὸν δ’αὖτε προσέειπε περίφρων Εὐρύκλεια·	- -- uu-u u-- ----	dactylic hexameter	feminine penthemimeral, trithemimeral
οὐκ ἄν μιν νῦν, τέκνον, ἀναίτιον αἰτιόῳο.	- - - - -u u-uu -uu--	dactylic hexameter	feminine penthemimeral, trithemimeral
οἶνον μὲν γὰρ πῖνε καθήμενος, ὄφρ’ ἔθελ’ αὐτός,	-- - - -u u-uu - uu --	dactylic hexameter	feminine penthemimeral, trithemimeral
σίτου δ’οὐκέτ’ ἔφη πεινήμεναι· εἴρετο γάρ μιν.	-- -u u- --uu -uu - -	dactylic hexameter	masculine penthemimeral
ἀλλ’ ὅτε δὴ κοίτοιο καὶ ὕπνου μιμνήσκοιτο,	- uu - --u u -- ----	dactylic hexameter	feminine penthemimeral, trithemimeral
ἡ μὲν δέμνι’ ἄνωγεν ὑποστορέσαι δμῳῇσιν,	- - -u u-u u-uu- ---	dactylic hexameter	feminine penthemimeral
αὐτὰρ ὅ γ’,ὥς τις πάμπαν ὀϊζυρὸς καὶ ἄποτμος,	-u u - - -u u--- u u--	dactylic hexameter	feminine penthemimeral, trithemimeral
οὐκ ἔθελ’ ἐν λέκτροισι καὶ ἐν ῥήγεσσι καθεύδειν,	- uu - --u u - --u u--	dactylic hexameter	feminine penthemimeral, hepthemimeral, trithemimeral
ἀλλ’ ἐν ἀδεψήτῳ βοέῃ καὶ κώεσιν οἰῶν	- u u--- uu- - -uu --	dactylic hexameter	masculine penthemimeral, hepthemimeral
ἔδραθ’ ἐνὶ προδόμῳ· χλαῖναν δ’ἐπιέσσαμεν ἡμεῖς.	-u u- uu- -- uu-uu --	dactylic hexameter	masculine penthemimeral, hepthemimeral, trithemimeral
ὣς φάτο, Τηλέμαχος δὲ διὲκ μεγάροιο βεβήκει	- uu -uu- u u- uu-u u--	dactylic hexameter	masculine penthemimeral, hepthemimeral
ἔγχος ἔχων, ἅμα τῷ γε κύνες πόδας ἀργοὶ ἕποντο.	-u u- uu - u u- uu -u u--	dactylic hexameter	masculine penthemimeral, hepthemimeral, trithemimeral
βῆ δ’ἴμεν εἰς ἀγορὴν μετ’ ἐϋκνήμιδας Ἀχαιούς.	- uu - uu- u u---u u--	dactylic hexameter	masculine penthemimeral, trithemimeral
ἡ δ’αὖτε δμῳῇσιν ἐκέκλετο δῖα γυναικῶν,	- -- --u u-uu -u u--	dactylic hexameter	feminine penthemimeral, trithemimeral
Εὐρύκλει’, Ὦπος θυγάτηρ Πεισηνορίδαο·	--- -- uu- --uu--	dactylic hexameter	masculine penthemimeral, hepthemimeral, trithemimeral
ἀγρεῖθ’, αἱ μὲν δῶμα κορήσατε ποιπνύσασαι,	-- - - -u u-uu ----	dactylic hexameter	feminine penthemimeral, trithemimeral
ῥάσσατέ τ’,ἔν τε θρόνοις εὐποιήτοισι τάπητας	-uu - u u- ----u u--	dactylic hexameter	masculine penthemimeral, trithemimeral
βάλλετε πορφυρέους· αἱ δὲ σπόγγοισι τραπέζας	-uu -uu- - - --u u--	dactylic hexameter	masculine penthemimeral, hepthemimeral
πάσας ἀμφιμάσασθε, καθήρατε δὲ κρητῆρας	-- -uu-u u-uu - ---	dactylic hexameter	feminine penthemimeral
καὶ δέπα ἀμφικύπελλα τετυγμένα· ταὶ δὲ μεθ’ ὕδωρ	- uu -uu-u u-uu - u u --	dactylic hexameter	feminine penthemimeral
ἔρχεσθε κρήνηνδε, καὶ οἴσετε θᾶσσον ἰοῦσαι.	--- --u u -uu -u u--	dactylic hexameter	feminine penthemimeral, trithemimeral
οὐ γὰρ δὴν μνηστῆρες ἀπέσσονται μεγάροιο,	- - - --u u--- uu--	dactylic hexameter	feminine penthemimeral, trithemimeral
ἀλλὰ μάλ’ ἦρι νέονται, ἐπεὶ καὶ πᾶσιν ἑορτή.	-u u -u u-u u- - -u u--	dactylic hexameter	feminine penthemimeral, hepthemimeral
ὣς ἔφαθ’, αἱ δ’ἄρα τῆς μάλα μὲν κλύον ἠδ’ ἐπίθοντο.	- uu - uu - uu - uu - uu--	dactylic hexameter	masculine penthemimeral, hepthemimeral, trithemimeral
αἱ μὲν ἐείκοσι βῆσαν ἐπὶ κρήνην μελάνυδρον,	- u u-uu -u u- -- uu--	dactylic hexameter	feminine penthemimeral, hepthemimeral
αἱ δ’αὐτοῦ κατὰ δώματ’ ἐπισταμένως πονέοντο.	- -- uu -u u-uu- uu--	dactylic hexameter	feminine penthemimeral, trithemimeral
ἐς δ’ἦλθον δρηστῆρες ἀγήνορες· οἱ μὲν ἔπειτα	- -- --u u-uu - u u--	dactylic hexameter	feminine penthemimeral, trithemimeral
εὖ καὶ ἐπισταμένως κέασαν ξύλα, ταὶ δὲ γυναῖκες	- u u-uu- uu- uu - u u--	dactylic hexameter	masculine penthemimeral, hepthemimeral
ἦλθον ἀπὸ κρήνης· ἐπὶ δέ σφισιν ἦλθε συβώτης	-u u- -- uu - uu -u u--	dactylic hexameter	masculine penthemimeral, hepthemimeral, trithemimeral
τρεῖς σιάλους κατάγων, οἳ ἔσαν μετὰ πᾶσιν ἄριστοι.	- uu- uu- u u- uu -u u--	dactylic hexameter	masculine penthemimeral, hepthemimeral, trithemimeral
καὶ τοὺς μέν ῥ’εἴασε καθ’ ἕρκεα καλὰ νέμεσθαι,	- - - --u u -uu -u u--	dactylic hexameter	feminine penthemimeral, trithemimeral
αὐτὸς δ’αὖτ’ Ὀδυσῆα προσηύδα μειλιχίοισι·	-- - uu-u u-- -uu--	dactylic hexameter	feminine penthemimeral, trithemimeral
ξεῖν’, ἦ ἄρ τί σε μᾶλλον Ἀχαιοὶ εἰσορόωσιν,	- - - u u -u u-- -uu--	dactylic hexameter	feminine penthemimeral, trithemimeral
ἦέ σ’ἀτιμάζουσι κατὰ μέγαρ’, ὡς τὸ πάρος περ;	-u u---u u- uu - u u- -	dactylic hexameter	feminine penthemimeral, hepthemimeral
τὸν δ’ἀπαμειβόμενος προσέφη πολύμητις Ὀδυσσεύς·	- uu-uu- uu- uu-u u--	dactylic hexameter	masculine penthemimeral, hepthemimeral
αἲ γὰρ δή, Εὔμαιε, θεοὶ τισαίατο λώβην,	- - - --u u- --uu --	dactylic hexameter	feminine penthemimeral, hepthemimeral, trithemimeral
ἣν οἵδ’ ὑβρίζοντες ἀεικέα μηχανόωνται	- - ---u u-uu -uu--	dactylic hexameter	feminine penthemimeral
οἴκῳ ἐν ἀλλοτρίῳ, οὐδ’ αἰδοῦς μοῖραν ἔχουσιν.	-u u -uu- - -- -u u--	dactylic hexameter	masculine penthemimeral
ὣς οἱ μὲν τοιαῦτα πρὸς ἀλλήλους ἀγόρευον,	- - - --u u --- uu--	dactylic hexameter	feminine penthemimeral, trithemimeral
ἀγχίμολον δέ σφ’ἦλθε Μελάνθιος, αἰπόλος αἰγῶν.	-uu- - -u u-uu -uu --	dactylic hexameter	feminine penthemimeral, trithemimeral
αἶγας ἄγων αἳ πᾶσι μετέπρεπον αἰπολίοισι,	-u u- - -u u-uu -uu--	dactylic hexameter	feminine penthemimeral, trithemimeral
δεῖπνον μνηστήρεσσι. δύω δ’ἅμ’ ἕποντο νομῆες.	-- ---u u- u u-u u--	dactylic hexameter	feminine penthemimeral, hepthemimeral
καὶ τὰς μὲν κατέδησεν ὑπ’ αἰθούσῃ ἐριδούπῳ,	- - - uu-u u --- uu--	dactylic hexameter	feminine penthemimeral, trithemimeral
αὐτὸς δ’αὖτ’ Ὀδυσῆα προσηύδα κερτομίοισι·	-- - uu-u u-- -uu--	dactylic hexameter	feminine penthemimeral, trithemimeral
ξεῖν’, ἔτι καὶ νῦν ἐνθάδ’ ἀνιήσεις κατὰ δῶμα	- uu - - -u u--- uu --	dactylic hexameter	feminine penthemimeral, trithemimeral
ἀνέρας αἰτίζων, ἀτὰρ οὐκ ἔξεισθα θύραζε;	-uu --- uu - --u u--	dactylic hexameter	masculine penthemimeral, hepthemimeral
πάντως οὐκέτι νῶϊ διακρινέεσθαι ὀΐω	-- -uu -u u-uu-u u--	dactylic hexameter	feminine penthemimeral
πρὶν χειρῶν γεύσασθαι, ἐπεὶ σύ περ οὐ κατὰ κόσμον	- -- --u u- u u - uu --	dactylic hexameter	feminine penthemimeral, hepthemimeral, trithemimeral
αἰτίζεις· εἰσὶν δὲ καὶ ἄλλοθι δαῖτες Ἀχαιῶν.	--- -- u u -uu -u u--	dactylic hexameter	masculine penthemimeral, trithemimeral
ὣς φάτο, τὸν δ’οὔ τι προσέφη πολύμητις Ὀδυσσεύς,	- uu - - - uu- uu-u u--	dactylic hexameter	masculine penthemimeral, hepthemimeral, trithemimeral
ἀλλ’ ἀκέων κίνησε κάρη, κακὰ βυσσοδομεύων.	- uu- --u u- uu -uu--	dactylic hexameter	feminine penthemimeral, hepthemimeral, trithemimeral
τοῖσι δ’ἐπὶ τρίτος ἦλθε Φιλοίτιος, ὄρχαμος ἀνδρῶν,	-u u- uu -u u-uu -uu --	dactylic hexameter	feminine penthemimeral, trithemimeral
βοῦν στεῖραν μνηστῆρσιν ἄγων καὶ πίονας αἶγας.	- -- --u u- - -uu --	dactylic hexameter	feminine penthemimeral, hepthemimeral, trithemimeral
πορθμῆες δ’ἄρα τούς γε διήγαγον, οἵ τε καὶ ἄλλους	--- uu - u u-uu - u u --	dactylic hexameter	masculine penthemimeral, trithemimeral
ἀνθρώπους πέμπουσιν, ὅτις σφέας εἰσαφίκηται.	--- --u u- uu -uu--	dactylic hexameter	feminine penthemimeral, hepthemimeral, trithemimeral
καὶ τὰ μὲν εὖ κατέδησεν ὑπ’ αἰθούσῃ ἐριδούπῳ,	- u u - uu-u u --- uu--	dactylic hexameter	feminine penthemimeral, trithemimeral
αὐτὸς δ’αὖτ’ ἐρέεινε συβώτην ἄγχι παραστάς·	-- - uu-u u-- -u u--	dactylic hexameter	feminine penthemimeral, trithemimeral
τίς δὴ ὅδε ξεῖνος νέον εἰλήλουθε, συβῶτα,	- u u- -- uu ---u u--	dactylic hexameter	masculine penthemimeral, trithemimeral
ἡμέτερον πρὸς δῶμα; τέων δ’ἐξ εὔχεται εἶναι	-uu- - -u u- - -uu --	dactylic hexameter	feminine penthemimeral, hepthemimeral, trithemimeral
ἀνδρῶν; ποῦ δέ νύ οἱ γενεὴ καὶ πατρὶς ἄρουρα;	-- - u u - uu- - -u u--	dactylic hexameter	masculine penthemimeral, hepthemimeral, trithemimeral
δύσμορος, ἦ τε ἔοικε δέμας βασιλῆϊ ἄνακτι·	-uu - u u-u u- uu-u u--	dactylic hexameter	feminine penthemimeral, hepthemimeral, trithemimeral
ἀλλὰ θεοὶ δυόωσι πολυπλάγκτους ἀνθρώπους,	-u u- uu-u u--- ---	dactylic hexameter	feminine penthemimeral, trithemimeral
ὁππότε καὶ βασιλεῦσιν ἐπικλώσωνται ὀϊζύν.	-uu - uu-u u---u u--	dactylic hexameter	feminine penthemimeral, trithemimeral
ἦ καὶ δεξιτερῇ δειδίσκετο χειρὶ παραστάς,	- - -uu- --uu -u u--	dactylic hexameter	masculine penthemimeral
καί μιν φωνήσας ἔπεα πτερόεντα προσηύδα·	- - --- uu- uu-u u--	dactylic hexameter	masculine penthemimeral, hepthemimeral
χαῖρε, πάτερ ὧ ξεῖνε· γένοιτό τοι ἔς περ ὀπίσσω	-u u- - -u u-u u - u u--	dactylic hexameter	feminine penthemimeral, trithemimeral
ὄλβος· ἀτὰρ μὲν νῦν γε κακοῖς ἔχεαι πολέεσσι.	-u u- - - u u- uu- uu--	dactylic hexameter	masculine penthemimeral, hepthemimeral, trithemimeral
Ζεῦ πάτερ, οὔ τις σεῖο θεῶν ὀλοώτερος ἄλλος·	- uu - - -u u- uu-uu --	dactylic hexameter	feminine penthemimeral, hepthemimeral, trithemimeral
οὐκ ἐλεαίρεις ἄνδρας, ἐπὴν δὴ γείνεαι αὐτός,	- uu-- -u u- - -uu --	dactylic hexameter	feminine penthemimeral, hepthemimeral
μισγέμεναι κακότητι καὶ ἄλγεσι λευγαλέοισιν.	-uu- uu-u u -uu -uu--	dactylic hexameter	feminine penthemimeral, trithemimeral
ἴδιον, ὡς ἐνόησα, δεδάκρυνται δέ μοι ὄσσε	-uu - uu-u u--- u u --	dactylic hexameter	feminine penthemimeral, trithemimeral
μνησαμένῳ Ὀδυσῆος, ἐπεὶ καὶ κεῖνον ὀΐω	-uu- uu-u u- - -u u--	dactylic hexameter	feminine penthemimeral, hepthemimeral, trithemimeral
τοιάδε λαίφε’ ἔχοντα κατ’ ἀνθρώπους ἀλάλησθαι,	-uu -u u-u u --- uu--	dactylic hexameter	feminine penthemimeral
εἴ που ἔτι ζώει καὶ ὁρᾷ φάος ἠελίοιο.	- u u- -- u u- uu -uu--	dactylic hexameter	masculine penthemimeral, hepthemimeral, trithemimeral
εἰ δ’ἤδη τέθνηκε καὶ εἰν Ἀΐδαο δόμοισιν,	- -- --u u - uu-u u--	dactylic hexameter	feminine penthemimeral, hepthemimeral, trithemimeral
ὤ μοι ἔπειτ’ Ὀδυσῆος ἀμύμονος, ὅς μ’ἐπὶ βουσὶν	- u u- uu-u u-uu - uu --	dactylic hexameter	feminine penthemimeral, trithemimeral
εἷσ’ ἔτι τυτθὸν ἐόντα Κεφαλλήνων ἐνὶ δήμῳ.	- uu -u u-u u--- uu --	dactylic hexameter	feminine penthemimeral
νῦν δ’αἱ μὲν γίνονται ἀθέσφατοι, οὐδέ κεν ἄλλως	- - - --u u-uu -u u --	dactylic hexameter	feminine penthemimeral, trithemimeral
ἀνδρί γ’ὑποσταχύοιτο βοῶν γένος εὐρυμετώπων·	-u u-uu-u u- uu -uu--	dactylic hexameter	feminine penthemimeral, hepthemimeral
τὰς δ’ἄλλοι με κέλονται ἀγινέμεναί σφισιν αὐτοῖς	- -- u u-u u-uu- uu --	dactylic hexameter	feminine penthemimeral, trithemimeral
ἔδμεναι· οὐδέ τι παιδὸς ἐνὶ μεγάροις ἀλέγουσιν,	-uu -u u -u u- uu- uu--	dactylic hexameter	feminine penthemimeral, hepthemimeral
οὐδ’ ὄπιδα τρομέουσι θεῶν· μεμάασι γὰρ ἤδη	- uu- uu-u u- uu-u u --	dactylic hexameter	feminine penthemimeral, hepthemimeral, trithemimeral
κτήματα δάσσασθαι δὴν οἰχομένοιο ἄνακτος.	-uu --- - -uu-u u--	dactylic hexameter	masculine penthemimeral
αὐτὰρ ἐμοὶ τόδε θυμὸς ἐνὶ στήθεσσι φίλοισι	-u u- uu -u u- --u u--	dactylic hexameter	feminine penthemimeral, hepthemimeral, trithemimeral
πόλλ’ ἐπιδινεῖται· μάλα μὲν κακὸν υἷος ἐόντος	- uu--- uu - uu -u u--	dactylic hexameter	masculine penthemimeral, hepthemimeral
ἄλλων δῆμον ἱκέσθαι ἰόντ’ αὐτῇσι βόεσσιν,	-- -u u-u u- --u u--	dactylic hexameter	feminine penthemimeral, hepthemimeral
ἄνδρας ἐς ἀλλοδαπούς· τὸ δὲ ῥίγιον, αὖθι μένοντα	-u u -uu- u u -uu -u u--	dactylic hexameter	masculine penthemimeral
βουσὶν ἐπ’ ἀλλοτρίῃσι καθήμενον ἄλγεα πάσχειν.	-u u -uu-u u-uu -uu --	dactylic hexameter	feminine penthemimeral
καί κεν δὴ πάλαι ἄλλον ὑπερμενέων βασιλήων	- - - uu -u u-uu- uu--	dactylic hexameter	feminine penthemimeral, trithemimeral
ἐξικόμην φεύγων, ἐπεὶ οὐκέτ’ ἀνεκτὰ πέλονται·	-uu- -- uu -u u-u u--	dactylic hexameter	masculine penthemimeral, trithemimeral
ἀλλ’ ἔτι τὸν δύστηνον ὀΐομαι, εἴ ποθεν ἐλθὼν	- uu - --u u-uu - uu --	dactylic hexameter	feminine penthemimeral, trithemimeral
ἀνδρῶν μνηστήρων σκέδασιν κατὰ δώματα θείη.	-- --- uu- uu -uu --	dactylic hexameter	masculine penthemimeral, hepthemimeral
τὸν δ’ἀπαμειβόμενος προσέφη πολύμητις Ὀδυσσεύς·	- uu-uu- uu- uu-u u--	dactylic hexameter	masculine penthemimeral, hepthemimeral
βουκόλ’, ἐπ εὶ οὔτε κακῷ οὔτ’ ἄφρονι φωτὶ ἔοικας,	-u u -u u- - -uu -u u--	dactylic hexameter	masculine penthemimeral
γινώσκω δὲ καὶ αὐτὸς ὅ τοι πινυτὴ φρένας ἵκει,	--- u u -u u - uu- uu --	dactylic hexameter	feminine penthemimeral, hepthemimeral, trithemimeral
τοὔνεκά τοι ἐρέω καὶ ἐπὶ μέγαν ὅρκον ὀμοῦμαι·	-uu - uu- u u- uu -u u--	dactylic hexameter	masculine penthemimeral, hepthemimeral, trithemimeral
ἴστω νῦν Ζεὺς πρῶτα θεῶν ξενίη τε τράπεζα	-- - - -u u- uu- u u--	dactylic hexameter	feminine penthemimeral, hepthemimeral, trithemimeral
ἱστίη τ’Ὀδυσῆος ἀμύμονος, ἣν ἀφικάνω,	--- uu-u u-uu - uu--	dactylic hexameter	feminine penthemimeral, trithemimeral
ἦ σέθεν ἐνθάδ’ ἐόντος ἐλεύσεται οἴκαδ’ Ὀδυσσεύς·	- uu -u u-u u-uu -u u--	dactylic hexameter	feminine penthemimeral
σοῖσιν δ’ὀφθαλμοῖσιν ἐπόψεαι, αἴ κ’ἐθέλῃσθα,	-- ---u u-uu - uu--	dactylic hexameter	feminine penthemimeral
κτεινομένους μνηστῆρας, οἳ ἐνθάδε κοιρανέουσι.	-uu- --u u -uu -uu--	dactylic hexameter	feminine penthemimeral, trithemimeral
τὸν δ’αὖτε προσέειπε βοῶν ἐπιβουκόλος ἀνήρ·	- -- uu-u u- uu-uu --	dactylic hexameter	feminine penthemimeral, hepthemimeral, trithemimeral
αἲ γὰρ τοῦτο, ξεῖνε, ἔπος τελέσειε Κρονίων·	- - -- -u u- uu-u u--	dactylic hexameter	feminine penthemimeral, hepthemimeral
γνοίης χ’οἵη ἐμὴ δύναμις καὶ χεῖρες ἕπονται.	-- -u u- uu- - -u u--	dactylic hexameter	masculine penthemimeral, hepthemimeral
ὣς δ’αὔτως Εὔμαιος ἐπεύξατο πᾶσι θεοῖσι	- -- --u u-uu -u u--	dactylic hexameter	feminine penthemimeral, trithemimeral
νοστῆσαι Ὀδυσῆα πολύφρονα ὅνδε δόμονδε.	--- uu-u u-uu -u u--	dactylic hexameter	feminine penthemimeral, trithemimeral
ὣς οἱ μὲν τοιαῦτα πρὸς ἀλλήλους ἀγόρευον,	- - - --u u --- uu--	dactylic hexameter	feminine penthemimeral, trithemimeral
μνηστῆρες δ’ἄρα Τηλεμάχῳ θάνατόν τε μόρον τε	--- uu -uu- uu- u u- -	dactylic hexameter	hepthemimeral, trithemimeral
ἤρτυον· αὐτὰρ ὁ τοῖσιν ἀριστερὸς ἤλυθεν ὄρνις,	-uu -u u -u u-uu -uu --	dactylic hexameter	feminine penthemimeral
αἰετὸς ὑψιπέτης, ἔχε δὲ τρήρωνα πέλειαν.	-uu -uu- uu - --u u--	dactylic hexameter	masculine penthemimeral, hepthemimeral
τοῖσιν δ’Ἀμφίνομος ἀγορήσατο καὶ μετέειπεν·	-- -uu- uu-uu - uu--	dactylic hexameter	masculine penthemimeral
ὧ φίλοι, οὐχ ἡμῖν συνθεύσεται ἥδε γε βουλή,	- uu - -- --uu -u u --	dactylic hexameter	masculine penthemimeral, trithemimeral
Τηλεμάχοιο φόνος· ἀλλὰ μνησώμεθα δαιτός.	-uu-u u- -- --uu --	dactylic hexameter	masculine penthemimeral, hepthemimeral
ὣς ἔφατ’ Ἀμφίνομος, τοῖσιν δ’ἐπιήνδανε μῦθος.	- uu -uu- -- uu-uu --	dactylic hexameter	masculine penthemimeral, hepthemimeral
ἐλθόντες δ’ἐς δώματ’ Ὀδυσσῆος θείοιο	--- - -u u--- ---	dactylic hexameter	feminine penthemimeral, trithemimeral
χλαίνας μὲν κατέθεντο κατὰ κλισμούς τε θρόνους τε,	-- - uu-u u- -- u u- -	dactylic hexameter	feminine penthemimeral, hepthemimeral, trithemimeral
οἱ δ’ἱέρευον ὄϊς μεγάλους καὶ πίονας αἶγας,	- uu-u u- uu- - -uu --	dactylic hexameter	masculine penthemimeral, hepthemimeral
ἵρευον δὲ σύας σιάλους καὶ βοῦν ἀγελαίην·	--- u u- uu- - - uu--	dactylic hexameter	masculine penthemimeral, hepthemimeral, trithemimeral
σπλάγχνα δ’ἄρ’ ὀπτήσαντες ἐνώμων, ἐν δέ τε οἶνον	-u u ---u u-- - u u --	dactylic hexameter	feminine penthemimeral
κρητῆρσι κερόωντο· κύπελλα δὲ νεῖμε συβώτης.	--- uu-u u-u u -u u--	dactylic hexameter	feminine penthemimeral, trithemimeral
σῖτον δέ σφ’ἐπένειμε Φιλοίτιος, ὄρχαμος ἀνδρῶν,	-- - uu-u u-uu -uu --	dactylic hexameter	feminine penthemimeral, trithemimeral
καλοῖς ἐν κανέοισιν, ἐῳνοχόει δὲ Μελανθεύς.	-- - uu-u u-uu- u u--	dactylic hexameter	feminine penthemimeral, trithemimeral
οἱ δ’ἐπ’ ὀνείαθ’ ἑτοῖμα προκείμενα χεῖρας ἴαλλον.	- u u-u u-u u-uu -u u--	dactylic hexameter	feminine penthemimeral
Τηλέμαχος δ’Ὀδυσῆα καθίδρυε, κέρδεα νωμῶν,	-uu- uu-u u-uu -uu --	dactylic hexameter	feminine penthemimeral, trithemimeral
ἐντὸς ἐϋσταθέος μεγάρου, παρὰ λάϊνον οὐδόν,	-u u-uu- uu- uu -uu --	dactylic hexameter	masculine penthemimeral, hepthemimeral
δίφρον ἀεικέλιον καταθεὶς ὀλίγην τε τράπεζαν·	-u u-uu- uu- uu- u u--	dactylic hexameter	masculine penthemimeral, hepthemimeral
πὰρ δ’ἐτίθει σπλάγχνων μοίρας, ἐν δ’οἶνον ἔχευεν	- uu- -- -- - -u u--	dactylic hexameter	masculine penthemimeral, hepthemimeral, trithemimeral
ἐν δέπαϊ χρυσέῳ, καί μιν πρὸς μῦθον ἔειπεν·	- uu- uu- - - - -u u--	dactylic hexameter	masculine penthemimeral, hepthemimeral, trithemimeral
ἐνταυθοῖ νῦν ἧσο μετ’ ἀνδράσιν οἰνοποτάζων·	--- - -u u -uu -uu--	dactylic hexameter	feminine penthemimeral, trithemimeral
κερτομίας δέ τοι αὐτὸς ἐγὼ καὶ χεῖρας ἀφέξω	-uu- u u -u u- - -u u--	dactylic hexameter	feminine penthemimeral, hepthemimeral, trithemimeral
πάντων μνηστήρων, ἐπεὶ οὔ τοι δήμιός ἐστιν	-- --- uu - - -uu --	dactylic hexameter	masculine penthemimeral, hepthemimeral
οἶκος ὅδ’, ἀλλ’ Ὀδυσῆος, ἐμοὶ δ’ἐκτήσατο κεῖνος.	-u u - uu-u u- --uu --	dactylic hexameter	feminine penthemimeral, hepthemimeral, trithemimeral
ὑμεῖς δέ, μνηστῆρες, ἐπίσχετε θυμὸν ἐνιπῆς	-- - --u u-uu -u u--	dactylic hexameter	feminine penthemimeral, trithemimeral
καὶ χειρῶν, ἵνα μή τις ἔρις καὶ νεῖκος ὄρηται.	- -- uu - u u- - -u u--	dactylic hexameter	masculine penthemimeral, hepthemimeral, trithemimeral
ὣς ἔφαθ’, οἱ δ’ἄρα πάντες ὀδὰξ ἐν χείλεσι φύντες	- uu - uu -u u- - -uu --	dactylic hexameter	feminine penthemimeral, hepthemimeral, trithemimeral
Τηλέμαχον θαύμαζον, ὃ θαρσαλέως ἀγόρευε.	-uu- --u u -uu- uu--	dactylic hexameter	feminine penthemimeral, trithemimeral
τοῖσιν δ’Ἀντίνοος μετέφη, Εὐπείθεος υἱός·	-- -uu- uu- --uu --	dactylic hexameter	masculine penthemimeral, hepthemimeral
καὶ χαλεπόν περ ἐόντα δεχώμεθα μῦθον, Ἀχαιοί,	- uu- u u-u u-uu -u u--	dactylic hexameter	feminine penthemimeral, trithemimeral
Τηλεμάχου· μάλα δ’ἧμιν ἀπειλήσας ἀγορεύει.	-uu- uu -u u--- uu--	dactylic hexameter	feminine penthemimeral, trithemimeral
οὐ γὰρ Ζεὺς εἴασε Κρονίων· τῶ κέ μιν ἤδη	- - - --u u-- - u u --	dactylic hexameter	feminine penthemimeral, trithemimeral
παύσαμεν ἐν μεγάροισι, λιγύν περ ἐόντ’ ἀγορητήν.	-uu - uu-u u- u u- uu--	dactylic hexameter	feminine penthemimeral, hepthemimeral, trithemimeral
ὣς ἔφατ’ Ἀντίνοος· ὁ δ’ἄρ’ οὐκ ἐμπάζετο μύθων.	- uu -uu- u u - --uu --	dactylic hexameter	masculine penthemimeral, hepthemimeral
κήρυκες δ’ἀνὰ ἄστυ θεῶν ἱερὴν ἑκατόμβην	--- uu -u u- uu- uu--	dactylic hexameter	feminine penthemimeral, hepthemimeral, trithemimeral
ἦγον· τοὶ δ’ἀγέροντο κάρη κομόωντες Ἀχαιοὶ	-- - uu-u u- uu-u u--	dactylic hexameter	feminine penthemimeral, hepthemimeral, trithemimeral
ἄλσος ὕπο σκιερὸν ἑκατηβόλου Ἀπόλλωνος.	-u u- uu- uu-uu ----	dactylic hexameter	masculine penthemimeral, trithemimeral
οἱ δ’ἐπεὶ ὤπτησαν κρέ’ ὑπέρτερα καὶ ἐρύσαντο,	- uu --- u u-uu - uu--	dactylic hexameter	masculine penthemimeral
μοίρας δασσάμενοι δαίνυντ’ ἐρικυδέα δαῖτα·	-- -uu- -- uu-uu --	dactylic hexameter	masculine penthemimeral, hepthemimeral
πὰρ δ’ἄρ’ Ὀδυσσῆϊ μοῖραν θέσαν οἳ πονέοντο	- u u--- -- uu - uu--	dactylic hexameter	masculine penthemimeral, hepthemimeral
ἴσην, ὡς αὐτοί περ ἐλάγχανον· ὣς γὰρ ἀνώγει	-- - -- u u-uu - u u--	dactylic hexameter	masculine penthemimeral, trithemimeral
Τηλέμαχος, φίλος υἱὸς Ὀδυσσῆος θείοιο.	-uu- uu -u u--- ---	dactylic hexameter	feminine penthemimeral, trithemimeral
μνηστῆρας δ’οὐ πάμπαν ἀγήνορας εἴα Ἀθήνη	--- - -u u-uu -u u--	dactylic hexameter	feminine penthemimeral, trithemimeral
λώβης ἴσχεσθαι θυμαλγέος, ὄφρ’ ἔτι μᾶλλον	-- --- --uu - uu --	dactylic hexameter	masculine penthemimeral
δύη ἄχος κραδίην Λαερτιάδην Ὀδυσῆα.	-u u- uu- --uu- uu--	dactylic hexameter	masculine penthemimeral, trithemimeral
ἦν δέ τις ἐν μνηστῆρσιν ἀνὴρ ἀθεμίστια εἰδώς,	- u u - --u u- uu-uu --	dactylic hexameter	feminine penthemimeral, hepthemimeral, trithemimeral
Κτήσιππος δ’ὄνομ’ ἔσκε, Σάμῃ δ’ἐνὶ οἰκία ναῖεν·	--- uu -u u- uu -uu --	dactylic hexameter	feminine penthemimeral, hepthemimeral, trithemimeral
ὃς δή τοι κτεάτεσσι πεποιθὼς πατρὸς ἑοῖο	- - - uu-u u-- -u u--	dactylic hexameter	feminine penthemimeral, trithemimeral
μνάσκετ’ Ὀδυσσῆος δὴν οἰχομένοιο δάμαρτα.	-u u--- - -uu-u u--	dactylic hexameter	masculine penthemimeral
ὅς ῥα τότε μνηστῆρσιν ὑπερφιάλοισι μετηύδα·	- u u- --u u-uu-u u--	dactylic hexameter	feminine penthemimeral, trithemimeral
κέκλυτέ μευ, μνηστῆρες ἀγήνορες, ὄφρα τι εἴπω·	-uu - --u u-uu -u u --	dactylic hexameter	feminine penthemimeral, trithemimeral
μοῖραν μὲν δὴ ξεῖνος ἔχει πάλαι, ὡς ἐπέοικεν,	-- - - -u u- uu - uu--	dactylic hexameter	feminine penthemimeral, hepthemimeral, trithemimeral
ἴσην· οὐ γὰρ καλὸν ἀτέμβειν οὐδὲ δίκαιον	-- - - -u u-- -u u--	dactylic hexameter	feminine penthemimeral, trithemimeral
ξείνους Τηλεμάχου, ὅς κεν τάδε δώμαθ’ ἵκηται.	-- -uu- - - uu -u u--	dactylic hexameter	masculine penthemimeral, hepthemimeral
ἀλλ’ ἄγε οἱ καὶ ἐγὼ δῶ ξείνιον, ὄφρα καὶ αὐτὸς	- uu - u u- - -uu -u u --	dactylic hexameter	masculine penthemimeral, trithemimeral
ἠὲ λοετροχόῳ δώῃ γέρας ἠέ τῳ ἄλλῳ	-u u-uu- -- uu -u u --	dactylic hexameter	masculine penthemimeral, hepthemimeral
δμώων, οἳ κατὰ δώματ’ Ὀδυσσῆος θείοιο.	-- - uu -u u--- ---	dactylic hexameter	feminine penthemimeral, trithemimeral
ὣς εἰπὼν ἔρριψε βοὸς πόδα χειρὶ παχείῃ.	- -- --u u- uu -u u--	dactylic hexameter	feminine penthemimeral, hepthemimeral, trithemimeral
κείμενον ἐκ κανέοιο λαβών· ὁ δ’ἀλεύατ’ Ὀδυσσεὺς	-uu - uu-u u- u u-u u--	dactylic hexameter	feminine penthemimeral, hepthemimeral, trithemimeral
ἦκα παρακλίνας κεφαλήν, μείδησε δὲ θυμῷ	-u u--- uu- --u u --	dactylic hexameter	masculine penthemimeral, hepthemimeral
σαρδάνιον μάλα τοῖον· ὁ δ’εὔδμητον βάλε τοῖχον.	-uu- uu -u u --- uu --	dactylic hexameter	feminine penthemimeral, trithemimeral
Κτήσιππον δ’ἄρα Τηλέμαχος ἠνίπαπε μύθῳ·	--- uu -uu- --uu --	dactylic hexameter	hepthemimeral, trithemimeral
Κτήσιππ’, ἦ μάλα τοι τόδε κέρδιον ἔπλετο θυμῷ·	-- - uu - uu -uu -uu --	dactylic hexameter	masculine penthemimeral, trithemimeral
οὐκ ἔβαλες τὸν ξεῖνον· ἀλεύατο γὰρ βέλος αὐτός.	- uu- - -u u-uu - uu --	dactylic hexameter	feminine penthemimeral, trithemimeral
ἦ γάρ κέν σε μέσον βάλον ἔγχεϊ ὀξυόεντι,	- - - u u- uu -uu -uu--	dactylic hexameter	masculine penthemimeral, trithemimeral
καί κέ τοι ἀντὶ γάμοιο πατὴρ τάφον ἀμφεπονεῖτο	- u u -u u-u u- uu -uu--	dactylic hexameter	feminine penthemimeral, hepthemimeral
ἐνθάδε. τῶ μή τίς μοι ἀεικείας ἐνὶ οἴκῳ	-uu - - - u u--- uu --	dactylic hexameter	masculine penthemimeral, trithemimeral
φαινέτω· ἤδη γὰρ νοέω καὶ οἶδα ἕκαστα,	-uu -- - uu- - -u u--	dactylic hexameter	masculine penthemimeral, hepthemimeral
ἐσθλά τε καὶ τὰ χέρεια· πάρος δ’ἔτι νήπιος ἦα.	-u u - u u-u u- uu -uu --	dactylic hexameter	feminine penthemimeral, hepthemimeral, trithemimeral
ἀλλ’ ἔμπης τάδε μὲν καὶ τέτλαμεν εἰσορόωντες,	- -- uu - - -uu -uu--	dactylic hexameter	masculine penthemimeral, trithemimeral
μήλων σφαζομένων οἴνοιό τε πινομένοιο	-- -uu- --u u -uu--	dactylic hexameter	masculine penthemimeral
καὶ σίτου· χαλεπὸν γὰρ ἐρυκακέειν ἕνα πολλούς.	- -- uu- u u-uu- uu --	dactylic hexameter	masculine penthemimeral, trithemimeral
ἀλλ’ ἄγε μηκέτι μοι κακὰ ῥέζετε δυσμενέοντες·	- uu -uu - uu -uu -uu--	dactylic hexameter	masculine penthemimeral
εἰ δ’ἤδη μ’αὐτὸν κτεῖναι μενεαίνετε χαλκῷ,	- -- -- -- uu-uu --	dactylic hexameter	masculine penthemimeral, hepthemimeral, trithemimeral
καί κε τὸ βουλοίμην, καί κεν πολὺ κέρδιον εἴη	- u u --- - - uu -uu --	dactylic hexameter	masculine penthemimeral, hepthemimeral
τεθνάμεν ἢ τάδε γ’αἰὲν ἀεικέα ἔργ’ ὁράασθαι,	-uu - uu -u u-uu - uu--	dactylic hexameter	feminine penthemimeral, trithemimeral
ξείνους τε στυφελιζομένους δμῳάς τε γυναῖκας	-- - uu-uu- -- u u--	dactylic hexameter	hepthemimeral, trithemimeral
ῥυστάζοντας ἀεικελίως κατὰ δώματα καλά.	---u u-uu- uu -uu --	dactylic hexameter	hepthemimeral
ὣς ἔφαθ’, οἱ δ’ἄρα πάντες ἀκὴν ἐγένοντο σιωπῇ·	- uu - uu -u u- uu-u u--	dactylic hexameter	feminine penthemimeral, hepthemimeral, trithemimeral
ὀψὲ δὲ δὴ μετέειπε Δαμαστορίδης Ἀγέλαος·	-u u - uu-u u-uu- uu--	dactylic hexameter	feminine penthemimeral, trithemimeral
ὧ φίλοι, οὐκ ἂν δή τις ἐπὶ ῥηθέντι δικαίῳ	- uu - - - u u- --u u--	dactylic hexameter	masculine penthemimeral, hepthemimeral, trithemimeral
ἀντιβίοις ἐπέεσσι καθαπτόμενος χαλεπαίνοι·	-uu- uu-u u-uu- uu--	dactylic hexameter	feminine penthemimeral, trithemimeral
μήτε τι τὸν ξεῖνον στυφελίζετε μήτε τιν’ ἄλλον	-u u - -- uu-uu -u u --	dactylic hexameter	masculine penthemimeral, trithemimeral
δμώων, οἳ κατὰ δώματ’ Ὀδυσσῆος θείοιο.	-- - uu -u u--- ---	dactylic hexameter	feminine penthemimeral, trithemimeral
Τηλεμάχῳ δέ κε μῦθον ἐγὼ καὶ μητέρι φαίην	-uu- u u -u u- - -uu --	dactylic hexameter	feminine penthemimeral, hepthemimeral, trithemimeral
ἤπιον, εἴ σφωϊν κραδίῃ ἅδοι ἀμφοτέροιϊν.	-uu - -- uu- uu -uu--	dactylic hexameter	masculine penthemimeral, hepthemimeral, trithemimeral
ὄφρα μὲν ὑμῖν θυμὸς ἐνὶ στήθεσσιν ἐώλπει	-u u -- -u u- --u u--	dactylic hexameter	feminine penthemimeral, hepthemimeral
νοστῆσαι Ὀδυσῆα πολύφρονα ὅνδε δόμονδε,	--- uu-u u-uu -u u--	dactylic hexameter	feminine penthemimeral, trithemimeral
τόφρ’ οὔ τις νέμεσις μενέμεν τ’ἦν ἰσχέμεναί τε	- - - uu- uu- - -uu- -	dactylic hexameter	masculine penthemimeral, hepthemimeral, trithemimeral
μνηστῆρας κατὰ δώματ’, ἐπεὶ τόδε κέρδιον ἦεν,	--- uu -u u- uu -uu --	dactylic hexameter	feminine penthemimeral, hepthemimeral, trithemimeral
εἰ νόστησ’ Ὀδυσεὺς καὶ ὑπότροπος ἵκετο δῶμα·	- -- uu- u u-uu -uu --	dactylic hexameter	masculine penthemimeral, trithemimeral
νῦν δ’ἤδη τόδε δῆλον, ὅτ’ οὐκέτι νόστιμός ἐστιν.	- -- uu -u u -uu -uu --	dactylic hexameter	feminine penthemimeral, trithemimeral
ἀλλ’ ἄγε, σῇ τάδε μητρὶ παρεζόμενος κατάλεξον,	- uu - uu -u u-uu- uu--	dactylic hexameter	feminine penthemimeral, trithemimeral
γήμασθ’ ὅς τις ἄριστος ἀνὴρ καὶ πλεῖστα πόρῃσιν,	-- - u u-u u- - -u u--	dactylic hexameter	feminine penthemimeral, hepthemimeral, trithemimeral
ὄφρα σὺ μὲν χαίρων πατρώϊα πάντα νέμηαι,	-u u - -- --uu -u u--	dactylic hexameter	masculine penthemimeral, trithemimeral
ἔσθων καὶ πίνων, ἡ δ’ἄλλου δῶμα κομίζῃ.	-- - -- - -- -u u--	dactylic hexameter	masculine penthemimeral, trithemimeral
τὸν δ’αὖ Τηλέμαχος πεπνυμένος ἀντίον ηὔδα·	- - -uu- --uu -uu --	dactylic hexameter	masculine penthemimeral
οὐ μὰ Ζῆν’, Ἀγέλαε, καὶ ἄλγεα πατρὸς ἐμοῖο,	- - - uu-u u -uu -u u--	dactylic hexameter	feminine penthemimeral, trithemimeral
ὅς που τῆλ’ Ἰθάκης ἢ ἔφθιται ἢ ἀλάληται,	- - - uu- - -uu - uu--	dactylic hexameter	masculine penthemimeral, trithemimeral
οὔ τι διατρίβω μητρὸς γάμον, ἀλλὰ κελεύω	- u u--- -- uu -u u--	dactylic hexameter	masculine penthemimeral, hepthemimeral
γήμασθ’ ᾧ κ’ἐθέλῃ, ποτὶ δ’ἄσπετα δῶρα δίδωμι.	-- - uu- uu -uu -u u--	dactylic hexameter	masculine penthemimeral, trithemimeral
αἰδέομαι δ’ἀέκουσαν ἀπὸ μεγάροιο δίεσθαι	-uu- uu-u u- uu-u u--	dactylic hexameter	feminine penthemimeral, hepthemimeral, trithemimeral
μύθῳ ἀναγκαίῳ· μὴ τοῦτο θεὸς τελέσειεν.	-u u--- - -u u- uu--	dactylic hexameter	masculine penthemimeral
ὣς φάτο Τηλέμαχος· μνηστῆρσι δὲ Παλλὰς Ἀθήνη	- uu -uu- --u u -u u--	dactylic hexameter	masculine penthemimeral
ἄσβεστον γέλω ὧρσε, παρέπλαγξεν δὲ νόημα.	--- uu -u u--- u u--	dactylic hexameter	feminine penthemimeral, trithemimeral
οἱ δ’ἤδη γναθμοῖσι γελώων ἀλλοτρίοισιν,	- -- --u u-- -uu--	dactylic hexameter	feminine penthemimeral, trithemimeral
αἱμοφόρυκτα δὲ δὴ κρέα ἤσθιον· ὄσσε δ’ἄρα σφέων	-uu-u u - uu -uu -u u- -	dactylic hexameter	masculine penthemimeral
δακρυόφιν πίμπλαντο, γόον δ’ὠΐετο θυμός.	-uu- --u u- --uu --	dactylic hexameter	feminine penthemimeral, hepthemimeral, trithemimeral
τοῖσι δὲ καὶ μετέειπε Θεοκλύμενος θεοειδής·	-u u - uu-u u-uu- uu--	dactylic hexameter	feminine penthemimeral, trithemimeral
ἆ δειλοί, τί κακὸν τόδε πάσχετε; νυκτὶ μὲν ὑμέων	- -- u u- uu -uu -u u --	dactylic hexameter	masculine penthemimeral, trithemimeral
εἰλύαται κεφαλαί τε πρόσωπά τε νέρθε τε γοῦνα.	-uu- uu- u u-u u -u u --	dactylic hexameter	masculine penthemimeral, trithemimeral
οἰμωγὴ δὲ δέδηε, δεδάκρυνται δὲ παρειαί,	--- u u-u u--- u u--	dactylic hexameter	feminine penthemimeral, trithemimeral
αἵματι δ’ἐρράδαται τοῖχοι καλαί τε μεσόδμαι·	-uu -uu- -- -- u u--	dactylic hexameter	masculine penthemimeral, hepthemimeral
εἰδώλων δὲ πλέον πρόθυρον, πλείη δὲ καὶ αὐλή,	--- u u- uu- -- u u --	dactylic hexameter	masculine penthemimeral, hepthemimeral, trithemimeral
ἱεμένων Ἔρεβόσδε ὑπὸ ζόφον· ἠέλιος δὲ	-uu- uu-u u- uu -uu- -	dactylic hexameter	feminine penthemimeral, hepthemimeral, trithemimeral
οὐρανοῦ ἐξαπόλωλε, κακὴ δ’ἐπιδέδρομεν ἀχλύς.	-uu -uu-u u- uu-uu --	dactylic hexameter	feminine penthemimeral, hepthemimeral
ὣς ἔφαθ’, οἱ δ’ἄρα πάντες ἐπ’ αὐτῷ ἡδὺ γέλασσαν.	- uu - uu -u u -- -u u--	dactylic hexameter	feminine penthemimeral, trithemimeral
τοῖσιν δ’Εὐρύμαχος, Πολύβου πάϊς, ἦρχ’ ἀγορεύειν·	-- -uu- uu- uu - uu--	dactylic hexameter	masculine penthemimeral, hepthemimeral
ἀφραίνει ξεῖνος νέον ἄλλοθεν εἰληλουθώς.	--- -- uu -uu ----	dactylic hexameter	masculine penthemimeral, trithemimeral
ἀλλά μιν αἶψα, νέοι, δόμου ἐκπέμψασθε θύραζε	-u u -u u- uu ---u u--	dactylic hexameter	masculine penthemimeral
εἰς ἀγορὴν ἔρχεσθαι, ἐπεὶ τάδε νυκτὶ ἐΐσκει.	- uu- --u u- uu -u u--	dactylic hexameter	feminine penthemimeral, hepthemimeral, trithemimeral
τὸν δ’αὖτε προσέειπε Θεοκλύμενος θεοειδής·	- -- uu-u u-uu- uu--	dactylic hexameter	feminine penthemimeral, trithemimeral
Εὐρύμαχ’, οὔ τί σ’ἄνωγα ἐμοὶ πομπῆας ὀπάζειν·	-uu - u u-u u- --u u--	dactylic hexameter	feminine penthemimeral, hepthemimeral, trithemimeral
εἰσί μοι ὀφθαλμοί τε καὶ οὔατα καὶ πόδες ἄμφω	-u u --- u u -uu - uu --	dactylic hexameter	masculine penthemimeral
καὶ νόος ἐν στήθεσσι τετυγμένος οὐδὲν ἀεικής.	- uu - --u u-uu -u u--	dactylic hexameter	feminine penthemimeral, trithemimeral
τοῖς ἔξειμι θύραζε, ἐπεὶ νοέω κακὸν ὔμμιν	- --u u-u u- uu- uu --	dactylic hexameter	feminine penthemimeral, hepthemimeral
ἐρχόμενον, τό κεν οὔ τις ὑπεκφύγοι οὐδ’ ἀλέαιτο	-uu- u u - u u-uu - uu--	dactylic hexameter	masculine penthemimeral, trithemimeral
μνηστήρων, οἳ δῶμα κάτ’ ἀντιθέου Ὀδυσῆος	--- - -u u -uu- uu--	dactylic hexameter	feminine penthemimeral, trithemimeral
ἀνέρας ὑβρίζοντες ἀτάσθαλα μηχανάασθε.	-uu ---u u-uu -uu--	dactylic hexameter	feminine penthemimeral
ὣς εἰπὼν ἐξῆλθε δόμων εὖ ναιεταόντων,	- -- --u u- - -uu--	dactylic hexameter	feminine penthemimeral, hepthemimeral, trithemimeral
ἵκετο δ’ἐς Πείραιον, ὅ μιν πρόφρων ὑπέδεκτο.	-uu - --u u - -- uu--	dactylic hexameter	feminine penthemimeral, hepthemimeral, trithemimeral
μνηστῆρες δ’ἄρα πάντες ἐς ἀλλήλους ὁρόωντες	--- uu -u u --- uu--	dactylic hexameter	feminine penthemimeral, trithemimeral
Τηλέμαχον ἐρέθιζον, ἐπὶ ξείνοις γελόωντες·	-uu- uu-u u- -- uu--	dactylic hexameter	feminine penthemimeral, hepthemimeral, trithemimeral
ὦδε δέ τις εἴπεσκε νέων ὑπερηνορεόντων·	-u u - --u u- uu-uu--	dactylic hexameter	feminine penthemimeral, hepthemimeral, trithemimeral
Τηλέμαχ’, οὔ τις σεῖο κακοξεινώτερος ἄλλος·	-uu - - -u u---uu --	dactylic hexameter	feminine penthemimeral, trithemimeral
οἷον μέν τινα τοῦτον ἔχεις ἐπίμαστον ἀλήτην,	-- - uu -u u- uu-u u--	dactylic hexameter	feminine penthemimeral, hepthemimeral, trithemimeral
σίτου καὶ οἴνου κεχρημένον, οὐδέ τι ἔργων	-- - -- --uu -u u --	dactylic hexameter	masculine penthemimeral, trithemimeral
ἔμπαιον οὐδὲ βίης, ἀλλ’ αὔτως ἄχθος ἀρούρης.	-uu -u u- - -- -u u--	dactylic hexameter	masculine penthemimeral
ἄλλος δ’αὖτέ τις οὗτος ἀνέστη μαντεύεσθαι.	-- -u u -u u-- ----	dactylic hexameter	feminine penthemimeral
ἀλλ’ εἴ μοί τι πίθοιο, τό κεν πολὺ κέρδιον εἴη·	- - - u u-u u - uu -uu --	dactylic hexameter	feminine penthemimeral, hepthemimeral, trithemimeral
τοὺς ξείνους ἐν νηῒ πολυκλήϊδι βαλόντες	- -- - -u u---u u--	dactylic hexameter	feminine penthemimeral, trithemimeral
ἐς Σικελοὺς πέμψωμεν, ὅθεν κέ τοι ἄξιον ἄλφοι.	- uu- --u u- u u -uu --	dactylic hexameter	feminine penthemimeral, hepthemimeral, trithemimeral
ὣς ἔφασαν μνηστῆρες· ὁ δ’οὐκ ἐμπάζετο μύθων,	- uu- --u u - --uu --	dactylic hexameter	feminine penthemimeral, hepthemimeral, trithemimeral
ἀλλ’ ἀκέων πατέρα προσεδέρκετο, δέγμενος αἰεί,	- uu- uu- uu-uu -uu --	dactylic hexameter	masculine penthemimeral, trithemimeral
ὁππότε δὴ μνηστῆρσιν ἀναιδέσι χεῖρας ἐφήσει.	-uu - --u u-uu -u u--	dactylic hexameter	feminine penthemimeral, trithemimeral
ἡ δὲ κατ’ ἄντηστιν θεμένη περικαλλέα δίφρον	- u u --- uu- uu-uu --	dactylic hexameter	masculine penthemimeral, hepthemimeral
κούρη Ἰκαρίοιο, περίφρων Πηνελόπεια,	-- -uu-u u-- -uu--	dactylic hexameter	feminine penthemimeral
ἀνδρῶν ἐν μεγάροισιν ἑκάστου μῦθον ἄκουε.	-- - uu-u u-- -u u--	dactylic hexameter	feminine penthemimeral, trithemimeral
δεῖπνον μὲν γάρ τοί γε γελώοντες τετύκοντο	-- - - - u u--- uu--	dactylic hexameter	masculine penthemimeral, trithemimeral
ἡδὺ τε καὶ μενοεικές, ἐπεὶ μάλα πόλλ’ ἱέρευσαν·	-u u - uu-u u- uu - uu--	dactylic hexameter	feminine penthemimeral, hepthemimeral, trithemimeral
δόρπου δ’οὐκ ἄν πως ἀχαρίστερον ἄλλο γένοιτο,	-- - - - uu-uu -u u--	dactylic hexameter	masculine penthemimeral, trithemimeral
οἷον δὴ τάχ’ ἔμελλε θεὰ καὶ καρτερὸς ἀνὴρ	-- - u u-u u- - -uu --	dactylic hexameter	feminine penthemimeral, hepthemimeral, trithemimeral
θησέμεναι· πρότεροι γὰρ ἀεικέα μηχανόωντο.	-uu- uu- u u-uu -uu--	dactylic hexameter	masculine penthemimeral, trithemimeral
