ἦλθε δ’ἐπὶ πτωχὸς πανδήμιος, ὃς κατὰ ἄστυ	-u u- -- --uu - uu --	dactylic hexameter	masculine penthemimeral, trithemimeral
πτωχεύεσκ’ Ἰθάκης, μετὰ δ’ἔπρεπε γαστέρι μάργῃ	--- uu- uu -uu -uu --	dactylic hexameter	masculine penthemimeral, trithemimeral
ἀζηχὲς φαγέμεν καὶ πιέμεν· οὐδέ οἱ ἦν ἲς	--- uu- - -uu -u u - -	dactylic hexameter	masculine penthemimeral, trithemimeral
οὐδὲ βίη, εἶδος δὲ μάλα μέγας ἦν ὁράασθαι.	-u u- -- u u- uu - uu--	dactylic hexameter	masculine penthemimeral, hepthemimeral, trithemimeral
Ἀρναῖος δ’ὄνομ’ ἔσκε· τὸ γὰρ θέτο πότνια μήτηρ	--- uu -u u - uu -uu --	dactylic hexameter	feminine penthemimeral, hepthemimeral, trithemimeral
ἐκ γενετῆς· Ἶρον δὲ νέοι κίκλησκον ἅπαντες,	- uu- -- u u- --u u--	dactylic hexameter	masculine penthemimeral, hepthemimeral, trithemimeral
οὕνεκ’ ἀπαγγέλλεσκε κιών, ὅτε πού τις ἀνώγοι·	-u u---u u- uu - u u--	dactylic hexameter	feminine penthemimeral, hepthemimeral
ὅς ῥ’ἐλθὼν Ὀδυσῆα διώκετο οἷο δόμοιο,	- -- uu-u u-uu -u u--	dactylic hexameter	feminine penthemimeral, trithemimeral
καί μιν νεικείων ἔπεα πτερόεντα προσηύδα·	- - --- uu- uu-u u--	dactylic hexameter	masculine penthemimeral, hepthemimeral
εἶκε, γέρον, προθύρου, μὴ δὴ τάχα καὶ ποδὸς ἕλκῃ.	-u u- uu- - - uu - uu --	dactylic hexameter	masculine penthemimeral, hepthemimeral, trithemimeral
οὐκ ἀΐεις ὅτι δή μοι ἐπιλλίζουσιν ἅπαντες,	- uu- uu - u u---u u--	dactylic hexameter	masculine penthemimeral, trithemimeral
ἑλκέμεναι δὲ κέλονται; ἐγὼ δ’αἰσχύνομαι ἔμπης.	-uu- u u-u u- --uu --	dactylic hexameter	feminine penthemimeral, hepthemimeral, trithemimeral
ἀλλ’ ἄνα, μὴ τάχα νῶϊν ἔρις καὶ χερσὶ γένηται.	- uu - uu -u u- - -u u--	dactylic hexameter	feminine penthemimeral, hepthemimeral, trithemimeral
τὸν δ’ἄρ’ ὑπόδρα ἰδὼν προσέφη πολύμητις Ὀδυσσεύς·	- u u-u u- uu- uu-u u--	dactylic hexameter	masculine penthemimeral, hepthemimeral
δαιμόνι’, οὔτε τί σε ῥέζω κακὸν οὔτ’ ἀγορεύω,	-uu -u u - -- uu - uu--	dactylic hexameter	masculine penthemimeral, hepthemimeral
οὔτε τινὰ φθονέω δόμεναι καὶ πόλλ’ ἀνελόντα.	-u u- uu- uu- - - uu--	dactylic hexameter	masculine penthemimeral, hepthemimeral, trithemimeral
οὐδὸς δ’ἀμφοτέρους ὅδε χείσεται, οὐδέ τί σε χρὴ	-- -uu- uu -uu -u u - -	dactylic hexameter	masculine penthemimeral
ἀλλοτρίων φθονέειν· δοκέεις δέ μοι εἶναι ἀλήτης	-uu- uu- uu- u u -u u--	dactylic hexameter	masculine penthemimeral, hepthemimeral, trithemimeral
ὥς περ ἐγών, ὄλβον δὲ θεοὶ μέλλουσιν ὀπάζειν.	- u u- -- u u- --u u--	dactylic hexameter	masculine penthemimeral, hepthemimeral, trithemimeral
χερσὶ δὲ μή τι λίην προκαλίζεο, μή με χολώσῃς,	-u u - u u- uu-uu - u u--	dactylic hexameter	masculine penthemimeral, trithemimeral
μή σε γέρων περ ἐὼν στῆθος καὶ χείλεα φύρσω	- u u- u u- -- - -uu --	dactylic hexameter	masculine penthemimeral, hepthemimeral, trithemimeral
αἵματος· ἡσυχίη δ’ἂν ἐμοὶ καὶ μᾶλλον ἔτ’ εἴη	-uu -uu- u u- - -u u --	dactylic hexameter	masculine penthemimeral, hepthemimeral
αὔριον· οὐ μὲν γάρ τί σ’ὑποστρέψεσθαι ὀΐω	-uu - - - u u---u u--	dactylic hexameter	masculine penthemimeral, trithemimeral
δεύτερον ἐς μέγαρον Λαερτιάδεω Ὀδυσῆος.	-uu - uu- --uu- uu--	dactylic hexameter	masculine penthemimeral, trithemimeral
τὸν δὲ χολωσάμενος προσεφώνεεν Ἶρος ἀλήτης·	- u u-uu- uu-uu -u u--	dactylic hexameter	masculine penthemimeral
ὢ πόποι, ὡς ὁ μολοβρὸς ἐπιτροχάδην ἀγορεύει,	- uu - u u-u u-uu- uu--	dactylic hexameter	feminine penthemimeral, trithemimeral
γρηῒ καμινοῖ ἶσος· ὃν ἂν κακὰ μητισαίμην	-u u-- -u u - uu ----	dactylic hexameter	feminine penthemimeral, hepthemimeral
κόπτων ἀμφοτέρῃσι, χαμαὶ δ’ἐκ πάντας ὀδόντας	-- -uu-u u- - -u u--	dactylic hexameter	feminine penthemimeral, hepthemimeral
γναθμῶν ἐξελάσαιμι συὸς ὣς ληϊβοτείρης.	-- -uu-u u- - -uu--	dactylic hexameter	feminine penthemimeral, hepthemimeral
ζῶσαι νῦν, ἵνα πάντες ἐπιγνώωσι καὶ οἵδε	-- - uu -u u---u u --	dactylic hexameter	feminine penthemimeral, trithemimeral
μαρναμένους· πῶς δ’ἂν σὺ νεωτέρῳ ἀνδρὶ μάχοιο;	-uu- - - u u-uu -u u--	dactylic hexameter	masculine penthemimeral, trithemimeral
ὣς οἱ μὲν προπάροιθε θυράων ὑψηλάων	- - - uu-u u-- ----	dactylic hexameter	feminine penthemimeral, trithemimeral
οὐδοῦ ἔπι ξεστοῦ πανθυμαδὸν ὀκριόωντο.	-u u- -- --uu -uu--	dactylic hexameter	masculine penthemimeral, trithemimeral
τοῖϊν δὲ ξυνέηχ’ ἱερὸν μένος Ἀντινόοιο,	-- - uu- uu- uu -uu--	dactylic hexameter	masculine penthemimeral, hepthemimeral, trithemimeral
ἡδὺ δ’ἄρ’ ἐκγελάσας μετεφώνει μνηστήρεσσιν·	-u u -uu- uu-- ----	dactylic hexameter	masculine penthemimeral
ὧ φίλοι, οὐ μέν πώ τι πάρος τοιοῦτον ἐτύχθη,	- uu - - - u u- --u u--	dactylic hexameter	masculine penthemimeral, hepthemimeral, trithemimeral
οἵην τερπωλὴν θεὸς ἤγαγεν ἐς τόδε δῶμα.	-- --- uu -uu - uu --	dactylic hexameter	masculine penthemimeral
ὁ ξεῖνός τε καὶ Ἶρος ἐρίζετον ἀλλήλοιϊν	- -- u u -u u-uu ----	dactylic hexameter	feminine penthemimeral, trithemimeral
χερσὶ μαχέσσασθαι· ἀλλὰ ξυνελάσσομεν ὧκα.	-u u--- -- uu-uu --	dactylic hexameter	masculine penthemimeral, hepthemimeral
ὣς ἔφαθ’, οἱ δ’ἄρα πάντες ἀνήϊξαν γελόωντες,	- uu - uu -u u--- uu--	dactylic hexameter	feminine penthemimeral, trithemimeral
ἀμφὶ δ’ἄρα πτωχοὺς κακοείμονας ἠγερέθοντο.	-u u- -- uu-uu -uu--	dactylic hexameter	masculine penthemimeral, trithemimeral
τοῖσιν δ’Ἀντίνοος μετέφη, Εὐπείθεος υἱός·	-- -uu- uu- --uu --	dactylic hexameter	masculine penthemimeral, hepthemimeral
κέκλυτέ μευ, μνηστῆρες ἀγήνορες, ὄφρα τι εἴπω.	-uu - --u u-uu -u u --	dactylic hexameter	feminine penthemimeral, trithemimeral
γαστέρες αἵδ’ αἰγῶν κέατ’ ἐν πυρί, τὰς ἐπὶ δόρπῳ	-uu - -- uu - uu - uu --	dactylic hexameter	masculine penthemimeral, hepthemimeral, trithemimeral
κατθέμεθα κνίσης τε καὶ αἵματος ἐμπλήσαντες·	-uu- -- u u -uu ----	dactylic hexameter	masculine penthemimeral, trithemimeral
ὁππότερος δέ κε νικήσῃ κρείσσων τε γένηται,	-uu- u u --- -- u u--	dactylic hexameter	hepthemimeral, trithemimeral
τάων ἥν κ’ἐθέλῃσιν ἀναστὰς αὐτὸς ἑλέσθω·	-- - uu-u u-- -u u--	dactylic hexameter	feminine penthemimeral, trithemimeral
αἰεὶ δ’αὖθ’ ἡμῖν μεταδαίσεται, οὐδέ τιν’ ἄλλον	-- - -- uu-uu -u u --	dactylic hexameter	masculine penthemimeral, trithemimeral
πτωχὸν ἔσω μίσγεσθαι ἐάσομεν αἰτήσοντα.	-u u- --u u-uu ----	dactylic hexameter	feminine penthemimeral, trithemimeral
ὣς ἔφατ’ Ἀντίνοος, τοῖσιν δ’ἐπιήνδανε μῦθος.	- uu -uu- -- uu-uu --	dactylic hexameter	masculine penthemimeral, hepthemimeral
τοῖς δὲ δολοφρονέων μετέφη πολύμητις Ὀδυσσεύς·	- u u-uu- uu- uu-u u--	dactylic hexameter	masculine penthemimeral, hepthemimeral
ὧ φίλοι, οὔ πως ἔστι νεωτέρῳ ἀνδρὶ μάχεσθαι	- uu - - -u u-uu -u u--	dactylic hexameter	feminine penthemimeral, trithemimeral
ἄνδρα γέροντα, δύῃ ἀρημένον· ἀλλά με γαστὴρ	-u u-u u- --uu -u u --	dactylic hexameter	masculine penthemimeral
ὀτρύνει κακοεργός, ἵνα πληγῇσι δαμείω.	--- uu-u u- --u u--	dactylic hexameter	feminine penthemimeral, hepthemimeral, trithemimeral
ἀλλ’ ἄγε νῦν μοι πάντες ὀμόσσατε καρτερὸν ὅρκον,	- uu - - -u u-uu -uu --	dactylic hexameter	feminine penthemimeral, trithemimeral
μή τις ἐπ’ Ἴρῳ ἦρα φέρων ἐμὲ χειρὶ βαρείῃ	- u u -- -u u- uu -u u--	dactylic hexameter	feminine penthemimeral, hepthemimeral
πλήξῃ ἀτασθάλλων, τούτῳ δέ με ἶφι δαμάσσῃ.	-u u--- -- u u -u u--	dactylic hexameter	masculine penthemimeral, hepthemimeral
ὣς ἔφαθ’, οἱ δ’ἄρα πάντες ἀπώμνυον ὡς ἐκέλευεν.	- uu - uu -u u-uu - uu--	dactylic hexameter	feminine penthemimeral, trithemimeral
αὐτὰρ ἐπεί ῥ’ὄμοσάν τε τελεύτησάν τε τὸν ὅρκον,	-u u- uu- u u--- u u --	dactylic hexameter	masculine penthemimeral, trithemimeral
τοῖς αὖτις μετέειφ’ ἱερὴ ἲς Τηλεμάχοιο·	- -- uu- uu- - -uu--	dactylic hexameter	masculine penthemimeral, hepthemimeral, trithemimeral
ξεῖν’, εἴ σ’ὀτρύνει κραδίη καὶ θυμὸς ἀγήνωρ	- - --- uu- - -u u--	dactylic hexameter	masculine penthemimeral, hepthemimeral
τοῦτον ἀλέξασθαι, τῶν δ’ἄλλων μή τιν’ Ἀχαιῶν	-u u--- - -- - u u--	dactylic hexameter	masculine penthemimeral
δείδιθ’, ἐπεὶ πλεόνεσσι μαχήσεται ὅς κέ σε θείνῃ·	-u u- uu-u u-uu - u u --	dactylic hexameter	feminine penthemimeral, trithemimeral
ξεινοδόκος μὲν ἐγών, ἐπὶ δ’αἰνεῖτον βασιλῆες,	-uu- u u- uu --- uu--	dactylic hexameter	masculine penthemimeral, trithemimeral
Εὐρύμαχός τε καὶ Ἀντίνοος, πεπνυμένω ἄμφω.	-uu- u u -uu- --uu --	dactylic hexameter	hepthemimeral, trithemimeral
ὣς ἔφαθ’, οἱ δ’ἄρα πάντες ἐπῄνεον· αὐτὰρ Ὀδυσσεὺς	- uu - uu -u u-uu -u u--	dactylic hexameter	feminine penthemimeral, trithemimeral
ζώσατο μὲν ῥάκεσιν περὶ μήδεα, φαῖνε δὲ μηροὺς	-uu - uu- uu -uu -u u --	dactylic hexameter	masculine penthemimeral, trithemimeral
καλούς τε μεγάλους τε, φάνεν δέ οἱ εὐρέες ὧμοι	-- - uu- u u- u u -uu --	dactylic hexameter	masculine penthemimeral, hepthemimeral, trithemimeral
στήθεά τε στιβαροί τε βραχίονες· αὐτὰρ Ἀθήνη	-uu - uu- u u-uu -u u--	dactylic hexameter	masculine penthemimeral, trithemimeral
ἄγχι παρισταμένη μέλε’ ἤλδανε ποιμένι λαῶν.	-u u-uu- uu -uu -uu --	dactylic hexameter	masculine penthemimeral
μνηστῆρες δ’ἄρα πάντες ὑπερφιάλως ἀγάσαντο·	--- uu -u u-uu- uu--	dactylic hexameter	feminine penthemimeral, trithemimeral
ὦδε δέ τις εἴπεσκεν ἰδὼν ἐς πλησίον ἄλλον·	-u u - --u u- - -uu --	dactylic hexameter	feminine penthemimeral, hepthemimeral, trithemimeral
ἦ τάχα Ἶρος Ἄϊρος ἐπίσπαστον κακὸν ἕξει,	- uu -u u-u u--- uu --	dactylic hexameter	feminine penthemimeral
οἵην ἐκ ῥακέων ὁ γέρων ἐπιγουνίδα φαίνει.	-- - uu- u u- uu-uu --	dactylic hexameter	masculine penthemimeral, hepthemimeral, trithemimeral
ὣς ἄρ’ ἔφαν, Ἴρῳ δὲ κακῶς ὠρίνετο θυμός.	- u u- -- u u- --uu --	dactylic hexameter	masculine penthemimeral, hepthemimeral, trithemimeral
ἀλλὰ καὶ ὣς δρηστῆρες ἄγον ζώσαντες ἀνάγκῃ	-u u - --u u- --u u--	dactylic hexameter	feminine penthemimeral, hepthemimeral, trithemimeral
δειδιότα· σάρκες δὲ περιτρομέοντο μέλεσσιν.	-uu- -- u u-uu-u u--	dactylic hexameter	masculine penthemimeral, trithemimeral
Ἀντίνοος δ’ἐνένιπεν ἔπος τ’ἔφατ’ ἔκ τ’ὀνόμαζε·	-uu- uu-u u- uu - uu--	dactylic hexameter	feminine penthemimeral, hepthemimeral, trithemimeral
νῦν μὲν μήτ’ εἴης, βουγάϊε, μήτε γένοιο,	- - - -- --uu -u u--	dactylic hexameter	masculine penthemimeral, trithemimeral
εἰ δὴ τοῦτόν γε τρομέεις καὶ δείδιας αἰνῶς,	- - -- - uu- - -uu --	dactylic hexameter	masculine penthemimeral, hepthemimeral
ἄνδρα γέροντα, δύῃ ἀρημένον, ἥ μιν ἱκάνει.	-u u-u u- --uu - u u--	dactylic hexameter	masculine penthemimeral
ἀλλ’ ἔκ τοι ἐρέω, τὸ δὲ καὶ τετελεσμένον ἔσται·	- - - uu- u u - uu-uu --	dactylic hexameter	masculine penthemimeral, hepthemimeral, trithemimeral
αἴ κέν σ’οὗτος νικήσῃ κρείσσων τε γένηται,	- - -- --- -- u u--	dactylic hexameter	hepthemimeral
πέμψω σ’ἤπειρόνδε, βαλὼν ἐν νηὶ μελαίνῃ,	-- ---u u- - -u u--	dactylic hexameter	feminine penthemimeral, hepthemimeral
εἰς Ἔχετον βασιλῆα, βροτῶν δηλήμονα πάντων,	- uu- uu-u u- --uu --	dactylic hexameter	feminine penthemimeral, hepthemimeral, trithemimeral
ὅς κ’ἀπὸ ῥῖνα τάμῃσι καὶ οὔατα νηλέϊ χαλκῷ,	- uu -u u-u u -uu -uu --	dactylic hexameter	feminine penthemimeral
μήδεά τ’ἐξερύσας δώῃ κυσὶν ὠμὰ δάσασθαι.	-uu -uu- -- uu -u u--	dactylic hexameter	masculine penthemimeral, hepthemimeral
ὣς φάτο, τῷ δ’ἔτι μᾶλλον ὑπὸ τρόμος ἔλλαβε γυῖα.	- uu - uu -u u- uu -uu --	dactylic hexameter	feminine penthemimeral, hepthemimeral, trithemimeral
ἐς μέσσον δ’ἄναγον· τὼ δ’ἄμφω χεῖρας ἀνέσχον.	- -- uu- - -- -u u--	dactylic hexameter	masculine penthemimeral, trithemimeral
δὴ τότε μερμήριξε πολύτλας δῖος Ὀδυσσεὺς	- uu ---u u-- -u u--	dactylic hexameter	feminine penthemimeral
ἢ ἐλάσει’ ὥς μιν ψυχὴ λίποι αὖθι πεσόντα,	- uu- - - -- uu -u u--	dactylic hexameter	masculine penthemimeral, hepthemimeral, trithemimeral
ἦέ μιν ἦκ’ ἐλάσειε τανύσσειέν τ’ἐπὶ γαίῃ.	-u u - uu-u u--- uu --	dactylic hexameter	feminine penthemimeral, trithemimeral
ὦδε δέ οἱ φρονέοντι δοάσσατο κέρδιον εἶναι,	-u u - uu-u u-uu -uu --	dactylic hexameter	feminine penthemimeral, trithemimeral
ἦκ’ ἐλάσαι, ἵνα μή μιν ἐπιφρασσαίατ’ Ἀχαιοί.	- uu- uu - u u---u u--	dactylic hexameter	masculine penthemimeral, trithemimeral
δὴ τότ’ ἀνασχομένω ὁ μὲν ἤλασε δεξιὸν ὧμον	- u u-uu- u u -uu -uu --	dactylic hexameter	masculine penthemimeral
Ἶρος, ὁ δ’αὐχέν’ ἔλασσεν ὑπ’ οὔατος, ὀστέα δ’εἴσω	-u u -u u-u u -uu -uu --	dactylic hexameter	feminine penthemimeral
ἔθλασεν· αὐτίκα δ’ἦλθεν ἀνὰ στόμα φοίνιον αἷμα,	-uu -uu -u u- uu -uu --	dactylic hexameter	feminine penthemimeral, hepthemimeral
κὰδ δ’ἔπεσ’ ἐν κονίῃσι μακών, σὺν δ’ἤλασ’ ὀδόντας	- uu - uu-u u- - -u u--	dactylic hexameter	feminine penthemimeral, hepthemimeral, trithemimeral
λακτίζων ποσὶ γαῖαν· ἀτὰρ μνηστῆρες ἀγαυοὶ	--- uu -u u- --u u--	dactylic hexameter	feminine penthemimeral, hepthemimeral, trithemimeral
χεῖρας ἀνασχόμενοι γέλῳ ἔκθανον. αὐτὰρ Ὀδυσσεὺς	-u u-uu- uu -uu -u u--	dactylic hexameter	masculine penthemimeral
εἷλκε διὲκ προθύροιο λαβὼν ποδός, ὄφρ’ ἵκετ’ αὐλήν,	-u u- uu-u u- uu - uu --	dactylic hexameter	feminine penthemimeral, hepthemimeral, trithemimeral
αἰθούσης τε θύρας· καί μιν ποτὶ ἑρκίον αὐλῆς	--- u u- - - uu -uu --	dactylic hexameter	masculine penthemimeral, hepthemimeral, trithemimeral
εἷσεν ἀνακλίνας· σκῆπτρον δέ οἱ ἔμβαλε χειρί,	-u u--- -- u u -uu --	dactylic hexameter	masculine penthemimeral, hepthemimeral
καί μιν φωνήσας ἔπεα πτερόεντα προσηύδα·	- - --- uu- uu-u u--	dactylic hexameter	masculine penthemimeral, hepthemimeral
ἐνταυθοῖ νῦν ἧσο σύας τε κύνας τ’ἀπερύκων,	--- - -u u- u u- uu--	dactylic hexameter	feminine penthemimeral, hepthemimeral, trithemimeral
μηδὲ σύ γε ξείνων καὶ πτωχῶν κοίρανος εἶναι	-u u - -- - -- -uu --	dactylic hexameter	masculine penthemimeral, trithemimeral
λυγρὸς ἐών, μή πού τι κακὸν καὶ μεῖζον ἐπαύρῃ.	-u u- - - u u- - -u u--	dactylic hexameter	masculine penthemimeral, hepthemimeral, trithemimeral
ἦ ῥα καὶ ἀμφ’ ὤμοισιν ἀεικέα βάλλετο πήρην,	- u u - --u u-uu -uu --	dactylic hexameter	feminine penthemimeral, trithemimeral
πυκνὰ ῥωγαλέην· ἐν δὲ στρόφος ἦεν ἀορτήρ.	-- -uu- - - uu -u u--	dactylic hexameter	masculine penthemimeral, hepthemimeral
ἂψ δ’ὅ γ’ἐπ’ οὐδὸν ἰὼν κατ’ ἄρ’ ἕζετο· τοὶ δ’ἴσαν εἴσω	- u u -u u- u u -uu - uu --	dactylic hexameter	masculine penthemimeral
ἡδὺ γελώοντες καὶ δεικανόωντ’ ἐπέεσσι·	-u u--- - -uu- uu--	dactylic hexameter	masculine penthemimeral
Ζεύς τοι δοίη, ξεῖνε, καὶ ἀθάνατοι θεοὶ ἄλλοι,	- - -- -u u -uu- uu --	dactylic hexameter	feminine penthemimeral
ὅττι μάλιστ’ ἐθέλεις καί τοι φίλον ἔπλετο θυμῷ,	-u u- uu- - - uu -uu --	dactylic hexameter	masculine penthemimeral, hepthemimeral, trithemimeral
ὃς τοῦτον τὸν ἄναλτον ἀλητεύειν ἀπέπαυσας	- -- u u-u u--- uu--	dactylic hexameter	feminine penthemimeral, trithemimeral
ἐν δήμῳ· τάχα γάρ μιν ἀνάξομεν ἤπειρόνδε	- -- uu - u u-uu ----	dactylic hexameter	masculine penthemimeral, trithemimeral
εἰς Ἔχετον βασιλῆα, βροτῶν δηλήμονα πάντων.	- uu- uu-u u- --uu --	dactylic hexameter	feminine penthemimeral, hepthemimeral, trithemimeral
ὣς ἄρ’ ἔφαν, χαῖρεν δὲ κλεηδόνι δῖος Ὀδυσσεύς.	- u u- -- u u-uu -u u--	dactylic hexameter	masculine penthemimeral, trithemimeral
Ἀντίνοος δ’ἄρα οἱ μεγάλην παρὰ γαστέρα θῆκεν,	-uu- uu - uu- uu -uu --	dactylic hexameter	masculine penthemimeral, hepthemimeral, trithemimeral
ἐμπλείην κνίσης τε καὶ αἵματος· Ἀμφίνομος δὲ	--- -- u u -uu -uu- -	dactylic hexameter	masculine penthemimeral, trithemimeral
ἄρτους ἐκ κανέοιο δύω παρέθηκεν ἀείρας	-- - uu-u u- uu-u u--	dactylic hexameter	feminine penthemimeral, hepthemimeral, trithemimeral
καὶ δέπαϊ χρυσέῳ δειδίσκετο, φώνησέν τε·	- uu- uu- --uu --- -	dactylic hexameter	masculine penthemimeral, trithemimeral
χαῖρε, πάτερ ὧ ξεῖνε, γένοιτό τοι ἔς περ ὀπίσσω	-u u- - -u u-u u - u u--	dactylic hexameter	feminine penthemimeral, trithemimeral
ὄλβος· ἀτὰρ μὲν νῦν γε κακοῖς ἔχεαι πολέεσσι.	-u u- - - u u- uu- uu--	dactylic hexameter	masculine penthemimeral, hepthemimeral, trithemimeral
τὸν δ’ἀπαμειβόμενος προσέφη πολύμητις Ὀδυσσεύς·	- uu-uu- uu- uu-u u--	dactylic hexameter	masculine penthemimeral, hepthemimeral
Ἀμφίνομ’, ἦ μάλα μοι δοκέεις πεπνυμένος εἶναι·	-uu - uu - uu- --uu --	dactylic hexameter	masculine penthemimeral, hepthemimeral, trithemimeral
τοίου γὰρ καὶ πατρός, ἐπεὶ κλέος ἐσθλὸν ἄκουον,	-- - - -u u- uu -u u--	dactylic hexameter	feminine penthemimeral, hepthemimeral, trithemimeral
Νῖσον Δουλιχιῆα ἐΰν τ’ἔμεν ἀφνειόν τε·	-- -uu-u u- uu --- -	dactylic hexameter	feminine penthemimeral, hepthemimeral
τοῦ σ’ἔκ φασι γενέσθαι, ἐπητῇ δ’ἀνδρὶ ἔοικας.	- - -u u-u u-- -u u--	dactylic hexameter	feminine penthemimeral
τοὔνεκά τοι ἐρέω, σὺ δὲ σύνθεο καί μευ ἄκουσον·	-uu - uu- u u -uu - u u--	dactylic hexameter	masculine penthemimeral, trithemimeral
οὐδὲν ἀκιδνότερον γαῖα τρέφει ἀνθρώποιο,	-u u-uu- -- uu ----	dactylic hexameter	masculine penthemimeral, hepthemimeral
πάντων ὅσσα τε γαῖαν ἔπι πνείει τε καὶ ἕρπει.	-- -u u -u u- -- u u --	dactylic hexameter	feminine penthemimeral, hepthemimeral
οὐ μὲν γάρ ποτέ φησι κακὸν πείσεσθαι ὀπίσσω,	- - - uu -u u- --u u--	dactylic hexameter	feminine penthemimeral, hepthemimeral, trithemimeral
ὄφρ’ ἀρετὴν παρέχωσι θεοὶ καὶ γούνατ’ ὀρώρῃ·	- uu- uu-u u- - -u u--	dactylic hexameter	feminine penthemimeral, hepthemimeral, trithemimeral
ἀλλ’ ὅτε δὴ καὶ λυγρὰ θεοὶ μάκαρες τελέωσι,	- uu - - -u u- uu- uu--	dactylic hexameter	feminine penthemimeral, hepthemimeral, trithemimeral
καὶ τὰ φέρει ἀεκαζόμενος τετληότι θυμῷ·	- u u- uu-uu- --uu --	dactylic hexameter	hepthemimeral, trithemimeral
τοῖος γὰρ νόος ἐστὶν ἐπιχθονίων ἀνθρώπων	-- - uu -u u-uu- ---	dactylic hexameter	feminine penthemimeral, trithemimeral
οἷον ἐπ’ ἦμαρ ἄγῃσι πατὴρ ἀνδρῶν τε θεῶν τε.	-u u -u u-u u- -- u u- -	dactylic hexameter	feminine penthemimeral, hepthemimeral
καὶ γὰρ ἐγώ ποτ’ ἔμελλον ἐν ἀνδράσιν ὄλβιος εἶναι,	- u u- u u-u u -uu -uu --	dactylic hexameter	feminine penthemimeral, trithemimeral
πολλὰ δ’ἀτάσθαλ’ ἔρεξα βίῃ καὶ κάρτεϊ εἴκων,	-u u-u u-u u- - -uu --	dactylic hexameter	feminine penthemimeral, hepthemimeral
πατρί τ’ἐμῷ πίσυνος καὶ ἐμοῖσι κασιγνήτοισι.	-u u- uu- u u-u u----	dactylic hexameter	masculine penthemimeral, trithemimeral
τῶ μή τίς ποτε πάμπαν ἀνὴρ ἀθεμίστιος εἴη,	- - - uu -u u- uu-uu --	dactylic hexameter	feminine penthemimeral, hepthemimeral, trithemimeral
ἀλλ’ ὅ γε σιγῇ δῶρα θεῶν ἔχοι, ὅττι διδοῖεν.	- u u -- -u u- uu -u u--	dactylic hexameter	feminine penthemimeral, hepthemimeral
οἷ’ ὁρόω μνηστῆρας ἀτάσθαλα μηχανόωντας,	- uu- --u u-uu -uu--	dactylic hexameter	feminine penthemimeral, trithemimeral
κτήματα κείροντας καὶ ἀτιμάζοντας ἄκοιτιν	-uu --- u u---u u--	dactylic hexameter	masculine penthemimeral
ἀνδρός, ὃν οὐκέτι φημὶ φίλων καὶ πατρίδος αἴης	-u u -uu -u u- - -uu --	dactylic hexameter	feminine penthemimeral, hepthemimeral
δηρὸν ἀπέσσεσθαι· μάλα δὲ σχεδόν. ἀλλά σε δαίμων	-u u--- uu - uu -u u --	dactylic hexameter	masculine penthemimeral, hepthemimeral
οἴκαδ’ ὑπεξαγάγοι, μηδ’ ἀντιάσειας ἐκείνῳ,	-u u-uu- - -uu-u u--	dactylic hexameter	masculine penthemimeral
ὁππότε νοστήσειε φίλην ἐς πατρίδα γαῖαν·	-uu ---u u- - -uu --	dactylic hexameter	feminine penthemimeral, hepthemimeral
οὐ γὰρ ἀναιμωτί γε διακρινέεσθαι ὀΐω	- u u--- u u-uu-u u--	dactylic hexameter	masculine penthemimeral
μνηστῆρας καὶ κεῖνον, ἐπεί κε μέλαθρον ὑπέλθῃ.	--- - -u u- u u-u u--	dactylic hexameter	feminine penthemimeral, hepthemimeral, trithemimeral
ὣς φάτο, καὶ σπείσας ἔπιεν μελιηδέα οἶνον,	- uu - -- uu- uu-uu --	dactylic hexameter	masculine penthemimeral, hepthemimeral, trithemimeral
ἂψ δ’ἐν χερσὶν ἔθηκε δέπας κοσμήτορι λαῶν.	- - -u u-u u- --uu --	dactylic hexameter	feminine penthemimeral, hepthemimeral
αὐτὰρ ὁ βῆ κατὰ δῶμα φίλον τετιημένος ἦτορ,	-u u - uu -u u- uu-uu --	dactylic hexameter	feminine penthemimeral, hepthemimeral, trithemimeral
νευστάζων κεφαλῇ· δὴ γὰρ κακὸν ὄσσετο θυμῷ.	--- uu- - - uu -uu --	dactylic hexameter	masculine penthemimeral, hepthemimeral, trithemimeral
ἀλλ’ οὐδ’ ὣς φύγε κῆρα· πέδησε δὲ καὶ τὸν Ἀθήνη	- - - uu -u u-u u - u u--	dactylic hexameter	feminine penthemimeral, trithemimeral
Τηλεμάχου ὑπὸ χερσὶ καὶ ἔγχεϊ ἶφι δαμῆναι.	-uu- uu -u u -uu -u u--	dactylic hexameter	feminine penthemimeral, trithemimeral
ἂψ δ’αὖτις κατ’ ἄρ’ ἕζετ’ ἐπὶ θρόνου ἔνθεν ἀνέστη.	- -- u u -u u- uu -u u--	dactylic hexameter	feminine penthemimeral, hepthemimeral, trithemimeral
τῇ δ’ἄρ’ ἐπὶ φρεσὶ θῆκε θεὰ γλαυκῶπις Ἀθήνη,	- u u- uu -u u- --u u--	dactylic hexameter	feminine penthemimeral, hepthemimeral, trithemimeral
κούρῃ Ἰκαρίοιο, περίφρονι Πηνελοπείῃ,	-- -uu-u u-uu -uu--	dactylic hexameter	feminine penthemimeral
μνηστήρεσσι φανῆναι, ὅπως πετάσειε μάλιστα	---u u-u u- uu-u u--	dactylic hexameter	feminine penthemimeral, hepthemimeral
θυμὸν μνηστήρων ἰδὲ τιμήεσσα γένοιτο	-- --- uu ---u u--	dactylic hexameter	masculine penthemimeral
μᾶλλον πρὸς πόσιός τε καὶ υἱέος ἢ πάρος ἦεν.	-- - uu- u u -uu - uu --	dactylic hexameter	masculine penthemimeral, trithemimeral
ἀχρεῖον δ’ἐγέλασσεν ἔπος τ’ἔφατ’ ἔκ τ’ὀνόμαζεν·	--- uu-u u- uu - uu--	dactylic hexameter	feminine penthemimeral, hepthemimeral, trithemimeral
Εὐρυνόμη, θυμός μοι ἐέλδεται, οὔ τι πάρος γε,	-uu- -- u u-uu - u u- -	dactylic hexameter	masculine penthemimeral, trithemimeral
μνηστήρεσσι φανῆναι, ἀπεχθομένοισί περ ἔμπης·	---u u-u u-uu-u u --	dactylic hexameter	feminine penthemimeral
παιδὶ δέ κεν εἴποιμι ἔπος, τό κε κέρδιον εἴη,	-u u - --u u- u u -uu --	dactylic hexameter	feminine penthemimeral, hepthemimeral, trithemimeral
μὴ πάντα μνηστῆρσιν ὑπερφιάλοισιν ὁμιλεῖν,	- -- --u u-uu-u u--	dactylic hexameter	feminine penthemimeral, trithemimeral
οἵ τ’εὖ μὲν βάζουσι, κακῶς δ’ὄπιθεν φρονέουσι.	- - - --u u- uu- uu--	dactylic hexameter	feminine penthemimeral, hepthemimeral, trithemimeral
τὴν δ’αὖτ’ Εὐρυνόμη ταμίη πρὸς μῦθον ἔειπε·	- - -uu- uu- - -u u--	dactylic hexameter	masculine penthemimeral, hepthemimeral
ναὶ δὴ ταῦτά γε πάντα, τέκος, κατὰ μοῖραν ἔειπες.	- - -u u -u u- uu -u u--	dactylic hexameter	feminine penthemimeral, hepthemimeral
ἀλλ’ ἴθι καὶ σῷ παιδὶ ἔπος φάο μηδ’ ἐπίκευθε,	- uu - - -u u- uu - uu--	dactylic hexameter	feminine penthemimeral, hepthemimeral, trithemimeral
χρῶτ’ ἀπονιψαμένη καὶ ἐπιχρίσασα παρειάς·	- uu-uu- u u---u u--	dactylic hexameter	masculine penthemimeral
μηδ’ οὕτω δακρύοισι πεφυρμένη ἀμφὶ πρόσωπα	- -- uu-u u-uu -u u--	dactylic hexameter	feminine penthemimeral, trithemimeral
ἔρχευ, ἐπεὶ κάκιον πενθήμεναι ἄκριτον αἰεί.	-u u- uu- --uu -uu --	dactylic hexameter	masculine penthemimeral, trithemimeral
ἤδη μὲν γάρ τοι παῖς τηλίκος, ὃν σὺ μάλιστα	-- - - - - -uu - u u--	dactylic hexameter	masculine penthemimeral, trithemimeral
ἠρῶ ἀθανάτοισι γενειήσαντα ἰδέσθαι.	-- -uu-u u---u u--	dactylic hexameter	feminine penthemimeral
τὴν δ’αὖτε προσέειπε περίφρων Πηνελόπεια·	- -- uu-u u-- -uu--	dactylic hexameter	feminine penthemimeral, trithemimeral
Εὐρυνόμη, μὴ ταῦτα παραύδα, κηδομένη περ,	-uu- - -u u-- -uu- -	dactylic hexameter	feminine penthemimeral, trithemimeral
χρῶτ’ ἀπονίπτεσθαι καὶ ἐπιχρίεσθαι ἀλοιφῇ·	- uu--- u u---u u--	dactylic hexameter	masculine penthemimeral
ἀγλαΐην γὰρ ἔμοιγε θεοί, τοὶ Ὄλυμπον ἔχουσιν,	-uu- u u-u u- u u-u u--	dactylic hexameter	feminine penthemimeral, hepthemimeral, trithemimeral
ὤλεσαν, ἐξ οὗ κεῖνος ἔβη κοίλῃς ἐνὶ νηυσίν.	-uu - - -u u- -- uu --	dactylic hexameter	feminine penthemimeral, hepthemimeral, trithemimeral
ἀλλά μοι Αὐτονόην τε καὶ Ἱπποδάμειαν ἄνωχθι	-u u -uu- u u -uu-u u--	dactylic hexameter	masculine penthemimeral
ἐλθέμεν, ὄφρα κέ μοι παρστήετον ἐν μεγάροισιν·	-uu -u u - --uu - uu--	dactylic hexameter	masculine penthemimeral
οἴη δ’οὐ κεῖσ’ εἶμι μετ’ ἀνέρας· αἰδέομαι γάρ.	-- - - -u u -uu -uu- -	dactylic hexameter	feminine penthemimeral, trithemimeral
ὣς ἄρ’ ἔφη, γρηῢς δὲ διὲκ μεγάροιο βεβήκει	- u u- -- u u- uu-u u--	dactylic hexameter	masculine penthemimeral, hepthemimeral, trithemimeral
ἀγγελέουσα γυναιξὶ καὶ ὀτρυνέουσα νέεσθαι.	-uu-u u-u u -uu-u u--	dactylic hexameter	feminine penthemimeral
ἔνθ’ αὖτ’ ἄλλ’ ἐνόησε θεὰ γλαυκῶπις Ἀθήνη·	- - - uu-u u- --u u--	dactylic hexameter	feminine penthemimeral, hepthemimeral, trithemimeral
κούρῃ Ἰκαρίοιο κατὰ γλυκὺν ὕπνον ἔχευεν,	-- -uu-u u- uu -u u--	dactylic hexameter	feminine penthemimeral, hepthemimeral
εὗδε δ’ἀνακλινθεῖσα, λύθεν δέ οἱ ἅψεα πάντα	-u u---u u- u u -uu --	dactylic hexameter	feminine penthemimeral, hepthemimeral
αὐτοῦ ἐνὶ κλιντῆρι· τέως δ’ἄρα δῖα θεάων	-u u- --u u- uu -u u--	dactylic hexameter	feminine penthemimeral, hepthemimeral, trithemimeral
ἄμβροτα δῶρα δίδου, ἵνα μιν θησαίατ’ Ἀχαιοί.	-uu -u u- uu - --u u--	dactylic hexameter	masculine penthemimeral, hepthemimeral
κάλλεϊ μέν οἱ πρῶτα προσώπατα καλὰ κάθηρεν	-uu - - -u u-uu -u u--	dactylic hexameter	feminine penthemimeral, trithemimeral
ἀμβροσίῳ, οἵῳ περ ἐϋστέφανος Κυθέρεια	-uu- -- u u-uu- uu--	dactylic hexameter	masculine penthemimeral, trithemimeral
χρίεται, εὖτ’ ἂν ἴῃ Χαρίτων χορὸν ἱμερόεντα·	-uu - u u- uu- uu -uu--	dactylic hexameter	masculine penthemimeral, hepthemimeral, trithemimeral
καί μιν μακροτέρην καὶ πάσσονα θῆκεν ἰδέσθαι,	- - -uu- - -uu -u u--	dactylic hexameter	masculine penthemimeral
λευκοτέρην δ’ἄρα μιν θῆκε πριστοῦ ἐλέφαντος.	-uu- uu - -- -- uu--	dactylic hexameter	masculine penthemimeral, hepthemimeral, trithemimeral
ἡ μὲν ἄρ’ ὣς ἔρξασ’ ἀπεβήσετο δῖα θεάων,	- u u - -- uu-uu -u u--	dactylic hexameter	masculine penthemimeral, trithemimeral
ἦλθον δ’ἀμφίπολοι λευκώλενοι ἐκ μεγάροιο	-- -uu- --uu - uu--	dactylic hexameter	masculine penthemimeral
φθόγγῳ ἐπερχόμεναι· τὴν δὲ γλυκὺς ὕπνος ἀνῆκε,	-u u-uu- - - uu -u u--	dactylic hexameter	masculine penthemimeral, hepthemimeral
καί ῥ’ἀπομόρξατο χερσὶ παρειὰς φώνησέν τε·	- uu-uu -u u-- --- -	dactylic hexameter	feminine penthemimeral
ἦ με μάλ’ αἰνοπαθῆ μαλακὸν περὶ κῶμ’ ἐκάλυψεν.	- u u -uu- uu- uu - uu--	dactylic hexameter	masculine penthemimeral, hepthemimeral
αἴθε μοι ὣς μαλακὸν θάνατον πόροι Ἄρτεμις ἁγνὴ	-u u - uu- uu- uu -uu --	dactylic hexameter	masculine penthemimeral, hepthemimeral, trithemimeral
αὐτίκα νῦν, ἵνα μηκέτ’ ὀδυρομένη κατὰ θυμὸν	-uu - uu -u u-uu- uu --	dactylic hexameter	feminine penthemimeral, trithemimeral
αἰῶνα φθινύθω, πόσιος ποθέουσα φίλοιο	--- uu- uu- uu-u u--	dactylic hexameter	masculine penthemimeral, hepthemimeral, trithemimeral
παντοίην ἀρετήν, ἐπεὶ ἔξοχος ἦεν Ἀχαιῶν.	--- uu- uu -uu -u u--	dactylic hexameter	masculine penthemimeral, trithemimeral
ὣς φαμένη κατέβαιν’ ὑπερώϊα σιγαλόεντα,	- uu- uu- uu-uu -uu--	dactylic hexameter	masculine penthemimeral, trithemimeral
οὐκ οἴη· ἅμα τῇ γε καὶ ἀμφίπολοι δύ’ ἕποντο.	- -- uu - u u -uu- u u--	dactylic hexameter	masculine penthemimeral, trithemimeral
ἡ δ’ὅτε δὴ μνηστῆρας ἀφίκετο δῖα γυναικῶν,	- uu - --u u-uu -u u--	dactylic hexameter	feminine penthemimeral, trithemimeral
στῆ ῥα παρὰ σταθμὸν τέγεος πύκα ποιητοῖο,	- u u- -- uu- uu ----	dactylic hexameter	masculine penthemimeral, hepthemimeral, trithemimeral
ἄντα παρειάων σχομένη λιπαρὰ κρήδεμνα·	-u u--- uu- uu- ---	dactylic hexameter	masculine penthemimeral, hepthemimeral
ἀμφίπολος δ’ἄρα οἱ κεδνὴ ἑκάτερθε παρέστη.	-uu- uu - -- uu-u u--	dactylic hexameter	masculine penthemimeral, hepthemimeral, trithemimeral
τῶν δ’αὐτοῦ λύτο γούνατ’, ἔρῳ δ’ἄρα θυμὸν ἔθελχθεν,	- -- uu -u u- uu -u u--	dactylic hexameter	feminine penthemimeral, hepthemimeral, trithemimeral
πάντες δ’ἠρήσαντο παραὶ λεχέεσσι κλιθῆναι.	-- ---u u- uu-u u--	dactylic hexameter	feminine penthemimeral, hepthemimeral
ἡ δ’αὖ Τηλέμαχον προσεφώνεεν, ὃν φίλον υἱόν·	- - -uu- uu-uu - uu --	dactylic hexameter	masculine penthemimeral
Τηλέμαχ’, οὐκέτι τοι φρένες ἔμπεδοι οὐδὲ νόημα·	-uu -uu - uu -uu -u u--	dactylic hexameter	masculine penthemimeral
παῖς ἔτ’ ἐὼν καὶ μᾶλλον ἐνὶ φρεσὶ κέρδε’ ἐνώμας·	- u u- - -u u- uu -u u--	dactylic hexameter	feminine penthemimeral, hepthemimeral, trithemimeral
νῦν δ’,ὅτε δὴ μέγας ἐσσὶ καὶ ἥβης μέτρον ἱκάνεις,	- uu - uu -u u -- -u u--	dactylic hexameter	feminine penthemimeral, trithemimeral
καί κέν τις φαίη γόνον ἔμμεναι ὀλβίου ἀνδρός,	- - - -- uu -uu -uu --	dactylic hexameter	masculine penthemimeral, trithemimeral
ἐς μέγεθος καὶ κάλλος ὁρώμενος, ἀλλότριος φώς,	- uu- - -u u-uu -uu- -	dactylic hexameter	feminine penthemimeral, trithemimeral
οὐκέτι τοι φρένες εἰσὶν ἐναίσιμοι οὐδὲ νόημα.	-uu - uu -u u-uu -u u--	dactylic hexameter	feminine penthemimeral, trithemimeral
οἷον δὴ τόδε ἔργον ἐνὶ μεγάροισιν ἐτύχθη,	-- - uu -u u- uu-u u--	dactylic hexameter	feminine penthemimeral, hepthemimeral, trithemimeral
ὃς τὸν ξεῖνον ἔασας ἀεικισθήμεναι οὕτω.	- - -u u-u u---uu --	dactylic hexameter	feminine penthemimeral
πῶς νῦν, εἴ τι ξεῖνος ἐν ἡμετέροισι δόμοισιν	- - - - -u u -uu-u u--	dactylic hexameter	feminine penthemimeral, trithemimeral
ἥμενος ὦδε πάθοι ῥυστακτύος ἐξ ἀλεγεινῆς;	-uu -u u- --uu - uu--	dactylic hexameter	masculine penthemimeral
σοί κ’αἶσχος λώβη τε μετ’ ἀνθρώποισι πέλοιτο.	- -- -- u u ---u u--	dactylic hexameter	masculine penthemimeral, trithemimeral
τὴν δ’αὖ Τηλέμαχος πεπνυμένος ἀντίον ηὔδα·	- - -uu- --uu -uu --	dactylic hexameter	masculine penthemimeral
μῆτερ ἐμή, τὸ μὲν οὔ σε νεμεσσῶμαι κεχολῶσθαι·	-u u- u u - u u--- uu--	dactylic hexameter	masculine penthemimeral, trithemimeral
αὐτὰρ ἐγὼ θυμῷ νοέω καὶ οἶδα ἕκαστα,	-u u- -- uu- - -u u--	dactylic hexameter	masculine penthemimeral, hepthemimeral, trithemimeral
ἐσθλά τε καὶ τὰ χέρεια· πάρος δ’ἔτι νήπιος ἦα.	-u u - u u-u u- uu -uu --	dactylic hexameter	feminine penthemimeral, hepthemimeral, trithemimeral
ἀλλά τοι οὐ δύναμαι πεπνυμένα πάντα νοῆσαι·	-u u - uu- --uu -u u--	dactylic hexameter	masculine penthemimeral, trithemimeral
ἐκ γάρ με πλήσσουσι παρήμενοι ἄλλοθεν ἄλλος	- - - --u u-uu -uu --	dactylic hexameter	feminine penthemimeral, trithemimeral
οἵδε κακὰ φρονέοντες, ἐμοὶ δ’οὐκ εἰσὶν ἀρωγοί.	-u u- uu-u u- - -u u--	dactylic hexameter	feminine penthemimeral, hepthemimeral, trithemimeral
οὐ μέν τοι ξείνου γε καὶ Ἴρου μῶλος ἐτύχθη	- - - -- u u -- -u u--	dactylic hexameter	masculine penthemimeral, trithemimeral
μνηστήρων ἰότητι, βίῃ δ’ὅ γε φέρτερος ἦεν.	--- uu-u u- u u -uu --	dactylic hexameter	feminine penthemimeral, hepthemimeral, trithemimeral
αἲ γάρ, Ζεῦ τε πάτερ καὶ &nbsnbsp;Ἀθηναίη καὶ Ἄπολλον,	- - - u u- u u--- u u--	dactylic hexameter	masculine penthemimeral, trithemimeral
οὕτω νῦν μνηστῆρες ἐν ἡμετέροισι δόμοισι	-- - --u u -uu-u u--	dactylic hexameter	feminine penthemimeral, trithemimeral
νεύοιεν κεφαλὰς δεδμημένοι, οἱ μὲν ἐν αὐλῇ,	--- uu- --uu - u u --	dactylic hexameter	masculine penthemimeral, trithemimeral
οἱ δ’ἔντοσθε δόμοιο, λελῦτο δὲ γυῖα ἑκάστου,	- --u u-u u-u u -u u--	dactylic hexameter	feminine penthemimeral
ὡς νῦν Ἶρος ἐκεῖνος ἐπ’ αὐλείῃσι θύρῃσιν	- - -u u-u u ---u u--	dactylic hexameter	feminine penthemimeral
ἧσται νευστάζων κεφαλῇ, μεθύοντι ἐοικώς,	-- --- uu- uu-u u--	dactylic hexameter	masculine penthemimeral, hepthemimeral
οὐδ’ ὀρθὸς στῆναι δύναται ποσὶν οὐδὲ νέεσθαι	- -- -- uu- uu -u u--	dactylic hexameter	masculine penthemimeral, hepthemimeral, trithemimeral
οἴκαδ’, ὅπῃ οἱ νόστος, ἐπεὶ φίλα γυῖα λέλυνται.	-u u- - -u u- uu -u u--	dactylic hexameter	feminine penthemimeral, hepthemimeral, trithemimeral
ὣς οἱ μὲν τοιαῦτα πρὸς ἀλλήλους ἀγόρευον·	- - - --u u --- uu--	dactylic hexameter	feminine penthemimeral, trithemimeral
Εὐρύμαχος δ’ἐπέεσσι προσηύδα Πηνελόπειαν·	-uu- uu-u u-- -uu--	dactylic hexameter	feminine penthemimeral, trithemimeral
κούρη Ἰκαρίοιο, περίφρων Πηνελόπεια,	-- -uu-u u-- -uu--	dactylic hexameter	feminine penthemimeral
εἰ πάντες σε ἴδοιεν ἀν’ Ἴασον Ἄργος Ἀχαιοί,	- -- u u-u u -uu -u u--	dactylic hexameter	feminine penthemimeral, trithemimeral
πλέονές κεν μνηστῆρες ἐν ὑμετέροισι δόμοισιν	-- - --u u -uu-u u--	dactylic hexameter	feminine penthemimeral, trithemimeral
ἠῶθεν δαινύατ’, ἐπεὶ περίεσσι γυναικῶν	--- --u u- uu-u u--	dactylic hexameter	feminine penthemimeral, hepthemimeral, trithemimeral
εἶδός τε μέγεθός τε ἰδὲ φρένας ἔνδον ἐΐσας.	-- - uu- u u- uu -u u--	dactylic hexameter	masculine penthemimeral, hepthemimeral, trithemimeral
τὸν δ’ἠμείβετ’ ἔπειτα περίφρων Πηνελόπεια·	- --u u-u u-- -uu--	dactylic hexameter	feminine penthemimeral
Εὐρύμαχ’, ἤτοι ἐμὴν ἀρετὴν εἶδός τε δέμας τε	-uu -u u- uu- -- u u- -	dactylic hexameter	masculine penthemimeral, hepthemimeral
ὤλεσαν ἀθάνατοι, ὅτε Ἴλιον εἰσανέβαινον	-uu -uu- uu -uu -uu--	dactylic hexameter	masculine penthemimeral
Ἀργεῖοι, μετὰ τοῖσι δ’ ἐμὸς πόσις ᾖεν Ὀδυσσεύς.	--- uu -u u- uu -u u--	dactylic hexameter	feminine penthemimeral, hepthemimeral, trithemimeral
εἰ κεῖνός γ’ἐλθὼν τὸν ἐμὸν βίον ἀμφιπολεύοι,	- -- -- u u- uu -uu--	dactylic hexameter	masculine penthemimeral, hepthemimeral, trithemimeral
μεῖζόν κε κλέος εἴη ἐμὸν καὶ κάλλιον οὕτω.	-- - uu -u u- - -uu --	dactylic hexameter	feminine penthemimeral, hepthemimeral, trithemimeral
νῦν δ’ἄχομαι· τόσα γάρ μοι ἐπέσσευεν κακὰ δαίμων.	- uu- uu - u u--- uu --	dactylic hexameter	masculine penthemimeral, trithemimeral
ἦ μὲν δὴ ὅτε τ’ᾖε λιπὼν κάτα πατρίδα γαῖαν,	- - - uu -u u- uu -uu --	dactylic hexameter	feminine penthemimeral, hepthemimeral, trithemimeral
δεξιτερὴν ἐπὶ καρπῷ ἑλὼν ἐμὲ χεῖρα προσηύδα·	-uu- uu -u u- uu -u u--	dactylic hexameter	feminine penthemimeral, hepthemimeral, trithemimeral
ὧ γύναι, οὐ γὰρ ὀΐω ἐϋκνήμιδας Ἀχαιοὺς	- uu - u u-u u---u u--	dactylic hexameter	feminine penthemimeral, trithemimeral
ἐκ Τροίης εὖ πάντας ἀπήμονας ἀπονέεσθαι·	- -- - -u u-uu -uu--	dactylic hexameter	feminine penthemimeral, trithemimeral
καὶ γὰρ Τρῶάς φασι μαχητὰς ἔμμεναι ἄνδρας,	- - -- -u u-- -uu --	dactylic hexameter	feminine penthemimeral
ἠμὲν ἀκοντιστὰς ἠδὲ ῥυτῆρας ὀϊστῶν	-u u--- -- --u u--	dactylic hexameter	masculine penthemimeral, hepthemimeral
ἵππων τ’ὠκυπόδων ἐπιβήτορας, οἵ κε τάχιστα	-- -uu- uu-uu - u u--	dactylic hexameter	masculine penthemimeral
ἔκριναν μέγα νεῖκος ὁμοιΐου πτολέμοιο.	--- uu -u u--- uu--	dactylic hexameter	feminine penthemimeral, trithemimeral
τῶ οὐκ οἶδ’ εἴ κέν μ’ἀνέσει θεός, ἦ κεν ἁλώω	- - - - - uu- uu - u u--	dactylic hexameter	masculine penthemimeral, hepthemimeral, trithemimeral
αὐτοῦ ἐνὶ Τροίῃ· σοὶ δ’ἐνθάδε πάντα μελόντων.	-u u- -- - -uu -u u--	dactylic hexameter	masculine penthemimeral, trithemimeral
μεμνῆσθαι πατρὸς καὶ μητέρος ἐν μεγάροισιν	--- -- - -uu - uu--	dactylic hexameter	masculine penthemimeral, trithemimeral
ὡς νῦν, ἢ ἔτι μᾶλλον ἐμεῦ ἀπονόσφιν ἐόντος·	- - - uu -u u- uu-u u--	dactylic hexameter	feminine penthemimeral, hepthemimeral, trithemimeral
αὐτὰρ ἐπὴν δὴ παῖδα γενειήσαντα ἴδηαι,	-u u- - -u u---u u--	dactylic hexameter	feminine penthemimeral, trithemimeral
γήμασθ’ ᾧ κ’ἐθέλῃσθα, τεὸν κατὰ δῶμα λιποῦσα.	-- - uu-u u- uu -u u--	dactylic hexameter	feminine penthemimeral, hepthemimeral, trithemimeral
κεῖνος τὼς ἀγόρευε· τὰ δὴ νῦν πάντα τελεῖται.	-- - uu-u u - - -u u--	dactylic hexameter	feminine penthemimeral, hepthemimeral, trithemimeral
νὺξ δ’ἔσται ὅτε δὴ στυγερὸς γάμος ἀντιβολήσει	- -- uu - uu- uu -uu--	dactylic hexameter	masculine penthemimeral, hepthemimeral, trithemimeral
οὐλομένης ἐμέθεν, τῆς τε Ζεὺς ὄλβον ἀπηύρα.	-uu- uu- - - - -u u--	dactylic hexameter	masculine penthemimeral, hepthemimeral, trithemimeral
ἀλλὰ τόδ’ αἰνὸν ἄχος κραδίην καὶ θυμὸν ἱκάνει·	-u u -u u- uu- - -u u--	dactylic hexameter	masculine penthemimeral, hepthemimeral
μνηστήρων οὐχ ἥδε δίκη τὸ πάροιθε τέτυκτο·	--- - -u u- u u-u u--	dactylic hexameter	feminine penthemimeral, hepthemimeral, trithemimeral
οἵ τ’ἀγαθήν τε γυναῖκα καὶ ἀφνειοῖο θύγατρα	- uu- u u-u u ---u u--	dactylic hexameter	feminine penthemimeral, trithemimeral
μνηστεύειν ἐθέλωσι καὶ ἀλλήλοις ἐρίσωσιν,	--- uu-u u --- uu--	dactylic hexameter	feminine penthemimeral, trithemimeral
αὐτοὶ τοί γ’ἀπάγουσι βόας καὶ ἴφια μῆλα,	-- - uu-u u- - -uu --	dactylic hexameter	feminine penthemimeral, hepthemimeral, trithemimeral
κούρης δαῖτα φίλοισι, καὶ ἀγλαὰ δῶρα διδοῦσιν·	-- -u u-u u -uu -u u--	dactylic hexameter	feminine penthemimeral
ἀλλ’ οὐκ ἀλλότριον βίοτον νήποινον ἔδουσιν.	- - -uu- uu- --u u--	dactylic hexameter	masculine penthemimeral, hepthemimeral
ὣς φάτο, γήθησεν δὲ πολύτλας δῖος Ὀδυσσεύς,	- uu --- u u-- -u u--	dactylic hexameter	masculine penthemimeral
οὕνεκα τῶν μὲν δῶρα παρέλκετο, θέλγε δὲ θυμὸν	-uu - - -u u-uu -u u --	dactylic hexameter	feminine penthemimeral, trithemimeral
μειλιχίοις ἐπέεσσι, νόος δέ οἱ ἄλλα μενοίνα.	-uu- uu-u u- u u -u u--	dactylic hexameter	feminine penthemimeral, hepthemimeral, trithemimeral
τὴν δ’αὖτ’ Ἀντίνοος προσέφη, Εὐπείθεος υἱός,	- - -uu- uu- --uu --	dactylic hexameter	masculine penthemimeral, hepthemimeral
κούρη Ἰκαρίοιο, περίφρων Πηνελόπεια,	-- -uu-u u-- -uu--	dactylic hexameter	feminine penthemimeral
δῶρα μὲν ὅς κ’ἐθέλῃσιν Ἀχαιῶν ἐνθάδ’ ἐνεῖκαι,	-u u - uu-u u-- -u u--	dactylic hexameter	feminine penthemimeral, trithemimeral
δέξασθ’. οὐ γὰρ καλὸν ἀνήνασθαι δόσιν ἐστίν·	-- - - -u u--- uu --	dactylic hexameter	feminine penthemimeral, trithemimeral
ἡμεῖς δ’οὔτ’ ἐπὶ ἔργα πάρος γ’ἴμεν οὔτε πῃ ἄλλῃ,	-- - uu -u u- uu -u u --	dactylic hexameter	feminine penthemimeral, hepthemimeral, trithemimeral
πρίν γέ σε τῷ γήμασθαι Ἀχαιῶν ὅς τις ἄριστος.	- u u - --u u-- - u u--	dactylic hexameter	feminine penthemimeral, trithemimeral
ὣς ἔφατ’ Ἀντίνοος, τοῖσιν δ’ἐπιήνδανε μῦθος·	- uu -uu- -- uu-uu --	dactylic hexameter	masculine penthemimeral, hepthemimeral
δῶρα δ’ἄρ’ οἰσέμεναι πρόεσαν κήρυκα ἕκαστος.	-u u -uu- uu- --u u--	dactylic hexameter	masculine penthemimeral, hepthemimeral
Ἀντινόῳ μὲν ἔνεικε μέγαν περικαλλέα πέπλον,	-uu- u u-u u- uu-uu --	dactylic hexameter	feminine penthemimeral, hepthemimeral, trithemimeral
ποικίλον· ἐν δ’ἄρ’ ἔσαν περόναι δυοκαίδεκα πᾶσαι	-uu - u u- uu- uu-uu --	dactylic hexameter	masculine penthemimeral, hepthemimeral, trithemimeral
χρύσειαι, κληῗσιν ἐϋγνάμπτοις ἀραρυῖαι.	--- --u u--- uu--	dactylic hexameter	feminine penthemimeral, trithemimeral
ὅρμον δ’Εὐρυμάχῳ πολυδαίδαλον αὐτίκ’ ἔνεικε.	-- -uu- uu-uu -u u--	dactylic hexameter	masculine penthemimeral
χρύσεον, ἠλέκτροισιν ἐερμένον ἠέλιον ὥς.	-- ---u u-uu -uu- -	dactylic hexameter	feminine penthemimeral
ἕρματα δ’Εὐρυδάμαντι δύω θεράποντες ἔνεικαν,	-uu -uu-u u- uu-u u--	dactylic hexameter	feminine penthemimeral, hepthemimeral
τρίγληνα μορόεντα· χάρις δ’ἀπελάμπετο πολλή.	--- uu-u u- uu-uu --	dactylic hexameter	feminine penthemimeral, hepthemimeral, trithemimeral
ἐκ δ’ἄρα Πεισάνδροιο Πολυκτορίδαο ἄνακτος	- uu ---u u-uu-u u--	dactylic hexameter	feminine penthemimeral
ἴσθμιον ἤνεικεν θεράπων, περικαλλὲς ἄγαλμα.	-uu --- uu- uu-u u--	dactylic hexameter	masculine penthemimeral, hepthemimeral
ἄλλο δ’ἄρ’ ἄλλος δῶρον Ἀχαιῶν καλὸν ἔνεικεν.	-u u -- -u u-- -u u--	dactylic hexameter	feminine penthemimeral
ἡ μὲν ἔπειτ’ ἀνέβαιν’ ὑπερώϊα δῖα γυναικῶν,	- u u- uu- uu-uu -u u--	dactylic hexameter	masculine penthemimeral, trithemimeral
τῇ δ’ἄρ’ ἅμ’ ἀμφίπολοι ἔφερον περικαλλέα δῶρα	- u u -uu- uu- uu-uu --	dactylic hexameter	masculine penthemimeral, hepthemimeral
οἱ δ’εἰς ὀρχηστύν τε καὶ ἱμερόεσσαν ἀοιδὴν	- - --- u u -uu-u u--	dactylic hexameter	masculine penthemimeral
τρεψάμενοι τέρποντο, μένον δ’ἐπὶ ἕσπερον ἐλθεῖν.	-uu- --u u- uu -uu --	dactylic hexameter	feminine penthemimeral, hepthemimeral, trithemimeral
τοῖσι δὲ τερπομένοισι μέλας ἐπὶ ἕσπερος ἦλθεν.	-u u -uu-u u- uu -uu --	dactylic hexameter	feminine penthemimeral, hepthemimeral
αὐτίκα λαμπτῆρας τρεῖς ἵστασαν ἐν μεγάροισιν,	-uu --- - -uu - uu--	dactylic hexameter	masculine penthemimeral
ὄφρα φαείνοιεν· περὶ δὲ ξύλα κάγκανα θῆκαν,	-u u--- uu - uu -uu --	dactylic hexameter	masculine penthemimeral, hepthemimeral
αὖα πάλαι, περίκηλα, νέον κεκεασμένα χαλκῷ,	-u u- uu-u u- uu-uu --	dactylic hexameter	feminine penthemimeral, hepthemimeral, trithemimeral
καὶ δαΐδας μετέμισγον· ἀμοιβηδὶς δ’ἀνέφαινον	- uu- uu-u u--- uu--	dactylic hexameter	feminine penthemimeral, trithemimeral
δμῳαὶ Ὀδυσσῆος ταλασίφρονος. αὐτὰρ ὁ τῇσιν	-u u--- uu-uu -u u --	dactylic hexameter	masculine penthemimeral
αὐτὸς διογενὴς μετέφη πολύμητις Ὀδυσσεύς·	-- -uu- uu- uu-u u--	dactylic hexameter	masculine penthemimeral, hepthemimeral
δμῳαὶ Ὀδυσσῆος, δὴν οἰχομένοιο ἄνακτος,	-u u--- - -uu-u u--	dactylic hexameter	masculine penthemimeral
ἔρχεσθε πρὸς δώμαθ’, ἵν’ αἰδοίη βασίλεια·	--- - -u u --- uu--	dactylic hexameter	feminine penthemimeral, trithemimeral
τῇ δὲ παρ’ ἠλάκατα στροφαλίζετε, τέρπετε δ’αὐτὴν	- u u -uu- uu-uu -uu --	dactylic hexameter	masculine penthemimeral
ἥμεναι ἐν μεγάρῳ, ἢ εἴρια πείκετε χερσίν·	-uu - uu- - -uu -uu --	dactylic hexameter	masculine penthemimeral, trithemimeral
αὐτὰρ ἐγὼ τούτοισι φάος πάντεσσι παρέξω.	-u u- --u u- --u u--	dactylic hexameter	feminine penthemimeral, hepthemimeral, trithemimeral
ἤν περ γάρ κ’ἐθέλωσιν ἐΰθρονον Ἠῶ μίμνειν,	- - - uu-u u-uu -- --	dactylic hexameter	feminine penthemimeral, trithemimeral
οὔ τί με νικήσουσι· πολυτλήμων δὲ μάλ’ εἰμί.	- u u ---u u--- u u --	dactylic hexameter	feminine penthemimeral
ὣς ἔφαθ’, αἱ δ’ἐγέλασσαν, ἐς ἀλλήλας δὲ ἴδοντο.	- uu - uu-u u --- u u--	dactylic hexameter	feminine penthemimeral, trithemimeral
τὸν δ’αἰσχρῶς ἐνένιπε Μελανθὼ καλλιπάρηος,	- -- uu-u u-- -uu--	dactylic hexameter	feminine penthemimeral, trithemimeral
τὴν Δολίος μὲν ἔτικτε, κόμισσε δὲ Πηνελόπεια,	- uu- u u-u u-u u -uu--	dactylic hexameter	feminine penthemimeral, trithemimeral
παῖδα δὲ ὣς ἀτίταλλε, δίδου δ’ἄρ’ ἀθύρματα θυμῷ·	-u u - uu-u u- u u-uu --	dactylic hexameter	feminine penthemimeral, hepthemimeral, trithemimeral
ἀλλ’ οὐδ’ ὣς ἔχε πένθος ἐνὶ φρεσὶ Πηνελοπείης,	- - - uu -u u- uu -uu--	dactylic hexameter	feminine penthemimeral, hepthemimeral, trithemimeral
ἀλλ’ ἥ γ’Εὐρυμάχῳ μισγέσκετο καὶ φιλέεσκεν.	- - -uu- --uu - uu--	dactylic hexameter	masculine penthemimeral
ἥ ῥ’Ὀδυσῆ’ ἐνένιπεν ὀνειδείοις ἐπέεσσι·	- uu- uu-u u--- uu--	dactylic hexameter	feminine penthemimeral, trithemimeral
ξεῖνε τάλαν, σύ γέ τις φρένας ἐκπεπαταγμένος ἐσσί,	-u u- u u - uu -uu-uu --	dactylic hexameter	masculine penthemimeral, trithemimeral
οὐδ’ ἐθέλεις εὕδειν χαλκήϊον ἐς δόμον ἐλθών,	- uu- -- --uu - uu --	dactylic hexameter	masculine penthemimeral, trithemimeral
ἠέ που ἐς λέσχην, ἀλλ’ ἐνθάδε πόλλ’ ἀγορεύεις,	-u u - -- - -uu - uu--	dactylic hexameter	masculine penthemimeral, trithemimeral
θαρσαλέως πολλοῖσι μετ’ ἀνδράσιν, οὐδέ τι θυμῷ	-uu- --u u -uu -u u --	dactylic hexameter	feminine penthemimeral, trithemimeral
ταρβεῖς· ἦ ῥά σε οἶνος ἔχει φρένας, ἤ νύ τοι αἰεὶ	-- - u u -u u- uu - u u --	dactylic hexameter	feminine penthemimeral, hepthemimeral, trithemimeral
τοιοῦτος νόος ἐστίν· ὃ καὶ μεταμώνια βάζεις.	--- uu -u u - uu-uu --	dactylic hexameter	feminine penthemimeral, hepthemimeral, trithemimeral
ἦ ἀλύεις, ὅτι Ἶρον ἐνίκησας τὸν ἀλήτην;	- uu- uu -u u--- u u--	dactylic hexameter	feminine penthemimeral, trithemimeral
μή τίς τοι τάχα Ἴρου ἀμείνων ἄλλος ἀναστῇ,	- - - uu -u u-- -u u--	dactylic hexameter	feminine penthemimeral, trithemimeral
ὅς τίς σ’ἀμφὶ κάρη κεκοπὼς χερσὶ στιβαρῇσι	- - -u u- uu- -- uu--	dactylic hexameter	masculine penthemimeral, hepthemimeral
δώματος ἐκπέμψῃσι, φορύξας αἵματι πολλῷ.	-uu ---u u-- -uu --	dactylic hexameter	feminine penthemimeral
τὴν δ’ἄρ’ ὑπόδρα ἰδὼν προσέφη πολύμητις Ὀδυσσεύς·	- u u-u u- uu- uu-u u--	dactylic hexameter	masculine penthemimeral, hepthemimeral
ἦ τάχα Τηλεμάχῳ ἐρέω, κύον, οἷ’ ἀγορεύεις,	- uu -uu- uu- uu - uu--	dactylic hexameter	masculine penthemimeral, hepthemimeral
κεῖσ’ ἐλθών, ἵνα σ’αὖθι διὰ μελεϊστὶ τάμῃσιν.	- -- uu -u u- uu-u u--	dactylic hexameter	feminine penthemimeral, hepthemimeral, trithemimeral
ὣς εἰπὼν ἐπέεσσι διεπτοίησε γυναῖκας.	- -- uu-u u---u u--	dactylic hexameter	feminine penthemimeral, trithemimeral
βὰν δ’ἴμεναι διὰ δῶμα, λύθεν δ’ὑπὸ γυῖα ἑκάστης	- uu- uu -u u- uu -u u--	dactylic hexameter	feminine penthemimeral, hepthemimeral, trithemimeral
ταρβοσύνῃ· φὰν γάρ μιν ἀληθέα μυθήσασθαι.	-uu- - - u u-uu ----	dactylic hexameter	masculine penthemimeral, trithemimeral
αὐτὰρ ὁ πὰρ λαμπτῆρσι φαείνων αἰθομένοισιν	-u u - --u u-- -uu--	dactylic hexameter	feminine penthemimeral, trithemimeral
ἑστήκει ἐς πάντας ὁρώμενος· ἄλλα δέ οἱ κῆρ	--- - -u u-uu -u u - -	dactylic hexameter	feminine penthemimeral, trithemimeral
ὥρμαινε φρεσὶν ᾗσιν, ἅ ῥ’οὐκ ἀτέλεστα γένοντο.	--- uu -u u - uu-u u--	dactylic hexameter	feminine penthemimeral, hepthemimeral, trithemimeral
μνηστῆρας δ’οὐ πάμπαν ἀγήνορας εἴα Ἀθήνη	--- - -u u-uu -u u--	dactylic hexameter	feminine penthemimeral, trithemimeral
λώβης ἴσχεσθαι θυμαλγέος, ὄφρ’ ἔτι μᾶλλον	-- --- --uu - uu --	dactylic hexameter	masculine penthemimeral
δύη ἄχος κραδίην Λαερτιάδεω Ὀδυσῆος.	-u u- uu- --uu- uu--	dactylic hexameter	masculine penthemimeral, trithemimeral
τοῖσιν δ’Εὐρύμαχος, Πολύβου πάϊς, ἦρχ’ ἀγορεύειν,	-- -uu- uu- uu - uu--	dactylic hexameter	masculine penthemimeral, hepthemimeral
κερτομέων Ὀδυσῆα· γέλων δ’ἑτάροισιν ἔτευχε.	-uu- uu-u u- uu-u u--	dactylic hexameter	feminine penthemimeral, hepthemimeral, trithemimeral
κέκλυτέ μευ, μνηστῆρες ἀγακλειτῆς βασιλείης,	-uu - --u u--- uu--	dactylic hexameter	feminine penthemimeral, trithemimeral
ὄφρ’ εἴπω τά με θυμὸς ἐνὶ στήθεσσι κελεύει.	- -- u u -u u- --u u--	dactylic hexameter	feminine penthemimeral, hepthemimeral, trithemimeral
οὐκ ἀθεεὶ ὅδ’ ἀνὴρ Ὀδυσήϊον ἐς δόμον ἵκει·	- uu- u u- uu-uu - uu --	dactylic hexameter	masculine penthemimeral, trithemimeral
ἔμπης μοι δοκέει δαίδων σέλας ἔμμεναι αὐτοῦ	-- - uu- -- uu -uu --	dactylic hexameter	masculine penthemimeral, hepthemimeral, trithemimeral
κὰκ κεφαλῆς, ἐπεὶ οὔ οἱ ἔνι τρίχες οὐδ’ ἠβαιαί.	- uu- uu - u u- uu - ---	dactylic hexameter	masculine penthemimeral, hepthemimeral, trithemimeral
ἦ ῥ’,ἅμα τε προσέειπεν Ὀδυσσῆα πτολίπορθον·	- uu - uu-u u--- uu--	dactylic hexameter	feminine penthemimeral, trithemimeral
ξεῖν’, ἦ ἄρ κ’ἐθέλοις θητευέμεν, εἴ σ’ἀνελοίμην,	- - - uu- --uu - uu--	dactylic hexameter	masculine penthemimeral, trithemimeral
ἀγροῦ ἐπ’ ἐσχατιῆς μισθὸς δέ τοι ἄρκιος ἔσται	-u u -uu- -- u u -uu --	dactylic hexameter	masculine penthemimeral, hepthemimeral
αἱμασιάς τε λέγων καὶ δένδρεα μακρὰ φυτεύων;	-uu- u u- - -uu -u u--	dactylic hexameter	masculine penthemimeral, trithemimeral
ἔνθα κ’ἐγὼ σῖτον μὲν ἐπηετανὸν παρέχοιμι,	-u u- -- u u-uu- uu--	dactylic hexameter	masculine penthemimeral, trithemimeral
εἵματα δ’ἀμφιέσαιμι ποσίν θ’ὑποδήματα δοίην.	-uu -uu-u u- uu-uu --	dactylic hexameter	feminine penthemimeral, hepthemimeral
ἀλλ’ ἐπεὶ οὖν δὴ ἔργα κάκ’ ἔμμαθες, οὐκ ἐθελήσεις	- uu - - -u u -uu - uu--	dactylic hexameter	feminine penthemimeral, trithemimeral
ἔργον ἐποίχεσθαι, ἀλλὰ πτώσσειν κατὰ δῆμον	-u u--- -- -- uu --	dactylic hexameter	masculine penthemimeral, hepthemimeral
βούλεαι, ὄφρ’ ἄν ἔχῃς βόσκειν σὴν γαστέρ’ ἄναλτον.	-uu - u u- -- - -u u--	dactylic hexameter	masculine penthemimeral, hepthemimeral, trithemimeral
τὸν δ’ἀπαμειβόμενος προσέφη πολύμητις Ὀδυσσεύς·	- uu-uu- uu- uu-u u--	dactylic hexameter	masculine penthemimeral, hepthemimeral
Εὐρύμαχ’, εἰ γὰρ νῶϊν ἔρις ἔργοιο γένοιτο	-uu - - -u u- --u u--	dactylic hexameter	feminine penthemimeral, hepthemimeral, trithemimeral
ὥρῃ ἐν εἰαρινῇ, ὅτε τ’ἤματα μακρὰ πέλονται,	-u u -uu- uu -uu -u u--	dactylic hexameter	masculine penthemimeral
ἐν ποίῃ, δρέπανον μὲν ἐγὼν εὐκαμπὲς ἔχοιμι,	- -- uu- u u- --u u--	dactylic hexameter	masculine penthemimeral, hepthemimeral, trithemimeral
καὶ δὲ σὺ τοῖον ἔχοις, ἵνα πειρησαίμεθα ἔργου	- u u -u u- uu ---uu --	dactylic hexameter	masculine penthemimeral
νήστιες ἄχρι μάλα κνέφαος, ποίη δὲ παρείη.	-uu -u u- uu- -- u u--	dactylic hexameter	masculine penthemimeral, hepthemimeral
εἰ δ’αὖ καὶ βόες εἶεν ἐλαυνέμεν, οἵ περ ἄριστοι,	- - - uu -u u-uu - u u--	dactylic hexameter	feminine penthemimeral, trithemimeral
αἴθωνες, μεγάλοι, ἄμφω κεκορηότε ποίης,	--- uu- -- uu-uu --	dactylic hexameter	masculine penthemimeral, hepthemimeral, trithemimeral
ἥλικες, ἰσοφόροι, τῶν τε σθένος οὐκ ἀλαπαδνόν,	-uu -uu- - - uu - uu--	dactylic hexameter	masculine penthemimeral, hepthemimeral
τετράγυον δ’εἴη, εἴκοι δ’ὑπὸ βῶλος ἀρότρῳ·	-uu- -- -- uu -u u--	dactylic hexameter	masculine penthemimeral, hepthemimeral, trithemimeral
τῶ κέ μ’ἴδοις, εἰ ὧλκα διηνεκέα προταμοίμην.	- u u- - -u u-uu- uu--	dactylic hexameter	feminine penthemimeral, trithemimeral
εἰ δ’αὖ καὶ πόλεμόν ποθεν ὁρμήσειε Κρονίων	- - - uu- uu ---u u--	dactylic hexameter	masculine penthemimeral, trithemimeral
σήμερον, αὐτὰρ ἐμοὶ σάκος εἴη καὶ δύο δοῦρε	-uu -u u- uu -- - uu --	dactylic hexameter	masculine penthemimeral
καὶ κυνέη πάγχαλκος, ἐπὶ κροτάφοις ἀραρυῖα,	- uu- --u u- uu- uu--	dactylic hexameter	feminine penthemimeral, hepthemimeral, trithemimeral
τῶ κέ μ’ἴδοις πρώτοισιν ἐνὶ προμάχοισι μιγέντα,	- u u- --u u- uu-u u--	dactylic hexameter	feminine penthemimeral, hepthemimeral, trithemimeral
οὐδ’ ἄν μοι τὴν γαστέρ’ ὀνειδίζων ἀγορεύοις.	- - - - -u u--- uu--	dactylic hexameter	feminine penthemimeral, trithemimeral
ἀλλὰ μάλ’ ὑβρίζεις, καί τοι νόος ἐστὶν ἀπηνής·	-u u --- - - uu -u u--	dactylic hexameter	masculine penthemimeral, hepthemimeral
καί πού τις δοκέεις μέγας ἔμμεναι ἠδὲ κραταιός,	- - - uu- uu -uu -u u--	dactylic hexameter	masculine penthemimeral, trithemimeral
οὕνεκα πὰρ παύροισι καὶ οὐκ ἀγαθοῖσιν ὁμιλεῖς.	-uu - --u u - uu-u u--	dactylic hexameter	feminine penthemimeral, hepthemimeral, trithemimeral
εἰ δ’Ὀδυσεὺς ἔλθοι καὶ ἵκοιτ’ ἐς πατρίδα γαῖαν,	- uu- -- u u- - -uu --	dactylic hexameter	masculine penthemimeral, hepthemimeral, trithemimeral
αἶψά κέ τοι τὰ θύρετρα, καὶ εὐρέα περ μάλ’ ἐόντα,	-u u - u u-u u -uu - u u--	dactylic hexameter	feminine penthemimeral, trithemimeral
φεύγοντι στείνοιτο διὲκ προθύροιο θύραζε.	--- --u u- uu-u u--	dactylic hexameter	feminine penthemimeral, hepthemimeral, trithemimeral
ὣς ἔφατ’, Εὐρύμαχος δὲ χολώσατο κηρόθι μᾶλλον,	- uu -uu- u u-uu -uu --	dactylic hexameter	masculine penthemimeral
καί μιν ὑπόδρα ἰδὼν ἔπεα πτερόεντα προσηύδα·	- u u-u u- uu- uu-u u--	dactylic hexameter	masculine penthemimeral, hepthemimeral
ἆ δείλ’, ἦ τάχα τοι τελέω κακόν, οἷ’ ἀγορεύεις	- - - uu - uu- uu - uu--	dactylic hexameter	masculine penthemimeral, hepthemimeral, trithemimeral
θαρσαλέως πολλοῖσι μετ’ ἀνδράσιν, οὐδέ τι θυμῷ	-uu- --u u -uu -u u --	dactylic hexameter	feminine penthemimeral, trithemimeral
ταρβεῖς· ἦ ῥά σε οἶνος ἔχει φρένας, ἤ νύ τοι αἰεὶ	-- - u u -u u- uu - u u --	dactylic hexameter	feminine penthemimeral, hepthemimeral, trithemimeral
τοιοῦτος νόος ἐστίν· ὃ καὶ μεταμώνια βάζεις.	--- uu -u u - uu-uu --	dactylic hexameter	feminine penthemimeral, hepthemimeral, trithemimeral
ἦ ἀλύεις, ὅτι Ἶρον ἐνίκησας τὸν ἀλήτην;	- uu- uu -u u--- u u--	dactylic hexameter	feminine penthemimeral, trithemimeral
ὣς ἄρα φωνήσας σφέλας ἔλλαβεν· αὐτὰρ Ὀδυσσεὺς	- uu --- uu -uu -u u--	dactylic hexameter	masculine penthemimeral
Ἀμφινόμου πρὸς γοῦνα καθέζετο Δουλιχιῆος,	-uu- - -u u-uu -uu--	dactylic hexameter	feminine penthemimeral, trithemimeral
Εὐρύμαχον δείσας· ὁ δ’ἄρ’ οἰνοχόον βάλε χεῖρα	-uu- -- u u -uu- uu --	dactylic hexameter	masculine penthemimeral, trithemimeral
δεξιτερήν· πρόχοος δὲ χαμαὶ βόμβησε πεσοῦσα,	-uu- uu- u u- --u u--	dactylic hexameter	masculine penthemimeral, hepthemimeral, trithemimeral
αὐτὰρ ὅ γ’οἰμώξας πέσεν ὕπτιος ἐν κονίῃσι.	-u u --- uu -uu - uu--	dactylic hexameter	masculine penthemimeral
μνηστῆρες δ’ὁμάδησαν ἀνὰ μέγαρα σκιόεντα,	--- uu-u u- uu- uu--	dactylic hexameter	feminine penthemimeral, hepthemimeral, trithemimeral
ὦδε δέ τις εἴπεσκεν ἰδὼν ἐς πλησίον ἄλλον·	-u u - --u u- - -uu --	dactylic hexameter	feminine penthemimeral, hepthemimeral, trithemimeral
αἴθ’ ὤφελλ’ ὁ ξεῖνος ἀλώμενος ἄλλοθ’ ὀλέσθαι	- -- - -u u-uu -u u--	dactylic hexameter	feminine penthemimeral, trithemimeral
πρὶν ἐλθεῖν· τῶ κ’οὔ τι τόσον κέλαδον μετέθηκε.	- -- - - u u- uu- uu--	dactylic hexameter	masculine penthemimeral, hepthemimeral, trithemimeral
νῦν δὲ περὶ πτωχῶν ἐριδαίνομεν, οὐδέ τι δαιτὸς	- u u- -- uu-uu -u u --	dactylic hexameter	masculine penthemimeral, trithemimeral
ἐσθλῆς ἔσσεται ἦδος, ἐπεὶ τὰ χερείονα νικᾷ.	-- -uu -u u- u u-uu --	dactylic hexameter	feminine penthemimeral, hepthemimeral
τοῖσι δὲ καὶ μετέειφ’ ἱερὴ ἲς Τηλεμάχοιο	-u u - uu- uu- - -uu--	dactylic hexameter	masculine penthemimeral, hepthemimeral, trithemimeral
δαιμόνιοι, μαίνεσθε καὶ οὐκέτι κεύθετε θυμῷ	-uu- --u u -uu -uu --	dactylic hexameter	feminine penthemimeral, trithemimeral
βρωτὺν οὐδὲ ποτῆτα· θεῶν νύ τις ὔμμ’ ὀροθύνει.	-- -u u-u u- u u - uu--	dactylic hexameter	feminine penthemimeral, hepthemimeral
ἀλλ’ εὖ δαισάμενοι κατακείετε οἴκαδ’ ἰόντες,	- - -uu- uu-uu -u u--	dactylic hexameter	masculine penthemimeral
ὁππότε θυμὸς ἄνωγε· διώκω δ’οὔ τιν’ ἔγωγε.	-uu -u u-u u-- - u u--	dactylic hexameter	feminine penthemimeral
ὣς ἔφαθ’, οἱ δ’ἄρα πάντες ὀδὰξ ἐν χείλεσι φύντες	- uu - uu -u u- - -uu --	dactylic hexameter	feminine penthemimeral, hepthemimeral, trithemimeral
Τηλέμαχον θαύμαζον, ὃ θαρσαλέως ἀγόρευε.	-uu- --u u -uu- uu--	dactylic hexameter	feminine penthemimeral, trithemimeral
τοῖσιν δ’Ἀμφίνομος ἀγορήσατο καὶ μετέειπε	-- -uu- uu-uu - uu--	dactylic hexameter	masculine penthemimeral
Νίσου φαίδιμος υἱός, Ἀρητιάδαο ἄνακτος·	-- -uu -u u-uu-u u--	dactylic hexameter	feminine penthemimeral
ὧ φίλοι, οὐκ ἂν δή τις ἐπὶ ῥηθέντι δικαίῳ	- uu - - - u u- --u u--	dactylic hexameter	masculine penthemimeral, hepthemimeral, trithemimeral
ἀντιβίοις ἐπέεσσι καθαπτόμενος χαλεπαίνοι·	-uu- uu-u u-uu- uu--	dactylic hexameter	feminine penthemimeral, trithemimeral
μήτε τι τὸν ξεῖνον στυφελίζετε μήτε τιν’ ἄλλον	-u u - -- uu-uu -u u --	dactylic hexameter	masculine penthemimeral, trithemimeral
δμώων, οἳ κατὰ δώματ’ Ὀδυσσῆος θείοιο.	-- - uu -u u--- ---	dactylic hexameter	feminine penthemimeral, trithemimeral
ἀλλ’ ἄγετ’, οἰνοχόος μὲν ἐπαρξάσθω δεπάεσσιν,	- uu -uu- u u--- uu--	dactylic hexameter	masculine penthemimeral
ὄφρα σπείσαντες κατακείομεν οἴκαδ’ ἰόντες·	-- --- uu-uu -u u--	dactylic hexameter	masculine penthemimeral
τὸν ξεῖνον δὲ ἐῶμεν ἐνὶ μεγάροις Ὀδυσῆος	- -- u u-u u- uu- uu--	dactylic hexameter	feminine penthemimeral, hepthemimeral, trithemimeral
Τηλεμάχῳ μελέμεν· τοῦ γὰρ φίλον ἵκετο δῶμα.	-uu- uu- - - uu -uu --	dactylic hexameter	masculine penthemimeral, hepthemimeral, trithemimeral
ὣς φάτο, τοῖσι δὲ πᾶσιν ἑαδότα μῦθον ἔειπε.	- uu -u u -u u-uu -u u--	dactylic hexameter	feminine penthemimeral
τοῖσιν δὲ κρητῆρα κεράσσατο Μούλιος ἥρως,	-- - --u u-uu -uu --	dactylic hexameter	feminine penthemimeral, trithemimeral
κῆρυξ Δουλιχιεύς· θεράπων δ’ἦν Ἀμφινόμοιο·	-- -uu- uu- - -uu--	dactylic hexameter	masculine penthemimeral, hepthemimeral
νώμησεν δ’ἄρα πᾶσιν ἐπισταδόν· οἱ δὲ θεοῖσι	--- uu -u u-uu - u u--	dactylic hexameter	feminine penthemimeral, trithemimeral
λείψαντες μακάρεσσι πίον μελιηδέα οἶνον.	--- uu-u u- uu-uu --	dactylic hexameter	feminine penthemimeral, hepthemimeral, trithemimeral
αὐτὰρ ἐπεὶ σπεῖσάν τ’ἔπιόν θ’ὅσον ἤθελε θυμός,	-u u- -- uu- uu -uu --	dactylic hexameter	masculine penthemimeral, hepthemimeral, trithemimeral
βάν ῥ’ἴμεναι κείοντες ἑὰ πρὸς δώμαθ’ ἕκαστος.	- uu- --u u- - -u u--	dactylic hexameter	feminine penthemimeral, hepthemimeral, trithemimeral
