αὐτὰρ ὁ ἐκ λιμένος προσέβη τρηχεῖαν ἀταρπὸν	-u u - uu- uu- --u u--	dactylic hexameter	masculine penthemimeral, hepthemimeral, trithemimeral
χῶρον ἀν’ ὑλήεντα δι’ ἄκριας, ᾗ οἱ Ἀθήνη	-u u ---u u -uu - u u--	dactylic hexameter	feminine penthemimeral
πέφραδε δῖον ὑφορβόν, ὅ οἱ βιότοιο μάλιστα	-uu -u u-u u - uu-u u--	dactylic hexameter	feminine penthemimeral, hepthemimeral
κήδετο οἰκήων, οὓς κτήσατο δῖος Ὀδυσσεύς.	-uu --- - -uu -u u--	dactylic hexameter	masculine penthemimeral
τὸν δ’ἄρ’ ἐνὶ προδόμῳ εὗρ’ ἥμενον, ἔνθα οἱ αὐλὴ	- u u- uu- - -uu -u u --	dactylic hexameter	masculine penthemimeral, trithemimeral
ὑψηλὴ δέδμητο, περισκέπτῳ ἐνὶ χώρῳ,	--- --u u--- uu --	dactylic hexameter	feminine penthemimeral, trithemimeral
καλή τε μεγάλη τε, περίδρομος· ἥν ῥα συβώτης	-- - uu- u u-uu - u u--	dactylic hexameter	masculine penthemimeral, trithemimeral
αὐτὸς δείμαθ’ ὕεσσιν ἀποιχομένοιο ἄνακτος,	-- -u u-u u-uu-u u--	dactylic hexameter	feminine penthemimeral
νόσφιν δεσποίνης καὶ Λαέρταο γέροντος,	-- --- - ---u u--	dactylic hexameter	masculine penthemimeral
ῥυτοῖσιν λάεσσι καὶ ἐθρίγκωσεν ἀχέρδῳ·	--- --u u ---u u--	dactylic hexameter	feminine penthemimeral, trithemimeral
σταυροὺς δ’ἐκτὸς ἔλασσε διαμπερὲς ἔνθα καὶ ἔνθα,	-- -u u-u u-uu -u u --	dactylic hexameter	feminine penthemimeral
πυκνοὺς καὶ θαμέας, τὸ μέλαν δρυὸς ἀμφικεάσσας·	-- - uu- u u- uu -uu--	dactylic hexameter	masculine penthemimeral, hepthemimeral, trithemimeral
ἔντοσθεν δ’αὐλῆς συφεοὺς δυοκαίδεκα ποίει	--- -- uu- uu-uu --	dactylic hexameter	masculine penthemimeral, hepthemimeral, trithemimeral
πλησίον ἀλλήλων, εὐνὰς συσίν· ἐν δὲ ἑκάστῳ	-uu --- -- uu - u u--	dactylic hexameter	masculine penthemimeral, hepthemimeral
πεντήκοντα σύες χαμαιευνάδες ἐρχατόωντο,	---u u- uu-uu -uu--	dactylic hexameter	masculine penthemimeral
θήλειαι τοκάδες· τοὶ δ’ἄρσενες ἐκτὸς ἴαυον,	--- uu- - -uu -u u--	dactylic hexameter	masculine penthemimeral, trithemimeral
πολλὸν παυρότεροι· τοὺς γὰρ μινύθεσκον ἔδοντες	-- -uu- - - uu-u u--	dactylic hexameter	masculine penthemimeral, hepthemimeral
ἀντίθεοι μνηστῆρες, ἐπεὶ προΐαλλε συβώτης	-uu- --u u- uu-u u--	dactylic hexameter	feminine penthemimeral, hepthemimeral, trithemimeral
αἰεὶ ζατρεφέων σιάλων τὸν ἄριστον ἁπάντων·	-- -uu- uu- u u-u u--	dactylic hexameter	masculine penthemimeral, hepthemimeral
οἱ δὲ τριηκόσιοί τε καὶ ἑξήκοντα πέλοντο.	- u u-uu- u u ---u u--	dactylic hexameter	masculine penthemimeral
πὰρ δὲ κύνες, θήρεσσιν ἐοικότες αἰὲν ἴαυον	- u u- --u u-uu -u u--	dactylic hexameter	feminine penthemimeral, trithemimeral
τέσσαρες, οὓς ἔθρεψε συβώτης, ὄρχαμος ἀνδρῶν.	-uu - --u u-- -uu --	dactylic hexameter	feminine penthemimeral, trithemimeral
αὐτὸς δ’ἀμφὶ πόδεσσιν ἑοῖς ἀράρισκε πέδιλα,	-- -u u-u u ---u u--	dactylic hexameter	feminine penthemimeral
τάμνων δέρμα βόειον ἐϋχροές· οἱ δὲ δὴ ἄλλοι	-- -u u-u u-uu - u u --	dactylic hexameter	feminine penthemimeral
ᾤχοντ’ ἄλλυδις ἄλλος ἅμ’ ἀγρομένοισι σύεσσιν,	-- -uu -u u -uu-u u--	dactylic hexameter	feminine penthemimeral
οἱ τρεῖς· τὸν δὲ τέταρτον ἀποπροέηκε πόλινδε	- - - u u-u u-uu-u u--	dactylic hexameter	feminine penthemimeral, trithemimeral
σῦν ἀγέμεν μνηστῆρσιν ὑπερφιάλοισιν ἀνάγκῃ,	- uu- --u u-uu-u u--	dactylic hexameter	feminine penthemimeral, trithemimeral
ὄφρ’ ἱερεύσαντες κρειῶν κορεσαίατο θυμόν.	- uu--- -- uu-uu --	dactylic hexameter	masculine penthemimeral, hepthemimeral
ἐξαπίνης δ’Ὀδυσῆα ἴδον κύνες ὑλακόμωροι.	-uu- uu-u u- uu -uu--	dactylic hexameter	feminine penthemimeral, hepthemimeral, trithemimeral
οἱ μὲν κεκλήγοντες ἐπέδραμον· αὐτὰρ Ὀδυσσεὺς	- - ---u u-uu -u u--	dactylic hexameter	feminine penthemimeral
ἕζετο κερδοσύνῃ, σκῆπτρον δέ οἱ ἔκπεσε χειρός.	-uu -uu- -- u u -uu --	dactylic hexameter	masculine penthemimeral, hepthemimeral
ἔνθα κεν ᾧ παρὰ σταθμῷ ἀεικέλιον πάθεν ἄλγος·	-- u - -- -- --uu- uu -u	lyric	
ἀλλὰ συβώτης ὦκα ποσὶ κραιπνοῖσι μετασπὼν	-u u-- -u u- --u u--	dactylic hexameter	feminine penthemimeral, hepthemimeral
ἔσσυτ’ ἀνὰ πρόθυρον, σκῦτος δέ οἱ ἔκπεσε χειρός.	-u u- uu- -- u u -uu --	dactylic hexameter	masculine penthemimeral, hepthemimeral, trithemimeral
τοὺς μὲν ὁμοκλήσας σεῦεν κύνας ἄλλυδις ἄλλον	- u u--- -- uu -uu --	dactylic hexameter	masculine penthemimeral, hepthemimeral
πυκνῇσιν λιθάδεσσιν· ὁ δὲ προσέειπεν ἄνακτα·	--- uu-u u - uu-u u--	dactylic hexameter	feminine penthemimeral, hepthemimeral, trithemimeral
ὦ γέρον, ἦ ὀλίγου σε κύνες διεδηλήσαντο	- uu - uu- u u- uu----	dactylic hexameter	masculine penthemimeral, hepthemimeral, trithemimeral
ἐξαπίνης, καί κέν μοι ἐλεγχείην κατέχευας.	-uu- - - u u--- uu--	dactylic hexameter	masculine penthemimeral, trithemimeral
καὶ δέ μοι ἄλλα θεοὶ δόσαν ἄλγεά τε στοναχάς τε·	- u u -u u- uu -uu - uu- -	dactylic hexameter	masculine penthemimeral
ἀντιθέου γὰρ ἄνακτος ὀδυρόμενος καὶ ἀχεύων	-uu- u u-u u-uu- u u--	dactylic hexameter	feminine penthemimeral, trithemimeral
ἧμαι, ἄλλοισιν δὲ σύας σιάλους ἀτιτάλλω	-- --- u u- uu- uu--	dactylic hexameter	masculine penthemimeral, hepthemimeral
ἔδμεναι· αὐτὰρ κεῖνος ἐελδόμενός που ἐδωδῆς	-uu -- -u u-uu- u u--	dactylic hexameter	feminine penthemimeral
πλάζετ’ ἐπ’ ἀλλοθρόων ἀνδρῶν δῆμόν τε πόλιν τε,	-u u -uu- -- -- u u- -	dactylic hexameter	masculine penthemimeral, hepthemimeral
εἴ που ἔτι ζώει καὶ ὁρᾷ φάος ἠελίοιο.	- u u- -- u u- uu -uu--	dactylic hexameter	masculine penthemimeral, hepthemimeral, trithemimeral
ἀλλ’ ἕπεο, κλισίηνδ’ ἴομεν, γέρον, ὄφρα καὶ αὐτός,	- uu- uu- uu- uu -u u --	dactylic hexameter	masculine penthemimeral, hepthemimeral, trithemimeral
σίτου καὶ οἴνοιο κορεσσάμενος κατὰ θυμόν,	-- - --u u-uu- uu --	dactylic hexameter	feminine penthemimeral, trithemimeral
εἴπῃς ὁππόθεν ἐσσὶ καὶ ὁππόσα κήδε’ ἀνέτλης.	-- -uu -u u -uu -u u--	dactylic hexameter	feminine penthemimeral
ὣς εἰπὼν κλισίηνδ’ ἡγήσατο δῖος ὑφορβός,	- -- uu- --uu -u u--	dactylic hexameter	masculine penthemimeral, trithemimeral
εἷσεν δ’εἰσαγαγών, ῥῶπας δ’ὑπέχευε δασείας,	-- -uu- -- uu-u u--	dactylic hexameter	masculine penthemimeral, hepthemimeral
ἐστόρεσεν δ’ἐπὶ δέρμα ἰονθάδος ἀγρίου αἰγός,	-uu- uu -u u-uu -uu --	dactylic hexameter	feminine penthemimeral, trithemimeral
αὐτοῦ ἐνεύναιον, μέγα καὶ δασύ. χαῖρε δ’Ὀδυσσεὺς	-u u--- uu - uu -u u--	dactylic hexameter	masculine penthemimeral, hepthemimeral
ὅττι μιν ὣς ὑπέδεκτο, ἔπος τ’ἔφατ’ ἔκ τ’ὀνόμαζε·	-u u - uu-u u- uu - uu--	dactylic hexameter	feminine penthemimeral, hepthemimeral, trithemimeral
Ζεύς τοι δοίη, ξεῖνε, καὶ ἀθάνατοι θεοὶ ἄλλοι	- - -- -u u -uu- uu --	dactylic hexameter	feminine penthemimeral
ὅττι μάλιστ’ ἐθέλεις, ὅτι με πρόφρων ὑπέδεξο.	-u u- uu- uu - -- uu--	dactylic hexameter	masculine penthemimeral, hepthemimeral, trithemimeral
τὸν δ’ἀπαμειβόμενος προσέφης, Εὔμαιε συβῶτα·	- uu-uu- uu- --u u--	dactylic hexameter	masculine penthemimeral, hepthemimeral
ξεῖν’, οὔ μοι θέμις ἔστ’, οὐδ’ εἰ κακίων σέθεν ἔλθοι,	- - - uu - - - uu- uu --	dactylic hexameter	masculine penthemimeral, hepthemimeral, trithemimeral
ξεῖνον ἀτιμῆσαι· πρὸς γὰρ Διός εἰσιν ἅπαντες	-u u--- - - uu -u u--	dactylic hexameter	masculine penthemimeral, hepthemimeral
ξεῖνοί τε πτωχοί τε· δόσις δ’ὀλίγη τε φίλη τε	-- - -- u u- uu- u u- -	dactylic hexameter	masculine penthemimeral, hepthemimeral, trithemimeral
γίνεται ἡμετέρη· ἡ γὰρ δμώων δίκη ἐστὶν	-uu -uu- - - -- uu --	dactylic hexameter	masculine penthemimeral, hepthemimeral
αἰεὶ δειδιότων, ὅτ’ ἐπικρατέωσιν ἄνακτες	-- -uu- u u-uu-u u--	dactylic hexameter	masculine penthemimeral
οἱ νέοι. ἦ γὰρ τοῦ γε θεοὶ κατὰ νόστον ἔδησαν,	- uu - - - u u- uu -u u--	dactylic hexameter	masculine penthemimeral, hepthemimeral, trithemimeral
ὅς κεν ἔμ’ ἐνδυκέως ἐφίλει καὶ κτῆσιν ὄπασσεν,	- u u -uu- uu- - -u u--	dactylic hexameter	masculine penthemimeral, hepthemimeral
οἶκόν τε κλῆρόν τε πολυμνήστην τε γυναῖκα,	-- - -- u u--- u u--	dactylic hexameter	masculine penthemimeral, trithemimeral
οἷά τε ᾧ οἰκῆϊ ἄναξ εὔθυμος ἔδωκεν,	-u u - --u u- --u u--	dactylic hexameter	feminine penthemimeral, hepthemimeral, trithemimeral
ὅς οἱ πολλὰ κάμῃσι, θεὸς δ’ἐπὶ ἔργον ἀέξῃ,	- - -u u-u u- uu -u u--	dactylic hexameter	feminine penthemimeral, hepthemimeral
ὡς καὶ ἐμοὶ τόδε ἔργον ἀέξεται, ᾧ ἐπιμίμνω.	- u u- uu -u u-uu - uu--	dactylic hexameter	feminine penthemimeral, trithemimeral
τῶ κέ με πόλλ’ ὤνησεν ἄναξ, εἰ αὐτόθ’ ἐγήρα·	- u u - --u u- - -u u--	dactylic hexameter	feminine penthemimeral, hepthemimeral, trithemimeral
ἀλλ’ ὄλεθ’ ὡς ὤφελλ’ Ἑλένης ἀπὸ φῦλον ὀλέσθαι	- uu - -- uu- uu -u u--	dactylic hexameter	masculine penthemimeral, hepthemimeral, trithemimeral
πρόχνυ, ἐπεὶ πολλῶν ἀνδρῶν ὑπὸ γούνατ’ ἔλυσε·	-u u- -- -- uu -u u--	dactylic hexameter	masculine penthemimeral, hepthemimeral, trithemimeral
καὶ γὰρ κεῖνος ἔβη Ἀγαμέμνονος εἵνεκα τιμῆς	- - -u u- uu-uu -uu --	dactylic hexameter	masculine penthemimeral
Ἴλιον εἰς εὔπωλον, ἵνα Τρώεσσι μάχοιτο.	-uu - --u u- --u u--	dactylic hexameter	feminine penthemimeral, hepthemimeral, trithemimeral
ὣς εἰπὼν ζωστῆρι θοῶς συνέεργε χιτῶνα,	- -- --u u- uu-u u--	dactylic hexameter	feminine penthemimeral, hepthemimeral, trithemimeral
βῆ δ’ἴμεν ἐς συφεούς, ὅθι ἔθνεα ἔρχατο χοίρων.	- uu - uu- uu -uu -uu --	dactylic hexameter	masculine penthemimeral, trithemimeral
ἔνθεν ἑλὼν δύ’ ἔνεικε καὶ ἀμφοτέρους ἱέρευσεν,	-u u- u u-u u -uu- uu--	dactylic hexameter	feminine penthemimeral, trithemimeral
εὗσεν μίστυλλέν τε καὶ ἀμφ’ ὀβελοῖσιν ἔπειρεν.	-- --- u u - uu-u u--	dactylic hexameter	masculine penthemimeral, hepthemimeral
ὀπτήσας δ’ἄρα πάντα φέρων παρέθηκ’ Ὀδυσῆϊ	--- uu -u u- uu- uu--	dactylic hexameter	feminine penthemimeral, hepthemimeral, trithemimeral
θέρμ’ αὐτοῖς ὀβελοῖσιν· ὁ δ’ἄλφιτα λευκὰ πάλυνεν·	- -- uu-u u -uu -u u--	dactylic hexameter	feminine penthemimeral, trithemimeral
ἐν δ’ἄρα κισσυβίῳ κίρνη μελιηδέα οἶνον,	- uu -uu- -- uu-uu --	dactylic hexameter	masculine penthemimeral, hepthemimeral
αὐτὸς δ’ἀντίον ἷζεν, ἐποτρύνων δὲ προσηύδα·	-- -uu -u u--- u u--	dactylic hexameter	feminine penthemimeral
ἔσθιε νῦν, ὦ ξεῖνε, τά τε δμώεσσι πάρεστι,	-uu - - -u u - --u u--	dactylic hexameter	feminine penthemimeral, hepthemimeral, trithemimeral
χοίρε’· ἀτὰρ σιάλους γε σύας μνηστῆρες ἔδουσιν,	-u u- uu- u u- --u u--	dactylic hexameter	masculine penthemimeral, hepthemimeral, trithemimeral
οὐκ ὄπιδα φρονέοντες ἐνὶ φρεσὶν οὐδ’ ἐλεητύν.	- uu- uu-u u- uu - uu--	dactylic hexameter	feminine penthemimeral, hepthemimeral, trithemimeral
οὐ μὲν σχέτλια ἔργα θεοὶ μάκαρες φιλέουσιν,	- - -uu -u u- uu- uu--	dactylic hexameter	feminine penthemimeral, hepthemimeral
ἀλλὰ δίκην τίουσι καὶ αἴσιμα ἔργ’ ἀνθρώπων.	-u u- --u u -uu - ---	dactylic hexameter	feminine penthemimeral, trithemimeral
καὶ μὲν δυσμενέες καὶ ἀνάρσιοι, οἵ τ’ἐπὶ γαίης	- - -uu- u u-uu - uu --	dactylic hexameter	masculine penthemimeral
ἀλλοτρίης βῶσιν καί σφιν Ζεὺς ληΐδα δώῃ,	-uu- -- - - - -uu --	dactylic hexameter	masculine penthemimeral, hepthemimeral, trithemimeral
πλησάμενοι δέ τε νῆας ἔβαν οἶκόνδε νέεσθαι,	-uu- u u -u u- --u u--	dactylic hexameter	feminine penthemimeral, hepthemimeral, trithemimeral
καὶ μὲν τοῖς ὄπιδος κρατερὸν δέος ἐν φρεσὶ πίπτει.	- - - uu- uu- uu - uu --	dactylic hexameter	masculine penthemimeral, hepthemimeral, trithemimeral
οἵδε δέ τοι ἴσασι, θεοῦ δέ τιν’ ἔκλυον αὐδήν,	-u u - --u u- u u -uu --	dactylic hexameter	feminine penthemimeral, hepthemimeral, trithemimeral
κείνου λυγρὸν ὄλεθρον, ὅ τ’οὐκ ἐθέλουσι δικαίως	-- -u u-u u - uu-u u--	dactylic hexameter	feminine penthemimeral, hepthemimeral
μνᾶσθαι οὐδὲ νέεσθαι ἐπὶ σφέτερ’, ἀλλὰ ἕκηλοι	-- -u u-u u- uu -u u--	dactylic hexameter	feminine penthemimeral, hepthemimeral
κτήματα δαρδάπτουσιν ὑπέρβιον, οὐδ’ ἔπι φειδώ.	-uu ---u u-uu - uu --	dactylic hexameter	feminine penthemimeral
ὅσσαι γὰρ νύκτες τε καὶ ἡμέραι ἐκ Διός εἰσιν,	-- - -- u u -uu - uu --	dactylic hexameter	masculine penthemimeral, trithemimeral
οὔ ποθ’ ἓν ἱρεύουσ’ ἱερήϊον, οὐδὲ δύ’ οἶα·	- u u --- uu-uu -u u --	dactylic hexameter	masculine penthemimeral
οἶνον δὲ φθινύθουσιν ὑπέρβιον ἐξαφύοντες.	-- - uu-u u-uu -uu--	dactylic hexameter	feminine penthemimeral, trithemimeral
ἦ γάρ οἱ ζωή γ’ἦν ἄσπετος· οὔ τινι τόσση	- - - -- - -uu - uu --	dactylic hexameter	masculine penthemimeral, trithemimeral
ἀνδρῶν ἡρώων, οὔτ’ ἠπείροιο μελαίνης	-- --- - ---u u--	dactylic hexameter	masculine penthemimeral
οὔτ’ αὐτῆς Ἰθάκης· οὐδὲ ξυνεείκοσι φωτῶν	- -- uu- -- uu-uu --	dactylic hexameter	masculine penthemimeral, hepthemimeral, trithemimeral
ἔστ’ ἄφενος τοσσοῦτον· ἐγὼ δέ κέ τοι καταλέξω.	- uu- --u u- u u - uu--	dactylic hexameter	feminine penthemimeral, hepthemimeral, trithemimeral
δώδεκ’ ἐν ἠπείρῳ ἀγέλαι· τόσα πώεα οἰῶν,	-u u --- uu- uu -uu --	dactylic hexameter	masculine penthemimeral, hepthemimeral
τόσσα συῶν συβόσια, τόσ’ αἰπόλια πλατέ’ αἰγῶν	-u u- uu-u u -uu- uu --	dactylic hexameter	feminine penthemimeral, trithemimeral
βόσκουσι ξεῖνοί τε καὶ αὐτοῦ βώτορες ἄνδρες.	--- -- u u -- -uu --	dactylic hexameter	masculine penthemimeral, trithemimeral
ἐνθάδε τ’αἰπόλια πλατέ’ αἰγῶν ἕνδεκα πάντα	-uu -uu- uu -- -uu --	dactylic hexameter	masculine penthemimeral
ἐσχατιῇ βόσκοντ’, ἐπὶ δ’ἀνέρες ἐσθλοὶ ὄρονται.	-uu- -- uu -uu -u u--	dactylic hexameter	masculine penthemimeral, trithemimeral
τῶν αἰεί σφιν ἕκαστος ἐπ’ ἤματι μῆλον ἀγινεῖ,	- -- u u-u u -uu -u u--	dactylic hexameter	feminine penthemimeral, trithemimeral
ζατρεφέων αἰγῶν ὅς τις φαίνηται ἄριστος.	-uu- -- - - --u u--	dactylic hexameter	masculine penthemimeral, hepthemimeral, trithemimeral
αὐτὰρ ἐγὼ σῦς τάσδε φυλάσσω τε ῥύομαί τε,	-u u- - -u u-- - uu- -	dactylic hexameter	feminine penthemimeral, trithemimeral
καί σφι συῶν τὸν ἄριστον ἐῢ κρίνας ἀποπέμπω.	- u u- u u-u u- -- uu--	dactylic hexameter	feminine penthemimeral, hepthemimeral, trithemimeral
ὣς φάθ’, ὁ δ’ἐνδυκέως κρέα τ’ἤσθιε πῖνέ τε οἶνον	- u u -uu- uu -uu -u u --	dactylic hexameter	masculine penthemimeral
ἁρπαλέως ἀκέων, κακὰ δὲ μνηστῆρσι φύτευεν.	-uu- uu- uu - --u u--	dactylic hexameter	masculine penthemimeral, hepthemimeral, trithemimeral
αὐτὰρ ἐπεὶ δείπνησε καὶ ἤραρε θυμὸν ἐδωδῇ,	-u u- --u u -uu -u u--	dactylic hexameter	feminine penthemimeral, trithemimeral
καί οἱ πλησάμενος δῶκε σκύφος, ᾧ περ ἔπινεν,	- - -uu- -- uu - u u--	dactylic hexameter	masculine penthemimeral, hepthemimeral
οἴνου ἐνίπλειον· ὁ δ’ἐδέξατο, χαῖρε δὲ θυμῷ,	-u u--- u u-uu -u u --	dactylic hexameter	masculine penthemimeral
καί μιν φωνήσας ἔπεα πτερόεντα προσηύδα·	- - --- uu- uu-u u--	dactylic hexameter	masculine penthemimeral, hepthemimeral
ὦ φίλε, τίς γάρ σε πρίατο κτεάτεσσιν ἑοῖσιν,	- uu - - - uu- uu-u u--	dactylic hexameter	masculine penthemimeral, hepthemimeral, trithemimeral
ὧδε μάλ’ ἀφνειὸς καὶ καρτερὸς ὡς ἀγορεύεις;	-u u --- - -uu - uu--	dactylic hexameter	masculine penthemimeral
φῇς δ’αὐτὸν φθίσθαι Ἀγαμέμνονος εἵνεκα τιμῆς.	- -- -- uu-uu -uu --	dactylic hexameter	masculine penthemimeral, trithemimeral
εἰπέ μοι, αἴ κέ ποθι γνώω τοιοῦτον ἐόντα.	-u u - u u- -- --u u--	dactylic hexameter	masculine penthemimeral, hepthemimeral, trithemimeral
Ζεὺς γάρ που τό γε οἶδε καὶ ἀθάνατοι θεοὶ ἄλλοι,	- - - u u -u u -uu- uu --	dactylic hexameter	feminine penthemimeral, trithemimeral
εἴ κέ μιν ἀγγείλαιμι ἰδών· ἐπὶ πολλὰ δ’ἀλήθην.	- u u ---u u- uu -u u--	dactylic hexameter	feminine penthemimeral, hepthemimeral
τὸν δ’ἠμείβετ’ ἔπειτα συβώτης, ὄρχαμος ἀνδρῶν·	- --u u-u u-- -uu --	dactylic hexameter	feminine penthemimeral
ὦ γέρον, οὔ τις κεῖνον ἀνὴρ ἀλαλήμενος ἐλθὼν	- uu - - -u u- uu-uu --	dactylic hexameter	feminine penthemimeral, hepthemimeral, trithemimeral
ἀγγέλλων πείσειε γυναῖκά τε καὶ φίλον υἱόν,	--- --u u-u u - uu --	dactylic hexameter	feminine penthemimeral, trithemimeral
ἀλλ’ ἄλλως κομιδῆς κεχρημένοι ἄνδρες ἀλῆται	- -- uu- --uu -u u--	dactylic hexameter	masculine penthemimeral, trithemimeral
ψεύδοντ’, οὐδ’ ἐθέλουσιν ἀληθέα μυθήσασθαι.	-- - uu-u u-uu ----	dactylic hexameter	feminine penthemimeral, trithemimeral
ὃς δέ κ’ἀλητεύων Ἰθάκης ἐς δῆμον ἵκηται,	- u u--- uu- - -u u--	dactylic hexameter	masculine penthemimeral, hepthemimeral
ἐλθὼν ἐς δέσποιναν ἐμὴν ἀπατήλια βάζει·	-- - --u u- uu-uu --	dactylic hexameter	feminine penthemimeral, hepthemimeral, trithemimeral
ἡ δ’εὖ δεξαμένη φιλέει καὶ ἕκαστα μεταλλᾷ,	- - -uu- uu- u u-u u--	dactylic hexameter	masculine penthemimeral, hepthemimeral
καί οἱ ὀδυρομένῃ βλεφάρων ἄπο δάκρυα πίπτει,	- u u-uu- uu- uu -uu --	dactylic hexameter	masculine penthemimeral, hepthemimeral
ἣ θέμις ἐστὶ γυναικός, ἐπὴν πόσις ἄλλοθ’ ὄληται.	- uu -u u-u u- uu -u u--	dactylic hexameter	feminine penthemimeral, hepthemimeral
αἶψά κε καὶ σύ, γεραιέ, ἔπος παρατεκτήναιο.	-u u - u u-u u- uu----	dactylic hexameter	feminine penthemimeral, hepthemimeral, trithemimeral
εἴ τίς τοι χλαῖνάν τε χιτῶνά τε εἵματα δοίη.	- - - -- u u-u u -uu --	dactylic hexameter	masculine penthemimeral, trithemimeral
τοῦ δ’ἤδη μέλλουσι κύνες ταχέες τ’οἰωνοὶ	- -- --u u- uu- ---	dactylic hexameter	feminine penthemimeral, hepthemimeral, trithemimeral
ῥινὸν ἀπ’ ὀστεόφιν ἐρύσαι, ψυχὴ δὲ λέλοιπεν·	-u u -uu- uu- -- u u--	dactylic hexameter	masculine penthemimeral, hepthemimeral
ἢ τόν γ’ἐν πόντῳ φάγον ἰχθύες, ὀστέα δ’αὐτοῦ	- - - -- uu -uu -uu --	dactylic hexameter	masculine penthemimeral, trithemimeral
κεῖται ἐπ’ ἠπείρου ψαμάθῳ εἰλυμένα πολλῇ.	-u u --- uu- --uu --	dactylic hexameter	masculine penthemimeral, hepthemimeral
ὣς ὁ μὲν ἔνθ’ ἀπόλωλε, φίλοισι δὲ κήδε’ ὀπίσσω	- u u - uu-u u-u u -u u--	dactylic hexameter	feminine penthemimeral, trithemimeral
πᾶσιν, ἐμοὶ δὲ μάλιστα, τετεύχαται· οὐ γὰρ ἔτ’ ἄλλον	-u u- u u-u u-uu - u u --	dactylic hexameter	feminine penthemimeral, trithemimeral
ἤπιον ὧδε ἄνακτα κιχήσομαι, ὁππόσ’ ἐπέλθω,	-uu -u u-u u-uu -u u--	dactylic hexameter	feminine penthemimeral
οὐδ’ εἴ κεν πατρὸς καὶ μητέρος αὖτις ἵκωμαι	- - - -- - -uu -u u--	dactylic hexameter	masculine penthemimeral, trithemimeral
οἶκον, ὅθι πρῶτον γενόμην καί μ’ἔτρεφον αὐτοί.	-u u- -- uu- - -uu --	dactylic hexameter	masculine penthemimeral, hepthemimeral, trithemimeral
οὐδέ νυ τῶν ἔτι τόσσον ὀδύρομαι, ἀχνύμενός περ	-u u - uu -u u-uu -uu- -	dactylic hexameter	feminine penthemimeral, trithemimeral
ὀφθαλμοῖσιν ἰδέσθαι ἐὼν ἐν πατρίδι γαίῃ·	---u u-u u- - -uu --	dactylic hexameter	feminine penthemimeral, hepthemimeral
ἀλλά μ’Ὀδυσσῆος πόθος αἴνυται οἰχομένοιο.	-u u--- uu -uu -uu--	dactylic hexameter	masculine penthemimeral
τὸν μὲν ἐγών, ὦ ξεῖνε, καὶ οὐ παρεόντ’ ὀνομάζειν	- u u- - -u u - uu- uu--	dactylic hexameter	feminine penthemimeral, hepthemimeral, trithemimeral
αἰδέομαι· πέρι γάρ μ’ἐφίλει καὶ κήδετο θυμῷ·	-uu- uu - uu- - -uu --	dactylic hexameter	masculine penthemimeral, hepthemimeral, trithemimeral
ἀλλά μιν ἠθεῖον καλέω καὶ νόσφιν ἐόντα.	-u u --- uu- - -u u--	dactylic hexameter	masculine penthemimeral, hepthemimeral
τὸν δ’αὖτε προσέειπε πολύτλας δῖος Ὀδυσσεύς·	- -- uu-u u-- -u u--	dactylic hexameter	feminine penthemimeral, trithemimeral
ὦ φίλ’, ἐπεὶ δὴ πάμπαν ἀναίνεαι, οὐδ’ ἔτι φῇσθα	- u u- - -u u-uu - uu --	dactylic hexameter	feminine penthemimeral, trithemimeral
κεῖνον ἐλεύσεσθαι, θυμὸς δέ τοι αἰὲν ἄπιστος·	-u u--- -- u u -u u--	dactylic hexameter	masculine penthemimeral, hepthemimeral
ἀλλ’ ἐγὼ οὐκ αὔτως μυθήσομαι, ἀλλὰ σὺν ὅρκῳ,	- uu - -- --uu -u u --	dactylic hexameter	masculine penthemimeral, trithemimeral
ὡς νεῖται Ὀδυσεύς· εὐαγγέλιον δέ μοι ἔστω	- -- uu- --uu- u u --	dactylic hexameter	masculine penthemimeral, trithemimeral
αὐτίκ’, ἐπεί κεν κεῖνος ἰὼν τὰ ἃ δώμαθ’ ἵκηται·	-u u- - -u u- u u -u u--	dactylic hexameter	feminine penthemimeral, hepthemimeral, trithemimeral
ἕσσαι με χλαῖνάν τε χιτῶνά τε, εἵματα καλά·	-- - -- u u-u u -uu --	dactylic hexameter	masculine penthemimeral, trithemimeral
πρὶν δέ κε, καὶ μάλα περ κεχρημένος, οὔ τι δεχοίμην.	- u u - uu - --uu - u u--	dactylic hexameter	masculine penthemimeral, trithemimeral
ἐχθρὸς γάρ μοι κεῖνος ὁμῶς Ἀΐδαο πύλῃσι	-- - - -u u- uu-u u--	dactylic hexameter	feminine penthemimeral, hepthemimeral, trithemimeral
γίνεται, ὃς πενίῃ εἴκων ἀπατήλια βάζει.	-uu - uu- -- uu-uu --	dactylic hexameter	masculine penthemimeral, hepthemimeral, trithemimeral
ἴστω νῦν Ζεὺς πρῶτα θεῶν, ξενίη τε τράπεζα,	-- - - -u u- uu- u u--	dactylic hexameter	feminine penthemimeral, hepthemimeral, trithemimeral
ἱστίη τ’Ὀδυσῆος ἀμύμονος, ἣν ἀφικάνω·	--- uu-u u-uu - uu--	dactylic hexameter	feminine penthemimeral, trithemimeral
ἦ μέν τοι τάδε πάντα τελείεται ὡς ἀγορεύω.	- - - uu -u u-uu - uu--	dactylic hexameter	feminine penthemimeral, trithemimeral
τοῦδ’ αὐτοῦ λυκάβαντος ἐλεύσεται ἐνθάδ’ Ὀδυσσεύς.	- -- uu-u u-uu -u u--	dactylic hexameter	feminine penthemimeral, trithemimeral
τοῦ μὲν φθίνοντος μηνός, τοῦ δ’ἱσταμένοιο,	- - --- -- - -uu--	dactylic hexameter	masculine penthemimeral, hepthemimeral
οἴκαδε νοστήσας, καὶ τίσεται ὅς τις ἐκείνου	-uu --- - -uu - u u--	dactylic hexameter	masculine penthemimeral
ἐνθάδ’ ἀτιμάζει ἄλοχον καὶ φαίδιμον υἱόν.	-u u--- uu- - -uu --	dactylic hexameter	masculine penthemimeral, hepthemimeral
τὸν δ’ἀπαμειβόμενος προσέφης, Εὔμαιε συβῶτα·	- uu-uu- uu- --u u--	dactylic hexameter	masculine penthemimeral, hepthemimeral
ὦ γέρον, οὔτ’ ἄρ’ ἐγὼν εὐαγγέλιον τόδε τίσω,	- uu - u u- --uu- uu --	dactylic hexameter	masculine penthemimeral, trithemimeral
οὔτ’ Ὀδυσεὺς ἔτι οἶκον ἐλεύσεται· ἀλλὰ ἕκηλος	- uu- uu -u u-uu -u u--	dactylic hexameter	feminine penthemimeral, trithemimeral
πῖνε, καὶ ἄλλα παρὲξ μεμνώμεθα, μηδέ με τούτων	-u u -u u- --uu -u u --	dactylic hexameter	masculine penthemimeral
μίμνησκ’· ἦ γὰρ θυμὸν ἐνὶ στήθεσσιν ἐμοῖσιν	-- - - -u u- --u u--	dactylic hexameter	feminine penthemimeral, hepthemimeral, trithemimeral
ἄχνυμαι, ὁππότε τις μνήσῃ κεδνοῖο ἄνακτος.	-uu -uu - -- --u u--	dactylic hexameter	masculine penthemimeral, hepthemimeral
ἀλλ’ ἤτοι ὅρκον μὲν ἐάσομεν, αὐτὰρ Ὀδυσσεὺς	- -- -- u u-uu -u u--	dactylic hexameter	masculine penthemimeral, trithemimeral
ἔλθοι ὅπως μιν ἔγωγ’ ἐθέλω καὶ Πηνελόπεια	-u u- u u- uu- - -uu--	dactylic hexameter	masculine penthemimeral, hepthemimeral, trithemimeral
Λαέρτης θ’ὁ γέρων καὶ Τηλέμαχος θεοειδής.	--- u u- - -uu- uu--	dactylic hexameter	masculine penthemimeral, trithemimeral
νῦν αὖ παιδὸς ἄλαστον ὀδύρομαι, ὃν τέκ’ Ὀδυσσεύς,	- - -u u-u u-uu - u u--	dactylic hexameter	feminine penthemimeral
Τηλεμάχου· τὸν ἐπεὶ θρέψαν θεοὶ ἔρνεϊ ἶσον,	-uu- u u- -- uu -uu --	dactylic hexameter	masculine penthemimeral, hepthemimeral, trithemimeral
καί μιν ἔφην ἔσσεσθαι ἐν ἀνδράσιν οὔ τι χερείω	- u u- --u u -uu - u u--	dactylic hexameter	feminine penthemimeral, trithemimeral
πατρὸς ἑοῖο φίλοιο, δέμας καὶ εἶδος ἀγητόν,	-u u-u u-u u- - -u u--	dactylic hexameter	feminine penthemimeral, hepthemimeral
τὸν δέ τις ἀθανάτων βλάψε φρένας ἔνδον ἐΐσας	- u u -uu- -- uu -u u--	dactylic hexameter	masculine penthemimeral, hepthemimeral
ἠέ τις ἀνθρώπων· ὁ δ’ἔβη μετὰ πατρὸς ἀκουὴν	-u u --- u u- uu -u u--	dactylic hexameter	masculine penthemimeral, hepthemimeral
ἐς Πύλον ἠγαθέην· τὸν δὲ μνηστῆρες ἀγαυοὶ	- uu -uu- - - --u u--	dactylic hexameter	masculine penthemimeral, hepthemimeral
οἴκαδ’ ἰόντα λοχῶσιν, ὅπως ἀπὸ φῦλον ὄληται	-u u-u u-u u- uu -u u--	dactylic hexameter	feminine penthemimeral, hepthemimeral
νώνυμον ἐξ Ἰθάκης Ἀρκεισίου ἀντιθέοιο.	-uu - uu- --uu -uu--	dactylic hexameter	masculine penthemimeral, trithemimeral
ἀλλ’ ἤτοι κεῖνον μὲν ἐάσομεν, ἤ κεν ἁλώῃ	- -- -- u u-uu - u u--	dactylic hexameter	masculine penthemimeral, trithemimeral
ἦ κε φύγῃ καί κέν οἱ ὑπέρσχῃ χεῖρα Κρονίων.	- u u- - - u u-- -u u--	dactylic hexameter	masculine penthemimeral, trithemimeral
ἀλλ’ ἄγε μοι σύ, γεραιέ, τὰ σ’αὐτοῦ κήδε’ ἐνίσπες	- uu - u u-u u -- -u u--	dactylic hexameter	feminine penthemimeral, trithemimeral
καί μοι τοῦτ’ ἀγόρευσον ἐτήτυμον, ὄφρ’ ἐῢ εἰδῶ·	- - - uu-u u-uu - uu --	dactylic hexameter	feminine penthemimeral, trithemimeral
τίς πόθεν εἶς ἀνδρῶν; πόθι τοι πόλις ἠδὲ τοκῆες;	- uu - -- uu - uu -u u--	dactylic hexameter	masculine penthemimeral, hepthemimeral, trithemimeral
ὁπποίης δ’ἐπὶ νηὸς ἀφίκεο· πῶς δέ σε ναῦται	--- uu -u u-uu - u u --	dactylic hexameter	feminine penthemimeral, trithemimeral
ἤγαγον εἰς Ἰθάκην; τίνες ἔμμεναι εὐχετόωντο;	-uu - uu- uu -uu -uu--	dactylic hexameter	masculine penthemimeral, trithemimeral
οὐ μὲν γάρ τί σε πεζὸν ὀΐομαι ἐνθάδ’ ἱκέσθαι.	- - - u u -u u-uu -u u--	dactylic hexameter	feminine penthemimeral, trithemimeral
τὸν δ’ἀπαμειβόμενος προσέφη πολύμητις Ὀδυσσεύς	- uu-uu- uu- uu-u u--	dactylic hexameter	masculine penthemimeral, hepthemimeral
τοιγὰρ ἐγώ τοι ταῦτα μάλ’ ἀτρεκέως ἀγορεύσω.	-u u- - -u u -uu- uu--	dactylic hexameter	feminine penthemimeral, trithemimeral
εἴη μὲν νῦν νῶϊν ἐπὶ χρόνον ἠμὲν ἐδωδὴ	-- - - -u u- uu -u u--	dactylic hexameter	feminine penthemimeral, hepthemimeral, trithemimeral
ἠδὲ μέθυ γλυκερὸν κλισίης ἔντοσθεν ἐοῦσι,	-u u- uu- uu- --u u--	dactylic hexameter	masculine penthemimeral, hepthemimeral, trithemimeral
δαίνυσθαι ἀκέοντ’, ἄλλοι δ’ἐπὶ ἔργον ἕποιεν·	--- uu- -- uu -u u--	dactylic hexameter	masculine penthemimeral, hepthemimeral, trithemimeral
ῥηϊδίως κεν ἔπειτα καὶ εἰς ἐνιαυτὸν ἅπαντα	-uu- u u-u u - uu-u u--	dactylic hexameter	feminine penthemimeral, hepthemimeral, trithemimeral
οὔ τι διαπρήξαιμι λέγων ἐμὰ κήδεα θυμοῦ,	- u u---u u- uu -uu --	dactylic hexameter	feminine penthemimeral, hepthemimeral
ὅσσα γε δὴ ξύμπαντα θεῶν ἰότητι μόγησα.	-u u - --u u- uu-u u--	dactylic hexameter	feminine penthemimeral, hepthemimeral, trithemimeral
ἐκ μὲν Κρητάων γένος εὔχομαι εὐρειάων,	- - --- uu -uu ----	dactylic hexameter	masculine penthemimeral
ἀνέρος ἀφνειοῖο πάϊς· πολλοὶ δὲ καὶ ἄλλοι	-uu ---u u- -- u u --	dactylic hexameter	feminine penthemimeral, hepthemimeral
υἷες ἐνὶ μεγάρῳ ἠμὲν τράφεν ἠδ’ ἐγένοντο	-u u- uu- -- uu - uu--	dactylic hexameter	masculine penthemimeral, hepthemimeral, trithemimeral
γνήσιοι ἐξ ἀλόχου· ἐμὲ δ’ὠνητὴ τέκε μήτηρ	-uu - uu- uu --- uu --	dactylic hexameter	masculine penthemimeral, trithemimeral
παλλακίς, ἀλλά με ἶσον ἰθαγενέεσσιν ἐτίμα	-uu -u u -u u-uu-u u--	dactylic hexameter	feminine penthemimeral
Κάστωρ Ὑλακίδης, τοῦ ἐγὼ γένος εὔχομαι εἶναι	-- -uu- u u- uu -uu --	dactylic hexameter	masculine penthemimeral, hepthemimeral
ὃς τότ’ ἐνὶ Κρήτεσσι θεὸς ὣς τίετο δήμῳ	- u u- --u u- - -uu --	dactylic hexameter	feminine penthemimeral, hepthemimeral, trithemimeral
ὄλβῳ τε πλούτῳ τε καὶ υἱάσι κυδαλίμοισιν.	-- - -- u u -uu -uu--	dactylic hexameter	masculine penthemimeral, trithemimeral
ἀλλ’ ἤτοι τὸν κῆρες ἔβαν θανάτοιο φέρουσαι	- -- - -u u- uu-u u--	dactylic hexameter	feminine penthemimeral, hepthemimeral, trithemimeral
εἰς Ἀΐδαο δόμους· τοὶ δὲ ζωὴν ἐδάσαντο	- uu-u u- - - -- uu--	dactylic hexameter	masculine penthemimeral, hepthemimeral
παῖδες ὑπέρθυμοι καὶ ἐπὶ κλήρους ἐβάλοντο,	-u u--- u u- -- uu--	dactylic hexameter	masculine penthemimeral, hepthemimeral
αὐτὰρ ἐμοὶ μάλα παῦρα δόσαν καὶ οἰκί’ ἔνειμαν.	-u u- uu -u u- - -u u--	dactylic hexameter	feminine penthemimeral, hepthemimeral, trithemimeral
ἠγαγόμην δὲ γυναῖκα πολυκλήρων ἀνθρώπων	-uu- u u-u u--- ---	dactylic hexameter	feminine penthemimeral, trithemimeral
εἵνεκ’ ἐμῆς ἀρετῆς, ἐπεὶ οὐκ ἀποφώλιος ἦα	-u u- uu- uu - uu-uu --	dactylic hexameter	masculine penthemimeral, hepthemimeral, trithemimeral
οὐδὲ φυγοπτόλεμος· νῦν δ’ἤδη πάντα λέλοιπεν	-u u-uu- - -- -u u--	dactylic hexameter	masculine penthemimeral
ἀλλ’ ἔμπης καλάμην γέ σ’ὀΐομαι εἰσορόωντα	- -- uu- u u-uu -uu--	dactylic hexameter	masculine penthemimeral, trithemimeral
γινώσκειν· ἦ γάρ με δύη ἔχει ἤλιθα πολλή.	--- - - u u- uu -uu --	dactylic hexameter	masculine penthemimeral, hepthemimeral, trithemimeral
ἦ μὲν δὴ θάρσος μοι Ἄρης τ’ἔδοσαν καὶ Ἀθήνη	- - - -- u u- uu- u u--	dactylic hexameter	masculine penthemimeral, hepthemimeral, trithemimeral
καὶ ῥηξηνορίην· ὁπότε κρίνοιμι λόχονδε	- --uu- uu- --u u--	dactylic hexameter	masculine penthemimeral, hepthemimeral
ἄνδρας ἀριστῆας, κακὰ δυσμενέεσσι φυτεύων,	-u u--- uu -uu-u u--	dactylic hexameter	masculine penthemimeral
οὔ ποτέ μοι θάνατον προτιόσσετο θυμὸς ἀγήνωρ,	- uu - uu- uu-uu -u u--	dactylic hexameter	masculine penthemimeral, trithemimeral
ἀλλὰ πολὺ πρώτιστος ἐπάλμενος ἔγχει ἕλεσκον	-u u- --u u-uu -u u--	dactylic hexameter	feminine penthemimeral, trithemimeral
ἀνδρῶν δυσμενέων ὅτε μοι εἴξειε πόδεσσι.	-- -uu- uu - --u u--	dactylic hexameter	masculine penthemimeral, hepthemimeral
τοῖος ἔα ἐν πολέμῳ· ἔργον δέ μοι οὐ φίλον ἔσκεν	-u u- uu- -- u u - uu --	dactylic hexameter	masculine penthemimeral, hepthemimeral, trithemimeral
οὐδ’ οἰκωφελίη, ἥ τε τρέφει ἀγλαὰ τέκνα,	- --uu- - - uu -uu --	dactylic hexameter	masculine penthemimeral, hepthemimeral
ἀλλά μοι αἰεὶ νῆες ἐπήρετμοι φίλαι ἦσαν	-u u -- -u u--- uu --	dactylic hexameter	feminine penthemimeral
καὶ πόλεμοι καὶ ἄκοντες ἐΰξεστοι καὶ ὀϊστοί,	- uu- u u-u u--- u u--	dactylic hexameter	feminine penthemimeral, trithemimeral
λυγρά, τά τ’ἄλλοισίν γε καταριγηλὰ πέλονται.	-u u --- u u---u u--	dactylic hexameter	masculine penthemimeral
αὐτὰρ ἐμοὶ τὰ φίλ’ ἔσκε τά που θεὸς ἐν φρεσὶ θῆκεν·	-u u- u u -u u - uu - uu --	dactylic hexameter	feminine penthemimeral, hepthemimeral, trithemimeral
ἄλλος γάρ τ’ἄλλοισιν ἀνὴρ ἐπιτέρπεται ἔργοις.	-- - --u u- uu-uu --	dactylic hexameter	feminine penthemimeral, hepthemimeral, trithemimeral
πρὶν μὲν γὰρ Τροίης ἐπιβήμεναι υἷας Ἀχαιῶν	- - - -- uu-uu -u u--	dactylic hexameter	masculine penthemimeral, trithemimeral
εἰνάκις ἀνδράσιν ἦρξα καὶ ὠκυπόροισι νέεσσιν	-uu -uu -u u -uu-u u--	dactylic hexameter	feminine penthemimeral
ἄνδρας ἐς ἀλλοδαπούς, καί μοι μάλα τύγχανε πολλά.	-u u -uu- - - uu -uu --	dactylic hexameter	masculine penthemimeral, hepthemimeral
τῶν ἐξαιρεύμην μενοεικέα, πολλὰ δ’ὀπίσσω	- ---- uu-uu -u u--	dactylic hexameter	masculine penthemimeral
λάγχανον· αἶψα δὲ οἶκος ὀφέλλετο, καί ῥα ἔπειτα	-uu -u u -u u-uu - u u--	dactylic hexameter	feminine penthemimeral
δεινός τ’αἰδοῖός τε μετὰ Κρήτεσσι τετύγμην.	-- --- u u- --u u--	dactylic hexameter	masculine penthemimeral, hepthemimeral
ἀλλ’ ὅτε δὴ τήν γε στυγερὴν ὁδὸν εὐρύοπα Ζεὺς	- uu - - - uu- uu -uu- -	dactylic hexameter	masculine penthemimeral, hepthemimeral, trithemimeral
ἐφράσαθ’, ἣ πολλῶν ἀνδρῶν ὑπὸ γούνατ’ ἔλυσε,	-uu - -- -- uu -u u--	dactylic hexameter	masculine penthemimeral, hepthemimeral, trithemimeral
δὴ τότε μ’ἤνωγον καὶ ἀγακλυτὸν Ἰδομενῆα	- uu --- u u-uu -uu--	dactylic hexameter	masculine penthemimeral
νήεσσ’ ἡγήσασθαι ἐς Ἴλιον· οὐδέ τι μῆχος	-- ---u u -uu -u u --	dactylic hexameter	feminine penthemimeral
ἦεν ἀνήνασθαι, χαλεπὴ δ’ἔχε δήμου φῆμις.	-u u--- uu- uu -- --	dactylic hexameter	masculine penthemimeral, hepthemimeral
ἔνθα μὲν εἰνάετες πολεμίζομεν υἷες Ἀχαιῶν,	-u u -uu- uu-uu -u u--	dactylic hexameter	masculine penthemimeral
τῷ δεκάτῳ δὲ πόλιν Πριάμου πέρσαντες ἔβημεν	- uu- u u- uu- --u u--	dactylic hexameter	masculine penthemimeral, hepthemimeral, trithemimeral
οἴκαδε σὺν νήεσσι, θεὸς δ’ἐκέδασσεν Ἀχαιούς.	-uu - --u u- uu-u u--	dactylic hexameter	feminine penthemimeral, hepthemimeral, trithemimeral
αὐτὰρ ἐμοὶ δειλῷ κακὰ μήδετο μητίετα Ζεύς·	-u u- -- uu -uu -uu- -	dactylic hexameter	masculine penthemimeral, trithemimeral
μῆνα γὰρ οἶον ἔμεινα τεταρπόμενος τεκέεσσι	-u u -u u-u u-uu- uu--	dactylic hexameter	feminine penthemimeral
κουριδίῃ τ’ἀλόχῳ καὶ κτήμασιν· αὐτὰρ ἔπειτα	-uu- uu- - -uu -u u--	dactylic hexameter	masculine penthemimeral, trithemimeral
Αἴγυπτόνδε με θυμὸς ἀνώγει ναυτίλλεσθαι,	---u u -u u-- ----	dactylic hexameter	feminine penthemimeral
νῆας ἐῢ στείλαντα σὺν ἀντιθέοις ἑτάροισιν.	-u u- --u u -uu- uu--	dactylic hexameter	feminine penthemimeral, trithemimeral
ἐννέα νῆας στεῖλα, θοῶς δ’ἐσαγείρατο λαός.	-uu -- -u u- uu-uu --	dactylic hexameter	feminine penthemimeral, hepthemimeral
ἑξῆμαρ μὲν ἔπειτα ἐμοὶ ἐρίηρες ἑταῖροι	--- u u-u u- uu-u u--	dactylic hexameter	feminine penthemimeral, hepthemimeral, trithemimeral
δαίνυντ’· αὐτὰρ ἐγὼν ἱερήϊα πολλὰ παρεῖχον	-- -u u- uu-uu -u u--	dactylic hexameter	masculine penthemimeral
θεοῖσίν τε ῥέζειν αὐτοῖσί τε δαῖτα πένεσθαι.	-- - -- --u u -u u--	dactylic hexameter	masculine penthemimeral, trithemimeral
ἑβδομάτῃ δ’ἀναβάντες ἀπὸ Κρήτης εὐρείης	-uu- uu-u u- -- ---	dactylic hexameter	feminine penthemimeral, hepthemimeral, trithemimeral
ἐπλέομεν Βορέῃ ἀνέμῳ ἀκραέϊ καλῷ	-uu- uu- uu- --uu --	dactylic hexameter	masculine penthemimeral, hepthemimeral, trithemimeral
ῥηϊδίως, ὡς εἴ τε κατὰ ῥόον· οὐδέ τις οὖν μοι	-uu- - - u u- uu -u u - -	dactylic hexameter	masculine penthemimeral, hepthemimeral, trithemimeral
νηῶν πημάνθη, ἀλλ’ ἀσκηθέες καὶ ἄνουσοι	-- --- - --- u u--	dactylic hexameter	masculine penthemimeral
ἥμεθα, τὰς δ’ἄνεμός τε κυβερνῆταί τ’ἴθυνον.	-uu - uu- u u--- ---	dactylic hexameter	masculine penthemimeral, trithemimeral
πεμπταῖοι δ’Αἴγυπτον ἐϋρρείτην ἱκόμεσθα,	--- --u u--- uu--	dactylic hexameter	feminine penthemimeral, trithemimeral
στῆσα δ’ἐν Αἰγύπτῳ ποταμῷ νέας ἀμφιελίσσας.	-u u --- uu- uu -uu--	dactylic hexameter	masculine penthemimeral, hepthemimeral
ἔνθ’ ἤτοι μὲν ἐγὼ κελόμην ἐρίηρας ἑταίρους	- -- u u- uu- uu-u u--	dactylic hexameter	masculine penthemimeral, hepthemimeral, trithemimeral
αὐτοῦ πὰρ νήεσσι μένειν καὶ νῆας ἔρυσθαι,	-- - --u u- - -u u--	dactylic hexameter	feminine penthemimeral, hepthemimeral, trithemimeral
ὀπτῆρας δὲ κατὰ σκοπιὰς ὤτρυνα νέεσθαι·	--- u u- uu- --u u--	dactylic hexameter	masculine penthemimeral, hepthemimeral, trithemimeral
οἱ δ’ὕβρει εἴξαντες, ἐπισπόμενοι μένεϊ σφῷ,	- -- --u u-uu- uu- -	dactylic hexameter	feminine penthemimeral, trithemimeral
αἶψα μάλ’ Αἰγυπτιων ἀνδρῶν περικαλλέας ἀγροὺς	-u u --- -- uu-uu --	dactylic hexameter	masculine penthemimeral, hepthemimeral
πόρθεον, ἐκ δὲ γυναῖκας ἄγον καὶ νήπια τέκνα,	-uu - u u-u u- - -uu --	dactylic hexameter	feminine penthemimeral, hepthemimeral, trithemimeral
αὐτούς τ’ἔκτεινον· τάχα δ’ἐς πόλιν ἵκετ’ ἀϋτή.	-- --- uu - uu -u u--	dactylic hexameter	masculine penthemimeral, hepthemimeral
οἱ δὲ βοῆς ἀΐοντες ἅμ’ ἠοῖ φαινομένηφι	- u u- uu-u u -- -uu--	dactylic hexameter	feminine penthemimeral, trithemimeral
ἦλθον· πλῆτο δὲ πᾶν πεδίον πεζῶν τε καὶ ἵππων	-- -u u - uu- -- u u --	dactylic hexameter	masculine penthemimeral, hepthemimeral
χαλκοῦ τε στεροπῆς· ἐν δὲ Ζεὺς τερπικέραυνος	-- - uu- - - - -uu--	dactylic hexameter	masculine penthemimeral, hepthemimeral, trithemimeral
φύζαν ἐμοῖς ἑτάροισι κακὴν βάλεν, οὐδέ τις ἔτλη	-u u- uu-u u- uu -u u --	dactylic hexameter	feminine penthemimeral, hepthemimeral, trithemimeral
μεῖναι ἐναντίβιον· περὶ γὰρ κακὰ πάντοθεν ἔστη.	-u u-uu- uu - uu -uu --	dactylic hexameter	masculine penthemimeral, hepthemimeral
ἔνθ’ ἡμέων πολλοὺς μὲν ἀπέκτανον ὀξέϊ χαλκῷ,	- -- -- u u-uu -uu --	dactylic hexameter	masculine penthemimeral, trithemimeral
τοὺς δ’ἄναγον ζωούς, σφίσιν ἐργάζεσθαι ἀνάγκῃ.	- uu- -- uu ---u u--	dactylic hexameter	masculine penthemimeral, trithemimeral
αὐτὰρ ἐμοὶ Ζεὺς αὐτὸς ἐνὶ φρεσὶν ὧδε νόημα	-u u- - -u u- uu -u u--	dactylic hexameter	feminine penthemimeral, hepthemimeral, trithemimeral
ποίησ’ ὡς ὄφελον θανέειν καὶ πότμον ἐπισπεῖν	-- - uu- uu- - -u u--	dactylic hexameter	masculine penthemimeral, hepthemimeral, trithemimeral
αὐτοῦ ἐν Αἰγύπτῳ· ἔτι γάρ νύ με πῆμ’ ὑπέδεκτο	-u u --- uu - u u - uu--	dactylic hexameter	masculine penthemimeral, hepthemimeral
αὐτίκ’ ἀπὸ κρατὸς κυνέην εὔτυκτον ἔθηκα	-u u- -- uu- --u u--	dactylic hexameter	masculine penthemimeral, hepthemimeral, trithemimeral
καὶ σάκος ὤμοιϊν, δόρυ δ’ἔκβαλον ἔκτοσε χειρός·	- uu --- uu -uu -uu --	dactylic hexameter	masculine penthemimeral
αὐτὰρ ἐγὼ βασιλῆος ἐναντίον ἤλυθον ἵππων	-u u- uu-u u-uu -uu --	dactylic hexameter	feminine penthemimeral, trithemimeral
καὶ κύσα γούναθ’ ἑλών· ὁ δ’ἐρύσατο καί μ’ἐλέησεν,	- uu -u u- u u-uu - uu--	dactylic hexameter	masculine penthemimeral
ἐς δίφρον δέ μ’ἕσας ἄγεν οἴκαδε δάκρυ χέοντα.	- -- u u- uu -uu -u u--	dactylic hexameter	masculine penthemimeral, trithemimeral
ἦ μέν μοι μάλα πολλοὶ ἐπήϊσσον μελίῃσιν,	- - - uu -u u--- uu--	dactylic hexameter	feminine penthemimeral, trithemimeral
ἱέμενοι κτεῖναι δὴ γὰρ κεχολώατο λίην	-uu- -- - - uu-uu --	dactylic hexameter	masculine penthemimeral, hepthemimeral, trithemimeral
ἀλλ’ ἀπὸ κεῖνος ἔρυκε, Διὸς δ’ὠπίζετο μῆνιν	- uu -u u-u u- --uu --	dactylic hexameter	feminine penthemimeral, hepthemimeral
ξεινίου, ὅς τε μάλιστα νεμεσσᾶται κακὰ ἔργα.	-uu - u u-u u--- uu --	dactylic hexameter	feminine penthemimeral, trithemimeral
ἔνθα μὲν ἑπτάετες μένον αὐτόθι, πολλὰ δ’ἄγειρα	-u u -uu- uu -uu -u u--	dactylic hexameter	masculine penthemimeral
χρήματ’ ἀν’ Αἰγυπτιους ἄνδρας· δίδοσαν γὰρ ἅπαντες.	-u u --- -- uu- u u--	dactylic hexameter	masculine penthemimeral, hepthemimeral
ἀλλ’ ὅτε δὴ ὄγδοόν μοι ἐπιπλόμενον ἔτος ἦλθε,	- uu - uu- u u-uu- uu --	dactylic hexameter	masculine penthemimeral, trithemimeral
δὴ τότε Φοῖνιξ ἦλθεν ἀνὴρ ἀπατήλια εἰδώς,	- uu -- -u u- uu-uu --	dactylic hexameter	feminine penthemimeral, hepthemimeral
τρώκτης, ὃς δὴ πολλὰ κάκ’ ἀνθρώποισιν ἐώργει·	-- - - -u u ---u u--	dactylic hexameter	feminine penthemimeral, trithemimeral
ὅς μ’ἄγε παρπεπιθὼν ᾗσι φρεσίν, ὄφρ’ ἱκόμεσθα	- uu -uu- -- uu - uu--	dactylic hexameter	masculine penthemimeral, hepthemimeral
Φοινίκην, ὅθι τοῦ γε δόμοι καὶ κτήματ’ ἔκειτο.	--- uu - u u- - -u u--	dactylic hexameter	masculine penthemimeral, hepthemimeral, trithemimeral
ἔνθα παρ’ αὐτῷ μεῖνα τελεσφόρον εἰς ἐνιαυτόν.	-u u -- -u u-uu - uu--	dactylic hexameter	feminine penthemimeral
ἀλλ’ ὅτε δὴ μῆνές τε καὶ ἡμέραι ἐξετελεῦντο	- uu - -- u u -uu -uu--	dactylic hexameter	masculine penthemimeral, trithemimeral
ἄψ περιτελλομένου ἔτεος καὶ ἐπήλυθον ὧραι,	- uu-uu- uu- u u-uu --	dactylic hexameter	masculine penthemimeral, hepthemimeral
ἐς Λιβύην μ’ἐπὶ νηὸς ἐέσσατο ποντοπόροιο	- uu- uu -u u-uu -uu--	dactylic hexameter	feminine penthemimeral, trithemimeral
ψεύδεα βουλεύσας, ἵνα οἱ σὺν φόρτον ἄγοιμι,	-uu --- uu - - -u u--	dactylic hexameter	masculine penthemimeral, hepthemimeral
κεῖθι δέ μ’ὡς περάσῃσι καὶ ἄσπετον ὦνον ἕλοιτο.	-u u - uu-u u -uu -u u--	dactylic hexameter	feminine penthemimeral, trithemimeral
τῷ ἑπόμην ἐπὶ νηός, ὀϊόμενός περ, ἀνάγκῃ.	- uu- uu -u u-uu- u u--	dactylic hexameter	feminine penthemimeral, trithemimeral
ἡ δ’ἔθεεν Βορέῃ ἀνέμῳ ἀκραέϊ καλῷ,	- uu- uu- uu- --uu --	dactylic hexameter	masculine penthemimeral, hepthemimeral, trithemimeral
μέσσον ὑπὲρ Κρήτης· Ζεὺς δέ σφισι μήδετ’ ὄλεθρον.	-u u- -- - - uu -u u--	dactylic hexameter	masculine penthemimeral, hepthemimeral, trithemimeral
ἀλλ’ ὅτε δὴ Κρήτην μὲν ἐλείπομεν, οὐδέ τις ἄλλη	- uu - -- u u-uu -u u --	dactylic hexameter	masculine penthemimeral, trithemimeral
φαίνετο γαιάων, ἀλλ’ οὐρανὸς ἠδὲ θάλασσα,	-uu --- - -uu -u u--	dactylic hexameter	masculine penthemimeral
δὴ τότε κυανέην νεφέλην ἔστησε Κρονίων	- uu -uu- uu- --u u--	dactylic hexameter	masculine penthemimeral, hepthemimeral
νηὸς ὕπερ γλαφυρῆς, ἤχλυσε δὲ πόντος ὑπ’ αὐτῆς.	-u u- uu- --u u -u u --	dactylic hexameter	masculine penthemimeral, trithemimeral
Ζεὺς δ’ἄμυδις βρόντησε καὶ ἔμβαλε νηῒ κεραυνόν·	- uu- --u u -uu -u u--	dactylic hexameter	feminine penthemimeral, trithemimeral
ἡ δ’ἐλελίχθη πᾶσα Διὸς πληγεῖσα κεραυνῷ,	- uu-- -u u- --u u--	dactylic hexameter	feminine penthemimeral, hepthemimeral
ἐν δὲ θεείου πλῆτο· πέσον δ’ἐκ νηὸς ἅπαντες.	- u u-- -u u- - -u u--	dactylic hexameter	feminine penthemimeral, hepthemimeral
οἱ δὲ κορώνῃσιν ἴκελοι περὶ νῆα μέλαιναν	- u u--- uu- uu -u u--	dactylic hexameter	masculine penthemimeral, hepthemimeral
κύμασιν ἐμφορέοντο· θεὸς δ’ἀποαίνυτο νόστον.	-uu -uu-u u- uu-uu --	dactylic hexameter	feminine penthemimeral, hepthemimeral
αὐτὰρ ἐμοὶ Ζεὺς αὐτός, ἔχοντί περ ἄλγεα θυμῷ,	-u u- - -u u-u u -uu --	dactylic hexameter	feminine penthemimeral, trithemimeral
ἱστὸν ἀμαιμάκετον νηὸς κυανοπρώροιο	-u u-uu- -- uu----	dactylic hexameter	masculine penthemimeral, hepthemimeral
ἐν χείρεσσιν ἔθηκεν, ὅπως ἔτι πῆμα φύγοιμι.	- --u u-u u- uu -u u--	dactylic hexameter	feminine penthemimeral, hepthemimeral
τῷ ῥα περιπλεχθεὶς φερόμην ὀλοοῖς ἀνέμοισιν.	- u u--- uu- uu- uu--	dactylic hexameter	masculine penthemimeral, hepthemimeral
ἐννῆμαρ φερόμην, δεκάτῃ δέ με νυκτὶ μελαίνῃ	--- uu- uu- u u -u u--	dactylic hexameter	masculine penthemimeral, hepthemimeral, trithemimeral
γαίῃ Θεσπρωτῶν πέλασεν μέγα κῦμα κυλίνδον.	-- --- uu- uu -u u--	dactylic hexameter	masculine penthemimeral, hepthemimeral
ἔνθα με Θεσπρωτῶν βασιλεὺς ἐκομίσσατο Φείδων	-u u --- uu- uu-uu --	dactylic hexameter	masculine penthemimeral, hepthemimeral
ἥρως ἀπριάτην· τοῦ γὰρ φίλος υἱὸς ἐπελθὼν	-- -uu- - - uu -u u--	dactylic hexameter	masculine penthemimeral, hepthemimeral
αἴθρῳ καὶ καμάτῳ δεδμημένον ἦγεν ἐς οἶκον,	-- - uu- --uu -u u --	dactylic hexameter	masculine penthemimeral, trithemimeral
χειρὸς ἀναστήσας, ὄφρ’ ἵκετο δώματα πατρός·	-u u--- - -uu -uu --	dactylic hexameter	masculine penthemimeral
ἀμφὶ δέ με χλαῖνάν τε χιτῶνά τε εἵματα ἕσσεν.	-u u - -- u u-u u -uu --	dactylic hexameter	masculine penthemimeral, trithemimeral
ἔνθ’ Ὀδυσῆος ἐγὼ πυθόμην· κεῖνος γὰρ ἔφασκε	- uu-u u- uu- -- u u--	dactylic hexameter	masculine penthemimeral, hepthemimeral
ξεινίσαι ἠδὲ φιλῆσαι ἰόντ’ ἐς πατρίδα γαῖαν,	-uu -u u-u u- - -uu --	dactylic hexameter	feminine penthemimeral, hepthemimeral
καί μοι κτήματ’ ἔδειξεν ὅσα ξυναγείρατ’ Ὀδυσσεύς,	- - -u u-u u- uu-u u--	dactylic hexameter	feminine penthemimeral, hepthemimeral
χαλκόν τε χρυσόν τε πολύκμητόν τε σίδηρον.	-- - -- u u--- u u--	dactylic hexameter	masculine penthemimeral, trithemimeral
καί νύ κεν ἐς δεκάτην γενεὴν ἕτερόν γ’ἔτι βόσκοι·	- u u - uu- uu- uu- uu --	dactylic hexameter	masculine penthemimeral, hepthemimeral, trithemimeral
ὅσσα οἱ ἐν μεγάροις κειμήλια κεῖτο ἄνακτος.	-u u - uu- --uu -u u--	dactylic hexameter	masculine penthemimeral, trithemimeral
τὸν δ’ἐς Δωδώνην φάτο βήμεναι, ὄφρα θεοῖο	- - --- uu -uu -u u--	dactylic hexameter	masculine penthemimeral
ἐκ δρυὸς ὑψικόμοιο Διὸς βουλὴν ἐπακούσῃ,	- uu -uu-u u- -- uu--	dactylic hexameter	feminine penthemimeral, hepthemimeral
ὅππως νοστήσῃ Ἰθάκης ἐς πίονα δῆμον	-- --- uu- - -uu --	dactylic hexameter	masculine penthemimeral, hepthemimeral
ἤδη δὴν ἀπεών, ἢ ἀμφαδὸν ἦε κρυφηδόν.	-- - uu- - -uu -u u--	dactylic hexameter	masculine penthemimeral, trithemimeral
ὤμοσε δὲ πρὸς ἔμ’ αὐτόν, ἀποσπένδων ἐνὶ οἴκῳ,	-uu - u u -u u--- uu --	dactylic hexameter	feminine penthemimeral, trithemimeral
νῆα κατειρύσθαι καὶ ἐπαρτέας ἔμμεν ἑταίρους,	-u u--- u u-uu -u u--	dactylic hexameter	masculine penthemimeral
οἳ δή μιν πέμψουσι φίλην ἐς πατρίδα γαῖαν.	- - - --u u- - -uu --	dactylic hexameter	feminine penthemimeral, hepthemimeral, trithemimeral
ἀλλ’ ἐμὲ πρὶν ἀπέπεμψε· τύχησε γὰρ ἐρχομένη νηῦς	- uu - uu-u u-u u -uu- -	dactylic hexameter	feminine penthemimeral, trithemimeral
ἀνδρῶν Θεσπρωτῶν ἐς Δουλίχιον πολύπυρον.	-- --- - -uu- uu--	dactylic hexameter	masculine penthemimeral
ἔνθ’ ὅ γέ μ’ἠνώγει πέμψαι βασιλῆϊ Ἀκάστῳ	- u u --- -- uu-u u--	dactylic hexameter	masculine penthemimeral, hepthemimeral
ἐνδυκέως· τοῖσιν δὲ κακὴ φρεσὶν ἥνδανε βουλὴ	-uu- -- u u- uu -uu --	dactylic hexameter	masculine penthemimeral, hepthemimeral, trithemimeral
ἀμφ’ ἐμοί, ὄφρ’ ἔτι πάγχυ δύης ἐπὶ πῆμα γενοίμην.	- uu - uu -u u- uu -u u--	dactylic hexameter	feminine penthemimeral, hepthemimeral, trithemimeral
ἀλλ’ ὅτε γαίης πολλὸν ἀπέπλω ποντοπόρος νηῦς,	- uu -- -u u-- -uu- -	dactylic hexameter	feminine penthemimeral
αὐτίκα δούλιον ἦμαρ ἐμοὶ περιμηχανόωντο.	-uu -uu -u u- uu-uu--	dactylic hexameter	feminine penthemimeral, hepthemimeral
ἐκ μέν με χλαῖνάν τε χιτῶνά τε εἵματ’ ἔδυσαν,	- - - -- u u-u u -u u--	dactylic hexameter	masculine penthemimeral, trithemimeral
ἀμφὶ δέ με ῥάκος ἄλλο κακὸν βάλον ἠδὲ χιτῶνα,	-u u - uu -u u- uu -u u--	dactylic hexameter	feminine penthemimeral, hepthemimeral, trithemimeral
ῥωγαλέα, τὰ καὶ αὐτὸς ἐν ὀφθαλμοῖσιν ὅρηαι·	-uu- u u -u u ---u u--	dactylic hexameter	feminine penthemimeral, trithemimeral
ἑσπέριοι δ’Ἰθάκης εὐδειέλου ἔργ’ ἀφίκοντο.	-uu- uu- --uu - uu--	dactylic hexameter	masculine penthemimeral, trithemimeral
ἔνθ’ ἐμὲ μὲν κατέδησαν ἐϋσσέλμῳ ἐνὶ νηῒ	- uu - uu-u u--- uu --	dactylic hexameter	feminine penthemimeral, trithemimeral
ὅπλῳ ἐϋστρεφέϊ στερεῶς, αὐτοὶ δ’ἀποβάντες	-u u-uu- uu- -- uu--	dactylic hexameter	masculine penthemimeral, hepthemimeral
ἐσσυμένως παρὰ θῖνα θαλάσσης δόρπον ἕλοντο.	-uu- uu -u u-- -u u--	dactylic hexameter	feminine penthemimeral, trithemimeral
αὐτὰρ ἐμοὶ δεσμὸν μὲν ἀνέγναμψαν θεοὶ αὐτοὶ	-u u- -- u u--- uu --	dactylic hexameter	masculine penthemimeral, trithemimeral
ῥηϊδίως· κεφαλῇ δὲ κατὰ ῥάκος ἀμφικαλύψας,	-uu- uu- u u- uu -uu--	dactylic hexameter	masculine penthemimeral, hepthemimeral, trithemimeral
ξεστὸν ἐφόλκαιον καταβὰς ἐπέλασσα θαλάσσῃ	-u u--- uu- uu-u u--	dactylic hexameter	masculine penthemimeral, hepthemimeral
στῆθος, ἔπειτα δὲ χερσὶ διήρεσα ἀμφοτέρῃσι	-u u-u u -u u-uu -uu--	dactylic hexameter	feminine penthemimeral
νηχόμενος, μάλα δ’ὦκα θύρηθ’ ἔα ἀμφὶς ἐκείνων.	-uu- uu -u u- uu -u u--	dactylic hexameter	feminine penthemimeral, hepthemimeral, trithemimeral
ἔνθ’ ἀναβάς, ὅθι τε δρίος ἦν πολυανθέος ὕλης,	- uu- uu - uu - uu-uu --	dactylic hexameter	masculine penthemimeral, hepthemimeral, trithemimeral
κείμην πεπτηώς. οἱ δὲ μεγάλα στενάχοντες	-- --- - - uu- uu--	dactylic hexameter	masculine penthemimeral, hepthemimeral
φοίτων· ἀλλ’ οὐ γάρ σφιν ἐφαίνετο κέρδιον εἶναι	-- - - - u u-uu -uu --	dactylic hexameter	masculine penthemimeral, trithemimeral
μαίεσθαι προτέρω, τοὶ μὲν πάλιν αὖτις ἔβαινον	--- uu- - - uu -u u--	dactylic hexameter	masculine penthemimeral, hepthemimeral, trithemimeral
νηὸς ἔπι γλαφυρῆς· ἐμὲ δ’ἔκρυψαν θεοὶ αὐτοὶ	-u u- uu- uu --- uu --	dactylic hexameter	masculine penthemimeral, trithemimeral
ῥηϊδίως, καί με σταθμῷ ἐπέλασσαν ἄγοντες	-uu- - - -- uu-u u--	dactylic hexameter	masculine penthemimeral, hepthemimeral, trithemimeral
ἀνδρὸς ἐπισταμένου· ἔτι γάρ νύ μοι αἶσα βιῶναι.	-u u-uu- uu - u u -u u--	dactylic hexameter	masculine penthemimeral, hepthemimeral
τὸν δ’ἀπαμειβόμενος προσέφης, Εὔμαιε συβῶτα·	- uu-uu- uu- --u u--	dactylic hexameter	masculine penthemimeral, hepthemimeral
ἆ δειλὲ ξείνων, ἦ μοι μάλα θυμὸν ὄρινας	- -- -- - - uu -u u--	dactylic hexameter	masculine penthemimeral, hepthemimeral, trithemimeral
ταῦτα ἕκαστα λέγων, ὅσα δὴ πάθες ἠδ’ ὅσ’ ἀλήθης.	-u u-u u- uu - uu - u u--	dactylic hexameter	masculine penthemimeral, hepthemimeral
ἀλλὰ τά γ’οὐ κατὰ κόσμον ὀΐομαι, οὐδέ με πείσεις	-u u - uu -u u-uu -u u --	dactylic hexameter	feminine penthemimeral, trithemimeral
εἰπὼν ἀμφ’ Ὀδυσῆϊ· τί σε χρὴ τοῖον ἐόντα	-- - uu-u u - - -u u--	dactylic hexameter	feminine penthemimeral, hepthemimeral, trithemimeral
μαψιδίως ψεύδεσθαι; ἐγὼ δ’εὖ οἶδα καὶ αὐτὸς	-uu- --u u- - -u u --	dactylic hexameter	feminine penthemimeral, hepthemimeral, trithemimeral
νόστον ἐμοῖο ἄνακτος, ὅτ’ ἤχθετο πᾶσι θεοῖσι	-u u-u u-u u -uu -u u--	dactylic hexameter	feminine penthemimeral
πάγχυ μάλ’, ὅττι μιν οὔ τι μετὰ Τρώεσσι δάμασσαν	-u u -u u - u u- --u u--	dactylic hexameter	masculine penthemimeral, hepthemimeral
ἠὲ φίλων ἐν χερσίν, ἐπεὶ πόλεμον τολύπευσε.	-u u- - -u u- uu- uu--	dactylic hexameter	feminine penthemimeral, hepthemimeral, trithemimeral
τῶ κέν οἱ τύμβον μὲν ἐποίησαν Παναχαιοί,	- - - -- u u--- uu--	dactylic hexameter	masculine penthemimeral, trithemimeral
ἠδέ κε καὶ ᾧ παιδὶ μέγα κλέος ἤρατ’ ὀπίσσω	-u u - - -u u- uu -u u--	dactylic hexameter	feminine penthemimeral, hepthemimeral, trithemimeral
νῦν δέ μιν ἀκλειῶς ἅρπυιαι ἀνηρείψαντο.	- u u --- --u u----	dactylic hexameter	masculine penthemimeral
αὐτὰρ ἐγὼ παρ’ ὕεσσιν ἀπότροπος· οὐδὲ πόλινδε	-u u- u u-u u-uu -u u--	dactylic hexameter	feminine penthemimeral, trithemimeral
ἔρχομαι, εἰ μή πού τι περίφρων Πηνελόπεια	-uu - - - u u-- -uu--	dactylic hexameter	masculine penthemimeral, trithemimeral
ἐλθέμεν ὀτρύνῃσιν, ὅτ’ ἀγγελίη ποθὲν ἔλθοι.	-uu ---u u -uu- uu --	dactylic hexameter	feminine penthemimeral
ἀλλ’ οἱ μὲν τὰ ἕκαστα παρήμενοι ἐξερέουσιν,	- - - u u-u u-uu -uu--	dactylic hexameter	feminine penthemimeral, trithemimeral
ἠμὲν οἳ ἄχνυνται δὴν οἰχομένοιο ἄνακτος,	-u u --- - -uu-u u--	dactylic hexameter	masculine penthemimeral
ἠδ’ οἳ χαίρουσιν βίοτον νήποινον ἔδοντες·	- - --- uu- --u u--	dactylic hexameter	masculine penthemimeral, hepthemimeral
ἀλλ’ ἐμοὶ οὐ φίλον ἐστὶ μεταλλῆσαι καὶ ἐρέσθαι,	- uu - uu -u u--- u u--	dactylic hexameter	feminine penthemimeral, trithemimeral
ἐξ οὗ δή μ’Αἰτωλὸς ἀνὴρ ἐξήπαφε μύθῳ,	- - - --u u- --uu --	dactylic hexameter	feminine penthemimeral, hepthemimeral, trithemimeral
ὅς ῥ’ἄνδρα κτείνας, πολλὴν ἐπὶ γαῖαν ἀληθείς,	- -- -- -- uu -u u--	dactylic hexameter	masculine penthemimeral, hepthemimeral, trithemimeral
ἦλθεν ἐμὰ πρὸς δώματ’· ἐγὼ δέ μιν ἀμφαγάπαζον.	-u u- - -u u- u u -uu--	dactylic hexameter	feminine penthemimeral, hepthemimeral, trithemimeral
φῆ δέ μιν ἐν Κρήτεσσι παρ’ Ἰδομενῆϊ ἰδέσθαι	- u u - --u u -uu-u u--	dactylic hexameter	feminine penthemimeral, trithemimeral
νῆας ἀκειόμενον, τάς οἱ ξυνέαξαν ἄελλαι·	-u u-uu- - - uu-u u--	dactylic hexameter	masculine penthemimeral, hepthemimeral
καὶ φάτ’ ἐλεύσεσθαι ἢ ἐς θέρος ἢ ἐς ὀπώρην,	- u u--- - - uu - u u--	dactylic hexameter	masculine penthemimeral, hepthemimeral
πολλὰ χρήματ’ ἄγοντα, σὺν ἀντιθέοις ἑτάροισι.	-- -u u-u u -uu- uu--	dactylic hexameter	feminine penthemimeral
καὶ σύ, γέρον πολυπενθές, ἐπεί σέ μοι ἤγαγε δαίμων,	- u u- uu-u u- u u -uu --	dactylic hexameter	feminine penthemimeral, hepthemimeral, trithemimeral
μήτε τί μοι ψεύδεσσι χαρίζεο μήτε τι θέλγε·	-u u - --u u-uu -u u --	dactylic hexameter	feminine penthemimeral, trithemimeral
οὐ γὰρ τοὔνεκ’ ἐγώ σ’αἰδέσσομαι οὐδὲ φιλήσω,	- - -u u- --uu -u u--	dactylic hexameter	masculine penthemimeral
ἀλλὰ Δία ξένιον δείσας αὐτόν τ’ἐλεαίρων.	-u u- uu- -- -- uu--	dactylic hexameter	masculine penthemimeral, hepthemimeral, trithemimeral
τὸν δ’ἀπαμειβόμενος προσέφη πολύμητις Ὀδυσσεύς·	- uu-uu- uu- uu-u u--	dactylic hexameter	masculine penthemimeral, hepthemimeral
ἦ μάλα τίς τοι θυμὸς ἐνὶ στήθεσσιν ἄπιστος,	- uu - - -u u- --u u--	dactylic hexameter	feminine penthemimeral, hepthemimeral, trithemimeral
οἷόν σ’οὐδ’ ὀμόσας περ ἐπήγαγον οὐδέ σε πείθω.	-- - uu- u u-uu -u u --	dactylic hexameter	masculine penthemimeral, trithemimeral
ἀλλ’ ἄγε νῦν ῥήτρην ποιησόμεθ’· αὐτὰρ ὄπισθε	- uu - -- --uu -u u--	dactylic hexameter	masculine penthemimeral, trithemimeral
μάρτυροι ἀμφοτέροισι θεοί, τοὶ Ὄλυμπον ἔχουσιν.	-uu -uu-u u- u u-u u--	dactylic hexameter	feminine penthemimeral, hepthemimeral
εἰ μέν κεν νοστήσῃ ἄναξ τεὸς ἐς τόδε δῶμα,	- - - --u u- uu - uu --	dactylic hexameter	feminine penthemimeral, hepthemimeral, trithemimeral
ἕσσας με χλαῖνάν τε χιτῶνά τε εἵματα πέμψαι	-- - -- u u-u u -uu --	dactylic hexameter	masculine penthemimeral, trithemimeral
Δουλίχιόνδ’ ἰέναι, ὅθι μοι φίλον ἔπλετο θυμῷ·	-uu- uu- uu - uu -uu --	dactylic hexameter	masculine penthemimeral, hepthemimeral, trithemimeral
εἰ δέ κε μὴ ἔλθῃσιν ἄναξ τεὸς ὡς ἀγορεύω,	- u u - --u u- uu - uu--	dactylic hexameter	feminine penthemimeral, hepthemimeral, trithemimeral
δμῶας ἐπισσεύας βαλέειν μεγάλης κατὰ πέτρης,	-u u--- uu- uu- uu --	dactylic hexameter	masculine penthemimeral, hepthemimeral
ὄφρα καὶ ἄλλος πτωχὸς ἀλεύεται ἠπεροπεύειν.	-u u -- -u u-uu -uu--	dactylic hexameter	feminine penthemimeral
τὸν δ’ἀπαμειβόμενος προσεφώνεε δῖος ὑφορβός·	- uu-uu- uu-uu -u u--	dactylic hexameter	masculine penthemimeral
ξεῖν’, οὕτω γάρ κέν μοι ἐϋκλείη τ’ἀρετή τε	- -- - - u u--- uu- -	dactylic hexameter	masculine penthemimeral, trithemimeral
εἴη ἐπ’ ἀνθρώπους ἅμα τ’αὐτίκα καὶ μετέπειτα,	-u u --- uu -uu - uu--	dactylic hexameter	masculine penthemimeral
ὅς σ’ἐπεὶ ἐς κλισίην ἄγαγον καὶ ξείνια δῶκα,	- uu - uu- uu- - -uu --	dactylic hexameter	masculine penthemimeral, hepthemimeral, trithemimeral
αὖτις δὲ κτείναιμι φίλον τ’ἀπὸ θυμὸν ἑλοίμην·	-- - --u u- uu -u u--	dactylic hexameter	feminine penthemimeral, hepthemimeral, trithemimeral
πρόφρων κεν δὴ ἔπειτα Δία Κρονίωνα λιτοίμην.	-- - u u-u u- uu-u u--	dactylic hexameter	feminine penthemimeral, hepthemimeral, trithemimeral
νῦν δ’ὥρη δόρποιο· τάχιστά μοι ἔνδον ἑταῖροι	- -- --u u-u u -u u--	dactylic hexameter	feminine penthemimeral, trithemimeral
εἶεν, ἵν’ ἐν κλισίῃ λαρὸν τετυκοίμεθα δόρπον.	-u u - uu- -- uu-uu --	dactylic hexameter	masculine penthemimeral, hepthemimeral, trithemimeral
ὣς οἱ μὲν τοιαῦτα πρὸς ἀλλήλους ἀγόρευον,	- - - --u u --- uu--	dactylic hexameter	feminine penthemimeral, trithemimeral
ἀγχίμολον δὲ σύες τε καὶ ἀνέρες ἦλθον ὑφορβοί.	-uu- u u- u u -uu -u u--	dactylic hexameter	masculine penthemimeral, trithemimeral
τὰς μὲν ἄρα ἔρξαν κατὰ ἤθεα κοιμηθῆναι,	- u u- -- uu -uu ----	dactylic hexameter	masculine penthemimeral, trithemimeral
κλαγγὴ δ’ἄσπετος ὦρτο συῶν αὐλιζομενάων	-- -uu -u u- --uu--	dactylic hexameter	feminine penthemimeral, hepthemimeral
αὐτὰρ ὁ οἷς ἑτάροισιν ἐκέκλετο δῖος ὑφορβός·	-u u - uu-u u-uu -u u--	dactylic hexameter	feminine penthemimeral, trithemimeral
ἄξεθ’ ὑῶν τὸν ἄριστον, ἵνα ξείνῳ ἱερεύσω	-u u- u u-u u- -- uu--	dactylic hexameter	feminine penthemimeral, hepthemimeral, trithemimeral
τηλεδαπῷ· πρὸς δ’αὐτοὶ ὀνησόμεθ’, οἵ περ ὀϊζὺν	-uu- - -u u-uu - u u--	dactylic hexameter	feminine penthemimeral, trithemimeral
δὴν ἔχομεν πάσχοντες ὑῶν ἕνεκ’ ἀργιοδόντων·	- uu- --u u- uu -uu--	dactylic hexameter	feminine penthemimeral, hepthemimeral, trithemimeral
ἄλλοι δ’ἡμέτερον κάματον νήποινον ἔδουσιν.	-- -uu- uu- --u u--	dactylic hexameter	masculine penthemimeral, hepthemimeral
ὣς ἄρα φωνήσας κέασε ξύλα νηλέϊ χαλκῷ,	- uu --- uu- uu -uu --	dactylic hexameter	masculine penthemimeral, hepthemimeral
οἱ δ’ὗν εἰσῆγον μάλα πίονα πενταέτηρον.	- - --- uu -uu -uu--	dactylic hexameter	masculine penthemimeral
τὸν μὲν ἔπειτ’ ἔστησαν ἐπ’ ἐσχάρῃ· οὐδὲ συβώτης	- u u- --u u -uu -u u--	dactylic hexameter	feminine penthemimeral, trithemimeral
λήθετ’ ἄρ’ ἀθανάτων· φρεσὶ γὰρ κέχρητ’ ἀγαθῇσιν·	-u u -uu- uu - -- uu--	dactylic hexameter	masculine penthemimeral, hepthemimeral
ἀλλ’ ὅ γ’ἀπαρχόμενος κεφαλῆς τρίχας ἐν πυρὶ βάλλεν	- u u-uu- uu- uu - uu --	dactylic hexameter	masculine penthemimeral, hepthemimeral
ἀργιόδοντος ὑός, καὶ ἐπεύχετο πᾶσι θεοῖσι	-uu-u u- u u-uu -u u--	dactylic hexameter	masculine penthemimeral
νοστῆσαι Ὀδυσῆα πολύφρονα ὅνδε δόμονδε.	--- uu-u u-uu -u u--	dactylic hexameter	feminine penthemimeral, trithemimeral
κόψε δ’ἀνασχόμενος σχίζῃ δρυός, ἣν λίπε κείων·	-u u-uu- -- uu - uu --	dactylic hexameter	masculine penthemimeral, hepthemimeral
τὸν δ’ἔλιπε ψυχή. τοὶ δ’ἔσφαξάν τε καὶ εὗσαν·	- uu- -- - --- u u --	dactylic hexameter	masculine penthemimeral, trithemimeral
αἶψα δέ μιν διέχευαν· ὁ δ’ὠμοθετεῖτο συβώτης,	-u u - uu-u u -uu-u u--	dactylic hexameter	feminine penthemimeral, trithemimeral
πάντοθεν ἀρχόμενος μελέων, ἐς πίονα δημόν,	-uu -uu- uu- - -uu --	dactylic hexameter	masculine penthemimeral, hepthemimeral
καὶ τὰ μὲν ἐν πυρὶ βάλλε, παλύνας ἀλφίτου ἀκτῇ,	- u u - uu -u u-- -uu --	dactylic hexameter	feminine penthemimeral, trithemimeral
μίστυλλόν τ’ἄρα τ’ἄλλα καὶ ἀμφ’ ὀβελοῖσιν ἔπειραν,	--- uu -u u - uu-u u--	dactylic hexameter	feminine penthemimeral, hepthemimeral, trithemimeral
ὤπτησάν τε περιφραδέως ἐρύσαντό τε πάντα,	--- u u-uu- uu-u u --	dactylic hexameter	hepthemimeral, trithemimeral
βάλλον δ’εἰν ἐλεοῖσιν ἀολλέα· ἂν δὲ συβώτης	-- - uu-u u-uu - u u--	dactylic hexameter	feminine penthemimeral, trithemimeral
ἵστατο δαιτρεύσων· περὶ γὰρ φρεσὶν αἴσιμα ᾔδη.	-uu --- uu - uu -uu --	dactylic hexameter	masculine penthemimeral, hepthemimeral
καὶ τὰ μὲν ἕπταχα πάντα διεμοιρᾶτο δαΐζων·	- u u -uu -u u---u u--	dactylic hexameter	feminine penthemimeral
τὴν μὲν ἴαν νύμφῃσι καὶ Ἑρμῇ, Μαιάδος υἱεῖ,	- u u- --u u -- -uu --	dactylic hexameter	feminine penthemimeral, trithemimeral
θῆκεν ἐπευξάμενος, τὰς δ’ἄλλας νεῖμεν ἑκάστῳ·	-u u-uu- - -- -u u--	dactylic hexameter	masculine penthemimeral
νώτοισιν δ’Ὀδυσῆα διηνεκέεσσι γέραιρεν	--- uu-u u-uu-u u--	dactylic hexameter	feminine penthemimeral, trithemimeral
ἀργιόδοντος ὑός, κύδαινε δὲ θυμὸν ἄνακτος·	-uu-u u- --u u -u u--	dactylic hexameter	masculine penthemimeral
καί μιν φωνήσας προσέφη πολύμητις Ὀδυσσεύς·	- - --- uu- uu-u u--	dactylic hexameter	masculine penthemimeral, hepthemimeral
αἴθ’ οὕτως, Εὔμαιε, φίλος Διῒ πατρὶ γένοιο	- -- --u u- uu -u u--	dactylic hexameter	feminine penthemimeral, hepthemimeral, trithemimeral
ὡς ἐμοί, ὅττι με τοῖον ἐόντ’ ἀγαθοῖσι γεραίρεις.	- uu -u u -u u- uu-u u--	dactylic hexameter	feminine penthemimeral, hepthemimeral
τὸν δ’ἀπαμειβόμενος προσέφης, Εὔμαιε συβῶτα·	- uu-uu- uu- --u u--	dactylic hexameter	masculine penthemimeral, hepthemimeral
ἔσθιε, δαιμόνιε ξείνων, καὶ τέρπεο τοῖσδε,	-uu -uu- -- - -uu --	dactylic hexameter	masculine penthemimeral, hepthemimeral
οἷα πάρεστι· θεὸς δὲ τὸ μὲν δώσει, τὸ δ’ἐάσει,	-u u-u u- u u - -- u u--	dactylic hexameter	masculine penthemimeral, hepthemimeral
ὅττι κεν ᾧ θυμῷ ἐθέλῃ· δύναται γὰρ ἅπαντα.	-u u - -- uu- uu- u u--	dactylic hexameter	masculine penthemimeral, hepthemimeral, trithemimeral
ἦ ῥα καὶ ἄργματα θῦσε θεοῖς αἰειγενέτῃσι,	- u u -uu -u u- --uu--	dactylic hexameter	feminine penthemimeral, hepthemimeral
σπείσας δ’αἴθοπα οἶνον Ὀδυσσῆϊ πτολιπόρθῳ	-- -uu -u u--- uu--	dactylic hexameter	feminine penthemimeral
ἐν χείρεσσιν ἔθηκεν· ὁ δ’ἕζετο ᾗ παρὰ μοίρῃ.	- --u u-u u -uu - uu --	dactylic hexameter	feminine penthemimeral
σῖτον δέ σφιν ἔνειμε Μεσαύλιος, ὅν ῥα συβώτης	-- - u u-u u-uu - u u--	dactylic hexameter	feminine penthemimeral, trithemimeral
αὐτὸς κτήσατο οἶος ἀποιχομένοιο ἄνακτος,	-- -uu -u u-uu-u u--	dactylic hexameter	feminine penthemimeral
νόσφιν δεσποίνης καὶ Λαέρταο γέροντος·	-- --- - ---u u--	dactylic hexameter	masculine penthemimeral
πὰρ δ’ἄρα μιν Ταφίων πρίατο κτεάτεσσιν ἑοῖσιν.	- uu - uu- uu- uu-u u--	dactylic hexameter	masculine penthemimeral, hepthemimeral, trithemimeral
οἱ δ’ἐπ’ ὀνείαθ’ ἑτοῖμα προκείμενα χεῖρας ἴαλλον.	- u u-u u-u u-uu -u u--	dactylic hexameter	feminine penthemimeral
αὐτὰρ ἐπεὶ πόσιος καὶ ἐδητύος ἐξ ἔρον ἕντο,	-u u- uu- u u-uu - uu --	dactylic hexameter	masculine penthemimeral, trithemimeral
σῖτον μέν σφιν ἀφεῖλε Μεσαύλιος, οἱ δ’ἐπὶ κοῖτον	-- - u u-u u-uu - uu --	dactylic hexameter	feminine penthemimeral, trithemimeral
σίτου καὶ κρειῶν κεκορημένοι ἐσσεύοντο.	-- - -- uu-uu ----	dactylic hexameter	masculine penthemimeral, trithemimeral
νὺξ δ’ἄρ’ ἐπῆλθε κακὴ σκοτομήνιος, ὗε δ’ἄρα Ζεὺς	- u u-u u- uu-uu -u u- -	dactylic hexameter	masculine penthemimeral
πάννυχος, αὐτὰρ ἄη Ζέφυρος μέγας αἰὲν ἔφυδρος.	-uu -u u- uu- uu -u u--	dactylic hexameter	masculine penthemimeral, hepthemimeral
τοῖς δ’Ὀδυσεὺς μετέειπε, συβώτεω πειρητίζων,	- uu- uu-u u-- ----	dactylic hexameter	feminine penthemimeral, trithemimeral
εἴ πώς οἱ ἐκδὺς χλαῖναν πόροι, ἤ τιν’ ἑταίρων	- - - -- -- uu - u u--	dactylic hexameter	masculine penthemimeral, hepthemimeral, trithemimeral
ἄλλον ἐποτρύνειεν, ἐπεί ἑο κήδετο λίην·	-u u---u u- - -uu --	dactylic hexameter	feminine penthemimeral, hepthemimeral
κέκλυθι νῦν, Εὔμαιε καὶ ἄλλοι πάντες ἑταῖροι,	-uu - --u u -- -u u--	dactylic hexameter	feminine penthemimeral, trithemimeral
εὐξάμενός τι ἔπος ἐρέω· οἶνος γὰρ ἀνώγει	-uu- u u- uu- -- u u--	dactylic hexameter	masculine penthemimeral, hepthemimeral, trithemimeral
ἠλεός, ὅς τ’ἐφέηκε πολύφρονά περ μάλ’ ἀεῖσαι	-uu - uu-u u-uu - u u--	dactylic hexameter	feminine penthemimeral, trithemimeral
καί θ’ἁπαλὸν γελάσαι, καί τ’ὀρχήσασθαι ἀνῆκε,	- uu- uu- - ---u u--	dactylic hexameter	masculine penthemimeral, trithemimeral
καί τι ἔπος προέηκεν ὅ περ τ’ἄρρητον ἄμεινον.	- u u- uu-u u - --u u--	dactylic hexameter	feminine penthemimeral, hepthemimeral, trithemimeral
ἀλλ’ ἐπεὶ οὖν τὸ πρῶτον ἀνέκραγον, οὐκ ἐπικεύσω.	- uu - - -u u-uu - uu--	dactylic hexameter	feminine penthemimeral, trithemimeral
εἴθ’ ὣς ἡβώοιμι βίη τέ μοι ἔμπεδος εἴη,	- - ---u u- u u -uu --	dactylic hexameter	feminine penthemimeral, hepthemimeral
ὡς ὅθ’ ὑπὸ Τροίην λόχον ἤγομεν ἀρτύναντες.	- u u- -- uu -uu ----	dactylic hexameter	masculine penthemimeral, trithemimeral
ἡγείσθην δ’Ὀδυσεύς τε καὶ Ἀτρεΐδης Μενέλαος,	--- uu- u u -uu- uu--	dactylic hexameter	masculine penthemimeral, trithemimeral
τοῖσι δ’ἅμα τρίτος ἤρχον ἐγών· αὐτοὶ γὰρ ἄνωγον.	-u u- uu -u u- -- u u--	dactylic hexameter	feminine penthemimeral, hepthemimeral, trithemimeral
ἀλλ’ ὅτε δή ῥ’ἱκόμεσθα ποτὶ πτόλιν αἰπύ τε τεῖχος,	- uu - uu-u u- uu -u u --	dactylic hexameter	feminine penthemimeral, hepthemimeral, trithemimeral
ἡμεῖς μὲν περὶ ἄστυ κατὰ ῥωπήϊα πυκνά,	-- - uu -u u- --uu --	dactylic hexameter	feminine penthemimeral, hepthemimeral, trithemimeral
ἂν δόνακας καὶ ἕλος, ὑπὸ τεύχεσι πεπτηῶτες	- uu- u u- uu -uu ----	dactylic hexameter	masculine penthemimeral, trithemimeral
κείμεθα. νὺξ δ’ἄρ’ ἐπῆλθε κακὴ Βορέαο πεσόντος,	-uu - u u-u u- uu-u u--	dactylic hexameter	feminine penthemimeral, hepthemimeral, trithemimeral
πηγυλίς· αὐτὰρ ὕπερθε χιὼν γένετ’ ἠΰτε πάχνη,	-uu -u u-u u- uu -uu --	dactylic hexameter	feminine penthemimeral, hepthemimeral
ψυχρή, καὶ σακέεσσι περιτρέφετο κρύσταλλος.	-- - uu-u u-uu- ---	dactylic hexameter	feminine penthemimeral, trithemimeral
ἔνθ’ ἄλλοι πάντες χλαίνας ἔχον ἠδὲ χιτῶνας,	- -- -- -- uu -u u--	dactylic hexameter	masculine penthemimeral, hepthemimeral, trithemimeral
εὗδον δ’εὔκηλοι, σάκεσιν εἰλυμένοι ὤμους·	-- --- uu- --uu --	dactylic hexameter	masculine penthemimeral, hepthemimeral
αὐτὰρ ἐγὼ χλαῖναν μὲν ἰὼν ἑτάροισιν ἔλειπον	-u u- -- u u- uu-u u--	dactylic hexameter	masculine penthemimeral, hepthemimeral, trithemimeral
ἀφραδέως, ἐπεὶ οὐκ ἐφάμην ῥιγωσέμεν ἔμπης,	-uu- uu - uu- --uu --	dactylic hexameter	masculine penthemimeral, hepthemimeral, trithemimeral
ἀλλ’ ἑπόμην σάκος οἶον ἔχων καὶ ζῶμα φαεινόν.	- uu- uu -u u- - -u u--	dactylic hexameter	feminine penthemimeral, hepthemimeral, trithemimeral
ἀλλ’ ὅτε δὴ τρίχα νυκτὸς ἔην, μετὰ δ’ἄστρα βεβήκει,	- uu - uu -u u- uu -u u--	dactylic hexameter	feminine penthemimeral, hepthemimeral, trithemimeral
καὶ τότ’ ἐγὼν Ὀδυσῆα προσηύδων ἐγγὺς ἐόντα	- u u- uu-u u-- -u u--	dactylic hexameter	feminine penthemimeral, trithemimeral
ἀγκῶνι νύξας· ὁ δ’ἄρ’ ἐμμαπέως ὑπάκουσε·	--- -- u u -uu- uu--	dactylic hexameter	masculine penthemimeral, trithemimeral
διογενὲς Λαερτιάδη, πολυμήχαν’ Ὀδυσσεῦ,	-uu- --uu- uu-u u--	dactylic hexameter	hepthemimeral, trithemimeral
οὔ τοι ἔτι ζωοῖσι μετέσσομαι, ἀλλά με χεῖμα	- u u- --u u-uu -u u --	dactylic hexameter	feminine penthemimeral, trithemimeral
δάμναται· οὐ γὰρ ἔχω χλαῖναν· παρά μ’ἤπαφε δαίμων	-uu - u u- -- uu -uu --	dactylic hexameter	masculine penthemimeral, hepthemimeral, trithemimeral
οἰοχίτων’ ἔμεναι· νῦν δ’οὐκέτι φυκτὰ πέλονται.	-uu- uu- - -uu -u u--	dactylic hexameter	masculine penthemimeral, trithemimeral
ὣς ἐφάμην, ὁ δ’ἔπειτα νόον σχέθε τόνδ’ ἐνὶ θυμῷ,	- uu- u u-u u- uu - uu --	dactylic hexameter	feminine penthemimeral, hepthemimeral, trithemimeral
οἷος ἐκεῖνος ἔην βουλευέμεν ἠδὲ μάχεσθαι·	-u u-u u- --uu -u u--	dactylic hexameter	masculine penthemimeral
φθεγξάμενος δ’ὀλίγῃ ὀπί με πρὸς μῦθον ἔειπε·	-uu- uu- uu - - -u u--	dactylic hexameter	masculine penthemimeral, hepthemimeral, trithemimeral
σίγα νῦν, μή τίς σευ Ἀχαιῶν ἄλλος ἀκούσῃ.	-- - - - u u-- -u u--	dactylic hexameter	masculine penthemimeral, trithemimeral
ἦ καὶ ἐπ’ ἀγκῶνος κεφαλὴν σχέθεν εἶπέ τε μῦθον·	- u u --- uu- uu -u u --	dactylic hexameter	masculine penthemimeral, hepthemimeral
κλῦτε, φίλοι· θεῖός μοι ἐνύπνιον ἦλθεν ὄνειρος.	-u u- -- u u-uu -u u--	dactylic hexameter	masculine penthemimeral, trithemimeral
λίην γὰρ νηῶν ἑκὰς ἤλθομεν· ἀλλά τις εἴη	-- - -- uu -uu -u u --	dactylic hexameter	masculine penthemimeral, trithemimeral
εἰπεῖν Ἀτρεΐδῃ Ἀγαμέμνονι, ποιμένι λαῶν,	-- -uu- uu-uu -uu --	dactylic hexameter	masculine penthemimeral
εἰ πλέονας παρὰ ναῦφιν ἐποτρύνειε νέεσθαι.	- uu- uu -u u---u u--	dactylic hexameter	feminine penthemimeral, trithemimeral
ὣς ἔφατ’, ὦρτο δ’ἔπειτα Θόας, Ἀνδραίμονος υἱός,	- uu -u u-u u- --uu --	dactylic hexameter	feminine penthemimeral, hepthemimeral
καρπαλίμως, ἀπὸ δὲ χλαῖναν θέτο φοινικόεσσαν,	-uu- uu - -- uu -uu--	dactylic hexameter	masculine penthemimeral, hepthemimeral, trithemimeral
βῆ δὲ θέειν ἐπὶ νῆας· ἐγὼ δ’ἐνὶ εἵματι κείνου	- u u- uu -u u- uu -uu --	dactylic hexameter	feminine penthemimeral, hepthemimeral, trithemimeral
κείμην ἀσπασίως, φάε δὲ χρυσόθρονος Ἠώς.	-- -uu- uu - --uu --	dactylic hexameter	masculine penthemimeral, hepthemimeral
ὣς νῦν ἡβώοιμι βίη τέ μοι ἔμπεδος εἴη·	- - ---u u- u u -uu --	dactylic hexameter	feminine penthemimeral, hepthemimeral
δοίη κέν τις χλαῖναν ἐνὶ σταθμοῖσι συφορβῶν,	-- - - -u u- --u u--	dactylic hexameter	feminine penthemimeral, hepthemimeral, trithemimeral
ἀμφότερον, φιλότητι καὶ αἰδοῖ φωτὸς ἑῆος·	-uu- uu-u u -- -u u--	dactylic hexameter	feminine penthemimeral, trithemimeral
νῦν δέ μ’ἀτιμάζουσι κακὰ χροῒ εἵματ’ ἔχοντα.	- u u---u u- uu -u u--	dactylic hexameter	feminine penthemimeral, hepthemimeral
τὸν δ’ἀπαμειβόμενος προσέφης, Εὔμαιε συβῶτα·	- uu-uu- uu- --u u--	dactylic hexameter	masculine penthemimeral, hepthemimeral
ὦ γέρον, αἶνος μέν τοι ἀμύμων, ὃν κατέλεξας,	- uu -- - u u-- - uu--	dactylic hexameter	masculine penthemimeral
οὐδέ τί πω παρὰ μοῖραν ἔπος νηκερδὲς ἔειπες·	-u u - uu -u u- --u u--	dactylic hexameter	feminine penthemimeral, hepthemimeral, trithemimeral
τῶ οὔτ’ ἐσθῆτος δευήσεαι οὔτε τευ ἄλλου,	- - --- --uu -u u --	dactylic hexameter	masculine penthemimeral
ὧν ἐπέοιχ’ ἱκέτην ταλαπείριον ἀντιάσαντα,	- uu- uu- uu-uu -uu--	dactylic hexameter	masculine penthemimeral, trithemimeral
νῦν· ἀτὰρ ἠῶθέν γε τὰ σὰ ῥάκεα δνοπαλίξεις.	- uu --- u u - uu- uu--	dactylic hexameter	masculine penthemimeral, hepthemimeral
οὐ γὰρ πολλαὶ χλαῖναι ἐπημοιβοί τε χιτῶνες	- - -- -u u--- u u--	dactylic hexameter	feminine penthemimeral
ἐνθάδε ἕννυσθαι, μία δ’οἴη φωτὶ ἑκάστῳ.	-uu --- uu -- -u u--	dactylic hexameter	masculine penthemimeral
αὐτὰρ ἐπὴν ἔλθῃσιν Ὀδυσσῆος φίλος υἱός,	-u u- --u u--- uu --	dactylic hexameter	feminine penthemimeral, trithemimeral
αὐτός τοι χλαῖνάν τε χιτῶνά τε εἵματα δώσει,	-- - -- u u-u u -uu --	dactylic hexameter	masculine penthemimeral, trithemimeral
πέμψει δ’ὅππῃ σε κραδίη θυμός τε κελεύει.	-- -- - uu- -- u u--	dactylic hexameter	masculine penthemimeral, hepthemimeral
ὣς εἰπὼν ἀνόρουσε, τίθει δ’ἄρα οἱ πυρὸς ἐγγὺς	- -- uu-u u- uu - uu --	dactylic hexameter	feminine penthemimeral, hepthemimeral, trithemimeral
εὐνήν, ἐν δ’ὀΐων τε καὶ αἰγῶν δέρματ’ ἔβαλλεν.	-- - uu- u u -- -u u--	dactylic hexameter	masculine penthemimeral, trithemimeral
ἔνθ’ Ὀδυσεὺς κατέλεκτ’· ἐπὶ δὲ χλαῖναν βάλεν αὐτῷ	- uu- uu- uu - -- uu --	dactylic hexameter	masculine penthemimeral, hepthemimeral, trithemimeral
πυκνὴν καὶ μεγάλην, ἥ οἱ παρεκέσκετ’ ἀμοιβάς,	-- - uu- - - uu-u u--	dactylic hexameter	masculine penthemimeral, hepthemimeral, trithemimeral
ἕννυσθαι ὅτε τις χειμὼν ἔκπαγλος ὄροιτο.	--- uu - -- --u u--	dactylic hexameter	masculine penthemimeral, hepthemimeral, trithemimeral
ὣς ὁ μὲν ἔνθ’ Ὀδυσεὺς κοιμήσατο, τοὶ δὲ παρ’ αὐτὸν	- u u - uu- --uu - u u --	dactylic hexameter	masculine penthemimeral, trithemimeral
ἄνδρες κοιμήσαντο νεηνίαι· οὐδὲ συβώτῃ	-- ---u u-uu -u u--	dactylic hexameter	feminine penthemimeral
ἥνδανεν αὐτόθι κοῖτος, ὑῶν ἄπο κοιμηθῆναι,	-uu -uu -u u- uu ----	dactylic hexameter	feminine penthemimeral, hepthemimeral
ἀλλ’ ὅ γ’ἄρ’ ἔξω ἰὼν ὡπλίζετο· χαῖρε δ’Ὀδυσσεύς,	- u u -u u- --uu -u u--	dactylic hexameter	masculine penthemimeral
ὅττι ῥά οἱ βιότου περικήδετο νόσφιν ἐόντος.	-u u - uu- uu-uu -u u--	dactylic hexameter	masculine penthemimeral, trithemimeral
πρῶτον μὲν ξίφος ὀξὺ περὶ στιβαροῖς βάλετ’ ὤμοις,	-- - uu -u u- uu- uu --	dactylic hexameter	feminine penthemimeral, hepthemimeral, trithemimeral
ἀμφὶ δὲ χλαῖναν ἑέσσατ’ ἀλεξάνεμον, μάλα πυκνήν,	-u u -u u-u u-uu- uu --	dactylic hexameter	feminine penthemimeral
ἂν δὲ νάκην ἕλετ’ αἰγὸς ἐϋτρεφέος μεγάλοιο,	- u u- uu -u u-uu- uu--	dactylic hexameter	feminine penthemimeral, trithemimeral
εἵλετο δ’ὀξὺν ἄκοντα, κυνῶν ἀλκτῆρα καὶ ἀνδρῶν.	-uu -u u-u u- --u u --	dactylic hexameter	feminine penthemimeral, hepthemimeral
βῆ δ’ἴμεναι κείων ὅθι περ σύες ἀργιόδοντες	- uu- -- uu - uu -uu--	dactylic hexameter	masculine penthemimeral, hepthemimeral, trithemimeral
πέτρῃ ὕπο γλαφυρῇ εὗδον, Βορέω ὑπ’ ἰωγῇ.	-u u- uu- -- uu- u u--	dactylic hexameter	masculine penthemimeral, hepthemimeral, trithemimeral
