ἄριστον μὲν ὕδωρ, ὁ δὲ χρυσὸς αἰθόμενον πῦρ	u-- u u- u - -u -uu- -	lyric	
ἅτε διαπρέπει νυκτὶ μεγάνορος ἔξοχα πλούτου·	uu u-u- -u u-uu -uu --	lyric	
εἰ δ᾽ἄεθλα γαρύεν	- u-u -u-	lyric	
ἔλδεαι, φίλον ἦτορ,	-u- uu --	lyric	
μηκέτʼ ἀελίου σκόπει	-u -u- u-	lyric	
ἄλλο θαλπνότερον ἐν ἁμέρᾳ φαεννὸν ἄστρον ἐρήμας διʼ αἰθέρος,	-u -uuu u -u- u-u -u u-- u -u-	lyric	
μηδʼ Ὀλυμπίας ἀγῶνα φέρτερον αὐδάσομεν·	- u-u- u-u -uu --u-	lyric	
ὅθεν ὁ πολύφατος ὕμνος ἀμφιβάλλεται	uu u uuuu -u -u-u-	lyric	
σοφῶν μητίεσσι, κελαδεῖν	u- -u-u uu-	lyric	
Κρόνου παῖδʼ ἐς ἀφνεὰν ἱκομένους	u- - u -u- uuu-	lyric	
μάκαιραν Ἱέρωνος ἑστίαν,	u-u uu-u -u-	lyric	
θεμιστεῖον ὃς ἀμφέπει σκᾶπτον ἐν πολυμάλῳ	u--u u -u- -u - uu--	lyric	
Σικελίᾳ, δρέπων μὲν κορυφὰς ἀρετᾶν ἄπο πασᾶν,	uuu- u- - uu- uu- uu --	lyric	
ἀγλαΐζεται δὲ καὶ	-u-u- u -	lyric	
μουσικᾶς ἐν ἀώτῳ,	-u- u u--	lyric	
οἷα παίζομεν φίλαν	-u -u- u-	lyric	
ἄνδρες ἀμφὶ θαμὰ τράπεζαν. ἀλλὰ Δωρίαν ἀπὸ φόρμιγγα πασσάλου	-u -u uu u-u -u -u- uu --u -u-	lyric	
λάμβανʼ, εἴ τί τοι Πίσας τε καὶ Φερενίκου χάρις	-u - u - u- u - uu-- u-	lyric	
νόον ὑπὸ γλυκυτάταις ἔθηκε φροντίσιν,	uu uu uuu- u-u -u-	lyric	
ὅτε παρʼ Ἀλφεῷ σύτο, δέμας	uu u -u- uu u-	lyric	
ἀκέντητον ἐν δρόμοισι παρέχων,	u--u - u-u uu-	lyric	
κράτει δὲ προσέμιξε δεσπόταν,	u- u uu-u -u-	lyric	
Συρακόσιον ἱπποχάρμαν βασιλῆα. λάμπει δέ οἱ κλέος	u-uuu -u-- uu-u -- u - u-	lyric	
ἐν εὐάνορι Λυδοῦ Πέλοπος ἀποικίᾳ·	u --uu -- uuu u-u-	lyric	
τοῦ μεγασθενὴς ἐράσσατο γαιάοχος	- u-u- u-uu --u-	lyric	
Ποσειδᾶν, ἐπεί νιν καθαροῦ λέβητος ἔξελε Κλωθὼ	u-- u- - uu- u-u -uu --	lyric	
ἐλέφαντι φαίδιμον ὦμον κεκαδμένον.	uu-u -uu -- u-u-	lyric	
ἦ θαυματὰ πολλά, καί πού τι καὶ βροτῶν	- -uu -u - - u - u-	lyric	
φάτις ὑπὲρ τὸν ἀλαθῆ λόγον	uu u- u u-- u-	lyric	
δεδαιδαλμένοι ψεύδεσι ποικίλοις ἐξαπατῶντι μῦθοι	u--u- -uu -u- -uu-u --	lyric	
Χάρις δ᾽,ἅπερ ἅπαντα τεύχει τὰ μείλιχα θνατοῖς,	u- -u u-u -- u -uu --	lyric	
ἐπιφέροισα τιμὰν καὶ ἄπιστον ἐμήσατο πιστὸν	uuu-u -- u u-u u-uu --	lyric	
ἔμμεναι τὸ πολλάκις·	-u- u -u-	lyric	
ἁμέραι δ᾽ἐπίλοιποι	-u- uu--	lyric	
μάρτυρες σοφώτατοι.	-u- u-u-	lyric	
ἔστι δ᾽ἀνδρὶ φάμεν ἐοικὸς ἀμφὶ δαιμόνων καλά· μείων γὰρ αἰτία.	-u -u uu u-u -u -u- uu -- u -u-	lyric	
υἱὲ Ταντάλου, σὲ δ᾽,ἀντία προτέρων, φθέγξομαι,	-u -u- u -u- uu- -u-	lyric	
ὁπότʼ ἐκάλεσε πατὴρ τὸν εὐνομώτατον	uu uuuu u- u -u-u-	lyric	
ἐς ἔρανον φίλαν τε Σίπυλον,	u uu- u- u uu-	lyric	
ἀμοιβαῖα θεοῖσι δεῖπνα παρέχων,	u--u -u -u uu-	lyric	
τότʼ Ἀγλαοτρίαιναν ἁρπάσαι	u -uuu-u -u-	lyric	
δαμέντα φρένας ἱμέρῳ χρυσέαισί τ᾽ἀνʼ ἵπποις	u-- uu -u- -u-u u --	lyric	
ὕπατον εὐρυτίμου ποτὶ δῶμα Διὸς μεταβᾶσαι,	uuu -u-- uu -u u- uu--	lyric	
ἔνθα δευτέρῳ χρόνῳ	-u -u- u-	lyric	
ἦλθε καὶ Γανυμήδης	-u - uu--	lyric	
Ζηνὶ τωὔτʼ ἐπὶ χρέος.	-u - u- u-	lyric	
ὡς δ᾽ἄφαντος ἔπελες, οὐδὲ ματρὶ πολλὰ μαιόμενοι φῶτες ἄγαγον,	- u-u uuu -u -u -u -uu- -u -u-	lyric	
ἔννεπε κρυφᾶ τις αὐτίκα φθονερῶν γειτόνων,	-u- u- u -u- uu- -u-	lyric	
ὕδατος ὅτι σε πυρὶ ζέοισαν εἰς ἀκμὰν	uuu uu u u- u-u - u-	lyric	
μαχαίρᾳ τάμον κάτα μέλη,	u-- u- uu u-	lyric	
τραπέζαισί τ᾽,ἀμφὶ δεύτατα, κρεῶν	u--u -u -uu u-	lyric	
σέθεν διεδάσαντο καὶ φάγον.	u- uuu-u - u-	lyric	
ἐμοὶ δ᾽ἄπορα γαστρίμαργον μακάρων τινʼ εἰπεῖν. ἀφίσταμαι.	u- uuu -u-- uu- u -- u-u-	lyric	
ἀκέρδεια λέλογχεν θαμινὰ κακαγόρους.	u--u u-- uuu u-u-	lyric	
εἰ δὲ δή τινʼ ἄνδρα θνατὸν Ὀλύμπου σκοποὶ	- u - u -u -u u-- u-	lyric	
ἐτίμασαν, ἦν Τάνταλος οὗτος· ἀλλὰ γὰρ καταπέψαι	u--u - -uu -u -u - uu--	lyric	
μέγαν ὄλβον οὐκ ἐδυνάσθη, κόρῳ δ᾽ἕλεν	uu -u - uu-- u- u-	lyric	
ἄταν ὑπέροπλον, ἅν οἱ πατὴρ ὑπερ	-- uu-u - - u- u-	lyric	
κρέμασε καρτερὸν αὐτῷ λίθον,	uuu -uu -- u-	lyric	
τὸν αἰεὶ μενοινῶν κεφαλᾶς βαλεῖν εὐφροσύνας ἀλᾶται.	u -- u-- uu- u- -uu- u--	lyric	
ἔχει δ᾽ἀπάλαμον βίον τοῦτον ἐμπεδόμοχθον,	u- -uu- u- -u -uu--	lyric	
μετὰ τριῶν τέταρτον πόνον, ἀθανάτων ὅτι κλέψαις	uu u- u-- uu -uu- uu --	lyric	
ἁλίκεσσι συμπόταις	-u-u -u-	lyric	
νέκταρ ἀμβροσίαν τε	-u -uu- -	lyric	
δῶκεν, οἷσιν ἄφθιτον	-u -u -u-	lyric	
θέν νιν. εἰ δὲ θεὸν ἀνήρ τις ἔλπεταί τι λαθέμεν ἔρδων, ἁμαρτάνει.	- u - u uu u- u -u- u -uu -- u-u-	lyric	
τοὔνεκα προῆκαν υἱὸν ἀθάνατοί οἱ πάλιν	-u- u-u -u -uu- - u-	lyric	
μετὰ τὸ ταχύποτμον αὖτις ἀνέρων ἔθνος.	uu u uuuu -u -u- u-	lyric	
πρὸς εὐάνθεμον δ᾽ὅτε φυὰν	u --u- uu u-	lyric	
λάχναι νιν μέλαν γένειον ἔρεφον,	u- - u- u-u uu-	lyric	
ἑτοῖμον ἀνεφρόντισεν γάμον	u-u uu-u- u-	lyric	
Πισάτα παρὰ πατρὸς εὔδοξον Ἱπποδάμειαν	u-- uu -u --u -uu--	lyric	
σχεθέμεν. ἐγγὺς ἐλθὼν πολιᾶς ἁλὸς οἶος ἐν ὄρφνᾳ	uuu -u -- uu- uu -u u --	lyric	
ἄπυεν βαρύκτυπον	-u- u-u-	lyric	
Εὐτρίαιναν· ὁ δ᾽αὐτῷ	-u-u u --	lyric	
πὰρ ποδὶ σχεδὸν φάνη.	- u- u- u-	lyric	
τῷ μὲν εἶπε: ‘φίλια δῶρα Κυπρίας ἄγʼ εἴ τι, Ποσείδαον, ἐς χάριν	- u -u uuu -u -u- u - u u--u - u-	lyric	
τέλλεται, πέδασον ἔγχος Οἰνομάου χάλκεον,	-u- u-u -u -uu- -u-	lyric	
ἐμὲ δ᾽ἐπὶ ταχυτάτων πόρευσον ἁρμάτων	uu uu uuu- u-u -u-	lyric	
ἐς Ἆλιν, κράτει δὲ πέλασον.	u -- u- u uu-	lyric	
ἐπεὶ τρεῖς τε καὶ δέκʼ ἄνδρας ὀλέσαις	u- - u - u -u uu-	lyric	
μναστῆρας ἀναβάλλεται γάμον	--u uu-u- u-	lyric	
θυγατρός. ὁ μέγας δὲ κίνδυνος ἄναλκιν οὐ φῶτα λαμβάνει.	u-u u u- u --u u-u - -u -u-	lyric	
θανεῖν δ᾽οἷσιν ἀνάγκα, τί κέ τις ἀνώνυμον	u- -u u-- u u u u-u-	lyric	
γῆρας ἐν σκότῳ καθήμενος ἕψοι μάταν,	-u - u- u-uu -- u-	lyric	
ἁπάντων καλῶν ἄμμορος; ἀλλʼ ἐμοὶ μὲν οὗτος ἄεθλος	u-- u- -uu - u- u -u u--	lyric	
ὑποκείσεται· τὺ δὲ πρᾶξιν φίλαν δίδοι.	uu-u- u u -- u- u-	lyric	
ὣς ἔννεπεν· οὐδʼ ἀκράντοις ἐφάψατο	- -uu - u-- u-u-	lyric	
ἔπεσι. τὸν μὲν ἀγάλλων θεὸς	uuu - u u-- u-	lyric	
ἔδωκεν δίφρον τε χρύσεον πτεροῖσίν τ᾽ἀκάμαντας ἵππους.	u-- u- - uu- u-- uu-u --	lyric	
ἕλεν δ᾽Οἰνομάου βίαν παρθένον τε σύνευνον·	u- -uu- u- -u- u u--	lyric	
τέκε τε λαγέτας ἓξ ἀρεταῖσι μεμαότας υἱούς.	uu u -u- - uu-u u-uu --	lyric	
νῦν δ᾽ἐν αἱμακουρίαις	- u -u-u-	lyric	
ἀγλααῖσι μέμικται,	-u-u u--	lyric	
Ἀλφεοῦ πόρῳ κλιθείς,	-u- u- u-	lyric	
τύμβον ἀμφίπολον ἔχων πολυξενωτάτῳ παρὰ βωμῷ. τὸ δὲ κλέος	-u -uuu u- u-u-u- uu -- u - u-	lyric	
τηλόθεν δέδορκε τᾶν Ὀλυμπιάδων ἐν δρόμοις	-u- u-u - u-uu- - u-	lyric	
Πέλοπος, ἵνα ταχυτὰς ποδῶν ἐρίζεται	uuu uu uu- u- u-u-	lyric	
ἀκμαί τ᾽ἰσχύος θρασύπονοι·	u- -u- uuu-	lyric	
ὁ νικῶν δὲ λοιπὸν ἀμφὶ βίοτον	u -- u -u -u uu-	lyric	
ἔχει μελιτόεσσαν εὐδίαν	u- uuu-u -u-	lyric	
ἀέθλων γ᾽ἕνεκεν. τὸ δ᾽αἰεὶ παράμερον ἐσλὸν	u-- uu- u -- u-uu --	lyric	
ὕπατον ἔρχεται παντὶ βροτῶν. ἐμὲ δὲ στεφανῶσαι	uuu -u- -u u- uu - uu--	lyric	
κεῖνον ἱππίῳ νόμῳ	-u -u- u-	lyric	
Αἰοληΐδι μολπᾷ	-u-uu --	lyric	
χρή· πέποιθα δὲ ξένον	- u-u - u-	lyric	
μή τινʼ, ἀμφότερα καλῶν τε ἴδριν ἅμα καὶ δύναμιν κυριώτερον,	- u -uuu u- u -u -u - uu- -u-u-	lyric	
τῶν γε νῦν κλυταῖσι δαιδαλωσέμεν ὕμνων πτυχαῖς.	- u - u-u -u-uu -- u-	lyric	
θεὸς ἐπίτροπος ἐὼν τεαῖσι μήδεται	uu uuuu u- u-u -u-	lyric	
ἔχων τοῦτο κᾶδος, Ἱέρων,	u- -u -u uu-	lyric	
μερίμναισιν· εἰ δὲ μὴ ταχὺ λίποι,	u--u - u - uu u-	lyric	
ἔτι γλυκυτέραν κεν ἔλπομαι	u- uuu- u -u-	lyric	
σὺν ἅρματι θοῷ κλεΐξειν, ἐπίκουρον εὑρὼν ὁδὸν λόγων	u -uu u- u-- uu-u -- u- u-	lyric	
παρʼ εὐδείελον ἐλθὼν Κρόνιον. ἐμοὶ μὲν ὦν	u --uu -- uuu u- u -	lyric	
Μοῖσα καρτερώτατον βέλος ἀλκᾷ τρέφει·	-u -u-u- uu -- u-	lyric	
ἐπʼ ἄλλοισι δ᾽ἄλλοι μεγάλοι. τὸ δ᾽ἔσχατον κορυφοῦται	u --u -- uu- u -u- uu--	lyric	
βασιλεῦσι. μηκέτι πάπταινε πόρσιον.	uu-u -uu --u -u-	lyric	
εἴη σέ τε τοῦτον ὑψοῦ χρόνον πατεῖν,	-- u u -u -- u- u-	lyric	
ἐμέ τε τοσσάδε νικαφόροις	uu u -uu --u-	lyric	
ὁμιλεῖν, πρόφαντον σοφίᾳ καθʼ Ἕλλανας ἐόντα παντᾷ.	u-- u-- uu- u --u u-u --	lyric	
ἀναξιφόρμιγγες ὕμνοι,	u-u--u --	lyric	
τίνα θεόν, τίνʼ ἥρωα, τίνα δ᾽ἄνδρα κελαδήσομεν;	uu u- u --u uu -u uu-u-	lyric	
ἤτοι Πίσα μὲν Διός· Ὀλυμπιάδα δ᾽ἔστασεν Ἡρακλέης	-- u- - uu u-uuu --u --u-	lyric	
ἀκρόθινα πολέμου·	-u-u uu-	lyric	
Θήρωνα δὲ τετραορίας ἕνεκα νικαφόρου	--u u u-u- uuu --u-	lyric	
γεγωνητέον, ὄπι δίκαιον ξένων, ἔρεισμʼ Ἀκράγαντος,	u--uu u- u-- u- u- -u--	lyric	
εὐωνύμων τε πατέρων ἄωτον ὀρθόπολιν·	--u- u uu- u-u -uu-	lyric	
καμόντες οἳ πολλὰ θυμῷ	u-u - -u --	lyric	
ἱερὸν ἔσχον οἴκημα ποταμοῦ, Σικελίας τ᾽ἔσαν	uuu -u --u uu- uuu- u-	lyric	
ὀφθαλμός, αἰὼν δ᾽ἔφεπε μόρσιμος, πλοῦτόν τε καὶ χάριν ἄγων	--u -- uuu -u- -- u - uu u-	lyric	
γνησίαις ἐπʼ ἀρεταῖς.	-u- u uu-	lyric	
ἀλλʼ ὦ Κρόνιε παῖ Ῥέας, ἕδος Ὀλύμπου νέμων	- - uuu - u- uu u-- u-	lyric	
ἀέθλων τε κορυφὰν πόρον τ᾽Ἀλφεοῦ, ἰανθεὶς ἀοιδαῖς	u-- u uu- u- -u- u-- u--	lyric	
εὔφρων ἄρουραν ἔτι πατρίαν σφίσιν κόμισον	-- u-u uu -u- u- uu-	lyric	
λοιπῷ γένει. τῶν δὲ πεπραγμένων	-- u- - u --u-	lyric	
ἐν δίκᾳ τε καὶ παρὰ δίκαν, ἀποίητον οὐδʼ ἂν	- u- u - uu u- u--u - -	lyric	
χρόνος ὁ πάντων πατὴρ δύναιτο θέμεν ἔργων τέλος·	uu u -- u- u-u uu -- u-	lyric	
λάθα δὲ πότμῳ σὺν εὐδαίμονι γένοιτʼ ἄν.	-- u -- u --uu u- -	lyric	
ἐσλῶν γὰρ ὑπὸ χαρμάτων πῆμα θνάσκει	-- u uu -u- -u --	lyric	
παλίγκοτον δαμασθέν,	u-u- u--	lyric	
ὅταν θεοῦ Μοῖρα πέμπῃ	u- u- -u --	lyric	
ἀνεκὰς ὄλβον ὑψηλόν. ἕπεται δὲ λόγος εὐθρόνοις	uuu -u --u uu- u uu -u-	lyric	
Κάδμοιο κούραις, ἔπαθον αἳ μεγάλα, πένθος δ᾽ἐπίτνει βαρὺ	--u -- uuu - uuu -- u-- u-	lyric	
κρεσσόνων πρὸς ἀγαθῶν.	-u- u uu-	lyric	
ζώει μὲν ἐν Ὀλυμπίοις ἀποθανοῖσα βρόμῳ	-- u u u-u- uuu-- u-	lyric	
κεραυνοῦ τανυέθειρα Σεμέλα, φιλεῖ δέ νιν Παλλὰς αἰεί,	u-- uuu-u uu- u- u - -u --	lyric	
καὶ Ζεὺς πατὴρ μάλα, φιλεῖ δὲ παῖς ὁ κισσοφόρος·	- - u- uu u- u - u -uu-	lyric	
λέγοντι δ᾽ἐν καὶ θαλάσσᾳ	u-u - - u--	lyric	
μετὰ κόραισι Νηρῆος ἁλίαις βίοτον ἄφθιτον	uu u-u --u uu- uuu -u-	lyric	
Ἰνοῖ τετάχθαι τὸν ὅλον ἀμφὶ χρόνον. ἤτοι βροτῶν γε κέκριται	-- u-- u uu -u uu -- u- u uu-	lyric	
πεῖρας οὔ τι θανάτου,	-u - u uu-	lyric	
οὐδʼ ἡσύχιμον ἁμέραν ὁπότε, παῖδʼ ἀελίου,	- -uuu -u- uuu - uuu-	lyric	
ἀτειρεῖ σὺν ἀγαθῷ τελευτάσομεν· ῥοαὶ δ᾽ἄλλοτʼ ἄλλαι	u-- u uu- u--u- u- -u --	lyric	
εὐθυμιᾶν τε μετὰ καὶ πόνων ἐς ἄνδρας ἔβαν.	--u- u uu - u- u -u u-	lyric	
οὕτω δὲ Μοῖρʼ, ἅ τε πατρώιον	-- u - - u --u-	lyric	
τῶνδʼ ἔχει τὸν εὔφρονα πότμον, θεόρτῳ σὺν ὄλβῳ	- u- u -uu u- u-- u --	lyric	
ἐπί τι καὶ πῆμʼ ἄγει παλιντράπελον ἄλλῳ χρόνῳ·	uu u - - u- u-uuu -- u-	lyric	
ἐξ οὗπερ ἔκτεινε Λᾷον μόριμος υἱὸς	- -u --u -- uuu --	lyric	
συναντόμενος, ἐν δὲ Πυθῶνι χρησθὲν	u-uuu - u --u --	lyric	
παλαίφατον τέλεσσεν.	u-u- u--	lyric	
ἰδοῖσα δ᾽ὀξεῖʼ Ἐριννὺς	u-u -- u--	lyric	
ἔπεφνέ οἱ σὺν ἀλλαλοφονίᾳ γένος ἀρήιον·	uuu - u --uuu- uu u-u-	lyric	
λείφθη δὲ Θέρσανδρος ἐριπέντι Πολυνείκει, νέοις ἐν ἀέθλοις	-- u --u uu-u uu-- u- u uu-	lyric	
ἐν μάχαις τε πολέμου	- u- u uu-	lyric	
τιμώμενος, Ἀδραστιδᾶν θάλος ἀρωγὸν δόμοις·	--uu u-u- uu u-- u-	lyric	
ὅθεν σπέρματος ἔχοντα ῥίζαν, πρέπει τὸν Αἰνησιδάμου	u- -uu u-u -- u- u --u--	lyric	
ἐγκωμίων τε μελέων λυρᾶν τε τυγχανέμεν.	--u- u uu- u- u -uu-	lyric	
Ὀλυμπίᾳ μὲν γὰρ αὐτὸς	u-u- - u --	lyric	
γέρας ἔδεκτο, Πυθῶνι δ᾽ὁμόκλαρον ἐς ἀδελφεὸν	uu u-u --u uu-u u u-u-	lyric	
Ἰσθμοῖ τε κοιναὶ Χάριτες ἄνθεα τεθρίππων δυωδεκαδρόμων	-- u -- uuu -uu u-- u-uuu-	lyric	
ἄγαγον. τὸ δὲ τυχεῖν	-u- u u u-	lyric	
πειρώμενον ἀγωνίας δυσφρονᾶν παραλύει.	--uu u-u- -u- uuu-	lyric	
ὁ μὰν πλοῦτος ἀρεταῖς δεδαιδαλμένος φέρει τῶν τε καὶ τῶν	u - -u uu- u--u- u- - u - -	lyric	
καιρόν, βαθεῖαν ὑπέχων μέριμναν ἀγροτέραν,	-- u-u uu- u-u -uu-	lyric	
ἀστὴρ ἀρίζηλος, ἐτυμώτατον	-- u--u uu-u-	lyric	
ἀνδρὶ φέγγος· εἰ δέ νιν ἔχων τις οἶδεν τὸ μέλλον,	-u -u - u u u- u -- u --	lyric	
ὅτι θανόντων μὲν ἐνθάδʼ αὐτίκʼ ἀπάλαμνοι φρένες	uu u-- u -u -u uu-- u-	lyric	
ποινὰς ἔτισαν, τὰ δ᾽ἐν τᾷδε Διὸς ἀρχᾷ	-- u-- u - -u uu --	lyric	
ἀλιτρὰ κατὰ γᾶς δικάζει τις ἐχθρᾷ	u-u uu - u-- u --	lyric	
λόγον φράσαις ἀνάγκᾳ·	u- u- u--	lyric	
ἴσαις δὲ νύκτεσσιν αἰεί,	u- u --u --	lyric	
ἴσαις δ᾽ ἁμέραις ἅλιον ἔχοντες, ἀπονέστερον	u- -u- -uu u-u uu-u-	lyric	
ἐσλοὶ δέκονται βίοτον, οὐ χθόνα ταράσσοντες ἐν χερὸς ἀκμᾷ	-- u-- uuu - uu u--u - uu u-	lyric	
οὐδὲ πόντιον ὕδωρ	-u -uu u-	lyric	
κεινὰν παρὰ δίαιταν· ἀλλὰ παρὰ μὲν τιμίοις	-- uu u-u -u uu - -u-	lyric	
θεῶν, οἵτινες ἔχαιρον εὐορκίαις, ἄδακρυν νέμονται	u- -uu u-u --u- u-- u--	lyric	
αἰῶνα· τοὶ δ᾽ἀπροσόρατον ὀκχέοντι πόνον	--u - uuu-u -u-u u-	lyric	
ὅσοι δ᾽ἐτόλμασαν ἐστρὶς	u- u--u --	lyric	
ἑκατέρωθι μείναντες ἀπὸ πάμπαν ἀδίκων ἔχειν	uuu-u --u uu -u uu- u-	lyric	
ψυχάν, ἔτειλαν Διὸς ὁδὸν παρὰ Κρόνου τύρσιν· ἔνθα μακάρων	-- u-- uu u- uu u- -u -u uu-	lyric	
νᾶσον ὠκεανίδες	-u -uuu-	lyric	
αὖραι περιπνέοισιν, ἄνθεμα δὲ χρυσοῦ φλέγει,	-- uuu-u -uu u -- u-	lyric	
τὰ μὲν χερσόθεν ἀπʼ ἀγλαῶν δενδρέων, ὕδωρ δ᾽ἄλλα φέρβει,	u - -uu u -u- -u- u- -u --	lyric	
ὅρμοισι τῶν χέρας ἀναπλέκοντι καὶ στεφάνους	--u - uu u-u-u - uu-	lyric	
βουλαῖς ἐν ὀρθαῖσι Ῥαδαμάνθυος,	-- u --u uu-u-	lyric	
ὃν πατὴρ ἔχει μέγας ἑτοῖμον αὐτῷ πάρεδρον,	- u- u- uu u-u -- u--	lyric	
πόσις ὁ πάντων Ῥέας ὑπέρτατον ἐχοίσας θρόνον.	uu u -- u- u-uu u-- u-	lyric	
Πηλεύς τε καὶ Κάδμος ἐν τοῖσιν ἀλέγονται·	-- u - -u - -u uu--	lyric	
Ἀχιλλέα τ᾽ἔνεικʼ, ἐπεὶ Ζηνὸς ἦτορ	u-uu u- u- -u --	lyric	
λιταῖς ἔπεισε, μάτηρ·	u- u-u --	lyric	
ὃς Ἕκτορʼ ἔσφαλε, Τροίας	u -u --u --	lyric	
ἄμαχον ἀστραβῆ κίονα, Κύκνον τε θανάτῳ πόρεν,	uuu -u- -uu u- u uu- u-	lyric	
Ἀοῦς τε παῖδʼ Αἰθίοπα. πολλά μοι ὑπʼ ἀγκῶνος ὠκέα βέλη	-- u - -uuu -u u u --u -uu u-	lyric	
ἔνδον ἐντι φαρέτρας	-u -u uu-	lyric	
φωνᾶντα συνετοῖσιν· ἐς δὲ τὸ πὰν ἑρμηνέων	--u uu-u - u u u --u-	lyric	
χατίζει. σοφὸς ὁ πολλὰ εἰδὼς φυᾷ· μαθόντες δὲ λάβροι	u-- uu u -u -- u- u-- u --	lyric	
παγγλωσσίᾳ, κόρακες ὥς, ἄκραντα γαρύετων	--u- uuu - u-u -uu-	lyric	
Διὸς πρὸς ὄρνιχα θεῖον.	u- u --u --	lyric	
ἔπεχε νῦν σκοπῷ τόξον, ἄγε θυμέ, τίνα βάλλομεν	uuu - u- -u uu -u uu -u-	lyric	
ἐκ μαλθακᾶς αὖτε φρενὸς εὐκλέας ὀϊστοὺς ἱέντες; ἐπί τοι	- -u- -u uu -uu u-- u-u uu -	lyric	
Ἀκράγαντι τανύσαις	-u-u uu-	lyric	
αὐδάσομαι ἐνόρκιον λόγον ἀλαθεῖ νόῳ	--uu u-u- uu u-- u-	lyric	
τεκεῖν μή τινʼ ἑκατόν γε ἐτέων πόλιν φίλοις ἄνδρα μᾶλλον	u- - u uu- u uu- u- u- -u --	lyric	
εὐεργέταν πραπίσιν ἀφθονέστερόν τε χέρα	--u- uuu -u-u- u u-	lyric	
Θήρωνος. ἀλλʼ αἶνον ἐπέβα κόρος	--u - -u uu- u-	lyric	
οὐ δίκᾳ συναντόμενος, ἀλλὰ μάργων ὑπʼ ἀνδρῶν,	- u- u-uuu -u -- u --	lyric	
τὸ λαλαγῆσαι ἐθέλων κρύφον τε θέμεν ἐσλῶν καλοῖς	u uu-u uu- u- u uu -- u-	lyric	
ἔργοις· ἐπεὶ ψάμμος ἀριθμὸν περιπέφευγεν,	-- u- -u uu- uuu--	lyric	
καὶ κεῖνος ὅσα χάρματʼ ἄλλοις ἔθηκεν	- -u uu -u -- u--	lyric	
τίς ἂν φράσαι δύναιτο;	u - u- u--	lyric	
Τυνδαρίδαις τε φιλοξείνοις ἁδεῖν καλλιπλοκάμῳ θ᾽Ἑλένᾳ	-uu- u u--- u- --uu- uu-	lyric	
κλεινὰν Ἀκράγαντα γεραίρων εὔχομαι,	-- uu-u u-- -u-	lyric	
Θήρωνος Ὀλυμπιονίκαν ὕμνον ὀρθώσαις, ἀκαμαντοπόδων	--u u-uu-- -u --- uu-uu-	lyric	
ἵππων ἄωτον. Μοῖσα δ᾽οὕτω ποι παρέστα μοι νεοσίγαλον εὑρόντι τρόπον	-- u-- -u -- - u-- - uu-uu --- u-	lyric	
Δωρίῳ φωνὰν ἐναρμόξαι πεδίλῳ	-u- -- u--- u--	lyric	
ἀγλαόκωμον. ἐπεὶ χαίταισι μὲν ζευχθέντες ἔπι στέφανοι	-uu-u u- --u - --u u- uu-	lyric	
πράσσοντί με τοῦτο θεόδματον χρέος,	--u u -u u--- u-	lyric	
φόρμιγγά τε ποικιλόγαρυν καὶ βοὰν αὐλῶν ἐπέων τε θέσιν	--u u -uu-- - u- -- uu- u u-	lyric	
Αἰνησιδάμου παιδὶ συμμῖξαι πρεπόντως, ἅ τε Πίσα με γεγωνεῖν· τᾶς ἄπο	--u-- -u --- u-- - u u- u u-- - u-	lyric	
θεόμοροι νίσοντʼ ἐπʼ ἀνθρώπους ἀοιδαί,	uuu- -- u --- u--	lyric	
ᾧ τινι, κραίνων ἐφετμὰς Ἡρακλέος προτέρας,	- u- -- u-- -uu- uu-	lyric	
ἀτρεκὴς Ἑλλανοδίκας γλεφάρων Αἰτωλὸς ἀνὴρ ὑψόθεν	-u- --uu- uu- --u -- -u-	lyric	
ἀμφὶ κόμαισι βάλῃ γλαυκόχροα κόσμον ἐλαίας· τάν ποτε	-u u-u u- --uu -u u-- - u-	lyric	
Ἴστρου ἀπὸ σκιαρᾶν παγᾶν ἔνεικεν Ἀμφιτρυωνιάδας,	-u u- uu- -- u-u -uu-uu-	lyric	
μνᾶμα τῶν Οὐλυμπίᾳ κάλλιστον ἀέθλων	-u - --u- --u --	lyric	
δᾶμον Ὑπερβορέων πείσαις Ἀπόλλωνος θεράποντα λόγῳ.	-u u-uu- -- u--- uu-u u-	lyric	
πιστὰ φρονέων Διὸς αἴτει πανδόκῳ	-- uu- uu -- -u-	lyric	
ἄλσει σκιαρόν τε φύτευμα ξυνὸν ἀνθρώποις στέφανόν τ᾽ἀρετᾶν.	-- uu- u u-- -u --- uu- uu-	lyric	
ἤδη γὰρ αὐτῷ, πατρὶ μὲν βωμῶν ἁγισθέντων, διχόμηνις ὅλον χρυσάρματος	-- u -- -u - -- u--- uu-u u- --u-	lyric	
ἑσπέρας ὀφθαλμὸν ἀντέφλεξε Μήνα,	-u- --u ---u --	lyric	
καὶ μεγάλων ἀέθλων ἁγνὰν κρίσιν καὶ πενταετηρίδʼ ἁμᾶ	- uu- uu- -- u- - -uu-u u-	lyric	
θῆκε ζαθέοις ἐπὶ κρημνοῖς Ἀλφεοῦ·	-- uu- uu -- -u-	lyric	
ἀλλʼ οὐ καλὰ δένδρεʼ ἔθαλλεν χῶρος ἐν βάσσαις Κρονίου Πέλοπος.	- - uu -u u-- -u - -- uu- uu-	lyric	
τούτων ἔδοξεν γυμνὸς αὐτῷ κᾶπος ὀξείαις ὑπακουέμεν αὐγαῖς ἀελίου.	-- u-- -u -- -u --- uu-uu -- -u-	lyric	
δὴ τότʼ ἐς γαῖαν πορεύεν θυμὸς ὥρμα	- u - -- u-- -u --	lyric	
Ἰστρίαν νιν· ἔνθα Λατοῦς ἱπποσόα θυγάτηρ	-u- u -u -- -uu- uu-	lyric	
δέξατʼ ἐλθόντʼ Ἀρκαδίας ἀπὸ δειρᾶν καὶ πολυγνάμπτων μυχῶν,	-u -- -uu- uu -- - u--- u-	lyric	
εὖτέ νιν ἀγγελίαις Εὐρυσθέος ἔντυʼ ἀνάγκα πατρόθεν	-u u -uu- --uu -u u-- -u-	lyric	
χρυσόκερων ἔλαφον θήλειαν ἄξονθʼ, ἅν ποτε Ταϋγέτα	-uu- uu- --u -- - uu -uu-	lyric	
ἀντιθεῖσʼ Ὀρθωσίας ἔγραψεν ἱεράν.	-u- --u- --u --	lyric	
τὰν μεθέπων ἴδε καὶ κείναν χθόνα πνοιᾶς ὄπιθεν Βορέα	- uu- uu - -- u- -- uu- uu-	lyric	
ψυχροῦ. τόθι δένδρεα θάμβαινε σταθείς.	-- uu -uu --- u-	lyric	
τῶν νιν γλυκὺς ἵμερος ἔσχεν δωδεκάγναμπτον περὶ τέρμα δρόμου	- - uu -uu -- -u--- uu -u u-	lyric	
ἵππων φυτεῦσαι. καί νυν ἐς ταύταν ἑορτὰν ἵλαος ἀντιθέοισιν νίσεται	-- u-- - u - -- u-- -uu -uu-- -u-	lyric	
σὺν βαθυζώνοιο διδύμοις παισὶ Λήδας.	- u---u uu- -u --	lyric	
τοῖς γὰρ ἐπέτραπεν Οὐλυμπόνδʼ ἰὼν θαητὸν ἀγῶνα νέμειν	- u u-uu --- u- --u u-u u-	lyric	
ἀνδρῶν τ᾽ἀρετᾶς πέρι καὶ ῥιμφαρμάτου	-- uu- uu - --u-	lyric	
διφρηλασίας. ἐμὲ δ᾽ὦν πᾳ θυμὸς ὀτρύνει φάμεν Ἐμμενίδαις	--uu- uu - - -u --- uu -uu-	lyric	
Θήρωνί τ᾽ἐλθεῖν κῦδος, εὐΐππων διδόντων Τυνδαριδᾶν, ὅτι πλείσταισι βροτῶν	--u -- -u --- u-- -uu- uu --- u-	lyric	
ξεινίαις αὐτοὺς ἐποίχονται τραπέζαις,	-u- -- u--- u--	lyric	
εὐσεβεῖ γνώμᾳ φυλάσσοντες μακάρων τελετάς.	-u- -- u--- uu- uu-	lyric	
εἰ δ᾽ἀριστεύει μὲν ὕδωρ, κτεάνων δὲ χρυσὸς αἰδοιέστατος,	- u--- u u- uu- - -u ---u-	lyric	
νῦν δὲ πρὸς ἐσχατιὰν Θήρων ἀρεταῖσιν ἱκάνων ἅπτεται	- u u -uu- -- uu-u u-- -u-	lyric	
οἴκοθεν Ἡρακλέος σταλᾶν. τὸ πόρσω δ᾽ἔστι σοφοῖς ἄβατον	-uu -uu- -- u -- -u u- uu-	lyric	
κἀσόφοις. οὔ νιν διώξω· κεινὸς εἴην.	-u- - - u-- -u --	lyric	
ἐλατὴρ ὑπέρτατε βροντᾶς ἀκαμαντόποδος Ζεῦ· τεαὶ γὰρ ὧραι	uu- u-uu -- uu-uu- - u- u --	lyric	
ὑπὸ ποικιλοφόρμιγγος ἀοιδᾶς ἑλισσόμεναί μ᾽ἔπεμψαν	uu -uu--u u-- u-uu- u--	lyric	
ὑψηλοτάτων μάρτυρʼ ἀέθλων.	--uu- -u u--	anapaestic	
ξείνων δ᾽εὖ πρασσόντων	-- - ---	lyric	
ἔσαναν αὐτίκʼ ἀγγελίαν ποτὶ γλυκεῖαν ἐσλοί.	u-u -u -uu- u- u-u --	lyric	
ἀλλὰ Κρόνου παῖ, ὃς Αἴτναν ἔχεις,	-- u- u u -- u-	lyric	
ἶπον ἀνεμόεσσαν ἑκατογκεφάλα Τυφῶνος ὀβρίμου,	-u -uu-u uu-uu- --u -u-	lyric	
Οὐλυμπιονίκαν	--uu--	lyric	
δέξαι Χαρίτων θ᾽ἕκατι τόνδε κῶμον,	-- uu- u-u -u --	lyric	
χρονιώτατον φάος εὐρυσθενέων ἀρετᾶν. Ψαύμιος γὰρ ἵκει	uu-u- uu --uu- uu- -u- u --	lyric	
ὀχέων, ὅς, ἐλαίᾳ στεφανωθεὶς Πισάτιδι, κῦδος ὄρσαι	uu- u u-- uu-- u-uu -u --	lyric	
σπεύδει Καμαρίνᾳ. θεὸς εὔφρων	-- uu-- uu --	anapaestic	
εἴη λοιπαῖς εὐχαῖς·	-- -- --	lyric	
ἐπεί νιν αἰνέω μάλα μὲν τροφαῖς ἑτοῖμον ἵππων,	u- u -u- uu - u- u-u --	lyric	
χαίροντά τε ξενίαις πανδόκοις	--u - uu- -u-	lyric	
καὶ πρὸς ἁσυχίαν φιλόπολιν καθαρᾷ γνώμᾳ τετραμμένον.	- u -uu- uuu- uu- -- u-u-	lyric	
οὐ ψεύδεϊ τέγξω	- -uu --	lyric	
λόγον· διάπειρά τοι βροτῶν ἔλεγχος·	u- uu-u - u- u--	lyric	
ἅπερ Κλυμένοιο παῖδα	-- uu-u --	lyric	
Λαμνιάδων γυναικῶν ἔλυσεν ἐξ ἀτιμίας.	-uu- u-- u-u - u-u-	lyric	
χαλκέοισι δ᾽ἐν ἔντεσι νικῶν δρόμον	--u u -uu -- u-	lyric	
ἔειπεν Ὑψιπυλείᾳ μετὰ στέφανον ἰών·	u-u -uu-- u- uuu u-	lyric	
οὗτος ἐγὼ ταχυτᾶτι·	-u u- uu--	lyric	
χεῖρες δὲ καὶ ἦτορ ἴσον. φύονται δὲ καὶ νέοις	-- u u -u u- u-- u - u-	lyric	
ἐν ἀνδράσιν πολιαὶ	u -u- uu-	lyric	
θαμὰ καὶ παρὰ τὸν ἁλικίας ἐοικότα χρόνον.	uu - uu u -uu- u-u- u-	lyric	
ὑψηλᾶν ἀρετᾶν καὶ στεφάνων ἄωτον γλυκὺν	--- uu- - uu- u-- u-	lyric	
τῶν Οὐλυμπίᾳ, Ὠκεανοῦ θύγατερ, καρδίᾳ γελανεῖ	- --uu -uu- uu- -u- u--	lyric	
ἀκαμαντόποδός τ᾽ἀπήνας δέκευ Ψαύμιός τε δῶρα·	uu-uu- u-- u- -u- u --	lyric	
ὃς τὰν σὰν πόλιν αὔξων, Καμάρινα, λαοτρόφον	- - - uu -- uu-u --u-	lyric	
βωμοὺς ἓξ διδύμους ἐγέραιρεν ἑορταῖς θεῶν μεγίσταις	-- - uu- uu-u u-- u- u--	lyric	
ὑπὸ βουθυσίαις ἀέθλων τε πεμπαμέροις ἁμίλλαις,	uu -uu- u-- u --u- u--	lyric	
ἵπποις ἡμιόνοις τε μοναμπυκίᾳ τε. τὶν δὲ κῦδος ἁβρόν	-- -uu- u u-uu- u - u -u --	lyric	
νικάσαις ἀνέθηκε, καὶ ὃν πατέρʼ Ἄκρωνʼ ἐκάρυξε καὶ τὰν νέοικον ἕδραν.	--- uu-u u - uu -- u--u - - u-u --	lyric	
ἵκων δ᾽Οἰνομάου καὶ Πέλοπος παρʼ εὐηράτων	-- -uu- - uu- u --u-	lyric	
σταθμῶν, ὦ πολιάοχε Παλλάς, ἀείδει μὲν ἄλσος ἁγνὸν	-- - uu-uu -u u-- u -u --	lyric	
τὸ τεόν, ποταμόν τε Ὤανιν, ἐγχωρίαν τε λίμναν,	u u- uu- u --u --u- u --	lyric	
καὶ σεμνοὺς ὀχετούς, Ἵππαρις οἷσιν ἄρδει στρατόν,	- -- uu- -uu -u -- u-	lyric	
κολλᾷ τε σταδίων θαλάμων ταχέως ὑψίγυιον ἄλσος,	-- - uu- uu- uu- -u-u --	lyric	
ἀπʼ ἀμαχανίας ἄγων ἐς φάος τόνδε δᾶμον ἀστῶν·	u u-uu- u- - u- -u -u --	lyric	
αἰεὶ δ᾽ἀμφʼ ἀρεταῖσι πόνος δαπάνα τε μάρναται πρὸς ἔργον	-- - uu-u u- uu- u -u- u --	lyric	
κινδύνῳ κεκαλυμμένον· ἠῢ δ᾽ἔχοντες σοφοὶ καὶ πολίταις ἔδοξαν ἔμμεν.	--- uu-uu -u u-- u- - u-- u-u --	lyric	
Σωτὴρ ὑψινεφὲς Ζεῦ, Κρόνιόν τε ναίων λόφον	-- -uu- - uu- u -- u-	lyric	
τιμῶν τ᾽Ἀλφεὸν εὐρὺ ῥέοντα Ἰδαῖόν τε σεμνὸν ἄντρον,	-- -uu -u u-u u-- u -u --	lyric	
ἱκέτας σέθεν ἔρχομαι Λυδίοις ἀπύων ἐν αὐλοῖς,	uu- uu -u- -u- -u- u --	lyric	
αἰτήσων πόλιν εὐανορίαισι τάνδε κλυταῖς	--- uu --uu-u -- u-	lyric	
δαιδάλλειν, σέ τ᾽,Ὀλυμπιόνικε, Ποσειδανίαισιν ἵπποις	--- u u-uu-u u--u-u --	lyric	
ἐπιτερπόμενον φέρειν γῆρας εὔθυμον ἐς τελευτάν,	uu-uu- u- -u --u - u--	lyric	
υἱῶν, Ψαῦμι, παρισταμένων. ὑγίεντα δ᾽εἴ τις ὄλβον ἄρδει,	-- -u u-uu- uu-u - u -u --	lyric	
ἐξαρκέων κτεάτεσσι καὶ εὐλογίαν προστιθείς, μὴ ματεύσῃ θεὸς γενέσθαι.	--- uu-u u -uu- -u- - u-- u- u--	lyric	
χρυσέας ὑποστάσαντες εὐτειχεῖ προθύρῳ θαλάμου	-- u---u --- uu- uu-	lyric	
κίονας, ὡς ὅτε θαητὸν μέγαρον	-uu - uu --- uu-	lyric	
πάξομεν· ἀρχομένου δ᾽ἔργου πρόσωπον	-uu -uu- -- u--	lyric	
χρὴ θέμεν τηλαυγές. εἰ δ᾽εἴη μὲν Ὀλυμπιονίκας,	- u- --u - -- u u-uu--	lyric	
βωμῷ τε μαντείῳ ταμίας Διὸς ἐν Πίσᾳ,	-- u --- uu- uu - u-	iambic trimeter (anapaestic)	
συνοικιστήρ τε τᾶν κλεινᾶν Συρακοσσᾶν· τίνα κεν φύγοι ὕμνον	u--- u - -- u--- uu - uu --	lyric	
κεῖνος ἀνήρ, ἐπικύρσαις ἀφθόνων ἀστῶν ἐν ἱμερταῖς ἀοιδαῖς;	-u u- uu-- -u- -- u --- u--	lyric	
ἴστω γὰρ ἐν τούτῳ πεδίλῳ δαιμόνιον πόδʼ ἔχων	-- u - -- u-- -uu- u u-	lyric	
Σωστράτου υἱός. ἀκίνδυνοι δ᾽ἀρεταὶ	-uu -u u--- uu-	lyric	
οὔτε παρʼ ἀνδράσιν οὔτʼ ἐν ναυσὶ κοίλαις	-u u -uu - - -u --	lyric	
τίμιαι· πολλοὶ δὲ μέμνανται, καλὸν εἴ τι ποναθῇ.	-u- -- u --- uu - u u--	lyric	
Ἁγησία, τὶν δ᾽αἶνος ἑτοῖμος, ὃν ἐνδίκας	--u- - -u u-u u -u-	iambic trimeter (anapaestic)	
ἀπὸ γλώσσας Ἄδραστος μάντιν Οἰκλείδαν ποτʼ ἐς Ἀμφιάρηον	u- -- u-- -u --- u u -uu--	lyric	
φθέγξατʼ, ἐπεὶ κατὰ γαῖʼ αὐτόν τέ νιν καὶ φαιδίμας ἵππους ἔμαρψεν.	-u u- uu - -- u - - -u- -- u--	lyric	
ἑπτὰ δ᾽ἔπειτα πυρᾶν νεκρῶν τελεσθεισᾶν Ταλαϊονίδας	-u u-u u- -- u--- uu-uu-	lyric	
εἶπεν ἐν Θήβαισι τοιοῦτόν τι ἔπος· ποθέω στρατιᾶς ὀφθαλμὸν ἐμᾶς,	-u - --u --- u u- uu- uu- --u u-	lyric	
ἀμφότερον μάντιν τ᾽ἀγαθὸν καὶ δουρὶ μάρνασθαι. τὸ καὶ	-uu- -- uu- - -u --- u -	lyric	
ἀνδρὶ κώμου δεσπότᾳ πάρεστι Συρακοσίῳ.	-u -- -u- u-u u-uu-	lyric	
οὔτε δύσηρις ἐὼν οὔτʼ ὦν φιλόνικος ἄγαν,	-u u-u u- - - uu-u u-	lyric	
καὶ μέγαν ὅρκον ὀμόσσαις τοῦτό γέ οἱ σαφέως	- uu -u u-- -u u - uu-	lyric	
μαρτυρήσω· μελίφθογγοι δ᾽ἐπιτρέψοντι Μοῖσαι.	-u-- u--- u---u --	lyric	
ὦ Φίντις, ἀλλὰ ζεῦξον ἤδη μοι σθένος ἡμιόνων,	- -u -- -u -- - uu -uu-	lyric	
ᾇ τάχος, ὄφρα κελεύθῳ τ᾽ἐν καθαρᾷ	- uu -u u-- - uu-	lyric	
βάσομεν ὄκχον, ἵκωμαί τε πρὸς ἀνδρῶν	-uu -u u-- - u --	lyric	
καὶ γένος· κεῖναι γὰρ ἐξ ἀλλᾶν ὁδὸν ἁγεμονεῦσαι	- u- -- u - -- uu -uu--	lyric	
ταύταν ἐπίστανται, στεφάνους ἐν Ὀλυμπίᾳ	-- u--- uu- u u-u-	iambic trimeter (anapaestic)	
ἐπεὶ δέξαντο· χρὴ τοίνυν πύλας ὕμνων ἀναπίτναμεν αὐταῖς·	u- --u - -- u- -- uu-uu --	lyric	
πρός Πιτάναν δὲ παρʼ Εὐρώτα πόρον δεῖ σάμερόν μ᾽ἐλθεῖν ἐν ὥρᾳ·	- uu- u u --- u- - -u- -- u --	lyric	
ἅ τοι Ποσειδάωνι μιχθεῖσα Κρονίῳ λέγεται	- - u---u --- uu- uu-	lyric	
παῖδα ἰόπλοκον Εὐάδναν τεκέμεν.	-u u-uu --- uu-	lyric	
κρύψε δὲ παρθενίαν ὠδῖνα κόλποις·	-u u -uu- --u --	lyric	
κυρίῳ δ᾽ἐν μηνὶ πέμποισʼ ἀμφιπόλους ἐκέλευσεν	-u- - -u -- -uu- uu--	lyric	
ἥρωι πορσαίνειν δόμεν Εἰλατίδᾳ βρέφος,	--u --- uu -uu- u-	iambic trimeter (anapaestic)	
ὃς ἀνδρῶν Ἀρκάδων ἄνασσε Φαισάνᾳ λάχε τ᾽Ἀλφεὸν οἰκεῖν·	u -- -u- --u --- uu -uu --	lyric	
ἔνθα τραφεῖσʼ ὑπʼ Ἀπόλλωνι γλυκείας πρῶτον ἔψαυσʼ Ἀφροδίτας.	-u u- u u--- u-- -u -- -u--	lyric	
οὐδʼ ἔλαθʼ Αἴπυτον ἐν παντὶ χρόνῳ κλέπτοισα θεοῖο γόνον.	- uu -uu - -- u- --u u-u u-	lyric	
ἀλλʼ ὁ μὲν Πυθώναδʼ, ἐν θυμῷ πιέσαις χόλον οὐ φατὸν ὀξείᾳ μελέτᾳ,	- u - --u - -- uu- uu - uu --- uu-	lyric	
ᾤχετʼ ἰὼν μαντευσόμενος ταύτας περʼ ἀτλάτου πάθας.	-u u- --uu- -- u --- u-	lyric	
ἁ δὲ φοινικόκροκον ζώναν καταθηκαμένα	- u ---u- -- uu-uu-	lyric	
κάλπιδά τ᾽ἀργυρέαν, λόχμας ὑπὸ κυανέας	-uu -uu- -- uu -uu-	lyric	
τίκτε θεόφρονα κοῦρον. τᾷ μὲν ὁ Χρυσοκόμας	-u u-uu -- - u u -uu-	lyric	
πραΰμητίν τ᾽Ἐλείθυιαν παρέστασέν τε Μοίρας·	-u-- u--- u--- u --	lyric	
ἦλθεν δ᾽ὑπὸ σπλάγχνων ὑπʼ ὠδῖνός τ᾽ἐρατᾶς Ἴαμος	-- u- -- u --- uu- uu-	lyric	
ἐς φάος αὐτίκα. τὸν μὲν κνιζομένα	- uu -uu - - -uu-	lyric	
λεῖπε χαμαί· δύο δὲ γλαυκῶπες αὐτὸν	-u u- uu - --u --	lyric	
δαιμόνων βουλαῖσιν ἐθρέψαντο δράκοντες ἀμεμφεῖ	-u- --u ---u u-u u--	lyric	
ἰῷ μελισσᾶν καδόμενοι. βασιλεὺς δ᾽ἐπεὶ	-- u-- -uu- uu- u-	iambic trimeter (anapaestic)	
πετραέσσας ἐλαύνων ἵκετʼ ἐκ Πυθῶνος, ἅπαντας ἐν οἴκῳ	u--- u-- -u - --u u-u u --	lyric	
εἴρετο παῖδα, τὸν Εὐάδνα τέκοι· Φοίβου γὰρ αὐτὸν φᾶ γεγάκειν	-uu -u u --- u- -- u -- - u--	lyric	
πατρός, περὶ θνατῶν δ᾽ἔσεσθαι μάντιν ἐπιχθονίοις	-- u- -- u-- -u u-uu-	lyric	
ἔξοχον, οὐδέ ποτʼ ἐκλείψειν γενεάν.	-uu -u u --- uu-	lyric	
ὣς ἄρα μάνυε. τοὶ δ᾽οὔτʼ ὦν ἀκοῦσαι	- uu -uu - - - u--	lyric	
οὔτʼ ἰδεῖν εὔχοντο πεμπταῖον γεγενημένον. ἀλλʼ ἐν	- u- --u --- uu-uu - -	lyric	
κέκρυπτο γὰρ σχοίνῳ βατιᾷ τ᾽ἐν ἀπειρίτῳ,	--u - -- uu- u u-u-	iambic trimeter (anapaestic)	
ἴων ξανθαῖσι καὶ παμπορφύροις ἀκτῖσι βεβρεγμένος ἁβρὸν	u- --u - --u- --u u-uu --	lyric	
σῶμα· τὸ καὶ κατεφάμιξεν καλεῖσθαί νιν χρόνῳ σύμπαντι μάτηρ	-u u - uu--- u-- - u- --u --	lyric	
τοῦτʼ ὄνυμʼ ἀθάνατον. τερπνᾶς δ᾽ἐπεὶ χρυσοστεφάνοιο λάβεν	- uu -uu- -- u- --uu-u u-	lyric	
καρπὸν Ἥβας, Ἀλφεῷ μέσσῳ καταβὰς ἐκάλεσσε Ποσειδᾶνʼ εὐρυβίαν,	-u -- -u- -- uu- uu-u u-- -uu-	lyric	
ὃν πρόγονον, καὶ τοξοφόρον Δάλου θεοδμάτας σκοπόν,	- uu- - -uu- -- u--- u-	lyric	
αἰτέων λαοτρόφον τιμάν τινʼ ἑᾷ κεφαλᾷ,	-u- --u- -- u u- uu-	lyric	
νυκτὸς ὑπαίθριος. ἀντεφθέγξατο δ᾽ἀρτιεπὴς	-u u-uu ---uu -uu-	lyric	
πατρία ὄσσα, μετάλλασέν τέ νιν· ὄρσο, τέκνον,	-uu -u u--- u u -u u-	lyric	
δεῦρο πάγκοινον ἐς χώραν ἴμεν φάμας ὄπισθεν.	-u --u - -- u- -- u--	lyric	
ἵκοντο δ᾽ὑψηλοῖο πέτραν ἀλίβατον Κρονίου·	--u ---u -- -uu- uu-	lyric	
ἔνθα οἱ ὤπασε θησαυρὸν δίδυμον	-u u -uu --- uu-	lyric	
μαντοσύνας, τόκα μὲν φωνὰν ἀκούειν	-uu- uu - -- u--	lyric	
ψευδέων ἄγνωστον, εὖτʼ ἂν δὲ θρασυμάχανος ἐλθὼν	-u- --u - - - uu-uu --	lyric	
Ἡρακλέης, σεμνὸν θάλος Ἀλκαϊδᾶν, πατρὶ	--u- -- uu -uu- u-	iambic trimeter (anapaestic)	
ἑορτάν τε κτίσῃ πλειστόμβροτον τεθμόν τε μέγιστον ἀέθλων,	u-- - u- --u- -- u u-u u--	lyric	
Ζηνὸς ἐπʼ ἀκροτάτῳ βωμῷ τότʼ αὖ χρηστήριον θέσθαι κέλευσεν.	-u u -uu- -- u - --u- -- u--	lyric	
ἐξ οὗ πολύκλειτον καθʼ Ἕλλανας γένος Ἰαμιδᾶν.	- - u--- u --- uu -uu-	lyric	
ὄλβος ἅμʼ ἕσπετο· τιμῶντες δ᾽ἀρετὰς	-u u -uu --- uu-	lyric	
ἐς φανερὰν ὁδὸν ἔρχονται. τεκμαίρει	- uu- uu --- u--	lyric	
χρῆμʼ ἕκαστον· μῶμος ἐξ ἄλλων κρέμαται φθονεόντων	- u-- -u - -- uu- uu--	lyric	
τοῖς, οἷς ποτε πρώτοις περὶ δωδέκατον δρόμον	- - u- -- uu -uu- u-	iambic trimeter (anapaestic)	
ἐλαυνόντεσσιν αἰδοία ποτιστάξῃ Χάρις εὐκλέα μορφάν.	u---u --- u--- uu -uu --	lyric	
εἰ δ᾽ἐτύμως ὑπὸ Κυλλάνας ὅροις, Ἁγησία, μάτρωες ἄνδρες	- uu- uu --- u- --u- --u --	lyric	
ναιετάοντες ἐδώρησαν θεῶν κάρυκα λιταῖς θυσίαις	-uu-u u--- u- --u u- uu-	lyric	
πολλὰ δὴ πολλαῖσιν Ἑρμᾶν εὐσεβέως, ὃς ἀγῶνας ἔχει μοῖράν τ᾽ἀέθλων	-u - --u -- -uu- u u-u u- -- uu-	lyric	
Ἀρκαδίαν τ᾽εὐάνορα τιμᾷ· κεῖνος, ὦ παῖ Σωστράτου,	-uu- --uu -- -u - - -u-	lyric	
σὺν βαρυγδούπῳ πατρὶ κραίνει σέθεν εὐτυχίαν.	- u--- u- -- uu -uu-	lyric	
δόξαν ἔχω τινʼ ἐπὶ γλώσσᾳ λιγυρᾶς ἀκόνας,	-u u- u u- -- uu- uu-	lyric	
ἅ μ᾽ἐθέλοντα προσέρπει καλλιρόοισι πνοαῖς·	- uu-u u-- -uu-u u-	lyric	
ματρομάτωρ ἐμὰ Στυμφαλίς, εὐανθὴς Μετώπα,	-u-- u- --u --- u--	lyric	
πλάξιππον ἃ Θήβαν ἔτικτεν, τᾶς ἐρατεινὸν ὕδωρ	--u - -- u-- - uu-u u-	lyric	
πίομαι, ἀνδράσιν αἰχματαῖσι πλέκων	-uu -uu ---u u-	lyric	
ποικίλον ὕμνον. ὄτρυνον νῦν ἑταίρους,	-uu -u u-- - u--	lyric	
Αἰνέα, πρῶτον μὲν Ἥραν Παρθενίαν κελαδῆσαι,	-u- -- u -- -uu- uu--	lyric	
γνῶναί τ᾽ἔπειτʼ, ἀρχαῖον ὄνειδος ἀλαθέσιν	-- u- --u u-u u-u-	iambic trimeter (anapaestic)	
λόγοις εἰ φεύγομεν, Βοιωτίαν ὗν. ἐσσὶ γὰρ ἄγγελος ὀρθός,	u- - -u- --u- - -u u -uu --	lyric	
ἠϋκόμων σκυτάλα Μοισᾶν, γλυκὺς κρατὴρ ἀγαφθέγκτων ἀοιδᾶν·	-uu- uu- -- u- -- u--- u--	lyric	
εἰπὸν δὲ μεμνᾶσθαι Συρακοσσᾶν τε καὶ Ὀρτυγίας·	-- u --- u--- u u -uu-	lyric	
τὰν Ἱέρων καθαρῷ σκάπτῳ διέπων,	- uu- uu- -- uu-	lyric	
ἄρτια μηδόμενος, φοινικόπεζαν	-uu -uu- --u--	lyric	
ἀμφέπει Δάματρα, λευκίππου τε θυγατρὸς ἑορτάν,	-u- --u --- u u-u u--	lyric	
καὶ Ζηνὸς Αἰτναίου κράτος. ἁδύλογοι δέ νιν	- -u --- uu -uu- u -	iambic trimeter (anapaestic)	
λύραι μολπαί τε γιγνώσκοντι. μὴ θράσσοι χρόνος ὄλβον ἐφέρπων.	u- -- u ---u - -- uu -u u--	lyric	
σὺν δὲ φιλοφροσύναις εὐηράτοις Ἁγησία δέξαιτο κῶμον	- u u-uu- --u- --u- --u --	lyric	
οἴκοθεν οἴκαδʼ ἀπὸ Στυμφαλίων τειχέων ποτινισσόμενον,	-uu -u u- --u- -- uu-uu-	lyric	
ματέρʼ εὐμήλοιο λείποντʼ Ἀρκαδίας. ἀγαθαὶ δὲ πέλοντʼ ἐν χειμερίᾳ	-u ---u -- -uu- uu- u u- - -uu-	lyric	
νυκτὶ θοᾶς ἐκ ναὸς ἀπεσκίμφθαι δύʼ ἄγκυραι. θεὸς	-u u- - -u u--- u --- u-	lyric	
τῶν τε κείνων τε κλυτὰν αἶσαν παρέχοι φιλέων.	- u -- - u- -- uu- uu-	lyric	
δέσποτα ποντομέδων, εὐθὺν δὲ πλόον καμάτων	-uu -uu- -- u u- uu-	lyric	
ἐκτὸς ἐόντα δίδοι, χρυσαλακάτοιο πόσις	-u u-u u- --uu-u u-	lyric	
Ἀμφιτρίτας, ἐμῶν δ᾽ὕμνων ἄεξʼ εὐτερπὲς ἄνθος.	-u-- u- -- u- --u --	lyric	
φιάλαν ὡς εἴ τις ἀφνειᾶς ἀπὸ χειρὸς ἑλὼν	uu- - - u --- uu -u u-	lyric	
ἔνδον ἀμπέλου καχλάζοισαν δρόσῳ	-u -u- u--- u-	lyric	
δωρήσεται	--u-	lyric	
νεανίᾳ γαμβρῷ προπίνων οἴκοθεν οἴκαδε, πάγχρυσον κορυφὰν κτεάνων,	u-u- -- u-- -uu -uu --- uu- uu-	lyric	
συμποσίου τε χάριν κᾶδός τε τιμάσαις νέον, ἐν δὲ φίλων	-uu- u u- -- u --- uu - u u-	lyric	
παρεόντων θῆκέ νιν ζαλωτὸν ὁμόφρονος εὐνᾶς·	uu-- -u - --u u-uu --	lyric	
καὶ ἐγὼ νέκταρ χυτόν, Μοισᾶν δόσιν, ἀεθλοφόροις	u u- -- u- -- uu -uu-	lyric	
ἀνδράσιν πέμπων, γλυκὺν καρπὸν φρενός,	-u- -- u- -- u-	lyric	
ἱλάσκομαι,	--u-	lyric	
Ὀλυμπίᾳ Πυθοῖ τε νικώντεσσιν· ὁ δ᾽ὄλβιος, ὃν φᾶμαι κατέχωντʼ ἀγαθαί.	u-u- -- u ---u u -uu - -- uu- uu-	lyric	
ἄλλοτε δ᾽ἄλλον ἐποπτεύει Χάρις ζωθάλμιος ἁδυμελεῖ	-uu -u u--- u- --uu -uu-	lyric	
θαμὰ μὲν φόρμιγγι παμφώνοισί τ᾽ἐν ἔντεσιν αὐλῶν.	uu - --u ---u u -uu --	lyric	
καί νυν ὑπʼ ἀμφοτέρων σὺν Διαγόρᾳ κατέβαν τὰν ποντίαν	- u u -uu- - -uu- uu- - -u-	lyric	
ὑμνέων παῖδʼ Ἀφροδίτας Ἀελίοιό τε νύμφαν, Ῥόδον,	-u- - -u-- -uu-u u -- u-	lyric	
εὐθυμάχαν ὄφρα πελώριον ἄνδρα παρʼ Ἀλφειῷ στεφανωσάμενον	-uu- uu u-uu -u u --- uu-uu-	lyric	
αἰνέσω πυγμᾶς ἄποινα	-u- -- u--	lyric	
καὶ παρὰ Κασταλίᾳ, πατέρα τε Δαμάγητον ἁδόντα Δίκᾳ,	- uu -uu- uuu u ---u u-u u-	lyric	
Ἀσίας εὐρυχόρου τρίπολιν νᾶσον πέλας	uu- -uu- uu- -- u-	lyric	
ἐμβόλῳ ναίοντας Ἀργείᾳ σὺν αἰχμᾷ.	-u- --u --- u --	lyric	
ἐθελήσω τοῖσιν ἐξ ἀρχᾶς ἀπὸ Τλαπολέμου	uu-- -u - -- uu -uu-	lyric	
ξυνὸν ἀγγέλλων διορθῶσαι λόγον,	-u --- u--- u-	lyric	
Ἡρακλέος	--u-	lyric	
εὐρυσθενεῖ γέννᾳ. τὸ μὲν γὰρ πατρόθεν ἐκ Διὸς εὔχονται· τὸ δ᾽Ἀμυντορίδαι	--u- -- u - - -uu - uu --- u u-uu-	lyric	
ματρόθεν Ἀστυδαμείας. ἀμφὶ δ᾽ἀνθρώπων φρασὶν ἀμπλακίαι	-uu -uu-- -u --- uu -uu-	lyric	
ἀναρίθμητοι κρέμανται· τοῦτο δ᾽ἀμάχανον εὑρεῖν,	uu--- u-- -u u-uu --	lyric	
ὅ τι νῦν ἐν καὶ τελευτᾷ φέρτατον ἀνδρὶ τυχεῖν.	u u - - - u-- -uu -u u-	lyric	
καὶ γὰρ Ἀλκμήνας κασίγνητον νόθον	- u --- u--- u-	lyric	
σκάπτῳ θένων	-- u-	lyric	
σκληρᾶς ἐλαίας ἔκτανʼ ἐν Τίρυνθι Λικύμνιον ἐλθόντʼ ἐκ θαλάμων Μιδέας	-- u-- -u - --u u-uu -- - uu- uu-	lyric	
τᾶσδέ ποτε χθονὸς οἰκιστὴρ χολωθείς. αἱ δὲ φρενῶν ταραχαὶ	-u u- uu --- u-- - u u- uu-	lyric	
παρέπλαγξαν καὶ σοφόν. μαντεύσατο δ᾽ἐς θεὸν ἐλθών.	uu-- - u- --uu - uu --	lyric	
τῷ μὲν ὁ Χρυσοκόμας εὐώδεος ἐξ ἀδύτου ναῶν πλόον	- u u -uu- --uu - uu- -- u-	lyric	
εἶπε Λερναίας ἀπʼ ἀκτᾶς εὐθὺν ἐς ἀμφιθάλασσον νομόν,	-u --- u -- -u u -uu-- u-	lyric	
ἔνθα ποτὲ βρέχε θεῶν βασιλεὺς ὁ μέγας χρυσέαις νιφάδεσσι πόλιν,	-u u- uu u- uu- u u- -- uu-u u-	lyric	
ἁνίχʼ Ἁφαίστου τέχναισιν	-u --- u--	lyric	
χαλκελάτῳ πελέκει πατέρος Αθαναία κορυφὰν κατʼ ἄκραν	-uu- uu- uuu u--- uu- u u-	lyric	
ἀνορούσαισʼ ἀλάλαξεν ὑπερμάκει βοᾷ·	uu-- uu-u u--- u-	lyric	
Οὐρανὸς δ᾽ἔφριξέ νιν καὶ Γαῖα μάτηρ.	-u- --u - - -u --	lyric	
τότε καὶ φαυσίμβροτος δαίμων Ὑπεριονίδας	uu - --u- -- uu-uu-	lyric	
μέλλον ἔντειλεν φυλάξασθαι χρέος	-u --- u--- u-	lyric	
παισὶν φίλοις,	-- u-	lyric	
ὡς ἂν θεᾷ πρῶτοι κτίσαιεν βωμὸν ἐναργέα, καὶ σεμνὰν θυσίαν θέμενοι	- - u- -- u-- -u u-uu - -- uu- uu-	lyric	
πατρί τε θυμὸν ἰάναιεν κόρᾳ τ᾽ἐγχειβρόμῳ. ἐν δ᾽ἀρετὰν	-u u -u u--- u- --uu - uu-	lyric	
ἔβαλεν καὶ χάρματʼ ἀνθρώποισι Προμαθέος Αἰδώς·	uu- - -u ---u u-uu --	lyric	
ἐπὶ μὰν βαίνει τε καὶ λάθας ἀτέκμαρτα νέφος,	uu - -- u - -- uu-u u-	lyric	
καὶ παρέλκει πραγμάτων ὀρθὰν ὁδὸν	- u-- -u- -- u-	lyric	
ἔξω φρενῶν.	-- u-	lyric	
καὶ τοὶ γὰρ αἰθοίσας ἔχοντες σπέρμʼ ἀνέβαν φλογὸς οὔ· τεῦξαν δ᾽ἀπύροις ἱεροῖς	- - u --- u-- - uu- uu - -- uu- uu-	lyric	
ἄλσος ἐν ἀκροπόλει· κείνοις ὁ μὲν ξανθὰν ἀγαγὼν νεφέλαν	-u u -uu- -- u - -- uu- uu-	lyric	
πολὺν ὗσε χρυσόν· αὐτὰ δέ σφισιν ὤπασε τέχναν	uu -- -u -- - uu -uu --	lyric	
πᾶσαν ἐπιχθονίων Γλαυκῶπις ἀριστοπόνοις χερσὶ κρατεῖν.	-u u-uu- --u u-uu- -- u-	lyric	
ἔργα δὲ ζωοῖσιν ἑρπόντεσσί θ᾽ὁμοῖα κέλευθοι φέρον·	-u - --u ---u u-u u-- u-	lyric	
ἦν δὲ κλέος βαθύ. δαέντι δὲ καὶ σοφία μείζων ἄδολος τελέθει.	- u u- uu u-u u - uu- -- uu- uu-	lyric	
φαντὶ δ᾽ἀνθρώπων παλαιαὶ	-u --- u--	lyric	
ῥήσιες, οὔπω, ὅτε χθόνα δατέοντο Ζεύς τε καὶ ἀθάνατοι,	-uu -u u- uu uu-- - u u -uu-	lyric	
φανερὰν ἐν πελάγει Ῥόδον ἔμμεν ποντίῳ,	uu- - uu- uu -- -u-	lyric	
ἁλμυροῖς δ᾽ἐν βένθεσιν νᾶσον κεκρύφθαι.	-u- - -u- -- u--	lyric	
ἀπεόντος δ᾽οὔτις ἔνδειξεν λάχος Ἀελίου·	uu-- -u --- uu -uu-	lyric	
καί ῥά μιν χώρας ἀκλάρωτον λίπον,	- u - -- u--- u-	lyric	
ἁγνὸν θεόν.	-- u-	lyric	
μνασθέντι δὲ Ζεὺς ἄμπαλον μέλλεν θέμεν. ἀλλά νιν οὐκ εἴασεν· ἐπεὶ πολιᾶς	--u - - -u- -- uu -u u - --u u- uu-	lyric	
εἶπέ τινʼ αὐτὸς ὁρᾶν ἔνδον θαλάσσας αὐξομέναν πεδόθεν	-u u -u u- -- u-- -uu- uu-	lyric	
πολύβοσκον γαῖαν ἀνθρώποισι καὶ εὔφρονα μήλοις.	uu-- -u ---u u -uu --	lyric	
ἐκέλευσεν δ᾽αὐτίκα χρυσάμπυκα μὲν Λάχεσιν	uu-- -u- --uu - uu-	lyric	
χεῖρας ἀντεῖναι, θεῶν δ᾽ὅρκον μέγαν	-u --- u- -- u-	lyric	
μὴ παρφάμεν,	- -u-	lyric	
ἀλλὰ Κρόνου σὺν παιδὶ νεῦσαι, φαεννὸν ἐς αἰθέρα νιν πεμφθεῖσαν ἑᾷ κεφαλᾷ	-- u- - -u -- -u u -uu - --u u- uu-	lyric	
ἐξοπίσω γέρας ἔσσεσθαι. τελεύταθεν δὲ λόγων κορυφαὶ	-uu- uu --- u--- u u- uu-	lyric	
ἐν ἀλαθείᾳ πετοῖσαι. βλάστε μὲν ἐξ ἁλὸς ὑγρᾶς	u u--- u-- -u u - uu --	lyric	
νᾶσος, ἔχει τέ νιν ὀξειᾶν ὁ γενέθλιος ἀκτίνων πατήρ,	-u u- u u --- u u-uu --- u-	lyric	
πῦρ πνεόντων ἀρχὸς ἵππων· ἔνθα Ῥόδῳ ποτὲ μιχθεὶς τέκεν	- u-- -u -- -u u- uu -- u-	lyric	
ἑπτὰ σοφώτατα νοήματʼ ἐπὶ προτέρων ἀνδρῶν παραδεξαμένους	-u u-uu u-u u- uu- -- uu-uu-	lyric	
παῖδας, ὧν εἷς μὲν Κάμειρον	-u - - - u--	lyric	
πρεσβύτατόν τε Ἰάλυσον ἔτεκεν Λίνδον τ᾽·ἀπάτερθε δ᾽ἔχον,	-uu- u u-uu uu- -- uu-u u-	lyric	
διὰ γαῖαν τρίχα δασσάμενοι πατρωίαν,	uu -- uu -uu- --u-	lyric	
ἀστέων μοῖραν, κέκληνται δέ σφιν ἕδραι.	-u- -- u-- - u --	lyric	
τόθι λύτρον συμφορᾶς οἰκτρᾶς γλυκὺ Τλαπολέμῳ	uu -- -u- -- uu -uu-	lyric	
ἵσταται Τιρυνθίων ἀρχαγέτᾳ,	-u- --u- --u-	lyric	
ὥσπερ θεῷ,	-- u-	lyric	
μήλων τε κνισσάεσσα πομπὰ καὶ κρίσις ἀμφʼ ἀέθλοις. τῶν ἄνθεσι Διαγόρας	-- u ---u -- - uu - uu- - -uu -uu-	lyric	
ἐστεφανώσατο δίς, κλεινᾷ τ᾽ἐν Ἰσθμῷ τετράκις εὐτυχέων,	-uu-uu - -- u -- -uu -uu-	lyric	
Νεμέᾳ τ᾽ἄλλαν ἐπʼ ἄλλα, καὶ κρανααῖς ἐν Ἀθάναις.	uu- -- u -- - uu- u u--	lyric	
ὅ τ᾽ἐν Ἄργει χαλκὸς ἔγνω νιν, τά τ᾽ἐν Ἀρκαδίᾳ	u u -- -u -- - u u -uu-	lyric	
ἔργα καὶ Θήβαις, ἀγῶνές τ᾽ἔννομοι	-u - -- u-- -u-	lyric	
Βοιωτίων,	--u-	lyric	
Πέλλανά τ᾽Αἴγινά τε νικῶνθʼ ἑξάκις. ἐν Μεγάροισίν τ᾽οὐχ ἕτερον λιθίνα	--u --- u -- -uu - uu-- - uu- uu-	lyric	
ψᾶφος ἔχει λόγον. ἀλλʼ, ὦ Ζεῦ πάτερ, νώτοισιν Ἀταβυρίου	-u u- uu - - - u- --u u-uu-	lyric	
μεδέων, τίμα μὲν ὕμνου τεθμὸν Ὀλυμπιονίκαν,	uu- -- u -- -u u-uu--	lyric	
ἄνδρα τε πὺξ ἀρετὰν εὑρόντα, δίδοι τέ οἱ αἰδοίαν χάριν	-u u - uu- --u u- u u --- u-	lyric	
καὶ ποτʼ ἀστῶν καὶ ποτὶ ξείνων. ἐπεὶ ὕβριος ἐχθρὰν ὁδὸν	- u -- - u- -- uu -uu -- u-	lyric	
εὐθυπορεῖ, σάφα δαεὶς ἅ τέ οἱ πατέρων ὀρθαὶ φρένες ἐξ ἀγαθῶν	-uu- uu u- u u - uu- -- uu - uu-	lyric	
ἔχρεον. μὴ κρύπτε κοινὸν	-u- - -u --	lyric	
σπέρμʼ ἀπὸ Καλλιάνακτος· Ἐρατιδᾶν τοι σὺν χαρίτεσσιν ἔχει	- uu -uu-u uuu- - - uu-u u-	lyric	
θαλίας καὶ πόλις· ἐν δὲ μιᾷ μοίρᾳ χρόνου	uu- - uu - u u- -- u-	lyric	
ἄλλοτʼ ἀλλοῖαι διαιθύσσοισιν αὖραι.	-u --- u---u --	lyric	
μᾶτερ ὦ χρυσοστεφάνων ἀέθλων, Οὐλυμπία,	-u - --uu- uu- --u-	lyric	
δέσποινʼ ἀλαθείας· ἵνα μάντιες ἄνδρες	-- u--- uu -uu --	lyric	
ἐμπύροις τεκμαιρόμενοι παραπειρῶνται Διὸς ἀργικεραύνου,	-u- --uu- uu--- uu -uu--	lyric	
εἴ τινʼ ἔχει λόγον ἀνθρώπων πέρι	- u u- uu --- u-	lyric	
μαιομένων μεγάλαν	-uu- uu-	lyric	
ἀρετὰν θυμῷ λαβεῖν,	uu- -- u-	lyric	
τῶν δὲ μόχθων ἀμπνοάν·	- u -- -u-	lyric	
ἄνεται δὲ πρὸς χάριν εὐσεβίας ἀνδρῶν λιταῖς.	-u- - - uu -uu- -- u-	lyric	
ἀλλʼ ὦ Πίσας εὔδενδρον ἐπʼ Ἀλφεῷ ἄλσος,	- - u- --u u -uu --	lyric	
τόνδε κῶμον καὶ στεφαναφορίαν δέξαι. μέγα τοι κλέος αἰεί,	-u -- - uu-uu- -- uu - uu --	lyric	
ᾧτινι σὸν γέρας ἕσπετʼ ἀγλαόν·	-uu - uu -u -u-	lyric	
ἄλλα δ᾽ἐπʼ ἄλλον ἔβαν	-u u -u u-	lyric	
ἀγαθῶν, πολλαὶ δ᾽ὁδοὶ	uu- -- u-	lyric	
σὺν θεοῖς εὐπραγίας.	- u- --u-	lyric	
Τιμόσθενες, ὔμμε δ᾽ἐκλάρωσεν πότμος	--uu -u u--- u-	lyric	
Ζηνὶ γενεθλίῳ· ὃς σὲ μὲν Νεμέᾳ πρόφατον,	-u u-uu - u - uu- uu-	lyric	
Ἀλκιμέδοντα δὲ πὰρ Κρόνου λόφῳ	-uu-u u - u- u-	lyric	
θῆκεν Ὀλυμπιονίκαν.	-u u-uu--	lyric	
ἦν δ᾽ἐσορᾶν καλός, ἔργῳ τ᾽οὐ κατὰ εἶδος ἐλέγχων	- uu- uu -- - uu -u u--	dactylic hexameter	hepthemimeral, trithemimeral
ἐξένεπε κρατέων πάλᾳ δολιχήρετμον Αἴγιναν πάτραν·	-uu- uu- u- uu-uu --- u-	lyric	
ἔνθα σώτειρα Διὸς ξενίου	-u --u u- uu-	lyric	
πάρεδρος ἀσκεῖται Θέμις	u-u --- u-	lyric	
ἔξοχʼ ἀνθρώπων. ὅ τι γὰρ πολὺ καὶ πολλᾷ ῥέπῃ,	-u --- u u - uu - -- u-	lyric	
ὀρθᾷ διακρίνειν φρενὶ μὴ παρὰ καιρόν,	-- u--- uu - uu --	lyric	
δυσπαλές· τεθμὸς δέ τις ἀθανάτων καὶ τάνδʼ ἁλιερκέα χώραν	-u- -- u u -uu- - - uu-uu --	lyric	
παντοδαποῖσιν ὑπέστασε ξένοις	-uu-u u--- u-	lyric	
κίονα δαιμονίαν	-uu -uu-	lyric	
ὁ δ᾽ἐπαντέλλων χρόνος	u u--- u-	lyric	
τοῦτο πράσσων μὴ κάμοι	-u -- - u-	lyric	
Δωριεῖ λαῷ ταμιευομέναν ἐξ Αἰακοῦ·	-u- -- uu-uu- - -u-	lyric	
τὸν παῖς ὁ Λατοῦς εὐρυμέδων τε Ποσειδᾶν,	- - u -- -uu- u u--	lyric	
Ἰλίῳ μέλλοντες ἐπὶ στέφανον τεῦξαι, καλέσαντο συνεργὸν	-u- --u u- uu- -- uu-u u--	lyric	
τείχεος, ἦν ὅτι νιν πεπρωμένον	-uu - uu - --u-	lyric	
ὀρνυμένων πολέμων	-uu- uu-	lyric	
πτολιπόρθοις ἐν μάχαις	uu-- - u-	lyric	
λάβρον ἀμπνεῦσαι καπνόν.	-u --- u-	lyric	
γλαυκοὶ δὲ δράκοντες, ἐπεὶ κτίσθη νέον,	-- u u-u u- -- u-	lyric	
πύργον ἐσαλλόμενοι τρεῖς, οἱ δύο μὲν κάπετον,	-u u-uu- - - uu - uu-	lyric	
αὖθι δ᾽ἀτυζομένω ψυχὰς βάλον·	-u u-uu- -- u-	lyric	
εἷς δ᾽ἀνόρουσε βοάσαις.	- uu-u u--	lyric	
ἔννεπε δ᾽ἀντίον ὁρμαίνων τέρας εὐθὺς, Ἀπόλλων·	-uu -uu --- uu -u u--	dactylic hexameter	hepthemimeral
"Πέργαμος ἀμφὶ τεαῖς, ἥρως, χερὸς ἐργασίαι ἁλίσκεται·	-uu -u u- -- uu -uu- u-u-	lyric	
ὣς ἐμοὶ φάσμα λέγει Κρονίδα	- u- -u u- uu-	lyric	
πεμφθὲν βαρυγδούπου Διός·	-- u--- u-	lyric	
οὐκ ἄτερ παίδων σέθεν, ἀλλʼ ἅμα πρώτοις ῥάζεται	- u- -- uu - uu -- -u-	lyric	
καὶ τερτάτοις᾽. ὣς ἆρα θεὸς σάφα εἴπαις	- -u- - -u u- uu --	lyric	
Ξάνθον ἤπειγεν καὶ Ἀμαζόνας εὐίππους καὶ ἐς Ἴστρον ἐλαύνων.	-u --- u u-uu --- u u -u u--	lyric	
Ὀρσοτρίαινα δ᾽ἐπʼ Ἰσθμῷ ποντίᾳ	-uu-u u -- -u-	lyric	
ἅρμα θοὸν τανύεν,	-u u- uu-	lyric	
ἀποπέμπων Αἰακὸν	uu-- -u-	lyric	
δεῦρʼ ἀνʼ ἵπποις χρυσέαις,	- u -- -u-	lyric	
καὶ Κορίνθου δειράδʼ ἐποψόμενος δαιτικλυτάν.	- u-- -u u-uu- --u-	lyric	
τερπνὸν δ᾽ἐν ἀνθρώποις ἴσον ἔσσεται οὐδέν.	-- u --- uu -uu --	lyric	
εἰ δ᾽ἐγὼ Μελησίᾳ ἐξ ἀγενείων κῦδος ἀνέδραμον ὕμνῳ,	- u- u-uu - uu-- -u u-uu --	lyric	
μὴ βαλέτω με λίθῳ τραχεῖ φθόνος·	- uu- u u- -- u-	lyric	
καὶ Νεμέᾳ γὰρ ὁμῶς	- uu- u u-	lyric	
ἐρέω ταύταν χάριν,	uu- -- u-	lyric	
τὰν δ᾽ἔπειτʼ ἀνδρῶν μάχαν	- u- -- u-	lyric	
ἐκ παγκρατίου. τὸ διδάξασθαι δέ τοι	- -uu- u u--- u -	lyric	
εἰδότι ῥᾴτερον· ἄγνωμον δὲ τὸ μὴ προμαθεῖν·	-uu -uu --- u u - uu-	lyric	
κουφότεραι γὰρ ἀπειράτων φρένες.	-uu- u u--- u-	lyric	
κεῖνα δὲ κεῖνος ἂν εἴποι	-u u -u u --	lyric	
ἔργα περαίτερον ἄλλων, τίς τρόπος ἄνδρα προβάσει	-u u-uu -- - uu -u u--	dactylic hexameter	hepthemimeral
ἐξ ἱερῶν ἀέθλων μέλλοντα ποθεινοτάταν δόξαν φέρειν.	- uu- uu- --u u-uu- -- u-	lyric	
νῦν μὲν αὐτῷ γέρας Ἀλκιμέδων	- u -- uu -uu-	lyric	
νίκαν τριακοστὰν ἑλών·	-- u--- u-	lyric	
ὃς τύχᾳ μὲν δαίμονος, ἀνορέας δ᾽οὐκ ἀμπλακὼν	- u- - -uu -uu- - -u-	lyric	
ἐν τέτρασιν παίδων ἀπεθήκατο γυίοις	- -u- -- uu-uu --	lyric	
νόστον ἔχθιστον καὶ ἀτιμοτέραν γλῶσσαν καὶ ἐπίκρυφον οἶμον,	-u --- u u-uu- -- u u-uu --	lyric	
πατρὶ δὲ πατρὸς ἐνέπνευσεν μένος	-u u -u u--- u-	lyric	
γήραος ἀντίπαλον.	-uu -uu-	lyric	
Ἀΐδα τοι λάθεται	uu- - -u-	lyric	
ἄρμενα πράξαις ἀνήρ.	-u- -- u-	lyric	
ἀλλʼ ἐμὲ χρὴ μναμοσύναν ἀνεγείροντα φράσαι	- u- - -uu- uu--- u-	lyric	
χειρῶν ἄωτον Βλεψιάδαις ἐπίνικον,	-- u-- -uu- uu--	lyric	
ἕκτος οἷς ἤδη στέφανος περίκειται φυλλοφόρων ἀπʼ ἀγώνων.	-u - -- uu- uu-- -uu- u u--	lyric	
ἔστι δὲ καί τι θανόντεσσιν μέρος	-u u - u u--- u-	lyric	
κὰν νόμον ἐρδομένων·	- uu -uu-	lyric	
κατακρύπτει δ᾽οὐ κόνις	uu-- - u-	lyric	
συγγόνων κεδνὰν χάριν.	-u- -- u-	lyric	
Ἑρμᾶ δὲ θυγατρὸς ἀκούσαις Ἰφίων	-- u u-u u-- -u-	lyric	
Ἀγγελίας, ἐνέποι κεν Καλλιμάχῳ λιπαρὸν	-uu- uu- - -uu- uu-	lyric	
κόσμον Ὀλυμπίᾳ, ὅν σφι Ζεὺς γένει	-u u-uu - - - u-	lyric	
ὤπασεν. ἐσλὰ δ᾽ἐπʼ ἐσλοῖς	-uu -u u --	lyric	
ἔργʼ ἐθέλοι δόμεν, ὀξείας δὲ νόσους ἀπαλάλκοι.	- uu- uu --- u u- uu--	dactylic hexameter	hepthemimeral, trithemimeral
εὔχομαι ἀμφὶ καλῶν μοίρᾳ Νέμεσιν διχόβουλον μὴ θέμεν·	-uu -u u- -- uu- uu-- - u-	lyric	
ἀλλʼ ἀπήμαντον ἄγων βίοτον	- u--u u- uu-	lyric	
αὐτούς τ᾽ἀέξοι καὶ πόλιν.	-- u-- - u-	lyric	
τὸ μὲν Ἀρχιλόχου μέλος	u u -uu- u-	lyric	
φωνᾶεν Ὀλυμπίᾳ, καλλίνικος ὁ τριπλόος κεχλαδώς,	--u u-u- -u-u u -u- u--	lyric	
ἄρκεσε Κρόνιον παρʼ ὄχθον ἁγεμονεῦσαι	-u- uu- u -u -uu--	lyric	
κωμάζοντι φίλοις Ἐφαρμόστῳ σὺν ἑταίροις·	---u u- u--- u u--	lyric	
ἀλλὰ νῦν ἑκαταβόλων Μοισᾶν ἀπὸ τόξων	-u - uu-u- -- uu --	lyric	
Δία τε φοινικοστερόπαν σεμνόν τ᾽ἐπίνειμαι	uu u ---uu- -- uu--	lyric	
ἀκρωτήριον Ἄλιδος	---uu -u-	lyric	
τοιοῖσδε βέλεσσιν,	--u u--	lyric	
τὸ δή ποτε Λυδὸς ἥρως Πέλοψ	u - uu -u -- u-	lyric	
ἐξάρατο κάλλιστον ἕδνον Ἱπποδαμείας·	--uu --u -u -uu--	lyric	
πτερόεντα δ᾽ἵει γλυκὺν	uu-u u- u-	lyric	
Πυθώναδʼ ὀϊστόν· οὔτοι χαμαιπετέων λόγων ἐφάψεαι	--u u-u -- u-uu- u- u--	lyric	
ἀνδρὸς ἀμφὶ παλαίσμασιν φόρμιγγʼ ἐλελίζων	-u -u u-u- -- uu--	lyric	
κλεινᾶς ἐξ Ὀπόεντος· αἰνήσαις ἓ καὶ υἱόν,	-- - uu-u --- u u --	lyric	
ἃν Θέμις θυγάτηρ τέ οἱ σώτειρα λέλογχεν	- u- uu- u - --u u--	lyric	
μεγαλόδοξος Εὐνομία, θάλλει δ᾽ἀρεταῖσιν	uuu-u -uu- -- uu--	lyric	
σόν τε, Κασταλία, πάρα	- u -uu- u-	lyric	
Ἀλφεοῦ τε ῥέεθρον·	-- u u--	lyric	
ὅθεν στεφάνων ἄωτοι κλυτὰν	u- uu- u-- u-	lyric	
Λοκρῶν ἐπαείροντι ματέρʼ ἀγλαόδενδρον.	-- uu--u -u -uu--	lyric	
ἐγὼ δέ τοι φίλαν πόλιν	u- u - u- u-	lyric	
μαλεραῖς ἐπιφλέγων ἀοιδαῖς,	uu- u-u- u--	lyric	
καὶ ἀγάνορος ἵππου	u u-uu --	lyric	
θᾶσσον καὶ ναὸς ὑποπτέρου παντᾷ	-- - -u u-u- --	lyric	
ἀγγελίαν πέμψω ταύταν,	-uu- -- --	lyric	
εἰ σύν τινι μοιριδίῳ παλάμᾳ	- - uu -uu- uu-	anapaestic	
ἐξαίρετον Χαρίτων νέμομαι κᾶπον·	--u- uu- uu- --	lyric	
κεῖναι γὰρ ὤπασαν τὰ τέρπνʼ· ἀγαθοὶ δὲ καὶ σοφοὶ κατὰ δαίμονʼ ἄνδρες	-- u -u- u - uu- u - u- uu -u --	lyric	
ἐγένοντʼ· ἐπεὶ ἀντία	uu- uu -u-	lyric	
πῶς ἂν τριόδοντος Ἡρακλέης σκύταλον τίναξε χερσίν,	- - uu-u --u- uu- u-u --	lyric	
ἁνίκʼ ἀμφὶ Πύλον σταθεὶς ἤρειδε Ποσειδᾶν	-u -u u- u- --u u--	lyric	
ἤρειδεν δέ νιν ἀργυρέῳ τόξῳ πολεμίζων	--- u u -u- -- uu--	lyric	
Φοῖβος, οὐδʼ Ἀΐδας ἀκινήταν ἔχε ῥάβδον,	-u - uu- u--- uu --	lyric	
βρότεα σώμαθʼ ᾇ κατάγει κοίλαν πρὸς ἀγυιὰν	uuu -u - uu- -- u u--	lyric	
θνᾳσκόντων; ἀπό μοι λόγον	--- uu - u-	lyric	
τοῦτον, στόμα, ῥῖψον·	-- uu --	lyric	
ἐπεὶ τό γε λοιδορῆσαι θεοὺς	u- u u -u-- u-	lyric	
ἐχθρὰ σοφία, καὶ τὸ καυχᾶσθαι παρὰ καιρὸν	-- uu- - u --- uu --	lyric	
μανίαισιν ὑποκρέκει.	uu-u u-u-	lyric	
μὴ νῦν λαλάγει τὰ τοιαῦτʼ· ἔα πόλεμον μάχαν τε πᾶσαν	- - uu- u -- u- uu- u- u --	lyric	
χωρὶς ἀθανάτων· φέροις δὲ Πρωτογενείας	-u -uu- u- - -uu--	lyric	
ἄστει γλῶσσαν, ἵνʼ αἰολοβρόντα Διὸς αἴσᾳ	-- -u u -u--- uu --	lyric	
Πύρρα Δευκαλίων τε Παρνασοῦ καταβάντε	-u -uu- u --- uu--	lyric	
δόμον ἔθεντο πρῶτον, ἄτερ δ᾽εὐνᾶς ὁμόδαμον	uu u-u -u u- -- uu--	lyric	
κτισσάσθαν λίθινον γόνον·	--- uu- u-	lyric	
λαοὶ δ᾽ὀνύμασθεν.	-- uu--	lyric	
ἔγειρʼ ἐπέων σφιν οἶμον λιγύν,	u- uu- u -- u-	lyric	
αἴνει δὲ παλαιὸν μὲν οἶνον, ἄνθεα δ᾽ὕμνων	-- u u-- u -u -uu --	lyric	
νεωτέρων. λέγοντι μὰν	u-u- u-u -	lyric	
χθόνα μὲν κατακλύσαι μέλαιναν	uu - u-u- u--	lyric	
ὕδατος σθένος, ἀλλὰ	uu- uu --	lyric	
Ζηνὸς τέχναις ἀνάπωτιν ἐξαίφνας	-- -- uu-u ---	lyric	
ἄντλον ἑλεῖν. κείνων ἔσαν	-u u- -- u-	lyric	
χαλκάσπιδες ὑμέτεροι πρόγονοι	--uu -uu- uu-	anapaestic	
ἀρχᾶθεν Ἰαπετιονίδος φύτλας	--u -uu-uu- --	lyric	
κοῦροι κορᾶν καὶ φερτάτων Κρονιδᾶν, ἐγχώριοι βασιλῆες αἰεί,	-- u- - -u- uu- --u- uu-u --	lyric	
πρὶν Ὀλύμπιος ἁγεμὼν	u u-uu -u-	lyric	
θύγατρʼ ἀπὸ γᾶς Ἐπειῶν Ὀπόεντος ἀναρπάσαις, ἕκαλος	u- uu - u-- u-u u-u- u--	lyric	
μίχθη Μαιναλίαισιν ἐν δειραῖς, καὶ ἔνεικεν	-- -uu-u - -- u u--	lyric	
Λοκρῷ, μὴ καθέλοι μιν αἰὼν πότμον ἐφάψαις	-- - uu- u -- -u u--	lyric	
ὀρφανὸν γενεᾶς. ἔχεν δὲ σπέρμα μέγιστον	-u- uu- u- - -u u--	lyric	
ἄλοχος, εὐφράνθη τε ἰδὼν ἥρως θετὸν υἱόν,	uuu --- u u- -- uu --	lyric	
μάτρωος δ᾽ἐκάλεσσέ νιν	--- uu-u -	lyric	
ἰσώνυμον ἔμμεν,	--uu --	lyric	
ὑπέρφατον ἄνδρα μορφᾷ τε καὶ	u-uu -u -- u -	lyric	
ἔργοισι. πόλιν δ᾽ὤπασεν λαόν τε διαιτᾶν.	--u u- -u- -- u u--	lyric	
ἀφίκοντο δέ οἱ ξένοι,	uu-u u - u-	lyric	
ἔκ τ᾽Ἄργεος ἔκ τε Θηβᾶν, οἱ δ᾽Ἀρκάδες, οἱ δὲ καὶ Πισᾶται·	- -uu - u -- - -uu - u - u--	lyric	
υἱὸν δ᾽Ἄκτορος ἐξόχως τίμασεν ἐποίκων	-- -uu -u- --u u--	lyric	
Αἰγίνας τε Μενοίτιον· τοῦ παῖς ἅμʼ Ἀτρείδαις	--- u u-u- - - u u--	lyric	
Τεύθραντος πεδίον μολὼν ἔστα σὺν Ἀχιλλεῖ	--- uu- u- -- u u--	lyric	
μόνος, ὅτʼ ἀλκᾶντας Δαναοὺς τρέψαις ἁλίαισιν	uu u --- uu- -- uu--	lyric	
πρύμναις Τήλεφος ἔμβαλεν·	-- -uu -u-	lyric	
ὥστʼ ἔμφρονι δεῖξαι	- -uu --	lyric	
μαθεῖν Πατρόκλου βιατὰν νόον.	u- uu- u-- u-	lyric	
ἐξ οὗ Θέτιος †γόνος οὐλίῳ νιν ἐν Ἄρει	- - uu- uu -u- u u --	lyric	
παραγορεῖτο μή ποτε	u-u-u - u-	lyric	
σφετέρας ἄτερθε ταξιοῦσθαι	uu- u-u -u--	lyric	
δαμασιμβρότου αἰχμᾶς.	uu-uu --	lyric	
εἴην εὑρησιεπὴς ἀναγεῖσθαι	-- --uu- u---	lyric	
πρόσφορος ἐν Μοισᾶν δίφρῳ·	-uu - -- --	lyric	
τόλμα δὲ καὶ ἀμφιλαφὴς δύναμις	-- u u -uu- uu-	anapaestic	
ἕσποιτο. προξενίᾳ δ᾽ἀρετᾷ τ᾽ἦλθον	--u -uu- uu- --	lyric	
τιμάορος Ἰσθμίαισι Λαμπρομάχου μίτραις, ὅτʼ ἀμφότεροι κράτησαν	--u -u-u -uu- u- u -uu- u--	lyric	
μίαν ἔργον ἀνʼ ἁμέραν.	uu -u u -u-	lyric	
ἄλλαι δὲ δύʼ ἐν Κορίνθου πύλαις ἐγένοντʼ ἔπειτα χάρμαι,	-- u u - u-- u- uu- u-u --	lyric	
ταὶ δὲ καὶ Νεμέας Ἐφαρμόστῳ κατὰ κόλπον·	- u - uu- u--- uu --	lyric	
Ἄργει τ᾽ἔσχεθε κῦδος ἀνδρῶν, παῖς δ᾽ἐν Ἀθάναις,	-- -uu -u -- - u u--	lyric	
οἷον δ᾽ἐν Μαραθῶνι συλαθεὶς ἀγενείων	-- - uu-u --- uu--	lyric	
μένεν ἀγῶνα πρεσβυτέρων ἀμφʼ ἀργυρίδεσσιν·	uu u-u -uu- - -uu--	lyric	
φῶτας δ᾽ὀξυρεπεῖ δόλῳ	-- -uu- u-	lyric	
ἀπτῶτι δαμάσσαις	--u u--	lyric	
διήρχετο κύκλον ὅσσᾳ βοᾷ,	u-uu -u -- u-	lyric	
ὡραῖος ἐὼν καὶ καλὸς κάλλιστά τε ῥέξαις.	--u u- - u- --u u --	lyric	
τὰ δὲ Παρρασίῳ στρατῷ	u u -uu- u-	lyric	
θαυμαστὸς ἐὼν φάνη Ζηνὸς ἀμφὶ πανάγυριν Λυκαίου,	--u u- u- -u -u u-u- u--	lyric	
καὶ ψυχρᾶν ὁπότʼ εὐδιανὸν φάρμακον αὐρᾶν	- -- uu -u-- -uu --	lyric	
Πελλάνᾳ φέρε· σύνδικος δ᾽αὐτῷ Ἰολάου	--- uu -u- -- uu--	lyric	
τύμβος εἰναλία τ᾽Ἐλευσὶς ἀγλαΐαισιν.	-u -uu- u-- -uu--	lyric	
τὸ δὲ φυᾷ κράτιστον ἅπαν· πολλοὶ δὲ διδακταῖς	u u u- u-u u- -- u u--	lyric	
ἀνθρώπων ἀρεταῖς κλέος	--- uu- u-	lyric	
ὤρουσαν ἀρέσθαι.	--u u--	lyric	
ἄνευ δὲ θεοῦ σεσιγαμένον	u- u u- u--u-	lyric	
οὐ σκαιότερον χρῆμʼ ἕκαστον. ἐντὶ γὰρ ἄλλαι	- -uu- - u-u -u u --	lyric	
ὁδῶν ὁδοὶ περαίτεραι,	u- u- u-u-	lyric	
μία δ᾽οὐχ ἅπαντας ἄμμε θρέψει	uu - u-u -u --	lyric	
μελέτα· σοφίαι μὲν	uu- uu- -	lyric	
αἰπειναί· τοῦτο δὲ προσφέρων ἆθλον,	--- -u u -u- --	lyric	
ὄρθιον ὤρυσαι θαρσέων,	-uu --- --	lyric	
τόνδʼ ἀνέρα δαιμονίᾳ γεγάμεν	- -uu -uu- uu-	anapaestic	
εὔχειρα, δεξιόγυιον, ὁρῶντʼ ἀλκάν,	--u -uu-u u- --	lyric	
Αἰάν, τεον τ᾽ἐν δαιτὶ Ἰλιάδα νικῶν ἐπεστεφάνωσε βωμόν.	-- u- - -u -uu- -- u-uu-u --	lyric	
τὸν Ὀλυμπιονίκαν ἀνάγνωτέ μοι	u u-uu-- u--u -	lyric	
Ἀρχεστράτου παῖδα, πόθι φρενὸς	--u- -u u- u-	lyric	
ἐμᾶς γέγραπται· γλυκὺ γὰρ αὐτῷ μέλος ὀφείλων ἐπιλέλαθʼ· ὦ Μοῖσʼ, ἀλλὰ σὺ καὶ θυγάτηρ	u- u-- uu u -- uu u-- uuu- - - -u u - uu-	lyric	
Ἀλάθεια Διός, ὀρθᾷ χερὶ	u--u uu -- u-	lyric	
ἐρύκετον ψευδέων	u-u- -u-	lyric	
ἐνιπὰν ἀλιτόξενον.	u-- uu-u-	lyric	
ἕκαθεν γὰρ ἐπελθὼν ὁ μέλλων χρόνος	uu- u u-- u -- u-	lyric	
ἐμὸν καταίσχυνε βαθὺ χρέος.	u- u--u u- u-	lyric	
ὅμως δὲ λῦσαι δυνατὸς ὀξεῖαν ἐπιμομφὰν τόκος· ὁρᾶτʼ ὦν νῦν ψᾶφον ἑλισσομέναν	u- u -- uuu --u uu-- uu u- - - -u u-uu-	lyric	
ὅπα κῦμα κατακλύσσει ῥέον,	u- -u uu-- u-	lyric	
ὅπα τε κοινὸν λόγον	u- u -- u-	lyric	
φίλαν τίσομεν ἐς χάριν.	u- -uu - u-	lyric	
νέμει γὰρ Ἀτρέκεια πόλιν Λοκρῶν Ζεφυρίων,	u- u uu-u u- -- uuu-	lyric	
μέλει τέ σφισι Καλλιόπα	u- - uu -uu-	lyric	
καὶ χάλκεος Ἄρης. τράπε δὲ Κύκνεια μάχα καὶ ὑπέρβιον	- -uu u- uu u --- u- u u-u-	lyric	
Ἡρακλέα. πύκτας δ᾽ἐν Ὀλυμπιάδι νικῶν	--uu -- u u-uuu --	lyric	
Ἴλᾳ φερέτω χάριν	-- uu- u-	lyric	
Ἁγησίδαμος ὡς	--u-u -	lyric	
Ἀχιλεῖ Πάτροκλος.	uu- uu-	anapaestic	
θήξαις δέ κε φύντʼ ἀρετᾷ ποτὶ	-- u u - uu- u-	lyric	
πελώριον ὁρμάσαι κλέος ἀνὴρ θεοῦ σὺν παλάμαις·	u-uu --- uu u- u- - uu-	lyric	
ἄπονον δ᾽ἔλαβον χάρμα παῦροί τινες,	uu- uu- -u -- u-	lyric	
ἔργων πρὸ πάντων βιότῳ φάος.	-- u -- uu- u-	lyric	
ἀγῶνα δ᾽ἐξαίρετον ἀεῖσαι θέμιτες ὦρσαν Διός, ὃν ἀρχαίῳ σάματι πὰρ Πέλοπος	u-u --uu u-- uuu -- uu u --- -uu - uu-	lyric	
†βωμῶν ἑξάριθμον ἐκτίσσατο,	-- -uuu --u-	lyric	
ἐπεὶ Ποσειδάνιον	u- u--u-	lyric	
πέφνε Κτέατον ἀμύμονα,	u- -u u-u-	lyric	
πέφνε δ᾽Εὔρυτον, ὡς Αὐγέαν λάτριον	uu -uu - -u- -u-	lyric	
ἀέκονθʼ ἑκὼν μισθὸν ὑπέρβιον	-- u- -u u-u-	lyric	
πράσσοιτο, λόχμαισι δὲ δοκεύσαις ὑπὸ Κλεωνᾶν δάμασε καὶ κείνους Ἡρακλέης ἐφʼ ὁδῷ,	--u --u u u-- uu u-- uuu - -- -uu- u u-	lyric	
ὅτι πρόσθε ποτὲ Τιρύνθιον	u- -u uu --u-	lyric	
ἔπερσαν αὐτῷ στρατὸν	u-u -- u-	lyric	
μυχοῖς ἥμενον Ἄλιδος	u- -uu -u-	lyric	
Μολίονες ὑπερφίαλοι. καὶ μὰν ξεναπάτας	u-uu u-uu- - - uuu-	lyric	
Ἐπειῶν βασιλεὺς ὄπιθεν	u-- uu- uu-	lyric	
οὐ πολλὸν ἴδε πατρίδα πολυκτέανον ὑπὸ στερεῷ πυρὶ	- -u uu -uu u--u u- uu- u-	lyric	
πλαγαῖς τε σιδάρου βαθὺν εἰς ὀχετὸν ἄτας	-- u u-- uu - uuu --	lyric	
ἵζοισαν ἑὰν πόλιν.	--u u- u-	lyric	
νεῖκος δὲ κρεσσόνων	-- u -u-	lyric	
ἀποθέσθʼ ἄπορον.	uu- uu-	anapaestic	
καὶ κεῖνος ἀβουλίᾳ ὕστατος	- -u u-uu -u-	lyric	
ἁλώσιος ἀντάσαις θάνατον αἰπὺν οὐκ ἐξέφυγεν.	u-uu --- uuu -u - -uu-	lyric	
ὁ δ᾽ἄρʼ ἐν Πίσᾳ ἔλσαις ὅλον τε στρατὸν	u u - uu -- u- - u-	lyric	
λαίαν τε πᾶσαν Διὸς ἄλκιμος	-- u -- uu -u-	lyric	
υἱὸς σταθμᾶτο ζάθεον ἄλσος πατρὶ μεγίστῳ· περὶ δὲ πάξαις Ἄλτιν μὲν ὅγʼ ἐν καθαρῷ	-- u-- uuu -- uu u-- uu u -- -- u u - uu-	lyric	
διέκρινε, τὸ δὲ κύκλῳ πέδον	u--u u u -- u-	lyric	
ἔθηκε δόρπου λύσιν,	u-u -- u-	lyric	
τιμάσαις πόρον Ἀλφεοῦ	--- uu -u-	lyric	
μετὰ δώδεκʼ ἀνάκτων θεῶν. καὶ πάγον	uu -u u-- u- - u-	lyric	
Κρόνου προσεφθέγξατο· πρόσθε γὰρ	u- u--uu -u -	lyric	
νώνυμνος, ἇς Οἰνόμαος ἆρχε, βρέχετο πολλᾷ νιφάδι. ταύτᾳ δ᾽ἐν πρωτογόνῳ τελετᾷ	--u - -uuu -- uuu -- uuu -- - -uu- uu-	lyric	
παρέσταν μὲν ἄρα Μοῖραι σχεδὸν	u-- u uu -- u-	lyric	
ὅ τ᾽ἐξελέγχων μόνος	u -u-- u-	lyric	
ἀλάθειαν ἐτήτυμον	u--u u-u-	lyric	
χρόνος. τὸ δὲ σαφανὲς ἰὼν πόρσω κατέφρασεν,	u- u u u-u u- -- uuu-	lyric	
ὅπα τὰν πολέμοιο δόσιν	u- - uu-u u-	lyric	
ἀκρόθινα διελὼν ἔθυε καὶ πενταετηρίδʼ ὅπως ἄρα	uu-u uu- uuu - -uu-u u- u-	lyric	
ἔστασεν ἑορτὰν σὺν Ὀλυμπιάδι πρώτᾳ	--u u-- u u-uuu --	lyric	
νικαφορίαισί τε.	--uu-u -	lyric	
τίς δὴ ποταίνιον	- - u-u-	lyric	
ἔλαχε στέφανον	uu- uu-	anapaestic	
χείρεσσι ποσίν τε καὶ ἅρματι,	--u u- u u -u-	lyric	
ἀγώνιον ἐν δόξᾳ θέμενος εὖχος, ἔργῳ καθελών;	u-uu - -- uuu -u -- uu-	lyric	
σταδίου μὲν ἀρίστευσεν εὐθὺν τόνον	uu- u u--u -- u-	lyric	
ποσσὶ τρέχων παῖς ὁ Λικυμνίου	-- u- - u u-u-	lyric	
Οἰωνός· ἷκεν δὲ Μιδέαθεν στρατὸν ἐλαύνων· ὁ δὲ πάλᾳ κυδαίνων Ἔχεμος Τεγέαν·	--u -- u uu-- uu u-- u u u- --- uu- uu-	lyric	
Δόρυκλος δ᾽ἔφερε πυγμᾶς τέλος,	u-- uuu -- u-	lyric	
Τίρυνθα ναίων πόλιν·	--u -- u-	lyric	
ἀνʼ ἵπποισι δὲ τέτρασιν	u --u u -u-	lyric	
ἀπὸ Μαντινέας Σᾶμος Ὡλιροθίου·	uu -uu- -u -uuu-	lyric	
ἄκοντι Φράστωρ ἔλασε σκοπόν·	u-u -- uu- u-	lyric	
μᾶκος δὲ Νικεὺς ἔδικε πέτρῳ χέρα κυκλώσαις ὑπὲρ ἁπάντων, καὶ συμμαχία θόρυβον	-- u -- uuu -- uu u-- uu u-- - -uu- uu-	lyric	
παραίθυξε μέγαν· ἐν δ᾽ἕσπερον	u--u uu - -u-	lyric	
ἔφλεξεν εὐώπιδος	u-u --u-	lyric	
σελάνας ἐρατὸν φάος.	u-- uu- u-	lyric	
ἀείδετο δὲ πᾶν τέμενος τερπναῖσι θαλίαις	u-uu u - uu- --u uu-	lyric	
τὸν ἐγκώμιον ἀμφὶ τρόπον.	u --uu -u u-	lyric	
ἀρχαῖς δὲ προτέραις ἑπόμενοι καί νυν ἐπωνυμίαν χάριν	-- u uu- uuu- - - u-uu- u-	lyric	
νίκας ἀγερώχου, κελαδησόμεθα βροντὰν	-- uu-- uu-uuu --	lyric	
καὶ πυρπάλαμον βέλος	- -uu- u-	lyric	
ὀρσικτύπου Διός,	--u- u-	lyric	
ἐν ἅπαντι κράτει	u u-u u-	anapaestic	
αἴθωνα κεραυνὸν ἀραρότα.	--u u-u u-u-	lyric	
χλιδῶσα δὲ μολπὰ πρὸς κάλαμον ἀντιάξει μελέων,	u-u u -- - uuu -u-- uu-	lyric	
τὰ παρʼ εὐκλέϊ Δίρκᾳ χρόνῳ μὲν φάνεν·	u u -uu -- u- - u-	lyric	
ἀλλʼ ὥτε παῖς ἐξ ἀλόχου πατρὶ	- -u - - uu- u-	lyric	
ποθεινὸς ἵκοντι νεότατος τὸ πάλιν ἤδη, μάλα δέ οἱ θερμαίνει φιλότατι νόον·	u-u --u uu-- u uu -- uu u - --- uu-u u-	lyric	
ἐπεὶ πλοῦτος ὁ λαχὼν ποιμένα	u- -u u u- -u-	lyric	
ἐπακτὸν ἀλλότριον,	u-u --u-	lyric	
θνᾴσκοντι στυγερώτατος·	--- uu-u-	lyric	
καὶ ὅταν καλὰ ἔρξαις ἀοιδᾶς ἄτερ,	u u- uu -- u-- u-	lyric	
Ἁγησίδαμʼ, εἰς Ἀΐδα σταθμὸν	--u- - uu- u-	lyric	
ἀνὴρ ἵκηται, κενεὰ πνεύσαις ἔπορε μόχθῳ βραχύ τι τερπνόν. τὶν δ᾽ἁδυεπής τε λύρα	u- u-- uuu -- uuu -- uu u -- - -uu- u u-	lyric	
γλυκύς τ᾽αὐλὸς ἀναπάσσει χάριν·	u- -u uu-- u-	lyric	
τρέφοντι δ᾽εὐρὺ κλέος	u-u -- u-	lyric	
κόραι Πιερίδες Διός.	u- -uu- u-	lyric	
ἐγὼ δὲ συνεφαπτόμενος σπουδᾷ, κλυτὸν ἔθνος	u- u uu-uu- -- uu --	lyric	
Λοκρῶν ἀμφέπεσον μέλιτι	u- -uu- uu-	lyric	
εὐάνορα πόλιν καταβρέχων· παῖδʼ ἐρατὸν δ᾽Ἀρχεστράτου	--uu u- uuu- - uu- --u-	lyric	
αἴνησα, τὸν εἶδον κρατέοντα χερὸς ἀλκᾷ	--u u -- uu-u uu --	lyric	
βωμὸν παρʼ Ὀλύμπιον,	-- u u-u-	lyric	
κεῖνον κατὰ χρόνον	-- u- u-	lyric	
ἰδέᾳ τε καλὸν	uu- u u-	anapaestic	
ὥρᾳ τε κεκραμένον, ἅ ποτε	-- u u-uu - u-	lyric	
ἀναιδέα Γανυμήδει μόρον ἄλαλκε σὺν Κυπρογενεῖ.	u-uu uu-- uu u-u - -uu-	lyric	
ἔστιν ἀνθρώποις ἀνέμων ὅτε πλείστα	-u --- uu- uu --	lyric	
χρῆσις, ἔστιν δ᾽οὐρανίων ὑδάτων,	-u -- -uu- uu-	lyric	
ὀμβρίων παίδων νεφέλας.	-u- -- uu-	lyric	
εἰ δὲ σὺν πόνῳ τις εὖ πράσσοι, μελιγάρυες ὕμνοι	- u - u- u - -- uu-uu --	lyric	
ὑστέρων ἀρχὰ λόγων	-u- -- u-	lyric	
τέλλεται καὶ πιστὸν ὅρκιον μεγάλαις ἀρεταῖς.	-u- - -u -u- uu- uu-	lyric	
ἀφθόνητος δ᾽αἶνος Ὀλυμπιονίκαις	-u-- -u u-uu--	lyric	
οὗτος ἄγκειται. τὰ μὲν ἁμετέρα	-u --- u u -uu-	lyric	
γλῶσσα ποιμαίνειν ἐθέλει·	-u --- uu-	lyric	
ἐκ θεοῦ δ᾽ἀνὴρ σοφαῖς ἀνθεῖ πραπίδεσσιν ὁμοίως.	- u- u- u- -- uu-u u--	lyric	
ἴσθι νῦν, Ἀρχεστράτου	-u - --u-	lyric	
παῖ, τεᾶς, Ἁγησίδαμε, πυγμαχίας ἕνεκεν	- u- --u-u -uu- uu-	lyric	
κόσμον ἐπὶ στεφάνῳ χρυσέας ἐλαίας	-u u- uu- -- u--	lyric	
ἁδυμελῆ κελαδήσω,	-uu- uu--	lyric	
Ζεφυρίων, Λοκρῶν γενεὰν ἀλέγων.	uuu- -- uu- uu-	lyric	
ἔνθα συγκωμάξατʼ· ἐγγυάσομαι	-u ---u -u-u-	lyric	
ὔμμιν, ὦ Μοῖσαι, φυγόξεινον στρατὸν	-u - -- u--- u-	lyric	
μηδʼ ἀπείρατον καλῶν,	- u--- u-	lyric	
ἀκρόσοφον δὲ καὶ αἰχματὰν ἀφίξεσθαι. τὸ γὰρ ἐμφυὲς οὔτʼ αἴθων ἀλώπηξ	-uu- u u --- u--- u u -uu - -- u--	lyric	
οὔτʼ ἐρίβρομοι λέοντες διαλλάξαντο ἦθος.	- u-u- u-- u---u --	lyric	
λίσσομαι, παῖ Ζηνὸς Ἐλευθερίου,	-u- - -u u-uu-	lyric	
Ἱμέραν εὐρυσθενέʼ ἀμφιπόλει, σώτειρα Τύχα.	-u- --uu -uu- --u u-	lyric	
τὶν γὰρ ἐν πόντῳ κυβερνῶνται θοαὶ	- u - -- u--- u-	lyric	
νᾶες, ἐν χέρσῳ τε λαιψηροὶ πόλεμοι	-u - -- u --- uu-	lyric	
κἀγοραὶ βουλαφόροι. αἵ γε μὲν ἀνδρῶν	-u- --uu - u u --	lyric	
πόλλʼ ἄνω, τὰ δ᾽αὖ κάτω ψεύδη μεταμώνια τάμνοισαι κυλίνδοντʼ ἐλπίδες·	- u- u - u- -- uu-uu --- u-- -u-	lyric	
σύμβολον δ᾽οὔ πώ τις ἐπιχθονίων	-u- - - u u-uu-	lyric	
πιστὸν ἀμφὶ πράξιος ἐσσομένας εὗρεν θεόθεν·	-u -- -uu -uu- -- uu-	lyric	
τῶν δὲ μελλόντων τετύφλωνται φραδαί.	- u --- u--- u-	lyric	
πολλὰ δ᾽ἀνθρώποις παρὰ γνώμαν ἔπεσεν,	-u --- u- -- uu-	lyric	
ἔμπαλιν μὲν τέρψιος, οἱ δ᾽ἀνιαραῖς	-u- - -uu - uu--	lyric	
ἀντικύρσαντες ζάλαις ἐσλὸν βαθὺ πήματος ἐν μικρῷ πεδάμειψαν χρόνῳ.	-u--- u- -- uu -uu - -- u--- u-	lyric	
υἱὲ Φιλάνορος, ἤτοι καὶ τεά κεν,	-u u-uu -- - u- -	lyric	
ἐνδομάχας ἅτʼ ἀλέκτωρ, συγγόνῳ παρʼ ἑστίᾳ	-uu- u u-- -u- u -u-	lyric	
ἀκλεὴς τιμὰ κατεφυλλορόησε ποδῶν,	-u- -- uu-uu-u u-	lyric	
εἰ μὴ στάσις ἀντιάνειρα Κνωσίας ἄμερσε πάτρας.	- - uu -uu-- -u- --u --	lyric	
νῦν δ᾽Ὀλυμπία στεφανωσάμενος	- u-u- uu-uu-	lyric	
καὶ δὶς ἐκ Πυθῶνος Ἰσθμοῖ τ᾽,Ἐργότελες,	- u - --u -- -uu-	lyric	
θερμὰ Νυμφᾶν λουτρὰ βαστάζεις, ὁμιλέων παρʼ οἰκείαις ἀρούραις.	-u -- -u --- u-u- u --- u--	lyric	
τρισολυμπιονίκαν	uu-uu--	lyric	
ἐπαινέων οἶκον ἅμερον ἀστοῖς,	u-u- -u -uu --	lyric	
ξένοισι δὲ θεράποντα, γνώσομαι	u-u u uu-- -u-	lyric	
τὰν ὀλβίαν Κόρινθον, Ἰσθμίου	- -u- u-u -u-	lyric	
πρόθυρον Ποτειδᾶνος, ἀγλαόκουρον.	uu- u--u -uu--	lyric	
ἐν τᾷ γὰρ Εὐνομία ναίει, κασίγνηταί τε, βάθρον πολίων ἀσφαλές,	- - u -uu- -- u--- u u- uu- -u-	lyric	
Δίκα καὶ ὁμότροφος Εἰρήνα, τάμι᾽ ἀνδράσι πλούτου,	u- u u-uu --- uu -uu --	lyric	
χρύσεαι παῖδες εὐβούλου Θέμιτος·	-u- -u --- uu-	lyric	
ἐθέλοντι δ᾽ἀλέξειν	uu-u u--	lyric	
Ὕβριν, Κόρου ματέρα θρασύμυθον.	u- u- -u- uu--	lyric	
ἔχω καλά τε φράσαι, τόλμα τέ μοι	u- uu u u- -- u -	lyric	
εὐθεῖα γλῶσσαν ὀρνύει λέγειν.	--u -u -u- u-	lyric	
ἄμαχον δὲ κρύψαι τὸ συγγενὲς ἦθος.	uu- u -- u -uu --	lyric	
ὔμμιν δέ, παῖδες Ἀλάτα, πολλὰ μὲν νικαφόρον ἀγλαΐαν ὤπασαν	-- u -u u-- -u - --uu -uu- -u-	lyric	
ἄκραις ἀρεταῖς ὑπερελθόντων ἱεροῖς ἐν ἀέθλοις,	-- uu- uu--- uu- u u--	lyric	
πολλὰ δ᾽ἐν καρδίαις ἀνδρῶν ἔβαλον	-u - -u- -- uu-	lyric	
ὧραι πολυάνθεμοι ἀρχαῖα σοφίσμαθʼ. ἅπαν δ᾽εὑρόντος ἔργον.	-- uu-uu --u u-u u- --u --	lyric	
ταὶ Διωνύσου πόθεν ἐξέφανεν	- u--- uu -uu-	lyric	
σὺν βοηλάτᾳ χάριτες διθυράμβῳ·	- u-u- uu- -u--	lyric	
τίς γὰρ ἱππείοις ἐν ἔντεσσιν μέτρα,	- u --- u --- u-	lyric	
ἢ θεῶν ναοῖσιν οἰωνῶν βασιλέα δίδυμον	- u- --u --- uu- uu-	lyric	
ἐπέθηκʼ; ἐν δὲ Μοῖσʼ ἁδύπνοος,	uu- - u - --u-	lyric	
ἐν δ᾽Ἄρης ἀνθεῖ νέων οὐλίαις αἰχμαῖσιν ἀνδρῶν.	- u- -- u- -u- --u --	lyric	
ὕπατʼ εὐρὺ ἀνάσσων	uu -u u--	lyric	
Ὀλυμπίας, ἀφθόνητος ἔπεσσιν	u-u- -u-u u--	lyric	
γένοιο χρόνον ἅπαντα, Ζεῦ πάτερ,	u-u uu u-- - u-	lyric	
καὶ τόνδε λαὸν ἀβλαβῆ νέμων	- -u -u -u- u-	lyric	
Ξενοφῶντος εὔθυνε δαίμονος οὖρον·	uu-u --u -uu --	lyric	
δέξαι τέ οἱ στεφάνων ἐγκώμιον τεθμόν, τὸν ἄγει πεδίων ἐκ Πίσας,	-- u - uu- --u- -- u u- uu- - u-	lyric	
πεντάθλῳ ἅμα σταδίου νικῶν δρόμον· ἀντεβόλησεν	--u u- uu- -- uu -uu--	lyric	
τῶν ἀνὴρ θνατὸς οὔπω τις πρότερον.	- u- -u -- - uu-	lyric	
δύο δ᾽αὐτὸν ἔρεψαν	uu -u u--	lyric	
πλόκοι σελίνων ἐν Ἰσθμιάδεσσιν	u- u-- u -uu--	lyric	
φανέντα· Νέμεά τ᾽οὐκ ἀντιξοεῖ.	u-u uuu - --u-	lyric	
πατρὸς δὲ Θεσσαλοῦ ἐπʼ Ἀλφεοῦ	-- u -u- u -u-	lyric	
ῥεέθροισιν αἴγλα ποδῶν ἀνάκειται,	uu-u -- u- uu--	lyric	
Πυθοῖ τ᾽ἔχει σταδίου τιμὰν διαύλου θ᾽ἁλίῳ ἀμφʼ ἑνί, μηνός τέ οἱ	-- u- uu- -- u-- -uu - uu -- u -	lyric	
τωὐτοῦ κρανααῖς ἐνʼ Ἀθάναισι τρία ἔργα ποδαρκὴς	-- uu- u u--- uu -u u--	lyric	
ἅμερα θῆκε κάλλιστʼ ἀμφὶ κόμαις,	-u- -u -- -u u-	lyric	
Ἑλλώτια δ᾽ἑπτάκις· ἐν δ᾽ἀμφιάλοισι Ποτειδᾶνος τεθμοῖσιν	--uu -uu - -uu-u u--- u--	lyric	
Πτοιοδώρῳ σὺν πατρὶ μακρότεραι	-u-- - uu -uu-	lyric	
Τερψίᾳ θ᾽ἕψοντʼ Ἐριτίμῳ ἀοιδαί.	-u- -- uu-- u--	lyric	
ὅσσα τ᾽ἐν Δελφοῖσιν ἀριστεύσατε	-u - --u ---u-	lyric	
ἠδὲ χόρτοις ἐν λέοντος, δηρίομαι πολέσιν	-u -- - u-- -uu- uu-	lyric	
περὶ πλήθει καλῶν, ὡς μὰν σαφὲς	uu -- u- - - u-	lyric	
οὐκ ἂν εἰδείην λέγειν ποντιᾶν ψάφων ἀριθμόν.	- u --- u- -u- -- u--	lyric	
ἕπεται δ᾽ἐν ἑκάστῳ	uu- u u--	lyric	
μέτρον· νοῆσαι δὲ καιρὸς ἄριστος.	u- u-- u -u u--	lyric	
ἐγὼ δὲ ἴδιος ἐν κοινῷ σταλεὶς	u- u uuu - -- u-	lyric	
μῆτίν τε γαρύων παλαιγόνων	-- u -u- u-u-	lyric	
πόλεμόν τ᾽ἐν ἡρωΐαις ἀρεταῖσιν	uu- u --u- uu--	lyric	
οὐ ψεύσομʼ ἀμφὶ Κορίνθῳ, Σίσυφον μὲν πυκνότατον παλάμαις ὡς θεόν,	- -u -u u-- -u- - -uu- uu- - u-	lyric	
καὶ τὰν πατρὸς ἀντία Μήδειαν θεμέναν γάμον αὐτᾷ,	- - uu -uu --- uu- uu --	lyric	
ναῒ σώτειραν Ἀργοῖ καὶ προπόλοις.	-u --u -- - uu-	lyric	
τὰ δὲ καί ποτʼ ἐν ἀλκᾷ	u u - u u --	lyric	
πρὸ Δαρδάνου τειχέων ἐδόκησαν	u -u- -u- uu--	lyric	
ἐπʼ ἀμφότερα μαχᾶν τάμνειν τέλος,	u -uuu u- -- u-	lyric	
τοὶ μὲν γένει φίλῳ σὺν Ἀτρέος	- - u- u- u -u-	lyric	
Ἑλέναν κομίζοντες, οἱ δ᾽ἀπὸ πάμπαν	uu- u--u - uu --	lyric	
εἴργοντες· ἐκ Λυκίας δὲ Γλαῦκον ἐλθόντα τρόμεον Δαναοί. τοῖσι μὲν	--u - uu- - -u --- uu- uu- -u -	lyric	
ἐξεύχετʼ ἐν ἄστεϊ Πειράνας σφετέρου πατρὸς ἀρχὰν	--u u -uu --- uu- uu --	lyric	
καὶ βαθὺν κλᾶρον ἔμμεν καὶ μέγαρον·	- u- -u -- - uu-	lyric	
ὃς τᾶς ὀφιώδεος υἱόν ποτε Γοργόνος ἦ πόλλʼ ἀμφὶ κρουνοῖς	- - uu-uu -- uu -uu - - -u --	lyric	
Πάγασον ζεῦξαι ποθέων ἔπαθεν,	-u- -- uu- uu-	lyric	
πρίν γέ οἱ χρυσάμπυκα κούρα χαλινὸν	- u - --uu -- u--	lyric	
Παλλὰς ἤνεγκʼ· ἐξ ὀνείρου δ᾽αὐτίκα	-u -- - u-- -u-	lyric	
ἦν ὕπαρ· φώνασε δ᾽·"εὕδεις, Αἰολίδα βασιλεῦ;	- u- --u -- -uu- uu-	lyric	
ἄγε φίλτρον τόδʼ ἵππειον δέκευ,	uu -- u --- u-	lyric	
καὶ Δαμαίῳ νιν θύων ταῦρον ἀργᾶντα πατρὶ δεῖξον."	- u-- - u- -u --u uu --	lyric	
κυαναιγὶς ἐν ὄρφνᾳ	uu-u u --	lyric	
κνώσσοντί οἱ παρθένος τόσα εἰπεῖν	--u - -u- uu --	lyric	
ἔδοξεν· ἀνὰ δ᾽ἐπᾶλτʼ ὀρθῷ ποδί.	u-u uu u- -- u-	lyric	
παρκείμενον δὲ συλλαβὼν τέρας,	--u- u -u- u-	lyric	
ἐπιχώριον μάντιν ἄσμενος εὗρεν,	uu-u- -u -uu --	lyric	
δεῖξέν τε Κοιρανίδᾳ πᾶσαν τελευτὰν πράγματος, ὥς τ᾽ἀνὰ βωμῷ θεᾶς	-- u -uu- -- u-- -uu - uu -- u-	lyric	
κοιτάξατο νύκτʼ ἀπὸ κείνου χρήσιος. ὥς τέ οἱ αὐτὰ	--uu - uu -- -uu - u u --	lyric	
Ζηνὸς ἐγχεικεραύνου παῖς ἔπορεν	-u --u-- - uu-	lyric	
δαμασίφρονα χρυσόν.	uu-uu --	lyric	
ἐνυπνίῳ δ᾽ᾇ τάχιστα πιθέσθαι	u-u- - u-u u--	lyric	
κελήσατό μιν, ὅταν δ᾽εὐρυσθενεῖ	u-uu u u- --u-	lyric	
καρταίποδʼ ἀναρύῃ Γαιαόχῳ,	--u uuu- --u-	lyric	
θέμεν Ἱππίᾳ βωμὸν εὐθὺς Ἀθάνᾳ.	uu -u- -u -u u--	lyric	
τελεῖ δὲ θεῶν δύναμις καὶ τὰν παρʼ ὅρκον καὶ παρὰ ἐλπίδα κούφαν κτίσιν.	u- u - uu- - - u -- - uu -uu -- u-	lyric	
ἤτοι καὶ ὁ καρτερὸς ὁρμαίνων ἕλε Βελλεροφόντας,	-- u u -uu --- uu -uu--	lyric	
φάρμακον πραῢ τείνων ἀμφὶ γένυι,	-u- -u -- -u u-	lyric	
ἵππον πτερόεντʼ· ἀναβὰς δ᾽εὐθὺς ἐνόπλια χαλκωθεὶς ἔπαιζεν.	-- uu- uu- -u u-uu --- u--	lyric	
σὺν δὲ κείνῳ καί ποτʼ Ἀμαζονίδων	- u -- - u u-uu-	lyric	
αἰθέρος ψυχρῶν ἀπὸ κόλπων ἐρήμου	-u- -- uu -- u--	lyric	
τοξόταν βάλλων γυναικεῖον στρατόν,	-u- -- u--- u-	lyric	
καὶ Χίμαιραν πῦρ πνέοισαν καὶ Σολύμους ἔπεφνεν.	- u-- - u-- - uu- u--	lyric	
διασωπάσομαί οἱ μόρον ἐγώ·	uu--u- - uu u-	lyric	
τὸν δ᾽ἐν Οὐλύμπῳ φάτναι Ζηνὸς ἀρχαῖαι δέκονται.	- u --- u- -u --- u--	lyric	
ἐμὲ δ᾽εὐθὺν ἀκόντων	uu -u u--	lyric	
ἱέντα ῥόμβον παρὰ σκοπὸν οὐ χρὴ	u-u -- u- uu - -	lyric	
τὰ πολλὰ βέλεα καρτύνειν χεροῖν.	u -u uuu --- u-	lyric	
Μοίσαις γὰρ ἀγλαοθρόνοις ἑκὼν	-- u -u-u- u-	lyric	
Ὀλιγαιθίδαισίν τ᾽ἔβαν ἐπίκουρος.	uu-u-- u- uu--	lyric	
Ἰσθμοῖ τά τ᾽ἐν Νεμέᾳ παύρῳ ἔπει θήσω φανέρʼ ἀθρόʼ, ἀλαθής τέ μοι	-- u - uu- -- u- -- uu -u u-- u -	lyric	
ἔξορκος ἐπέσσεται ἑξηκοντάκι δὴ ἀμφοτέρωθεν	--u u-uu ---uu -uu--	lyric	
ἁδύγλωσσος βοὰ κάρυκος ἐσλοῦ.	-u-- u- --u u-	lyric	
τὰ δ᾽Ὀλυμπίᾳ αὐτῶν	u u-uu --	lyric	
ἔοικεν ἤδη πάροιθε λελέχθαι·	u-u -- u-u u--	lyric	
τά τ᾽ἐσσόμενα τότʼ ἂν φαίην σαφές·	u -uuu u - -- u-	lyric	
νῦν δ᾽ἔλπομαι μέν, ἐν θεῷ γε μὰν	- -u- u - u- u -	lyric	
τέλος· εἰ δὲ δαίμων γενέθλιος ἕρποι,	uu - u -- u-uu --	lyric	
Δι τοῦτʼ Ἐνυαλίῳ τ᾽ἐκδώσομεν πράσσειν. τὰ δ᾽ὑπʼ ὀφρύϊ Παρνασσίᾳ	- - u-uu- --u- -- u u -uu --u-	lyric	
ἕξ· Ἄργεΐ θ᾽ὅσσα καὶ ἐν Θήβαις, ὅσα τ᾽Ἀρκάσι βάσσαις	- -uu -u u - -- uu -uu --	lyric	
μαρτυρήσει Λυκαίου βωμὸς ἄναξ,	-u-- u-- -u u-	lyric	
Πέλλανά τε καὶ Σικυὼν καὶ Μέγαρʼ Αἰακιδᾶν τ᾽εὐερκὲς ἄλσος,	--u u - uu- - uu -uu- --u --	lyric	
ἅ τ᾽Ἐλευσὶς καὶ λιπαρὰ Μαραθών,	- u-- - uu- uu-	lyric	
ταί θ᾽ὑπʼ Αἴτνας ὑψιλόφου καλλίπλουτοι	- u -- -uu- -u--	lyric	
πόλιες, ἅ τ᾽Εὔβοια· καὶ πᾶσαν κατὰ	uuu - --u - -- u-	lyric	
Ἑλλάδʼ εὑρήσεις ἐρευνῶν μάσσονʼ ἢ ὡς ἰδέμεν.	-u --- u-- -u u - uu-	lyric	
ἄνα, κούφοισιν ἐκνεῦσαι ποσίν·	uu --u --- u-	lyric	
Ζεῦ τέλειʼ, αἰδῶ δίδοι καὶ τύχαν τερπνῶν γλυκεῖαν.	- u- -- u- - u- -- u--	lyric	
Καφισίων ὑδάτων	--u- uu-	lyric	
λαχοῖσαι, αἵτε ναίετε καλλίπωλον ἕδραν,	u-u -u -uu -u-u --	lyric	
ὦ λιπαρᾶς ἀοίδιμοι βασίλειαι	- uu- u-u- uu--	lyric	
Χάριτες Ὀρχομενοῦ, παλαιγόνων Μινυᾶν ἐπίσκοποι,	uuu -uu- u-u- uu- u-u-	lyric	
κλῦτʼ, ἐπεὶ εὔχομαι. σὺν γὰρ ὔμμιν τὰ τε τερπνὰ καὶ	- uu -u- - u -- u u -u -	lyric	
τὰ γλυκέʼ ἄνεται πάντα βροτοῖς,	- uu -u- -u u-	lyric	
εἰ σοφός, εἰ καλός, εἴ τις ἀγλαὸς ἀνήρ.	- uu - uu - u -uu --	lyric	
οὐδὲ γὰρ θεοὶ σεμνᾶν Χαρίτων ἄτερ	-u - - -- uu- u-	lyric	
κοιρανέοντι χοροὺς οὔτε δαῖτας· ἀλλὰ πάντων ταμίαι	-uu-u u- -u -u -u -- uu-	lyric	
ἔργων ἐν οὐρανῷ, χρυσότοξον θέμεναι παρὰ	-- u -u- -u-- uu- u-	lyric	
Πύθιον Ἀπόλλωνα θρόνους,	-uu u--- u-	lyric	
αἰέναον σέβοντι πατρὸς Ὀλυμπίοιο τιμάν.	-uu- u-u -u u-u-u --	lyric	
ὦ πότνιʼ Ἀγλαΐα	- -u -uu-	lyric	
φιλησίμολπέ τ᾽Εὐφροσύνα, θεῶν κρατίστου	u-u-u -uu- u- u--	lyric	
παῖδες, ἐπακοοῖτε νῦν, Θαλία τε	-u u-u-u - uu- -	lyric	
ἐρασίμολπε, ἰδοῖσα τόνδε κῶμον ἐπʼ εὐμενεῖ τύχᾳ	uuu-u u-u -u -u u -u- u-	lyric	
κοῦφα βιβῶντα· Λυδῷ γὰρ Ἀσώπιχον ἐν τρόπῳ	-u u-u -- u --uu - u-	lyric	
ἔν μελέταις ἀείδων ἔμολον,	- uu- u-- uu-	lyric	
οὕνεκʼ Ὀλυμπιόνικος ἁ Μινυεία	-u u-uu-u - uu--	lyric	
σεῦ ἕκατι. μελαντειχέα νῦν δόμον	- u-u u--uu - u-	lyric	
Φερσεφόνας ἔλθʼ, Ἀχοῖ, πατρὶ κλυτὰν φέροισʼ ἀγγελίαν,	-uu- - -- u- u- u- -uu-	lyric	
Κλεόδαμον ὄφρʼ ἰδοῖσʼ, υἱὸν εἴπῃς ὅτι οἱ νέαν	--u - u- -u -- uu - u-	lyric	
κόλποις παρʼ εὐδόξοις Πίσας	-- u --- u-	lyric	
ἐστεφάνωσε κυδίμων ἀέθλων πτεροῖσι χαίταν.	-uu-u -u- uu- u-u --	lyric	
