ἢ οἵη προλιποῦσα δόμους καὶ πατρίδα γαῖαν	- -- uu-u u- - -uu --	dactylic hexameter	feminine penthemimeral, hepthemimeral, trithemimeral
ἤλυθεν ἐς Θήβας μετʼ ἀρήιον Ἀμφιτρύωνα	-uu - -- u u-uu -uu--	dactylic hexameter	masculine penthemimeral, trithemimeral
Ἀλκμήνη, θυγάτηρ λαοσσόου Ἠλεκτύωνος·	--- uu- --uu ----	dactylic hexameter	masculine penthemimeral, trithemimeral
ἥ ῥα γυναικῶν φῦλον ἐκαίνυτο θηλυτεράων	- u u-- -u u-uu -uu--	dactylic hexameter	feminine penthemimeral
εἴδεΐ τε μεγέθει τε· νόον γε μὲν οὔ τις ἔριζε	-uu - uu- u u- u u - u u--	dactylic hexameter	masculine penthemimeral, hepthemimeral, trithemimeral
τάων, ἃς θνηταὶ θνητοῖς τέκον εὐνηθεῖσαι.	-- - -- -- uu ----	dactylic hexameter	masculine penthemimeral, hepthemimeral, trithemimeral
τῆς καὶ ἀπὸ κρῆθεν βλεφάρων τ᾽ἄπο κυανεάων	- u u- -- uu- uu -uu--	dactylic hexameter	masculine penthemimeral, hepthemimeral, trithemimeral
τοῖον ἄηθʼ οἶόν τε πολυχρύσου Ἀφροδίτης.	-u u- -- u u-uu -u--	lyric	
ἣ δὲ καὶ ὣς κατὰ θυμὸν ἑὸν τίεσκεν ἀκοίτην,	- u u - uu -u u- --u u--	dactylic hexameter	feminine penthemimeral, hepthemimeral, trithemimeral
ὡς οὔ πώ τις ἔτισε γυναικῶν θηλυτεράων·	- - - u u-u u-- -uu--	dactylic hexameter	feminine penthemimeral, trithemimeral
ἦ μέν οἱ πατέρʼ ἐσθλὸν ἀπέκτανε ἶφι δαμάσσας,	- - - uu -u u-uu -u u--	dactylic hexameter	feminine penthemimeral, trithemimeral
χωσάμενος περὶ βουσί· λιπὼν δ᾽ὅ γε πατρίδα γαῖαν	-uu- uu -u u- u u -uu --	dactylic hexameter	feminine penthemimeral, hepthemimeral, trithemimeral
ἐς Θήβας ἱκέτευσε φερεσσακέας Καδμείους.	- -- uu-u u-uu- ---	dactylic hexameter	feminine penthemimeral, trithemimeral
ἔνθʼ ὅ γε δώματʼ ἔναιε σὺν αἰδοίῃ παρακοίτι	- u u -u u-u u --- uu--	dactylic hexameter	feminine penthemimeral
νόσφιν ἄτερ φιλότητος ἐφιμέρου, οὐδέ οἱ ἦεν	-u u- uu-u u-uu -u u --	dactylic hexameter	feminine penthemimeral, trithemimeral
πρὶν λεχέων ἐπιβῆναι ἐυσφύρου Ἠλεκτρυώνης,	- uu- uu-u u-uu -uu--	dactylic hexameter	feminine penthemimeral, trithemimeral
πρίν γε φόνον τίσαιτο κασιγνήτων μεγαθύμων	- u u- --u u--- uu--	dactylic hexameter	feminine penthemimeral, trithemimeral
ἧς ἀλόχου, μαλερῷ δὲ καταφλέξαι πυρὶ κώμας	- uu- uu- u u--- uu --	dactylic hexameter	masculine penthemimeral, trithemimeral
ἀνδρῶν ἡρώων Ταφίων ἰδὲ Τηλεβοάων.	-- --- uu- uu -uu--	dactylic hexameter	masculine penthemimeral, hepthemimeral
τὼς γάρ οἱ διέκειτο, θεοὶ δ᾽ἐπὶ μάρτυροι ἦσαν·	- - - uu-u u- uu -uu --	dactylic hexameter	feminine penthemimeral, hepthemimeral, trithemimeral
τῶν ὅ γ᾽ὀπίζετο μῆνιν, ἐπείγετο δ᾽ὅττι τάχιστα	- u u-uu -u u-uu -u u--	dactylic hexameter	feminine penthemimeral
ἐκτελέσαι μέγα ἔργον, ὅ οἱ Διόθεν θέμις ἦεν.	-uu- uu -u u - uu- uu --	dactylic hexameter	feminine penthemimeral, hepthemimeral, trithemimeral
τῷ δ᾽ἅμα ἱέμενοι πολέμοιό τε φυλόπιδός τε	- uu -uu- uu-u u -uu- -	dactylic hexameter	masculine penthemimeral
Βοιωτοὶ πλήξιπποι, ὑπὲρ σακέων πνείοντες,	--- --u u- uu- ---	dactylic hexameter	feminine penthemimeral, hepthemimeral, trithemimeral
Λοκροί τ᾽ἀγχέμαχοι καὶ Φωκῆες μεγάθυμοι	-- -uu- - --- uu--	dactylic hexameter	masculine penthemimeral
ἕσποντʼ· ἦρχε δὲ τοῖσιν ἐὺς πάις Ἀλκαίοιο	-- -u u -- - uu ----	dactylic hexameter	hepthemimeral
κυδιόων λαοῖσι. πατὴρ δ᾽ἀνδρῶν τε θεῶν τε	-uu- --u u- -- u u- -	dactylic hexameter	feminine penthemimeral, hepthemimeral, trithemimeral
ἄλλην μῆτιν ὕφαινε μετὰ φρεσίν, ὥς ῥα θεοῖσιν	-- -u u-u u- uu - u u--	dactylic hexameter	feminine penthemimeral, hepthemimeral
ἀνδράσι τ᾽ἀλφηστῇσιν ἀρῆς ἀλκτῆρα φυτεύσαι.	-uu ---u u- --u u--	dactylic hexameter	feminine penthemimeral, hepthemimeral
ὦρτο δ᾽ἀπʼ Οὐλύμποιο δόλον φρεσὶ βυσσοδομεύων,	-u u ---u u- uu -uu--	dactylic hexameter	feminine penthemimeral, hepthemimeral
ἱμείρων φιλότητος ἐυζώνοιο γυναικός,	--- uu-u u---u u--	dactylic hexameter	feminine penthemimeral, trithemimeral
ἐννύχιος· τάχα δ᾽ἷξε Τυφαόνιον· τόθεν αὖτις	-uu- uu -u u-uu- uu --	dactylic hexameter	feminine penthemimeral, trithemimeral
Φίκιον ἀκρότατον προσεβήσατο μητίετα Ζεύς.	-uu -uu- uu-uu -uu- -	dactylic hexameter	masculine penthemimeral
ἔνθα καθεζόμενος φρεσὶ μήδετο θέσκελα ἔργα·	-u u-uu- uu -uu -uu --	dactylic hexameter	masculine penthemimeral
αὐτῇ μὲν γὰρ νυκτὶ τανυσφύρου Ἠλεκτρυώνης	-- - - -u u-uu -uu--	dactylic hexameter	feminine penthemimeral, trithemimeral
εὐνῇ καὶ φιλότητι μίγη, τέλεσεν δ᾽ἄρʼ ἐέλδωρ·	-- - uu-u u- uu- u u--	dactylic hexameter	feminine penthemimeral, hepthemimeral, trithemimeral
αὐτῇ δ᾽Ἀμφιτρύων λαοσσόος, ἀγλαὸς ἥρως,	-- -uu- --uu -uu --	dactylic hexameter	masculine penthemimeral
ἐκτελέσας μέγα ἔργον ἀφίκετο ὅνδε δόμονδε.	-uu- uu -u u-uu -u u--	dactylic hexameter	feminine penthemimeral, trithemimeral
οὐδʼ ὅ γ᾽ἐπὶ δμῶας καὶ ποιμένας ἀγροιώτας	- u u- -- - -uu ----	dactylic hexameter	masculine penthemimeral, trithemimeral
ὦρτʼ ἰέναι, πρίν γ᾽ἧς ἀλόχου ἐπιβήμεναι εὐνῆς·	- uu- - - uu- uu-uu --	dactylic hexameter	masculine penthemimeral, hepthemimeral, trithemimeral
τοῖος γὰρ κραδίην πόθος αἴνυτο ποιμένα λαῶν.	-- - uu- uu -uu -uu --	dactylic hexameter	masculine penthemimeral, trithemimeral
ὡς δ᾽ὅτʼ ἀνὴρ ἀσπαστὸν ὑπεκπροφύγῃ κακότητα	- u u- --u u-uu- uu--	dactylic hexameter	feminine penthemimeral, trithemimeral
νούσου ὕπʼ ἀργαλέης ἢ καὶ κρατεροῦ ὑπὸ δεσμοῦ,	-u u -uu- - - uu- uu --	dactylic hexameter	masculine penthemimeral, hepthemimeral
ὥς ῥα τότʼ Ἀμφιτρύων χαλεπὸν πόνον ἐκτολυπεύσας	- u u -uu- uu- uu -uu--	dactylic hexameter	masculine penthemimeral, hepthemimeral
ἀσπασίως τε φίλως τε ἑὸν δόμον εἰσαφίκανεν.	-uu- u u- u u- uu -uu--	dactylic hexameter	masculine penthemimeral, hepthemimeral, trithemimeral
παννύχιος δ᾽ἄρʼ ἔλεκτο σὺν αἰδοίῃ παρακοίτι	-uu- u u-u u --- uu--	dactylic hexameter	feminine penthemimeral, trithemimeral
τερπόμενος δώροισι πολυχρύσου Ἀφροδίτης.	-uu- --u u-uu -u--	lyric	
ἣ δὲ θεῷ δμηθεῖσα καὶ ἀνέρι πολλὸν ἀρίστῳ	- u u- --u u -uu -u u--	dactylic hexameter	feminine penthemimeral, trithemimeral
Θήβῃ ἐν ἑπταπύλῳ διδυμάονε γείνατο παῖδε,	-u u -uu- uu-uu -uu --	dactylic hexameter	masculine penthemimeral
οὐ καθʼ ὁμὰ φρονέοντε· κασιγνήτω γε μὲν ἤστην·	- u u- uu-u u--- u u --	dactylic hexameter	feminine penthemimeral, trithemimeral
τὸν μὲν χειρότερον, τὸν δ᾽αὖ μέγʼ ἀμείνονα φῶτα,	- - -uu- - - u u-uu --	dactylic hexameter	masculine penthemimeral, hepthemimeral
δεινόν τε κρατερόν τε, βίην Ἡρακληείην·	-- - uu- u u- -----	dactylic hexameter	masculine penthemimeral, hepthemimeral, trithemimeral
τὸν μὲν ὑποδμηθεῖσα κελαινεφέι Κρονίωνι,	- u u---u u-uu- uu--	dactylic hexameter	feminine penthemimeral
τὸν δ᾽ἄρα Ἰφικλῆα δορυσσόῳ Ἀμφιτρύωνι,	- uu ---u u-uu -uu--	dactylic hexameter	feminine penthemimeral
κεκριμένην γενεήν· τὸν μὲν βροτῷ ἀνδρὶ μιγεῖσα,	-uu- uu- - - uu -u u--	dactylic hexameter	masculine penthemimeral, hepthemimeral, trithemimeral
τὸν δὲ Διὶ Κρονίωνι, θεῶν σημάντορι πάντων.	- u u- uu-u u- --uu --	dactylic hexameter	feminine penthemimeral, hepthemimeral, trithemimeral
ὃς καὶ Κύκνον ἔπεφνεν, Ἀρητιάδην μεγάθυμον.	- - -u u-u u-uu- uu--	dactylic hexameter	feminine penthemimeral
εὗρε γὰρ ἐν τεμένει ἑκατηβόλου Ἀπόλλωνος	-u u - uu- uu-uu ----	dactylic hexameter	masculine penthemimeral, trithemimeral
αὐτὸν καὶ πατέρα ὅν Ἄρην, ἄατον πολέμοιο,	-- - uu- u u- uu- uu--	dactylic hexameter	masculine penthemimeral, hepthemimeral, trithemimeral
τεύχεσι λαμπομένους σέλας ὣς πυρὸς αἰθομένοιο,	-uu -uu- uu - uu -uu--	dactylic hexameter	masculine penthemimeral, hepthemimeral
ἑσταότʼ ἐν δίφρῳ· χθόνα δ᾽ἔκτυπον ὠκέες ἵπποι	-uu - -- uu -uu -uu --	dactylic hexameter	masculine penthemimeral, trithemimeral
νύσσοντες χηλῇσι, κόνις δέ σφʼ ἀμφιδεδήει	--- --u u- - -uu--	dactylic hexameter	feminine penthemimeral, hepthemimeral, trithemimeral
κοπτομένη πλεκτοῖσιν ὑφʼ ἅρμασι καὶ ποσὶν ἵππων.	-uu- --u u -uu - uu --	dactylic hexameter	feminine penthemimeral, trithemimeral
ἅρματα δ᾽εὐποίητα καὶ ἄντυγες ἀμφαράβιζον	-uu ---u u -uu -uu--	dactylic hexameter	feminine penthemimeral
ἵππων ἱεμένων· κεχάρητο δὲ Κύκνος ἀμύμων,	-- -uu- uu-u u -u u--	dactylic hexameter	masculine penthemimeral
ἐλπόμενος Διὸς υἱὸν ἀρήιον ἡνίοχόν τε	-uu- uu -u u-uu -uu- -	dactylic hexameter	feminine penthemimeral, trithemimeral
χαλκῷ δηιώσειν καὶ ἀπὸ κλυτὰ τεύχεα δύσειν.	-- --- u u- uu -uu --	dactylic hexameter	masculine penthemimeral, hepthemimeral
ἀλλά οἱ εὐχωλέων οὐκ ἔκλυε Φοῖβος Ἀπόλλων·	-u u --- - -uu -u u--	dactylic hexameter	masculine penthemimeral
αὐτὸς γάρ οἱ ἐπῶρσε βίην Ἡρακληείην.	-- - u u-u u- -----	dactylic hexameter	feminine penthemimeral, hepthemimeral, trithemimeral
πᾶν δ᾽ἄλσος καὶ βωμὸς Ἀπόλλωνος Παγασαίου	- -- - -u u--- uu--	dactylic hexameter	feminine penthemimeral, trithemimeral
λάμπεν ὑπὸ δεινοῖο θεοῦ τευχέων τε καὶ αὐτοῦ·	-u u- --u u- -- u u --	dactylic hexameter	feminine penthemimeral, hepthemimeral, trithemimeral
πῦρ δ᾽ὣς ὀφθαλμῶν ἀπελάμπετο. τίς κεν ἐκείνου	- - --- uu-uu - u u--	dactylic hexameter	masculine penthemimeral
ἔτλη θνητὸς ἐὼν κατεναντίον ὁρμηθῆναι	-- -u u- uu-uu ----	dactylic hexameter	masculine penthemimeral
πλήν γ᾽Ἡρακλῆος καὶ κυδαλίμου Ἰολάου;	- ---- - -uu- uu--	dactylic hexameter	masculine penthemimeral
κείνων γὰρ μεγάλη τε βίη καὶ χεῖρες ἄαπτοι	-- - uu- u u- - -u u--	dactylic hexameter	masculine penthemimeral, hepthemimeral, trithemimeral
ἐξ ὤμων ἐπέφυκον ἐπὶ στιβαροῖσι μέλεσσιν.	- -- uu-u u- uu-u u--	dactylic hexameter	feminine penthemimeral, hepthemimeral, trithemimeral
ὅς ῥα τόθʼ ἡνίοχον προσέφη κρατερὸν Ἰόλαον·	- u u -uu- uu- uu- uu--	dactylic hexameter	masculine penthemimeral, hepthemimeral
ἥρως ὦ Ἰόλαε, βροτῶν πολὺ φίλτατε πάντων,	-- - uu-u u- uu -uu --	dactylic hexameter	feminine penthemimeral, hepthemimeral, trithemimeral
ἦ τε μέγʼ ἀθανάτους μάκαρας, τοὶ Ὄλυμπον ἔχουσιν,	- u u -uu- uu- u u-u u--	dactylic hexameter	masculine penthemimeral, hepthemimeral
ἤλιτεν Ἀμφιτρύων, ὅτʼ ἐυστέφανον ποτὶ Θήβην	-uu -uu- u u-uu- uu --	dactylic hexameter	masculine penthemimeral
ἦλθε λιπὼν Τίρυνθα, ἐυκτίμενον πτολίεθρον,	-u u- --u u-uu- uu--	dactylic hexameter	feminine penthemimeral, trithemimeral
κτείνας Ἠλεκτρύωνα βοῶν ἕνεκʼ εὐρυμετώπων·	-- -uu-u u- uu -uu--	dactylic hexameter	feminine penthemimeral, hepthemimeral
ἵκετο δ᾽ἐς Κρείοντα καὶ Ἠνιόχην τανύπεπλον,	-uu - --u u -uu- uu--	dactylic hexameter	feminine penthemimeral, trithemimeral
οἵ ῥά μιν ἠσπάζοντο καὶ ἄρμενα πάντα παρεῖχον,	- u u ---u u -uu -u u--	dactylic hexameter	feminine penthemimeral
ἣ δίκη ἔσθʼ ἱκέτῃσι, τίον δέ ἑ κηρόθι μᾶλλον.	- uu - uu-u u- u u -uu --	dactylic hexameter	feminine penthemimeral, hepthemimeral, trithemimeral
ζῶε δ᾽ἀγαλλόμενος σὺν ἐυσφύρῳ Ἠλεκτρυώνῃ,	-u u-uu- u u-uu -uu--	dactylic hexameter	masculine penthemimeral
ᾗ ἀλόχῳ· τάχα δ᾽ἄμμες ἐπιπλομένων ἐνιαυτῶν	- uu- uu -u u-uu- uu--	dactylic hexameter	feminine penthemimeral, trithemimeral
γεινόμεθʼ οὔτε φυὴν ἐναλίγκιοι οὔτε νόημα,	-uu -u u- uu-uu -u u--	dactylic hexameter	masculine penthemimeral
σός τε πατὴρ καὶ ἐγώ· τοῦ μὲν φρένας ἐξέλετο Ζεύς,	- u u- u u- - - uu -uu- -	dactylic hexameter	masculine penthemimeral, hepthemimeral, trithemimeral
ὃς προλιπὼν σφέτερον τε δόμον σφετέρους τε τοκῆας	- uu- uu- u u- uu- u u--	dactylic hexameter	masculine penthemimeral, hepthemimeral, trithemimeral
ᾤχετο, τιμήσων ἀλιτήμενον Εὐρυσθῆα,	-uu --- uu-uu ----	dactylic hexameter	masculine penthemimeral
σχέτλιος· ἦ που πολλὰ μετεστεναχίζετʼ ὀπίσσω	-uu - - -u u-uu-u u--	dactylic hexameter	feminine penthemimeral, trithemimeral
ἣν ἄτην ὀχέων· ἣ δ᾽οὐ παλινάγρετός ἐστιν.	- -- uu- - - uu-uu --	dactylic hexameter	masculine penthemimeral, hepthemimeral, trithemimeral
αὐτὰρ ἐμοὶ δαίμων χαλεποὺς ἐπετέλλετʼ ἀέθλους.	-u u- -- uu- uu-u u--	dactylic hexameter	masculine penthemimeral, hepthemimeral, trithemimeral
ὦ φίλος, ἀλλὰ σὺ θᾶσσον ἔχʼ ἡνία φοινικόεντα	- uu -u u -u u -uu -uu--	dactylic hexameter	feminine penthemimeral
ἵππων ὠκυπόδων· μέγα δὲ φρεσὶ θάρσος ἀέξων	-- -uu- uu - uu -u u--	dactylic hexameter	masculine penthemimeral, hepthemimeral
ἰθὺς ἔχειν θοὸν ἅρμα καὶ ὠκυπόδων σθένος ἵππων,	-u u- uu -u u -uu- uu --	dactylic hexameter	feminine penthemimeral, trithemimeral
μηδὲν ὑποδδείσας κτύπον Ἄρεος ἀνδροφόνοιο,	-u u--- uu -uu -uu--	dactylic hexameter	masculine penthemimeral
ὃς νῦν κεκληγὼς περιμαίνεται ἱερὸν ἄλσος	- - --- uu-uu -uu --	dactylic hexameter	masculine penthemimeral
Φοίβου Ἀπόλλωνος, ἑκατηβελέταο ἄνακτος·	-u u--- uu-uu-u u--	dactylic hexameter	masculine penthemimeral
ἦ μὴν καὶ κρατερός περ ἐὼν ἄαται πολέμοιο.	- - - uu- u u- uu- uu--	dactylic hexameter	masculine penthemimeral, hepthemimeral, trithemimeral
τὸν δ᾽αὖτε προσέειπεν ἀμώμητος Ἰόλαος·	- -- uu-u u--- uu--	dactylic hexameter	feminine penthemimeral, trithemimeral
ἠθεῖʼ, ἦ μάλα δή τι πατὴρ ἀνδρῶν τε θεῶν τε	-- - uu - u u- -- u u- -	dactylic hexameter	masculine penthemimeral, hepthemimeral, trithemimeral
τιμᾷ σὴν κεφαλὴν καὶ ταύρεος Ἐννοσίγαιος,	-- - uu- - -uu -uu--	dactylic hexameter	masculine penthemimeral, trithemimeral
ὃς Θήβης κρήδεμνον ἔχει ῥύεταί τε πόληα·	- -- --u u- uu- u u--	dactylic hexameter	feminine penthemimeral, hepthemimeral, trithemimeral
οἶον δὴ καὶ τόνδε βροτὸν κρατερόν τε μέγαν τε	-- - - -u u- uu- u u- -	dactylic hexameter	feminine penthemimeral, hepthemimeral, trithemimeral
σὰς ἐς χεῖρας ἄγουσιν, ἵνα κλέος ἐσθλὸν ἄρηαι.	- - -u u-u u- uu -u u--	dactylic hexameter	feminine penthemimeral, hepthemimeral
ἀλλʼ ἄγε δύσεο τεύχεʼ ἀρήια, ὄφρα τάχιστα	- uu -uu -u u-uu -u u--	dactylic hexameter	feminine penthemimeral
δίφρους ἐμπελάσαντες Ἄρηός θ᾽ἡμέτερόν τε	-- -uu-u u-- -uu- -	dactylic hexameter	feminine penthemimeral
μαρνώμεσθʼ, ἐπεὶ οὔ τοι ἀτάρβητον Διὸς υἱὸν	--- uu - u u--- uu --	dactylic hexameter	masculine penthemimeral, trithemimeral
οὐδʼ Ἰφικλεΐδην δειδίξεται, ἀλλά μιν οἴω	- --uu- --uu -u u --	dactylic hexameter	masculine penthemimeral
φεύξεσθαι δύο παῖδας ἀμύμονος Ἀλκεΐδαο,	--- uu -u u-uu -uu--	dactylic hexameter	feminine penthemimeral, trithemimeral
οἳ δή σφι σχεδόν εἰσι, λιλαιόμενοι πολέμοιο	- - - uu -u u-uu- uu--	dactylic hexameter	feminine penthemimeral, trithemimeral
φυλόπιδα στῆσαι, τά σφιν πολὺ φίλτερα θοίνης.	-uu- -- - - uu -uu --	dactylic hexameter	masculine penthemimeral, hepthemimeral, trithemimeral
ὣς φάτο· μείδησεν δὲ βίη Ἡρακληείη	- uu --- u u- -----	dactylic hexameter	masculine penthemimeral, hepthemimeral
θυμῷ γηθήσας· μάλα γάρ νύ οἱ ἄρμενα εἶπεν·	-- --- uu - u u -uu --	dactylic hexameter	masculine penthemimeral, hepthemimeral
καί μιν ἀμειβόμενος ἔπεα πτερόεντα προσηύδα·	- u u-uu- uu- uu-u u--	dactylic hexameter	masculine penthemimeral, hepthemimeral
ἥρως ὦ Ἰόλαε, διοτρεφές, οὐκέτι τηλοῦ	-- - uu-u u-uu -uu --	dactylic hexameter	feminine penthemimeral, trithemimeral
ὑσμίνη τρηχεῖα· σὺ δ᾽ὡς πάρος ἦσθα δαΐφρων,	--- --u u - uu -u u--	dactylic hexameter	feminine penthemimeral, hepthemimeral, trithemimeral
ὣς καὶ νῦν μέγαν ἵππον Ἀρίονα κυανοχαίτην	- - - uu -u u-uu -uu--	dactylic hexameter	feminine penthemimeral, trithemimeral
πάντη ἀναστρωφᾶν καὶ ἀρηγέμεν, ὥς κε δύνηαι.	-u u--- u u-uu - u u--	dactylic hexameter	masculine penthemimeral
ὣς εἰπὼν κνημῖδας ὀρειχάλκοιο φαεινοῦ,	- -- --u u---u u--	dactylic hexameter	feminine penthemimeral, trithemimeral
Ἡφαίστου κλυτὰ δῶρα, περὶ κνήμῃσιν ἔθηκεν·	--- uu -u u- --u u--	dactylic hexameter	feminine penthemimeral, hepthemimeral, trithemimeral
δεύτερον αὖ θώρηκα περὶ στήθεσσιν ἔδυνε	-uu - --u u- --u u--	dactylic hexameter	feminine penthemimeral, hepthemimeral, trithemimeral
καλὸν χρύσειον πολυδαίδαλον, ὅν οἱ ἔδωκε	-- --- uu-uu - u u--	dactylic hexameter	masculine penthemimeral
Παλλὰς Ἀθηναίη, κούρη Διός, ὁππότʼ ἔμελλε	-u u--- -- uu -u u--	dactylic hexameter	masculine penthemimeral, hepthemimeral
τὸ πρῶτον στονόεντας ἐφορμήσεσθαι ἀέθλους.	- -- uu-u u---u u--	dactylic hexameter	feminine penthemimeral, trithemimeral
θήκατο δ᾽ἀμφʼ ὤμοισιν ἀρῆς ἀλκτῆρα σίδηρον	-uu - --u u- --u u--	dactylic hexameter	feminine penthemimeral, hepthemimeral, trithemimeral
δεινὸς ἀνήρ· κοΐλην δὲ περὶ στήθεσσι φαρέτρην	-u u- uu- u u- --u u--	dactylic hexameter	masculine penthemimeral, hepthemimeral, trithemimeral
καββάλετʼ ἐξόπιθεν· πολλοὶ δ᾽ἔντοσθεν ὀιστοὶ	-uu -uu- -- --- --	dactylic hexameter	masculine penthemimeral, hepthemimeral
ῥιγηλοί, θανάτοιο λαθιφθόγγοιο δοτῆρες.	--- uu-u u---u u--	dactylic hexameter	feminine penthemimeral, trithemimeral
πρόσθεν μὲν θάνατόν τ᾽εἶχον καὶ δάκρυσι μῦρον,	-- - uu- -- - -uu --	dactylic hexameter	masculine penthemimeral, hepthemimeral, trithemimeral
μέσσοι δὲ ξεστοί, περιμήκεες, αὐτὰρ ὄπισθε	-- - -- uu-uu -u u--	dactylic hexameter	masculine penthemimeral, trithemimeral
μόρφνοιο φλεγύαο καλυπτόμενοι πτερύγεσσιν.	--- uu-u u-uu- uu--	dactylic hexameter	feminine penthemimeral, trithemimeral
εἵλετο δ᾽ὄβριμον ἔγχος, ἀκαχμένον αἴθοπι χαλκῷ,	-uu -uu -u u-uu -uu --	dactylic hexameter	feminine penthemimeral
κρατὶ δ᾽ἔπʼ ἰφθίμῳ κυνέην ἐύτυκτον ἔθηκε,	-u u --- uu- uu-u u--	dactylic hexameter	masculine penthemimeral, hepthemimeral
δαιδαλέην ἀδάμαντος, ἐπὶ κροτάφοις ἀραρυῖαν,	-uu- uu-u u- uu- uu--	dactylic hexameter	feminine penthemimeral, hepthemimeral, trithemimeral
ἥτʼ εἴρυτο κάρη Ἡρακλῆος θείοιο.	- --u u- ---- ---	dactylic hexameter	masculine penthemimeral
χερσί γε μὴν σάκος εἷλε παναίολον, οὐδέ τις αὐτὸ	-u u - uu -u u-uu -u u --	dactylic hexameter	feminine penthemimeral, trithemimeral
οὔτʼ ἔρρηξε βαλὼν οὔτʼ ἔθλασε, θαῦμα ἰδέσθαι.	- --u u- - -uu -u u--	dactylic hexameter	masculine penthemimeral
πᾶν μὲν γὰρ κύκλῳ τιτάνῳ λευκῷ τ᾽ἐλέφαντι	- - - -- uu- -- uu--	dactylic hexameter	masculine penthemimeral, hepthemimeral, trithemimeral
ἠλέκτρῳ θ᾽ὑπολαμπὲς ἔην χρυσῷ τε φαεινῷ	--- uu-u u- -- u u--	dactylic hexameter	feminine penthemimeral, hepthemimeral, trithemimeral
λαμπόμενον, κυάνου δὲ διὰ πτύχες ἠλήλαντο.	-uu- uu- u u- uu ----	dactylic hexameter	masculine penthemimeral, hepthemimeral, trithemimeral
ἐν μέσσῳ δ᾽ἀδάμαντος ἔην Φόβος οὔ τι φατειός,	- -- uu-u u- uu - u u--	dactylic hexameter	feminine penthemimeral, hepthemimeral, trithemimeral
ἔμπαλιν ὄσσοισιν πυρὶ λαμπομένοισι δεδορκώς·	-uu --- uu -uu-u u--	dactylic hexameter	masculine penthemimeral
τοῦ καὶ ὀδόντων μὲν πλῆτο στόμα λευκὰ θεόντων,	- u u-- - -- uu -u u--	dactylic hexameter	masculine penthemimeral, hepthemimeral
δεινῶν ἀπλήτων, ἐπὶ δὲ βλοσυροῖο μετώπου	-- --- uu - uu-u u--	dactylic hexameter	masculine penthemimeral, hepthemimeral
δεινὴ Ἔρις πεπότητο κορύσσουσα κλόνον ἀνδρῶν,	-u u- uu-u u--- uu --	dactylic hexameter	feminine penthemimeral, trithemimeral
σχετλίη, ἥ ῥα νόον τε καὶ ἐκ φρένας εἵλετο φωτῶν.	-uu - u u- u u - uu -uu --	dactylic hexameter	masculine penthemimeral, hepthemimeral, trithemimeral
οἵτινες ἀντιβίην πόλεμον Διὸς υἷι φέροιεν.	-uu -uu- uu- uu -u u--	dactylic hexameter	masculine penthemimeral, hepthemimeral
τῶν καὶ ψυχαὶ μὲν χθόνα δύμεναι Ἄιδος εἴσω	- - -- - uu -uu -- --	dactylic hexameter	masculine penthemimeral
κάκκιον, ὀστέα δέ σφι περὶ ῥινοῖο σαπείσης	-uu -uu - u u- --u u--	dactylic hexameter	masculine penthemimeral, hepthemimeral
Σειρίου ἀζαλέοιο μελαίνῃ πύθεται αἴῃ.	-uu -uu-u u-- -uu --	dactylic hexameter	feminine penthemimeral
ἐν δὲ Προΐωξίς τε Παλίωξίς τε τέτυκτο,	- u u--- u u--- u u--	dactylic hexameter	masculine penthemimeral
ἐν δ᾽Ὅμαδός τε Φόβος τ᾽Ἀνδροκτασίη τε δεδήει,	- uu- u u- --uu- u u--	dactylic hexameter	masculine penthemimeral, trithemimeral
ἐν δ᾽Ἔρις, ἐν δὲ Κυδοιμὸς ἐθύνεον, ἐν δ᾽ὀλοὴ Κὴρ	- uu - u u-u u-uu - uu- -	dactylic hexameter	feminine penthemimeral, trithemimeral
ἄλλον ζωὸν ἔχουσα νεούτατον, ἄλλον ἄουτον,	-- -u u-u u-uu -u u--	dactylic hexameter	feminine penthemimeral
ἄλλον τεθνηῶτα κατὰ μόθον ἕλκε ποδοῖιν.	-- ---u u- uu -u u--	dactylic hexameter	feminine penthemimeral, hepthemimeral
εἷμα δ᾽ἔχʼ ἄμφʼ ὤμοισι δαφοινεὸν αἵματι φωτῶν,	-u u - --u u-uu -uu --	dactylic hexameter	feminine penthemimeral, trithemimeral
δεινὸν δερκομένη καναχῇσί τε βεβρυχυῖα.	-- -uu- uu-u u ----	dactylic hexameter	masculine penthemimeral
ἐν δ᾽ὀφίων κεφαλαὶ δεινῶν ἔσαν, οὔ τι φατειῶν,	- uu- uu- -- uu - u u--	dactylic hexameter	masculine penthemimeral, hepthemimeral, trithemimeral
δώδεκα, ταὶ φοβέεσκον ἐπὶ χθονὶ φῦλʼ ἀνθρώπων,	-uu - uu-u u- uu - ---	dactylic hexameter	feminine penthemimeral, hepthemimeral, trithemimeral
οἵ τινες ἀντιβίην πόλεμον Διὸς υἷι φέροιεν·	- uu -uu- uu- uu -u u--	dactylic hexameter	masculine penthemimeral, hepthemimeral
τῶν καὶ ὀδόντων μὲν καναχὴ πέλεν, εὖτε μάχοιτο	- u u-- - uu- uu -u u--	dactylic hexameter	masculine penthemimeral, hepthemimeral
Ἀμφιτρυωνιάδης, τὰ δ᾽ἐδαίετο θαυματὰ ἔργα.	-uu-uu- u u-uu -uu --	dactylic hexameter	masculine penthemimeral
στίγματα δ᾽ὣς ἐπέφαντο ἰδεῖν δεινοῖσι δράκουσιν·	-uu - uu-u u- --u u--	dactylic hexameter	feminine penthemimeral, hepthemimeral, trithemimeral
κυάνεοι κατὰ νῶτα, μελάνθησαν δὲ γένεια.	-uu- uu -u u--- u u--	dactylic hexameter	feminine penthemimeral, trithemimeral
ἐν δὲ συῶν ἀγέλαι χλούνων· ἔσαν ἠδὲ λεόντων	- u u- uu- -- uu -u u--	dactylic hexameter	masculine penthemimeral, hepthemimeral, trithemimeral
ἐς σφέας δερκομένων, κοτεόντων θ᾽ἱεμένων τε.	- - -uu- uu-- -uu- -	dactylic hexameter	masculine penthemimeral
τῶν καὶ ὁμιληδὸν στίχες ἤισαν· οὐδέ νυ τώ γε	- u u--- uu -uu -u u - -	dactylic hexameter	masculine penthemimeral
οὐδέτεροι τρεέτην· φρῖσσόν γε μὲν αὐχένας ἄμφω.	-uu- uu- -- u u -uu --	dactylic hexameter	masculine penthemimeral, hepthemimeral, trithemimeral
ἤδη γάρ σφιν ἔκειτο μέγας λῖς, ἀμφὶ δὲ κάπροι	-- - u u-u u- - -u u --	dactylic hexameter	feminine penthemimeral, hepthemimeral, trithemimeral
δοιοί, ἀπουράμενοι ψυχάς, κατὰ δέ σφι κελαινὸν	-u u-uu- -- uu - u u--	dactylic hexameter	masculine penthemimeral, hepthemimeral
αἷμʼ ἀπελείβετʼ ἔραζʼ· οἳ δ᾽αὐχένας ἐξεριπόντες	- uu-u u- - -uu -uu--	dactylic hexameter	masculine penthemimeral
κείατο τεθνηῶτες ὑπὸ βλοσυροῖσι λέουσιν.	-uu ---u u- uu-u u--	dactylic hexameter	feminine penthemimeral, hepthemimeral
τοὶ δ᾽ἔτι μᾶλλον ἐγειρέσθην κοτέοντε μάχεσθαι,	- uu -u u--- uu-u u--	dactylic hexameter	hepthemimeral
ἀμφότεροι, χλοῦναί τε σύες χαροποί τε λέοντες.	-uu- -- u u- uu- u u--	dactylic hexameter	masculine penthemimeral, hepthemimeral, trithemimeral
ἐν δ᾽ἦν ὑσμίνη Λαπιθάων αἰχμητάων	- - --- uu-- ----	dactylic hexameter	masculine penthemimeral
Καινέα τ᾽ἀμφὶ ἄνακτα Δρύαντά τε Πειρίθοόν τε	-uu -u u-u u-u u -uu- -	dactylic hexameter	feminine penthemimeral
Ὁπλέα τ᾽Ἐξάδιόν τε Φάληρόν τε Πρόλοχόν τε	-uu -uu- u u-- - uu- -	dactylic hexameter	masculine penthemimeral
Μόψον τ᾽Ἀμπυκίδην, Τιταρήσιον, ὄζον Ἄρηος,	-- -uu- uu-uu -u u--	dactylic hexameter	masculine penthemimeral
Θησέα τ᾽Αἰγεΐδην, ἐπιείκελον ἀθανάτοισιν·	-uu -uu- uu-uu -uu--	dactylic hexameter	masculine penthemimeral
ἀργύρεοι, χρύσεια περὶ χροῒ τεύχεʼ ἔχοντες.	-uu- --u u- uu -u u--	dactylic hexameter	feminine penthemimeral, hepthemimeral, trithemimeral
Κένταυροι δ᾽ἑτέρωθεν ἐναντίοι ἠγερέθοντο	--- uu-u u-uu -uu--	dactylic hexameter	feminine penthemimeral, trithemimeral
ἀμφὶ μέγαν Πετραῖον ἰδʼ Ἄσβολον οἰωνιστὴν	-u u- --u u -uu ----	dactylic hexameter	feminine penthemimeral, trithemimeral
Ἄρκτον τ᾽Οὔρειόν τε μελαγχαίτην τε Μίμαντα	-- --- u u--- u u--	dactylic hexameter	masculine penthemimeral
καὶ δύο Πευκεΐδας, Περιμήδεά τε Δρύαλόν τε,	- uu -uu- uu-uu - uu- -	dactylic hexameter	masculine penthemimeral
ἀργύρεοι, χρυσέας ἐλάτας ἐν χερσὶν ἔχοντες.	-uu- uu- uu- - -u u--	dactylic hexameter	masculine penthemimeral, hepthemimeral, trithemimeral
καί τε συναΐγδην ὡς εἰ ζωοί περ ἐόντες	- u u--- - - -- u u--	dactylic hexameter	masculine penthemimeral, hepthemimeral
ἔγχεσιν ἠδʼ ἐλάτῃς αὐτοσχεδὸν ὠριγνῶντο.	-uu - uu- --uu ----	dactylic hexameter	masculine penthemimeral, trithemimeral
ἐν δ᾽Ἄρεος βλοσυροῖο ποδώκεες ἕστασαν ἵπποι	- uu- uu-u u-uu -uu --	dactylic hexameter	feminine penthemimeral, trithemimeral
χρύσεοι, ἐν δὲ καὶ αὐτὸς ἐναρσφόρος οὔλιος Ἄρης	-uu - u u -u u-uu -uu --	dactylic hexameter	feminine penthemimeral, trithemimeral
αἰχμὴν ἐν χείρεσσιν ἔχων, πρυλέεσσι κελεύων,	-- - --u u- uu-u u--	dactylic hexameter	feminine penthemimeral, hepthemimeral, trithemimeral
αἵματι φοινικόεις, ὡς εἰ ζωοὺς ἐναρίζων	-uu -uu- - - -- uu--	dactylic hexameter	masculine penthemimeral, hepthemimeral
δίφρου ἐπεμβεβαώς· παρὰ δὲ Δεῖμός τε Φόβος τε	-u u-uu- uu - -- u u- -	dactylic hexameter	masculine penthemimeral, hepthemimeral
ἕστασαν ἱέμενοι πόλεμον καταδύμεναι ἀνδρῶν.	-uu -uu- uu- uu-uu --	dactylic hexameter	masculine penthemimeral, hepthemimeral
ἐν δὲ Διὸς θυγάτηρ ἀγελείη Τριτογένεια,	- u u- uu- uu-- -uu--	dactylic hexameter	masculine penthemimeral, trithemimeral
τῇ ἰκέλη ὡς εἴ τε μάχην ἐθέλουσα κορύσσειν,	- uu- - - u u- uu-u u--	dactylic hexameter	masculine penthemimeral, hepthemimeral, trithemimeral
ἔγχος ἔχουσʼ ἐν χερσὶν ἰδὲ χρυσέην τρυφάλειαν	-u u- - -u u- uu- uu--	dactylic hexameter	feminine penthemimeral, hepthemimeral, trithemimeral
αἰγίδα τ᾽ἀμφʼ ὤμοις· ἐπὶ δ᾽ᾤχετο φύλοπιν αἰνήν.	-uu - -- uu -uu -uu --	dactylic hexameter	masculine penthemimeral, trithemimeral
ἐν δ᾽ἦν ἀθανάτων ἱερὸς χορός· ἐν δ᾽ἄρα μέσσῳ	- - -uu- uu- uu - uu --	dactylic hexameter	masculine penthemimeral, hepthemimeral
ἱμερόεν κιθάριζε Διὸς καὶ Λητοῦς υἱὸς	-uu- uu-u u- - -- --	dactylic hexameter	feminine penthemimeral, hepthemimeral, trithemimeral
χρυσείῃ φόρμιγγι· θεῶν δ᾽ἕδος ἁγνὸς Ὄλυμπος·	--- --u u- uu -u u--	dactylic hexameter	feminine penthemimeral, hepthemimeral, trithemimeral
ἐν δ᾽ἀγορή, περὶ δ᾽ὄλβος ἀπείριτος ἐστεφάνωτο	- uu- uu -u u-uu -uu--	dactylic hexameter	feminine penthemimeral, trithemimeral
ἀθανάτων ἐν ἀγῶνι· θεαὶ δ᾽ἐξῆρχον ἀοιδῆς	-uu- u u-u u- --u u--	dactylic hexameter	feminine penthemimeral, hepthemimeral, trithemimeral
Μοῦσαι Πιερίδες, λιγὺ μελπομένῃς ἐικυῖαι.	-- -uu- uu -uu- ---	dactylic hexameter	masculine penthemimeral
ἐν δὲ λιμὴν ἐύορμος ἀμαιμακέτοιο θαλάσσης	- u u- uu-u u-uu-u u--	dactylic hexameter	feminine penthemimeral, trithemimeral
κυκλοτερὴς ἐτέτυκτο πανέφθου κασσιτέροιο	-uu- uu-u u-- -uu--	dactylic hexameter	feminine penthemimeral, trithemimeral
κλυζομένῳ ἴκελος· πολλοί γε μὲν ἂμ μέσον αὐτοῦ	-uu- uu- -- u u - uu --	dactylic hexameter	masculine penthemimeral, hepthemimeral, trithemimeral
δελφῖνες τῇ καὶ τῇ ἐθύνεον ἰχθυάοντες	--- - - u u-uu -uu--	dactylic hexameter	masculine penthemimeral, trithemimeral
νηχομένοις ἴκελοι· δοιὼ δ᾽ἀναφυσιόωντες	-uu- uu- -- uu-uu--	dactylic hexameter	masculine penthemimeral, hepthemimeral, trithemimeral
ἀργύρεοι δελφῖνες ἐθοινῶντʼ ἔλλοπας ἰχθῦς.	-uu- --u u-- -uu --	dactylic hexameter	feminine penthemimeral, trithemimeral
τῶν δ᾽ὕπο χάλκειοι τρέον ἰχθύες· αὐτὰρ ἐπʼ ἀκταῖς	- uu --- uu -uu -u u --	dactylic hexameter	masculine penthemimeral
ἧστο ἀνὴρ ἁλιεὺς δεδοκημένος· εἶχε δὲ χερσὶν	-u u- uu- uu-uu -u u --	dactylic hexameter	masculine penthemimeral, trithemimeral
ἰχθύσιν ἀμφίβληστρον ἀπορρίψοντι ἐοικώς.	-uu ---u u---u u--	dactylic hexameter	feminine penthemimeral
ἐν δ᾽ἦν ἠυκόμου Δανάης τέκος, ἱππότα Περσεύς,	- - -uu- uu- uu -uu --	dactylic hexameter	masculine penthemimeral, hepthemimeral
οὔτʼ ἄρʼ ἐπιψαύων σάκεος ποσὶν οὔθʼ ἑκὰς αὐτοῦ,	- u u--- uu- uu - uu --	dactylic hexameter	masculine penthemimeral, hepthemimeral
θαῦμα μέγα φράσσασθʼ, ἐπεὶ οὐδαμῇ ἐστήρικτο.	-u u- -- uu -uu ----	dactylic hexameter	masculine penthemimeral, trithemimeral
τὼς γάρ μιν παλάμαις τεῦξεν κλυτὸς Ἀμφιγυήεις	- - - uu- -- uu -uu--	dactylic hexameter	masculine penthemimeral, hepthemimeral, trithemimeral
χρύσεον· ἀμφὶ δὲ ποσσὶν ἔχεν πτερόεντα πέδιλα.	-uu -u u -u u- uu-u u--	dactylic hexameter	feminine penthemimeral, hepthemimeral
ὤμοισιν δέ μιν ἀμφὶ μελάνδετον ἆορ ἔκειτο	--- u u -u u-uu -u u--	dactylic hexameter	feminine penthemimeral, trithemimeral
χαλκέου ἐκ τελαμῶνος· ὃ δ᾽ὥς τε νόημʼ ἐποτᾶτο·	-uu - uu-u u - u u- uu--	dactylic hexameter	feminine penthemimeral, hepthemimeral, trithemimeral
πᾶν δὲ μετάφρενον εἶχε κάρη δεινοῖο πελώρου,	- u u-uu -u u- --u u--	dactylic hexameter	feminine penthemimeral, hepthemimeral
Γοργοῦς· ἀμφὶ δέ μιν κίβισις θέε, θαῦμα ἰδέσθαι,	-- -u u - uu- uu -u u--	dactylic hexameter	masculine penthemimeral, hepthemimeral
ἀργυρέη· θύσανοι δὲ κατῃωρεῦντο φαεινοὶ	-uu- uu- u u---u u--	dactylic hexameter	masculine penthemimeral, trithemimeral
χρύσειοι· δεινὴ δὲ περὶ κροτάφοισιν ἄνακτος	--- -- u u- uu-u u--	dactylic hexameter	masculine penthemimeral, hepthemimeral, trithemimeral
κεῖτʼ Ἄιδος κυνέη νυκτὸς ζόφον αἰνὸν ἔχουσα.	- -- uu- -- uu -u u--	dactylic hexameter	masculine penthemimeral, hepthemimeral, trithemimeral
αὐτὸς δὲ σπεύδοντι καὶ ἐρρίγοντι ἐοικὼς	-- - --u u ---u u--	dactylic hexameter	feminine penthemimeral, trithemimeral
Περσεὺς Δαναΐδης ἐτιταίνετο. ταὶ δὲ μετʼ αὐτὸν	-- -uu- uu-uu - u u --	dactylic hexameter	masculine penthemimeral
Γοργόνες ἄπλητοί τε καὶ οὐ φαταὶ ἐρρώοντο	-uu --- u u - uu ----	dactylic hexameter	masculine penthemimeral, hepthemimeral
ἱέμεναι μαπέειν. ἐπὶ δὲ χλωροῦ ἀδάμαντος	-uu- uu- uu - -- uu--	dactylic hexameter	masculine penthemimeral, hepthemimeral, trithemimeral
βαινουσέων ἰάχεσκε σάκος μεγάλῳ ὀρυμαγδῷ	--- ---u u- uu- uu--	lyric	
ὀξέα καὶ λιγέως· ἐπὶ δὲ ζώνῃσι δράκοντε	-uu - uu- uu - --u u--	dactylic hexameter	masculine penthemimeral, hepthemimeral, trithemimeral
δοιὼ ἀπῃωρεῦντʼ ἐπικυρτώοντε κάρηνα.	-u u--- uu---u u--	dactylic hexameter	masculine penthemimeral
λίχμαζον δ᾽ἄρα τώ γε· μένει δ᾽ἐχάρασσον ὀδόντας	--- uu - u u- uu-u u--	dactylic hexameter	masculine penthemimeral, hepthemimeral, trithemimeral
ἄγρια δερκομένω. ἐπὶ δὲ δεινοῖσι καρήνοις	-uu -uu- uu - --u u--	dactylic hexameter	masculine penthemimeral, hepthemimeral
Γοργείοις ἐδονεῖτο μέγας Φόβος. οἳ δ᾽ὑπὲρ αὐτέων	--- uu-u u- uu - uu --	dactylic hexameter	feminine penthemimeral, hepthemimeral, trithemimeral
ἄνδρες ἐμαρνάσθην πολεμήια τεύχεʼ ἔχοντες,	-u u--- uu-uu -u u--	dactylic hexameter	masculine penthemimeral
τοὶ μὲν ὑπὲρ σφετέρης πόλιος σφετέρων τε τοκήων	- u u- uu- uu- uu- u u--	dactylic hexameter	masculine penthemimeral, hepthemimeral, trithemimeral
λοιγὸν ἀμύνοντες, τοὶ δὲ πραθέειν μεμαῶτες.	-u u--- - - uu- uu--	dactylic hexameter	masculine penthemimeral, hepthemimeral
πολλοὶ μὲν κέατο, πλέονες δ᾽ἔτι δῆριν ἔχοντες	-- - uu- uu- uu -u u--	dactylic hexameter	masculine penthemimeral, hepthemimeral, trithemimeral
μάρνανθʼ· αἱ δὲ γυναῖκες ἐυδμήτων ἐπὶ πύργων	-- - u u-u u--- uu --	dactylic hexameter	feminine penthemimeral, trithemimeral
χαλκέων ὀξὺ βόων, κατὰ δ᾽ἐδρύπτοντο παρειάς,	-- -u u- uu ---u u--	dactylic hexameter	masculine penthemimeral
ζωῇσιν ἴκελαι, ἔργα κλυτοῦ Ἡφαίστοιο.	--- uu- -- uu ----	dactylic hexameter	masculine penthemimeral, hepthemimeral, trithemimeral
ἄνδρες δ᾽,οἳ πρεσβῆες ἔσαν γῆράς τε μέμαρπεν,	-- - --u u- -- u u--	dactylic hexameter	feminine penthemimeral, hepthemimeral, trithemimeral
ἀθρόοι ἔκτοσθεν πυλέων ἔσαν, ἂν δὲ θεοῖσι	-uu --- uu- uu - u u--	dactylic hexameter	masculine penthemimeral, hepthemimeral
χεῖρας ἔχον μακάρεσσι, περὶ σφετέροισι τέκεσσι	-u u- uu-u u- uu-u u--	dactylic hexameter	feminine penthemimeral, hepthemimeral, trithemimeral
δειδιότες· τοὶ δ᾽αὖτε μάχην ἔχον. αἳ δὲ μετʼ αὐτοὺς	-uu- - -u u- uu - u u --	dactylic hexameter	feminine penthemimeral, hepthemimeral, trithemimeral
Κῆρες κυάνεαι, λευκοὺς ἀραβεῦσαι ὀδόντας,	-- -uu- -- uu-u u--	dactylic hexameter	masculine penthemimeral, hepthemimeral
δεινωπαὶ βλοσυραί τε δαφοιναί τ᾽ἄπληταί τε	--- uu- u u-- --- -	dactylic hexameter	masculine penthemimeral, trithemimeral
δῆριν ἔχον περὶ πιπτόντων· πᾶσαι δ᾽ἄρʼ ἵεντο	-u u- uu --- -- u u--	dactylic hexameter	hepthemimeral, trithemimeral
αἷμα μέλαν πιέειν· ὃν δὲ πρῶτον μεμάποιεν	-u u- uu- - - -- uu--	dactylic hexameter	masculine penthemimeral, hepthemimeral, trithemimeral
κείμενον ἢ πίπτοντα νεούτατον, ἀμφὶ μὲν αὐτῷ	-uu - --u u-uu -u u --	dactylic hexameter	feminine penthemimeral, trithemimeral
βάλλʼ ὄνυχας μεγάλους, ψυχὴ δ᾽Ἄιδόσδε κατῇεν	- uu- uu- -- --u u--	dactylic hexameter	masculine penthemimeral, hepthemimeral, trithemimeral
Τάρταρον ἐς κρυόενθʼ. αἳ δὲ φρένας εὖτʼ ἀρέσαντο	-uu - uu- - - uu - uu--	dactylic hexameter	masculine penthemimeral, hepthemimeral, trithemimeral
αἵματος ἀνδρομέου, τὸν μὲν ῥίπτασκον ὀπίσσω,	-uu -uu- - - --u u--	dactylic hexameter	masculine penthemimeral, hepthemimeral
ἂψ δ᾽ὅμαδον καὶ μῶλον ἐθύνεον αὖτις ἰοῦσαι.	- uu- - -u u-uu -u u--	dactylic hexameter	feminine penthemimeral, trithemimeral
Κλωθὼ καὶ Λάχεσίς σφιν ἐφέστασαν· ἣ μὲν ὑφήσσων	-- - uu- u u-uu - u u--	dactylic hexameter	masculine penthemimeral, trithemimeral
Ἀτροπος οὔ τι πέλεν μεγάλη θεός, ἀλλʼ ἄρα ἥ γε	-uu - u u- uu- uu - uu - -	dactylic hexameter	masculine penthemimeral, hepthemimeral, trithemimeral
τῶν γε μὲν ἀλλάων προφερής τ᾽ἦν πρεσβυτάτη τε.	- u u --- uu- - -uu- -	dactylic hexameter	masculine penthemimeral, hepthemimeral
πᾶσαι δ᾽ἀμφʼ ἑνὶ φωτὶ μάχην δριμεῖαν ἔθεντο.	-- - uu -u u- --u u--	dactylic hexameter	feminine penthemimeral, hepthemimeral, trithemimeral
δεινὰ δ᾽ἐς ἀλλήλας δράκον ὄμμασι θυμήνασαι,	-u u --- uu -uu ----	dactylic hexameter	masculine penthemimeral
ἐν δ᾽ὄνυχας χεῖράς τε θρασείας ἰσώσαντο	- uu- -- u u-- ----	dactylic hexameter	masculine penthemimeral, trithemimeral
πὰρ δ᾽Ἀχλὺς εἱστήκει ἐπισμυγερή τε καὶ αἰνή,	- -- --u u-uu- u u --	dactylic hexameter	feminine penthemimeral, trithemimeral
χλωρὴ ἀυσταλέη λιμῷ καταπεπτηυῖα,	-u u-uu- -- uu----	dactylic hexameter	masculine penthemimeral, hepthemimeral
γουνοπαχής, μακροὶ δ᾽ὄνυχες χείρεσσιν ὑπῆσαν.	-uu- -- uu- --u u--	dactylic hexameter	masculine penthemimeral, hepthemimeral, trithemimeral
τῆς ἐκ μὲν ῥινῶν μύξαι ῥέον, ἐκ δὲ παρειῶν	- - - -- -- uu - u u--	dactylic hexameter	masculine penthemimeral, hepthemimeral, trithemimeral
αἷμʼ ἀπελείβετʼ ἔραζʼ· ἣ δ᾽ἄπλητον σεσαρυῖα	- uu-u u- - --- uu--	dactylic hexameter	masculine penthemimeral
εἱστήκει, πολλὴ δὲ κόνις κατενήνοθεν ὤμους,	--- -- u u- uu-uu --	dactylic hexameter	masculine penthemimeral, hepthemimeral, trithemimeral
δάκρυσι μυδαλέη. παρὰ δ᾽εὔπυργος πόλις ἀνδρῶν·	-uu -uu- uu --- uu --	dactylic hexameter	masculine penthemimeral
χρύσειαι δέ μιν εἶχον ὑπερθυρίοις ἀραρυῖαι	--- u u -u u-uu- uu--	dactylic hexameter	feminine penthemimeral, trithemimeral
ἑπτὰ πύλαι· τοὶ δ᾽ἄνδρες ἐν ἀγλαΐῃς τε χοροῖς τε	-u u- - -u u -uu- u u- -	dactylic hexameter	feminine penthemimeral, trithemimeral
τέρψιν ἔχον· τοὶ μὲν γὰρ ἐυσσώτρου ἐπʼ ἀπήνης	-u u- - - u u--- u u--	dactylic hexameter	masculine penthemimeral, trithemimeral
ἤγοντʼ ἀνδρὶ γυναῖκα, πολὺς δ᾽ὑμέναιος ὀρώρει·	-- -u u-u u- uu-u u--	dactylic hexameter	feminine penthemimeral, hepthemimeral
τῆλε δ᾽ἀπʼ αἰθομένων δαΐδων σέλας εἰλύφαζε	-u u -uu- uu- uu ----	dactylic hexameter	masculine penthemimeral, hepthemimeral
χερσὶν ἔνι δμῳῶν· ταὶ δ᾽ἀγλαΐῃ τεθαλυῖαι	-u u- -- - ---- uu--	lyric	
πρόσθʼ ἔκιον· τῇσιν δὲ χοροὶ παίζοντες ἕποντο.	- uu- -- u u- --u u--	dactylic hexameter	masculine penthemimeral, hepthemimeral, trithemimeral
τοὶ μὲν ὑπὸ λιγυρῶν συρίγγων ἵεσαν αὐδὴν	- u u- uu- --- -uu --	dactylic hexameter	masculine penthemimeral, trithemimeral
ἐξ ἁπαλῶν στομάτων, περὶ δέ σφισιν ἄγνυτο ἠχώ.	- uu- uu- uu - uu -uu --	dactylic hexameter	masculine penthemimeral, hepthemimeral, trithemimeral
αἳ δ᾽ὑπὸ φορμίγγων ἄναγον χορὸν ἱμερόεντα.	- uu --- uu- uu -uu--	dactylic hexameter	masculine penthemimeral, hepthemimeral
ἔνθεν δ᾽αὖθʼ ἑτέρωθε νέοι κώμαζον ὑπʼ αὐλοῦ,	-- - uu-u u- --u u --	dactylic hexameter	feminine penthemimeral, hepthemimeral, trithemimeral
τοί γε μὲν αὖ παίζοντες ὑπʼ ὀρχηθμῷ καὶ ἀοιδῇ	- u u - --u u --- u u--	dactylic hexameter	feminine penthemimeral, trithemimeral
τοί γε μὲν αὖ γελόωντες ὑπʼ αὐλητῆρι ἕκαστος	- u u - uu-u u ---u u--	dactylic hexameter	feminine penthemimeral, trithemimeral
πρόσθʼ ἔκιον· πᾶσαν δὲ πόλιν θαλίαι τε χοροί τε	- uu- -- u u- uu- u u- -	dactylic hexameter	masculine penthemimeral, hepthemimeral, trithemimeral
ἀγλαΐαι τ᾽εἶχον. τοὶ δ᾽αὖ προπάροιθε πόληος	-uu- -- - - uu-u u--	dactylic hexameter	masculine penthemimeral, hepthemimeral, trithemimeral
νῶθʼ ἵππων ἐπιβάντες ἐθύνεον. οἱ δ᾽ἀροτῆρες	- -- uu-u u-uu - uu--	dactylic hexameter	feminine penthemimeral, trithemimeral
ἤρεικον χθόνα δῖαν, ἐπιστολάδην δὲ χιτῶνας	--- uu -u u-uu- u u--	dactylic hexameter	feminine penthemimeral, trithemimeral
ἐστάλατʼ. αὐτὰρ ἔην βαθὺ λήιον· οἵ γε μὲν ἤμων	-uu -u u- uu -uu - u u --	dactylic hexameter	masculine penthemimeral
αἰχμῇς ὀξείῃσι κορωνιόωντα πέτηλα,	-- ---u u-uu-u u--	dactylic hexameter	feminine penthemimeral
βριθόμενα σταχύων, ὡς εἰ Δημήτερος ἀκτήν·	-uu- uu- - - --uu --	dactylic hexameter	masculine penthemimeral, hepthemimeral, trithemimeral
οἳ δ᾽ἄρʼ ἐν ἐλλεδανοῖσι δέον καὶ ἔπιτνον ἀλωήν,	- u u -uu-u u- u u-u u--	dactylic hexameter	feminine penthemimeral, hepthemimeral
οἳ δ᾽ἐτρύγων οἴνας δρεπάνας ἐν χερσὶν ἔχοντες,	- uu- -- -uu - -- ---	lyric	
οἳ δ᾽αὖτʼ ἐς ταλάρους ἐφόρευν ὑπὸ τρυγητήρων	- - - uu- uu- uu ----	dactylic hexameter	masculine penthemimeral, hepthemimeral, trithemimeral
λευκοὺς καὶ μέλανας βότρυας μεγάλων ἀπὸ ὄρχων,	-- - uu- uu- uu- uu --	dactylic hexameter	masculine penthemimeral, hepthemimeral, trithemimeral
βριθομένων φύλλοισι καὶ ἀργυρέῃς ἑλίκεσσιν.	-uu- --u u -uu- uu--	dactylic hexameter	feminine penthemimeral, trithemimeral
οἳ δ᾽αὖτʼ ἐς ταλάρους ἐφόρευν. παρὰ δέ σφισιν ὄρχος	- - - uu- uu- uu - uu --	dactylic hexameter	masculine penthemimeral, hepthemimeral, trithemimeral
χρύσεος ἦν, κλυτὰ ἔργα περίφρονος Ἡφαίστοιο,	-uu - uu -u u-uu ----	dactylic hexameter	feminine penthemimeral, trithemimeral
σειόμενος φύλλοισι καὶ ἀργυρέῃσι κάμαξι,	-uu- --u u -uu-u u--	dactylic hexameter	feminine penthemimeral, trithemimeral
βριθόμενος σταφυλῇσι· μελάνθησάν γε μὲν αἵδε.	-uu- uu-u u--- u u --	dactylic hexameter	feminine penthemimeral, trithemimeral
οἵ γε μὲν ἐτράπεον, τοὶ δ᾽ἤρυον· οἳ δ᾽ἐμάχοντο	- u u -uu- - -uu - uu--	dactylic hexameter	masculine penthemimeral
πύξ τε καὶ ἑλκηδόν· τοὶ δ᾽ὠκύποδας λαγὸς ᾕρευν	- u u --- - -uu- uu --	dactylic hexameter	masculine penthemimeral
ἄνδρες θηρευταί, καὶ καρχαρόδοντε κύνε πρό,	-- --- - -uu-u u- -	dactylic hexameter	masculine penthemimeral
ἱέμενοι μαπέειν, οἳ δ᾽ἱέμενοι ὑπαλύξαι.	-uu- uu- - -uu- uu--	dactylic hexameter	masculine penthemimeral, trithemimeral
πὰρ δ᾽αὐτοῖς ἱππῆες ἔχον πόνον, ἀμφὶ δ᾽ἀέθλῳ	- -- --u u- uu -u u--	dactylic hexameter	feminine penthemimeral, hepthemimeral, trithemimeral
δῆριν ἔχον καὶ μόχθον. ἐυπλεκέων δ᾽ἐπὶ δίφρων	-u u- - -u u-uu- uu --	dactylic hexameter	feminine penthemimeral, trithemimeral
ἡνίοχοι βεβαῶτες ἐφίεσαν ὠκέας ἵππους	-uu- uu-u u-uu -uu --	dactylic hexameter	feminine penthemimeral, trithemimeral
ῥυτὰ χαλαίνοντες, τὰ δ᾽ἐπικροτέοντα πέτοντο	-u u--- u u-uu-u u--	dactylic hexameter	masculine penthemimeral
ἅρματα κολλήεντʼ, ἐπὶ δὲ πλῆμναι μέγʼ ἀύτευν.	-uu --- uu - -- - --	dactylic hexameter	masculine penthemimeral, hepthemimeral
οἳ μὲν ἄρʼ ἀίδιον εἶχον πόνον οὐδέ ποτέ σφιν	- u u -uu- -- uu -u u- -	dactylic hexameter	masculine penthemimeral, hepthemimeral
νίκη ἐπηνύσθη, ἀλλʼ ἄκριτον εἶχον ἄεθλον.	-u u--- - -uu -u u--	dactylic hexameter	masculine penthemimeral
τοῖσιν δὲ προέκειτο μέγας τρίπος ἐντὸς ἀγῶνος,	-- - uu-u u- uu -u u--	dactylic hexameter	feminine penthemimeral, hepthemimeral, trithemimeral
χρύσειος, κλυτὰ ἔργα περίφρονος Ἡφαίστοιο.	--- uu -u u-uu ----	dactylic hexameter	feminine penthemimeral, trithemimeral
ἀμφὶ δ᾽ἴτυν ῥέεν Ὠκεανὸς πλήθοντι ἐοικώς,	-u u- uu -uu- --u u--	dactylic hexameter	hepthemimeral, trithemimeral
πᾶν δὲ συνεῖχε σάκος πολυδαίδαλον, οἳ δὲ κατʼ αὐτὸν	- u u-u u- uu-uu - u u --	dactylic hexameter	masculine penthemimeral
κύκνοι ἀερσιπόται μεγάλʼ ἤπυον, οἵ ῥά τε πολλοὶ	-u u-uu- uu -uu - u u --	dactylic hexameter	masculine penthemimeral
νῆχον ἐπʼ ἄκρον ὕδωρ· παρὰ δ᾽ἰχθύες ἐκλονέοντο.	-u u -u u- uu -uu -uu--	dactylic hexameter	masculine penthemimeral
θαῦμα ἰδεῖν καὶ Ζηνὶ βαρυκτύπῳ, οὗ διὰ βουλὰς	-u u- - -u u-uu - uu --	dactylic hexameter	feminine penthemimeral, trithemimeral
Ἥφαιστος ποίησε σάκος μέγα τε στιβαρόν τε,	--- --u u- uu - uu- -	dactylic hexameter	feminine penthemimeral, hepthemimeral, trithemimeral
ἀρσάμενος παλάμῃσι. τὸ μὲν Διὸς ἄλκιμος υἱὸς	-uu- uu-u u - uu -uu --	dactylic hexameter	feminine penthemimeral, hepthemimeral, trithemimeral
πάλλεν ἐπικρατέως· ἐπὶ δ᾽ἱππείου θόρε δίφρου,	-u u-uu- uu --- uu --	dactylic hexameter	masculine penthemimeral
εἴκελος ἀστεροπῇ πατρὸς Διὸς αἰγιόχοιο,	-uu -uu- -- uu -uu--	dactylic hexameter	masculine penthemimeral, hepthemimeral
κοῦφα βιβάς· τῷ δ᾽ἡνίοχος κρατερὸς Ἰόλαος	-u u- - -uu- uu- uu--	dactylic hexameter	hepthemimeral, trithemimeral
δίφρου ἐπεμβεβαὼς ἰθύνετο καμπύλον ἅρμα.	-u u-uu- uu-- -uu --	dactylic hexameter	masculine penthemimeral
ἀγχίμολον δέ σφʼ ἦλθε θεὰ γλαυκῶπις Ἀθήνη,	-uu- - -u u- --u u--	dactylic hexameter	feminine penthemimeral, hepthemimeral, trithemimeral
καί σφεας θαρσύνουσ᾽ ἔπεα πτερόεντα προσηύδα·	- - --- uu- uu-u u--	dactylic hexameter	masculine penthemimeral, hepthemimeral
χαίρετε, Λυγκῆος γενεὴ τηλεκλειτοῖο·	-uu --- uu- -----	dactylic hexameter	masculine penthemimeral, hepthemimeral
νῦν δὴ Ζεὺς κράτος ὔμμι διδοῖ μακάρεσσιν ἀνάσσων	- - - uu -u u- uu-u u--	dactylic hexameter	feminine penthemimeral, hepthemimeral, trithemimeral
Κύκνον τ᾽ἐξεναρεῖν καὶ ἀπὸ κλυτὰ τεύχεα δῦσαι.	-- -uu- u u- uu -uu --	dactylic hexameter	masculine penthemimeral, hepthemimeral
ἄλλο δὲ τοί τι ἔπος ἐρέω, μέγα φέρτατε λαῶν·	-u u - u u- uu- uu -uu --	dactylic hexameter	masculine penthemimeral, hepthemimeral, trithemimeral
εὖτʼ ἂν δὴ Κύκνον γλυκερῆς αἰῶνος ἀμέρσῃς,	- - - -- uu- --u u--	dactylic hexameter	masculine penthemimeral, hepthemimeral, trithemimeral
τὸν μὲν ἔπειτʼ αὐτοῦ λιπέειν καὶ τεύχεα τοῖο,	- u u- -- uu- - -uu --	dactylic hexameter	masculine penthemimeral, hepthemimeral, trithemimeral
αὐτὸς δὲ βροτολοιγὸν Ἄρην ἐπιόντα δοκεύσας,	-- - uu-u u- uu-u u--	dactylic hexameter	feminine penthemimeral, hepthemimeral, trithemimeral
ἔνθα κε γυμνωθέντα σάκευς ὕπο δαιδαλέοιο	-u u ---u u- uu -uu--	dactylic hexameter	feminine penthemimeral, hepthemimeral
ὀφθαλμοῖσιν ἴδῃς, ἔνθʼ οὐτάμεν ὀξέι χαλκῷ·	---u u- - -uu -uu --	dactylic hexameter	masculine penthemimeral
ἂψ δ᾽ἀναχάσσασθαι· ἐπεὶ οὔ νύ τοι αἴσιμόν ἐστιν	- uu--- uu - u u -uu --	dactylic hexameter	masculine penthemimeral, hepthemimeral
οὔθʼ ἵππους ἑλέειν οὔτε κλυτὰ τεύχεα τοῖο.	- -- uu- -- uu -uu --	dactylic hexameter	masculine penthemimeral, hepthemimeral, trithemimeral
ὣς εἰποῦσʼ ἐς δίφρον ἐβήσατο δῖα θεάων,	- -- - -u u-uu -u u--	dactylic hexameter	feminine penthemimeral, trithemimeral
νίκην ἀθανάτῃς χερσὶν καὶ κῦδος ἔχουσα,	-- -uu- -- - -u u--	dactylic hexameter	masculine penthemimeral, hepthemimeral
ἐσσυμένως. τότε δή ῥα διόγνητος Ἰόλαος	-uu- uu - u u--- uu--	dactylic hexameter	masculine penthemimeral, trithemimeral
σμερδαλέον ἵπποισιν ἐκέκλετο· τοὶ δ᾽ὑπʼ ὀμοκλῆς	-uu- --u u-uu - u u--	dactylic hexameter	feminine penthemimeral, trithemimeral
ῥίμφʼ ἔφερον θοὸν ἅρμα κονίοντες πεδίοιο.	- uu- uu -u u--- uu--	dactylic hexameter	feminine penthemimeral, trithemimeral
ἐν γάρ σφιν μένος ἧκε θεὰ γλαυκῶπις Ἀθήνη	- - - uu -u u- --u u--	dactylic hexameter	feminine penthemimeral, hepthemimeral, trithemimeral
αἰγίδʼ ἀνασσείσασα· περιστονάχησε δὲ γαῖα.	-u u---u u-uu-u u --	dactylic hexameter	feminine penthemimeral
τοὶ δ᾽ἄμυδις προγένοντʼ ἴκελοι πυρὶ ἠὲ θυέλλῃ,	- uu- uu- uu- uu -u u--	dactylic hexameter	masculine penthemimeral, hepthemimeral, trithemimeral
Κύκνος θ᾽ἱππόδαμος καὶ Ἄρης ἀκόρητος ἀυτῆς.	-- -uu- u u- uu-u u--	dactylic hexameter	masculine penthemimeral, hepthemimeral
τῶν ἵπποι μὲν ἔπειθʼ ὑπεναντίοι ἀλλήλοισιν	- -- u u- uu-uu ----	dactylic hexameter	masculine penthemimeral, trithemimeral
ὀξεῖα χρέμισαν, περὶ δέ σφισιν ἄγνυτο ἠχώ.	--- uu- uu - uu -uu --	dactylic hexameter	masculine penthemimeral, hepthemimeral, trithemimeral
τὸν πρότερος προσέειπε βίη Ἡρακληείη·	- uu- uu-u u- -----	dactylic hexameter	feminine penthemimeral, hepthemimeral, trithemimeral
κύκνε πέπον, τί νυ νῶιν ἐπίσχετον ὠκέας ἵππους	-u u- u u -u u-uu -uu --	dactylic hexameter	feminine penthemimeral, trithemimeral
ἀνδράσιν, οἵ τε πόνου καὶ ὀιζύος ἴδριές εἰμεν;	-uu - u u- - -uu -uu --	dactylic hexameter	masculine penthemimeral, trithemimeral
ἀλλὰ παρὲξ ἔχε δίφρον ἐύξοον ἠδὲ κελεύθου	-u u- uu -u u-uu -u u--	dactylic hexameter	feminine penthemimeral, trithemimeral
εἶκε παρὲξ ἰέναι. Τρηχῖνα δέ τοι παρελαύνω	-u u- uu- --u u - uu--	dactylic hexameter	masculine penthemimeral, trithemimeral
ἐς Κήυκα ἄνακτα· ὃ γὰρ δυνάμι τε καὶ αἰδοῖ	- -- --u u - uu- u u --	dactylic hexameter	feminine penthemimeral, hepthemimeral, trithemimeral
Τρηχῖνος προβέβηκε, σὺ δ᾽εὖ μάλα οἶσθα καὶ αὐτός·	--- uu-u u - uu -u u --	dactylic hexameter	feminine penthemimeral, hepthemimeral, trithemimeral
τοῦ γὰρ ὀπυίεις παῖδα Θεμιστονόην κυανῶπιν.	- u u-- -u u-uu- uu--	dactylic hexameter	feminine penthemimeral
ὦ πέπον, οὐ μὲν γὰρ τοι Ἄρης θανάτοιο τελευτὴν	- uu - - - u u- uu-u u--	dactylic hexameter	masculine penthemimeral, hepthemimeral, trithemimeral
ἀρκέσει, εἰ δὴ νῶι συνοισόμεθα πτολεμίζειν.	-uu - - -u u-uu- uu--	dactylic hexameter	feminine penthemimeral, trithemimeral
ἤδη μέν τέ ἕ φημι καὶ ἄλλοτε πειρηθῆναι	-- - u u -u u -uu ----	dactylic hexameter	feminine penthemimeral, trithemimeral
ἔγχεος ἡμετέρου, ὅθʼ ὑπὲρ Πύλου ἠμαθόεντος	-uu -uu- u u- uu -uu--	dactylic hexameter	masculine penthemimeral, hepthemimeral
ἀντίος ἔστη ἐμεῖο, μάχης ἄμοτον μενεαίνων.	-uu -u u-u u- uu- uu--	dactylic hexameter	feminine penthemimeral, hepthemimeral
τρὶς μὲν ἐμῷ ὑπὸ δουρὶ τυπεὶς ἠρείσατο γαίῃ	- u u- uu -u u- --uu --	dactylic hexameter	feminine penthemimeral, hepthemimeral, trithemimeral
οὐταμένου σάκεος, τὸ δὲ τέτρατον ἤλασα μηρὸν	-uu- uu- u u -uu -uu --	dactylic hexameter	masculine penthemimeral, trithemimeral
παντὶ μένει σπεύδων, διὰ δὲ μέγα σαρκὸς ἄραξα.	-u u- -- uu - uu -u u--	dactylic hexameter	masculine penthemimeral, hepthemimeral, trithemimeral
πρηνὴς δ᾽ἐν κονίῃσι χαμαὶ πέσεν ἔγχεος ὁρμῇ.	-- - uu-u u- uu -uu --	dactylic hexameter	feminine penthemimeral, hepthemimeral, trithemimeral
ἔνθα κε δὴ λωβητὸς ἐν ἀθανάτοισιν ἐτύχθη	-u u - --u u -uu-u u--	dactylic hexameter	feminine penthemimeral, trithemimeral
χερσὶν ὕφʼ ἡμετέρῃσι λιπὼν ἔναρα βροτόεντα.	-u u -uu-u u- uu- uu--	dactylic hexameter	feminine penthemimeral, hepthemimeral
ὣς ἔφατʼ· οὐδʼ ἄρα Κύκνος ἐυμμελίης ἐμενοίνα	- uu - uu -u u-uu- uu--	dactylic hexameter	feminine penthemimeral, trithemimeral
τῷ ἐπιπειθόμενος ἐχέμεν ἐρυσάρματας ἵππους.	- uu-uu- uu- uu-uu --	dactylic hexameter	masculine penthemimeral, hepthemimeral
δὴ τότʼ ἀπʼ εὐπλεκέων δίφρων θόρον αἶψʼ ἐπὶ γαῖαν	- u u -uu- -- uu - uu --	dactylic hexameter	masculine penthemimeral, hepthemimeral
παῖς τε Διὸς μεγάλου καὶ Ἐνυαλίοιο ἄνακτος.	- u u- uu- u u-uu-u u--	dactylic hexameter	masculine penthemimeral, trithemimeral
ἡνίοχοι δ᾽ἔμπλην ἔλασαν καλλίτριχας ἵππους·	-uu- -- uu- --uu --	dactylic hexameter	masculine penthemimeral, hepthemimeral, trithemimeral
τῶν δ᾽ὕπο σευομένων κανάχιζε πόσʼ εὐρεῖα χθών.	- uu -uu- uu-u u --- -	dactylic hexameter	masculine penthemimeral
ὡς δ᾽ὅτʼ ἀφʼ ὑψηλῆς κορυφῆς ὄρεος μεγάλοιο	- u u --- uu- uu- uu--	dactylic hexameter	masculine penthemimeral, hepthemimeral
πέτραι ἀποθρῴσκωσιν, ἐπʼ ἀλλήλῃς δὲ πέσωσι,	-u u---u u --- u u--	dactylic hexameter	feminine penthemimeral
πολλαὶ δὲ δρῦς ὑψίκομοι, πολλαὶ δὲ τε πεῦκαι	-- - - -uu- -- u u --	dactylic hexameter	hepthemimeral, trithemimeral
αἴγειροί τε τανύρριζοι ῥήγνυνται ὑπʼ αὐτέων	--- u u--- --u u --	dactylic hexameter	hepthemimeral, trithemimeral
ῥίμφα κυλινδομένων, εἵως πεδίονδʼ ἀφίκωνται,	-u u-uu- -- uu- uu--	dactylic hexameter	masculine penthemimeral, hepthemimeral
ὣς οἳ ἐπʼ ἀλλήλοισι πέσον μέγα κεκλήγοντες.	- u u ---u u- uu ----	dactylic hexameter	feminine penthemimeral, hepthemimeral
πᾶσα δὲ Μυρμιδόνων τε πόλις κλειτή τ᾽Ἰαωλκὸς	-u u -uu- u u- -- uu--	dactylic hexameter	masculine penthemimeral, hepthemimeral
Ἄρνη τ᾽ἠδʼ Ἑλίκη Ἄνθειά τε ποιήεσσα	-- - uu- --u u ----	dactylic hexameter	masculine penthemimeral, trithemimeral
φωνῇ ὕπʼ ἀμφοτέρων μεγάλʼ ἴαχον· οἳ δ᾽ἀλαλητῷ	-u u -uu- uu -uu - uu--	dactylic hexameter	masculine penthemimeral
θεσπεσίῳ σύνισαν· μέγα δ᾽ἔκτυπε μητίετα Ζεύς.	-uu- uu- uu -uu -uu- -	dactylic hexameter	masculine penthemimeral, trithemimeral
κὰδ δ᾽ἄρʼ ἀπʼ οὐρανόθεν ψιάδας βάλεν αἱματοέσσας,	- u u -uu- uu- uu -uu--	dactylic hexameter	masculine penthemimeral, hepthemimeral
σῆμα τιθεὶς πολέμοιο ἑῷ μεγαθαρσέι παιδί.	-u u- uu-u u- uu-uu --	dactylic hexameter	feminine penthemimeral, hepthemimeral, trithemimeral
οἷος δ᾽ἐν βήσσῃς ὄρεος χαλεπὸς προϊδέσθαι	-- - -- uu- uu- uu--	dactylic hexameter	masculine penthemimeral, hepthemimeral, trithemimeral
κάπρος χαυλιόδων φρονέει θυμῷ μαχέσασθαι	-- -uu- uu- -- uu--	dactylic hexameter	masculine penthemimeral, hepthemimeral
ἀνδράσι θηρευτῇς, θήγει δέ τε λευκὸν ὀδόντα	-uu --- -- u u -u u--	dactylic hexameter	masculine penthemimeral, hepthemimeral
δοχμωθείς, ἀφρὸς δὲ περὶ στόμα μαστιχόωντι	--- -- u u- uu -uu--	dactylic hexameter	masculine penthemimeral, hepthemimeral, trithemimeral
λείβεται, ὄσσε δέ οἱ πυρὶ λαμπετόωντι ἔικτον,	-uu -u u - uu -uu-- --	dactylic hexameter	masculine penthemimeral
ὀρθὰς δ᾽ἐν λοφιῇ φρίσσει τρίχας ἀμφί τε δειρήν·	-- - uu- -- uu -u u --	dactylic hexameter	masculine penthemimeral, hepthemimeral, trithemimeral
τῷ ἴκελος Διὸς υἱὸς ἀφʼ ἱππείου θόρε δίφρου.	- uu- uu -u u --- uu --	dactylic hexameter	feminine penthemimeral, trithemimeral
ἦμος δὲ χλοερῷ κυανόπτερος ἠχέτα τέττιξ	-- - uu- uu-uu -uu --	dactylic hexameter	masculine penthemimeral, trithemimeral
ὄζῳ ἐφεζόμενος θέρος ἀνθρώποισιν ἀείδειν	-u u-uu- uu ---u u--	dactylic hexameter	masculine penthemimeral
ἄρχεται, ᾧ τε πόσις καὶ βρῶσις θῆλυς ἐέρση,	-uu - u u- - -- -u u--	dactylic hexameter	masculine penthemimeral, trithemimeral
καί τε πανημέριός τε καὶ ἠώιος χέει αὐδὴν	- u u-uu- u u --- uu --	dactylic hexameter	masculine penthemimeral
ἴδει ἐν αἰνοτάτῳ, ὅτε τε χρόα Σείριος ἄζει,	-u u -uu- uu - uu -uu --	dactylic hexameter	masculine penthemimeral, hepthemimeral
τῆμος δὴ κέγχροισι πέρι γλῶχες τελέθουσι	-- - --u u- -- uu--	dactylic hexameter	feminine penthemimeral, hepthemimeral, trithemimeral
τούς τε θέρει σπείρουσιν, ὅτʼ ὄμφακες αἰόλλονται,	- u u- --u u -uu ----	dactylic hexameter	feminine penthemimeral, trithemimeral
οἷα Διώνυσος δῶκʼ ἀνδράσι χάρμα καὶ ἄχθος·	-u u--- - -uu -u u --	dactylic hexameter	masculine penthemimeral
τὴν ὥρην μάρναντο, πολὺς δ᾽ὀρυμαγδὸς ὀρώρει.	- -- --u u- uu-u u--	dactylic hexameter	feminine penthemimeral, hepthemimeral, trithemimeral
ὡς δὲ λέοντε δύω ἀμφὶ κταμένης ἐλάφοιο	- u u-u u- -- uu- uu--	dactylic hexameter	masculine penthemimeral, hepthemimeral
ἀλλήλοις κοτέοντες ἐπὶ σφέας ὁρμήσωσι,	--- uu-u u- uu ----	dactylic hexameter	feminine penthemimeral, hepthemimeral, trithemimeral
δεινὴ δέ σφʼ ἰαχὴ ἄραβός θ᾽ἅμα γίγνετʼ ὀδόντων·	-- - uu- --- uu -u u--	lyric	
οἳ δ᾽ὥς τ᾽αἰγυπιοὶ γαμψώνυχες, ἀγκυλοχεῖλαι,	- - -uu- --uu -uu--	dactylic hexameter	masculine penthemimeral
πέτρῃ ἔφʼ ὑψηλῇ μεγάλα κλάζοντε μάχονται	-u u --- uu- --u u--	dactylic hexameter	masculine penthemimeral, hepthemimeral
αἰγὸς ὀρεσσινόμου ἢ ἀγροτέρης ἐλάφοιο	-u u-uu- - -uu- uu--	dactylic hexameter	masculine penthemimeral
πίονος, ἥν τ᾽ἐδάμασσε βαλὼν αἰζήιος ἀνὴρ	-uu - uu-u u- --uu --	dactylic hexameter	feminine penthemimeral, hepthemimeral, trithemimeral
ἰῷ ἀπὸ νευρῆς, αὐτὸς δ᾽ἀπαλήσεται ἄλλῃ	-u u- -- -- uu-uu --	dactylic hexameter	masculine penthemimeral, hepthemimeral, trithemimeral
χώρου ἄιδρις ἐών· οἳ δ᾽ὀτραλέως ἐνόησαν,	-u u-u u- - -uu- uu--	dactylic hexameter	masculine penthemimeral
ἐσσυμένως δέ οἱ ἀμφὶ μάχην δριμεῖαν ἔθεντο·	-uu- u u -u u- --u u--	dactylic hexameter	feminine penthemimeral, hepthemimeral, trithemimeral
ὣς οἳ κεκλήγοντες ἐπʼ ἀλλήλοισιν ὄρουσαν.	- - ---u u ---u u--	dactylic hexameter	feminine penthemimeral
ἔνθʼ ἦ τοι Κύκνος μὲν ὑπερμενέος Διὸς υἱὸν	- - - -- u u-uu- uu --	dactylic hexameter	masculine penthemimeral, trithemimeral
κτεινέμεναι μεμαὼς σάκει ἔμβαλε χάλκεον ἔγχος,	-uu- uu- uu -uu -uu --	dactylic hexameter	masculine penthemimeral, trithemimeral
οὐδʼ ἔρρηξεν χαλκόν· ἔρυτο δὲ δῶρα θεοῖο.	- --- -u u-u u -u u--	dactylic hexameter	feminine penthemimeral
Ἀμφιτρυωνιάδης δέ, βίη Ἡρακληείη,	-uu-uu- u u- -----	dactylic hexameter	masculine penthemimeral, hepthemimeral
μεσσηγὺς κόρυθός τε καὶ ἀσπίδος ἔγχεϊ μακρῷ	--- uu- u u -uu -uu --	dactylic hexameter	masculine penthemimeral, trithemimeral
αὐχένα γυμνωθέντα θοῶς ὑπένερθε γενείου	-uu ---u u- uu-u u--	dactylic hexameter	feminine penthemimeral, hepthemimeral
ἤλασʼ ἐπικρατέως· ἀπὸ δ᾽ἄμφω κέρσε τένοντε	-u u-uu- uu -- -u u--	dactylic hexameter	masculine penthemimeral
ἀνδροφόνος μελίη· μέγα γὰρ σθένος ἔμπεσε φωτός.	-uu- uu- uu - uu -uu --	dactylic hexameter	masculine penthemimeral, hepthemimeral, trithemimeral
ἤριπε δ᾽,ὡς ὅτε τις δρῦς ἤριπεν ἢ ὅτε πεύκη	-uu - uu - - -uu - uu --	dactylic hexameter	masculine penthemimeral, trithemimeral
ἠλίβατος, πληγεῖσα Διὸς ψολόεντι κεραυνῷ·	-uu- --u u- uu-u u--	dactylic hexameter	feminine penthemimeral, hepthemimeral, trithemimeral
ὣς ἔριπʼ· ἀμφὶ δέ οἱ βράχε τεύχεα ποικίλα χαλκῷ.	- uu -u u - uu -uu -uu --	dactylic hexameter	masculine penthemimeral
τὸν μὲν ἔπειτʼ εἴασε Διὸς ταλακάρδιος υἱός,	- u u- --u u- uu-uu --	dactylic hexameter	feminine penthemimeral, hepthemimeral, trithemimeral
αὐτὸς δὲ βροτολοιγὸν Ἄρην προσιόντα δοκεύσας,	-- - uu-u u- uu-u u--	dactylic hexameter	feminine penthemimeral, hepthemimeral, trithemimeral
δεινὸν ὁρῶν ὄσσοισι, λέων ὣς σώματι κύρσας,	-u u- --u u- - -uu --	dactylic hexameter	feminine penthemimeral, hepthemimeral, trithemimeral
ὅς τε μάλʼ ἐνδυκέως ῥινὸν κρατεροῖς ὀνύχεσσι	- u u -uu- -- uu- uu--	dactylic hexameter	masculine penthemimeral, hepthemimeral
σχίσσας ὅττι τάχιστα μελίφρονα θυμὸν ἀπηύρα·	-- -u u-u u-uu -u u--	dactylic hexameter	feminine penthemimeral
ἐμ μένεος δ᾽ἄρα τοῦ γε κελαινὸν πίμπλαται ἦτορ·	- uu- uu - u u-- -uu --	dactylic hexameter	masculine penthemimeral, trithemimeral
γλαυκιόων δ᾽ὄσσοις δεινὸν πλευράς τε καὶ ὤμους	-uu- -- -- -- u u --	dactylic hexameter	masculine penthemimeral, hepthemimeral, trithemimeral
οὐρῇ μαστιόων ποσσὶν γλάφει, οὐδέ τις αὐτὸν	-- -uu- -- uu -u u --	dactylic hexameter	masculine penthemimeral, hepthemimeral
ἔτλη ἐς ἄντα ἰδὼν σχεδὸν ἐλθέμεν οὐδὲ μάχεσθαι·	-u u -u u- uu -uu -u u--	dactylic hexameter	masculine penthemimeral
τοῖος ἄρʼ Ἀμφιτρυωνιάδης, ἀκόρητος ἀυτῆς,	-u u -uu-uu- uu-u u--	dactylic hexameter	hepthemimeral
ἀντίος ἔστη Ἄρηος, ἐνὶ φρεσὶ θάρσος ἀέξων,	-uu -u u-u u- uu -u u--	dactylic hexameter	feminine penthemimeral, hepthemimeral
ἐσσυμένως· ὃ δέ οἱ σχεδὸν ἤλυθεν ἀχνύμενος κῆρ·	-uu- u u - uu -uu -uu- -	dactylic hexameter	masculine penthemimeral, trithemimeral
ἀμφότεροι δ᾽ἰάχοντες ἐπʼ ἀλλήλοισιν ὄρουσαν.	-uu- uu-u u ---u u--	dactylic hexameter	feminine penthemimeral, trithemimeral
ὡς δ᾽ὅτʼ ἀπὸ μεγάλου πέτρη πρηῶνος ὀρούσῃ,	- u u- uu- -- --u u--	dactylic hexameter	masculine penthemimeral, hepthemimeral, trithemimeral
μακρὰ δ᾽ἐπιθρῴσκουσα κυλίνδεται, ἣ δέ τε ἠχῇ	-u u---u u-uu - u u --	dactylic hexameter	feminine penthemimeral
ἔρχεται ἐμμεμαυῖα, πάγος δέ οἱ ἀντεβόλησεν	-uu -uu-u u- u u -uu--	dactylic hexameter	feminine penthemimeral, hepthemimeral
ὑψηλός· τῷ δὴ συνενείκεται, ἔνθα μιν ἴσχει·	--- - - uu-uu -u u --	dactylic hexameter	masculine penthemimeral, trithemimeral
τόσσῃ ὃ μὲν ἰαχῇ βρισάρματος οὔλιος Ἄρης	-u u - uu- --uu -uu --	dactylic hexameter	masculine penthemimeral, trithemimeral
κεκληγὼς ἐπόρουσεν· ὃ δ᾽ἐμμαπέως ὑπέδεκτο.	--- uu-u u -uu- uu--	dactylic hexameter	feminine penthemimeral, trithemimeral
αὐτὰρ Ἀθηναίη, κούρη Διὸς αἰγιόχοιο,	-u u--- -- uu -uu--	dactylic hexameter	masculine penthemimeral, hepthemimeral
ἀντίη ἦλθεν Ἄρηος ἐρεμνὴν αἰγίδʼ ἔχουσα·	-uu -u u-u u-- -u u--	dactylic hexameter	feminine penthemimeral
δεινὰ δ᾽ὑπόδρα ἰδοῦσ᾽ ἔπεα πτερόεντα προσηύδα·	-u u-u u- uu- ---u u--	lyric	
Ἆρες, ἔπισχε μένος κρατερὸν καὶ χεῖρας ἀάπτους·	-u u-u u- uu- - -u u--	dactylic hexameter	masculine penthemimeral, hepthemimeral
οὐ γάρ τοι θέμις ἐστὶν ἀπὸ κλυτὰ τεύχεα δῦσαι	- - - uu -u u- uu -uu --	dactylic hexameter	feminine penthemimeral, hepthemimeral, trithemimeral
Ἡρακλέα κτείναντα, Διὸς θρασυκάρδιον υἱόν·	-uu- --u u- uu-uu --	dactylic hexameter	feminine penthemimeral, hepthemimeral, trithemimeral
ἀλλʼ ἄγε παῦε μάχην, μηδʼ ἀντίος ἵστασʼ ἐμεῖο.	- uu -u u- - -uu -u u--	dactylic hexameter	masculine penthemimeral
ὣς ἔφατʼ· ἀλλʼ οὐ πεῖθʼ Ἄρεος μεγαλήτορα θυμόν,	- uu - - - uu- uu-uu --	dactylic hexameter	masculine penthemimeral, hepthemimeral, trithemimeral
ἀλλὰ μέγα ἰάχων φλογὶ εἴκελά τ᾽ἔγχεα πάλλων	-u u- uu- uu -uu -uu --	dactylic hexameter	masculine penthemimeral, trithemimeral
καρπαλίμως ἐπόρουσε βίῃ Ἡρακληείῃ	-uu- uu-u u- -----	dactylic hexameter	feminine penthemimeral, hepthemimeral, trithemimeral
κακτάμεναι μεμαώς· καί ῥ᾽ἔμβαλε χάλκεον ἔγχος,	-uu- uu- - -uu -uu --	dactylic hexameter	masculine penthemimeral, trithemimeral
σπερχνὸν παιδὸς ἑοῦ κοτέων πέρι τεθνηῶτος,	-- -u u- uu- uu ----	dactylic hexameter	masculine penthemimeral, hepthemimeral
ἐν σάκεϊ μεγάλῳ. ἀπὸ δὲ γλαυκῶπις Ἀθήνη	- uu- uu- uu - --u u--	dactylic hexameter	masculine penthemimeral, hepthemimeral, trithemimeral
ἔγχεος ὁρμὴν ἔτραπʼ ὀρεξαμένη ἀπὸ δίφρου.	-uu -- -u u-uu- uu --	dactylic hexameter	feminine penthemimeral
δριμὺ δ᾽Ἄρην ἄχος εἷλε· ἐρυσσάμενος δ᾽ἄορ ὀξὺ	-u u- uu -u u-uu- uu --	dactylic hexameter	feminine penthemimeral, trithemimeral
ἔσσυτʼ ἐφʼ Ἡρακλέα κρατερόφρονα· τὸν δ᾽ἐπιόντα	-u u -uu- uu-uu - uu--	dactylic hexameter	masculine penthemimeral
Ἀμφιτρυωνιάδης, δεινῆς ἀκόρητος ἀυτῆς,	-uu-uu- -- uu-u u--	dactylic hexameter	masculine penthemimeral, hepthemimeral
μηρὸν γυμνωθέντα σάκευς ὕπο δαιδαλέοιο	-- ---u u- uu -uu--	dactylic hexameter	feminine penthemimeral, hepthemimeral
οὔτασʼ ἐπικρατέως· διὰ δὲ μέγα σαρκὸς ἄραξε	-u u-uu- uu - uu -u u--	dactylic hexameter	masculine penthemimeral, hepthemimeral
δούρατι νωμήσας, ἐπὶ δὲ χθονὶ κάββαλε μέσσῃ.	-uu --- uu - uu -uu --	dactylic hexameter	masculine penthemimeral, hepthemimeral
τῷ δὲ Φόβος καὶ Δεῖμος ἐύτροχον ἅρμα καὶ ἵππους	- u u- - -u u-uu -u u --	dactylic hexameter	feminine penthemimeral, trithemimeral
ἤλασαν αἶψʼ ἐγγύς, καὶ ἀπὸ χθονὸς εὐρυοδείης	-uu - -- u u- uu -uu--	dactylic hexameter	masculine penthemimeral, hepthemimeral, trithemimeral
ἐς δίφρον θῆκαν πολυδαίδαλον· αἶψα δ᾽ἔπειτα	- -- -- uu-uu -u u--	dactylic hexameter	masculine penthemimeral, trithemimeral
ἵππους μαστιέτην· ἵκοντο δὲ μακρὸν Ὄλυμπον.	-- -uu- --u u -u u--	dactylic hexameter	masculine penthemimeral
υἱὸς δ᾽Ἀλκμήνης καὶ κυδάλιμος Ἰόλαος	-- --- - -uu- uu--	dactylic hexameter	masculine penthemimeral
Κύκνον σκυλεύσαντες ἀπʼ ὤμων τεύχεα καλὰ	-- ---u u -- -uu --	dactylic hexameter	feminine penthemimeral
νίσσοντʼ· αἶψα δ᾽ἔπειτα πόλιν Τρηχῖνος ἵκοντο	-- -u u-u u- --u u--	dactylic hexameter	feminine penthemimeral, hepthemimeral
ἵπποις ὠκυπόδεσσιν. ἀτὰρ γλαυκῶπις Ἀθήνη	-- -uu-u u- --u u--	dactylic hexameter	feminine penthemimeral, hepthemimeral
ἐξίκετʼ Οὔλυμπόν τε μέγαν καὶ δώματα πατρός.	-uu --- u u- - -uu --	dactylic hexameter	masculine penthemimeral, hepthemimeral
κύκνον δ᾽αὖ Κῆυξ θάπτεν καὶ λαὸς ἀπείρων,	-- - -- -- - -u u--	dactylic hexameter	masculine penthemimeral, hepthemimeral, trithemimeral
οἵ ῥ᾽ἐγγὺς ναῖον πόλιας κλειτοῦ βασιλῆος	- -- -- uu- -- uu--	dactylic hexameter	masculine penthemimeral, hepthemimeral, trithemimeral
Ἄνθην Μυρμιδόνων τε πόλιν κλειτήν τ᾽Ἰαωλκὸν	-- -uu- u u- -- uu--	dactylic hexameter	masculine penthemimeral, hepthemimeral
Ἄρνην τ᾽ἠδʼ Ἑλίκην· πολλὸς δ᾽ἠγείρετο λαός,	-- - uu- -- --uu --	dactylic hexameter	masculine penthemimeral, hepthemimeral, trithemimeral
τιμῶντες Κήυκα, φίλον μακάρεσσι θεοῖσιν.	--- -- -- uu-u u--	dactylic hexameter	masculine penthemimeral, hepthemimeral, trithemimeral
τοῦ δὲ τάφον καὶ σῆμʼ ἀιδὲς ποίησεν Ἄναυρος	- u u- - - -- --u u--	dactylic hexameter	masculine penthemimeral, hepthemimeral, trithemimeral
ὄμβρῳ χειμερίῳ πλήθων· τὼς γάρ μιν Ἀπόλλων	-- -uu- -- - - u u--	dactylic hexameter	masculine penthemimeral, hepthemimeral
Λητοΐδης ἤνωξʼ, ὅτι ῥα κλειτὰς ἑκατόμβας	-uu- -- uu - -- uu--	dactylic hexameter	masculine penthemimeral, hepthemimeral, trithemimeral
ὅστις ἄγοι Πυθοῖδε βίῃ σύλασκε δοκεύων.	-u u- --u u- --u u--	dactylic hexameter	feminine penthemimeral, hepthemimeral, trithemimeral
