Κάδμου πολῖται, χρὴ λέγειν τὰ καίρια	-- u-- - u- u -u-	iambic trimeter (tragic)	
ὅστις φυλάσσει πρᾶγος ἐν πρύμνῃ πόλεως	-- u-- -u - -- u-	iambic trimeter (tragic)	
οἴακα νωμῶν, βλέφαρα μὴ κοιμῶν ὕπνῳ.	--u -- uuu - -- u-	lyric	
εἰ μὲν γὰρ εὖ πράξαιμεν, αἰτία θεοῦ·	- - u - --u -u- u-	iambic trimeter (tragic)	
εἰ δʼ αὖθʼ, ὃ μὴ γένοιτο, συμφορὰ τύχοι,	- - u - u-u -u- u-	iambic trimeter (tragic)	
Ἐτεοκλέης ἂν εἷς πολὺς κατὰ πτόλιν	uu-u- u - u- u- u-	iambic trimeter (tragic)	
ὑμνοῖθʼ ὑπʼ ἀστῶν φροιμίοις πολυρρόθοις	-- u -- -u- u-u-	iambic trimeter (tragic)	
οἰμώγμασίν θʼ, ὧν Ζεὺς ἀλεξητήριος	--u- - - u---u-	iambic trimeter (tragic)	
ἐπώνυμος γένοιτο Καδμείων πόλει.	u-u- u-u --- u-	iambic trimeter (tragic)	
ὑμᾶς δὲ χρὴ νῦν, καὶ τὸν ἐλλείποντʼ ἔτι	-- u - - - u --- u-	iambic trimeter (tragic)	
ἥβης ἀκμαίας καὶ τὸν ἔξηβον χρόνῳ,	-- u-- - u --- u-	iambic trimeter (tragic)	
βλαστημὸν ἀλδαίνοντα σώματος πολύν,	--u ---u -u- u-	iambic trimeter (tragic)	
ὥραν τʼ ἔχονθʼ ἕκαστον ὥστε συμπρεπές,	-- u- u-u -u -u-	iambic trimeter (tragic)	
πόλει τʼ ἀρήγειν καὶ θεῶν ἐγχωρίων	u- u-- - u- --u-	iambic trimeter (tragic)	
βωμοῖσι, τιμὰς μὴ ʼξαλειφθῆναί ποτε·	--u -- - u--- u-	iambic trimeter (tragic)	
τέκνοις τε, Γῇ τε μητρί, φιλτάτῃ τροφῷ·	u- u - u -u -u- u-	iambic trimeter (tragic)	
ἡ γὰρ νέους ἕρποντας εὐμενεῖ πέδῳ,	- - u- --u -u- u-	iambic trimeter (tragic)	
ἅπαντα πανδοκοῦσα παιδείας ὄτλον,	u-u -u-u --- u-	iambic trimeter (tragic)	
ἐθρέψατʼ οἰκητῆρας ἀσπιδηφόρους	u-u ---u -u-u-	iambic trimeter (tragic)	
πιστοὺς ὅπως γένοισθε πρὸς χρέος τόδε.	-- u- u-u - u- u-	iambic trimeter (tragic)	
καὶ νῦν μὲν ἐς τόδʼ ἦμαρ εὖ ῥέπει θεός·	- - u - u -u - u- u-	iambic trimeter (tragic)	
χρόνον γὰρ ἤδη τόνδε πυργηρουμένοις	u- u -- -u ---u-	iambic trimeter (tragic)	
καλῶς τὰ πλείω πόλεμος ἐκ θεῶν κυρεῖ.	u- u -- uuu - u- u-	lyric	
νῦν δʼ ὡς ὁ μάντις φησίν, οἰωνῶν βοτήρ,	- - u -- -u --- u-	iambic trimeter (tragic)	
ἐν ὠσὶ νωμῶν καὶ φρεσίν, πυρὸς δίχα,	u -u -- - u- u- u-	iambic trimeter (tragic)	
χρηστηρίους ὄρνιθας ἀψευδεῖ τέχνῃ·	--u- --u --- u-	iambic trimeter (tragic)	
οὗτος τοιῶνδε δεσπότης μαντευμάτων	-- u-u -u- --u-	iambic trimeter (tragic)	
λέγει μεγίστην προσβολὴν Ἀχαιίδα	u- u-- -u- u-u-	iambic trimeter (tragic)	
νυκτηγορεῖσθαι κἀπιβουλεύσειν πόλει.	--u-- -u--- u-	iambic trimeter (tragic)	
ἀλλʼ ἔς τʼ ἐπάλξεις καὶ πύλας πυργωμάτων	- - u-- - u- --u-	iambic trimeter (tragic)	
ὁρμᾶσθε πάντες, σοῦσθε σὺν παντευχίᾳ,	--u -- -u - --u-	iambic trimeter (tragic)	
πληροῦτε θωρακεῖα, κἀπὶ σέλμασιν	--u ---u -u -u-	iambic trimeter (tragic)	
πύργων στάθητε, καὶ πυλῶν ἐπʼ ἐξόδοις	-- u-u - u- u -u-	iambic trimeter (tragic)	
μίμνοντες εὖ θαρσεῖτε, μηδʼ ἐπηλύδων	--u - --u - u-u-	iambic trimeter (tragic)	
ταρβεῖτʼ ἄγαν ὅμιλον· εὖ τελεῖ θεός.	-- u- u-u - u- u-	iambic trimeter (tragic)	
σκοποὺς δὲ κἀγὼ καὶ κατοπτῆρας στρατοῦ	u- u -- - u--- u-	iambic trimeter (tragic)	
ἔπεμψα, τοὺς πέποιθα μὴ ματᾶν ὁδῷ·	u-u - u-u - u- u-	iambic trimeter (tragic)	
καὶ τῶνδʼ ἀκούσας οὔ τι μὴ ληφθῶ δόλῳ.	- - u-- - u - -- u-	iambic trimeter (tragic)	
Ἐτεόκλεες, φέριστε Καδμείων ἄναξ,	uu-u- u-u --- u-	iambic trimeter (tragic)	
ἥκω σαφῆ τἀκεῖθεν ἐκ στρατοῦ φέρων,	-- u- --u - u- u-	iambic trimeter (tragic)	
αὐτὸς κατόπτης δʼ εἴμʼ ἐγὼ τῶν πραγμάτων·	-- u-- - u- - -u-	iambic trimeter (tragic)	
ἄνδρες γὰρ ἑπτά, θούριοι λοχαγέται,	-- u -u -u- u-u-	iambic trimeter (tragic)	
ταυροσφαγοῦντες ἐς μελάνδετον σάκος	--u-u - u-u- u-	iambic trimeter (tragic)	
καὶ θιγγάνοντες χερσὶ ταυρείου φόνου,	- -u-- -u --- u-	iambic trimeter (tragic)	
Ἄρη τʼ, Ἐνυώ, καὶ φιλαίματον Φόβον	u- u-- - u-u- u-	iambic trimeter (tragic)	
ὡρκωμότησαν ἢ πόλει κατασκαφὰς	--u-u - u- u-u-	iambic trimeter (tragic)	
θέντες λαπάξειν ἄστυ Καδμείων βίᾳ,	-- u-- -u --- u-	iambic trimeter (tragic)	
ἢ γῆν θανόντες τήνδε φυράσειν φόνῳ·	- - u-- -u --- u-	iambic trimeter (tragic)	
μνημεῖά θʼ αὑτῶν τοῖς τεκοῦσιν ἐς δόμους	--u -- - u-u - u-	iambic trimeter (tragic)	
πρὸς ἅρμʼ Ἀδράστου χερσὶν ἔστεφον, δάκρυ	u - u-- -u -u- u-	iambic trimeter (tragic)	
λείβοντες· οἶκτος δʼ οὔτις ἦν διὰ στόμα.	--u -- -u - u- u-	iambic trimeter (tragic)	
σιδηρόφρων γὰρ θυμὸς ἀνδρείᾳ φλέγων	u-u- - -u --- u-	iambic trimeter (tragic)	
ἔπνει, λεόντων ὡς Ἄρη δεδορκότων.	u- u-- - u- u-u-	iambic trimeter (tragic)	
καὶ τῶνδε πύστις οὐκ ὄκνῳ χρονίζεται·	- -u -u - u- u-u-	iambic trimeter (tragic)	
κληρουμένους δʼ ἔλειπον, ὡς πάλῳ λαχὼν	--u- u-u - u- u-	iambic trimeter (tragic)	
ἕκαστος αὐτῶν πρὸς πύλας ἄγοι λόχον.	u-u -- - u- u- u-	iambic trimeter (tragic)	
πρὸς ταῦτʼ ἀρίστους ἄνδρας ἐκκρίτους πόλεως	- - u-- -u -u- u-	iambic trimeter (tragic)	
πυλῶν ἐπʼ ἐξόδοισι τάγευσαι τάχος·	u- u -u-u --- u-	iambic trimeter (tragic)	
ἐγγὺς γὰρ ἤδη πάνοπλος Ἀργείων στρατὸς	-- u -- uuu --- u-	lyric	
χωρεῖ, κονίει, πεδία δʼ ἀργηστὴς ἀφρὸς	-- u-- uuu --- u-	lyric	
χραίνει σταλαγμοῖς ἱππικῶν ἐκ πλευμόνων.	-- u-- -u- - -u-	iambic trimeter (tragic)	
σὺ δʼ ὥστε ναὸς κεδνὸς οἰακοστρόφος	u -u -- -u ---u-	iambic trimeter (tragic)	
φράξαι πόλισμα, πρὶν καταιγίσαι πνοὰς	-- u-u - u-u- u-	iambic trimeter (tragic)	
Ἄρεως· βοᾷ γὰρ κῦμα χερσαῖον στρατοῦ·	u- u- - -u --- u-	iambic trimeter (tragic)	
καὶ τῶνδε καιρὸν ὅστις ὤκιστος λαβέ·	- -u -u -u --- u-	iambic trimeter (tragic)	
κἀγὼ τὰ λοιπὰ πιστὸν ἡμεροσκόπον	-- u -u -u -u-u-	iambic trimeter (tragic)	
ὀφθαλμὸν ἕξω, καὶ σαφηνείᾳ λόγου	--u -- - u--- u-	iambic trimeter (tragic)	
εἰδὼς τὰ τῶν θύραθεν ἀβλαβὴς ἔσῃ.	-- u - u-u -u- u-	iambic trimeter (tragic)	
ὦ Ζεῦ τε καὶ Γῆ καὶ πολισσοῦχοι θεοί,	- - u - - - u--- u-	iambic trimeter (tragic)	
Ἀρά τʼ Ἐρινὺς πατρὸς ἡ μεγασθενής,	u- u-- -u - u-u-	iambic trimeter (tragic)	
μή μοι πόλιν γε πρυμνόθεν πανώλεθρον	- - u- u -u- u-u-	iambic trimeter (tragic)	
ἐκθαμνίσητε δῃάλωτον, Ἑλλάδος	--u-u -u-u -u-	iambic trimeter (tragic)	
φθόγγον χέουσαν, καὶ δόμους ἐφεστίους·	-- u-- - u- u-u-	iambic trimeter (tragic)	
ἐλευθέραν δὲ γῆν τε καὶ Κάδμου πόλιν	u-u- u - u - -- u-	iambic trimeter (tragic)	
ζυγοῖσι δουλίοισι μήποτε σχεθεῖν·	u-u -u-u -u- u-	iambic trimeter (tragic)	
γένεσθε δʼ ἀλκή· ξυνὰ δʼ ἐλπίζω λέγειν·	u-u -- -u --- u-	iambic trimeter (tragic)	
πόλις γὰρ εὖ πράσσουσα δαίμονας τίει.	u- u - --u -u- u-	iambic trimeter (tragic)	
u-u θρέομαι φοβερὰ μεγάλʼ ἄχη·	u-u uu- uuu uu u-	lyric	
μεθεῖται στρατός· στρατόπεδον λιπὼν	u-- u- uuu- u-	lyric	
ῥεῖ πολὺς ὅδε λεὼς πρόδρομος ἱππότας·	- uu uu u- uuu -u-	lyric	
αἰθερία κόνις με πείθει φανεῖσʼ,	-uu- u- u -- u-	lyric	
ἄναυδος σαφὴς ἔτυμος ἄγγελος.	u-- u- uuu -u-	lyric	
ἔτι δὲ <γᾶς> ἐμᾶς πεδίʼ ὁπλόκτυπʼ ὠ-	uu u - u- uu u-u -	lyric	
τὶ χρίμπτει βοάν· ποτᾶται, βρέμει δʼ	u -- u- u-- u-	lyric	
ἀμαχέτου δίκαν ὕδατος ὀροτύπου.	uuu- u- uuu uuu-	lyric	
ἰὼ ἰὼ	u- u-	lyric	
ἰὼ θεοὶ θεαί τʼ ὀρόμενον κακὸν	u- - u- uuu- u-	lyric	
βοᾷ τειχέων ὕπερ ἀλεύσατε.	u- -u- uu u-u-	lyric	
ὁ λεύκασπις ὄρνυται λαὸς εὐ-	u --u -u- -u -	lyric	
τρεπὴς ἐπὶ πόλιν διώκων [πόδα	u- uu u- u-- u-	lyric	
τίς ἄρα ῥύσεται, τίς ἄρʼ ἐπαρκέσει	u uu -u- u u u-u-	lyric	
θεῶν ἢ θεᾶν;	u- - u-	lyric	
πότερα δῆτʼ ἐγὼ <πάτρια> ποτιπέσω	uuu - u- uuu uuu-	lyric	
βρέτη δαιμόνων;	u- -u-	lyric	
ἰὼ μάκαρες εὔεδροι,	u- uuu -u-	lyric	
ἀκμάζει βρετέων ἔχεσθαι· τί μέλ-	u-- u- u-- u -	lyric	
λομεν ἀγάστονοι;	uu u-u-	lyric	
ἀκούετʼ ἢ οὐκ ἀκούετʼ ἀσπίδων κτύπον;	u-u - u-u -u- u-	iambic trimeter (tragic)	
πέπλων καὶ στεφέων πότʼ εἰ μὴ νῦν ἀμ-	u- - u- u - - - -	lyric	
φὶ λιτάνʼ ἕξομεν;	u uu -u-	lyric	
κτύπον δέδορκα· πάταγος οὐχ ἑνὸς δορός.	u- u-u uuu - u- u-	lyric	
τί ῥέξεις; προδώσεις, παλαίχθων	u -- u-- u--	lyric	
Ἄρης, τὰν τεάν;	u- - u-	lyric	
ὼ χρυσοπήληξ δαῖμον ἔπιδʼ ἔπιδε πόλιν	- -u-- -u uu uuu u-	lyric	
ἅν ποτʼ εὐφιλήταν ἔθου.	- u -u-- u-	lyric	
θεοὶ πολιάοχοι πάντες ἴτε χθονὸς·	- uu-u- -u u- u-	lyric	
ἴδετε παρθένων	uuu -u-	lyric	
ἱκέσιον λόχον δουλοσύνας ὕπερ.	uuu- u- -uu- u-	lyric	
κῦμα περὶ πτόλιν δοχμολόφων ἀνδρῶν	-u u- u- -uu- --	lyric	
καχλάζει πνοαῖς Ἄρεος ὀρόμενον.	u-- u- uuu uuu-	lyric	
ἀλλʼ, ὦ Ζεῦ πάτερ παντὸς ἔχων τέλος,	- - - u- -u u- u-	lyric	
πάντως ἄρηξον δαΐων ἅλωσιν.	-- u-- -u- u--	lyric	
Ἀργέιοι δὲ πόλισμα Κάδμου	-uu- u u-u --	lyric	
κυκλοῦνται· φόβος δʼ ἀρῄων ὅπλων	u-- u- u-- u-	lyric	
[δονεῖ	u- uu u - uu- -u-	lyric	
μινύρονται φόνον χαλινοί.	u--- u- u--	lyric	
ἑπτὰ δʼ ἀγάνορες πρέποντες στρατοῦ	-u u-u- u-- u-	lyric	
δορυσσοῖς σαγαῖς πύλαις ἑβδόμαις	u-- u- u- -u-	lyric	
προσίστανται πάλῳ λαχόντες.	u--- u- u--	lyric	
σύ τʼ, ὦ Διογενὲς φιλόμαχον κράτος,	u - uuu- uuu- u-	lyric	
ῥυσίπολις γενοῦ,	uuu- u-	lyric	
Παλλάς, ὅ θʼ ἵππιος ποντομέδων ἄναξ	-u u -u- -uu- u-	lyric	
ἰχθυβόλῳ Ποσειδάων μαχανᾷ,	-uu- u--- -u-	lyric	
ἐπίλυσιν φόβων, ἐπίλυσιν δίδου.	uuu- u- uuu- u-	lyric	
σύ τʼ, Ἄρης, φεῦ, φεῦ, πόλιν ἐπώνυμον	u -- - - uu u-u-	lyric	
Κάδμου φύλαξον κήδεσαί τʼ ἐναργῶς.	u- u-- -u- u--	lyric	
καὶ Κύπρις, ἅτε γένους προμάτωρ,	- uu -u u- u--	lyric	
ἄλευσον· σέθεν γὰρ ἐξ αἵματος	u-- u- u - -u-	lyric	
γεγόναμεν· λιταῖσί σε θεοκλύτοις	uuu- u-u u u-u-	lyric	
ἀυτοῦσαι πελαζόμεσθα.	u--- u-u--	lyric	
καὶ σύ, Λύκειʼ ἄναξ, Λύκειος γενοῦ	- u u- u- u-- u-	lyric	
στρατῷ δαΐῳ στόνων ἀντίτας.	u- -u- u- -u-	lyric	
σύ τʼ, ὦ Λατογένει-	u - -uu-	lyric	
α κούρα, τόξον εὐτυκάζου.	u -- -u -u--	lyric	
ἒ ἒ ἒ ἔ,	u u u u	lyric	
ὄτοβον ἁρμάτων ἀμφὶ πόλιν κλύω·	uuu -u- -u u- u-	lyric	
ὦ πότνιʼ Ἥρα.	- uu --	anapaestic	
ἔλακον ἀξόνων βριθομένων χνόαι.	uuu -u- -uu- u-	lyric	
Ἄρτεμι φίλα,	-uu u-	lyric	
δοριτίνακτος αἰθὴρ δʼ ἐπιμαίνεται.	uuu-u -- uu-u-	lyric	
τί πόλις ἄμμι πάσχει, τί γενήσεται;	u uu -u -- u u-u-	lyric	
ποῖ δʼ ἔτι τέλος ἐπάγει θεός;	- uu uu uu- u-	lyric	
ἒ ἒ ἒ ἔ,	u u u u	lyric	
ἀκροβόλων δʼ ἐπάλξεων λιθὰς ἔρχεται·	uuu- u-- uu -u-	lyric	
ὦ φίλʼ Ἄπολλον·	- u u--	anapaestic	
κόναβος ἐν πύλαις χαλκοδέτων σακέων,	uuu - u- -uu- u-	lyric	
παῖ Διός, ὅθεν	- uu u-	lyric	
πολεμόκραντον ἁγνὸν τέλος ἐν μάχᾳ.	uuu-u -- uu - u-	lyric	
σύ τε, μάκαιρʼ ἄνασσʼ Ὄγκα, πρὸ πόλεως	u u u- u- -- u uu-	lyric	
ἑπτάπυλον ἕδος ἐπιρρύου.	-uuu uu u-u-	lyric	
ἰὼ παναρκεῖς θεοί,	u- u-- u-	lyric	
ἰὼ τέλειοι τέλειαί τε γᾶς	u- u-- u-- u -	lyric	
τᾶσδε πυργοφύλακες,	-u -uuu-	lyric	
πόλιν δορίπονον μὴ προδῶθʼ	u- uuu- - u-	lyric	
ἑτεροφώνῳ στρατῷ.	uuu-- u-	lyric	
κλύετε παρθένων κλύετε πανδίκως	uuu -u- uuu -u-	lyric	
χειροτόνους λιτάς.	-uu- u-	lyric	
ἰὼ φίλοι δαίμονες,	u- u- -u-	lyric	
λυτήριοί <τʼ >ἀμφιβάντες πόλιν,	u-u- -u-- u-	lyric	
δείξαθʼ ὡς φιλοπόλεις,	-u - uuu-	lyric	
μέλεσθέ θʼ ἱερῶν δημίων,	u-u uu- -u-	lyric	
μελόμενοις τʼ ἄλξατε·	uuu- -u-	lyric	
φιλοθύτων δέ τοι πόλεος ὀργίων	uuu- u - uuu -u-	lyric	
μνήστορες ἐστέ μοι.	-uu -u -	lyric	
ὑμᾶς ἐρωτῶ, θρέμματʼ οὐκ ἀνασχετά,	-- u-- -u - u-u-	iambic trimeter (tragic)	
ἦ ταῦτʼ ἄριστα καὶ πόλει σωτήρια,	- - u-u - u- --u-	iambic trimeter (tragic)	
στρατῷ τε θάρσος τῷδε πυργηρουμένῳ,	u- u -- -u ---u-	iambic trimeter (tragic)	
βρέτη πεσούσας πρὸς πολισσούχων θεῶν	u- u-- - u--- u-	iambic trimeter (tragic)	
αὔειν, λακάζειν, σωφρόνων μισήματα;	-- u-- -u- --u-	iambic trimeter (tragic)	
μήτʼ ἐν κακοῖσι μήτʼ ἐν εὐεστοῖ φίλῃ	- - u-u - u --- u-	iambic trimeter (tragic)	
ξύνοικος εἴην τῷ γυναικείῳ γένει.	u-u -- - u--- u-	iambic trimeter (tragic)	
κρατοῦσα μὲν γὰρ οὐχ ὁμιλητὸν θράσος,	u-u - u - u--- u-	iambic trimeter (tragic)	
δείσασα δʼ οἴκῳ καὶ πόλει πλέον κακόν.	--u -- - u- u- u-	iambic trimeter (tragic)	
καὶ νῦν πολίταις τάσδε διαδρόμους φυγὰς	- - u-- -u uuu- u-	lyric	
θεῖσαι διερροθήσατʼ ἄψυχον κάκην·	-- u-u-u --- u-	iambic trimeter (tragic)	
τὰ τῶν θύραθεν δʼ ὡς ἄριστʼ ὀφέλλεται,	u - u-- - u- u-u-	iambic trimeter (tragic)	
αὐτοὶ δʼ ὑπʼ αὐτῶν ἔνδοθεν πορθούμεθα.	-- u -- -u- --u-	iambic trimeter (tragic)	
τοιαῦτά τἂν γυναιξὶ συνναίων ἔχοις.	--u - u-u --- u-	iambic trimeter (tragic)	
κεἰ μή τις ἀρχῆς τῆς ἐμῆς ἀκούσεται,	- - u -- - u- u-u-	iambic trimeter (tragic)	
ἀνὴρ γυνή τε χὤ τι τῶν μεταίχμιον,	u- u- u - u - u-u-	iambic trimeter (tragic)	
ψῆφος κατʼ αὐτῶν ὀλεθρία βουλεύσεται,	-- u -- uuu- --u-	lyric	
λευστῆρα δήμου δʼ οὔ τι μὴ φύγῃ μόρον.	--u -- - u - u- u-	iambic trimeter (tragic)	
μέλει γὰρ ἀνδρί, μὴ γυνὴ βουλευέτω,	u- u -u - u- --u-	iambic trimeter (tragic)	
τἄξωθεν· ἔνδον δʼ οὖσα μὴ βλάβην τίθει.	--u -- -u - u- u-	iambic trimeter (tragic)	
ἤκουσας ἢ οὐκ ἤκουσας, ἢ κωφῇ λέγω;	--u - --u - -- u-	iambic trimeter (tragic)	
ὦ φίλον Οἰδίπου τέκος, ἔδεισʼ ἀκού-	- uu -u- uu u- u-	lyric	
σασα τὸν ἁρματόκτυπον ὄτοβον ὄτοβον,	-u u -u-uu uuu uu-	lyric	
ὅτε τε σύριγγες ἔκλαγξαν ἑλίτροχοι,	uu u --u u-u u-u-	lyric	
ἱππικῶν τʼ ἀπύαν πηδαλίων διὰ στόμα	-u- -u- -uu- u- u-	lyric	
πυριγενετᾶν χαλινῶν.	uuuu- u--	lyric	
τί οὖν; ὁ ναύτης ἆρα μὴ ʼς πρῷραν φυγὼν	u - u -- -u - -- u-	iambic trimeter (tragic)	
πρύμνηθεν ηὗρε μηχανὴν σωτηρίας,	--u -u -u- --u-	iambic trimeter (tragic)	
νεὼς καμούσης ποντίῳ πρὸς κύματι;	u- u-- -u- - -u-	iambic trimeter (tragic)	
ἀλλʼ ἐπὶ δαιμόνων πρόδρομος ἦλθον ἀρ-	- uu -u- uuu -u -	lyric	
χαῖα βρέτη, θεοῖσι πίσυνος, νιφάδος	-u u- u-u uu- uuu	lyric	
ὅτʼ ὀλοᾶς νειφομένας βρόμος ἐν πύλαις·	u uu- -uu- uu - u-	lyric	
δὴ τότʼ ἤρθην φόβῳ πρὸς μακάρων λιτάς, πόλεως	- u -- u- - uu- u- u-	lyric	
ἵνʼ ὑπερέχοιεν ἀλκάν.	u uuu-u --	lyric	
πύργον στέγειν εὔχεσθε πολέμιον δόρυ.	-- u- --u uuu- u-	lyric	
οὐκοῦν τάδʼ ἔσται πρὸς θεῶν· ἀλλʼ οὖν θεοὺς	-- u -- - u- - - u-	iambic trimeter (tragic)	
τοὺς τῆς ἁλούσης πόλεος ἐκλείπειν λόγος.	- - u-- uuu --- u-	lyric	
μήποτʼ ἐμὸν κατʼ αἰῶνα λίποι θεῶν	-u u- u --u u- u-	lyric	
ἅδε πανάγυρις, μηδʼ ἐπίδοιμι τάνδʼ	uu u-u- - uu-u -	lyric	
ἀστυδρομουμέναν πόλιν καὶ στράτευμʼ	-uu-u- u- - u-	lyric	
ἁπτόμενον πυρὶ δαΐῳ.	-uu- uu -u-	lyric	
μή μοι θεοὺς καλοῦσα βουλεύου κακῶς·	- - u- u-u --- u-	iambic trimeter (tragic)	
πειθαρχία γάρ ἐστι τῆς εὐπραξίας	--u- u -u - --u-	iambic trimeter (tragic)	
μήτηρ, γυνὴ σωτῆρος· ὧδʼ ἔχει λόγος.	-- u- --u - u- u-	iambic trimeter (tragic)	
ἔστι· θεοῦ δʼ ἔτʼ ἰσχὺς καθυπερτέρα·	-u u- u -- uu-u-	lyric	
πολλάκι δʼ ἐν κακοῖσι τὸν ἀμάχανον	-uu - u-u u u-u-	lyric	
κἀκ χαλεπᾶς δύας ὕπερθʼ ὀμμάτων	- uu- uu u- -u-	lyric	
κρημναμενᾶν νεφελᾶν ὀρθοῖ.	-uu- uu- --	lyric	
ἀνδρῶν τάδʼ ἐστί, σφάγια καὶ χρηστήρια	-- u -- uuu - --u-	lyric	
θεοῖσιν ἕρδειν πολεμίων πειρωμένους·	u-u -- uuu- --u-	lyric	
σὸν δʼ αὖ τὸ σιγᾶν καὶ μένειν εἴσω δόμων.	- - u -- - u- -- u-	iambic trimeter (tragic)	
διὰ θεῶν πόλιν νεμόμεθʼ ἀδάματον,	uu u- u- uuu uuu-	lyric	
δυσμενέων δʼ ὄχλον πύργος ἀποστέγει.	-uu- u- -u u-u-	lyric	
τίς τάδε νέμεσις στυγεῖ;	- uu uu- u-	lyric	
οὔτοι φθονῶ σοι δαιμόνων τιμᾶν γένος·	-- u- - -u- u- u-	iambic trimeter (tragic)	
ἀλλʼ ὡς πολίτας μὴ κακοσπλάγχνους τιθῇς,	- - u-- - u--- u-	iambic trimeter (tragic)	
εὔκηλος ἴσθι μηδʼ ἄγαν ὑπερφοβοῦ.	--u -u - u- u-u-	iambic trimeter (tragic)	
ποτίφατον κλύουσα πάταγον ἀνάμιγα	uuu- u-u uuu uuu-	lyric	
ταρβοσύνῳ φόβῳ τάνδʼ ἐς ἀκρόπτολιν,	-uu- u- - u u-u-	lyric	
τίμιον ἕδος, ἱκόμαν.	-uu uu -u-	lyric	
μή νυν, ἐὰν θνῄσκοντας ἢ τετρωμένους	- - u- --u - u-u-	iambic trimeter (tragic)	
πύθησθε, κωκυτοῖσιν ἁρπαλίζετε.	u-u ---u -u-u-	iambic trimeter (tragic)	
τούτῳ γὰρ Ἄρης βόσκεται, φόνῳ βροτῶν.	-- u -- -u- u- u-	iambic trimeter (tragic)	
καὶ μὴν ἀκούω γʼ ἱππικῶν φρυαγμάτων.	- - u-- -u- u-u-	iambic trimeter (tragic)	
μή νυν ἀκούουσʼ ἐμφανῶς ἄκουʼ ἄγαν.	- - u-- -u- u- u-	iambic trimeter (tragic)	
στένει πόλισμα γῆθεν, ὡς κυκλουμένων.	u- u-u -u - u-u-	iambic trimeter (tragic)	
οὐκοῦν ἔμʼ ἀρκεῖ τῶνδε βουλεύειν πέρι.	-- u -- -u --- u-	iambic trimeter (tragic)	
δέδοικʼ, ἀραγμὸς δʼ ἐν πύλαις ὀφέλλεται.	u- u-- - u- u-u-	iambic trimeter (tragic)	
οὐ σῖγα μηδὲν τῶνδʼ ἐρεῖς κατὰ πτόλιν;	- -u -- - u- u- u-	iambic trimeter (tragic)	
ὦ ξυντέλεια, μὴ προδῷς πυργώματα.	- -u-u - u- --u-	iambic trimeter (tragic)	
οὐκ ἐς φθόρον σιγῶσʼ ἀνασχήσῃ τάδε;	- - u- -- u--- u-	iambic trimeter (tragic)	
θεοὶ πολῖται, μή με δουλείας τυχεῖν.	u- u-- - u --- u-	iambic trimeter (tragic)	
αὐτὴ σὺ δουλοῖς κἀμὲ καὶ πᾶσαν πόλιν.	-- u -- -u - -- u-	iambic trimeter (tragic)	
ὦ παγκρατὲς Ζεῦ, τρέψον εἰς ἐχθροὺς βέλος.	- -u- - -u - -- u-	iambic trimeter (tragic)	
ὦ Ζεῦ, γυναικῶν οἷον ὤπασας γένος.	- - u-- -u -u- u-	iambic trimeter (tragic)	
μοχθηρόν, ὥσπερ ἄνδρας ὧν ἁλῷ πόλις.	--u -u -u - u- u-	iambic trimeter (tragic)	
παλινστομεῖς αὖ θιγγάνουσʼ ἀγαλμάτων;	u-u- - -u- u-u-	iambic trimeter (tragic)	
ἀψυχίᾳ γὰρ γλῶσσαν ἁρπάζει φόβος.	--u- - -u --- u-	iambic trimeter (tragic)	
αἰτουμένῳ μοι κοῦφον εἰ δοίης τέλος.	--u- - -u - -- u-	iambic trimeter (tragic)	
λέγοις ἂν ὡς τάχιστα, καὶ τάχʼ εἴσομαι.	u- u - u-u - u -u-	iambic trimeter (tragic)	
σίγησον, ὦ τάλαινα, μὴ φίλους φόβει.	--u - u-u - u- u-	iambic trimeter (tragic)	
σιγῶ· σὺν ἄλλοις πείσομαι τὸ μόρσιμον.	-- u -- -u- u -u-	iambic trimeter (tragic)	
τοῦτʼ ἀντʼ ἐκείνων τοὔπος αἱροῦμαι σέθεν.	- - u-- -u --- u-	iambic trimeter (tragic)	
καὶ πρός γε τούτοις, ἐκτὸς οὖσʼ ἀγαλμάτων,	- - u -- -u - u-u-	iambic trimeter (tragic)	
εὔχου τὰ κρείσσω, ξυμμάχους εἶναι θεούς·	-- u -- -u- -- u-	iambic trimeter (tragic)	
κἀμῶν ἀκούσασʼ εὐγμάτων, ἔπειτα σὺ	-- u-- -u- u-u -	iambic trimeter (tragic)	
ὀλολυγμὸν ἱερὸν εὐμενῆ παιώνισον,	uu-u uuu -u- --u-	lyric	
Ἑλληνικὸν νόμισμα θυστάδος βοῆς,	--u- u-u -u- u-	iambic trimeter (tragic)	
θάρσος φίλοις, λύουσα πολέμιον φόβον.	-- u- u-u uuu- u-	lyric	
ἐγὼ δὲ χώρας τοῖς πολισσούχοις θεοῖς,	u- u -- - u--- u-	iambic trimeter (tragic)	
πεδιονόμοις τε κἀγορᾶς ἐπισκόποις,	uuuu- u -u- u-u-	lyric	
Δίρκης τε πηγαῖς, ὕδατί τʼ Ἰσμηνοῦ λέγω	-- u -- uuu --- u-	lyric	
εὖ ξυντυχόντων καὶ πόλεως σεσωμένης,	- -u-- - u- u-u-	iambic trimeter (tragic)	
μήλοισιν αἱμάσσοντας ἑστίας θεῶν,	--u ---u -u- u-	iambic trimeter (tragic)	
[ταυροκτονοῦντας θεοῖσιν, ὧδʼ ἐπεύχομαι	--u-- -u - u-u-	iambic trimeter (tragic)	
θύσειν τροπαῖα, δαΐων δʼ ἐσθήματα,	-- u-u -u- --u-	iambic trimeter (tragic)	
στέψω λάφυρα δουρίπληχθʼ ἁγνοῖς δόμοις.	-- u-u -u- -- u-	iambic trimeter (tragic)	
[στέψω πρὸ ναῶν, πολεμίων δʼ ἐσθήματα.	-- u -- uuu- --u-	lyric	
τοιαῦτʼ ἐπεύχου μὴ φιλοστόνως θεοῖς,	-- u-- - u-u- u-	iambic trimeter (tragic)	
μηδʼ ἐν ματαίοις κἀγρίοις ποιφύγμασιν·	- - u-- -u- --u-	iambic trimeter (tragic)	
οὐ γάρ τι μᾶλλον μὴ φύγῃς τὸ μόρσιμον.	- - u -- - u- u -u-	iambic trimeter (tragic)	
ἐγὼ δέ γʼ ἄνδρας ἓξ ἐμοὶ σὺν ἑβδόμῳ	u- u -- - u- u -u-	iambic trimeter (tragic)	
ἀντηρέτας ἐχθροῖσι τὸν μέγαν τρόπον	--u- --u - u- u-	iambic trimeter (tragic)	
εἰς ἑπτατειχεῖς ἐξόδους τάξω μολών,	- -u-- -u- -- u-	iambic trimeter (tragic)	
πρὶν ἀγγέλους σπερχνούς τε καὶ ταχυρρόθους	u -u- -- u - u-u-	iambic trimeter (tragic)	
λόγους ἱκέσθαι καὶ φλέγειν χρείας ὕπο.	u- u-- - u- -- u-	iambic trimeter (tragic)	
μέλει, φόβῳ δʼ οὐχ ὑπνώσσει κέαρ·	u- u- - u-- u-	lyric	
γείτονες δὲ καρδίας	-u- u -u-	lyric	
μέριμναι ζωπυροῦσι τάρβος	u-- -u-u --	lyric	
τὸν ἀμφιτειχῆ λεών,	u -u-- u-	lyric	
δράκοντας ὥς τις τέκνων	u-u - - u-	lyric	
ὑπερδέδοικεν λεχαίων δυσευνάτορας	u-u-- u-- u--u-	lyric	
πάντρομος πελειάς.	-u- u--	lyric	
τοὶ μὲν γὰρ ποτὶ πύργους	- - - uu --	lyric	
πανδαμεὶ πανομιλεὶ	--- uu--	lyric	
στείχουσιν. τί γένωμαι;	--- u u--	lyric	
τοὶ δʼ ἐπʼ ἀμφιβόλοισιν	- u -uu--	lyric	
ἰάπτουσι πολίταις	---u u--	lyric	
χερμάδʼ ὀκριόεσσαν.	-u -uu--	lyric	
παντὶ τρόπῳ, Διογενεῖς	-u u- -uu-	lyric	
θεοί, πόλιν καὶ στρατὸν	- u- - u-	lyric	
Καδμογενῆ ῥύεσθε.	-uu- u-u	lyric	
ποῖον δʼ ἀμείψεσθε γαίας πέδον	-- u--u -- u-	lyric	
τᾶσδʼ ἄρειον, ἐχθροῖς	- u-u --	lyric	
ἀφέντες τὰν βαθύχθονʼ αἶαν,	u-- - u-u --	lyric	
ὕδωρ τε Διρκαῖον, εὐ-	u- u --u -	lyric	
τραφέστατον πωμάτων	u-u- -u-	lyric	
ὅσων ἵησιν Ποσειδᾶν ὁ γαιάοχος	u- u-- u-- u --u-	lyric	
Τηθύος τε παῖδες.	-u- u --	lyric	
πρὸς τάδʼ, ὦ πολιοῦχοι	- u - uu--	lyric	
θεοί, τοῖσι μὲν ἔξω	u- -u u --	lyric	
πύργων ἀνδρολέτειραν	-- -uu--	lyric	
κῆρα, ῥίψοπλον ἄταν,	-u -uu --	lyric	
ἐμβαλόντες ἄροισθε	-u-u u--	lyric	
κῦδος τοῖσδε πολίταις.	-- -u u--	lyric	
καὶ πόλεως ῥύτορες <ἔστʼ>	- uu- -uu -	lyric	
εὔεδροί τε στάθητʼ	-u- - u-	lyric	
ὀξυγόοις λιταῖσιν.	-uu- u--	lyric	
οἰκτρὸν γὰρ πόλιν ὧδʼ ὠγυγίαν	-- - uu - -uu-	anapaestic	
Ἀίδᾳ προϊάψαι, δορὸς ἄγραν	uu- uu-- uu --	anapaestic	
δουλίαν ψαφαρᾷ σποδῷ	-u- uu- u-	lyric	
ὑπʼ ἀνδρὸς Ἀχαιοῦ θεόθεν	u -u u-- uu-	lyric	
περθομέναν ἀτίμως,	-uu- u--	lyric	
τὰς δὲ κεχειρωμένας ἄγεσθαι,	- u u--u- u--	lyric	
ἒ ἔ, νέας τε καὶ παλαιὰς	u u u- u - u--	lyric	
ἱππηδὸν πλοκάμων, περιρ-	--- uu- u-	lyric	
ρηγνυμένων φαρέων. βοᾷ	-uu- u- u-	lyric	
δʼ ἐκκενουμένα πόλις,	-u-u- u-	lyric	
λαΐδος ὀλλυμένας μιξοθρόου·	-uu -uu- -uu-	anapaestic	
βαρείας τοι τύχας προταρβῶ.	u-- - u- u--	lyric	
κλαυτὸν δʼ ἀρτιτρόποις ὠμοδρόποις	-- -uu- -uu-	anapaestic	
νομίμων προπάροιθεν διαμεῖψαι	uu- uu-- uu--	anapaestic	
δωμάτων στυγερὰν ὁδόν·	-u- uu- u-	lyric	
τί; τὸν φθίμενον γὰρ προλέγω	u - uu- - uu-	lyric	
βέλτερα τῶνδε πράσσειν·	-uu -u --	lyric	
πολλὰ γάρ, εὖτε πτόλις δαμασθῇ,	-u u -- u- u--	lyric	
ἒ ἔ, δυστυχῆ τε πράσσει.	u u -u- u --	lyric	
ἄλλος δʼ ἄλλον ἄγει, φονεύ-	-- -u u- u-	lyric	
ει, τὰ δὲ πυρφορεῖ· καπνῷ	- u u -u- u-	lyric	
χραίνεται πόλισμʼ ἅπαν·	-u- u- u-	lyric	
μαινόμενος δʼ ἐπιπνεῖ λαοδάμας	-uu- uu- -uu-	anapaestic	
μιαίνων εὐσέβειαν Ἄρης.	u-- -u-u --	lyric	
κορκορυγαὶ δʼ ἀνʼ ἄστυ, προτὶ δʼ ὁρκάνα	-uu- u -u uu -u-	lyric	
πυργῶτις· πρὸς ἀνδρὸς δʼ ἀνὴρ	--- u -- u-	lyric	
<ἀμφὶ> δορὶ κλίνεται·	-u uu -u-	lyric	
βλαχαὶ δʼ αἱματόεσσαι	-- -uu--	lyric	
τῶν ἐπιμαστιδίων	- uu-uu-	lyric	
ἀρτιτρεφεῖς βρέμονται.	-uu- u--	lyric	
ἁρπαγαὶ δὲ διαδρομᾶν ὁμαίμονες·	-u- u uuu- u-u-	lyric	
ξυμβολεῖ φέρων φέροντι,	-u- u- u--	lyric	
καὶ κενὸς κενὸν καλεῖ,	- u- u- u-	lyric	
ξύννομον θέλων ἔχειν,	-u- u- u-	lyric	
οὔτε μεῖον οὔτʼ ἴσον λελιμμένοι.	-u -u - u- u-u-	lyric	
τὰ δʼ ἐκ τῶνδʼ εἰκάσαι λόγος πάρα.	u - - -u- u- u-	lyric	
παντοδαπὸς δὲ καρπὸς χαμάδις πεσὼν	-uu- u -- uu- u-	lyric	
ἀλγύνει κυρήσας· πικρὸν	--- u-- u-	lyric	
δʼ ὄμμα θαλαμηπόλων·	-u uu-u-	lyric	
πολλὰ δʼ ἀκριτόφυρτος	-u -uu--	lyric	
γᾶς δόσις οὐτιδανοῖς	- uu -uu-	lyric	
ἐν ῥοθίοις φορεῖται.	- uu- u--	lyric	
δμωίδες δὲ καινοπήμονες νέαι·	-u- u -u-u- u-	lyric	
τλάμονʼ εὐνὰν αἰχμάλωτον	-u -- -u--	lyric	
ἀνδρὸς εὐτυχοῦντος ὣς	-u -u-u -	lyric	
δυσμενοῦς ὑπερτέρου	-u- u-u-	lyric	
ἐλπίς ἐστι νύκτερον τέλος μολεῖν,	-u -u -u- u- u-	lyric	
παγκλαύτων ἀλγέων ἐπίρροθον.	--- -u- u-u-	lyric	
ὅ τοι κατόπτης, ὡς ἐμοὶ δοκεῖ, στρατοῦ	u - u-- - u- u- u-	iambic trimeter (tragic)	
πευθώ τινʼ ἡμῖν, ὦ φίλαι, νέαν φέρει,	-- u -- - u- u- u-	iambic trimeter (tragic)	
σπουδῇ διώκων πομπίμους χνόας ποδῶν.	-- u-- -u- u- u-	iambic trimeter (tragic)	
καὶ μὴν ἄναξ ὅδʼ αὐτὸς Οἰδίπου τόκος	- - u- u -u -u- u-	iambic trimeter (tragic)	
εἰς ἀρτίκολλον ἀγγέλου λόγον μαθεῖν·	- -u-u -u- u- u-	iambic trimeter (tragic)	
σπουδὴ δὲ καὶ τοῦδʼ οὐκ ἀπαρτίζει πόδα.	-- u - - - u--- u-	iambic trimeter (tragic)	
λέγοιμʼ ἂν εἰδὼς εὖ τὰ τῶν ἐναντίων,	u- u -- - u - u-u-	iambic trimeter (tragic)	
ὥς τʼ ἐν πύλαις ἕκαστος εἴληχεν πάλον.	- - u- u-u --- u-	iambic trimeter (tragic)	
Τυδεὺς μὲν ἤδη πρὸς πύλαισι Προιτίσιν	-- u -- - u-u -u-	iambic trimeter (tragic)	
βρέμει, πόρον δʼ Ἰσμηνὸν οὐκ ἐᾷ περᾶν	u- u- --u - u- u-	iambic trimeter (tragic)	
ὁ μάντις· οὐ γὰρ σφάγια γίγνεται καλά.	u -u - - uuu -u- u-	lyric	
Τυδεὺς δὲ μαργῶν καὶ μάχης λελιμμένος	-- u -- - u- u-u-	iambic trimeter (tragic)	
μεσημβριναῖς κλαγγαῖσιν ὡς δράκων βοᾷ·	u-u- --u - u- u-	iambic trimeter (tragic)	
θείνει δʼ ὀνείδει μάντιν Οἰκλείδην σοφόν,	-- u-- -u --- u-	iambic trimeter (tragic)	
σαίνειν μόρον τε καὶ μάχην ἀψυχίᾳ.	-- u- u - u- --u-	iambic trimeter (tragic)	
τοιαῦτʼ ἀυτῶν τρεῖς κατασκίους λόφους	-- u-- - u-u- u-	iambic trimeter (tragic)	
σείει, κράνους χαίτωμʼ, ὑπʼ ἀσπίδος δʼ ἔσω	-- u- -- u -u- u-	iambic trimeter (tragic)	
χαλκήλατοι κλάζουσι κώδωνες φόβον·	--u- --u --- u-	iambic trimeter (tragic)	
ἔχει δʼ ὑπέρφρον σῆμʼ ἐπʼ ἀσπίδος τόδε,	u- u-- - u -u- u-	iambic trimeter (tragic)	
φλέγονθʼ ὑπʼ ἄστροις οὐρανὸν τετυγμένον·	u- u -- -u- u-u-	iambic trimeter (tragic)	
λαμπρὰ δὲ πανσέληνος ἐν μέσῳ σάκει,	-- u -u-u - u- u-	iambic trimeter (tragic)	
πρέσβιστον ἄστρων, νυκτὸς ὀφθαλμός, πρέπει.	--u -- -u --- u-	iambic trimeter (tragic)	
τοιαῦτʼ ἀλύων ταῖς ὑπερκόμποις σαγαῖς	-- u-- - u--- u-	iambic trimeter (tragic)	
βοᾷ παρʼ ὄχθαις ποταμίαις, μάχης ἐρῶν,	u- u -- uuu- u- u-	lyric	
ἵππος χαλινῶν ὣς κατασθμαίνων μένει,	-- u-- - u--- u-	iambic trimeter (tragic)	
ὅστις βοὴν σάλπιγγος ὁρμαίνει μένων.	-- u- --u --- u-	iambic trimeter (tragic)	
τίνʼ ἀντιτάξεις τῷδε; τίς Προίτου πυλῶν	u -u-- -u - -- u-	iambic trimeter (tragic)	
κλῄθρων λυθέντων προστατεῖν φερέγγυος;	-- u-- -u- u-u-	iambic trimeter (tragic)	
κόσμον μὲν ἀνδρὸς οὔτινʼ ἂν τρέσαιμʼ ἐγώ,	-- u -u -u - u- u-	iambic trimeter (tragic)	
οὐδʼ ἑλκοποιὰ γίγνεται τὰ σήματα·	- -u-u -u- u -u-	iambic trimeter (tragic)	
λόφοι δὲ κώδων τʼ οὐ δάκνουσʼ ἄνευ δορός.	u- u -- - u- u- u-	iambic trimeter (tragic)	
καὶ νύκτα ταύτην ἣν λέγεις ἐπʼ ἀσπίδος	- -u -- - u- u -u-	iambic trimeter (tragic)	
ἄστροισι μαρμαίρουσαν οὐρανοῦ κυρεῖν,	--u ---u -u- u-	iambic trimeter (tragic)	
τάχʼ ἂν γένοιτο μάντις ἁνοία τινί.	u - u-u -u --- u-	iambic trimeter (tragic)	
εἰ γὰρ θανόντι νὺξ ἐπʼ ὀφθαλμοῖς πέσοι,	- - u-u - u --- u-	iambic trimeter (tragic)	
τῷ τοι φέροντι σῆμʼ ὑπέρκομπον τόδε	- - u-u - u--- u-	iambic trimeter (tragic)	
γένοιτʼ ἂν ὀρθῶς ἐνδίκως τʼ ἐπώνυμον,	u- u -- -u- u-u-	iambic trimeter (tragic)	
καὐτὸς καθʼ αὑτοῦ τήνδʼ ὕβριν μαντεύσεται.	-- u -- - u- --u-	iambic trimeter (tragic)	
ἐγὼ δὲ Τυδεῖ κεδνὸν Ἀστακοῦ τόκον	u- u -- -u -u- u-	iambic trimeter (tragic)	
τῶνδʼ ἀντιτάξω προστάτην πυλωμάτων,	- -u-- -u- u-u-	iambic trimeter (tragic)	
μάλʼ εὐγενῆ τε καὶ τὸν Αἰσχύνης θρόνον	u -u- u - u --- u-	iambic trimeter (tragic)	
τιμῶντα καὶ στυγοῦνθʼ ὑπέρφρονας λόγους.	--u - u- u-u- u-	iambic trimeter (tragic)	
αἰσχρῶν γὰρ ἀργός, μὴ κακὸς δʼ εἶναι φιλεῖ.	-- u -- - u- -- u-	iambic trimeter (tragic)	
σπαρτῶν δʼ ἀπʼ ἀνδρῶν, ὧν Ἄρης ἐφείσατο,	-- u -- - u- u-u-	iambic trimeter (tragic)	
ῥίζωμʼ ἀνεῖται, κάρτα δʼ ἔστʼ ἐγχώριος,	-- u-- -u - --u-	iambic trimeter (tragic)	
Μελάνιππος· ἔργον δʼ ἐν κύβοις Ἄρης κρινεῖ·	uu-u -- - u- u- u-	iambic trimeter (tragic)	
Δίκη δʼ ὁμαίμων κάρτα νιν προστέλλεται	u- u-- -u - --u-	iambic trimeter (tragic)	
εἴργειν τεκούσῃ μητρὶ πολέμιον δόρυ.	-- u-- -u uuu- u-	lyric	
τὸν ἁμόν νυν ἀντίπαλον εὐτυχεῖν	u -- u -uuu -u-	lyric	
θεοὶ δοῖεν, ὡς δικαίως πόλεως	u- -u - u-- u-	lyric	
πρόμαχος ὄρνυται· τρέμω δʼ αἱματη-	uuu -u- u- -u-	lyric	
φόρους μόρους ὑπὲρ φίλων	u- u- u- u-	lyric	
ὀλομένων ἰδέσθαι.	uuu- u--	lyric	
τούτῳ μὲν οὕτως εὐτυχεῖν δοῖεν θεοί·	-- u -- -u- -- u-	iambic trimeter (tragic)	
Καπανεὺς δʼ ἐπʼ Ἠλέκτραισιν εἴληχεν πύλαις,	uu- u ---u --- u-	iambic trimeter (tragic)	
γίγας ὅδʼ ἄλλος τοῦ πάρος λελεγμένου	u- u -- - u- u-u-	iambic trimeter (tragic)	
μείζων, ὁ κόμπος δʼ οὐ κατʼ ἄνθρωπον φρονεῖ,	-- u -- - u --- u-	iambic trimeter (tragic)	
πύργοις δʼ ἀπειλεῖ δείνʼ, ἃ μὴ κραίνοι τύχη·	-- u-- - u - -- u-	iambic trimeter (tragic)	
θεοῦ τε γὰρ θέλοντος ἐκπέρσειν πόλιν	u- u - u-u --- u-	iambic trimeter (tragic)	
καὶ μὴ θέλοντός φησιν, οὐδὲ τὴν Διὸς	- - u-- -u -u - u-	iambic trimeter (tragic)	
ἔριν πέδοι σκήψασαν ἐμποδὼν σχεθεῖν.	u- u- --u -u- u-	iambic trimeter (tragic)	
τὰς δʼ ἀστραπάς τε καὶ κεραυνίους βολὰς	- -u- u - u-u- u-	iambic trimeter (tragic)	
μεσημβρινοῖσι θάλπεσιν προσῄκασεν·	u-u-u -u- u-u-	iambic trimeter (tragic)	
ἔχει δὲ σῆμα γυμνὸν ἄνδρα πυρφόρον,	u- u -u -u -u -u-	iambic trimeter (tragic)	
φλέγει δὲ λαμπὰς διὰ χερῶν ὡπλισμένη·	u- u -- uu u- --u-	lyric	
χρυσοῖς δὲ φωνεῖ γράμμασιν πρήσω πόλιν.	-- u -- -u- -- u-	iambic trimeter (tragic)	
τοιῷδε φωτὶ πέμπε— τίς ξυστήσεται,	--u -u -u - --u-	iambic trimeter (tragic)	
τίς ἄνδρα κομπάζοντα μὴ τρέσας μενεῖ;	u -u ---u - u- u-	iambic trimeter (tragic)	
καὶ τῷδε κέρδει κέρδος ἄλλο τίκτεται.	- -u -- -u -u -u-	iambic trimeter (tragic)	
τῶν τοι ματαίων ἀνδράσιν φρονημάτων	- - u-- -u- u-u-	iambic trimeter (tragic)	
ἡ γλῶσσʼ ἀληθὴς γίγνεται κατήγορος·	- - u-- -u- u-u-	iambic trimeter (tragic)	
Καπανεὺς δʼ ἀπειλεῖ, δρᾶν παρεσκευασμένος,	uu- u-- - u---u-	iambic trimeter (tragic)	
θεοὺς ἀτίζων, κἀπογυμνάζων στόμα	u- u-- -u--- u-	iambic trimeter (tragic)	
χαρᾷ ματαίᾳ θνητὸς ὢν εἰς οὐρανὸν	u- u-- -u - - -u-	iambic trimeter (tragic)	
πέμπει γεγωνὰ Ζηνὶ κυμαίνοντʼ ἔπη·	-- u-- -u --- u-	iambic trimeter (tragic)	
πέποιθα δʼ αὐτῷ ξὺν δίκῃ τὸν πυρφόρον	u-u -- - u- - -u-	iambic trimeter (tragic)	
ἥξειν κεραυνόν, οὐδὲν ἐξῃκασμένον	-- u-u -u ---u-	iambic trimeter (tragic)	
μεσημβρινοῖσι θάλπεσιν τοῖς ἡλίου.	u-u-u -u- - -u-	iambic trimeter (tragic)	
ἀνὴρ δʼ ἐπʼ αὐτῷ, κεἰ στόμαργός ἐστʼ ἄγαν,	u- u -- - u-u - u-	iambic trimeter (tragic)	
αἴθων τέτακται λῆμα, Πολυφόντου βία,	-- u-- -u uu-- u-	lyric	
φερέγγυον φρούρημα, προστατηρίας	u-u- --u -u-u-	iambic trimeter (tragic)	
Ἀρτέμιδος εὐνοίαισι σύν τʼ ἄλλοις θεοῖς.	-uuu ---u - -- u-	lyric	
λέγʼ ἄλλον ἄλλαις ἐν πύλαις εἰληχότα.	u -u -- - u- --u-	iambic trimeter (tragic)	
ὄλοιθʼ ὃς πόλει μεγάλʼ ἐπεύχεται,	u- - u- uu u-u-	lyric	
κεραυνοῦ δέ νιν βέλος ἐπισχέθοι,	u-- u - uu u-u-	lyric	
πρὶν ἐμὸν ἐσθορεῖν δόμον, πωλικῶν	u uu -u- u- -u-	lyric	
θʼ ἑδωλίων ὑπερκόπῳ	u-u- u-u-	lyric	
δορί ποτʼ ἐκλαπάξαι.	uu u -u--	lyric	
καὶ μὴν τὸν ἐντεῦθεν λαχόντα πρὸς πύλαις	- - u --- u-u - u-	iambic trimeter (tragic)	
λέξω· τρίτῳ γὰρ Ἐτεόκλῳ τρίτος πάλος	-- u- u uuu- u- u-	lyric	
ἐξ ὑπτίου ʼπήδησεν εὐχάλκου κράνους,	- -u- --u --- u-	iambic trimeter (tragic)	
πύλαισι Νηίστῃσι προσβαλεῖν λόχον.	u-u ---u -u- u-	iambic trimeter (tragic)	
ἵππους δʼ ἐν ἀμπυκτῆρσιν ἐμβριμωμένας	-- u ---u ---u-	iambic trimeter (tragic)	
δινεῖ, θελούσας πρὸς πύλαις πεπτωκέναι.	-- u-- - u- --u-	iambic trimeter (tragic)	
φιμοὶ δὲ συρίζουσι βάρβαρον τρόπον,	-- u ---u -u- u-	iambic trimeter (tragic)	
μυκτηροκόμποις πνεύμασιν πληρούμενοι.	--u-- -u- --u-	iambic trimeter (tragic)	
ἐσχημάτισται δʼ ἀσπὶς οὐ σμικρὸν τρόπον·	--u-- -u - u- u-	iambic trimeter (tragic)	
ἀνὴρ ὁπλίτης κλίμακος προσαμβάσεις	u- u-- -u- u-u-	iambic trimeter (tragic)	
στείχει πρὸς ἐχθρῶν πύργον, ἐκπέρσαι θέλων.	-- u -- -u --- u-	iambic trimeter (tragic)	
βοᾷ δὲ χοὖτος γραμμάτων ἐν ξυλλαβαῖς,	u- u -- -u- - -u-	iambic trimeter (tragic)	
ὡς οὐδʼ ἂν Ἄρης σφʼ ἐκβάλοι πυργωμάτων.	- - u -- -u- --u-	iambic trimeter (tragic)	
καὶ τῷδε φωτὶ πέμπε τὸν φερέγγυον	- -u -u -u - u-u-	iambic trimeter (tragic)	
πόλεως ἀπείργειν τῆσδε δούλιον ζυγόν.	u- u-- -u -u- u-	iambic trimeter (tragic)	
πέμποιμʼ ἂν ἤδη τόνδε, σὺν τύχῃ δέ τῳ·	-- u -- -u - u- u -	iambic trimeter (tragic)	
καὶ δὴ πέπεμπται κόμπον ἐν χεροῖν ἔχων,	- - u-- -u - u- u-	iambic trimeter (tragic)	
Μεγαρεύς, Κρέοντος σπέρμα τοῦ σπαρτῶν γένους,	uu- u-- -u - -- u-	iambic trimeter (tragic)	
ὃς οὔτι μάργων ἱππικῶν φρυαγμάτων	u -u -- -u- u-u-	iambic trimeter (tragic)	
βρόμον φοβηθεὶς ἐκ πυλῶν χωρήσεται,	u- u-- - u- --u-	iambic trimeter (tragic)	
ἀλλʼ ἢ θανὼν τροφεῖα πληρώσει χθονί,	- - u- u-u --- u-	iambic trimeter (tragic)	
ἢ καὶ δύʼ ἄνδρε καὶ πόλισμʼ ἐπʼ ἀσπίδος	- - u -u - u- u -u-	iambic trimeter (tragic)	
ἑλὼν λαφύροις δῶμα κοσμήσει πατρός.	u- u-- -u --- u-	iambic trimeter (tragic)	
κόμπαζʼ ἐπʼ ἄλλῳ, μηδέ μοι φθόνει λέγων.	-- u -- -u - u- u-	iambic trimeter (tragic)	
ἐπεύχομαι τῷδε μὲν εὐτυχεῖν, ἰὼ	u-u- -u u -u- u-	lyric	
πρόμαχʼ ἐμῶν δόμων, τοῖσι δὲ δυστυχεῖν.	uu u- u- -u u -u-	lyric	
ὡς δʼ ὑπέραυχα βάζουσιν ἐπὶ πτόλει	- uu-u --u u- u-	lyric	
μαινομένᾳ φρενί, τώς νιν	-uu- uu - -	lyric	
Ζεὺς νεμέτωρ ἐπίδοι κοταίνων.	- uu- uu- u--	lyric	
τέταρτος ἄλλος, γείτονας πύλας ἔχων	u-u -- -u- u- u-	iambic trimeter (tragic)	
Ὄγκας Ἀθάνας, ξὺν βοῇ παρίσταται,	-- u-- - u- u-u-	iambic trimeter (tragic)	
Ἱππομέδοντος σχῆμα καὶ μέγας τύπος·	--u-- -u - u- u-	iambic trimeter (tragic)	
ἅλω δὲ πολλήν, ἀσπίδος κύκλον λέγω,	u- u -- -u- u- u-	iambic trimeter (tragic)	
ἔφριξα δινήσαντος· οὐκ ἄλλως ἐρῶ.	u-u ---u - -- u-	iambic trimeter (tragic)	
ὁ σηματουργὸς δʼ οὔ τις εὐτελὴς ἄρʼ ἦν	u -u-- - u -u- u -	iambic trimeter (tragic)	
ὅστις τόδʼ ἔργον ὤπασεν πρὸς ἀσπίδι,	-- u -u -u- u -u-	iambic trimeter (tragic)	
Τυφῶνʼ ἱέντα πύρπνοον διὰ στόμα	u- u-u -u- u- u-	iambic trimeter (tragic)	
λιγνὺν μέλαιναν, αἰόλην πυρὸς κάσιν·	-- u-u -u- u- u-	iambic trimeter (tragic)	
ὄφεων δὲ πλεκτάναισι περίδρομον κύτος	uu- u -u-u uuu- u-	lyric	
προσηδάφισται κοιλογάστορος κύκλου.	u-u-- -u-u- u-	iambic trimeter (tragic)	
αὐτὸς δʼ ἐπηλάλαξεν, ἔνθεος δʼ Ἄρει	-- u-u-u -u- u-	iambic trimeter (tragic)	
βακχᾷ πρὸς ἀλκὴν Θυιὰς ὣς φόβον βλέπων.	-- u -- -u - u- u-	iambic trimeter (tragic)	
τοιοῦδε φωτὸς πεῖραν εὖ φυλακτέον·	--u -- -u - u-u-	iambic trimeter (tragic)	
Φόβος γὰρ ἤδη πρὸς πύλαις κομπάζεται.	u- u -- - u- --u-	iambic trimeter (tragic)	
πρῶτον μὲν Ὄγκα Παλλάς, ἥτʼ ἀγχίπτολις,	-- u -u -u - --u-	iambic trimeter (tragic)	
πύλαισι γείτων, ἀνδρὸς ἐχθαίρουσʼ ὕβριν,	u-u -- -u --- u-	iambic trimeter (tragic)	
εἴρξει νεοσσῶν ὣς δράκοντα δύσχιμον·	-- u-- - u-u -u-	iambic trimeter (tragic)	
Ὑπέρβιος δέ, κεδνὸς Οἴνοπος τόκος,	u-u- u -u -u- u-	iambic trimeter (tragic)	
ἀνὴρ κατʼ ἄνδρα τοῦτον ᾑρέθη, θέλων	u- u -u -u -u- u-	iambic trimeter (tragic)	
ἐξιστορῆσαι μοῖραν ἐν χρείᾳ τύχης,	--u-- -u - -- u-	iambic trimeter (tragic)	
οὔτʼ εἶδος οὔτε θυμὸν οὐδʼ ὅπλων σχέσιν	- -u -u -u - u- u-	iambic trimeter (tragic)	
μωμητός, Ἑρμῆς δʼ εὐλόγως ξυνήγαγεν.	--u -- -u- u-u-	iambic trimeter (tragic)	
ἐχθρὸς γὰρ ἁνὴρ ἀνδρὶ τῷ ξυστήσεται,	-- u -- -u - --u-	iambic trimeter (tragic)	
ξυνοίσετον δὲ πολεμίους ἐπʼ ἀσπίδων	u-u- u uuu- u -u-	lyric	
θεούς· ὁ μὲν γὰρ πύρπνοον Τυφῶνʼ ἔχει,	u- u - - -u- -- u-	iambic trimeter (tragic)	
Ὑπερβίῳ δὲ Ζεὺς πατὴρ ἐπʼ ἀσπίδος	u-u- - - u- u -u-	iambic trimeter (tragic)	
σταδαῖος ἧσται, διὰ χερὸς βέλος φλέγων·	u-u -- uu u- u- u-	lyric	
κοὔπω τις εἶδε Ζῆνά που νικώμενον.	-- u -- -u - u-u-	iambic trimeter (tragic)	
τοιάδε μέντοι προσφίλεια δαιμόνων·	--u -- -u-u -u-	iambic trimeter (tragic)	
πρὸς τῶν κρατούντων δʼ ἐσμέν, οἱ δʼ ἡσσωμένων,	- - u-- -u - --u-	iambic trimeter (tragic)	
εἰ Ζεύς γε Τυφῶ καρτερώτερος μάχῃ·	- - u -- -u-u- u-	iambic trimeter (tragic)	
εἰκὸς δὲ πράξειν ἄνδρας ὧδʼ ἀντιστάτας,	-- u -- -u - --u-	iambic trimeter (tragic)	
Ὑπερβίῳ τε πρὸς λόγον τοῦ σήματος	u-u- u - u- - -u-	iambic trimeter (tragic)	
σωτὴρ γένοιτʼ ἂν Ζεὺς ἐπʼ ἀσπίδος τυχών.	-- u- - - u -u- u-	iambic trimeter (tragic)	
πέποιθα <δὴ> τὸν Διὸς ἀντίτυπον ἔχοντʼ	u-u - - uu -uuu u-	lyric	
ἄφιλον ἐν σάκει τοῦ χθονίου δέμας	uuu - u- - uu- u-	lyric	
δαίμονος, ἐχθρὸν εἴκασμα βροτοῖς τε καὶ	-uu -u --u u- u -	lyric	
δαροβίοισι θεοῖσιν,	-uu-u u--	lyric	
πρόσθε πυλᾶν κεφαλὰν ἰάψειν.	-u u- uu- u--	lyric	
οὕτως γένοιτο. τὸν δὲ πέμπτον αὖ λέγω,	-- u-u - u -u - u-	iambic trimeter (tragic)	
πέμπταισι προσταχθέντα Βορραίαις πύλαις,	--u ---u --- u-	iambic trimeter (tragic)	
τύμβον κατʼ αὐτὸν Διογενοῦς Ἀμφίονος·	-- u -- uuu- --u-	lyric	
ὄμνυσι δʼ αἰχμὴν ἣν ἔχει μᾶλλον θεοῦ	--u -- - u- -- u-	iambic trimeter (tragic)	
σέβειν πεποιθὼς ὀμμάτων θʼ ὑπέρτερον,	u- u-- -u- u-u-	iambic trimeter (tragic)	
ἦ μὴν λαπάξειν ἄστυ Καδμείων βίᾳ	- - u-- -u --- u-	iambic trimeter (tragic)	
Διός· τόδʼ αὐδᾷ μητρὸς ἐξ ὀρεσκόου	u- u -- -u - u-u-	iambic trimeter (tragic)	
βλάστημα καλλίπρῳρον, ἀνδρόπαις ἀνήρ·	--u -u-u -u- u-	iambic trimeter (tragic)	
στείχει δʼ ἴουλος ἄρτι διὰ παρηίδων,	-- u-u -u uu u-u-	lyric	
ὥρας φυούσης, ταρφὺς ἀντέλλουσα θρίξ.	-- u-- -u ---u -	iambic trimeter (tragic)	
ὁ δʼ ὠμόν, οὔτι παρθένων ἐπώνυμον,	u -u -u -u- u-u-	iambic trimeter (tragic)	
φρόνημα, γοργὸν δʼ ὄμμʼ ἔχων, προσίσταται.	u-u -- - u- u-u-	iambic trimeter (tragic)	
οὐ μὴν ἀκόμπαστός γʼ ἐφίσταται πύλαις·	- - u--- u-u- u-	iambic trimeter (tragic)	
τὸ γὰρ πόλεως ὄνειδος ἐν χαλκηλάτῳ	u - u- u-u - --u-	iambic trimeter (tragic)	
σάκει, κυκλωτῷ σώματος προβλήματι,	u- u-- -u- u-u-	iambic trimeter (tragic)	
Σφίγγʼ ὠμόσιτον προσμεμηχανημένην	- -u-- -u-u-u-	iambic trimeter (tragic)	
γόμφοις ἐνώμα, λαμπρὸν ἔκκρουστον δέμας,	-- u-u -u --- u-	iambic trimeter (tragic)	
φέρει δʼ ὑφʼ αὑτῇ φῶτα Καδμείων ἕνα,	u- u -- -u --- u-	iambic trimeter (tragic)	
ὡς πλεῖστʼ ἐπʼ ἀνδρὶ τῷδʼ ἰάπτεσθαι βέλη.	- - u -u - u--- u-	iambic trimeter (tragic)	
ἐλθὼν δʼ ἔοικεν οὐ καπηλεύσειν μάχην,	-- u-u - u--- u-	iambic trimeter (tragic)	
μακρᾶς κελεύθου δʼ οὐ καταισχυνεῖν πόρον,	u- u-- - u--- u-	iambic trimeter (tragic)	
ὁ Παρθενοπαῖος Ἀρκάς· ὁ δὲ τοιόσδʼ ἀνὴρ	u -uu-u -u u u -- u-	lyric	
μέτοικος, Ἄργει δʼ ἐκτίνων καλὰς τροφάς,	u-u -- -u- u- u-	iambic trimeter (tragic)	
πύργοις ἀπειλεῖ τοῖσδʼ ἃ μὴ κραίνοι θεός.	-- u-- - u - -- u-	iambic trimeter (tragic)	
εἰ γὰρ τύχοιεν ὧν φρονοῦσι πρὸς θεῶν,	- - u-u - u-u - u-	iambic trimeter (tragic)	
αὐτοῖς ἐκείνοις ἀνοσίοις κομπάσμασιν·	-- u-- uuu- --u-	lyric	
ἦ τἂν πανώλεις παγκάκως τʼ ὀλοίατο.	- - u-- -u- u-u-	iambic trimeter (tragic)	
ἔστιν δὲ καὶ τῷδʼ, ὃν λέγεις τὸν Ἀρκάδα,	-- u - - - u- u -u-	iambic trimeter (tragic)	
ἀνὴρ ἄκομπος, χεὶρ δʼ ὁρᾷ τὸ δράσιμον,	u- u-- - u- u -u-	iambic trimeter (tragic)	
Ἄκτωρ ἀδελφὸς τοῦ πάρος λελεγμένου·	-- u-- - u- u-u-	iambic trimeter (tragic)	
ὃς οὐκ ἐάσει γλῶσσαν ἐργμάτων ἄτερ	u - u-- -u -u- u-	iambic trimeter (tragic)	
ἔσω πυλῶν ῥέουσαν ἀλδαίνειν κακά,	u- u- u-u --- u-	iambic trimeter (tragic)	
οὐδʼ εἰσαμεῖψαι θηρὸς ἐχθίστου δάκους	- -u-- -u --- u-	iambic trimeter (tragic)	
εἰκὼ φέροντα πολεμίας ἐπʼ ἀσπίδος·	-- u-u uuu- u -u-	lyric	
ἣ ʼξωθεν εἴσω τῷ φέροντι μέμψεται,	- -u -- - u-u -u-	iambic trimeter (tragic)	
πυκνοῦ κροτησμοῦ τυγχάνουσʼ ὑπὸ πτόλιν.	u- u-- -u- u- u-	iambic trimeter (tragic)	
θεῶν θελόντων τἂν ἀληθεύσαιμʼ ἐγώ.	u- u-- - u--- u-	iambic trimeter (tragic)	
ἱκνεῖται λόγος διὰ στηθέων,	--- u- u- -u-	lyric	
τριχὸς δʼ ὀρθίας πλόκαμος ἵσταται,	u- -u- uuu -u-	lyric	
μεγάλα μεγαληγόρων κλυούσᾳ	uuu uu-u- u--	lyric	
ἀνοσίων ἀνδρῶν. εἴθε γὰρ θεοὶ	uuu- -- -u - u-	lyric	
τοῦδʼ ὀλέσειαν ἐν γᾷ.	- uu-u - -	lyric	
ἕκτον λέγοιμʼ ἂν ἄνδρα σωφρονέστατον,	-- u- u -u -u-u-	iambic trimeter (tragic)	
ἀλκήν τʼ ἄριστον μάντιν, Ἀμφιάρεω βίαν·	-- u-- -u -uu- u-	iambic trimeter (tragic)	
Ὁμολωίσιν δὲ πρὸς πύλαις τεταγμένος	uu-u- u - u- u-u-	iambic trimeter (tragic)	
κακοῖσι βάζει πολλὰ Τυδέως βίαν·	u-u -- -u -u- u-	iambic trimeter (tragic)	
τὸν ἀνδροφόντην, τὸν πόλεως ταράκτορα,	u -u-- - u- u-u-	iambic trimeter (tragic)	
μέγιστον Ἄργει τῶν κακῶν διδάσκαλον,	u-u -- - u- u-u-	iambic trimeter (tragic)	
Ἐρινύος κλητῆρα, πρόσπολον φόνου,	u-u- --u -u- u-	iambic trimeter (tragic)	
κακῶν τʼ Ἀδράστῳ τῶνδε βουλευτήριον.	u- u-- -u ---u-	iambic trimeter (tragic)	
καὶ τὸν σὸν αὖθις προσθροῶν ὁμόσπορον,	- - u -- -u- u-u-	iambic trimeter (tragic)	
ἐξυπτιάζων ὄμμα, Πολυνείκους βίαν,	--u-- -u uu-- u-	lyric	
δίς τʼ ἐν τελευτῇ τοὔνομʼ ἐνδατούμενος,	- - u-- -u -u-u-	iambic trimeter (tragic)	
καλεῖ. λέγει δὲ τοῦτʼ ἔπος διὰ στόμα·	u- u- u - u- u- u-	iambic trimeter (tragic)	
ἦ τοῖον ἔργον καὶ θεοῖσι προσφιλές,	- -u -- - u-u -u-	iambic trimeter (tragic)	
καλόν τʼ ἀκοῦσαι καὶ λέγειν μεθυστέροις,	u- u-- - u- u-u-	iambic trimeter (tragic)	
πόλιν πατρῴαν καὶ θεοὺς τοὺς ἐγγενεῖς	u- u-- - u- - -u-	iambic trimeter (tragic)	
πορθεῖν, στράτευμʼ ἐπακτὸν ἐμβεβληκότα;	-- u- u-u -u-u-	iambic trimeter (tragic)	
μητρός τε πηγὴν τίς κατασβέσει δίκη;	-- u -- - u-u- u-	iambic trimeter (tragic)	
πατρίς τε γαῖα σῆς ὑπὸ σπουδῆς δορὶ	u- u -u - u- -- u-	iambic trimeter (tragic)	
ἁλοῦσα πῶς σοι ξύμμαχος γενήσεται;	u-u - - -u- u-u-	iambic trimeter (tragic)	
ἔγωγε μὲν δὴ τήνδε πιανῶ χθόνα,	u-u - - -u -u- u-	iambic trimeter (tragic)	
μάντις κεκευθὼς πολεμίας ὑπὸ χθονός.	-- u-- uuu- u- u-	lyric	
μαχώμεθʼ, οὐκ ἄτιμον ἐλπίζω μόρον.	u-u - u-u --- u-	iambic trimeter (tragic)	
τοιαῦθʼ ὁ μάντις ἀσπίδʼ εὐκήλως ἔχων	-- u -u -u --- u-	iambic trimeter (tragic)	
πάγχαλκον ηὔδα· σῆμα δʼ οὐκ ἐπῆν κύκλῳ.	--u -- -u - u- u-	iambic trimeter (tragic)	
οὐ γὰρ δοκεῖν ἄριστος, ἀλλʼ εἶναι θέλει,	- - u- u-u - -- u-	iambic trimeter (tragic)	
βαθεῖαν ἄλοκα διὰ φρενὸς καρπούμενος,	u-u uuu uu u- --u-	lyric	
ἐξ ἧς τὰ κεδνὰ βλαστάνει βουλεύματα.	- - u -u -u- --u-	iambic trimeter (tragic)	
τούτῳ σοφούς τε κἀγαθοὺς ἀντηρέτας	-- u- u -u- --u-	iambic trimeter (tragic)	
πέμπειν ἐπαινῶ. δεινὸς ὃς θεοὺς σέβει.	-- u-- -u - u- u-	iambic trimeter (tragic)	
φεῦ τοῦ ξυναλλάσσοντος ὄρνιθος βροτοῖς	- - u---u --- u-	iambic trimeter (tragic)	
δίκαιον ἄνδρα τοῖσι δυσσεβεστέροις.	u-u -u -u -u-u-	iambic trimeter (tragic)	
ἐν παντὶ πράγει δʼ ἔσθʼ ὁμιλίας κακῆς	- -u -- - u-u- u-	iambic trimeter (tragic)	
κάκιον οὐδέν, καρπὸς οὐ κομιστέος·	u-u -- -u - u-u-	iambic trimeter (tragic)	
ἄτης ἄρουρα θάνατον ἐκκαρπίζεται.	u- u-u uuu ---u-	lyric	
ἢ γὰρ ξυνεισβὰς πλοῖον εὐσεβὴς ἀνὴρ	- - u-- -u -u- u-	iambic trimeter (tragic)	
ναύταισι θερμοῖς καὶ πανουργίᾳ τινὶ	--u -- - u-u- u-	iambic trimeter (tragic)	
ὄλωλεν ἀνδρῶν σὺν θεοπτύστῳ γένει,	u-u -- - u--- u-	iambic trimeter (tragic)	
ἢ ξὺν πολίταις ἀνδράσιν δίκαιος ὢν	- - u-- -u- u-u -	iambic trimeter (tragic)	
ἐχθροξένοις τε καὶ θεῶν ἀμνήμοσιν,	--u- u - u- --u-	iambic trimeter (tragic)	
ταὐτοῦ κυρήσας ἐκδίκως ἀγρεύματος,	-- u-- -u- u-u-	iambic trimeter (tragic)	
πληγεὶς θεοῦ μάστιγι παγκοίνῳ ʼδάμη.	-- u- --u --- u-	iambic trimeter (tragic)	
οὕτως δʼ ὁ μάντις, υἱὸν Οἰκλέους λέγω,	-- u -u -u -u- u-	iambic trimeter (tragic)	
σώφρων δίκαιος ἀγαθὸς εὐσεβὴς ἀνήρ,	-- u-u uuu -u- u-	lyric	
μέγας προφήτης, ἀνοσίοισι συμμιγεὶς	u- u-- uuu-u -u-	lyric	
θρασυστόμοισιν ἀνδράσιν βίᾳ φρενῶν,	u-u-u -u- u- u-	iambic trimeter (tragic)	
τείνουσι πομπὴν τὴν μακρὰν πάλιν μολεῖν,	--u -- - u- u- u-	iambic trimeter (tragic)	
Διὸς θέλοντος ξυγκαθελκυσθήσεται.	u- u-- -u---u-	iambic trimeter (tragic)	
δοκῶ μὲν οὖν σφε μηδὲ προσβαλεῖν πύλαις	u- u - u -u -u- u-	iambic trimeter (tragic)	
οὐχ ὡς ἄθυμος οὐδὲ λήματος κάκῇ,	- - u-u -u -u- u-	iambic trimeter (tragic)	
ἀλλʼ οἶδεν ὥς σφε χρὴ τελευτῆσαι μάχῃ,	- -u - u - u--- u-	iambic trimeter (tragic)	
εἰ καρπὸς ἔσται θεσφάτοισι Λοξίου·	- -u -- -u-u -u-	iambic trimeter (tragic)	
φιλεῖ δὲ σιγᾶν ἢ λέγειν τὰ καίρια.	u- u -- - u- u -u-	iambic trimeter (tragic)	
ὅμως δʼ ἐπʼ αὐτῷ φῶτα, Λασθένους βίαν,	u- u -- -u -u- u-	iambic trimeter (tragic)	
ἐχθρόξενον πυλωρὸν ἀντιτάξομεν,	--u- u-u -u-u-	iambic trimeter (tragic)	
γέροντα τὸν νοῦν, σάρκα δʼ ἡβῶσαν φύει,	u-u - - -u --- u-	iambic trimeter (tragic)	
ποδῶκες ὄμμα, χεῖρα δʼ οὐ βραδύνεται	u-u -u -u - u-u-	iambic trimeter (tragic)	
παρʼ ἀσπίδος γυμνωθὲν ἁρπάσαι δόρυ.	u -u- --u -u- u-	iambic trimeter (tragic)	
θεοῦ δὲ δῶρόν ἐστιν εὐτυχεῖν βροτούς.	u- u -u -u -u- u-	iambic trimeter (tragic)	
κλύοντες θεοὶ δικαίας λιτὰς	u-- u- u-- u-	lyric	
ἁμετέρας τελεῖθʼ, ὡς πόλις εὐτυχῇ,	-uu- u- - uu -u-	lyric	
δορίπονα κάκʼ ἐκτρέποντες <ἐς> γᾶς	uuuu u -u-u - -	lyric	
ἐπιμόλους· πύργων δʼ ἔκτοθεν βαλὼν	uuu- -- -u- u-	lyric	
Ζεύς σφε κάνοι κεραυνῷ.	- u u- u--	lyric	
τὸν ἕβδομον δὴ τόνδʼ ἐφʼ ἑβδόμαις πύλαις	u -u- - - u -u- u-	iambic trimeter (tragic)	
λέξω, τὸν αὐτοῦ σοῦ κασίγνητον, πόλει	-- u -- - u--- u-	iambic trimeter (tragic)	
οἵας ἀρᾶται καὶ κατεύχεται τύχας·	-- u-- - u-u- u-	iambic trimeter (tragic)	
πύργοις ἐπεμβὰς κἀπικηρυχθεὶς χθονί,	-- u-- -u--- u-	iambic trimeter (tragic)	
ἁλώσιμον παιᾶνʼ ἐπεξιακχάσας,	u-u- -- u-u-u-	iambic trimeter (tragic)	
σοὶ ξυμφέρεσθαι καὶ κτανὼν θανεῖν πέλας,	- -u-- - u- u- u-	iambic trimeter (tragic)	
ἢ ζῶντʼ ἀτιμαστῆρα τὼς ἀνδρηλάτην	- - u---u - --u-	iambic trimeter (tragic)	
φυγῇ τὸν αὐτὸν τόνδε τείσασθαι τρόπον.	u- u -- -u --- u-	iambic trimeter (tragic)	
τοιαῦτʼ ἀυτεῖ καὶ θεοὺς γενεθλίους	-- u-- - u- u-u-	iambic trimeter (tragic)	
καλεῖ πατρῴας γῆς ἐποπτῆρας λιτῶν	u- u-- - u--- u-	iambic trimeter (tragic)	
τῶν ὧν γενέσθαι πάγχυ Πολυνείκους βία.	- - u-- -u uu-- u-	lyric	
ἔχει δὲ καινοπηγὲς εὔκυκλον σάκος	u- u -u-u -u- u-	iambic trimeter (tragic)	
διπλοῦν τε σῆμα προσμεμηχανημένον.	u- u -u -u-u-u-	iambic trimeter (tragic)	
χρυσήλατον γὰρ ἄνδρα τευχηστὴν ἰδεῖν	--u- u -u --- u-	iambic trimeter (tragic)	
ἄγει γυνή τις σωφρόνως ἡγουμένη.	u- u- - -u- --u-	iambic trimeter (tragic)	
Δίκη δʼ ἄρʼ εἶναί φησιν, ὡς τὰ γράμματα	u- u -- -u - u -u-	iambic trimeter (tragic)	
λέγει κατάξω δʼ ἄνδρα τόνδε καὶ πόλιν	u- u-- -u -u - u-	iambic trimeter (tragic)	
ἕξει πατρῴων δωμάτων τʼ ἐπιστροφάς.	-- u-- -u- u-u-	iambic trimeter (tragic)	
τοιαῦτʼ ἐκείνων ἐστὶ τἀξευρήματα.	-- u-- -u ---u-	iambic trimeter (tragic)	
[σὺ δʼ αὐτὸς ἤδη γνῶθι τίνα πέμπειν δοκεῖ·	u -u -- -u uu -- u-	lyric	
ὡς οὔποτʼ ἀνδρὶ τῷδε κηρυκευμάτων	- -u -u -u -u-u-	iambic trimeter (tragic)	
μέμψῃ, σὺ δʼ αὐτὸς γνῶθι ναυκληρεῖν πόλιν.	-- u -- -u --- u-	iambic trimeter (tragic)	
ὦ θεομανές τε καὶ θεῶν μέγα στύγος,	- uuu- u - u- u- u-	lyric	
ὦ πανδάκρυτον ἁμὸν Οἰδίπου γένος·	- -u-u -u -u- u-	iambic trimeter (tragic)	
ὤμοι, πατρὸς δὴ νῦν ἀραὶ τελεσφόροι.	-- u- - - u- u-u-	iambic trimeter (tragic)	
ἀλλʼ οὔτε κλαίειν οὔτʼ ὀδύρεσθαι πρέπει,	- -u -- - u--- u-	iambic trimeter (tragic)	
μὴ καὶ τεκνωθῇ δυσφορώτερος γόος.	- - u-- -u-u- u-	iambic trimeter (tragic)	
ἐπωνύμῳ δὲ κάρτα, Πολυνείκει λέγω,	u-u- u -u uu-- u-	lyric	
τάχʼ εἰσόμεσθα τοὐπίσημʼ ὅποι τελεῖ,	u -u-u -u- u- u-	iambic trimeter (tragic)	
εἴ νιν κατάξει χρυσότευκτα γράμματα	- - u-- -u-u -u-	iambic trimeter (tragic)	
ἐπʼ ἀσπίδος φλύοντα σὺν φοίτῳ φρενῶν.	u -u- --u - -- u-	iambic trimeter (tragic)	
εἰ δʼ ἡ Διὸς παῖς παρθένος Δίκη παρῆν	- - u- - -u- u- u-	iambic trimeter (tragic)	
ἔργοις ἐκείνου καὶ φρεσίν, τάχʼ ἂν τόδʼ ἦν·	-- u-- - u- u - u -	iambic trimeter (tragic)	
ἀλλʼ οὔτε νιν φυγόντα μητρόθεν σκότον,	- -u - u-u -u- u-	iambic trimeter (tragic)	
οὔτʼ ἐν τροφαῖσιν, οὔτʼ ἐφηβήσαντά πω,	- - u-u - u---u -	iambic trimeter (tragic)	
οὔτʼ ἐν γενείου ξυλλογῇ τριχώματος,	- - u-- -u- u-u-	iambic trimeter (tragic)	
Δίκη προσεῖδε καὶ κατηξιώσατο·	u- u-u - u-u-u-	iambic trimeter (tragic)	
οὐδʼ ἐν πατρῴας μὴν χθονὸς κακουχίᾳ	- - u-- - u- u-u-	iambic trimeter (tragic)	
οἶμαί νιν αὐτῷ νῦν παραστατεῖν πέλας.	-- u -- - u-u- u-	iambic trimeter (tragic)	
ἦ δῆτʼ ἂν εἴη πανδίκως ψευδώνυμος	- - u -- -u- --u-	iambic trimeter (tragic)	
Δίκη, ξυνοῦσα φωτὶ παντόλμῳ φρένας.	u- u-u -u --- u-	iambic trimeter (tragic)	
τούτοις πεποιθὼς εἶμι καὶ ξυστήσομαι	-- u-- -u - --u-	iambic trimeter (tragic)	
αὐτός· τίς ἄλλος μᾶλλον ἐνδικώτερος;	-- u -- -u -u-u-	iambic trimeter (tragic)	
ἄρχοντί τʼ ἄρχων καὶ κασιγνήτῳ κάσις,	--u -- - u--- u-	iambic trimeter (tragic)	
ἐχθρὸς σὺν ἐχθρῷ στήσομαι. φέρʼ ὡς τάχος	-- u -- -u- u - u-	iambic trimeter (tragic)	
κνημῖδας, αἰχμῆς καὶ πέτρων προβλήματα.	--u -- - u- u-u-	iambic trimeter (tragic)	
μή, φίλτατʼ ἀνδρῶν, Οἰδίπου τέκος, γένῃ	- -u -- -u- u- u-	iambic trimeter (tragic)	
ὀργὴν ὁμοῖος τῷ κάκιστʼ αὐδωμένῳ·	-- u-- - u- --u-	iambic trimeter (tragic)	
ἀλλʼ ἄνδρας Ἀργείοισι Καδμείους ἅλις	- -u ---u --- u-	iambic trimeter (tragic)	
ἐς χεῖρας ἐλθεῖν· αἷμα γὰρ καθάρσιον.	- -u -- -u - u-u-	iambic trimeter (tragic)	
ἀνδροῖν δʼ ὁμαίμοιν θάνατος ὧδʼ αὐτοκτόνος,	-- u-- uuu - --u-	lyric	
οὐκ ἔστι γῆρας τοῦδε τοῦ μιάσματος.	- -u -- -u - u-u-	iambic trimeter (tragic)	
εἴπερ κακὸν φέροι τις, αἰσχύνης ἄτερ	-- u- u- u --- u-	iambic trimeter (tragic)	
ἔστω· μόνον γὰρ κέρδος ἐν τεθνηκόσι·	-- u- - -u - u-u-	iambic trimeter (tragic)	
κακῶν δὲ κᾀσχρῶν οὔτινʼ εὐκλείαν ἐρεῖς.	u- u -- -u --- u-	iambic trimeter (tragic)	
τί μέμονας, τέκνον; μή τί σε θυμοπλη-	u uu- u- - u u -u-	lyric	
θὴς δορίμαργος ἄτα φερέτω· κακοῦ δʼ	- uu-u -- uu- u-	lyric	
ἔκβαλʼ ἔρωτος ἀρχάν.	-u u-u --	lyric	
ἐπεὶ τὸ πρᾶγμα κάρτʼ ἐπισπέρχει θεός,	u- u -u - u--- u-	iambic trimeter (tragic)	
ἴτω κατʼ οὖρον κῦμα Κωκυτοῦ λαχὸν	u- u -- -u --- u-	iambic trimeter (tragic)	
Φοίβῳ στυγηθὲν πᾶν τὸ Λαΐου γένος.	-- u-- - u -u- u-	iambic trimeter (tragic)	
ὠμοδακής σʼ ἄγαν ἵμερος ἐξοτρύ-	-uu- u- -uu -u-	lyric	
νει πικρόκαρπον ἀνδροκτασίαν τελεῖν	- uu-u --uu- u-	lyric	
αἵματος οὐ θεμιστοῦ.	-uu - u--	lyric	
φίλου γὰρ ἐχθρά μοι πατρὸς τάλαινʼ ἀρὰ	u- u -u - u- u- u-	iambic trimeter (tragic)	
ξηροῖς ἀκλαύτοις ὄμμασιν προσιζάνει,	-- u-- -u- u-u-	iambic trimeter (tragic)	
λέγουσα κέρδος πρότερον ὑστέρου μόρου.	u-u -- uuu -u- u-	lyric	
ἀλλὰ σὺ μὴ ʼποτρύνου· κακὸς οὐ κεκλή-	-u u - u-- uu - u-	lyric	
σῃ βίον εὖ κυρήσας· μελάναιγις οὐκ	- uu - u-- uu-u -	lyric	
εἶσι δόμων Ἐρινύς, ὅταν ἐκ χερῶν	-u u- u-- uu - u-	lyric	
θεοὶ θυσίαν δέχωνται;	- uu- u--	lyric	
θεοῖς μὲν ἤδη πως παρημελήμεθα,	u- u -- - u-u-u-	iambic trimeter (tragic)	
χάρις δʼ ἀφʼ ἡμῶν ὀλομένων θαυμάζεται·	u- u -- uuu- --u-	lyric	
τί οὖν ἔτʼ ἂν σαίνοιμεν ὀλέθριον μόρον;	u - u - --u uuu- u-	lyric	
νῦν ὅτε σοι παρέστακεν· ἐπεὶ δαίμων	- uu - u--u u- --	lyric	
λήματος ἐν τροπαίᾳ χρονίᾳ μεταλ-	-uu - u-- uu- u-	lyric	
λακτὸς ἴσως ἂν ἔλθοι θελεμωτέρῳ	-u u- u -- uu-u-	lyric	
πνεύματι· νῦν δʼ ἔτι ζεῖ.	-uu - u- -	lyric	
ἐξέζεσεν γὰρ Οἰδίπου κατεύγματα·	--u- u -u- u-u-	iambic trimeter (tragic)	
ἄγαν δʼ ἀληθεῖς ἐνυπνίων φαντασμάτων	u- u-- uuu- --u-	lyric	
ὄψεις, πατρῴων χρημάτων δατήριοι.	-- u-- -u- u-u-	iambic trimeter (tragic)	
πιθοῦ γυναιξί, καίπερ οὐ στέργων ὅμως.	u- u-u -u - -- u-	iambic trimeter (tragic)	
λέγοιτʼ ἂν ὧν ἄνη τις· οὐδὲ χρὴ μακράν.	u- u - u- u -u - u-	iambic trimeter (tragic)	
μὴ ʼλθῃς ὁδοὺς σὺ τάσδʼ ἐφʼ ἑβδόμαις πύλαις.	- - u- u - u -u- u-	iambic trimeter (tragic)	
τεθηγμένον τοί μʼ οὐκ ἀπαμβλυνεῖς λόγῳ.	u-u- - - u--- u-	iambic trimeter (tragic)	
νίκην γε μέντοι καὶ κακὴν τιμᾷ θεός.	-- u -- - u- -- u-	iambic trimeter (tragic)	
οὐκ ἄνδρʼ ὁπλίτην τοῦτο χρὴ στέργειν ἔπος.	- - u-- -u - -- u-	iambic trimeter (tragic)	
ἀλλʼ αὐτάδελφον αἷμα δρέψασθαι θέλεις;	- -u-u -u --- u-	iambic trimeter (tragic)	
θεῶν διδόντων οὐκ ἂν ἐκφύγοις κακά.	u- u-- - u -u- u-	iambic trimeter (tragic)	
πέφρικα τὰν ὠλεσίοικον	u-u - -uu--	lyric	
θεόν, οὐ θεοῖς ὁμοίαν,	uu - u- u--	lyric	
παναλαθῆ κακόμαντιν	uu-- uu--	lyric	
πατρὸς εὐκταίαν Ἐρινὺν	uu -u- u--	lyric	
τελέσαι τὰς περιθύμους	uu- - uu--	lyric	
κατάρας Οἰδιπόδα βλαψίφρονος·	uu- -uu- -uu-	anapaestic	
παιδολέτωρ δʼ ἔρις ἅδʼ ὀτρύνει.	-uu- uu - u--	lyric	
ξένος δὲ κλήρους ἐπινωμᾷ,	u- u -- uu--	lyric	
Χάλυβος Σκυθᾶν ἄποικος,	uu- u- u--	lyric	
κτεάνων χρηματοδαίτας	uu- -uu--	lyric	
πικρός, ὠμόφρων σίδαρος,	uu -u- u--	lyric	
χθόνα ναίειν διαπήλας,	uu -- uu--	lyric	
ὁπόσαν καὶ φθιμένοισιν κατέχειν,	uu- - uu-- uu-	anapaestic	
τῶν μεγάλων πεδίων ἀμοίρους.	- uu- uu- u--	lyric	
ἐπεὶ δʼ ἂν αὐτοκτόνως	u- u --u-	lyric	
αὐτοδάικτοι θάνωσι,	-uu-- u-u	lyric	
καὶ γαΐα κόνις	- -u- u-	lyric	
πίῃ μελαμπαγὲς αἷμα φοίνιον,	u- u--u -u -u-	lyric	
τίς ἂν καθαρμοὺς πόροι,	u - u-- u-	lyric	
τίς ἄν σφε λούσειεν; ὦ πόνοι δόμων	u - u --u - u- u-	lyric	
νέοι παλαιοῖσι συμμιγεῖς κακοῖς.	u- u--u -u- u-	lyric	
παλαιγενῆ γὰρ λέγω	u-u- - u-	lyric	
παρβασίαν ὠκύποινον,	-uu- -u-u	lyric	
αἰῶνα δʼ ἐς τρίτον	--u - u-	lyric	
μένειν, Ἀπόλλωνος εὖτε Λάιος	u- u--u -u -u-	lyric	
βίᾳ, τρὶς εἰπόντος ἐν	u- u --u -	lyric	
μεσομφάλοις Πυθικοῖς χρηστηρίοις	u-u- -u- --u-	lyric	
θνᾴσκοντα γέννας ἄτερ σῴζειν πόλιν,	--u -- u- -- u-	lyric	
κρατηθεὶς δʼ ἐκ φίλων ἀβουλιᾶν	u-- - u- u-u-	lyric	
ἐγείνατο μὲν μόρον αὑτῷ,	u-uu - uu --	lyric	
πατροκτόνον Οἰδιπόδαν,	u-uu -uu-	lyric	
ὅστε ματρὸς ἁγνὰν	-u -u --	lyric	
σπείρας ἄρουραν, ἵνʼ ἐτράφη,	-- u-u u -u-	lyric	
ῥίζαν αἱματόεσσαν	-u -uu--	lyric	
ἔτλα· παράνοια συνᾶγε	u- uu-u u--	lyric	
νυμφίους φρενώλεις.	-u- u--	lyric	
κακῶν δʼ ὥσπερ θάλασσα κῦμʼ ἄγει·	u- -- u-u - u-	lyric	
τὸ μὲν πίτνον, ἄλλο δʼ ἀείρει	u - uu -u u--	lyric	
τρίχαλον, ὃ καὶ περὶ πρύμ-	u-u u - uu -	lyric	
ναν πόλεως καχλάζει.	- uu- u--	lyric	
μεταξὺ δʼ ἀλκὰ διʼ ὀλίγου	u-u -u u uu-	lyric	
τείνει, πύργος ἐν εὔρει.	-- -u u --	lyric	
δέδοικα δὲ σὺν βασιλεῦσι	u-u u - uu-u	lyric	
μὴ πόλις δαμασθῇ.	- u- u--	lyric	
τελειᾶν γὰρ παλαιφάτων ἀρᾶν	u-- - u-u- u-	lyric	
βαρεῖαι καταλλαγαί·	u-- u-u-	lyric	
τὰ δʼ ὀλοʼ οὐ παρέρχεται.	u uu - u-u-	lyric	
πρόπρυμνα δʼ ἐκβολὰν φέρει	u-u -u- u-	lyric	
ἀνδρῶν ἀλφηστᾶν	-- ---	lyric	
ὄλβος ἄγαν παχυνθείς.	-u u- u--	lyric	
τίνʼ ἀνδρῶν γὰρ τοσόνδʼ ἐθαύμασαν	u -- - u- u-u-	lyric	
θεοὶ καὶ ξυνέστιοι	u- - u-u-	lyric	
πολύβατός τʼ ἀγὼν βροτῶν,	uuu- u- u-	lyric	
ὅσον τότʼ Οἰδίπουν τίον,	u- u -u- u-	lyric	
τὰν ἁρπαξάνδραν	u ----	lyric	
κῆρʼ ἀφελόντα χώρας;	- uu-u --	lyric	
ἐπεὶ δʼ ἀρτίφρων	u- -u-	lyric	
ἐγένετο μέλεος ἀθλίων	uuuu uuu -u-	lyric	
γάμων, ἐπʼ ἄλγει δυσφορῶν	u- u -- -u-	lyric	
μαινομένᾳ κραδίᾳ	-uu- uu-	lyric	
δίδυμα κάκʼ ἐτέλεσεν·	uuu u uuu-	lyric	
πατροφόνῳ χερὶ τῶν	-uu- uu -	lyric	
κρεισσοτέκνων ὀμμάτων ἐπλάγχθη·	-uu- -u- u--	lyric	
τέκνοις δʼ ἀγρίας	u- -u-	lyric	
ἐφῆκεν ἐπικότους τροφᾶς,	u-u uuu- u-	lyric	
αἰαῖ, πικρογλώσσους ἀράς,	-- u--- u-	lyric	
καί σφε σιδαρονόμῳ	- u u-uu-	lyric	
διὰ χερί ποτε λαχεῖν	uu uu uu u-	lyric	
κτήματα· νῦν δὲ τρέω	-uu - u u-	lyric	
μὴ τελέσῃ καμψίπους Ἐρινύς.	- uu- -u- u--	lyric	
θαρσεῖτε, παῖδες μητέρων τεθραμμέναι.	--u -- -u- u-u-	iambic trimeter (tragic)	
πόλις πέφευγεν ἥδε δούλιον ζυγόν·	u- u-u -u -u- u-	iambic trimeter (tragic)	
πέπτωκεν ἀνδρῶν ὀβρίμων κομπάσματα·	--u -- -u- --u-	iambic trimeter (tragic)	
πόλις δʼ ἐν εὐδίᾳ τε καὶ κλυδωνίου	u- u -u- u - u-u-	iambic trimeter (tragic)	
πολλαῖσι πληγαῖς ἄντλον οὐκ ἐδέξατο.	--u -- -u - u-u-	iambic trimeter (tragic)	
στέγει δὲ πύργος, καὶ πύλας φερεγγύοις	u- u -- - u- u-u-	iambic trimeter (tragic)	
ἐφραξάμεσθα μονομάχοισι προστάταις·	u-u-u uuu-u -u-	lyric	
καλῶς ἔχει τὰ πλεῖστʼ, ἐν ἓξ πυλώμασι·	u- u- u - u - u-u-	iambic trimeter (tragic)	
τὰς δʼ ἑβδόμας ὁ σεμνὸς ἑβδομαγέτης	- -u- u -u -u-u-	iambic trimeter (tragic)	
ἄναξ Ἀπόλλων εἵλετʼ, Οἰδίπου γένει	u- u-- -u -u- u-	iambic trimeter (tragic)	
κραίνων παλαιὰς Λαΐου δυσβουλίας.	-- u-- -u- --u-	iambic trimeter (tragic)	
τί δʼ ἔστι πρᾶγμα νεόκοτον πόλει πλέον;	u -u -u uuu- u- u-	lyric	
πόλις σέσωσται· βασιλέες δʼ ὁμόσποροι—	u- u-- uuu- u-u-	lyric	
τίνες; τί δʼ εἶπας; παραφρονῶ φόβῳ λόγου.	u- u -- uuu- u- u-	lyric	
φρονοῦσα νῦν ἄκουσον· Οἰδίπου τόκοι	u-u - u-u -u- u-	iambic trimeter (tragic)	
οἲ ʼγὼ τάλαινα, μάντις εἰμὶ τῶν κακῶν.	- - u-u -u -u - u-	iambic trimeter (tragic)	
οὐδʼ ἀμφιλέκτως μὴν κατεσποδημένοι—	- -u-- - u-u-u-	iambic trimeter (tragic)	
ἐκεῖθι κεῖσθον; βαρέα δʼ οὖν ὅμως φράσον.	u-u -- uuu - u- u-	lyric	
ἅνδρες τεθνᾶσιν ἐκ χερῶν αὐτοκτόνων.	-- u-u - u- --u-	iambic trimeter (tragic)	
οὕτως ἀδελφαῖς χερσὶν ἠναίρονθʼ ἅμα;	-- u-- -u --- u-	iambic trimeter (tragic)	
οὕτως ὁ δαίμων κοινὸς ἦν ἀμφοῖν ἄγαν.	-- u -- -u - -- u-	iambic trimeter (tragic)	
αὐτὸς δʼ ἀναλοῖ δῆτα δύσποτμον γένος.	-- u-- -u --- u-	iambic trimeter (tragic)	
τοιαῦτα χαίρειν καὶ δακρύεσθαι πάρα·	--u -- - u--- u-	iambic trimeter (tragic)	
πόλιν μὲν εὖ πράσσουσαν, οἱ δʼ ἐπιστάται,	u- u - --u - u-u-	iambic trimeter (tragic)	
δισσὼ στρατηγώ, διέλαχον σφυρηλάτῳ	-- u-- uuu- --u-	lyric	
Σκύθῃ σιδήρῳ κτημάτων παμπησίαν.	u- u-- -u- --u-	iambic trimeter (tragic)	
ἕξουσι δʼ ἣν λάβωσιν ἐν ταφῇ χθονός,	--u - u-u - u- u-	iambic trimeter (tragic)	
πατρὸς κατʼ εὐχὰς δυσπότμως φορούμενοι.	u- u -- -u- u-u-	iambic trimeter (tragic)	
[πόλις σέσωσται· βασιλέοιν δʼ ὁμοσπόροιν	u- u-- uuu- u-u-	lyric	
[πέπωκεν αἷμά γαῖʼ ὑπʼ ἀλλήλων φόνῳ.	u-u -u - u --- u-	iambic trimeter (tragic)	
ὦ μεγάλε Ζεῦ καὶ πολιοῦχοι	- uu- - - uu--	anapaestic	
δαίμονες, οἳ δὴ Κάδμου πύργους	-uu - - -- --	anapaestic	
τούσδε ῥύεσθε,	-u u--	anapaestic	
πότερον χαίρω κἀπολολύξω	uu- -- -uu--	anapaestic	
πόλεως ἀσινεῖ σωτῆρι.	uu- uu- ---	lyric	
ἢ τοὺς μογεροὺς καὶ δυσδαίμονας	- - uu- - --uu	anapaestic	
ἀτέκνους κλαύσω πολεμάρχους;	uu- -- uu--	lyric	
οἳ δῆτʼ ὀρθῶς κατʼ ἐπωνυμίαν	- - -- u u-uu-	anapaestic	
καὶ πολυνεικεῖς	- uu--	anapaestic	
ὤλοντʼ ἀσεβεῖ διανοίᾳ.	-- uu- uu--	lyric	
ὦ μέλαινα καὶ τελεία γένεος Οἰδίπου τʼ ἀρά,	- u-u - u-u uuu -u- u-	lyric	
κακόν με καρδίαν τι περιπίτνει κρύος.	u- u -u- u uuu- u-	lyric	
ἔτευξα τύμβῳ μέλος	u-u -- u-	lyric	
Θυιὰς αἱματοσταγεῖς	-u -u-u-	lyric	
νεκροὺς κλύουσα δυσμόρως	u- u-u -u-	lyric	
θανόντας· ἦ δύσορνις ἅ-	u-u - u-u -	lyric	
δε ξυναυλία δορός.	- u-u- u-	lyric	
ἐξέπραξεν, οὐδʼ ἀπεῖπεν πατρόθεν εὐκταία φάτις·	-u-u - u-- uuu --- u-	lyric	
βουλαὶ δʼ ἄπιστοι Λαΐου διήρκεσαν.	-- u-- -u- u-u-	iambic trimeter (tragic)	
μέριμνα δʼ ἀμφὶ πτόλιν·	u-u -- u-	lyric	
θέσφατʼ οὐκ ἀμβλύνεται.	-u - --u-	lyric	
ἰὼ πολύστονοι, τόδʼ ἠρ-	u- u-u- u -	lyric	
γάσασθʼ ἄπιστον· ἦλθε δʼ αἰ-	u- u-u -u -	lyric	
ακτὰ πήματʼ οὐ λόγῳ.	-u -u - u-	lyric	
τάδʼ αὐτόδηλα, προῦπτος ἀγγέλου λόγος·	u -u-u -u -u- u-	iambic trimeter (tragic)	
διπλαῖν μερίμναιν διδύμα νῦν ὁρῶ κακά,	u- u-- uuu - u- u-	lyric	
αὐτοφόνα, δίμορα τέλεα τάδε πάθη. τί φῶ;	-uuu uuu uuu uu u- u -	lyric	
τί δʼ ἄλλο γʼ ἢ πόνοι πόνων ἐφέστιοι;	u -u - u- u- u-u-	iambic trimeter (tragic)	
ἀλλὰ γόων, ὦ φίλαι, κατʼ οὖρον	-u u- - u- u --	lyric	
ἐρέσσετʼ ἀμφὶ κρατὶ πόμπιμον χεροῖν	u-u -u -u -u- u-	iambic trimeter (tragic)	
πίτυλον, ὃς αἰὲν διʼ Ἀχέροντʼ ἀμείβεται	uuu u -- u uu- u-u-	lyric	
τὰν ἄστολον μελάγκροκον θεωρίδα,	- -u- u-u- u-u-	iambic trimeter (tragic)	
τὰν ἀστιβῆ Παιῶνι, τὰν ἀνάλιον	- -u- --u - u-u-	iambic trimeter (tragic)	
πάνδοκον εἰς ἀφανῆ τε χέρσον.	-uu - uu- u --	lyric	
ἀλλὰ γὰρ ἥκουσʼ αἵδʼ ἐπὶ πρᾶγος	-u u -- - uu --	anapaestic	
πικρὸν Ἀντιγόνη τʼ ἠδʼ Ἰσμήνη,	uu -uu- - ---	anapaestic	
θρῆνον ἀδελφοῖν· οὐκ ἀμφιβόλως	-u u-- - -uu-	anapaestic	
οἶμαί σφʼ ἐρατῶν ἐκ βαθυκόλπων	-- uu- - uu--	anapaestic	
στηθέων ἥσειν ἄλγος ἐπάξιον.	-- -- -u u-uu	anapaestic	
ἡμᾶς δὲ δίκη πρότερον φήμης	-- u u- uu- --	anapaestic	
τὸν δυσκέλαδόν θʼ ὕμνον Ἐρινύος	- -uu- -u u-uu	anapaestic	
ἰαχεῖν Ἀίδα τʼ	uu- uu-	anapaestic	
ἐχθρὸν παιᾶνʼ ἐπιμέλπειν.	-- -- uu--	lyric	
δυσαδελφόταται πασῶν ὁπόσαι	uu-uu- -- uu-	anapaestic	
στρόφον ἐσθῆσιν περιβάλλονται,	uu --- uu---	anapaestic	
κλαίω, στένομαι, καὶ δόλος οὐδεὶς	-- uu- - uu --	anapaestic	
μὴ ʼκ φρενὸς ὀρθῶς με λιγαίνειν.	- uu -- u u--	lyric	
ἰὼ ἰὼ δύσφρονες,	u- u- -u-	lyric	
φίλων ἄπιστοι καὶ κακῶν ἀτρύμονες,	u- u-- - u- u-u-	iambic trimeter (tragic)	
δόμους πατρῴους ἑλόν-	u- u-- u-	lyric	
τες μέλεοι σὺν αἰχμᾷ.	- u- u --	lyric	
μέλεοι δῆθʼ οἳ μελέους θανάτους	uu- - - uu- uu-	anapaestic	
εὕροντο δόμων ἐπὶ λύμῃ.	--u u- uu --	lyric	
ἰὼ ἰὼ δωμάτων	u- u- -u-	lyric	
ἐρειψίτοιχοι καὶ πικρὰς μοναρχίας	u-u-- - u- u-u-	iambic trimeter (tragic)	
ἰδόντες, ἤδη διήλ-	u-u -- u-	lyric	
λαχθε σὺν σιδάρῳ.	-u - u--	lyric	
κάρτα δʼ ἀληθῆ πατρὸς Οἰδιπόδα	-u u-- uu -uu-	anapaestic	
πότνιʼ Ἐρινὺς ἐπέκρανεν.	-u u-- uu--	lyric	
διʼ εὐωνύμων τετυμμένοι,	u --u- u-u-	lyric	
τετυμμένοι δῆθʼ,ὁμο-	u-u- -u-	lyric	
-σπλάγχνων τε πλευρωμάτων	-- u --u-	lyric	
αἰαῖ δαιμόνιοι,	-- -uu-	lyric	
αἰαῖ δʼ ἀντιφόνων θανάτων ἀραί.	-- -uu- uu- u-	lyric	
διανταίαν λέγεις δόμοισι καὶ	u--- u- u-u -	lyric	
σώμασιν πεπλαγμένους,	-u- u-u-	lyric	
ἀναυδάτῳ μένει	u--- u-	lyric	
ἀραίῳ τʼ ἐκ πατρὸς	u-- - u-	lyric	
<οὐ> διχόφρονι πότμῳ.	- uuuu --	lyric	
διήκει δὲ καὶ πόλιν στόνος,	u-- u - u- u-	lyric	
στένουσι πύργοι, στένει	u-u -- u-	lyric	
πέδον φίλανδρον· μένει	u- u-- u-	lyric	
κτέανα δʼ ἐπιγόνοις,	uuu uuu-	lyric	
διʼ ὧν αἰνομόροις,	u - -uu-	lyric	
διʼ ὧν νεῖκος ἔβα θανάτου τέλος.	u - -u u- uu- u-	lyric	
ἐμοιράσαντο δʼ ὀξυκάρδιοι	u---u -u-u-	lyric	
κτήμαθʼ, ὥστʼ ἴσον λαχεῖν.	-u - u- u-	lyric	
διαλλακτῆρι δʼ οὐκ	u---u -	lyric	
ἀμεμφεία φίλοις,	u--- u-	lyric	
οὐδʼ ἐπίχαρις Ἄρης.	- uuuu --	lyric	
σιδαρόπλακτοι μὲν ὧδʼ ἔχουσιν,	u-u-- u - u--	lyric	
σιδαρόπλακτοι δὲ τοὺς μένουσι,	u-u-- u - u--	lyric	
τάχʼ ἄν τις εἴποι, τίνες;	u - u -- u-	lyric	
τάφων πατρῴων λαχαί.	u- u-- u-	lyric	
ἀχάεις δόμων μάλʼ αὐτούς	--- u- u --	lyric	
προπέμπει δαϊκτὴρ	u-- u--	lyric	
γόος αὐτόστονος, αὐτοπήμων,	uu --uu -u--	lyric	
δαϊόφρων, οὐ φιλογαθής,	-uu- - uu--	lyric	
ἐτύμως δακρυχέων ἐκ	uu- -uu- -	lyric	
φρενός, ἃ κλαιομένας μου	uu - -uu- -	lyric	
μινύθει τοῖνδε δυοῖν ἀνάκτοιν.	uu- -u u- u--	lyric	
πάρεστι δʼ εἰπεῖν ἐπʼ ἀθλίοισιν	u-u -- u -u--	lyric	
ὡς ἐρξάτην πολλὰ μὲν πολίτας,	- -u- -u - u--	lyric	
ξένων τε πάντων στίχας	u- u -- u-	lyric	
πολυφθόρους ἐν δαΐ.	u-u- - u-	lyric	
δυσδαίμων σφιν ἁ τεκοῦσα	--- u - u--	lyric	
πρὸ πασᾶν γυναικῶν	u -- u--	lyric	
ὁπόσαι τεκνογόνοι κέκληνται.	uu- -uu- u--	lyric	
παῖδα τὸν αὐτᾶς πόσιν αὐτὰ	-u u -- uu --	lyric	
θεμένα τούσδʼ ἔτεχʼ, οἱ δʼ ὧδʼ	uu- - uu - -	lyric	
ἐτελεύτασαν ὑπʼ ἀλλα-	uu--u u --	lyric	
-λοφόνοις χερσὶν ὁμοσπόροισιν.	uu- -u u-u--	lyric	
ὁμόσποροι δῆτα καὶ πανώλεθροι,	u-u- -u - u-u-	lyric	
διατομαῖς οὐ φίλαις,	uuu- - u-	lyric	
ἔριδι μαινομένᾳ,	uuu -uu-	lyric	
νείκεος ἐν τελευτᾷ.	-uu - u--	lyric	
πέπαυται δʼ ἔχθος, ἐν δὲ γαίᾳ	u-- -u - u --	lyric	
ζόα φονορύτῳ	u- uuu-	lyric	
μέμεικται· κάρτα δʼ εἴσʼ ὅμαιμοι.	u-- -u - u--	lyric	
πικρὸς λυτὴρ νεικέων ὁ πόντιος	u- u- -u- u -u-	lyric	
ξεῖνος ἐκ πυρὸς συθεὶς	-u - u- u-	lyric	
θακτὸς σίδαρος· πικρὸς δὲ χρημάτων	-- u-- u- u -u-	lyric	
κακὸς δατητὰς Ἄρης ἀρὰν πατρῴ-	u- u-- u- u- u-	lyric	
αν τιθεὶς ἀλαθῆ.	- u- u--	lyric	
ἔχουσι μοῖραν λαχόντες οἱ μέλεοι	u-u -- u-u - u-	lyric	
διοδότων ἀχθέων·	uuu- -u-	lyric	
ὑπὸ δὲ σώματι γᾶς	uu u -uu -	lyric	
πλοῦτος ἄβυσσος ἔσται.	-u u-u --	lyric	
ἰὼ πολλοῖς ἐπανθίσαντες	u- -- u-u--	lyric	
πόνοισι γενεάν·	u-u uu-	lyric	
τελευταῖαι δʼ ἐπηλάλαξαν	u--- u-u--	lyric	
Ἀραὶ τὸν ὀξὺν νόμον, τετραμμένου	u- u -- u- u-u-	lyric	
παντρόπῳ φυγᾷ γένους.	-u- u- u-	lyric	
ἕστακε δʼ Ἄτας τροπαῖον ἐν πύλαις,	--u -- u-u - u-	lyric	
ἐν αἷς ἐθείνοντο, καὶ δυοῖν κρατή-	u - u--u - u- u-	lyric	
σας ἔληξε δαίμων.	- u-u --	lyric	
παισθεὶς ἔπαισας. σὺ δʼ ἔθανες κατακτανών.	-- u-- u uu- u-u-	lyric	
δορὶ δʼ ἔκανες δορὶ δʼ ἔθανες	uu uu- uu uu-	lyric	
μελεοπόνος. μελεοπαθής.	uuuu- uuuu-	lyric	
ἴτω γόος. ἴτω δάκρυ.	u- u- u- u-	lyric	
πρόκεισαι κατακτάς.	u-- u--	lyric	
ἠέ.	-u	lyric	
ἠέ.	-u	lyric	
μαίνεται γόοισι φρήν.	-u- u-u -	lyric	
ἐντὸς δὲ καρδία στένει.	-- u -u- u-	lyric	
ἰὼ ἰὼ πάνδυρτε σύ.	u- u- --u -	lyric	
σὺ δʼ αὖτε καὶ πανάθλιε.	u -u - u-u-	lyric	
πρὸς φίλου ἔφθισο.	- uu -u-	lyric	
καὶ φίλον ἔκτανες.	- uu -u-	lyric	
διπλᾶ λέγειν διπλᾶ δʼ ὁρᾶν	u- u- u- u-	lyric	
ἄχεα τῶνδε τάδʼ ἐγγύθεν.	uuu -u u -u-	lyric	
πέλας ἀδελφέʼ ἀδελφεῶν.	uu u-u u-u-	lyric	
ἰὼ Μοῖρα βαρυδότειρα μογερά, πότνιά τʼ Οἰδίπου σκιά,	u- -u uuu-u uu- uuu -u- u-	lyric	
μέλαινʼ Ἐρινύς, ἦ μεγασθενής τις εἶ.	u- u-- - u-u- u -	iambic trimeter (tragic)	
ἠέ.	-u	lyric	
ἠέ.	-u	lyric	
δυσθέατα πήματα	-uuu -u-	lyric	
ἔδειξεν ἐκ φυγᾶς ἐμοί.	u-u - u- u-	lyric	
οὐδʼ ἵκεθʼ ὡς κατέκτανεν.	- uu - u-u-	lyric	
σωθεὶς δὲ πνεῦμʼ ἀπώλεσεν.	-- u - u-u-	lyric	
ὤλεσε δῆτʼ <ἄγαν>.	-uu - u-	lyric	
καὶ τὸν ἐνόσφισεν.	- u u-u-	lyric	
τάλαν γένος. τάλαν πάθος.	u- u- u- u-	lyric	
δύστονα κήδεʼ ὁμαίμονα.	-uu -u u-u-	lyric	
δίυγρα τριπάλτων πημάτων.	-u u-- -u-	lyric	
ἰὼ Μοῖρα βαρυδότειρα μογερά, πότνιά τʼ Οἰδίπου σκιά,	u- -u uuu-u uuu uuu -u- u-	lyric	
μέλαινʼ Ἐρινύς, ἦ μεγασθενής τις εἶ.	u- u-- - u-u- u -	iambic trimeter (tragic)	
σὺ τοί νιν οἶσθα διαπερῶν—	u - u -u uuu-	lyric	
σὺ δʼ οὐδὲν ὕστερος μαθών—	u -u -u- u-	lyric	
ἐπεὶ κατῆλθες ἐς πόλιν,	u- u-u - u-	lyric	
δορός γε τῷδʼ ἀντηρέτας.	u- u - --u-	lyric	
ὀλοὰ λέγειν.	uuu u-	lyric	
ὀλοὰ δʼ ὁρᾶν.	uuu u-	lyric	
ἰὼ πόνος—	u- u-	lyric	
ἰὼ κακά—	u- u-	lyric	
δώμασι καὶ χθονί.	-uu - u-	lyric	
πρὸ πάντων δʼ ἐμοί.	u -- u-	lyric	
καὶ τὸ πρόσω γʼ ἐμοί.	- u u- u-	lyric	
ἰὼ ἰὼ δυστόνων κακῶν, ἄναξ.	u- u- -u- u- u-	lyric	
ἰὼ ἰὼ πάντα πολυπονώτατοι.	u- u- -u uuu-u-	lyric	
ἰὼ ἰὼ δαιμονῶντες ἄτᾳ.	u- u- -u-u --	lyric	
ἰὼ ἰώ, ποῦ σφε θήσομεν χθονός;	u- u- - u -u- u-	lyric	
ἰώ, ὅπου <ʼσʼτι> τιμιώτατον.	u- u- u -u-u-	lyric	
ἰὼ ἰώ, πῆμα πατρὶ πάρευνον.	u- u- -u uu u--	lyric	
δοκοῦντα καὶ δόξαντʼ ἀπαγγέλλειν με χρὴ	u-u - -- u--- u -	iambic trimeter (tragic)	
δήμου προβούλοις τῆσδε Καδμείας πόλεως·	-- u-- -u --- u-	iambic trimeter (tragic)	
Ἐτεοκλέα μὲν τόνδʼ ἐπʼ εὐνοίᾳ χθονὸς	uu-u- - - u --- u-	iambic trimeter (tragic)	
θάπτειν ἔδοξε γῆς φίλαις κατασκαφαῖς·	-- u-u - u- u-u-	iambic trimeter (tragic)	
στυγῶν γὰρ ἐχθροὺς θάνατον εἵλετʼ ἐν πόλει	u- u -- uuu -u - u-	lyric	
ἱερῶν πατρῴων δʼ ὅσιος ὢν μομφῆς ἄτερ	uu- u-- uuu - -- u-	lyric	
τέθνηκεν οὗπερ τοῖς νέοις θνῄσκειν καλόν.	u-u -- - u- -- u-	iambic trimeter (tragic)	
οὕτω μὲν ἀμφὶ τοῦδʼ ἐπέσταλται λέγειν·	-- u -u - u--- u-	iambic trimeter (tragic)	
τούτου δʼ ἀδελφὸν τόνδε Πολυνείκους νεκρὸν	-- u-- -u uu-- u-	lyric	
ἔξω βαλεῖν ἄθαπτον, ἁρπαγὴν κυσίν,	-- u- u-u -u- u-	iambic trimeter (tragic)	
ὡς ὄντʼ ἀναστατῆρα Καδμείων χθονός,	- - u-u-u --- u-	iambic trimeter (tragic)	
εἰ μὴ θεῶν τις ἐμποδὼν ἔστη δορὶ	- - u- u -u- -- u-	iambic trimeter (tragic)	
τῷ τοῦδʼ·. ἄγος δὲ καὶ θανὼν κεκτήσεται	- - u- u - u- --u-	iambic trimeter (tragic)	
θεῶν πατρῴων, οὓς ἀτιμάσας ὅδε	u- u-- - u--- u-	iambic trimeter (tragic)	
στράτευμʼ ἐπακτὸν ἐμβαλὼν ᾕρει πόλιν.	u- u-u -u- -- u-	iambic trimeter (tragic)	
οὕτω πετηνῶν τόνδʼ ὑπʼ οἰωνῶν δοκεῖ	-- u-- - u --- u-	iambic trimeter (tragic)	
ταφέντʼ ἀτίμως τοὐπιτίμιον λαβεῖν,	u- u-- -u-u- u-	iambic trimeter (tragic)	
καὶ μήθʼ ὁμαρτεῖν τυμβοχόα χειρώματα	- - u-- -uuu --u-	lyric	
μήτʼ ὀξυμόλποις προσσέβειν οἰμώγμασιν,	- -u-- -u- --u-	iambic trimeter (tragic)	
ἄτιμον εἶναι δʼ ἐκφορᾶς φίλων ὕπο.	u-u -- -u- u- u-	iambic trimeter (tragic)	
τοιαῦτʼ ἔδοξε τῷδε Καδμείων τέλει.	-- u-u -u --- u-	iambic trimeter (tragic)	
ἐγὼ δὲ Καδμείων γε προστάταις λέγω·	u- u --- u -u- u-	iambic trimeter (tragic)	
ἢν μή τις ἄλλος τόνδε συνθάπτειν θέλῃ,	- - u -- -u --- u-	iambic trimeter (tragic)	
ἐγώ σφε θάψω κἀνὰ κίνδυνον βαλῶ	u- u -- -u --- u-	iambic trimeter (tragic)	
θάψασʼ ἀδελφὸν τὸν ἐμόν, οὐδʼ αἰσχύνομαι	-- u-- u uu - --u-	lyric	
ἔχουσʼ ἄπιστον τήνδʼ ἀναρχίαν πόλει.	u- u-- - u-u- u-	iambic trimeter (tragic)	
δεινὸν τὸ κοινὸν σπλάγχνον, οὗ πεφύκαμεν,	-- u -- -u - u-u-	iambic trimeter (tragic)	
μητρὸς ταλαίνης κἀπὸ δυστήνου πατρός.	-- u-- -u --- u-	iambic trimeter (tragic)	
τοιγὰρ θέλουσʼ ἄκοντι κοινώνει κακῶν	-- u- --u --- u-	iambic trimeter (tragic)	
ψυχή, θανόντι ζῶσα συγγόνῳ φρενί.	-- u-- -u -u- u-	iambic trimeter (tragic)	
τούτου δὲ σάρκας οὐδὲ κοιλογάστορες	-- u -u -u -u-u-	iambic trimeter (tragic)	
λύκοι σπάσονται· μὴ δοκησάτω τινί.	u- u-- - u-u- u-	iambic trimeter (tragic)	
τάφον γὰρ αὐτῷ καὶ κατασκαφὰς ἐγώ,	u- u -- - u-u- u-	iambic trimeter (tragic)	
γυνή περ οὖσα, τῷδε μηχανήσομαι,	u- u -u -u -u-u-	iambic trimeter (tragic)	
κόλπῳ φέρουσα βυσσίνου πεπλώματος.	-- u-u -u- u-u-	iambic trimeter (tragic)	
καὐτὴ καλύψω, μηδέ τῳ δόξῃ πάλιν·	-- u-- -u - -- u-	iambic trimeter (tragic)	
θάρσει, παρέσται μηχανὴ δραστήριος.	-- u-- -u- --u-	iambic trimeter (tragic)	
αὐδῶ πόλιν σε μὴ βιάζεσθαι τάδε.	-- u- u - u--- u-	iambic trimeter (tragic)	
αὐδῶ σὲ μὴ περισσὰ κηρύσσειν ἐμοί.	-- u - u-u --- u-	iambic trimeter (tragic)	
τραχύς γε μέντοι δῆμος ἐκφυγὼν κακά.	-- u -- -u -u- u-	iambic trimeter (tragic)	
τράχυνʼ· ἄθαπτος δʼ οὗτος οὐ γενήσεται.	-- u-- -u - u-u-	iambic trimeter (tragic)	
ἀλλʼ ὃν πόλις στυγεῖ, σὺ τιμήσεις τάφῳ,;	- - u- u- u --- u-	iambic trimeter (tragic)	
ἤδη τὰ τοῦδε διατετίμηται θεοῖς.	-- u -u uuu--- u-	lyric	
οὔ, πρίν γε χώραν τήνδε κινδύνῳ βαλεῖν.	- - u -- -u --- u-	iambic trimeter (tragic)	
παθὼν κακῶς κακοῖσιν ἀντημείβετο.	u- u- u-u ---u-	iambic trimeter (tragic)	
ἀλλʼ εἰς ἅπαντας ἀνθʼ ἑνὸς τόδʼ ἔργον ἦν.	- - u-u - u- u -u -	iambic trimeter (tragic)	
ἔρις περαίνει μῦθον ὑστάτη θεῶν.	u- u-- -u -u- u-	iambic trimeter (tragic)	
ἐγὼ δὲ θάψω τόνδε· μὴ μακρηγόρει.	u- u -- -u - u-u-	iambic trimeter (tragic)	
ἀλλʼ αὐτόβουλος ἴσθʼ, ἀπεννέπω δʼ ἐγώ.	- -u-u - u-u- u-	iambic trimeter (tragic)	
φεῦ φεῦ.	- -	lyric	
ὦ μεγάλαυχοι καὶ φθερσιγενεῖς	- uu-- - -uu-	anapaestic	
Κῆρες Ἐρινύες, αἵτʼ Οἰδιπόδα	-u u-uu - -uu-	anapaestic	
γένος ὠλέσατε πρυμνόθεν οὕτως,	uu -uu- -uu --	anapaestic	
τί πάθω; τί δὲ δρῶ; τί δὲ μήσωμαι;	u u- u u - u u ---	anapaestic	
πῶς τολμήσω μήτε σὲ κλαίειν	- --- -u u --	anapaestic	
μήτε προπέμπειν ἐπὶ τύμβον·	-u u-- uu --	lyric	
ἀλλὰ φοβοῦμαι κἀποτρέπομαι	-u u-- --uu-	anapaestic	
δεῖμα πολιτῶν.	-u u--	anapaestic	
σύ γε μὴν πολλῶν πενθητήρων	u u - -- ----	anapaestic	
τεύξει· κεῖνος δʼ ὁ τάλας ἄγοος	-- -- u u- uu-	anapaestic	
μονόκλαυτον ἔχων θρῆνον ἀδελφῆς	uu-u u- -u u--	anapaestic	
εἶσιν· τίς ἂν οὖν τὰ πίθοιτο;	-- u u - u u--	lyric	
δράτω <τι> πόλις καὶ μὴ δράτω	-- u u- - - --	anapaestic	
τοὺς κλαίοντας Πολυνείκη.	- --- uu--	lyric	
ἡμεῖς μὲν ἴμεν καὶ συνθάψομεν	-- u u- - --uu	anapaestic	
αἵδε προπομποί. καὶ γὰρ γενεᾷ	-u u-- - - uu-	anapaestic	
κοινὸν τόδʼ ἄχος, καὶ πόλις ἄλλως	-- u u- - uu --	anapaestic	
ἄλλοτʼ ἐπαινεῖ τὰ δίκαια.	-u u-- u u--	lyric	
ἡμεῖς δʼ ἅμα τῷδʼ, ὥσπερ τε πόλις	-- uu - -- u u-	anapaestic	
καὶ τὸ δίκαιον ξυνεπαινεῖ.	- u u-- uu--	lyric	
μετὰ γὰρ μάκαρας καὶ Διὸς ἰσχὺν	uu - uu- - uu --	anapaestic	
ὅδε Καδμείων ἤρυξε πόλιν	uu --- --u u-	anapaestic	
μὴ ʼνατραπῆναι μηδʼ ἀλλοδαπῷ	- uu-- - -uu-	anapaestic	
κύματι φωτῶν	-uu --	anapaestic	
κατακλυσθῆναι τὰ μάλιστα.	uu--- u u--	lyric	
