Ἐργατίνα βουκαῖε, τί νῦν ᾦζυρὲ πεπόνθεις;	-uu- --u u - --u u--	dactylic hexameter	feminine penthemimeral, hepthemimeral, trithemimeral
οὔθ᾽ ἑὸν ὄγμον ἄγειν ὀρθὸν δύνᾳ, ὡς τὸ πρὶν ἆγες,	- uu -u u- -- uu - u u --	dactylic hexameter	masculine penthemimeral, hepthemimeral
οὔθ᾽ ἅμα λᾳοτομεῖς τῷ πλατίον, ἀλλ᾽ ἀπολείπῃ	- uu -uu- - -uu - uu--	dactylic hexameter	masculine penthemimeral
ὥσπερ ὄις ποίμνας, ἇς τὸν πόδα κάκτος ἔτυψε.	-- - -- - - uu -u u--	dactylic hexameter	masculine penthemimeral, hepthemimeral, trithemimeral
ποῖός τις δείλαν τυ καὶ ἐκ μέσω ἄματος ἐσσῇ,	-- - -- u u - uu -uu --	dactylic hexameter	masculine penthemimeral, hepthemimeral, trithemimeral
ὃς νῦν ἀρχόμενος τᾶς αὔλακος οὐκ ἀποτρώγεις;	- - -uu- - -uu - uu--	dactylic hexameter	masculine penthemimeral
Μίλων ὀψαμάτα, πέτρας ἀπόκομμ᾽ ἀτεράμνω,	-- -uu- -- uu- uu--	dactylic hexameter	masculine penthemimeral, hepthemimeral
οὐδαμά τοι συνέβα ποθέσαι τινὰ τῶν ἀπεόντων;	-uu - uu- uu- uu - uu--	dactylic hexameter	masculine penthemimeral, hepthemimeral, trithemimeral
οὐδαμά. τίς δὲ πόθος τῶν ἔκτοθεν ἐργάτᾳ ἀνδρί;	-uu - u u- - -uu -uu --	dactylic hexameter	masculine penthemimeral, trithemimeral
οὐδαμά νυν συνέβα τοι ἀγρυπνῆσαι δι᾽ ἔρωτα;	-uu - uu- u u--- u u--	dactylic hexameter	masculine penthemimeral, trithemimeral
μηδέ γε συμβαίη· χαλεπὸν χορίω κύνα γεῦσαι.	-u u --- uu- uu- uu --	dactylic hexameter	masculine penthemimeral, hepthemimeral
ἀλλ᾽ ἐγὼ ὦ Μίλων ἔραμαι σχεδὸν ἑνδεκαταῖος.	- uu - -- uu- uu -uu--	dactylic hexameter	masculine penthemimeral, hepthemimeral, trithemimeral
ἐκ πίθω ἀντλεῖς δῆλον· ἐγὼ δ᾽ἔχω οὐδ᾽ ἅλις ὄξος.	- uu - -- -- uu - uu --	dactylic hexameter	masculine penthemimeral, hepthemimeral, trithemimeral
τοιγάρτοι πρὸ θυρᾶν μοι ἀπὸ σπόρω ἄσκαλα πάντα.	--- u u- u u- uu -uu --	dactylic hexameter	masculine penthemimeral, hepthemimeral, trithemimeral
τίς δέ τυ τᾶν παίδων λυμαίνεται; ἁ Πολυβώτα,	- u u - -- --uu - uu--	dactylic hexameter	masculine penthemimeral, trithemimeral
ἃ πρᾶν ἀμάντεσσι παρ᾽ Ἱπποκίωνι ποταύλει.	- - ---u u -uu-u u--	dactylic hexameter	feminine penthemimeral
εὗρε θεὸς τὸν ἀλιτρόν· ἔχεις πάλαι ὧν ἐπεθύμεις.	-u u- u u-u u- uu - uu--	dactylic hexameter	feminine penthemimeral, hepthemimeral, trithemimeral
μάντίς τοι τὰν νύκτα χροϊξεῖθ᾽ ἁ καλαμαία.	-- - - -u u-- - uu--	dactylic hexameter	feminine penthemimeral, trithemimeral
μωμᾶσθαί μ᾽ἄρχῃ τύ· τυφλὸς δ᾽οὐκ αὐτὸς ὁ Πλοῦτος,	--- -- u u- - -u u --	dactylic hexameter	masculine penthemimeral, hepthemimeral, trithemimeral
ἀλλὰ καὶ ὡφρόντιστος Ἔρως. μὴ δὴ μέγα μυθεῦ.	-u u ---u u- - - uu --	dactylic hexameter	feminine penthemimeral, hepthemimeral
οὐ μέγα μυθεῦμαι· τὺ μόνον κατάβαλλε τὸ λᾷον,	- uu --- u u- uu-u u --	dactylic hexameter	masculine penthemimeral, hepthemimeral
καί τι κόρας φιλικὸν μέλος ἀμβάλευ. ἅδιον οὑτῶς	- u u- uu- uu -uu -uu --	dactylic hexameter	masculine penthemimeral, trithemimeral
ἐργαξῇ· καὶ μὰν πρότερόν ποκα μουσικὸς ἦσθα.	--- - - uu- uu -uu --	dactylic hexameter	masculine penthemimeral, hepthemimeral, trithemimeral
Μοῖσαι Πιερίδες, συναείσατε τὰν ῥαδινάν μοι	-- -uu- uu-uu - uu- -	dactylic hexameter	masculine penthemimeral
παῖδ᾽· ὧν γάρ χ᾽ἅψησθε θεαί, καλὰ πάντα ποεῖτε.	- - - --u u- uu -u u--	dactylic hexameter	feminine penthemimeral, hepthemimeral, trithemimeral
Βομβύκα χαρίεσσα, Σύραν καλέοντί τυ πάντες,	-uu ---u u- uu-u u --	dactylic hexameter	feminine penthemimeral, hepthemimeral
ἰσχνὰν ἁλιόκαυστον, ἐγὼ δὲ μόνος μελίχλωρον.	-- -uu-u u- u u- uu--	dactylic hexameter	feminine penthemimeral, hepthemimeral
καὶ τὸ ἴον μέλαν ἐστὶ καὶ ἁ γραπτὰ ὑάκινθος,	- u u- uu -u u - -- uu--	dactylic hexameter	feminine penthemimeral, hepthemimeral, trithemimeral
ἀλλ᾽ ἔμπας ἐν τοῖς στεφάνοις τὰ πρᾶτα λέγονται.	- -- - - uu- - -u u--	dactylic hexameter	masculine penthemimeral, hepthemimeral, trithemimeral
ἁ αἲξ τὰν κύτισον, ὁ λύκος τὰν αἶγα διώκει,	- - - uu- u u- - -u u--	dactylic hexameter	masculine penthemimeral, hepthemimeral, trithemimeral
ἁ γέρανος τὤροτρον, ἐγὼ δ᾽ἐπὶ τὶν μεμάνημαι.	- uu- --u u- uu - uu--	dactylic hexameter	feminine penthemimeral, hepthemimeral, trithemimeral
αἴθέ μοι ἦς, ὅσσα Κροῖσόν ποκα φαντὶ πεπᾶσθαι,	-u u - -- -- uu -u u--	dactylic hexameter	masculine penthemimeral, hepthemimeral, trithemimeral
χρύσεοι ἀμφότεροί κ᾽ἀνεκείμεθα τᾷ Ἀφροδίτᾳ,	-uu -uu- uu-uu - uu--	dactylic hexameter	masculine penthemimeral
τὼς αὐλὼς μὲν ἔχοισα καὶ ἢ ῥόδον ἢ μᾶλον τύ,	- -- u u-u u - uu - -- -	dactylic hexameter	feminine penthemimeral, hepthemimeral, trithemimeral
σχῆμα δ᾽ἐγὼ καὶ καινὰς ἐπ᾽ ἀμφοτέροισιν ἀμύκλας.	-u u- - -u u -uu-u u--	dactylic hexameter	feminine penthemimeral, trithemimeral
Βομβύκα χαρίεσσ᾽, οἱ μὲν πόδες ἀστράγαλοί τευς,	-uu --- - - uu -uu- -	dactylic hexameter	masculine penthemimeral, hepthemimeral
ἁ φωνὰ δὲ τρύχνος· τὸν μὰν τρόπον οὐκ ἔχω εἰπεῖν.	- -- - - - - uu - uu --	dactylic hexameter	masculine penthemimeral, hepthemimeral, trithemimeral
Ἠ καλὰς ἄμμι ποέων ἐλελήθει βοῦκος ἀοιδάς.	- uu -u u- uu-- -u u--	dactylic hexameter	masculine penthemimeral
ὡς εὖ τὰν ἰδέαν τᾶς ἁρμονίας ἐμέτρησεν.	- - - uu- - -uu- uu--	dactylic hexameter	masculine penthemimeral, trithemimeral
ὤμοι τῶ πώγωνος, ὃν ἀλιθίως ἀνέφυσα.	-- - --u u -uu- uu--	dactylic hexameter	feminine penthemimeral, trithemimeral
θᾶσαι δὴ καὶ ταῦτα τὰ τῶ θείω Λιτυέρσα.	-- - - -u u - -- uu--	dactylic hexameter	feminine penthemimeral, hepthemimeral, trithemimeral
Δάματερ πολύκαρπε πολύσταχυ, τοῦτο τὸ λᾷον	--- uu-u u-uu -u u --	dactylic hexameter	feminine penthemimeral, trithemimeral
εὔεργόν τ᾽εἴη καὶ κάρπιμον ὅττι μάλιστα.	--- -- - -uu -u u--	dactylic hexameter	masculine penthemimeral, trithemimeral
Σφίγγετ᾽ ἀμαλλοδέται τὰ δράγματα, μὴ παριών τις	-u u-uu- - -uu - uu- -	dactylic hexameter	masculine penthemimeral
εἴποι· "σύκινοι ἄνδρες, ἀπώλετο χοὗτος ὁ μισθός."	-- -uu -u u-uu -u u --	dactylic hexameter	feminine penthemimeral
Ἐς βορέην ἄνεμον τᾶς κόρθυος ἁ τομὰ ὔμμιν	- uu- uu- - -uu - uu --	dactylic hexameter	masculine penthemimeral, trithemimeral
ἢ ζέφυρον βλεπέτω· πιαίνεται ὁ στάχυς οὑτῶς.	- uu- uu- --uu - uu --	dactylic hexameter	masculine penthemimeral, trithemimeral
σῖτον ἀλοιῶντας φεύγειν τὸ μεσαμβρινὸν ὕπνον·	-u u--- -- u u-uu --	dactylic hexameter	masculine penthemimeral, hepthemimeral
ἐκ καλάμας ἄχυρον τελέθει τημόσδε μάλιστα.	- uu- uu- uu- --u u--	dactylic hexameter	masculine penthemimeral, hepthemimeral, trithemimeral
ἄρχεσθαι δ᾽ἀμῶντας ἐγειρομένω κορυδαλλῶ,	--- --u u-uu- uu--	dactylic hexameter	feminine penthemimeral, trithemimeral
καὶ λήγειν εὕδοντος, ἐλινῦσαι δὲ τὸ καῦμα.	- -- --u u--- u u --	dactylic hexameter	feminine penthemimeral, trithemimeral
εὐκτὸς ὁ τῶ βατράχω παῖδες βίος· οὐ μελεδαίνει	-u u - uu- -- uu - uu--	dactylic hexameter	masculine penthemimeral, hepthemimeral, trithemimeral
τὸν προπιεῖν ἐγχεῦντα· πάρεστι γὰρ ἄφθονον αὐτῷ.	- uu- --u u-u u -uu --	dactylic hexameter	feminine penthemimeral, trithemimeral
κάλλιον ὦπιμελητὰ φιλάργυρε τὸν φακὸν ἕψειν·	-uu -uu-u u-uu - uu --	dactylic hexameter	feminine penthemimeral
μή τι τάμῃς τὰν χεῖρα καταπρίων τὸ κύμινον.	- u u- - -u u--- u u--	dactylic hexameter	feminine penthemimeral, trithemimeral
ταῦτα χρὴ μοχθεῦντας ἐν ἁλίῳ ἄνδρας ἀείδειν,	-- - -- u u-- -u u--	dactylic hexameter	masculine penthemimeral, trithemimeral
τὸν δὲ τεὸν βουκαῖε πρέπει λιμηρὸν ἔρωτα	- u u- --u u- --u u--	dactylic hexameter	feminine penthemimeral, hepthemimeral, trithemimeral
μυθίσδεν τᾷ ματρὶ κατ᾽ εὐνὰν ὀρθρευοίσᾳ.	--- - -u u -- ----	dactylic hexameter	feminine penthemimeral, trithemimeral
οὐδὲν πὸτ τὸν ἔρωτα πεφύκει φάρμακον ἄλλο	-- - u u-u u-- -uu --	dactylic hexameter	feminine penthemimeral, trithemimeral
Νικία οὔτ᾽ ἔγχριστον, ἐμὶν δοκεῖ, οὔτ᾽ ἐπίπαστον,	-uu - --u u- uu - uu--	dactylic hexameter	feminine penthemimeral, hepthemimeral, trithemimeral
ἢ ταὶ Πιερίδες· κοῦφον δέ τι τοῦτο καὶ ἁδὺ	- - -uu- -- u u -u u --	dactylic hexameter	masculine penthemimeral, hepthemimeral
γίνετ᾽ ἐπ᾽ ἀνθρώποις, εὑρεῖν δ᾽οὐ ῥᾴδιόν ἐστι.	-u u --- -- - -uu --	dactylic hexameter	masculine penthemimeral, hepthemimeral
γινώσκειν δ᾽οἶμαί τυ καλῶς ἰατρὸν ἐόντα	--- -- u u- --u u--	dactylic hexameter	masculine penthemimeral, hepthemimeral, trithemimeral
καὶ ταῖς ἐννέα δὴ πεφιλάμενον ἔξοχα Μοίσαις.	- - -uu - uu-uu -uu --	dactylic hexameter	masculine penthemimeral
οὕτω γοῦν ῥάιστα διᾶγ᾽ ὁ Κύκλωψ ὁ παρ᾽ ἁμῖν,	-- - --u u- u u- u u --	dactylic hexameter	feminine penthemimeral, hepthemimeral, trithemimeral
ὡρχαῖος Πολύφαμος, ὅκ᾽ ἤρατο τᾶς Γαλατείας,	--- uu-u u -uu - uu--	dactylic hexameter	feminine penthemimeral, trithemimeral
ἄρτι γενειάσδων περὶ τὸ στόμα τὼς κροτάφως τε.	-u u--- uu - uu - uu- -	dactylic hexameter	masculine penthemimeral, hepthemimeral
ἤρατο δ᾽οὐ μάλοις οὐδὲ ῥόδῳ οὐδὲ κικίννοις,	-uu - -- -- uu -u u--	dactylic hexameter	masculine penthemimeral, hepthemimeral, trithemimeral
ἀλλ᾽ ὀρθαῖς μανίαις, ἁγεῖτο δὲ πάντα πάρεργα.	- -- uu- --u u -u u--	dactylic hexameter	masculine penthemimeral, trithemimeral
πολλάκι ταὶ ὄιες ποτὶ ταὐλίον αὐταὶ ἀπῆνθον	-uu - -- uu -uu -u u--	dactylic hexameter	masculine penthemimeral, trithemimeral
χλωρᾶς ἐκ βοτάνας· ὁ δὲ τὰν Γαλάτειαν ἀείδων	-- - uu- u u - uu-u u--	dactylic hexameter	masculine penthemimeral, hepthemimeral, trithemimeral
αὐτόθ᾽ ἐπ᾽ ἀιόνος κατετάκετο φυκιοέσσας	-u u --- uu-uu -uu--	dactylic hexameter	masculine penthemimeral
ἐξ ἀοῦς, ἔχθιστον ἔχων ὑποκάρδιον ἕλκος	- -- -- -- uu-uu --	dactylic hexameter	masculine penthemimeral, hepthemimeral, trithemimeral
Κύπριδος ἐκ μεγάλας, τό οἱ ἥπατι πᾶξε βέλεμνον.	-uu - uu- u u -uu -u u--	dactylic hexameter	masculine penthemimeral, trithemimeral
ἀλλὰ τὸ φάρμακον εὗρε, καθεζόμενος δ᾽ἐπὶ πέτρας	-u u -uu -u u-uu- uu --	dactylic hexameter	feminine penthemimeral
ὑψηλᾶς ἐς πόντον ὁρῶν ἄειδε τοιαῦτα.	--- - -u u- --u u--	dactylic hexameter	feminine penthemimeral, hepthemimeral, trithemimeral
Ὠ λευκὰ Γαλάτεια, τί τὸν φιλέοντ᾽ ἀποβάλλῃ;	- -- uu-u u - uu- uu--	dactylic hexameter	feminine penthemimeral, hepthemimeral, trithemimeral
λευκοτέρα πακτᾶς ποτιδεῖν, ἁπαλωτέρα ἀρνός,	-uu- -- uu- uu-uu --	dactylic hexameter	masculine penthemimeral, hepthemimeral, trithemimeral
μόσχω γαυροτέρα, σφριγανωτέρα ὄμφακος ὠμᾶς.	-- -uu- uu-uu -uu --	dactylic hexameter	masculine penthemimeral
φοιτῇς δ᾽αὖθ᾽ οὑτῶς, ὅκκα γλυκὺς ὕπνος ἔχῃ με,	-- - -- -- uu -u u- -	dactylic hexameter	masculine penthemimeral, hepthemimeral, trithemimeral
οἴχῃ δ᾽εὐθὺς ἰοῖσ᾽, ὅκκα γλυκὺς ὕπνος ἀνῇ με,	-- -u u- -- uu -u u- -	dactylic hexameter	masculine penthemimeral, hepthemimeral
φεύγεις δ᾽ὥσπερ ὄις πολιὸν λύκον ἀθρήσασα.	-- -- - uu- uu ----	dactylic hexameter	masculine penthemimeral, hepthemimeral
ἠράσθην μὲν ἔγωγα τεοῦς κόρα, ἁνίκα πρᾶτον	--- u u-u u- uu -uu --	dactylic hexameter	feminine penthemimeral, hepthemimeral, trithemimeral
ἦνθες ἐμᾷ σὺν ματρὶ θέλοισ᾽ ὑακίνθινα φύλλα	-u u- - -u u- uu-uu --	dactylic hexameter	feminine penthemimeral, hepthemimeral, trithemimeral
ἐξ ὄρεος δρέψασθαι, ἐγὼ δ᾽ὁδὸν ἁγεμόνευον.	- uu- --u u- uu -uu--	dactylic hexameter	feminine penthemimeral, hepthemimeral, trithemimeral
παύσασθαι δ᾽ἐσιδών τυ καὶ ὕστερον οὐδέ τί πᾳ νῦν	--- uu- u u -uu -u u - -	dactylic hexameter	masculine penthemimeral, trithemimeral
ἐκ τήνω δύναμαι· τὶν δ᾽οὐ μέλει, οὐ μὰ Δί᾽ οὐδέν.	- -- uu- - - uu - u u --	dactylic hexameter	masculine penthemimeral, hepthemimeral, trithemimeral
γινώσκω χαρίεσσα κόρα, τίνος ὥνεκα φεύγεις·	--- uu-u u- uu -uu --	dactylic hexameter	feminine penthemimeral, hepthemimeral, trithemimeral
ὥνεκά μοι λασία μὲν ὀφρῦς ἐπὶ παντὶ μετώπῳ	-uu - uu- u u- uu -u u--	dactylic hexameter	masculine penthemimeral, hepthemimeral, trithemimeral
ἐξ ὠτὸς τέταται ποτὶ θὥτερον ὦς μία μακρά,	- -- uu- uu -uu - uu --	dactylic hexameter	masculine penthemimeral, trithemimeral
εἷς δ᾽ὀφθαλμὸς ἔπεστι, πλατεῖα δὲ ῥὶς ἐπὶ χείλει.	- --u u-u u-u - - uu --	lyric	
ἀλλ᾽ οὗτος τοιοῦτος ἐὼν βοτὰ χίλια βόσκω,	- -- --u u- uu -uu --	dactylic hexameter	feminine penthemimeral, hepthemimeral, trithemimeral
κἠκ τούτων τὸ κράτιστον ἀμελγόμενος γάλα πίνω·	- -- u u-u u-uu- uu --	dactylic hexameter	feminine penthemimeral, trithemimeral
τυρὸς δ᾽οὐ λείπει μ᾽οὔτ᾽ ἐν θέρει οὔτ᾽ ἐν ὀπώρᾳ,	-- - -- - - uu - u u--	dactylic hexameter	masculine penthemimeral, hepthemimeral, trithemimeral
οὐ χειμῶνος ἄκρω· ταρσοὶ δ᾽ὑπεραχθέες αἰεί.	- --u u- -- uu-uu --	dactylic hexameter	masculine penthemimeral, hepthemimeral
συρίσδεν δ᾽ὡς οὔτις ἐπίσταμαι ὧδε Κυκλώπων,	--- - -u u-uu -u u--	dactylic hexameter	feminine penthemimeral, trithemimeral
τὶν τὸ φίλον γλυκύμαλον ἁμᾷ κἠμαυτὸν ἀείδων	- u u- uu-u u- --u u--	dactylic hexameter	feminine penthemimeral, hepthemimeral, trithemimeral
πολλάκι νυκτὸς ἀωρί. τρέφω δέ τοι ἕνδεκα νεβρὼς	-uu -u u-u u- u u -uu --	dactylic hexameter	feminine penthemimeral, hepthemimeral
πάσας μηνοφόρως καὶ σκύμνως τέσσαρας ἄρκτων.	-- -uu- - -- -uu --	dactylic hexameter	masculine penthemimeral
ἀλλ᾽ ἀφίκευσο ποθ᾽ ἁμέ, καὶ ἑξεῖς οὐδὲν ἔλασσον,	- uu-u u -u u -- -u u--	dactylic hexameter	feminine penthemimeral
τὰν γλαυκὰν δὲ θάλασσαν ἔα ποτὶ χέρσον ὀρεχθεῖν.	- -- u u-u u- uu -u --	lyric	
ἅδιον ἐν τὤντρῳ παρ᾽ ἐμὶν τὰν νύκτα διαξεῖς.	-uu - -- u u- - -u u--	dactylic hexameter	masculine penthemimeral, hepthemimeral, trithemimeral
ἐντὶ δάφναι τηνεῖ, ἐντὶ ῥαδιναὶ κυπάρισσοι,	-u u- -- -- uu- uu--	dactylic hexameter	masculine penthemimeral, hepthemimeral, trithemimeral
ἔστι μέλας κισσός, ἔστ᾽ ἄμπελος ἁ γλυκύκαρπος,	-u u- -- - -uu - uu--	dactylic hexameter	masculine penthemimeral, trithemimeral
ἔστι ψυχρὸν ὕδωρ, τό μοι ἁ πολυδένδρεος Αἴτνα	-- -u u- u u - uu-uu --	dactylic hexameter	masculine penthemimeral, hepthemimeral
λευκᾶς ἐκ χιόνος ποτὸν ἀμβρόσιον προΐητι.	-- - uu- uu -uu- uu--	dactylic hexameter	masculine penthemimeral, trithemimeral
τίς κα τῶνδε θάλασσαν ἔχειν καὶ κύμαθ᾽ ἕλοιτο;	- - -u u-u u- - -u u--	dactylic hexameter	feminine penthemimeral, hepthemimeral
αἰ δέ τοι αὐτὸς ἐγὼ δοκέω λασιώτερος ἦμεν,	- u u -u u- uu- uu-uu --	dactylic hexameter	masculine penthemimeral, hepthemimeral
ἐντὶ δρυὸς ξύλα μοι καὶ ὑπὸ σποδῷ ἀκάματον πῦρ.	-u u- uu - u u- uu -uu- -	dactylic hexameter	masculine penthemimeral, hepthemimeral, trithemimeral
καιόμενος δ᾽ὑπὸ τεῦς καὶ τὰν ψυχὰν ἀνεχοίμαν	-uu- uu - - - uu ----	dactylic hexameter	masculine penthemimeral, hepthemimeral, trithemimeral
καὶ τὸν ἕν᾽ ὀφθαλμόν, τῶ μοι γλυκερώτερον οὐδέν.	- u u --- - - uu-uu --	dactylic hexameter	masculine penthemimeral, hepthemimeral
ὤμοι, ὅ τ᾽οὐκ ἔτεκέν μ᾽ἁ μάτηρ βραγχί᾽ ἔχοντα,	-u u - uu- u u- -- ---	dactylic hexameter	masculine penthemimeral, hepthemimeral, trithemimeral
ὡς κατέδυν ποτὶ τὶν καὶ τὰν χέρα τευς ἐφίλασα,	- uu- uu - - - uu - uu--	dactylic hexameter	masculine penthemimeral, hepthemimeral, trithemimeral
αἰ μὴ τὸ στόμα λῇς, ἔφερον δέ τοι ἢ κρίνα λευκὰ	- - - uu - uu- u u - uu --	dactylic hexameter	masculine penthemimeral, hepthemimeral, trithemimeral
ἢ μάκων᾽ ἁπαλὰν ἐρυθρὰ πλαταγώνι᾽ ἔχοισαν.	- -- uu- uu- uu-u u--	dactylic hexameter	masculine penthemimeral, hepthemimeral, trithemimeral
ἀλλὰ τὰ μὲν θέρεος, τὰ δὲ γίνεται ἐν χειμῶνι,	-u u - uu- u u -uu - ---	dactylic hexameter	masculine penthemimeral, trithemimeral
ὥστ᾽ οὐκ ἄν τοι ταῦτα φέρειν ἅμα πάντ᾽ ἐδυνάθην.	- - - - -u u- uu - uu--	dactylic hexameter	feminine penthemimeral, hepthemimeral, trithemimeral
νῦν μὰν ὦ κόριον, νῦν αὐτόγα νεῖν κε μάθοιμι,	- - - uu- - -uu - u u--	dactylic hexameter	masculine penthemimeral, trithemimeral
αἴκά τις σὺν ναῒ πλέων ξένος ὧδ᾽ ἀφίκηται,	-- - - -u u- uu - uu--	dactylic hexameter	feminine penthemimeral, hepthemimeral, trithemimeral
ὡς εἰδῶ, τί ποθ᾽ ἁδὺ κατοικεῖν τὸν βυθὸν ὔμμιν.	- -- u u -u u-- - uu --	dactylic hexameter	feminine penthemimeral, trithemimeral
ἐξένθοις Γαλάτεια καὶ ἐξενθοῖσα λάθοιο	--- uu-u u ---u u--	dactylic hexameter	feminine penthemimeral, trithemimeral
ὥσπερ ἐγὼ νῦν ὧδε καθήμενος οἴκαδ᾽ ἀπενθεῖν.	-u u- - -u u-uu -u u--	dactylic hexameter	feminine penthemimeral, trithemimeral
ποιμαίνειν δ᾽ἐθέλοις σὺν ἐμὶν ἅμα καὶ γάλ᾽ ἀμέλγειν	--- uu- u u- uu - u u--	dactylic hexameter	masculine penthemimeral, hepthemimeral, trithemimeral
καὶ τυρὸν πᾶξαι τάμισον δριμεῖαν ἐνεῖσα.	- -- -- uu- --u u--	dactylic hexameter	masculine penthemimeral, hepthemimeral, trithemimeral
ἁ μάτηρ ἀδικεῖ με μόνα, καὶ μέμφομαι αὐτᾷ·	- -- uu- u u- - -uu --	dactylic hexameter	masculine penthemimeral, hepthemimeral, trithemimeral
οὐδὲν πήποχ᾽ ὅλως ποτὶ τὶν φίλον εἶπεν ὑπέρ μευ,	-- -u u- uu - uu -u u- -	dactylic hexameter	masculine penthemimeral, hepthemimeral
καὶ ταῦτ᾽ ἆμαρ ἐπ᾽ ἆμαρ ὁρεῦσά με λεπτὸν ἐόντα.	- - -u u -u u-u u -u u--	dactylic hexameter	feminine penthemimeral
φασῶ τὰν κεφαλὰν καὶ τὼς πόδας ἀμφοτέρως μευ	-- - uu- - - uu -uu- -	dactylic hexameter	masculine penthemimeral, hepthemimeral, trithemimeral
σφύζειν, ὡς ἀνιαθῇ, ἐπεὶ κἠγὼν ἀνιῶμαι.	-- - uu-u u- -- uu--	dactylic hexameter	feminine penthemimeral, hepthemimeral, trithemimeral
ὦ Κύκλωψ Κύκλωψ, πᾷ τὰς φρένας ἐκπεπότασαι;	- -- -- - - uu -uu--	dactylic hexameter	masculine penthemimeral, hepthemimeral, trithemimeral
αἴκ᾽ ἐνθὼν θαλάρως τε πλέκοις καὶ θαλλὸν ἀμάσας	- -- uu- u u- - -u u--	dactylic hexameter	masculine penthemimeral, hepthemimeral, trithemimeral
ταῖς ἄρνεσσι φέροις, τάχα κα πολὺ μᾶλλον ἔχοις νῶν.	- --u u- uu - uu -u u- -	dactylic hexameter	masculine penthemimeral, hepthemimeral
τὰν παρεοῖσαν ἄμελγε. τί τὸν φεύγοντα διώκεις;	- uu-u u-u u - --u u--	dactylic hexameter	feminine penthemimeral, hepthemimeral
εὑρησεῖς Γαλάτειαν ἴσως καὶ καλλίον᾽ ἄλλαν.	--- uu-u u- - -uu --	dactylic hexameter	feminine penthemimeral, hepthemimeral, trithemimeral
πολλαὶ συμπαίσδέν με κόραι τὰν νύκτα κέλονται,	-- --- u u- - -u u--	dactylic hexameter	masculine penthemimeral, hepthemimeral
κιχλίζοντι δὲ πᾶσαι, ἐπεί κ᾽αὐταῖς ὑπακούσω	---u u -u u- -- uu--	dactylic hexameter	feminine penthemimeral, hepthemimeral
δῆλον ὅ τ᾽ἐν τᾷ γᾷ κἠγώ τις φαίνομαι ἦμεν.	-u u - - - -- - -uu --	dactylic hexameter	masculine penthemimeral, hepthemimeral, trithemimeral
οὕτω τοι Πολύφαμος ἐποίμαινεν τὸν ἔρωτα	-- - uu-u u--- u u--	dactylic hexameter	feminine penthemimeral, trithemimeral
μουσίσδων, ῥᾷον δὲ διᾶγ᾽ ἢ εἰ χρυσὸν ἔδωκεν.	--- -- u u- - -u u--	dactylic hexameter	masculine penthemimeral, hepthemimeral, trithemimeral
Ἤλυθες ὦ φίλε κοῦρε τρίτῃ σὺν νυκτὶ καὶ ἀοῖ;	-uu - uu -u u- - -u u --	dactylic hexameter	feminine penthemimeral, hepthemimeral, trithemimeral
ἤλυθες· οἱ δὲ ποθεῦντες ἐν ἤματι γηράσκουσιν.	-uu - u u-u u -uu ----	dactylic hexameter	feminine penthemimeral, trithemimeral
ὅσσον ἔαρ χειμῶνος, ὅσον μᾶλον βραβίλοιο	-u u- --u u- -- uu--	dactylic hexameter	feminine penthemimeral, hepthemimeral, trithemimeral
ἅδιον, ὅσσον ὄις σφετέρας λασιωτέρα ἀρνός,	-uu -- - uu- uu-uu --	dactylic hexameter	masculine penthemimeral, hepthemimeral
ὅσσον παρθενικὴ προφέρει τριγάμοιο γυναικός,	-- -uu- uu- uu-u u--	dactylic hexameter	masculine penthemimeral, hepthemimeral
ὅσσον ἐλαφροτέρη μόσχου νεβρός, ὅσσον ἀηδὼν	-u u-uu- -- uu -u u--	dactylic hexameter	masculine penthemimeral, hepthemimeral
συμπάντων λιγύφωνος ἀοιδοτάτη πετεηνῶν,	--- uu-u u-uu- uu--	dactylic hexameter	feminine penthemimeral, trithemimeral
τόσσον ἔμ᾽ εὔφρανας τὺ φανείς, σκιερὰν δ᾽ὑπὸ φαγὸν	-u u --- u u- uu- uu --	dactylic hexameter	masculine penthemimeral, hepthemimeral
ἀελίου φρύγοντος ὁδοιπόρος ἔδραμον ὥς τις.	-uu- --u u-uu -uu - -	dactylic hexameter	feminine penthemimeral, trithemimeral
εἴθ᾽ ὁμαλοὶ πνεύσειαν ἐπ᾽ ἀμφοτέροισιν Ἔρωτες	- uu- --u u -uu-u u--	dactylic hexameter	feminine penthemimeral, trithemimeral
νῶιν, ἐπεσσομένοις δὲ γενοίμεθα πᾶσιν ἀοιδά.	-u u-uu- u u-uu -u u--	dactylic hexameter	masculine penthemimeral
θείω δή τινε τώδε μετὰ προτέροισι γενέσθην	-- - uu -u u- uu-u u--	dactylic hexameter	feminine penthemimeral, hepthemimeral, trithemimeral
φῶθ᾽, ὁ μὲν εἴσπνηλος, φαίη χ᾽ὡμυκλαϊάσδων,	- u u --- -- --uu--	dactylic hexameter	masculine penthemimeral, hepthemimeral
τὸν δ᾽ἕτερον πάλιν ὥς κεν ὁ Θεσσαλὸς εἴποι ἀίταν.	- uu- uu - u u -uu -u u--	dactylic hexameter	masculine penthemimeral, trithemimeral
ἀλλήλους δ᾽ἐφίλησαν ἴσῳ ζυγῷ. ἦ ῥα τότ᾽ ἦσαν	--- uu-u u- uu - u u --	dactylic hexameter	feminine penthemimeral, hepthemimeral, trithemimeral
χρύσειοι πάλιν ἄνδρες, ὃ κἀντεφίλησ᾽ ὁ φιληθείς.	--- uu -u u -uu- u u--	dactylic hexameter	feminine penthemimeral, trithemimeral
εἰ γὰρ τοῦτο πάτερ Κρονίδα πέλοι, εἰ γὰρ ἀγήρῳ	- - -u u- uu- uu - u u--	dactylic hexameter	masculine penthemimeral, hepthemimeral
ἀθάνατοι, γενεαῖς δὲ διηκοσίαισιν ἔπειτα	-uu- uu- u u-uu-u u--	dactylic hexameter	masculine penthemimeral, trithemimeral
ἀγγείλειεν ἐμοί τις ἀνέξοδον εἰς Ἀχέροντα·	---u u- u u-uu - uu--	dactylic hexameter	masculine penthemimeral
"ἡ σὴ νῦν φιλότης καὶ τοῦ χαρίεντος ἀίτεω	- - - uu- - - uu-u u--	dactylic hexameter	masculine penthemimeral, hepthemimeral, trithemimeral
πᾶσι διὰ στόματος, μετὰ δ᾽ἠιθέοισι μάλιστα."	-u u- uu- uu -uu-u u--	dactylic hexameter	masculine penthemimeral, trithemimeral
ἀλλ᾽ ἤτοι τούτων μὲν ὑπέρτεροι Οὐρανίωνες	- -- -- u u-uu -uu--	dactylic hexameter	masculine penthemimeral, trithemimeral
ἔσσονθ᾽ ὡς ἐθέλοντι. ἐγὼ δέ σε τὸν καλὸν αἰνέων	-- - uu-u u- u u - uu --	dactylic hexameter	feminine penthemimeral, hepthemimeral, trithemimeral
ψεύδεα ῥινὸς ὕπερθεν ἀραιᾶς οὐκ ἀναφύσω.	-uu -u u-u u-- - uu--	dactylic hexameter	feminine penthemimeral
ἢν γὰρ καί τι δάκῃς, τὸ μὲν ἀβλαβὲς εὐθὺς ἔθηκας,	- - - u u- u u -uu -u u--	dactylic hexameter	masculine penthemimeral, trithemimeral
διπλάσιον δ᾽ὤνασας, ἔχων δ᾽ἐπίμετρον ἀπῆνθον.	-uu- --u u- uu-u u--	dactylic hexameter	feminine penthemimeral, hepthemimeral, trithemimeral
Νισαῖοι Μεγαρῆες ἀριστεύοντες ἐρετμοῖς,	--- uu-u u---u u--	dactylic hexameter	feminine penthemimeral, trithemimeral
ὄλβιοι οἰκείοιτε, τὸν Ἀττικὸν ὡς περίαλλα	-uu ---u u -uu - uu--	dactylic hexameter	feminine penthemimeral
ξεῖνον ἐτιμήσασθε Διοκλέα τὸν φιλόπαιδα.	-u u---u u-uu - uu--	dactylic hexameter	feminine penthemimeral
αἰεί οἱ περὶ τύμβον ἀολλέες εἴαρι πράτῳ	-- - uu -u u-uu -uu --	dactylic hexameter	feminine penthemimeral, trithemimeral
κοῦροι ἐριδμαίνοντι φιλήματος ἄκρα φέρεσθαι.	-u u--- --uu -u u--	dactylic hexameter	masculine penthemimeral
ὃς δέ κε προσμάξῃ γλυκερώτερα χείλεσι χείλη,	- u u --- uu-uu -uu --	dactylic hexameter	masculine penthemimeral
βριθόμενος στεφάνοισιν ἑὰν ἐς μητέρ᾽ ἀπῆνθεν.	-uu- uu-u u- - -u u--	dactylic hexameter	feminine penthemimeral, hepthemimeral, trithemimeral
ὄλβιος, ὅστις παισὶ φιλήματα κεῖνα διαιτᾷ.	-uu -- -u u-uu -u u--	dactylic hexameter	feminine penthemimeral
ἦ που τὸν χαροπὸν Γανυμήδεα πόλλ᾽ ἐπιβωτᾷ	- - - uu- uu-uu - uu--	dactylic hexameter	masculine penthemimeral, trithemimeral
Λυδίῃ ἶσον ἔχειν πέτρῃ στόμα, χρυσὸν ὁποίῃ	-uu -u u- -- uu -u u--	dactylic hexameter	masculine penthemimeral, hepthemimeral
πεύθονται μὴ φαῦλος ἐτήτυμω ἀργυραμοιβοί.	--- - -u u-uu -uu--	dactylic hexameter	feminine penthemimeral, trithemimeral
οὐχ ἁμῖν τὸν Ἔρωτα μόνοις ἔτεχ᾽, ὡς ἐδοκεῦμες,	- -- u u-u u- uu - uu--	dactylic hexameter	feminine penthemimeral, hepthemimeral, trithemimeral
Νικία, ᾧ τινι τοῦτο θεῶν ποκα τέκνον ἔγεντο.	-uu - uu -u u- uu -u u--	dactylic hexameter	feminine penthemimeral, hepthemimeral, trithemimeral
οὐχ ἁμῖν τὰ καλὰ πράτοις καλὰ φαίνεται εἶμεν,	- -- u u- -- uu -uu --	dactylic hexameter	masculine penthemimeral, hepthemimeral, trithemimeral
οἳ θνατοὶ πελόμεσθα, τὸ δ᾽αὔριον οὐκ ἐσορῶμες·	- -- uu-u u -uu - uu--	dactylic hexameter	feminine penthemimeral, trithemimeral
ἀλλὰ καὶ ὡμφιτρύωνος ὁ χαλκεοκάρδιος υἱός,	-u u -uu-u u -uu-uu --	dactylic hexameter	feminine penthemimeral
ὃς τὸν λῖν ὑπέμεινε τὸν ἄγριον, ἤρατο παιδός,	- - - uu-u u -uu -uu --	dactylic hexameter	feminine penthemimeral, trithemimeral
τῶ χαρίεντος Ὕλα, τῶ τὰν πλοκαμῖδα φορεῦντος,	- uu-u u- - - uu-u u--	dactylic hexameter	masculine penthemimeral, hepthemimeral
καί νιν πάντ᾽ ἐδίδαξε πατὴρ ὡσεὶ φίλον υἱέα,	- - - uu-u u- -- uu ---	lyric	
ὅσσα μαθὼν ἀγαθὸς καὶ ἀοίδιμος αὐτὸς ἔγεντο·	-u u- uu- u u-uu -u u--	dactylic hexameter	masculine penthemimeral, trithemimeral
χωρὶς δ᾽οὐδέποκ᾽ ἦς, οὔτ᾽ εἰ μέσον ἆμαρ ὄροιτο,	-- -uu - - - uu -u u--	dactylic hexameter	masculine penthemimeral, hepthemimeral
οὔτ᾽ ἄρ᾽ ὅχ᾽ ἁ λεύκιππος ἀνατρέχοι ἐς Διὸς Ἀώς,	- u u - --u u-uu - uu --	dactylic hexameter	feminine penthemimeral, trithemimeral
οὐδ᾽ ὁπόκ᾽ ὀρτάλιχοι μινυροὶ ποτὶ κοῖτον ὁρῷεν,	- uu -uu- uu- uu -u u--	dactylic hexameter	masculine penthemimeral, hepthemimeral
σεισαμένας πτερὰ ματρὸς ἐπ᾽ αἰθαλόεντι πετεύρῳ,	-uu- uu -u u -uu-u u--	dactylic hexameter	feminine penthemimeral, trithemimeral
ὡς αὐτῷ κατὰ θυμὸν ὁ παῖς πεποναμένος εἴη,	- -- uu -u u - uu-uu --	dactylic hexameter	feminine penthemimeral, hepthemimeral, trithemimeral
αὐτῷ δ᾽εὖ ἕλκων ἐς ἀλαθινὸν ἄνδρ᾽ ἀποβαίη.	-- - -- u u-uu - uu--	dactylic hexameter	masculine penthemimeral, trithemimeral
ἀλλ᾽ ὅτε τὸ χρύσειον ἔπλει μετὰ κῶας Ἰήσων	- uu - --u u- uu -u u--	dactylic hexameter	feminine penthemimeral, hepthemimeral, trithemimeral
Αἰσονίδας, οἱ δ᾽αὐτῷ ἀριστῆες συνέποντο	-uu- - -u u--- uu--	dactylic hexameter	feminine penthemimeral, trithemimeral
πασᾶν ἐκ πολίων προλελεγμένοι, ὧν ὄφελός τι,	-- - uu- uu-uu - uu- -	dactylic hexameter	masculine penthemimeral, trithemimeral
ἵκετο χὡ ταλαεργὸς ἀνὴρ ἐς ἀφνειὸν Ἰωλκόν,	-uu - uu-u u- u u-u u--	dactylic hexameter	feminine penthemimeral, hepthemimeral, trithemimeral
Ἀλκμήνης υἱὸς Μιδεάτιδος ἡρωίνης,	--- -- uu-uu ----	dactylic hexameter	masculine penthemimeral, trithemimeral
σὺν δ᾽αὐτῷ κατέβαινεν Ὕλας εὔεδρον ἐς Ἀργώ,	- -- uu-u u- --u u --	dactylic hexameter	feminine penthemimeral, hepthemimeral, trithemimeral
ἅτις κυανεᾶν οὐχ ἥψατο συνδρομάδων ναῦς,	-- -uu- - -uu -uu- -	dactylic hexameter	masculine penthemimeral
ἀλλὰ διεξάιξε, βαθὺν δ᾽εἰσέδραμε Φᾶσιν,	-u u---u u- --uu --	dactylic hexameter	feminine penthemimeral, hepthemimeral
αἰετὸς ἐς μέγα λαῖτμα· ἀφ᾽ οὗ τότε χοιράδες ἔσταν.	-uu - uu -u u - uu -uu --	dactylic hexameter	feminine penthemimeral, hepthemimeral, trithemimeral
ἆμος δ᾽ἀντέλλοντι Πελειάδες, ἐσχατιαὶ δὲ	-- ---u u-uu -uu- -	dactylic hexameter	feminine penthemimeral
ἄρνα νέον βόσκοντι, τετραμμένου εἴαρος ἤδη,	-u u- --u u-uu -uu --	dactylic hexameter	feminine penthemimeral, trithemimeral
τᾶμος ναυτιλίας μιμνάσκετο θεῖος ἄωτος	-- -uu- --uu -u u--	dactylic hexameter	masculine penthemimeral
ἡρώων, κοίλαν δὲ καθιδρυνθέντες ἐς Ἀργὼ	--- -- u u---u u --	dactylic hexameter	masculine penthemimeral, trithemimeral
Ἑλλάσποντον ἵκοντο νότῳ τρίτον ἆμαρ ἀέντι,	---u u-u u- uu -u u--	dactylic hexameter	feminine penthemimeral, hepthemimeral
εἴσω δ᾽ὅρμον ἔθεντο Προποντίδος, ἔνθα Κιανῶν	-- -u u-u u-uu -u u--	dactylic hexameter	feminine penthemimeral
αὔλακας εὐρύνοντι βόες τρίβοντες ἄροτρα.	-uu ---u u- --u u--	dactylic hexameter	feminine penthemimeral, hepthemimeral
ἐκβάντες δ᾽ἐπὶ θῖνα κατὰ ζυγὰ δαῖτα πένοντο	--- uu -u u- uu -u u--	dactylic hexameter	feminine penthemimeral, hepthemimeral, trithemimeral
δειελινοί, πολλοὶ δὲ μίαν στορέσαντο χαμεύναν.	-uu- -- u u- uu-u u--	dactylic hexameter	masculine penthemimeral, hepthemimeral, trithemimeral
λειμὼν γάρ σφιν ἔκειτο, μέγα στιβάδεσσιν ὄνειαρ,	-- - u u-u u- uu-u u--	dactylic hexameter	feminine penthemimeral, hepthemimeral, trithemimeral
ἔνθεν βούτομον ὀξὺ βαθύν τ᾽ἐτάμοντο κύπειρον.	-- -uu -u u- uu-u u--	dactylic hexameter	feminine penthemimeral, hepthemimeral
κᾤχεθ᾽ Ὕλας ὁ ξανθὸς ὕδωρ ἐπιδόρπιον οἰσῶν	-u u- - -u u- uu-uu --	dactylic hexameter	feminine penthemimeral, hepthemimeral, trithemimeral
αὐτῷ θ᾽Ἡρακλῆι καὶ ἀστεμφεῖ Τελαμῶνι,	-- ---u u --- uu--	dactylic hexameter	feminine penthemimeral
οἳ μίαν ἄμφω ἑταῖροι ἀεὶ δαίνυντο τράπεζαν,	- uu -u u-u u- --u u--	dactylic hexameter	feminine penthemimeral, hepthemimeral
χάλκεον ἄγγος ἔχων. τάχα δὲ κράναν ἐνόησεν	-uu -u u- uu - uu ----	dactylic hexameter	masculine penthemimeral, hepthemimeral
ἡμένῳ ἐν χώρῳ· περὶ δὲ θρύα πολλὰ πεφύκει,	-uu - -- uu - uu -u u--	dactylic hexameter	masculine penthemimeral, hepthemimeral, trithemimeral
κυάνεόν τε χελιδόνιον χλωρόν τ᾽ἀδίαντον	-uu- u u-uu- -- uu--	dactylic hexameter	hepthemimeral, trithemimeral
καὶ θάλλοντα σέλινα καὶ εἰλιτενὴς ἄγρωστις.	- --u u-u u -uu- ---	dactylic hexameter	feminine penthemimeral
ὕδατι δ᾽ἐν μέσσῳ Νύμφαι χορὸν ἀρτίζοντο,	-uu - -- -- uu ----	dactylic hexameter	masculine penthemimeral, hepthemimeral, trithemimeral
νύμφαι ἀκοίμητοι, δειναὶ θεαὶ ἀγροιώταις,	-u u--- -- uu ----	dactylic hexameter	masculine penthemimeral, hepthemimeral
Εὐνείκα καὶ Μαλὶς ἔαρ θ᾽ὁρόωσα Νύχεια,	--- - -u u- uu-u u--	dactylic hexameter	feminine penthemimeral, hepthemimeral, trithemimeral
ἤτοι ὁ κοῦρος ἐπεῖχε ποτῷ πολυχανδέα κρωσσὸν	-u u -u u-u u- uu-uu --	dactylic hexameter	feminine penthemimeral, hepthemimeral
βάψαι ἐπειγόμενος, ταὶ δ᾽ἐν χερὶ πᾶσαι ἔφυσαν·	-u u-uu- - - uu -u u--	dactylic hexameter	masculine penthemimeral, hepthemimeral
πασάων γὰρ ἔρως ἁπαλὰς φρένας ἐξεσόβησεν	--- u u- uu- uu -uu--	dactylic hexameter	masculine penthemimeral, hepthemimeral, trithemimeral
Ἀργείῳ ἐπὶ παιδί· κατήριπε δ᾽ἐς μέλαν ὕδωρ	--- uu -u u-uu - uu --	dactylic hexameter	feminine penthemimeral, trithemimeral
ἀθρόος, ὡς ὅτε πυρσὸς ἀπ᾽ οὐρανοῦ ἤριπεν ἀστὴρ	-uu - uu -u u -uu -uu --	dactylic hexameter	feminine penthemimeral, trithemimeral
ἀθρόος, ἐν πόντῳ, ναύταις δέ τις εἶπεν ἑταίροις·	-uu - -- -- u u -u u--	dactylic hexameter	masculine penthemimeral, hepthemimeral, trithemimeral
"κουφότερ᾽ ὦ παῖδες ποιεῖσθ᾽ ὅπλα· πνευστικὸς οὖρος."	-uu - -- -- uu -uu --	dactylic hexameter	masculine penthemimeral, hepthemimeral, trithemimeral
νύμφαι μὲν σφετέροις ἐπὶ γούνασι κοῦρον ἔχοισαι	-- - uu- uu -uu -u u--	dactylic hexameter	masculine penthemimeral, trithemimeral
δακρυόεντ᾽ ἀγανοῖσι παρεψύχοντ᾽ ἐπέεσσιν.	-uu- uu-u u--- uu--	dactylic hexameter	feminine penthemimeral, trithemimeral
Ἀμφιτρυωνιάδας δὲ ταρασσόμενος περὶ παιδὶ	-uu-uu- u u-uu- uu --	dactylic hexameter	masculine penthemimeral
ᾤχετο, μαιωτιστὶ λαβὼν εὐκαμπέα τόξα	-uu ---u u- --uu --	dactylic hexameter	feminine penthemimeral, hepthemimeral
καὶ ῥόπαλον, τό οἱ αἰὲν ἐχάνδανε δεξιτερὴ χείρ.	- uu- u u -u u-uu -uu- -	dactylic hexameter	feminine penthemimeral, trithemimeral
τρὶς μὲν Ὕλαν ἄυσεν, ὅσον βαρὺς ἤρυγε λαιμός·	- u u- -- -- uu -uu --	dactylic hexameter	masculine penthemimeral, hepthemimeral, trithemimeral
τρὶς δ᾽ἄρ᾽ ὁ παῖς ὑπάκουσεν, ἀραιὰ δ᾽ἵκετο φωνὰ	- u u - uu-u u-u u-- --	dactylic hexameter	feminine penthemimeral, trithemimeral
ἐξ ὕδατος, παρεὼν δὲ μάλα σχεδὸν εἴδετο πόρρω.	- uu- uu- u u- uu -uu --	dactylic hexameter	masculine penthemimeral, hepthemimeral, trithemimeral
ὡς δ᾽ὁπότ᾽ ἠυγένειος ἀπόπροθι λῖς ἐσακούσας†,	- uu -uu-u u-uu - uu--	dactylic hexameter	feminine penthemimeral
νεβροῦ φθεγξαμένας τις ἐν οὔρεσιν ὠμοφάγος λῖς	-- -uu- u u -uu -uu- -	dactylic hexameter	masculine penthemimeral
ἐξ εὐνᾶς ἔσπευσεν ἑτοιμοτάταν ἐπὶ δαῖτα·	- -- --u u-uu- uu --	dactylic hexameter	feminine penthemimeral, trithemimeral
Ἡρακλέης τοιοῦτος ἐν ἀτρίπτοισιν ἀκάνθαις	-uu- --u u ---u u--	dactylic hexameter	feminine penthemimeral, trithemimeral
παῖδα ποθῶν δεδόνητο, πολὺν δ᾽ἐπελάμβανε χῶρον.	-u u- uu-u u- uu-uu --	dactylic hexameter	feminine penthemimeral, hepthemimeral, trithemimeral
σχέτλιοι οἱ φιλέοντες· ἀλώμενος ὅσσ᾽ ἐμόγησεν	-- - uu-u u-uu - uu--	dactylic hexameter	feminine penthemimeral, trithemimeral
οὔρεα καὶ δρυμούς, τὰ δ᾽Ἰήσονος ὕστερα πάντ᾽ ἦς.	-uu - -- u u-uu -uu - -	dactylic hexameter	masculine penthemimeral, trithemimeral
ναῦς γέμεν ἄρμεν᾽ ἔχοισα μετάρσια τῶν παρεόντων,	- uu -u u-u u-uu - uu--	dactylic hexameter	feminine penthemimeral
ἱστία δ᾽ἡμίθεοι μεσονύκτιον ἐξεκάθαιρον	-uu -uu- uu-uu -uu--	dactylic hexameter	masculine penthemimeral
Ἡρακλῆα μένοντες. ὁ δ᾽ᾇ πόδες ἆγον ἐχώρει	---u u-u u - uu -u u--	dactylic hexameter	feminine penthemimeral, hepthemimeral
μαινόμενος· χαλεπὸς γὰρ ἔσω θεὸς ἧπαρ ἄμυσσεν.	-uu- uu- u u- uu -u u--	dactylic hexameter	masculine penthemimeral, hepthemimeral, trithemimeral
οὕτω μὲν κάλλιστος Ὕλας μακάρων ἀμιθρεῖται·	-- - --u u- uu- uu--	dactylic hexameter	feminine penthemimeral, hepthemimeral, trithemimeral
Ἡρακλέην δ᾽ἥρωες ἐκερτόμεον λιποναύταν,	-uu- --u u-uu- uu--	dactylic hexameter	feminine penthemimeral, trithemimeral
οὕνεκεν ἠρώησε τριακοντάζυγον Ἀργώ,	-uu ---u u---uu --	dactylic hexameter	feminine penthemimeral
πεζᾷ δ᾽ἐς Κόλχους τε καὶ ἄξενον ἵκετο Φᾶσιν.	-- - -- u u -uu -uu --	dactylic hexameter	masculine penthemimeral, trithemimeral
χαίρειν πολλὰ τὸν ἄνδρα Θυώνιχον. ἀλλὰ τὺ ταὐτά,	-- -u u -u u-uu -u u --	dactylic hexameter	feminine penthemimeral
Αἰσχίνα. ὡς χρόνιος. χρόνιος; τί δέ τοι τὸ μέλημα;	-uu - uu- uu- u u - u u--	dactylic hexameter	masculine penthemimeral, hepthemimeral, trithemimeral
πράσσομες οὐχ ὡς λῷστα Θυώνιχε. ταῦτ᾽ ἄρα λεπτός,	-uu - - -u u-uu - uu --	dactylic hexameter	feminine penthemimeral, trithemimeral
χὡ μύσταξ πολὺς οὗτος, ἀυσταλέοι δὲ κίκιννοι.	- -- uu -u u-uu- u u--	dactylic hexameter	feminine penthemimeral, trithemimeral
τοιοῦτος πρώαν τις ἀφίκετο Πυθαγορικτάς,	--- -- u u-uu -uu--	dactylic hexameter	masculine penthemimeral, trithemimeral
ὠχρὸς κἀνυπόδητος· Ἀθηναῖος δ᾽ἔφατ᾽ ἦμεν.	-- -uu-u u--- uu --	dactylic hexameter	feminine penthemimeral
ἤρατο μὰν καὶ τῆνος, ἐμὶν δοκεῖ, ὀπτῶ ἀλεύρω.	-uu - - -u u- uu -u u--	dactylic hexameter	feminine penthemimeral, hepthemimeral, trithemimeral
παίσδεις ὦγάθ᾽ ἔχων· ἐμὲ δ᾽ἁ χαρίεσσα Κυνίσκα	-- -u u- uu - uu-u u--	dactylic hexameter	masculine penthemimeral, hepthemimeral
ὑβρίσδει· λασῶ δὲ μανείς ποκα, θρὶξ ἀνὰ μέσσον.	--- -- u u- uu - uu --	dactylic hexameter	masculine penthemimeral, hepthemimeral, trithemimeral
τοιοῦτος μὲν ἀεὶ τὺ φίλ᾽ Αἰσχίνα, ἁσυχᾷ ὀξύς,	--- u u- u u -uu -uu --	dactylic hexameter	masculine penthemimeral, trithemimeral
πάντ᾽ ἐθέλων κατὰ καιρόν· ὅμως δ᾽εἶπον, τί τὸ καινόν.	- uu- uu -u u- -- u u --	dactylic hexameter	feminine penthemimeral, hepthemimeral, trithemimeral
ὡργεῖος κἠγὼ καὶ ὁ Θεσσαλὸς ἱπποδιώκτας	--- -- u u -uu -uu--	dactylic hexameter	masculine penthemimeral, trithemimeral
Ἀπις καὶ Κλεύνικος ἐπίνομες ὁ στρατιώτας	-- - --u u-uu - uu--	dactylic hexameter	feminine penthemimeral, trithemimeral
ἐν χώρῳ παρ᾽ ἐμίν. δύο μὲν κατέκοψα νεοσσὼς	- -- u u- uu - uu-u u--	dactylic hexameter	masculine penthemimeral, hepthemimeral, trithemimeral
θηλάζοντά τε χοῖρον, ἀνῷξα δὲ βίβλινον αὐτοῖς	---u u -u u-u u -uu --	dactylic hexameter	feminine penthemimeral
εὐώδη, τετόρων ἐτέων, σχεδὸν ὡς ἀπὸ λανῶ.	--- uu- uu- uu - uu --	dactylic hexameter	masculine penthemimeral, hepthemimeral, trithemimeral
βολβὸς κτεὶς κοχλίας ἐξῃρέθη. ἦς πότος ἁδύς.	-- - uu- --uu - uu --	dactylic hexameter	masculine penthemimeral, trithemimeral
ἤδη δὲ προϊόντος, ἔδοξ᾽ ἐπιχεῖσθαι ἄκρατον	-- - uu-u u- uu-u u--	dactylic hexameter	feminine penthemimeral, hepthemimeral, trithemimeral
ὧτινος ἤθελ᾽ ἕκαστος· ἔδει μόνον ὧτινος εἰπεῖν.	-uu -u u-u u- uu -uu --	dactylic hexameter	feminine penthemimeral, hepthemimeral
ἄμμες μὲν φωνεῦντες ἐπίνομες, ὡς ἐδέδοκτο·	-- - --u u-uu - uu--	dactylic hexameter	feminine penthemimeral, trithemimeral
ἁ δ᾽οὐδὲν παρεόντος ἐμεῦ. τίν᾽ ἔχειν με δοκεῖς νοῦν;	- -- uu-u u- u u- u u- -	dactylic hexameter	feminine penthemimeral, hepthemimeral, trithemimeral
"οὐ φθεγξῇ; λύκον εἶδες·" ἔπαιξέ τις. "ὡς σοφός" εἶπε,	- -- uu -u u-u u - uu --	dactylic hexameter	feminine penthemimeral, trithemimeral
κἠφᾶπτ᾽· εὐμαρέως κεν ἀπ᾽ αὐτᾶς καὶ λύχνον ἇψας.	-- -uu- u u -- - - --	dactylic hexameter	masculine penthemimeral
ἔστι Λύκος, Λύκος ἐστί, Λάβα τῶ γείτονος υἱός,	-u u- uu -u u- - -uu --	dactylic hexameter	feminine penthemimeral, hepthemimeral, trithemimeral
εὐμάκης ἁπαλός, πολλοῖς δοκέων καλὸς ἦμεν.	--- uu- -- uu- uu --	dactylic hexameter	masculine penthemimeral, hepthemimeral, trithemimeral
τούτω τὸν κλύμενον κατετάκετο τῆνον ἔρωτα.	-- - uu- uu-uu -u u--	dactylic hexameter	masculine penthemimeral, trithemimeral
χἁμῖν τοῦτο δι᾽ ὠτὸς ἔγεντό ποθ᾽ ἁσυχᾷ οὑτῶς·	-- -u u -u u-u u -uu --	dactylic hexameter	feminine penthemimeral
οὐ μὰν ἐξήταξα μάταν εἰς ἄνδρα γενειῶν.	- - ---u u- - -u u--	dactylic hexameter	feminine penthemimeral, hepthemimeral
ἤδη δ᾽ὦν πόσιος τοὶ τέσσαρες ἐν βάθει ἦμες,	-- - uu- - -uu - uu --	dactylic hexameter	masculine penthemimeral, trithemimeral
χὡ Λαρισαῖος "τὸν ἐμὸν Λύκον" ᾆδεν ἀπ᾽ ἀρχᾶς,	- uu-u u- -- uu -u u --	dactylic hexameter	masculine penthemimeral, hepthemimeral
Θεσσαλικόν τι μέλισμα, κακαὶ φρένες· ἁ δὲ Κυνίσκα	-uu- u u-u u- uu - u u--	dactylic hexameter	feminine penthemimeral, hepthemimeral, trithemimeral
ἔκλαι᾽ ἐξαπίνας θαλερώτερον ἢ παρὰ ματρὶ	-- -uu- uu-uu - uu --	dactylic hexameter	masculine penthemimeral
παρθένος ἑξαέτης κόλπω ἐπιθυμήσασα.	-uu -uu- -- uu----	dactylic hexameter	masculine penthemimeral, hepthemimeral
τᾶμος ἐγώ, τὸν ἴσαις τὺ Θυώνιχε, πὺξ ἐπὶ κόρρας	-u u- u u- u u-uu - uu --	dactylic hexameter	masculine penthemimeral, trithemimeral
ἤλασα, κἄλλαν αὖθις. ἀνειρύσσασα δὲ πέπλως	-uu -- -u u---u u --	dactylic hexameter	feminine penthemimeral
ἔξω ἀπῴχετο θᾶσσον. "ἐμὸν κακόν, οὔ τοι ἀρέσκω;	-u u-uu -u u- uu - u u--	dactylic hexameter	feminine penthemimeral, hepthemimeral
ἄλλός τοι γλυκίων ὑποκόλπιος; ἄλλον ἰοῖσα	-- - uu- uu-uu -u u--	dactylic hexameter	masculine penthemimeral, trithemimeral
θάλπε φίλον. τήνῳ τὰ σὰ δάκρυα μᾶλα ῥέοντι."	-u u- -- u u -uu -u u--	dactylic hexameter	masculine penthemimeral, trithemimeral
μάστακα δοῖσα τέκνοισιν ὑπωροφίοισι χελιδὼν	-uu -u u-u u-uu-u u--	dactylic hexameter	feminine penthemimeral
ἄψορρον ταχινὰ πέτεται βίον ἄλλον ἀγείρειν·	--- uu- uu- uu -u u--	dactylic hexameter	masculine penthemimeral, hepthemimeral, trithemimeral
ὠκυτέρα μαλακᾶς ἀπὸ δίφρακος ἔδραμε τήνα	-uu- uu- uu -uu -uu --	dactylic hexameter	masculine penthemimeral, trithemimeral
ἰθὺ δι᾽ ἀμφιθύρω καὶ δικλίδος, ᾇ πόδες ἆγον.	-u u -uu- - -uu - uu --	dactylic hexameter	masculine penthemimeral
αἶνός θην λέγεταί τις· ἔβα τάχα ταῦρος ἀν᾽ ὕλαν.	-- - uu- u u- uu -u u --	dactylic hexameter	masculine penthemimeral, hepthemimeral, trithemimeral
εἴκατι· ταὶ δ᾽ὀκτώ, ταὶ δ᾽ἐννέα, ταὶ δὲ δέκ᾽ ἄλλαι,	-uu - -- - -uu - u u --	dactylic hexameter	masculine penthemimeral, trithemimeral
σάμερον ἑνδεκάτα, ποτίθει δύο, καὶ δύο μῆνες,	-uu -uu- uu- uu - uu --	dactylic hexameter	masculine penthemimeral, hepthemimeral
ἐξ ὧ ἀπ᾽ ἀλλάλων. οὐδ᾽ εἰ Θρᾳκιστὶ κέκαρμαι,	- u u --- - - --u u--	dactylic hexameter	masculine penthemimeral, hepthemimeral
οἶδε. Λύκος νῦν πάντα, Λύκῳ καὶ νυκτὸς ἀνῷκται.	-u u- - -u u- - -u u--	dactylic hexameter	feminine penthemimeral, hepthemimeral, trithemimeral
ἄμμες δ᾽οὔτε λόγω τινὸς ἄξιοι οὔτ᾽ ἀριθμητοί,	-- -u u- uu -uu - uu--	dactylic hexameter	masculine penthemimeral
δύστηνοι Μεγαρῆες ἀτιμοτάτῃ ἐνὶ μοίρῃ.	--- uu-u u-uu- uu --	dactylic hexameter	feminine penthemimeral, trithemimeral
κεἰ μὲν ἀποστέρξαιμι, τὰ πάντά κεν εἰς δέον ἕρποι.	- u u---u u -u u - uu --	dactylic hexameter	feminine penthemimeral
νῦν δὲ πόθεν; μῦς, φαντὶ Θυώνιχε, γεύμεθα πίσσας.	- u u- - -u u-uu -uu --	dactylic hexameter	feminine penthemimeral, trithemimeral
χὥτι τὸ φάρμακόν ἐστιν ἀμηχανέοντος ἔρωτος,	-u u -uu -u u-uu-u u--	dactylic hexameter	feminine penthemimeral
οὐκ οἶδα. πλὰν Σῖμος ὁ τᾶς Ἐπιχάλκω ἐρασθεὶς	- -- - -u u - uu-u u--	dactylic hexameter	feminine penthemimeral, hepthemimeral, trithemimeral
ἐκπλεύσας ὑγιὴς ἐπανῆλθ᾽, ἐμὸς ἁλικιώτας.	--- uu- uu- uu -uu--	dactylic hexameter	masculine penthemimeral, hepthemimeral, trithemimeral
πλευσοῦμαι κἠγὼ διαπόντιος, οὔτε κάκιστος	--- -- uu-uu -u u--	dactylic hexameter	masculine penthemimeral, trithemimeral
οὔτε πρᾶτος ἴσως, ὁμαλὸς δέ τις ὁ στρατιώτας.	-- -u u- uu- u u - uu--	dactylic hexameter	masculine penthemimeral, hepthemimeral
ὤφελε μὰν χωρεῖν κατὰ νοῦν τεόν, ὧν ἐπεθύμεις	-uu - -- uu - uu - uu--	dactylic hexameter	masculine penthemimeral, hepthemimeral, trithemimeral
Αἰσχίνα. εἰ δ᾽οὑτῶς ἄρα τοι δοκεῖ ὥστ᾽ ἀποδαμεῖν,	-uu - -- uu - uu - uu--	dactylic hexameter	masculine penthemimeral, hepthemimeral, trithemimeral
μισθοδότας Πτολεμαῖος ἐλευθέρῳ οἷος ἄριστος,	-uu- uu-u u-uu -u u--	dactylic hexameter	feminine penthemimeral, trithemimeral
τἄλλα δ᾽ἀνὴρ ποῖός τις ἐλευθέρῳ οἷος ἄριστος;	-u u- -- u u-uu -u u--	dactylic hexameter	masculine penthemimeral, trithemimeral
εὐγνώμων, φιλόμουσος, ἐρωτικός, εἰς ἄκρον ἁδύς,	--- uu-u u-uu - uu --	dactylic hexameter	feminine penthemimeral, trithemimeral
εἰδὼς τὸν φιλέοντα, τὸν οὐ φιλέοντ᾽ ἔτι μᾶλλον,	-- - uu-u u - uu- uu --	dactylic hexameter	feminine penthemimeral, hepthemimeral, trithemimeral
πολλοῖς πολλὰ διδούς, αἰτεύμενος οὐκ ἀνανεύων	-- -u u- --uu - uu--	dactylic hexameter	masculine penthemimeral
οἷα χρὴ βασιλῆ᾽· αἰτεῖν δὲ δεῖ οὐκ ἐπὶ παντὶ	-- - uu- -- u u - uu --	dactylic hexameter	masculine penthemimeral, hepthemimeral, trithemimeral
Αἰσχίνα. ὥστ᾽ εἴ τοι κατὰ δεξιὸν ὦμον ἀρέσκει	-uu - - - uu -uu -u u--	dactylic hexameter	masculine penthemimeral, trithemimeral
λῶπος ἄκρον περονᾶσθαι, ἐπ᾽ ἀμφοτέροις δὲ βεβακὼς	-u u- uu-u u -uu- u u--	dactylic hexameter	feminine penthemimeral, trithemimeral
τολμασεῖς ἐπιόντα μένειν θρασὺν ἀσπιδιώταν,	--- uu-u u- uu -uu--	dactylic hexameter	feminine penthemimeral, hepthemimeral, trithemimeral
ᾇ τάχος εἰς Αἴγυπτον. ἀπὸ κροτάφων πελόμεσθα	- uu - --u u- uu- uu--	dactylic hexameter	feminine penthemimeral, hepthemimeral, trithemimeral
πάντες γηραλέοι, καὶ ἐπισχερὼ ἐς γένυν ἕρπει	-- -uu- u u-uu - uu --	dactylic hexameter	masculine penthemimeral
λευκαίνων ὁ χρόνος· ποιεῖν τι δεῖ, ἇς γόνυ χλωρόν.	--- u u- -- u u - uu --	dactylic hexameter	masculine penthemimeral, hepthemimeral, trithemimeral
Ἔνδοι Πραξινόα; Γοργοῖ φίλα, ὡς χρόνῳ. ἔνδοι.	-- -uu- -- uu - uu --	dactylic hexameter	masculine penthemimeral, hepthemimeral
θαῦμ᾽ ὅτι καὶ νῦν ἦνθες. ὅρη δίφρον Εὐνόα αὐτῇ.	- uu - - -u u- uu -uu --	dactylic hexameter	feminine penthemimeral, hepthemimeral, trithemimeral
ἔμβαλε καὶ ποτίκρανον. ἔχει κάλλιστα. καθίζευ.	-uu - uu-u u- --u u--	dactylic hexameter	feminine penthemimeral, hepthemimeral, trithemimeral
ὢ τᾶς ἀλεμάτω ψυχᾶς· μόλις ὔμμιν ἐσώθην	- - -uu- -- uu -u u--	dactylic hexameter	masculine penthemimeral, hepthemimeral
Πραξινόα πολλῶ μὲν ὄχλω, πολλῶν δὲ τεθρίππων.	-uu- -- u u- -- u u--	dactylic hexameter	masculine penthemimeral, hepthemimeral, trithemimeral
παντᾷ κρηπῖδες, παντᾷ χλαμυδηφόροι ἄνδρες·	-- --- -- uu-uu --	dactylic hexameter	masculine penthemimeral, hepthemimeral
ἁ δ᾽ὁδὸς ἄτρυτος· τὺ δ᾽ἑκαστάτω ὅσσον ἀποικεῖς.	- uu --- u u-uu -u u--	dactylic hexameter	masculine penthemimeral
ταῦθ᾽ ὁ πάραρος τῆνος ἐπ᾽ ἔσχατα γᾶς ἔλαβ᾽ ἐνθὼν	- u u-- -u u -uu - uu --	dactylic hexameter	feminine penthemimeral
ἰλεόν, οὐκ οἴκησιν, ὅπως μὴ γείτονες ὦμες	-uu - --u u- - -uu --	dactylic hexameter	feminine penthemimeral, hepthemimeral, trithemimeral
ἀλλάλαις, ποτ᾽ ἔριν, φθονερὸν κακόν, αἰὲν ὁμοῖος.	--- u u- uu- uu -u u--	dactylic hexameter	masculine penthemimeral, hepthemimeral, trithemimeral
μὴ λέγε τὸν τεὸν ἄνδρα φίλα Δίκωνα τοιαῦτα,	- uu - uu -u u- --u u--	dactylic hexameter	feminine penthemimeral, hepthemimeral, trithemimeral
τῶ μικκῶ παρεόντος· ὅρη γύναι, ὡς ποθορῇ τυ.	- -- uu-u u- uu - uu- -	dactylic hexameter	feminine penthemimeral, hepthemimeral, trithemimeral
θάρσει Ζωπυρίων, γλυκερὸν τέκος· οὐ λέγει ἀπφῦν.	-- -uu- uu- uu - uu --	dactylic hexameter	masculine penthemimeral, hepthemimeral
αἰσθάνεται τὸ βρέφος, ναὶ τὰν πότνιαν. καλὸς ἀπφῦς.	-uu- u u- - - uu- uu --	dactylic hexameter	masculine penthemimeral, hepthemimeral, trithemimeral
ἀπφῦς μὰν τῆνος τὰ πρόαν (λέγομες δὲ πρόαν θην	-- - -- u u- uu- u u- -	dactylic hexameter	masculine penthemimeral, hepthemimeral, trithemimeral
πάντα) νίτρον καὶ φῦκος ἀπὸ σκανᾶς ἀγοράσδων	-u u- - -u u- -- uu--	dactylic hexameter	feminine penthemimeral, hepthemimeral, trithemimeral
ἦνθε φέρων ἅλας ἄμμιν, ἀνὴρ τρισκαιδεκάπηχυς.	-u u- uu -u u- --uu--	dactylic hexameter	feminine penthemimeral, hepthemimeral, trithemimeral
χὡμὸς ταὐτᾷ ἔχει, φθόρος ἀργυρίω, Διοκλείδας·	-- -u u- uu -uu- uu--	dactylic hexameter	masculine penthemimeral
ἑπταδράχμως κυνάδας, γραιᾶν ἀποτίλματα πηρᾶν,	-uu- uu- -- uu-uu --	dactylic hexameter	masculine penthemimeral, hepthemimeral, trithemimeral
πέντε πόκως ἔλαβ᾽ ἐχθές, ἅπαν ῥύπον, ἔργον ἐπ᾽ ἔργῳ.	-u u- uu - uu -- -u u --	dactylic hexameter	masculine penthemimeral, trithemimeral
ἀλλ᾽ ἴθι τὠμπέχονον καὶ τὰν περονατρίδα λάζευ.	- uu -uu- - - uu-uu --	dactylic hexameter	masculine penthemimeral, hepthemimeral
βᾶμες τῶ βασιλῆος ἐς ἀφνειῶ Πτολεμαίω	-- - uu-u u --- uu--	dactylic hexameter	feminine penthemimeral, trithemimeral
θασόμεναι τὸν Ἄδωνιν· ἀκούω χρῆμα καλόν τι	-uu- u u-u u-- -u u- -	dactylic hexameter	feminine penthemimeral, trithemimeral
κοσμεῖν τὰν βασίλισσαν. ἐν ὀλβίω ὄλβια πάντα.	-- - uu-u u -uu -uu --	dactylic hexameter	feminine penthemimeral, trithemimeral
ὧν ἴδες, ὧν εἶπες καὶ ἰδοῖσα τὺ τῷ μὴ ἰδόντι.	- uu - -- u u-u u - u u--	dactylic hexameter	masculine penthemimeral, trithemimeral
ἕρπειν ὥρα κ᾽εἴη. ἀεργοῖς αἰὲν ἑορτά.	-- -- -u u-- -u u--	dactylic hexameter	feminine penthemimeral
Εὐνόα, αἶρε τὸ νῆμα καὶ ἐς μέσον αἰνόθρυπτε	-uu -u u -u u - uu ----	dactylic hexameter	feminine penthemimeral, hepthemimeral
θὲς πάλιν. αἱ γαλέαι μαλακῶς χρῄζοντι καθεύδειν·	- uu - uu- uu- --u u--	dactylic hexameter	masculine penthemimeral, hepthemimeral, trithemimeral
κινεῦ δή, φέρε θᾶσσον ὕδωρ. ὕδατος πρότερον δεῖ.	-- - uu -u u- uu- uu- -	dactylic hexameter	feminine penthemimeral, hepthemimeral, trithemimeral
ἁ δὲ σμᾶμα φέρει. δὸς ὅμως. μὴ δὴ πολ᾽ ἄπληστε.	- - -u u- u u- - - u u--	dactylic hexameter	masculine penthemimeral, hepthemimeral
ἔγχει ὕδωρ. δύστανε, τί μευ τὸ χιτώνιον ἄρδεις;	-u u- --u u - u u-uu --	dactylic hexameter	feminine penthemimeral, hepthemimeral, trithemimeral
παῦε. ὁκοῖα θεοῖς ἐδόκει, τοιαῦτα νένιμμαι.	-u u-u u- uu- --u u--	dactylic hexameter	masculine penthemimeral, hepthemimeral
ἁ κλᾲξ τᾶς μεγάλας πᾷ λάρνακος; ὧδε φέρ᾽ αὐτάν.	- - - uu- - -uu -u u --	dactylic hexameter	masculine penthemimeral, trithemimeral
Πραξινόα, μάλα τοι τὸ καταπτυχὲς ἐμπερόναμα	-uu- uu - u u-uu -uu--	dactylic hexameter	masculine penthemimeral, trithemimeral
τοῦτο πρέπει· λέγε μοι, πόσσω κατέβα τοι ἀφ᾽ ἱστῶ;	-u u- uu - -- uu- u u --	dactylic hexameter	masculine penthemimeral, hepthemimeral, trithemimeral
μὴ μνάσῃς Γοργοῖ· πλέον ἀργυρίω καθαρῶ μνᾶν	- -- -- uu -uu- uu- -	dactylic hexameter	masculine penthemimeral, trithemimeral
ἢ δύο· τοῖς δ᾽ἔργοις καὶ τὰν ψυχὰν ποτέθηκα.	- uu - -- - - -- uu--	dactylic hexameter	masculine penthemimeral, hepthemimeral, trithemimeral
ἀλλὰ κατὰ γνώμαν ἀπέβα τοι. τοῦτο κάλ᾽ εἶπες.	-u u- -- uu- - -u u --	dactylic hexameter	masculine penthemimeral, hepthemimeral, trithemimeral
τὠμπέχονον φέρε μοι καὶ τὰν θολίαν κατὰ κόσμον	-uu- uu - - - uu- uu --	dactylic hexameter	masculine penthemimeral, hepthemimeral, trithemimeral
ἀμφίθες. οὐκ ἀξῶ τυ τέκνον. μορμώ, δάκνει ἵππος.	-uu - -- u u- -- uu --	dactylic hexameter	masculine penthemimeral, hepthemimeral, trithemimeral
δάκρυ᾽, ὅσσα θέλεις, χωλὸν δ᾽οὐ δεῖ τυ γενέσθαι.	-- -u u- -- - - u u--	dactylic hexameter	masculine penthemimeral, hepthemimeral
ἕρπωμες. Φρυγία, τὸν μικκὸν παῖσδε λαβοῖσα,	--- uu- - -- -u u--	dactylic hexameter	masculine penthemimeral, trithemimeral
τὰν κύν᾽ ἔσω κάλεσον, τὰν αὐλείαν ἀπόκλᾳξον.	- u u- uu- - --- uu--	dactylic hexameter	masculine penthemimeral, trithemimeral
ὦ θεοί, ὅσσος ὄχλος. πῶς καὶ πόκα τοῦτο περᾶσαι	- uu -u u- - - uu -u u--	dactylic hexameter	masculine penthemimeral, hepthemimeral
χρὴ τὸ κακόν; μύρμακες ἀνάριθμοι καὶ ἄμετροι.	- u u- --u u--- u u--	dactylic hexameter	feminine penthemimeral, trithemimeral
πολλά τοι ὦ Πτολεμαῖε πεποίηται καλὰ ἔργα,	-u u - uu-u u--- uu --	dactylic hexameter	feminine penthemimeral, trithemimeral
ἐξ ὧ ἐν ἀθανάτοις ὁ τεκων· οὐδεὶς κακοεργὸς	- u u -uu- u u- -- uu--	dactylic hexameter	masculine penthemimeral, hepthemimeral
δαλεῖται τὸν ἰόντα παρέρπων Αἰγυπτιστί,	--- u u-u u-- ----	dactylic hexameter	feminine penthemimeral, trithemimeral
οἷα πρὶν ἐξ ἀπάτας κεκροτημένοι ἄνδρες ἔπαισδον,	-u u - uu- uu-uu -u u--	dactylic hexameter	masculine penthemimeral, trithemimeral
ἀλλάλοις ὁμαλοί, κακὰ παίγνια, πάντες ἐρειοί.	--- uu- uu -uu -u u--	dactylic hexameter	masculine penthemimeral, trithemimeral
ἁδίστα Γοργοῖ, τί γενοίμεθα; τοὶ πολεμισταὶ	--- -- u u-uu - uu--	dactylic hexameter	masculine penthemimeral, trithemimeral
ἵπποι τῶ βασιλῆος. ἄνερ φίλε, μή με πατήσῃς.	-- - uu-u u- uu - u u--	dactylic hexameter	feminine penthemimeral, hepthemimeral, trithemimeral
ὀρθὸς ἀνέστα ὁ πυρρός· ἴδ᾽ ὡς ἄγριος. κυνοθαρσὴς	-u u-u u -u u - uu- uu--	dactylic hexameter	feminine penthemimeral, hepthemimeral
Εὐνόα, οὐ φευξῇ; διαχρησεῖται τὸν ἄγοντα.	-uu - -- uu--- u u--	dactylic hexameter	masculine penthemimeral, trithemimeral
ὠνάθην μεγάλως, ὅτι μοι τὸ βρέφος μένει ἔνδον.	--- uu- uu - u u- uu --	dactylic hexameter	masculine penthemimeral, hepthemimeral, trithemimeral
θάρσει Πραξινόα· καὶ δὴ γεγενήμεθ᾽ ὄπισθεν,	-- -uu- - - uu-u u--	dactylic hexameter	masculine penthemimeral, hepthemimeral
τοὶ δ᾽ἔβαν ἐς χώραν. καὐτὰ συναγείρομαι ἤδη.	- uu - -- -- uu-uu --	dactylic hexameter	masculine penthemimeral, hepthemimeral, trithemimeral
ἵππον καὶ τὸν ψυχρὸν ὄφιν τὰ μάλιστα δεδοίκω	-- - - -u u- u u-u u--	dactylic hexameter	feminine penthemimeral, hepthemimeral, trithemimeral
ἐκ παιδός. σπεύδωμες· ὄχλος πολὺς ἄμμιν ἐπιρρεῖ.	- -- --u u- uu -u u--	dactylic hexameter	feminine penthemimeral, hepthemimeral, trithemimeral
ἐξ αὐλᾶς ὦ μᾶτερ; ἐγὼν ὦ τέκνα. παρενθεῖν	- -- - -u u- - -u u--	dactylic hexameter	feminine penthemimeral, hepthemimeral, trithemimeral
εὐμαρές; ἐς Τροίαν πειρώμενοι ἦνθον Ἀχαιοί,	-uu - -- --uu -u u--	dactylic hexameter	masculine penthemimeral, trithemimeral
καλλίστα παίδων· πείρᾳ θην πάντα τελεῖται.	--- -- -- - -u u--	dactylic hexameter	masculine penthemimeral, hepthemimeral, trithemimeral
χρησμὼς ἁ πρεσβῦτις ἀπῴχετο θεσπίξασα.	-- - --u u-uu ----	dactylic hexameter	feminine penthemimeral, trithemimeral
πάντα γυναῖκες ἴσαντι, καὶ ὡς Ζεὺς ἠγάγεθ᾽ Ἥρην.	-u u-u u-u u - - -uu --	dactylic hexameter	feminine penthemimeral, hepthemimeral
θᾶσαι Πραξινόα, περὶ τὰς θύρας ὅσσος ὅμιλος.	-- -uu- uu - uu -u u--	dactylic hexameter	masculine penthemimeral, hepthemimeral
θεσπέσιος. Γοργοῖ, δὸς τὰν χέρα μοι· λάβε καὶ τὺ	-uu- -- - - uu - uu - -	dactylic hexameter	masculine penthemimeral, hepthemimeral, trithemimeral
Εὐνόα Εὐτυχίδος· πότεχ᾽ αὐτᾷ, μή τι πλαναθῇς.	-uu -uu- uu -- - u u--	dactylic hexameter	masculine penthemimeral
πᾶσαι ἅμ᾽ εἰσένθωμες· ἀπρὶξ ἔχευ Εὐνόα ἁμῶν.	-u u ---u u- uu -uu --	dactylic hexameter	feminine penthemimeral, hepthemimeral
οἴμοι δειλαία, δίχα μευ τὸ θερίστριον ἤδη	-- --- uu - u u-uu --	dactylic hexameter	masculine penthemimeral, hepthemimeral
ἔσχισται Γοργοῖ. πὸτ τῶ Διός, εἴτι γένοιο	--- -- - - uu -u u--	dactylic hexameter	masculine penthemimeral, hepthemimeral, trithemimeral
εὐδαίμων ὤνθρωπε, φυλάσσεο τὠμπέχονόν μευ.	--- --u u-uu -uu- -	dactylic hexameter	feminine penthemimeral, trithemimeral
οὐκ ἐπ᾽ ἐμὶν μέν, ὅμως δὲ φυλαξεῦμαι· ὄχλος ἄθρως.	- u u- u u- u u--- uu --	dactylic hexameter	masculine penthemimeral, trithemimeral
ὠθεῦνθ᾽ ὥσπερ ὕες. θάρσει γύναι· ἐν καλῷ εἰμές.	-- -u u- -- uu - uu --	dactylic hexameter	masculine penthemimeral, hepthemimeral
κεἰς ὥρας κἤπειτα φίλ᾽ ἀνδρῶν ἐν καλῷ εἴης	- -- --u u -- - uu --	dactylic hexameter	feminine penthemimeral, trithemimeral
ἄμμε περιστέλλων. χρηστῶ κᾠκτίρμονος ἀνδρός.	-u u--- -- --uu --	dactylic hexameter	masculine penthemimeral, hepthemimeral
φλίβεται Εὐνόα ἇμιν· ἄγ᾽ ὦ δειλὰ τὺ βιάζευ.	-uu -uu -u u - -- u u--	dactylic hexameter	feminine penthemimeral, hepthemimeral
κάλλιστ᾽· ἔνδοι πᾶσαι, ὁ τὰν νυὸν εἶπ᾽ ἀποκλᾴξας.	-- -- -u u - uu - uu--	dactylic hexameter	feminine penthemimeral, hepthemimeral
Πραξινόα, πόταγ᾽ ὧδε. τὰ ποικίλα πρᾶτον ἄθρησον,	-uu- uu -u u -uu -u u--	dactylic hexameter	feminine penthemimeral, trithemimeral
λεπτὰ καὶ ὡς χαρίεντα· θεῶν περονάματα φασεῖς.	-u u - uu-u u- uu-uu --	dactylic hexameter	feminine penthemimeral, hepthemimeral, trithemimeral
πότνι᾽ Ἀθαναία, ποῖαί σφ᾽ ἐπόνασαν ἔριθοι,	-u u--- -- uu-u u--	dactylic hexameter	masculine penthemimeral, hepthemimeral
ποῖοι ζῳογράφοι τἀκριβέα γράμματ᾽ ἔγραψαν.	-- -uu- --uu -u u--	dactylic hexameter	masculine penthemimeral
ὡς ἔτυμ᾽ ἑστάκαντι, καὶ ὡς ἔτυμ᾽ ἐνδινεῦντι,	- uu ---u u - uu ----	dactylic hexameter	feminine penthemimeral, hepthemimeral
ἔμψυχ᾽, οὐκ ἐνυφαντά. σοφόν τοι χρῆμ᾽ ὥνθρωπος.	-- - uu-u u- - - ---	dactylic hexameter	feminine penthemimeral, hepthemimeral, trithemimeral
αὐτὸς δ᾽ὡς θαητὸς ἐπ᾽ ἀργυρέας κατάκειται	-- - --u u -uu- uu--	dactylic hexameter	feminine penthemimeral, trithemimeral
κλισμῶ, πρᾶτον ἴουλον ἀπὸ κροτάφων καταβάλλων,	-- -u u-u u- uu- uu--	dactylic hexameter	feminine penthemimeral, hepthemimeral
ὁ τριφίλητος Ἄδωνις, ὃ κἠν Ἀχέροντι φιλεῖται.	- uu-u u-u u - uu-u u--	dactylic hexameter	feminine penthemimeral, hepthemimeral
παύσασθ᾽ ὦ δύστανοι, ἀνάνυτα κωτίλλοισαι	-- - --u u-uu ----	dactylic hexameter	feminine penthemimeral, trithemimeral
τρυγόνες. ἐκκναισεῦντι πλατειάσδοισαι ἅπαντα.	-uu ---u u---u u--	dactylic hexameter	feminine penthemimeral
μᾶ, πόθεν ὥνθρωπος; τί δὲ τίν, εἰ κωτίλαι εἰμές;	- uu --- u u - - -uu --	dactylic hexameter	masculine penthemimeral, hepthemimeral
πασάμενος ἐπίτασσε. Συρακοσίαις ἐπιτάσσεις;	-uu- uu-u u-uu- uu--	dactylic hexameter	feminine penthemimeral, trithemimeral
ὡς δ᾽εἰδῇς καὶ τοῦτο· Κορίνθιαι εἰμὲς ἄνωθεν,	- -- - -u u-uu -u u--	dactylic hexameter	feminine penthemimeral, trithemimeral
ὡς καὶ ὁ Βελλεροφῶν· Πελοποννασιστὶ λαλεῦμες·	- u u -uu- uu---u u--	dactylic hexameter	masculine penthemimeral
δωρίσδεν δ᾽ἔξεστι δοκῶ τοῖς Δωριέεσσι.	--- --u u- - -uu--	dactylic hexameter	feminine penthemimeral, hepthemimeral, trithemimeral
μὴ φύη Μελιτῶδες ὃς ἁμῶν καρτερὸς εἴη,	- -- uu-u u -- -uu --	dactylic hexameter	feminine penthemimeral, trithemimeral
πλὰν ἑνός. οὐκ ἀλέγω. μή μοι κενεὰν ἀπομάξῃς.	- uu - uu- - - uu- uu--	dactylic hexameter	masculine penthemimeral, hepthemimeral, trithemimeral
σιγᾷ Πραξινόα· μέλλει τὸν Ἄδωνιν ἀείδειν	-- -uu- -- u u-u u--	dactylic hexameter	masculine penthemimeral, hepthemimeral
ἁ τᾶς Ἀργείας θυγάτηρ πολύιδρις ἀοιδός,	- - --- uu- --u u--	dactylic hexameter	masculine penthemimeral, hepthemimeral
ἅτις καὶ πέρυσιν τὸν ἰάλεμον ἀρίστευσε.	-- - uu- u u-uu ----	dactylic hexameter	masculine penthemimeral, trithemimeral
φθεγξεῖταί τι σάφ᾽ οἶδα καλόν· διαθρύπτεται ἤδη.	--- u u -u u- uu-uu --	dactylic hexameter	feminine penthemimeral, hepthemimeral, trithemimeral
δέσποιν᾽, ἃ Γολγώς τε καὶ Ἰδάλιον ἐφίλασας	-- - -- u u -uu- uu--	dactylic hexameter	masculine penthemimeral, trithemimeral
αἰπεινάν τ᾽Ἐρύκαν, χρυσῷ παίζοισ᾽ Ἀφροδίτα·	--- uu- -- -- ----	lyric	
οἷόν τοι τὸν Ἄδωνιν ἀπ᾽ ἀενάω Ἀχέροντος	-- - u u-u u -uu- uu--	dactylic hexameter	feminine penthemimeral, trithemimeral
μηνὶ δυωδεκάτῳ μαλακαὶ πόδας ἄγαγον ̂Ὡραι.	-u u-uu- uu- uu -uu --	dactylic hexameter	masculine penthemimeral, hepthemimeral
βάρδισται μακάρων ̂Ὡραι φίλαι, ἀλλὰ ποθειναὶ	--- uu- -- uu -u u--	dactylic hexameter	masculine penthemimeral, hepthemimeral, trithemimeral
ἔρχονται πάντεσσι βροτοῖς αἰεί τι φορεῦσαι.	--- --u u- -- u u--	dactylic hexameter	feminine penthemimeral, hepthemimeral, trithemimeral
Κύπρι Διωναία, τὺ μὲν ἀθανάταν ἀπὸ θνατᾶς,	-u u--- u u -uu- uu --	dactylic hexameter	masculine penthemimeral
ἀνθρώπων ὡς μῦθος, ἐποίησας Βερενίκαν,	--- - -u u--- uu--	dactylic hexameter	feminine penthemimeral, trithemimeral
ἀμβροσίαν ἐς στῆθος ἀποστάξασα γυναικός·	-uu- - -u u---u u--	dactylic hexameter	feminine penthemimeral, trithemimeral
τὶν δὲ χαριζομένα, πολυώνυμε καὶ πολύναε,	- u u-uu- uu-uu - uu--	dactylic hexameter	masculine penthemimeral
ἁ Βερενικεία θυγάτηρ Ἑλένᾳ εἰκυῖα	- uu--- uu- uu- ---	dactylic hexameter	masculine penthemimeral, hepthemimeral
Ἀρσινόα πάντεσσι καλοῖς ἀτιτάλλει Ἄδωνιν.	-uu- --u u- uu-u u--	dactylic hexameter	feminine penthemimeral, hepthemimeral, trithemimeral
πὰρ μέν οἱ ὥρια κεῖται, ὅσα δρυὸς ἄκρα φέρονται,	- u u -uu -u u- uu -u u--	dactylic hexameter	feminine penthemimeral, hepthemimeral
πὰρ δ᾽ἁπαλοὶ κᾶποι πεφυλαγμένοι ἐν ταλαρίσκοις	- uu- -- uu-uu - uu--	dactylic hexameter	masculine penthemimeral, trithemimeral
ἀργυρέοις, Συρίω δὲ μύρω χρύσει᾽ ἀλάβαστρα.	-uu- uu- u u- -- uu--	dactylic hexameter	masculine penthemimeral, hepthemimeral, trithemimeral
εἴδατα δ᾽ὅσσα γυναῖκες ἐπὶ πλαθάνω πονέονται,	-uu -u u-u u- uu- uu--	dactylic hexameter	feminine penthemimeral, hepthemimeral
ἄνθεα μίσγοισαι λευκῷ παντοῖα μαλεύρῳ,	-uu --- -- --u u--	dactylic hexameter	masculine penthemimeral, hepthemimeral
ὅσσά τ᾽ἀπὸ γλυκερῶ μέλιτος τά τ᾽ἐν ὑγρῷ ἐλαίῳ,	-u u- uu- uu- u u -u u--	dactylic hexameter	masculine penthemimeral, hepthemimeral, trithemimeral
πάντ᾽ αὐτῷ πετεηνὰ καὶ ἑρπετὰ τεῖδε πάρεστι.	- -- uu-u u -uu -u u--	dactylic hexameter	feminine penthemimeral, trithemimeral
χλωραὶ δὲ σκιάδες μαλακῷ βρίθοντι ἀνήθῳ	-- - uu- uu- --u u--	dactylic hexameter	masculine penthemimeral, hepthemimeral, trithemimeral
δέδμανθ᾽· οἱ δέ τε κῶροι ὑπερπωτῶνται Ἔρωτες,	- - - - -u u---u u--	dactylic hexameter	feminine penthemimeral, trithemimeral
οἷοι ἀηδονιδῆες ἀεξομενᾶν ἐπὶ δένδρων	-u u-uu-u u-uu- uu --	dactylic hexameter	feminine penthemimeral
πωτῶνται πτερύγων πειρώμενοι ὄζον ἀπ᾽ ὄζω.	--- uu- --uu -u u --	dactylic hexameter	masculine penthemimeral, trithemimeral
ὢ ἔβενος, ὢ χρυσός, ὢ ἐκ λευκῶ ἐλέφαντος	- uu- - -u u - -- uu--	dactylic hexameter	feminine penthemimeral, hepthemimeral, trithemimeral
αἰετοὶ οἰνοχόον Κρονίδᾳ Διὶ παῖδα φέροντες.	-uu -uu- uu- uu -u u--	dactylic hexameter	masculine penthemimeral, hepthemimeral
πορφύρεοι δὲ τάπητες ἄνω μαλακώτεροι ὕπνω,	-uu- u u-u u- uu-uu --	dactylic hexameter	feminine penthemimeral, hepthemimeral, trithemimeral
ἁ Μίλατος ἐρεῖ χὡ τὰν Σαμίαν κάτα βόσκων·	- uu- -- - - uu- uu --	dactylic hexameter	masculine penthemimeral, hepthemimeral, trithemimeral
"ἔστρωται κλίνα τῷ Ἀδώνιδι τῷ καλῷ ἄλλα."	--- uu - --uu - uu --	dactylic hexameter	masculine penthemimeral, trithemimeral
τὰν μὲν Κύπρις ἔχει, τὰν δ᾽ὁ ῥοδόπαχυς Ἄδωνις	- - -u u- - - uu-u u--	dactylic hexameter	masculine penthemimeral, hepthemimeral
ὀκτωκαιδεκέτης ἢ ἐννεακαίδεχ᾽ ὁ γαμβρός.	---uu- - -uu-u u --	dactylic hexameter	masculine penthemimeral
οὐ κεντεῖ τὸ φίλαμ᾽, ἔτι οἱ περὶ χείλεα πυρρά.	- -- u u- uu - uu -uu --	dactylic hexameter	masculine penthemimeral, hepthemimeral, trithemimeral
νῦν μὰν Κύπρις ἔχοισα τὸν αὐτᾶς χαιρέτω ἄνδρα·	- - -u u-u u -- -uu --	dactylic hexameter	feminine penthemimeral
ἀῶθεν δ᾽ἁμές νιν ἅμα δρόσῳ ἀθρόαι ἔξω	--- -- u u- uu -uu --	dactylic hexameter	masculine penthemimeral, hepthemimeral, trithemimeral
οἰσεῦμες ποτὶ κύματ᾽ ἐπ᾽ ἀιόνι πτύοντα,	--- uu -u u --- ---	dactylic hexameter	feminine penthemimeral, trithemimeral
λύσασαι δὲ κόμαν καὶ ἐπὶ σφυρὰ κόλπον ἀνεῖσαι	--- u u- u u- uu -u u--	dactylic hexameter	masculine penthemimeral, hepthemimeral, trithemimeral
στήθεσι φαινομένοις λιγυρᾶς ἀρξώμεθ᾽ ἀοιδᾶς·	-uu -uu- uu- --u u--	dactylic hexameter	masculine penthemimeral, hepthemimeral
Ἕρπεις ὦ φίλ᾽ Ἄδωνι καὶ ἐνθάδε κεἰς Ἀχέροντα	-- - u u-u u -uu - uu--	dactylic hexameter	feminine penthemimeral, trithemimeral
ἡμιθέων, ὡς φαντί, μονώτατος. οὔτ᾽ Ἀγαμέμνων	-uu- - -u u-uu - uu--	dactylic hexameter	feminine penthemimeral, trithemimeral
τοῦτ᾽ ἔπαθ᾽, οὔτ᾽ Αἴας ὁ μέγας βαρυμάνιος ἥρως,	- uu - -- u u- uu-uu --	dactylic hexameter	masculine penthemimeral, hepthemimeral, trithemimeral
οὔθ᾽ Ἕκτωρ Ἑκάβας ὁ γεραίτερος εἴκατι παίδων,	- -- uu- u u-uu -uu --	dactylic hexameter	masculine penthemimeral, trithemimeral
οὐ Πατροκλῆς, οὐ Πύρρος ἀπὸ Τροίας ἐπανελθών,	- uu- - -u u- -- uu--	dactylic hexameter	feminine penthemimeral, hepthemimeral, trithemimeral
οὔθ᾽ οἱ ἔτι πρότερον Λαπίθαι καὶ Δευκαλίωνες,	- u u- uu- uu- - -uu--	dactylic hexameter	masculine penthemimeral, hepthemimeral, trithemimeral
οὐ Πελοπηιάδαι τε καὶ Ἄργεος ἄκρα Πελασγοί·	- uu-uu- u u -uu -u u--	dactylic hexameter	masculine penthemimeral
ἵλαθι νῦν φίλ᾽ Ἄδωνι, καὶ ἐς νέωτ᾽ εὐθυμήσαις.	-uu - u u-u u - - ----	dactylic hexameter	feminine penthemimeral, hepthemimeral, trithemimeral
καὶ νῦν ἦνθες Ἄδωνι, καὶ ὅκκ᾽ ἀφίκῃ, φίλος ἡξεῖς.	- - -u u-u u - uu- uu --	dactylic hexameter	feminine penthemimeral, hepthemimeral
Πραξινόα, τὸ χρῆμα σοφώτερον ἁ θήλεια.	-uu- - -u u-uu - ---	dactylic hexameter	feminine penthemimeral, trithemimeral
ὀλβία ὅσσα ἴσατι, πανολβία ὡς γλυκὺ φωνεῖ.	-uu -u u-u u-uu - uu --	dactylic hexameter	feminine penthemimeral
ὥρα ὅμως κεἰς οἶκον. ἀνάριστος Διοκλείδας.	-u u- - -u u--- uu--	dactylic hexameter	feminine penthemimeral, trithemimeral
χὡνὴρ ὄξος ἅπαν, πεινᾶντι δὲ μηδὲ ποτένθῃς.	-- -u u- --u u -u u--	dactylic hexameter	masculine penthemimeral
χαῖρε Ἄδων ἀγαπητέ· καὶ ἐς χαίροντας ἀφίκευ.	-u u- uu-u u - --u u--	dactylic hexameter	feminine penthemimeral, hepthemimeral, trithemimeral
αἰεὶ τοῦτο Διὸς κούραις μέλει, αἰὲν ἀοιδοῖς,	-- -u u- -- uu -u u--	dactylic hexameter	masculine penthemimeral, hepthemimeral
ὑμνεῖν ἀθανάτους, ὑμνεῖν ἀγαθῶν κλέα ἀνδρῶν.	-- -uu- -- uu- uu --	dactylic hexameter	masculine penthemimeral, hepthemimeral
Μοῦσαι μὲν θεαὶ ἐντί, θεοὺς θεαὶ ἀείδοντι·	-- - uu -u u- uu ----	dactylic hexameter	feminine penthemimeral, hepthemimeral, trithemimeral
ἄμμες δὲ βροτοὶ οἵδε, βροτοὺς βροτοὶ ἀείδωμεν.	-- - uu -u u- uu ----	dactylic hexameter	feminine penthemimeral, hepthemimeral, trithemimeral
τίς γὰρ τῶν ὁπόσοι γλαυκὰν ναίουσιν ὑπ᾽ ἀῶ	- - - uu- -- --u u --	dactylic hexameter	masculine penthemimeral, hepthemimeral, trithemimeral
ἡμετέρας Χάριτας πετάσας ὑποδέξεται οἴκῳ	-uu- uu- uu- uu-uu --	dactylic hexameter	masculine penthemimeral, hepthemimeral, trithemimeral
ἀσπασίως, οὐδ᾽ αὖθις ἀδωρήτους ἀποπέμψει;	-uu- - -u u--- uu--	dactylic hexameter	feminine penthemimeral, trithemimeral
αἱ δὲ σκυζόμεναι γυμνοῖς ποσὶν οἴκαδ᾽ ἴασι,	- - -uu- -- uu -u u--	dactylic hexameter	masculine penthemimeral, hepthemimeral
πολλά με τωθάζοισαι, ὅ τ᾽ἀλιθίαν ὁδὸν ἦνθον,	-u u ---u u -uu- uu --	dactylic hexameter	feminine penthemimeral
ὀκνηραὶ δὲ πάλιν κενεᾶς ἐν πυθμένι χηλοῦ	--- u u- uu- - -uu --	dactylic hexameter	masculine penthemimeral, hepthemimeral, trithemimeral
ψυχροῖς ἐν γονάτεσσι κάρη μίμνοντι βαλοῖσαι,	-- - uu-u u- --u u--	dactylic hexameter	feminine penthemimeral, hepthemimeral, trithemimeral
ἔνθ᾽ αἰεί σφισιν ἕδρα, ἐπὴν ἄπρηκτοι ἵκωνται.	- -- uu -u u- --u u--	dactylic hexameter	feminine penthemimeral, hepthemimeral, trithemimeral
τίς τῶν νῦν τοιόσδε; τίς εὖ εἰπόντα φιλήσει;	- - - --u u - --u u--	dactylic hexameter	feminine penthemimeral, hepthemimeral, trithemimeral
οὐκ οἶδ᾽· οὐ γὰρ ἔτ᾽ ἄνδρες ἐπ᾽ ἔργμασιν ὡς πάρος ἐσθλοῖς	- - - u u -u u -uu - uu --	dactylic hexameter	feminine penthemimeral, trithemimeral
αἰνεῖσθαι σπεύδοντι, νενίκηνται δ᾽ὑπὸ κερδέων.	--- --u u--- uu --	dactylic hexameter	feminine penthemimeral, trithemimeral
πᾶς δ᾽ὑπὸ κόλπῳ χεῖρας ἔχων πόθεν οἴσεται ἀθρεῖ	- uu -- -u u- uu -uu --	dactylic hexameter	feminine penthemimeral, hepthemimeral
ἄργυρον, οὐδέ κεν ἰὸν ἀποτρίψας τινὶ δοίη,	-uu -u u -u u--- uu --	dactylic hexameter	feminine penthemimeral
ἀλλ᾽ εὐθὺς μυθεῖται· "ἀπωτέρω ἢ γόνυ κνάμα·	- -- --u u-uu - uu --	dactylic hexameter	feminine penthemimeral, trithemimeral
αὐτῷ μοί τι γένοιτο· θεοὶ τιμῶσιν ἀοιδούς.	-- - u u-u u- --u u--	dactylic hexameter	feminine penthemimeral, hepthemimeral, trithemimeral
τίς δέ κεν ἄλλου ἀκούσαι; ἅλις πάντεσσιν Ὅμηρος.	- u u -u u-u u- --u u--	dactylic hexameter	feminine penthemimeral, hepthemimeral
οὗτος ἀοιδῶν λῷστος, ὃς ἐξ ἐμεῦ οἴσεται οὐδέν."	-u u-- -u u - uu -uu --	dactylic hexameter	feminine penthemimeral, hepthemimeral
δαιμόνιοι, τί δὲ κέρδος ὁ μυρίος ἔνδοθι χρυσὸς	-uu- u u -u u -uu --- --	lyric	
κείμενος; οὐχ ἅδε πλούτου φρονέουσιν ὄνασις,	-uu - -- -- uu-u u--	dactylic hexameter	masculine penthemimeral, hepthemimeral, trithemimeral
ἀλλὰ τὸ μὲν ψυχᾷ, τὸ δὲ καί τινι δοῦναι ἀοιδῶν·	-u u - -- u u - uu -u u--	dactylic hexameter	masculine penthemimeral, hepthemimeral, trithemimeral
πολλοὺς δ᾽εὖ ἔρξαι παῶν, πολλοὺς δὲ καὶ ἄλλων	-- - -- -- -- u u --	dactylic hexameter	masculine penthemimeral, hepthemimeral, trithemimeral
ἀνθρώπων, αἰεὶ δὲ θεοῖς ἐπιβώμια ῥέζειν,	--- -- u u- uu-uu --	dactylic hexameter	masculine penthemimeral, hepthemimeral, trithemimeral
μηδὲ ξεινοδόκον κακὸν ἔμμεναι, ἀλλὰ τραπέζῃ	-- -uu- uu -uu -u u--	dactylic hexameter	masculine penthemimeral
μειλίξαντ᾽ ἀποπέμψαι, ἐπὴν ἐθέλωντι νέεσθαι,	--- uu-u u- uu-u u--	dactylic hexameter	feminine penthemimeral, hepthemimeral, trithemimeral
Μουσάων δὲ μάλιστα τίειν ἱεροὺς ὑποφήτας,	--- u u-u u- uu- uu--	dactylic hexameter	feminine penthemimeral, hepthemimeral, trithemimeral
ὄφρα καὶ εἰν Ἀίδαο κεκρυμμένος ἐσθλὸς ἀκούσῃς,	-u u - uu-u u-uu -u u--	dactylic hexameter	feminine penthemimeral, trithemimeral
μηδ᾽ ἀκλεὴς μύρηαι ἐπὶ ψυχροῦ Ἀχέροντος,	- uu- --u u- -- uu--	dactylic hexameter	feminine penthemimeral, hepthemimeral, trithemimeral
ὡσεί τις μακέλᾳ τετυλωμένος ἔνδοθι χεῖρας	-- - uu- uu-uu -uu --	dactylic hexameter	masculine penthemimeral, trithemimeral
ἀχὴν ἐκ πατέρων πενίην ἀκτήμονα κλαίων.	-- - uu- uu- --uu --	dactylic hexameter	masculine penthemimeral, hepthemimeral, trithemimeral
πολλοὶ ἐν Ἀντιόχοιο δόμοις καὶ ἄνακτος Ἀλεύα	-u u -uu-u u- u u-u u--	dactylic hexameter	feminine penthemimeral, hepthemimeral
ἁρμαλιὴν ἔμμηνον ἐμετρήσαντο πενέσται·	-uu- --u u---u u--	dactylic hexameter	feminine penthemimeral, trithemimeral
πολλοὶ δὲ Σκοπάδῃσιν ἐλαυνόμενοι ποτὶ σακοὺς	-- - uu-u u-uu- uu --	dactylic hexameter	feminine penthemimeral, trithemimeral
μόσχοι σὺν κεραῇσιν ἐμυκήσαντο βόεσσι,	-- - uu-u u---u u--	dactylic hexameter	feminine penthemimeral, trithemimeral
μυρία δ᾽ἀμπεδίον Κραννώνιον ἐνδιάασκον	-uu -uu- --uu -uu--	dactylic hexameter	masculine penthemimeral
ποιμένες ἔκκριτα μῆλα φιλοξείνοισι Κρεώνδαις·	-uu -uu -u u---u u--	dactylic hexameter	feminine penthemimeral
ἀλλ᾽ οὔ σφιν τῶν ἦδος, ἐπεὶ γλυκὺν ἐξεκένωσαν	- - - - -u u- uu -uu--	dactylic hexameter	feminine penthemimeral, hepthemimeral, trithemimeral
θυμὸν ἐς εὐρεῖαν σχεδίαν στυγνοῦ Ἀχέροντος,	-u u --- uu- -- uu--	dactylic hexameter	masculine penthemimeral, hepthemimeral
ἄμναστοι δὲ τὰ πολλὰ καὶ ὄλβια τῆνα λιπόντες	--- u u -u u -uu -u u--	dactylic hexameter	feminine penthemimeral, trithemimeral
δειλοῖς ἐν νεκύεσσι μακροὺς αἰῶνας ἔκειντο,	-- - uu-u u- --u u--	dactylic hexameter	feminine penthemimeral, hepthemimeral, trithemimeral
εἰ μὴ κεῖνος ἀοιδὸς ὁ Κήιος αἰόλα φωνέων	- - -u u-u u -uu -uu --	dactylic hexameter	feminine penthemimeral
βάρβιτον ἐς πολύχορδον ἐν ἀνδράσι θῆκ᾽ ὀνομαστοὺς	-uu - uu-u u -uu - uu--	dactylic hexameter	feminine penthemimeral, trithemimeral
ὁπλοτέροις, τιμᾶς δὲ καὶ ὠκέες ἔλλαχον ἵπποι,	-uu- -- u u -uu -uu --	dactylic hexameter	masculine penthemimeral, trithemimeral
οἵ σφισιν ἐξ ἱερῶν στεφανηφόροι ἦλθον ἀγώνων.	- uu - uu- uu-uu -u u--	dactylic hexameter	masculine penthemimeral, trithemimeral
τίς δ᾽ἂν ἀριστῆας Λυκίων ποτέ, τίς κομόωντας	- u u--- uu- uu - uu--	dactylic hexameter	masculine penthemimeral, hepthemimeral
Πριαμίδας ἢ θῆλυν ἀπὸ χροιᾶς Κύκνον ἔγνω,	-uu- - -u u- -- uu --	dactylic hexameter	feminine penthemimeral, hepthemimeral, trithemimeral
εἰ μὴ φυλόπιδας προτέρων ὕμνησαν ἀοιδοί;	- - -uu- uu- --u u--	dactylic hexameter	masculine penthemimeral, hepthemimeral
οὐδ᾽ Ὀδυσεὺς ἑκατόν τε καὶ εἴκοσι μῆνας ἀλαθεὶς	- uu- uu- u u -uu -u u--	dactylic hexameter	masculine penthemimeral, trithemimeral
πάντας ἐπ᾽ ἀνθρώπους, Ἀίδαν τ᾽εἰς ἔσχατον ἐλθὼν	-u u --- uu- - -uu --	dactylic hexameter	masculine penthemimeral, hepthemimeral
ζωός, καὶ σπήλυγγα φυγὼν ὀλοοῖο Κύκλωπος,	-- - --u u- uu-u u--	dactylic hexameter	feminine penthemimeral, hepthemimeral, trithemimeral
δηναιὸν κλέος ἔσχεν, ἐσιγάθη δ᾽ἂν ὑφορβὸς	--- uu -u u--- u u--	dactylic hexameter	feminine penthemimeral, trithemimeral
Εὔμαιος, καὶ βουσὶ Φιλοίτιος ἀμφ᾽ ἀγελαίαις	--- - -u u-uu - uu--	dactylic hexameter	feminine penthemimeral, trithemimeral
ἔργον ἔχων, αὐτός τε περίσπλαγχνος Λαέρτης,	-u u- -- u u-- ---	lyric	
εἰ μή σφεας ὤνασαν Ἰάονος ἀνδρὸς ἀοιδαί.	- - - --u u-uu -u u--	dactylic hexameter	feminine penthemimeral, trithemimeral
Ἐκ Μοισᾶν ἀγαθὸν κλέος ἔρχεται ἀνθρώποισι,	- -- uu- uu -uu ----	dactylic hexameter	masculine penthemimeral, trithemimeral
χρήματα δὲ ζώοντες ἀμαλδύνουσι θανόντων.	-uu - --u u---u u--	dactylic hexameter	feminine penthemimeral, trithemimeral
ἀλλ᾽ ἶσος γὰρ ὁ μόχθος ἐπ᾽ ᾀόνι κύματα μετρεῖν,	- -- u u - - -uu -uu --	dactylic hexameter	masculine penthemimeral, trithemimeral
ὅσσ᾽ ἄνεμος χέρσονδε μετὰ γλαυκᾶς ἁλὸς ὠθεῖ,	- uu- --u u- -- uu --	dactylic hexameter	feminine penthemimeral, hepthemimeral, trithemimeral
ἢ ὕδατι νίζειν θολερὰν διαειδέι πλίνθον,	- uu- -- uu- uu-uu --	dactylic hexameter	masculine penthemimeral, hepthemimeral, trithemimeral
καὶ φιλοκερδείᾳ βεβλαμμένον ἄνδρα παρελθεῖν.	- uu--- --uu -u u--	dactylic hexameter	masculine penthemimeral
χαιρέτω ὃς τοιοῦτος, ἀνάριθμος δέ οἱ εἰη	-uu - --u u--- u u --	dactylic hexameter	feminine penthemimeral, trithemimeral
ἄργυρος, αἰεὶ δὲ πλεόνων ἔχοι ἵμερος αὐτόν.	-uu -- - uu- uu -uu --	dactylic hexameter	masculine penthemimeral, hepthemimeral
αὐτὰρ ἐγὼ τιμήν τε καὶ ἀνθρώπων φιλότητα	-u u- -- u u --- uu--	dactylic hexameter	masculine penthemimeral, trithemimeral
πολλῶν ἡμιόνων τε καὶ ἵππων πρόσθεν ἑλοίμαν.	-- -uu- u u -- -u u--	dactylic hexameter	masculine penthemimeral
δίζημαι δ᾽,ὅτινι θνατῶν κεχαρισμένος ἔνθω	--- uu- -- uu-uu --	dactylic hexameter	masculine penthemimeral, hepthemimeral, trithemimeral
σὺν Μοίσαις· χαλεπαὶ γὰρ ὁδοὶ τελέθουσιν ἀοιδοῖς	- -- uu- u u- uu-u u--	dactylic hexameter	masculine penthemimeral, hepthemimeral, trithemimeral
κουράων ἀπάνευθε Διὸς μέγα βουλεύοντος.	--- uu-u u- uu ----	dactylic hexameter	feminine penthemimeral, hepthemimeral, trithemimeral
οὔπω μῆνας ἄγων ἔκαμ᾽ οὐρανὸς οὐδ᾽ ἐνιαυτούς·	-- -u u- uu -uu - uu--	dactylic hexameter	masculine penthemimeral
πολλοὶ κινήσουσιν ἔτι τροχὸν ἅρματος ἵπποι·	-- ---u u- uu -uu --	dactylic hexameter	feminine penthemimeral, hepthemimeral
ἔσσεται οὗτος ἀνήρ, ὃς ἐμεῦ κεχρήσετ᾽ ἀοιδοῦ,	-uu -u u- u u- --u u--	dactylic hexameter	masculine penthemimeral, hepthemimeral
ῥέξας ἢ Ἀχιλεὺς ὅσσον μέγας ἢ βαρὺς Αἴας	-u u --- -- uu - uu --	dactylic hexameter	masculine penthemimeral, hepthemimeral
ἐν πεδίῳ Σιμόεντος, ὅθι Φρυγὸς ἠρίον Ἴλου.	- uu- uu-u u- uu -uu --	dactylic hexameter	feminine penthemimeral, hepthemimeral, trithemimeral
ἤδη νῦν Φοίνικες ὑπ᾽ ἠελίῳ δύνοντι	-- - --u u -uu- ---	dactylic hexameter	feminine penthemimeral, trithemimeral
οἰκεῦντες Λιβύας ἄκρον σφυρὸν ἐρρίγασιν.	--- uu- -- uu -u--	lyric	
ἤδη βαστάζουσι Συρακόσιοι μέσα δοῦρα	-- ---u u-uu- uu --	dactylic hexameter	feminine penthemimeral
ἀχθόμενοι σακέεσσι βραχίονας ἰτεΐνοισιν·	--- uu-u u-uu -uu--	dactylic hexameter	feminine penthemimeral, trithemimeral
ἐν δ᾽αὐτοῖς Ἱέρων προτέροις ἴσος ἡρώεσσι	- -- uu- uu- uu ----	dactylic hexameter	masculine penthemimeral, hepthemimeral, trithemimeral
ζώννυται, ἵππειαι δὲ κόρυν σκεπάουσιν ἔθειραι.	-uu --- u u- uu-u u--	dactylic hexameter	masculine penthemimeral, hepthemimeral
αἰ γὰρ Ζεῦ κύδιστε πάτερ καὶ πότνι᾽ Ἀθάνα	- - - --u u- - -u u--	dactylic hexameter	feminine penthemimeral, hepthemimeral, trithemimeral
κούρη θ᾽,ἣ σὺν ματρὶ πολυκλήρων Ἐφυραίων	-- - - -u u--- uu--	dactylic hexameter	feminine penthemimeral, trithemimeral
εἴληχας μέγα ἄστυ παρ᾽ ὕδασι Λυσιμελείας,	--- uu -u u -uu -uu--	dactylic hexameter	feminine penthemimeral, trithemimeral
ἐχθροὺς ἐκ νάσοιο κακὰ πέμψειεν ἀνάγκα	- - --- uu --- ---	dactylic hexameter	masculine penthemimeral
Σαρδόνιον κατὰ κῦμα, φίλων μόρον ἀγγέλλοντας	-uu- uu -u u- uu ----	dactylic hexameter	feminine penthemimeral, hepthemimeral, trithemimeral
τέκνοις ἠδ᾽ ἀλόχοισιν, ἀριθμητοὺς ἀπὸ πολλῶν·	-- - uu-u u--- uu --	dactylic hexameter	feminine penthemimeral, trithemimeral
ἄστεά τε προτέροισι πάλιν ναίοιτο πολίταις,	-uu - uu-u u- --u u--	dactylic hexameter	feminine penthemimeral, hepthemimeral, trithemimeral
δυσμενέων ὅσα χεῖρες ἐλωβήσαντο κατάκρας·	-uu- uu -u u---u u--	dactylic hexameter	feminine penthemimeral, trithemimeral
ἀγροὺς δ᾽ἐργάζοιντο τεθαλότας· αἱ δ᾽ἀνάριθμοι	-- ---u u-uu - uu--	dactylic hexameter	feminine penthemimeral
μήλων χιλιάδες βοτάνᾳ διαπιανθεῖσαι	-- -uu- uu- uu----	dactylic hexameter	masculine penthemimeral, hepthemimeral
ἀμπεδίον βληχοῖντο, βόες δ᾽ἀγελαδὸν ἐς αὖλιν	-uu- --u u- uu-u u --	dactylic hexameter	feminine penthemimeral, hepthemimeral, trithemimeral
ἐρχόμεναι σκνιφαῖον ἐπισπεύδοιεν ὁδίταν·	-uu- --u u---u u--	dactylic hexameter	feminine penthemimeral, trithemimeral
νειοὶ δ᾽ἐκπονέοιντο ποτὶ σπόρον, ἁνίκα τέττιξ	-- -uu-u u- uu -uu --	dactylic hexameter	feminine penthemimeral, hepthemimeral
ποιμένας ἐνδίους πεφυλαγμένος ἔνδοθι δένδρων	-uu --- uu-uu -uu --	dactylic hexameter	masculine penthemimeral
ἀχεῖ ἐν ἀκρεμόνεσσιν· ἀράχνια δ᾽εἰς ὅπλ᾽ ἀράχναι	-u u -uu-u u-- - - --	dactylic hexameter	feminine penthemimeral
λεπτὰ διαστήσαιντο, βοᾶς δ᾽ἔτι μηδ᾽ ὄνομ᾽ εἴη.	-u u---u u- uu - uu --	dactylic hexameter	feminine penthemimeral, hepthemimeral
ὑψηλὸν δ᾽Ἱέρωνι κλέος φορέοιεν ἀοιδοὶ	--- uu-u u- uu-u u--	dactylic hexameter	feminine penthemimeral, hepthemimeral, trithemimeral
καὶ πόντου Σκυθικοῖο πέραν καὶ ὅθι πλατὺ τεῖχος	- -- uu-u u- u u- uu --	dactylic hexameter	feminine penthemimeral, hepthemimeral, trithemimeral
ἀσφάλτῳ δήσασα Σεμίραμις ἐμβασίλευεν.	--- --u u-uu -uu--	dactylic hexameter	feminine penthemimeral, trithemimeral
εἷς μὲν ἐγώ, πολλοὺς δὲ Διὸς φιλέοντι καὶ ἄλλους	- u u- -- u u- uu-u u --	dactylic hexameter	masculine penthemimeral, hepthemimeral, trithemimeral
θυγατέρες, τοῖς πᾶσι μέλοι Σικελὰν Ἀρέθοισαν	-uu- - -u u- uu- uu--	dactylic hexameter	feminine penthemimeral, hepthemimeral, trithemimeral
ὑμνεῖν σὺν λαοῖσι καὶ αἰχμητὰν Ἱέρωνα.	-- - --u u --- uu--	dactylic hexameter	feminine penthemimeral, trithemimeral
ὦ Ἐτεόκλειοι θύγατρες θεαί, ὦ Μινύειον	- uu--- uu- uu - uu--	dactylic hexameter	masculine penthemimeral, hepthemimeral
Ὀρχομενὸν φιλέοισαι ἀπεχθόμενόν ποτε Θήβαις,	-uu- uu-u u--- uu --	dactylic hexameter	feminine penthemimeral, trithemimeral
ἄκλητος μὲν ἔγωγε μένοιμί κεν, ἐς δὲ καλεύντων	--- u u-u u-u u - u u--	dactylic hexameter	feminine penthemimeral, trithemimeral
θαρσήσας Μοίσαισι σὺν ἁμετέραισιν ἱκοίμαν.	--- --u u -uu-u u--	dactylic hexameter	feminine penthemimeral, trithemimeral
καλλείψω δ᾽οὐδ᾽ ὔμμε· τί γὰρ Χαρίτων ἀγαπητὸν	--- - -u u - uu- uu--	dactylic hexameter	feminine penthemimeral, hepthemimeral, trithemimeral
ἀνθρώποις ἀπάνευθεν; ἀεὶ Χαρίτεσσιν ἅμ᾽ εἴην.	--- uu-u u- uu-u u --	dactylic hexameter	feminine penthemimeral, hepthemimeral, trithemimeral
Ἐκ Διὸς ἀρχώμεσθα καὶ ἐς Δία λήγετε Μοῖσαι,	- uu ---u u - uu -uu --	dactylic hexameter	feminine penthemimeral, hepthemimeral
ἀθανάτων τὸν ἄριστον ἐπὴν αὐδῶμεν ἀοιδαῖς·	-uu- u u-u u- --u u--	dactylic hexameter	feminine penthemimeral, hepthemimeral, trithemimeral
ἀνδρῶν δ᾽αὖ Πτολεμαῖος ἐνὶ πρώτοισι λεγέσθω	-- - uu-u u- --u u--	dactylic hexameter	feminine penthemimeral, hepthemimeral, trithemimeral
καὶ πύματος καὶ μέσσος· ὁ γὰρ προφερέστατος ἄλλων.	- uu- - -u u - uu-uu --	dactylic hexameter	feminine penthemimeral, hepthemimeral, trithemimeral
ἥρωες, τοὶ πρόσθεν ἀφ᾽ ἡμιθέων ἐγένοντο,	--- - -u u -uu- uu--	dactylic hexameter	feminine penthemimeral, trithemimeral
ῥέξαντες καλὰ ἔργα σοφῶν ἐκύρησαν ἀοιδῶν·	--- uu -u u- uu-u u--	dactylic hexameter	feminine penthemimeral, hepthemimeral, trithemimeral
αὐτὰρ ἐγὼ Πτολεμαῖον ἐπιστάμενος καλὰ εἰπεῖν	-u u- uu-u u-uu- uu --	dactylic hexameter	feminine penthemimeral, trithemimeral
ὑμνήσαιμ᾽· ὕμνοι δὲ καὶ ἀθανάτων γέρας αὐτῶν.	--- -- u u -uu- uu --	dactylic hexameter	masculine penthemimeral, trithemimeral
Ἴδαν ἐς πολύδενδρον ἀνὴρ ὑλατόμος ἐλθὼν	-- - uu-u u- uu-- --	dactylic hexameter	feminine penthemimeral, hepthemimeral, trithemimeral
παπταίνει, παρεόντος ἄδην, πόθεν ἄρξεται ἔργου.	--- uu-u u- uu -uu --	dactylic hexameter	feminine penthemimeral, hepthemimeral, trithemimeral
τί πρῶτον καταλέξω; ἐπεὶ πάρα μυρία εἰπεῖν,	- -- uu-u u- uu -uu --	dactylic hexameter	feminine penthemimeral, hepthemimeral, trithemimeral
οἷσι θεοὶ τὸν ἄριστον ἐτίμησαν βασιλήων.	-u u- u u-u u--- uu--	dactylic hexameter	feminine penthemimeral, trithemimeral
Ἐκ πατέρων οἷος μὲν ἔην τελέσαι μέγα ἔργον	- uu- -- u u- uu- uu --	dactylic hexameter	masculine penthemimeral, hepthemimeral, trithemimeral
Λαγείδας Πτολεμαῖος, ὅτε φρεσὶν ἐγκατάθοιτο	--- uu-u u- uu -uu--	dactylic hexameter	feminine penthemimeral, hepthemimeral, trithemimeral
βουλάν, ἃν οὐκ ἄλλος ἀνὴρ οἷός τε νοῆσαι.	-u u - -- -- -- u u--	dactylic hexameter	masculine penthemimeral, hepthemimeral, trithemimeral
τῆνον καὶ μακάρεσσι πατὴρ ὁμότιμον ἔθηκεν	-- - uu-u u- uu-u u--	dactylic hexameter	feminine penthemimeral, hepthemimeral, trithemimeral
ἀθανάτοις, καί οἱ χρύσεος δόμος ἐν Διὸς οἴκῳ	-uu- - - uu- uu - uu --	dactylic hexameter	masculine penthemimeral, hepthemimeral, trithemimeral
δέδμηται· παρὰ δ᾽αὐτὸν Ἀλέξανδρος φίλα εἰδὼς	-- -- -u u--- uu --	dactylic hexameter	feminine penthemimeral
ἑδριάει, Πέρσαισι βαρὺς θεὸς αἰολομίτρας.	-uu- --u u- uu -uu--	dactylic hexameter	feminine penthemimeral, hepthemimeral, trithemimeral
ἀντία δ᾽Ἡρακλῆος ἕδρα κενταυροφόνοιο	-uu ---u u- --uu--	dactylic hexameter	feminine penthemimeral, hepthemimeral
ἵδρυται στερεοῖο τετυγμένα ἐξ ἀδάμαντος·	--- uu-u u-uu - uu--	dactylic hexameter	feminine penthemimeral, trithemimeral
ἔνθα σὐν ἄλλοισιν θαλίας ἔχει οὐρανίδαισι,	-u u --- uu- uu -uu--	dactylic hexameter	masculine penthemimeral, hepthemimeral
χαίρων υἱωνῶν περιώσιον υἱωνοῖσιν,	-- --- uu-uu ----	dactylic hexameter	masculine penthemimeral
ὅττί σφεων Κρονίδης μελέων ἐξείλετο γῆρας,	-- - uu- uu- --uu --	dactylic hexameter	masculine penthemimeral, hepthemimeral, trithemimeral
ἀθάνατοι δὲ καλεῦνται ἑοὶ νέποδες γεγαῶτες.	-uu- u u-u u- uu- uu--	dactylic hexameter	feminine penthemimeral, hepthemimeral, trithemimeral
ἄμφω γὰρ πρόγονός σφιν ὁ καρτερὸς Ἡρακλείδας,	-- - uu- u u -uu ----	dactylic hexameter	masculine penthemimeral, trithemimeral
ἀμφότεροι δ᾽ἀριθμεῦνται ἐς ἔσχατον Ἡρακλῆα.	-uu- uu-u u -uu ----	dactylic hexameter	feminine penthemimeral, trithemimeral
τῷ καὶ ἐπεὶ δαίτηθεν ἴοι κεκορημένος ἤδη	- u u- --u u- uu-uu --	dactylic hexameter	feminine penthemimeral, hepthemimeral, trithemimeral
νέκταρος εὐόδμοιο φίλας ἐς δῶμ᾽ ἀλόχοιο,	-uu --- uu - - ----	dactylic hexameter	masculine penthemimeral, hepthemimeral
τῷ μὲν τόξον ἔδωκεν ὑπωλένιόν τε φαρέτραν,	- - -u u-u u-uu- u u--	dactylic hexameter	feminine penthemimeral
τῷ δὲ σιδάρειον σκύταλον κεχαραγμένον ὄζοις.	- u u--- uu- uu-uu --	dactylic hexameter	masculine penthemimeral, hepthemimeral
οἱ δ᾽εἰς ἀμβρόσιον θάλαμον λευκοσφύρου Ἥβης	- - -uu- uu- --uu --	dactylic hexameter	masculine penthemimeral, hepthemimeral
ὅπλα καὶ αὐτὸν ἄγουσι γενειήταν Διὸς υἱόν.	-u u -u u-u u--- uu --	dactylic hexameter	feminine penthemimeral
οἵα δ᾽ἐν πινυταῖσι περικλειτὰ Βερενίκα	-- - uu-u u--- uu--	dactylic hexameter	feminine penthemimeral, trithemimeral
ἔπρεπε θηλυτέραις, ὄφελος μέγα γειναμένοισι.	-uu -uu- uu- uu -uu--	dactylic hexameter	masculine penthemimeral, hepthemimeral
τᾷ μὲν Κύπρον ἔχοισα Διώνας πότνια κούρα	- - -u u-u u-- -uu --	dactylic hexameter	feminine penthemimeral
κόλπον ἐς εὐώδη ῥαδινὰς ἐσεμάξατο χεῖρας.	-u u --- uu- uu-uu --	dactylic hexameter	masculine penthemimeral, hepthemimeral
τῷ οὔπω τινὰ φαντὶ ἁδεῖν τόσον ἀνδρὶ γυναικῶν,	- -- uu -u u- uu -u u--	dactylic hexameter	feminine penthemimeral, hepthemimeral, trithemimeral
ὅσσόν περ Πτολεμαῖος ἑὴν ἐφίλησεν ἄκοιτιν.	-- - uu-u u- uu-u u--	dactylic hexameter	feminine penthemimeral, hepthemimeral, trithemimeral
ἦ μὰν ἀντεφιλεῖτο πολὺ πλέον· ὧδέ κε παισὶ	- - -uu-u u- uu -u u --	dactylic hexameter	feminine penthemimeral, hepthemimeral
θαρσήσας σφετέροισιν ἐπιτρέποι οἶκον ἅπαντα,	--- uu-u u-uu -u u--	dactylic hexameter	feminine penthemimeral, trithemimeral
ὁππότε κεν φιλέων βαίνῃ λέχος ἐς φιλεούσης.	-uu - uu- -- uu - uu--	dactylic hexameter	masculine penthemimeral, hepthemimeral, trithemimeral
ἀστόργου δὲ γυναικὸς ἐπ᾽ ἀλλοτρίῳ νόος αἰεί,	--- u u-u u -uu- uu --	dactylic hexameter	feminine penthemimeral, trithemimeral
ῥηίδιοι δὲ γοναί, τέκνα δ᾽οὐ ποτεοικότα πατρί.	-uu- u u- uu - uu-uu --	dactylic hexameter	masculine penthemimeral, hepthemimeral, trithemimeral
κάλλει ἀριστεύουσα θεάων πότν᾽ Ἀφροδίτα,	-u u---u u-- - ----	lyric	
σοὶ τήνα μεμέλητο· σέθεν δ᾽ἕνεκεν Βερενίκα	- -- uu-u u- uu- uu--	dactylic hexameter	feminine penthemimeral, hepthemimeral, trithemimeral
εὐειδὴς Ἀχέροντα πολύστονον οὐκ ἐπέρασεν,	--- uu-u u-uu - uu--	dactylic hexameter	feminine penthemimeral, trithemimeral
ἀλλά μιν ἁρπάξασα, πάροιθ᾽ ἐπὶ νῆα κατελθεῖν	-u u ---u u- uu -u u--	dactylic hexameter	feminine penthemimeral, hepthemimeral
κυανέαν καὶ στυγνὸν ἀεὶ πορθμῆα καμόντων,	-uu- - -u u- --u u--	dactylic hexameter	feminine penthemimeral, hepthemimeral, trithemimeral
ἐς ναὸν κατέθηκας, ἑᾶς δ᾽ἀπεδάσσαο τιμᾶς.	- -- uu-u u- uu-uu --	dactylic hexameter	feminine penthemimeral, hepthemimeral, trithemimeral
πᾶσιν δ᾽ἤπιος ἥδε βροτοῖς μαλακοὺς μὲν ἔρωτας	-- -uu -u u- uu- u u--	dactylic hexameter	feminine penthemimeral, hepthemimeral
προσπνείει, κούφας δὲ διδοῖ ποθέοντι μερίμνας.	--- -- u u- uu-u u--	dactylic hexameter	masculine penthemimeral, hepthemimeral, trithemimeral
Ἀργεία κυάνοφρυ, σὺ λαοφόνον Διομήδεα	--- uu-u u -uu- uu---	lyric	
μισγομένα Τυδῆι τέκες, Καλυδώνιον ἄνδρα,	-uu- --u u- uu-uu --	dactylic hexameter	feminine penthemimeral, hepthemimeral, trithemimeral
ἀλλὰ Θέτις βαθύκολπος ἀκοντιστὰν Ἀχιλῆα	-u u- uu-u u--- uu--	dactylic hexameter	feminine penthemimeral, trithemimeral
Αἰακίδᾳ Πηλῆι, σὲ δ᾽αἰχμητὰ Πτολεμαῖε	-uu- --u u --- uu--	dactylic hexameter	feminine penthemimeral, trithemimeral
αἰχμητᾷ Πτολεμαίῳ ἀρίζηλος Βερενίκα.	--- uu-u u--- uu--	dactylic hexameter	feminine penthemimeral, trithemimeral
καί σε Κόως ἀτίταλλε βρέφος νεογιλλὸν ἐόντα,	- u u- uu-u u- uu-u u--	dactylic hexameter	feminine penthemimeral, hepthemimeral, trithemimeral
δεξαμένα παρὰ ματρός, ὅτε πρώταν ἴδες ἀῶ.	-uu- uu -u u- -- uu --	dactylic hexameter	feminine penthemimeral, hepthemimeral, trithemimeral
ἔνθα γὰρ Εἰλείθυιαν ἐβώσατο λυσίζωνον	-u u ---u u-uu ----	dactylic hexameter	feminine penthemimeral
Ἀντιγόνας θυγάτηρ βεβαρημένα ὠδίνεσσιν·	-uu- uu- uu-uu ----	dactylic hexameter	masculine penthemimeral, trithemimeral
ἡ δέ οἱ εὐμενέοισα παρίστατο, κὰδ δ᾽ἄρα πάντων	- u u -uu-u u-uu - uu --	dactylic hexameter	feminine penthemimeral
νωδυνίαν κατέχευε μελῶν· ὁ δὲ πατρὶ ἐοικὼς	-uu- uu-u u- u u -u u--	dactylic hexameter	feminine penthemimeral, hepthemimeral, trithemimeral
παῖς ἀγαπητὸς ἔγεντο. Κόως δ᾽ὀλόλυξεν ἰδοῖσα,	- uu-u u-u u- uu-u u--	dactylic hexameter	feminine penthemimeral, hepthemimeral
φᾶ δὲ καθαπτομένα βρέφεος χείρεσσι φίλῃσιν·	- u u-uu- uu- --u u--	dactylic hexameter	masculine penthemimeral, hepthemimeral
"Ὄλβιε κοῦρε γένοιο, τίοις δέ με τόσσον, ὅσον περ	-uu -u u-u u- u u -u u- -	dactylic hexameter	feminine penthemimeral, hepthemimeral
Δᾶλον ἐτίμησεν κυανάμπυκα Φοῖβος Ἀπόλλων·	-u u--- uu-uu -u u--	dactylic hexameter	masculine penthemimeral
ἐν δὲ μιᾷ τιμᾷ Τρίοπον καταθεῖο κολώναν,	- u u- -- uu- uu-u u--	dactylic hexameter	masculine penthemimeral, hepthemimeral, trithemimeral
ἶσον Δωριέεσσι νέμων γέρας ἐγγὺς ἐοῦσιν."	-- -uu-u u- uu -u u--	dactylic hexameter	feminine penthemimeral, hepthemimeral
ἶσον καὶ Ῥήναιαν ἄναξ ἐφίλησεν Ἀπόλλων.	-- - --u u- uu-u u--	dactylic hexameter	feminine penthemimeral, hepthemimeral, trithemimeral
Ὣς ἄρα νᾶσος ἔειπεν· ὁ δ᾽ὑψόθεν ἔκλαγε φωνᾷ	- uu -u u-u u -uu -uu --	dactylic hexameter	feminine penthemimeral
ἐς τρὶς ἀπὸ νεφέων μέγας αἰετὸς αἴσιος ὄρνις.	- u u- uu- uu -uu -uu --	dactylic hexameter	masculine penthemimeral, trithemimeral
Ζηνός που τόδε σᾶμα. Διὶ Κρονίωνι μέλοντι	-- - uu -u u- uu-u u--	dactylic hexameter	feminine penthemimeral, hepthemimeral, trithemimeral
αἰδοῖοι βασιλῆες· ὁ δ᾽ἔξοχος, ὅν κε φιλήσῃ	--- uu-u u -uu - u u--	dactylic hexameter	feminine penthemimeral, trithemimeral
γεινόμενον τὰ πρῶτα· πολὺς δέ οἱ ὄλβος ὀπαδεῖ,	-uu- - -u u- u u -u u--	dactylic hexameter	feminine penthemimeral, hepthemimeral, trithemimeral
πολλᾶς δὲ κρατέει γαίας, πολλᾶς δὲ θαλάσσας.	-- - uu- -- -- u u--	dactylic hexameter	masculine penthemimeral, hepthemimeral, trithemimeral
μυρίαι ἄπειροί τε καὶ ἔθνεα μυρία φωτῶν	-uu --- u u -uu -uu --	dactylic hexameter	masculine penthemimeral
λήιον ἀλδήσκουσιν ὀφελλόμεναι Διὸς ὄμβρῳ·	-uu ---u u-uu- uu --	dactylic hexameter	feminine penthemimeral
ἀλλ᾽ οὔτις τόσα φύει, ὅσα χθαμαλὰ Αἴγυπτος,	- -- uu -u u- uu- ---	dactylic hexameter	feminine penthemimeral, hepthemimeral, trithemimeral
Νεῖλος ἀναβλύζων διερὰν ὅτε βώλακα θρύπτει.	-u u--- uu- uu -uu --	dactylic hexameter	masculine penthemimeral, hepthemimeral
οὐδέ τις ἄστεα τόσσα βροτῶν ἔχει ἔργα δαέντων.	-u u -uu -u u- uu -u u--	dactylic hexameter	feminine penthemimeral, hepthemimeral
τρεῖς μέν οἱ πολίων ἑκατοντάδες ἐνδέδμηνται,	- - - uu- uu-uu ---	lyric	
τρεῖς δ᾽ἄρα χιλιάδες τρισσαῖς ἐπὶ μυριάδεσσι,	- uu -uu- -- uu -uu--	dactylic hexameter	masculine penthemimeral, hepthemimeral
δοιαὶ δὲ τριάδες, μετὰ δέ σφισιν ἐννεάδες τρεῖς·	-- - uu- uu - uu -uu- -	dactylic hexameter	masculine penthemimeral, hepthemimeral, trithemimeral
τῶν πάντων Πτολεμαῖος ἀλήνωρ ἐμβασιλεύει.	- -- uu-u u-- -uu--	dactylic hexameter	feminine penthemimeral, trithemimeral
καὶ μὴν Φοινίκας ἀποτέμνεται Ἀρραβίας τε	- - -uu ---uu -uu- -	dactylic hexameter	
καὶ Συρίας Λιβύας τε κελαινῶν τ᾽Αἰθιοπήων.	- uu- uu- u u-- -uu--	dactylic hexameter	masculine penthemimeral, trithemimeral
Παμφύλοισί τε πᾶσι καὶ αἰχμηταῖς Κιλίκεσσι	---u u -u u --- uu--	dactylic hexameter	feminine penthemimeral
σαμαίνει, Λυκίοις τε φιλοπτολέμοισί τε Καρσί,	--- uu- u u-uu-u u --	dactylic hexameter	masculine penthemimeral, trithemimeral
καὶ νάσοις Κυκλάδεσσιν, ἐπεί οἱ νᾶες ἄρισται	- -- uu-u u- - -u u--	dactylic hexameter	feminine penthemimeral, hepthemimeral, trithemimeral
πόντον ἐπιπλώοντι, θάλασσα δὲ πᾶσα καὶ αἶα	-u u---u u-u u -u u --	dactylic hexameter	feminine penthemimeral
καὶ ποταμοὶ κελάδοντες ἀνάσσονται Πτολεμαίῳ.	- uu- uu-u u--- uu--	dactylic hexameter	feminine penthemimeral, trithemimeral
πολλοὶ δ᾽ἱππῆες, πολλοὶ δέ μιν ἀσπιδιῶται.	-- --- -- u u -uu--	dactylic hexameter	masculine penthemimeral, hepthemimeral
χαλκῷ μαρμαίροντι σεσαγμένοι ἀμφαγέρονται.	-- ---u u-uu -uu--	dactylic hexameter	feminine penthemimeral
ὄλβῳ μὲν πάντάς κε καταβρίθοι βασιλῆας·	-- - -- u u--- uu--	dactylic hexameter	masculine penthemimeral, trithemimeral
τόσσον ἐπ᾽ ἆμαρ ἕκαστον ἐς ἀφνεὸν ἔρχεται οἶκον	-u u -u u-u u -uu -uu --	dactylic hexameter	feminine penthemimeral
πάντοθε. λαοὶ δ᾽ἔργα περιστέλλουσιν ἕκηλοι.	-uu -- -u u---u u--	dactylic hexameter	feminine penthemimeral
οὐ γάρ τις δηίων πολυκήτεα Νεῖλον ὑπερβὰς	- - - -- uu-uu -u u--	dactylic hexameter	masculine penthemimeral, trithemimeral
πεζὸς ἐν ἀλλοτρίαισι βοὰν ἐστάσατο κώμαις,	-u u -uu-u u- --uu --	dactylic hexameter	feminine penthemimeral, hepthemimeral
οὐδέ τις αἰγιαλόνδε θοᾶς ἐξάλατο ναὸς	-u u -uu-u u- --uu --	dactylic hexameter	feminine penthemimeral, hepthemimeral
θωρηχθεὶς ἐπὶ βουσὶν ἀνάρσιος Αἰγυπτίῃσι·	--- uu -u u-uu -uu--	dactylic hexameter	feminine penthemimeral, trithemimeral
τοῖος ἀνὴρ πλατέεσσιν ἐνίδρυται πεδίοισι	-u u- uu-u u--- uu--	dactylic hexameter	feminine penthemimeral, trithemimeral
ξανθοκόμας Πτολεμαῖος, ἐπιστάμενος δόρυ πάλλειν,	-uu- uu-u u-uu- uu --	dactylic hexameter	feminine penthemimeral, trithemimeral
ᾧ ἐπὶ πάγχυ μέλει πατρώια πάντα φυλάσσειν	- uu -u u- --uu -u u--	dactylic hexameter	masculine penthemimeral
οἷ᾽ ἀγαθῷ βασιλῆι, τὰ δὲ κτεατίζεται αὐτός.	- uu- uu-u u - uu-uu --	dactylic hexameter	feminine penthemimeral, hepthemimeral, trithemimeral
οὐ μὰν ἀχρεῖός γε δόμῳ ἐνὶ πίονι χρυσὸς	- - --- u u- uu --- --	lyric	
μυρμάκων ἅτε πλοῦτος ἀεὶ κέχυται μογεόντων·	--- uu -u u- uu- uu--	dactylic hexameter	feminine penthemimeral, hepthemimeral, trithemimeral
ἀλλὰ πολὺν μὲν ἔχοντι θεῶν ἐρικυδέες οἶκοι,	-u u- u u-u u- uu-uu --	dactylic hexameter	feminine penthemimeral, hepthemimeral, trithemimeral
αἰὲν ἀπαρχομένοιο σὺν ἄλλοισιν γεράεσσι,	-u u-uu-u u --- uu--	dactylic hexameter	feminine penthemimeral
πολλὸν δ᾽ἰφθίμοισι δεδώρηται βασιλεῦσι,	-- ---u u--- uu--	dactylic hexameter	feminine penthemimeral
πολλὸν δὲ πτολίεσσι, πολὺν δ᾽ἀγαθοῖσιν ἑταίροις.	-- - uu-u u- uu-u u--	dactylic hexameter	feminine penthemimeral, hepthemimeral, trithemimeral
οὐδὲ Διωνύσου τις ἀνὴρ ἱεροὺς κατ᾽ ἀγῶνας	-u u--- u u- uu- u u--	dactylic hexameter	masculine penthemimeral, hepthemimeral
ἵκετ᾽ ἐπιστάμενος λιγυρὰν ἀναμέλψαι ἀοιδάν,	-u u-uu- uu- uu-u u--	dactylic hexameter	masculine penthemimeral, hepthemimeral
ᾧ οὐ δωτίναν ἀντάξιον ὤπασε τέχνας.	- - -uu ---- -u- -	lyric	
Μουσάων δ᾽ὑποφῆται ἀείδοντι Πτολεμαῖον	--- uu-u u--- uu--	dactylic hexameter	feminine penthemimeral, trithemimeral
ἀντ᾽ εὐεργεσίας. τί δὲ κάλλιον ἀνδρί κεν εἴη	- --uu- u u -uu -u u --	dactylic hexameter	masculine penthemimeral
ὀλβίῳ ἢ κλέος ἐσθλὸν ἐν ἀνθρώποισιν ἀρέσθαι;	-uu - uu -u u ---u u--	dactylic hexameter	feminine penthemimeral, trithemimeral
τοῦτο καὶ Ἀτρείδαισι μένει· τὰ δὲ μυρία τῆνα,	-u u ---u u- u u -uu --	dactylic hexameter	feminine penthemimeral, hepthemimeral
ὅσσα μέγαν Πριάμοιο δόμον κτεάτισσαν ἑλόντες,	-u u- uu-u u- uu-u u--	dactylic hexameter	feminine penthemimeral, hepthemimeral, trithemimeral
ἀέρι πᾳ κέκρυπται, ὅθεν πάλιν οὐκέτι νόστος·	-uu - --u u- uu -uu --	dactylic hexameter	feminine penthemimeral, hepthemimeral, trithemimeral
μοῦνος δὲ προτέρων τε καὶ ὧν ἔτι θερμὰ κονία	-- - uu- u u - uu -u u--	dactylic hexameter	masculine penthemimeral, hepthemimeral, trithemimeral
στειβομένα καθύπερθε ποδῶν ἐκμάσσεται ἴχνη,	-uu- uu-u u- --u- -	lyric	
ματρὶ φίλᾳ καὶ πατρὶ θυώδεας εἵσατο ναούς·	-u u- - -u u-uu -uu --	dactylic hexameter	feminine penthemimeral, trithemimeral
ἐν δ᾽αὐτοὺς χρυσῷ περικαλλέας ἠδ᾽ ἐλέφαντι	- -- -- uu-uu - uu--	dactylic hexameter	masculine penthemimeral, trithemimeral
ἵδρυται πάντεσσιν ἐπιχθονίοισιν ἀρωγούς.	--- --u u---u u--	dactylic hexameter	feminine penthemimeral, trithemimeral
πολλὰ δὲ πιανθέντα βοῶν ὅγε μηρία καίει	-u u ---u u- uu -uu --	dactylic hexameter	feminine penthemimeral, hepthemimeral
μησὶ περιπλομένοισιν ἐρευθομένων ἐπὶ βωμῶν,	-u u-uu-u u-uu- uu --	dactylic hexameter	feminine penthemimeral
αὐτός τ᾽ἰφθίμα τ᾽ἄλοχος, τᾶς οὔτις ἀρείων	-- -uu --- - -u u--	dactylic hexameter	hepthemimeral
νυμφίον ἐν μεγάροισι γυνὰ περιβάλλετ᾽ ἀγοστῷ,	-uu - uu-u u- uu-u u--	dactylic hexameter	feminine penthemimeral, hepthemimeral, trithemimeral
ἐκ θυμοῦ στέργοισα κασίγνητόν τε πόσιν τε.	- -- --u u--- u u- -	dactylic hexameter	feminine penthemimeral, trithemimeral
ὧδε καὶ ἀθανάτων ἱερὸς γάμος ἐξετελέσθη,	-u u -uu- uu- uu -uu--	dactylic hexameter	masculine penthemimeral, hepthemimeral
οὓς τέκετο κρείουσα Ῥέα βασιλῆας Ὀλύμπου·	- uu- --u u- uu-u u--	dactylic hexameter	feminine penthemimeral, hepthemimeral, trithemimeral
ἓν δὲ λέχος στόρνυσιν ἰαύειν Ζηνὶ καὶ Ἥρῃ	- u u- --u u-- -u u --	dactylic hexameter	feminine penthemimeral, trithemimeral
χεῖρας φοιβήσασα μύροις ἔτι παρθένος ̂Ἰρις.	-- ---u u- uu -uu --	dactylic hexameter	feminine penthemimeral, hepthemimeral
χαῖρε ἄναξ Πτολεμαῖε· σέθεν δ᾽ἐγὼ ἶσα καὶ ἄλλων	-u u- uu-u u- uu -u u --	dactylic hexameter	feminine penthemimeral, hepthemimeral, trithemimeral
μνάσομαι ἡμιθέων, δοκέω δ᾽ἔπος οὐκ ἀπόβλητον	-uu -uu- uu- uu - uu--	dactylic hexameter	masculine penthemimeral, hepthemimeral
φθέγξομαι ἐσσομένοις· ἀρετήν γε μὲν ἐκ Διὸς αἰτεῦ.	-uu -uu- uu- u u - uu --	dactylic hexameter	masculine penthemimeral, hepthemimeral
Ἔν ποκ᾽ ἄρα Σπάρτᾳ ξανθότριχι πὰρ Μενελάῳ	- u u- -- --uu - uu--	dactylic hexameter	masculine penthemimeral, trithemimeral
παρθενικαὶ θάλλοντα κόμαις ὑάκινθον ἔχοισαι	-uu- --u u- uu-u u--	dactylic hexameter	feminine penthemimeral, hepthemimeral, trithemimeral
πρόσθε νεογράπτω θαλάμω χορὸν ἐστάσαντο,	-u u--- uu- uu ----	dactylic hexameter	masculine penthemimeral, hepthemimeral
δώδεκα ταὶ πρᾶται πόλιος, μέγα χρῆμα Λακαινᾶν,	-uu - -- uu- uu -u u--	dactylic hexameter	masculine penthemimeral, hepthemimeral, trithemimeral
ἁνίκα Τυνδαριδᾶν κατεδέξατο τὰν ἀγαπητὰν	-uu -uu- uu-uu - uu--	dactylic hexameter	masculine penthemimeral
μναστεύσας Ἑλέναν ὁ νεώτερος Ἀτρέος υἱός.	--- uu- u u-uu -uu --	dactylic hexameter	masculine penthemimeral, trithemimeral
ἄειδον δ᾽ἄρα πᾶσαι ἐς ἓν μέλος ἐγκροτέοισαι	--- uu -u u - uu -uu--	dactylic hexameter	feminine penthemimeral, hepthemimeral, trithemimeral
ποσσὶ περιπλέκτοις, ὑπὸ δ᾽ἴαχε δῶμ᾽ ὑμεναίῳ.	-u u--- uu -uu - uu--	dactylic hexameter	masculine penthemimeral
οὕτω δὴ πρωιζὲ κατέδραθες ὦ φίλε γαμβρέ;	-- - --u u-uu - uu --	dactylic hexameter	feminine penthemimeral, trithemimeral
ἦ ῥά τις ἐσσὶ λίαν βαρυγούνατος; ἦ ῥα φίλυπνος;	- u u -u u- uu-uu - u u--	dactylic hexameter	masculine penthemimeral
ἦ ῥα πολύν τιν᾽ ἔπινες, ὅτ᾽ εἰς εὐνὰν κατεβάλλευ;	- u u- u u-u u - -- uu--	dactylic hexameter	feminine penthemimeral, hepthemimeral, trithemimeral
εὕδειν μὰν σπεύδοντα καθ᾽ ὥραν αὐτὸν ἐχρῆν τυ,	-- - --u u -- -u u- -	dactylic hexameter	feminine penthemimeral, trithemimeral
παῖδα δ᾽ἐᾶν σὺν παισὶ φιλοστόργῳ παρὰ ματρὶ	-u u- - -u u--- uu --	dactylic hexameter	feminine penthemimeral, trithemimeral
παίσδειν ἐς βαθὺν ὄρθρον, ἐπεὶ καὶ ἔνας καὶ ἐς ἀῶ	-- - uu -u u- u u- u u --	dactylic hexameter	feminine penthemimeral, hepthemimeral, trithemimeral
κεἰς ἔτος ἐξ ἔτεος Μενέλαε τεὰ νυὸς ἅδε.	- uu - uu- uu-u u- uu --	dactylic hexameter	masculine penthemimeral, trithemimeral
ὄλβιε γάμβρ᾽, ἀγαθός τις ἐπέπταρεν ἐρχομένῳ τοι	-uu - uu- u u-uu -uu- -	dactylic hexameter	masculine penthemimeral, trithemimeral
ἐς Σπάρταν, ἅπερ ὥλλοι ἀριστέες, ὡς ἀνύσαιο.	- -- uu -u u-uu - uu--	dactylic hexameter	feminine penthemimeral, trithemimeral
μοῦνος ἐν ἡμιθέοις Κρονίδαν Δία πενθερὸν ἑξεῖς.	-u u -uu- uu- uu -uu --	dactylic hexameter	masculine penthemimeral, hepthemimeral
Ζανός τοι θυγάτηρ ὑπὸ τὰν μίαν ἵκετο χλαῖναν,	-- - uu- uu - uu -uu --	dactylic hexameter	masculine penthemimeral, hepthemimeral, trithemimeral
οἵα Ἀχαιιάδων γαῖαν πατεῖ οὐδὲ μί᾽ ἄλλα.	-u u-uu- -- uu -u u --	dactylic hexameter	masculine penthemimeral, hepthemimeral
ἦ μέγα κέν τι τέκοιτ᾽, εἰ ματέρι τίκτοι ὁμοῖον.	- uu - u u- - -uu -u u--	dactylic hexameter	masculine penthemimeral, trithemimeral
ἄμμες δ᾽αἱ πᾶσαι συνομάλικες, αἷς δρόμος ωὑτός	-- - -- uu-uu - uu ---	lyric	
χρισαμέναις ἀνδριστὶ παρ᾽ Εὐρώταο λοετροῖς,	-uu- --u u ---u u--	dactylic hexameter	feminine penthemimeral, trithemimeral
τετράκις ἑξήκοντα κόραι, θῆλυς νεολαία,	-uu ---u u- -- uu--	dactylic hexameter	feminine penthemimeral, hepthemimeral
τᾶν οὐδέν τις ἄμωμος, ἐπεί χ᾽Ἑλένᾳ παρισωθῇ.	- -- u u-u u- uu- uu--	dactylic hexameter	feminine penthemimeral, hepthemimeral, trithemimeral
Ἀὼς ἀντέλλοισα καλὸν διέφανε πρόσωπον,	-- ---u u- uu-u u--	dactylic hexameter	feminine penthemimeral, hepthemimeral
πότνια νὺξ τό τε λευκὸν ἔαρ χειμῶνος ἀνέντος·	-uu - u u -u u- --u u--	dactylic hexameter	feminine penthemimeral, hepthemimeral, trithemimeral
ὧδε καὶ ἁ χρυσέα Ἑλένα διαφαίνετ᾽ ἐν ἁμῖν.	-u u - uu- uu- uu-u u --	dactylic hexameter	masculine penthemimeral, hepthemimeral, trithemimeral
πιείρᾳ μέγα λᾷον ἀνέδραμε κόσμος ἀρούρᾳ	--- uu -u u-uu -u u--	dactylic hexameter	feminine penthemimeral, trithemimeral
ἢ κάπῳ κυπάρισσος ἢ ἅρματι Θεσσαλὸς ἵππος·	- -- uu-u u -uu -uu --	dactylic hexameter	feminine penthemimeral, trithemimeral
ὧδε καὶ ἁ ῥοδόχρως Ἑλένα Λακεδαίμονι κόσμος.	-u u - uu- uu- uu-uu --	dactylic hexameter	masculine penthemimeral, hepthemimeral, trithemimeral
οὔτέ τις ἐκ ταλάρω πανίσδεται ἔργα τοιαῦτα,	-u u - uu- --uu -u u--	dactylic hexameter	masculine penthemimeral, trithemimeral
οὔτ᾽ ἐνὶ δαιδαλέῳ πυκινώτερον ἄτριον ἱστῷ	- uu -uu- uu-uu -uu --	dactylic hexameter	masculine penthemimeral
κερκίδι συμπλέξασα μακρῶν ἔταμ᾽ ἐκ κελεόντων.	-uu ---u u- uu - uu--	dactylic hexameter	feminine penthemimeral, hepthemimeral
οὐ μὰν οὐδὲ λύραν τις ἐπίσταται ὧδε κροτῆσαι	- - -u u- u u-uu -u u--	dactylic hexameter	masculine penthemimeral
Ἄρτεμιν ἀείδοισα καὶ εὐρύστερνον Ἀθάναν,	-uu ---u u ---u u--	dactylic hexameter	feminine penthemimeral
ὡς Ἑλένα, τᾶς πάντες ἐπ᾽ ὄμμασιν ἵμεροι ἐντί.	- uu- - -u u -uu -uu --	dactylic hexameter	feminine penthemimeral, trithemimeral
ὦ καλὰ ὦ χαρίεσσα κόρα, τὺ μὲν οἰκέτις ἤδη,	- uu - uu-u u- u u -uu --	dactylic hexameter	feminine penthemimeral, hepthemimeral, trithemimeral
ἄμμες δ᾽ἐς δρόμον ἦρι καὶ ἐς λειμώνια φύλλα	-- - uu -u u - --uu --	dactylic hexameter	feminine penthemimeral, hepthemimeral, trithemimeral
ἑρψοῦμες στεφάνως δρεψούμεναι ἁδὺ πνέοντας,	--- uu- --uu -u u--	dactylic hexameter	masculine penthemimeral, trithemimeral
πολλὰ τεοῦς Ἑλένα μεμναμέναι ὡς γαλαθηναὶ	-u u- uu- --uu - uu--	dactylic hexameter	masculine penthemimeral, trithemimeral
ἄρνες γειναμένας ὄιος μαστὸν ποθέοισαι.	-- -uu- -- -- uu--	dactylic hexameter	masculine penthemimeral, hepthemimeral
πρᾶταί τοι στέφανον λωτῶ χαμαὶ αὐξομένοιο	-- - uu- -- uu -uu--	dactylic hexameter	masculine penthemimeral, hepthemimeral, trithemimeral
πλέξασαι σκιερὰν καταθήσομεν ἐς πλατάνιστον,	--- uu- uu-uu - uu--	dactylic hexameter	masculine penthemimeral, trithemimeral
πρᾶται δ᾽ἀργυρέας ἐξ ὄλπιδος ὑγρὸν ἄλειφαρ	-- -uu- - -uu -u u--	dactylic hexameter	masculine penthemimeral
λαζύμεναι σταξεῦμες ὑπὸ σκιερὰν πλατάνιστον·	-uu- --u u- uu- uu--	dactylic hexameter	feminine penthemimeral, hepthemimeral, trithemimeral
γράμματα δ᾽ἐν φλοιῷ γεγράψεται, (ὡς παριών τις	-uu - -- --uu - uu- -	dactylic hexameter	masculine penthemimeral, trithemimeral
ἀννείμῃ,) δωριστί· σέβου μ᾽·Ἑλένας φυτὸν εἰμί.	--- --u u- uu- uu --	dactylic hexameter	feminine penthemimeral, hepthemimeral, trithemimeral
χαίροις ὦ νύμφα, χαίροις εὐπένθερε γαμβρέ.	-- - -- -- --uu --	dactylic hexameter	masculine penthemimeral, hepthemimeral, trithemimeral
Λατὼ μὲν δοίη, Λατὼ κουροτρόφος ὔμμιν	-- - -- -- --uu --	dactylic hexameter	masculine penthemimeral, hepthemimeral, trithemimeral
εὐτεκνίαν, Κύπρις δέ, θεὰ Κύπρις ἶσον ἔρασθαι	-uu- -- u u- uu -u u--	dactylic hexameter	masculine penthemimeral, hepthemimeral, trithemimeral
ἀλλάλων, Ζεὺς δέ, Κρονίδας Ζεὺς ἄφθιτον ὄλβον,	--- - - uu- - -uu --	dactylic hexameter	masculine penthemimeral, hepthemimeral, trithemimeral
ὡς ἐξ εὐπατριδᾶν εἰς εὐπατρίδας πάλιν ἔνθῃ.	- - -uu- - -uu- uu --	dactylic hexameter	masculine penthemimeral
εὕδετ᾽ ἐς ἀλλάλων στέρνον φιλότητα πνέοντες	-u u --- -- uu-u u--	dactylic hexameter	masculine penthemimeral, hepthemimeral
καὶ πόθον, ἔγρεσθαι δὲ πρὸς ἀῶ μἠπιλάθησθε.	- uu --- u u -- -uu--	dactylic hexameter	masculine penthemimeral
νεύμεθα κἄμμες ἐς ὄρθρον, ἐπεί κα πρᾶτος ἀοιδὸς	-uu -u u -u u- - -u u--	dactylic hexameter	feminine penthemimeral, hepthemimeral
ἐξ εὐνᾶς κελαδήσῃ ἀνασχὼν εὔτριχα δειράν.	- -- uu-u u-- -uu --	dactylic hexameter	feminine penthemimeral, trithemimeral
Ὕμὴν ὦ Ὕμέναιε, γάμῳ ἐπὶ τῷδε χαρείης.	-- - uu-u u- uu -u u--	dactylic hexameter	feminine penthemimeral, hepthemimeral, trithemimeral
τὸν κλέπταν πότ᾽ Ἔρωτα κακὰ κέντασε μέλισσα	- -- u u-u u- --u u--	dactylic hexameter	feminine penthemimeral, hepthemimeral, trithemimeral
κηρίον ἐκ σίμβλων συλεύμενον, ἄκρα δὲ χειρῶν	-uu - -- --uu -u u --	dactylic hexameter	masculine penthemimeral, trithemimeral
δάκτυλα πάνθ᾽ ὑπένυξεν. ὁ δ᾽ἄλγεε καὶ χέρ᾽ ἐφύση	-uu - uu-u u -uu - u u--	dactylic hexameter	feminine penthemimeral, trithemimeral
καὶ τὰν γᾶν ἐπάταξε καὶ ἅλατο, τᾷ δ᾽Ἀφροδίτᾳ	- - - uu-u u -uu - uu--	dactylic hexameter	feminine penthemimeral, trithemimeral
δεῖξεν τὰν ὀδύναν καὶ μέμφετο, ὅττί γε τυτθὸν	-- - uu- - -uu -u u --	dactylic hexameter	masculine penthemimeral, trithemimeral
θηρίον ἐστὶ μέλισσα καὶ ἁλίκα τραύματα ποιεῖ.	-uu -u u-u u -uu -uu --	dactylic hexameter	feminine penthemimeral
χἁ μάτηρ γελάσασα· τί δ᾽; οὐκ ἴσος ἐσσὶ μελίσσαις;	- -- uu-u u - uu -u u--	dactylic hexameter	feminine penthemimeral, hepthemimeral, trithemimeral
ὡς τυτθὸς μὲν ἔφυς, τὰ δὲ τραύματα χἁλίκα ποιεῖς.	- -- u u- u u -uu -uu --	dactylic hexameter	masculine penthemimeral, trithemimeral
