μουσάων Ἑλικωνιάδων ἀρχώμεθʼ ἀείδειν,	--- uu-uu- --u u--	dactylic hexameter	hepthemimeral, trithemimeral
αἵθʼ Ἑλικῶνος ἔχουσιν ὄρος μέγα τε ζάθεόν τε	- uu-u u-u u- uu - uu- -	dactylic hexameter	feminine penthemimeral, hepthemimeral
καί τε περὶ κρήνην ἰοειδέα πόσσʼ ἁπαλοῖσιν	- u u- -- uu-uu - uu--	dactylic hexameter	masculine penthemimeral, trithemimeral
ὀρχεῦνται καὶ βωμὸν ἐρισθενέος Κρονίωνος.	--- - -u u-uu- uu--	dactylic hexameter	feminine penthemimeral, trithemimeral
καί τε λοεσσάμεναι τέρενα χρόα Περμησσοῖο	- u u-uu- uu- uu ----	dactylic hexameter	masculine penthemimeral, hepthemimeral
ἢ Ἵππου κρήνης ἢ Ὀλμειοῦ ζαθέοιο	- -- -- - --- uu--	dactylic hexameter	masculine penthemimeral, trithemimeral
ἀκροτάτῳ Ἑλικῶνι χοροὺς ἐνεποιήσαντο	-uu- uu-u u- uu----	dactylic hexameter	feminine penthemimeral, hepthemimeral, trithemimeral
καλούς, ἱμερόεντας· ἐπερρώσαντο δὲ ποσσίν.	-- -uu-u u---u u --	dactylic hexameter	feminine penthemimeral
ἔνθεν ἀπορνύμεναι, κεκαλυμμέναι ἠέρι πολλῇ,	-u u-uu- uu-uu -uu --	dactylic hexameter	masculine penthemimeral
ἐννύχιαι στεῖχον περικαλλέα ὄσσαν ἱεῖσαι,	-uu- -- uu-uu -u u--	dactylic hexameter	masculine penthemimeral, trithemimeral
ὑμνεῦσαι Δία τ᾽αἰγίοχον καὶ πότνιαν Ἥρην	--- uu -uu- - -uu --	dactylic hexameter	hepthemimeral, trithemimeral
Ἀργεΐην, χρυσέοισι πεδίλοις ἐμβεβαυῖαν,	-uu- uu-u u-- -uu--	dactylic hexameter	feminine penthemimeral, trithemimeral
κούρην τ᾽αἰγιόχοιο Διὸς γλαυκῶπιν Ἀθήνην	-- -uu-u u- --u u--	dactylic hexameter	feminine penthemimeral, hepthemimeral
Φοῖβόν τ᾽Ἀπόλλωνα καὶ Ἄρτεμιν ἰοχέαιραν	-- ---u u -uu -uu--	dactylic hexameter	feminine penthemimeral
ἠδὲ Ποσειδάωνα γεήοχον, ἐννοσίγαιον,	-u u---u u-uu -uu--	dactylic hexameter	feminine penthemimeral
καὶ Θέμιν αἰδοίην ἑλικοβλέφαρόν τ᾽Ἀφροδίτην	- uu --- uu-uu- uu--	dactylic hexameter	masculine penthemimeral
Ἥβην τε χρυσοστέφανον καλήν τε Διώνην	-- - --uu- -- u u--	dactylic hexameter	hepthemimeral, trithemimeral
Λητώ τ᾽Ἰαπετόν τε ἰδὲ Κρόνον ἀγκυλομήτην	-- -uu- u u- uu -uu--	dactylic hexameter	masculine penthemimeral, hepthemimeral
Ἠῶ τ᾽Ἠέλιόν τε μέγαν λαμπράν τε Σελήνην	-- -uu- u u- -- u u--	dactylic hexameter	masculine penthemimeral, hepthemimeral
Γαῖάν τ᾽Ὠκεανόν τε μέγαν καὶ Νύκτα μέλαιναν	-- -uu- u u- - -u u--	dactylic hexameter	masculine penthemimeral, hepthemimeral
ἄλλων τ᾽ἀθανάτων ἱερὸν γένος αἰὲν ἐόντων.	-- -uu- uu- uu -u u--	dactylic hexameter	masculine penthemimeral, hepthemimeral
αἵ νύ ποθʼ Ἡσίοδον καλὴν ἐδίδαξαν ἀοιδήν,	- u u -uu- -- uu-u u--	dactylic hexameter	masculine penthemimeral, hepthemimeral
ἄρνας ποιμαίνονθʼ Ἑλικῶνος ὕπο ζαθέοιο.	-- --- uu-u u- uu--	dactylic hexameter	masculine penthemimeral
τόνδε δέ με πρώτιστα θεαὶ πρὸς μῦθον ἔειπον,	-u u - --u u- - -u u--	dactylic hexameter	feminine penthemimeral, hepthemimeral, trithemimeral
Μοῦσαι Ὀλυμπιάδες, κοῦραι Διὸς αἰγιόχοιο·	-u u-uu- -- uu -uu--	dactylic hexameter	masculine penthemimeral, hepthemimeral
ποιμένες ἄγραυλοι, κάκʼ ἐλέγχεα, γαστέρες οἶον,	-uu --- u u-uu -uu --	dactylic hexameter	masculine penthemimeral
ἴδμεν ψεύδεα πολλὰ λέγειν ἐτύμοισιν ὁμοῖα,	-- -uu -u u- uu-u u--	dactylic hexameter	feminine penthemimeral, hepthemimeral
ἴδμεν δ᾽,εὖτʼ ἐθέλωμεν, ἀληθέα γηρύσασθαι.	-- - uu-u u-uu ----	dactylic hexameter	feminine penthemimeral, trithemimeral
ὣς ἔφασαν κοῦραι μεγάλου Διὸς ἀρτιέπειαι·	- uu- -- uu- uu -uu--	dactylic hexameter	masculine penthemimeral, hepthemimeral, trithemimeral
καί μοι σκῆπτρον ἔδον δάφνης ἐριθηλέος ὄζον	- - -u u- -- uu-uu --	dactylic hexameter	masculine penthemimeral, hepthemimeral
δρέψασαι, θηητόν· ἐνέπνευσαν δέ μοι αὐδὴν	--- --u u--- u u --	dactylic hexameter	feminine penthemimeral, trithemimeral
θέσπιν, ἵνα κλείοιμι τά τ᾽ἐσσόμενα πρό τ᾽ἐόντα.	-u u- --u u -uu- u u--	dactylic hexameter	feminine penthemimeral, trithemimeral
καί μ᾽ἐκέλονθʼ ὑμνεῖν μακάρων γένος αἰὲν ἐόντων,	- uu- -- uu- uu -u u--	dactylic hexameter	masculine penthemimeral, hepthemimeral, trithemimeral
σφᾶς δ᾽αὐτὰς πρῶτόν τε καὶ ὕστατον αἰὲν ἀείδειν.	- -- -- u u -uu -u u--	dactylic hexameter	masculine penthemimeral, trithemimeral
ἀλλὰ τί ἦ μοι ταῦτα περὶ δρῦν ἢ περὶ πέτρην;	-u u - - -u u- - - uu --	dactylic hexameter	feminine penthemimeral, hepthemimeral, trithemimeral
τύνη, Μουσάων ἀρχώμεθα, ταὶ Διὶ πατρὶ	-- --- --uu - uu --	dactylic hexameter	masculine penthemimeral
ὑμνεῦσαι τέρπουσι μέγαν νόον ἐντὸς Ὀλύμπου,	--- --u u- uu -u u--	dactylic hexameter	feminine penthemimeral, hepthemimeral, trithemimeral
εἰρεῦσαι τά τ᾽ἐόντα τά τ᾽ἐσσόμενα πρό τ᾽ἐόντα,	--- u u-u u -uu- u u--	dactylic hexameter	feminine penthemimeral, trithemimeral
φωνῇ ὁμηρεῦσαι· τῶν δ᾽ἀκάματος ῥέει αὐδὴ	-u u--- - -uu- uu --	dactylic hexameter	masculine penthemimeral
ἐκ στομάτων ἡδεῖα· γελᾷ δέ τε δώματα πατρὸς	- uu- --u u- u u -uu --	dactylic hexameter	feminine penthemimeral, hepthemimeral, trithemimeral
Ζηνὸς ἐριγδούποιο θεᾶν ὀπὶ λειριοέσσῃ	-u u---u u- uu -uu--	dactylic hexameter	feminine penthemimeral, hepthemimeral
σκιδναμένῃ· ἠχεῖ δὲ κάρη νιφόεντος Ὀλύμπου	-uu- -- u u- uu-u u--	dactylic hexameter	masculine penthemimeral, hepthemimeral, trithemimeral
δώματά τ᾽ἀθανάτων. αἳ δ᾽ἄμβροτον ὄσσαν ἱεῖσαι	-uu -uu- - -uu -u u--	dactylic hexameter	masculine penthemimeral
θεῶν γένος αἰδοῖον πρῶτον κλείουσιν ἀοιδῇ	- uu --- -- --u u--	dactylic hexameter	masculine penthemimeral, hepthemimeral
ἐξ ἀρχῆς, οὓς Γαῖα καὶ Οὐρανὸς εὐρὺς ἔτικτεν,	- -- - -u u -uu -u u--	dactylic hexameter	feminine penthemimeral, trithemimeral
οἵ τ᾽ἐκ τῶν ἐγένοντο θεοί, δωτῆρες ἐάων.	- - - uu-u u- --u u--	dactylic hexameter	feminine penthemimeral, hepthemimeral, trithemimeral
δεύτερον αὖτε Ζῆνα, θεῶν πατέρʼ ἠδὲ καὶ ἀνδρῶν,	-uu -- -u u- uu -u u --	dactylic hexameter	feminine penthemimeral, hepthemimeral
ἀρχόμεναί θ᾽ὑμνεῦσι καὶ ἐκλήγουσαι ἀοιδῆς,	-uu- --u u ---u u--	dactylic hexameter	feminine penthemimeral, trithemimeral
ὅσσον φέρτατός ἐστι θεῶν κράτεί τε μέγιστος.	-- -uu -u u- -- u u--	dactylic hexameter	feminine penthemimeral, hepthemimeral
αὖτις δ᾽ἀνθρώπων τε γένος κρατερῶν τε Γιγάντων	-- --- u u- uu- u u--	dactylic hexameter	masculine penthemimeral, hepthemimeral
ὑμνεῦσαι τέρπουσι Διὸς νόον ἐντὸς Ὀλύμπου	--- --u u- uu -u u--	dactylic hexameter	feminine penthemimeral, hepthemimeral, trithemimeral
Μοῦσαι Ὀλυμπιάδες, κοῦραι Διὸς αἰγιόχοιο.	-u u-uu- -- uu -uu--	dactylic hexameter	masculine penthemimeral, hepthemimeral
τὰς ἐν Πιερίῃ Κρονίδῃ τέκε πατρὶ μιγεῖσα	- - -uu- uu- uu -u u--	dactylic hexameter	masculine penthemimeral, hepthemimeral
Μνημοσύνη, γουνοῖσιν Ἐλευθῆρος μεδέουσα,	-uu- --u u--- uu--	dactylic hexameter	feminine penthemimeral, trithemimeral
λησμοσύνην τε κακῶν ἄμπαυμά τε μερμηράων.	-uu- u u- --u u ----	dactylic hexameter	masculine penthemimeral, trithemimeral
ἐννέα γάρ οἱ νυκτὸς ἐμίσγετο μητίετα Ζεὺς	-uu - - -u u-uu -uu- -	dactylic hexameter	feminine penthemimeral, trithemimeral
νόσφιν ἀπʼ ἀθανάτων ἱερὸν λέχος εἰσαναβαίνων·	-u u -uu- uu- uu -uu--	dactylic hexameter	masculine penthemimeral, hepthemimeral
ἀλλʼ ὅτε δή ῥ᾽ἐνιαυτὸς ἔην, περὶ δ᾽ἔτραπον ὧραι	- uu - uu-u u- uu -uu --	dactylic hexameter	feminine penthemimeral, hepthemimeral, trithemimeral
μηνῶν φθινόντων, περὶ δ᾽ἤματα πόλλʼ ἐτελέσθη,	-- --- uu -uu - uu--	dactylic hexameter	masculine penthemimeral
ἣ δ᾽ἔτεκʼ ἐννέα κούρας ὁμόφρονας, ᾗσιν ἀοιδὴ	- uu -uu -u u-uu -u u--	dactylic hexameter	feminine penthemimeral
μέμβλεται ἐν στήθεσσιν, ἀκηδέα θυμὸν ἐχούσαις,	-uu - --u u-uu -u u--	dactylic hexameter	feminine penthemimeral, trithemimeral
τυτθὸν ἀπʼ ἀκροτάτης κορυφῆς νιφόεντος Ὀλύμπου.	-u u -uu- uu- uu-u u--	dactylic hexameter	masculine penthemimeral, hepthemimeral
ἔνθα σφιν λιπαροί τε χοροὶ καὶ δώματα καλά.	-- - uu- u u- - -uu --	dactylic hexameter	masculine penthemimeral, hepthemimeral, trithemimeral
πὰρ δ᾽αὐτῇς Χάριτές τε καὶ Ἵμερος οἰκίʼ ἔχουσιν	- -- uu- u u -uu -u u--	dactylic hexameter	masculine penthemimeral, trithemimeral
ἐν θαλίῃς· ἐρατὴν δὲ διὰ στόμα ὄσσαν ἱεῖσαι	- uu- uu- u u- uu -u u--	dactylic hexameter	masculine penthemimeral, hepthemimeral, trithemimeral
μέλπονται πάντων τε νόμους καὶ ἤθεα κεδνὰ	--- -- u u- - -uu --	dactylic hexameter	masculine penthemimeral, hepthemimeral, trithemimeral
ἀθανάτων κλείουσιν, ἐπήρατον ὄσσαν ἱεῖσαι.	-uu- --u u-uu -u u--	dactylic hexameter	feminine penthemimeral, trithemimeral
αἳ τότʼ ἴσαν πρὸς Ὄλυμπον ἀγαλλόμεναι ὀπὶ καλῇ,	- u u- u u-u u-uu- uu --	dactylic hexameter	feminine penthemimeral, trithemimeral
ἀμβροσίῃ μολπῇ· περὶ δ᾽ἴαχε γαῖα μέλαινα	-uu- -- uu -uu -u u--	dactylic hexameter	masculine penthemimeral, trithemimeral
ὑμνεύσαις, ἐρατὸς δὲ ποδῶν ὕπο δοῦπος ὀρώρει	--- uu- u u- uu -u u--	dactylic hexameter	masculine penthemimeral, hepthemimeral, trithemimeral
νισσομένων πατέρʼ εἰς ὅν· ὃ δ᾽οὐρανῷ ἐμβασιλεύει,	-uu- uu - u u -uu -uu--	dactylic hexameter	masculine penthemimeral, trithemimeral
αὐτὸς ἔχων βροντὴν ἠδʼ αἰθαλόεντα κεραυνόν,	-u u- -- - -uu-u u--	dactylic hexameter	masculine penthemimeral, trithemimeral
κάρτει νικήσας πατέρα Κρόνον· εὖ δὲ ἕκαστα	-- --- uu- uu - u u--	dactylic hexameter	masculine penthemimeral, hepthemimeral
ἀθανάτοις διέταξεν ὁμῶς καὶ ἐπέφραδε τιμάς.	-uu- uu-u u- u u-uu --	dactylic hexameter	feminine penthemimeral, hepthemimeral, trithemimeral
ταῦτʼ ἄρα Μοῦσαι ἄειδον, Ὀλύμπια δώματʼ ἔχουσαι,	- uu -u u-u u-uu -u u--	dactylic hexameter	feminine penthemimeral
ἐννέα θυγατέρες μεγάλου Διὸς ἐκγεγαυῖαι,	-uu -uu- uu- uu -uu--	dactylic hexameter	masculine penthemimeral, hepthemimeral
Κλειώ τ᾽Εὐτέρπη τε Θάλειά τε Μελπομένη τε	-- --- u u-u u -uu- -	dactylic hexameter	masculine penthemimeral
Τερψιχόρη τ᾽Ἐρατώ τε Πολύμνιά τ᾽Οὐρανίη τε	-uu- uu- u u-uu -uu- -	dactylic hexameter	masculine penthemimeral, trithemimeral
Καλλιόπη θʼ· ἣ δὲ προφερεστάτη ἐστὶν ἁπασέων.	-uu- - - uu-uu -u u--	dactylic hexameter	masculine penthemimeral, trithemimeral
ἣ γὰρ καὶ βασιλεῦσιν ἅμʼ αἰδοίοισιν ὀπηδεῖ.	- - - uu-u u ---u u--	dactylic hexameter	feminine penthemimeral, trithemimeral
ὅν τινα τιμήσωσι Διὸς κοῦραι μεγάλοιο	- uu ---u u- -- uu--	dactylic hexameter	feminine penthemimeral, hepthemimeral
γεινόμενόν τε ἴδωσι διοτρεφέων βασιλήων,	-uu- u u-u u-uu- uu--	dactylic hexameter	feminine penthemimeral, trithemimeral
τῷ μὲν ἐπὶ γλώσσῃ γλυκερὴν χείουσιν ἐέρσην,	- u u- -- uu- --u u--	dactylic hexameter	masculine penthemimeral, hepthemimeral, trithemimeral
τοῦ δ᾽ἔπεʼ ἐκ στόματος ῥεῖ μείλιχα· οἱ δέ τε λαοὶ	- uu - uu- - -uu - u u --	dactylic hexameter	masculine penthemimeral, trithemimeral
πάντες ἐς αὐτὸν ὁρῶσι διακρίνοντα θέμιστας	-u u -u u-u u---u u--	dactylic hexameter	feminine penthemimeral
ἰθείῃσι δίκῃσιν· ὃ δ᾽ἀσφαλέως ἀγορεύων	---u u-u u -uu- uu--	dactylic hexameter	feminine penthemimeral
αἶψά κε καὶ μέγα νεῖκος ἐπισταμένως κατέπαυσεν·	-u u - uu -u u-uu- uu--	dactylic hexameter	feminine penthemimeral, trithemimeral
τοὔνεκα γὰρ βασιλῆες ἐχέφρονες, οὕνεκα λαοῖς	-uu - uu-u u-uu -uu --	dactylic hexameter	feminine penthemimeral, trithemimeral
βλαπτομένοις ἀγορῆφι μετάτροπα ἔργα τελεῦσι	-uu- uu-u u-uu -u u--	dactylic hexameter	feminine penthemimeral, trithemimeral
ῥηιδίως, μαλακοῖσι παραιφάμενοι ἐπέεσσιν.	-uu- uu-u u-uu- uu--	dactylic hexameter	feminine penthemimeral, trithemimeral
ἐρχόμενον δ᾽ἀνʼ ἀγῶνα θεὸν ὣς ἱλάσκονται	-uu- u u-u u- - ----	dactylic hexameter	feminine penthemimeral, hepthemimeral, trithemimeral
αἰδοῖ μειλιχίῃ, μετὰ δὲ πρέπει ἀγρομένοισιν·	-- -uu- uu - uu -uu--	dactylic hexameter	masculine penthemimeral, hepthemimeral
τοίη Μουσάων ἱερὴ δόσις ἀνθρώποισιν.	-- --- uu- uu ----	dactylic hexameter	masculine penthemimeral, hepthemimeral
ἐκ γάρ τοι Μουσέων καὶ ἑκηβόλου Ἀπόλλωνος	- - - -- u u-uu ----	dactylic hexameter	masculine penthemimeral, trithemimeral
ἄνδρες ἀοιδοὶ ἔασιν ἐπὶ χθόνα καὶ κιθαρισταί,	-u u-u u-u u- uu - uu--	dactylic hexameter	feminine penthemimeral, hepthemimeral
ἐκ δὲ Διὸς βασιλῆες· ὃ δ᾽ὄλβιος, ὅν τινα Μοῦσαι	- u u- uu-u u -uu - uu --	dactylic hexameter	feminine penthemimeral, trithemimeral
φίλωνται· γλυκερή οἱ ἀπὸ στόματος ῥέει αὐδή.	--- uu- u u- uu- uu --	dactylic hexameter	masculine penthemimeral, hepthemimeral, trithemimeral
εἰ γάρ τις καὶ πένθος ἔχων νεοκηδέι θυμῷ	- - - - -u u- uu-uu --	dactylic hexameter	feminine penthemimeral, hepthemimeral, trithemimeral
ἄζηται κραδίην ἀκαχήμενος, αὐτὰρ ἀοιδὸς	--- uu- uu-uu -u u--	dactylic hexameter	masculine penthemimeral, trithemimeral
Μουσάων θεράπων κλέεα προτέρων ἀνθρώπων	--- uu- uu- uu- ---	dactylic hexameter	masculine penthemimeral, hepthemimeral, trithemimeral
ὑμνήσῃ μάκαράς τε θεούς, οἳ Ὄλυμπον ἔχουσιν,	--- uu- u u- u u-u u--	dactylic hexameter	masculine penthemimeral, hepthemimeral, trithemimeral
αἶψʼ ὅ γε δυσφροσυνέων ἐπιλήθεται οὐδέ τι κηδέων	- u u -uu- uu-uu -u u --	dactylic hexameter	masculine penthemimeral
μέμνηται· ταχέως δὲ παρέτραπε δῶρα θεάων.	--- uu- u u-uu -u u--	dactylic hexameter	masculine penthemimeral, trithemimeral
χαίρετε, τέκνα Διός, δότε δ᾽ἱμερόεσσαν ἀοιδήν.	-uu -u u- uu -uu-u u--	dactylic hexameter	masculine penthemimeral
κλείετε δ᾽ἀθανάτων ἱερὸν γένος αἰὲν ἐόντων,	-uu -uu- uu- uu -u u--	dactylic hexameter	masculine penthemimeral, hepthemimeral
οἳ Γῆς τ᾽ἐξεγένοντο καὶ Οὐρανοῦ ἀστερόεντος,	- - -uu-u u -uu -uu--	dactylic hexameter	feminine penthemimeral
Νυκτός τε δνοφερῆς, οὕς θ᾽ἁλμυρὸς ἔτρεφε Πόντος.	-- - uu- - -uu -uu --	dactylic hexameter	masculine penthemimeral, trithemimeral
εἴπατε δ᾽,ὡς τὰ πρῶτα θεοὶ καὶ γαῖα γένοντο	-uu - - -u u- - -u u--	dactylic hexameter	feminine penthemimeral, hepthemimeral, trithemimeral
καὶ ποταμοὶ καὶ πόντος ἀπείριτος, οἴδματι θυίων,	- uu- - -u u-uu -uu --	dactylic hexameter	feminine penthemimeral, trithemimeral
ἄστρα τε λαμπετόωντα καὶ οὐρανὸς εὐρὺς ὕπερθεν	-u u -uu-u u -uu -u u--	dactylic hexameter	feminine penthemimeral
[οἵ τ᾽ἐκ τῶν ἐγένοντο θεοί, δωτῆρες ἐάων	- - - uu-u u- --u u--	dactylic hexameter	feminine penthemimeral, hepthemimeral, trithemimeral
ὥς τ᾽ἄφενος δάσσαντο καὶ ὡς τιμὰς διέλοντο	- uu- --u u - -- uu--	dactylic hexameter	feminine penthemimeral, hepthemimeral, trithemimeral
ἠδὲ καὶ ὡς τὰ πρῶτα πολύπτυχον ἔσχον Ὄλυμπον.	-u u - - -u u-uu -u u--	dactylic hexameter	feminine penthemimeral, trithemimeral
ταῦτά μοι ἔσπετε Μοῦσαι, Ὀλύμπια δώματʼ ἔχουσαι	-u u -uu -u u-uu -u u--	dactylic hexameter	feminine penthemimeral
ἐξ ἀρχῆς, καὶ εἴπαθʼ, ὅ τι πρῶτον γένετʼ αὐτῶν.	- -- - -u u - -- uu --	dactylic hexameter	feminine penthemimeral, hepthemimeral, trithemimeral
ἦ τοι μὲν πρώτιστα Χάος γένετʼ, αὐτὰρ ἔπειτα	- - - --u u- uu -u u--	dactylic hexameter	feminine penthemimeral, hepthemimeral, trithemimeral
Γαῖʼ εὐρύστερνος, πάντων ἕδος ἀσφαλὲς αἰεὶ	- ---- -- uu -uu --	dactylic hexameter	masculine penthemimeral, hepthemimeral
[ἀθανάτων, οἳ ἔχουσι κάρη νιφόεντος Ὀλύμπου,	-uu- u u-u u- uu-u u--	dactylic hexameter	feminine penthemimeral, hepthemimeral, trithemimeral
Τάρταρά τ᾽ἠερόεντα μυχῷ χθονὸς εὐρυοδείης,	-uu -uu-u u- uu -uu--	dactylic hexameter	feminine penthemimeral, hepthemimeral
ἠδʼ Ἔρος, ὃς κάλλιστος ἐν ἀθανάτοισι θεοῖσι,	- uu - --u u -uu-u u--	dactylic hexameter	feminine penthemimeral, trithemimeral
λυσιμελής, πάντων δὲ θεῶν πάντων τ᾽ἀνθρώπων	-uu- -- u u- -- ---	dactylic hexameter	masculine penthemimeral, hepthemimeral, trithemimeral
δάμναται ἐν στήθεσσι νόον καὶ ἐπίφρονα βουλήν.	-uu - --u u- u u-uu --	dactylic hexameter	feminine penthemimeral, hepthemimeral, trithemimeral
ἐκ Χάεος δ᾽Ἔρεβός τε μέλαινά τε Νὺξ ἐγένοντο·	- uu- uu- u u-u u - uu--	dactylic hexameter	masculine penthemimeral, trithemimeral
Νυκτὸς δ᾽αὖτʼ Αἰθήρ τε καὶ Ἡμέρη ἐξεγένοντο,	-- - -- u u -uu -uu--	dactylic hexameter	masculine penthemimeral, trithemimeral
οὓς τέκε κυσαμένη Ἐρέβει φιλότητι μιγεῖσα.	- uu -uu- uu- uu-u u--	dactylic hexameter	masculine penthemimeral, hepthemimeral
Γαῖα δέ τοι πρῶτον μὲν ἐγείνατο ἶσον ἑαυτῇ	-u u - -- u u-uu -u u--	dactylic hexameter	masculine penthemimeral, trithemimeral
Οὐρανὸν ἀστερόενθʼ, ἵνα μιν περὶ πάντα καλύπτοι,	-uu -uu- uu - uu -u u--	dactylic hexameter	masculine penthemimeral, hepthemimeral
ὄφρʼ εἴη μακάρεσσι θεοῖς ἕδος ἀσφαλὲς αἰεί.	- -- uu-u u- uu -uu --	dactylic hexameter	feminine penthemimeral, hepthemimeral, trithemimeral
γείνατο δ᾽Οὔρεα μακρά, θεῶν χαρίεντας ἐναύλους,	-uu -uu -u u- uu-u u--	dactylic hexameter	feminine penthemimeral, hepthemimeral
Νυμφέων, αἳ ναίουσιν ἀνʼ οὔρεα βησσήεντα.	-- - --u u -uu ----	dactylic hexameter	feminine penthemimeral, trithemimeral
ἣ δὲ καὶ ἀτρύγετον πέλαγος τέκεν, οἴδματι θυῖον,	- u u -uu- uu- uu -uu --	dactylic hexameter	masculine penthemimeral, hepthemimeral
Πόντον, ἄτερ φιλότητος ἐφιμέρου· αὐτὰρ ἔπειτα	-u u- uu-u u-uu -u u--	dactylic hexameter	feminine penthemimeral, trithemimeral
Οὐρανῷ εὐνηθεῖσα τέκʼ Ὠκεανὸν βαθυδίνην,	-uu ---u u -uu- uu--	dactylic hexameter	feminine penthemimeral
Κοῖόν τε Κρῖόν θ᾽Ὑπερίονά τ᾽Ἰαπετόν τε	-- - -- uu-uu -uu- -	dactylic hexameter	masculine penthemimeral, trithemimeral
Θείαν τε Ῥείαν τε Θέμιν τε Μνημοσύνην τε	-- - -- u u- - -uu- -	dactylic hexameter	masculine penthemimeral, hepthemimeral, trithemimeral
Φοίβην τε χρυσοστέφανον Τηθύν τ᾽ἐρατεινήν.	-- - --uu- -- uu--	dactylic hexameter	hepthemimeral, trithemimeral
τοὺς δὲ μέθʼ ὁπλότατος γένετο Κρόνος ἀγκυλομήτης,	- u u -uu- uu- uu -uu--	dactylic hexameter	masculine penthemimeral, hepthemimeral
δεινότατος παίδων· θαλερὸν δ᾽ἤχθηρε τοκῆα.	-uu- -- uu- --u u--	dactylic hexameter	masculine penthemimeral, hepthemimeral, trithemimeral
γείνατο δ᾽αὖ Κύκλωπας ὑπέρβιον ἦτορ ἔχοντας,	-uu - --u u-uu -u u--	dactylic hexameter	feminine penthemimeral, trithemimeral
Βρόντην τε Στερόπην τε καὶ Ἄργην ὀβριμόθυμον,	-- - uu- u u -- -uu--	dactylic hexameter	masculine penthemimeral, trithemimeral
οἳ Ζηνὶ βροντήν τε δόσαν τεῦξάν τε κεραυνόν.	- -- -- u u- -- u u--	dactylic hexameter	masculine penthemimeral, hepthemimeral, trithemimeral
οἳ δή τοι τὰ μὲν ἄλλα θεοῖς ἐναλίγκιοι ἦσαν,	- - - u u -u u- uu-uu --	dactylic hexameter	feminine penthemimeral, hepthemimeral, trithemimeral
μοῦνος δ᾽ὀφθαλμὸς μέσσῳ ἐνέκειτο μετώπῳ.	-- --- -- uu-u u--	dactylic hexameter	masculine penthemimeral, hepthemimeral
Κύκλωπες δ᾽ὄνομʼ ἦσαν ἐπώνυμον, οὕνεκʼ ἄρα σφέων	--- uu -u u-uu -u u- -	dactylic hexameter	feminine penthemimeral, trithemimeral
κυκλοτερὴς ὀφθαλμὸς ἕεις ἐνέκειτο μετώπῳ·	-uu- --u u- uu-u u--	dactylic hexameter	feminine penthemimeral, hepthemimeral, trithemimeral
ἰσχὺς δ᾽ἠδὲ βίη καὶ μηχαναὶ ἦσαν ἐπʼ ἔργοις.	-- -u u- - -uu -u u --	dactylic hexameter	masculine penthemimeral
ἄλλοι δ᾽αὖ Γαίης τε καὶ Οὐρανοῦ ἐξεγένοντο	-- - -- u u -uu -uu--	dactylic hexameter	masculine penthemimeral, trithemimeral
τρεῖς παῖδες μεγάλοι τε καὶ ὄβριμοι, οὐκ ὀνομαστοί,	- -- uu- u u -uu - uu--	dactylic hexameter	masculine penthemimeral, trithemimeral
Κόττος τε Βριάρεώς τε Γύης θ᾽,ὑπερήφανα τέκνα.	-- - uu- u u- uu-uu --	dactylic hexameter	masculine penthemimeral, hepthemimeral, trithemimeral
τῶν ἑκατὸν μὲν χεῖρες ἀπʼ ὤμων ἀίσσοντο,	- uu- - -u u -- ----	dactylic hexameter	feminine penthemimeral, trithemimeral
ἄπλαστοι, κεφαλαὶ δὲ ἑκάστῳ πεντήκοντα	--- uu- u u-- ----	dactylic hexameter	masculine penthemimeral, trithemimeral
ἐξ ὤμων ἐπέφυκον ἐπὶ στιβαροῖσι μέλεσσιν·	- -- uu-u u- uu-u u--	dactylic hexameter	feminine penthemimeral, hepthemimeral, trithemimeral
ἰσχὺς δ᾽ἄπλητος κρατερὴ μεγάλῳ ἐπὶ εἴδει.	-- --- uu- uu- uu --	dactylic hexameter	masculine penthemimeral, hepthemimeral
ὅσσοι γὰρ Γαίης τε καὶ Οὐρανοῦ ἐξεγένοντο,	-- - -- u u -uu -uu--	dactylic hexameter	masculine penthemimeral, trithemimeral
δεινότατοι παίδων, σφετέρῳ δ᾽ἤχθοντο τοκῆι	-uu- -- uu- --u u--	dactylic hexameter	masculine penthemimeral, hepthemimeral, trithemimeral
ἐξ ἀρχῆς· καὶ τῶν μὲν ὅπως τις πρῶτα γένοιτο,	- -- - - u u- - -u u--	dactylic hexameter	masculine penthemimeral, hepthemimeral, trithemimeral
πάντας ἀποκρύπτασκε, καὶ ἐς φάος οὐκ ἀνίεσκε,	-u u---u u - uu - uu--	dactylic hexameter	feminine penthemimeral, hepthemimeral
Γαίης ἐν κευθμῶνι, κακῷ δ᾽ἐπετέρπετο ἔργῳ	-- - --u u- uu-uu --	dactylic hexameter	feminine penthemimeral, hepthemimeral, trithemimeral
Οὐρανός. ἣ δ᾽ἐντὸς στοναχίζετο Γαῖα πελώρη	-uu - -- uu-uu -u u--	dactylic hexameter	masculine penthemimeral, trithemimeral
στεινομένη· δολίην δὲ κακήν τ᾽ἐφράσσατο τέχνην.	-uu- uu- u u- --uu --	dactylic hexameter	masculine penthemimeral, hepthemimeral, trithemimeral
αἶψα δὲ ποιήσασα γένος πολιοῦ ἀδάμαντος	-u u ---u u- uu- uu--	dactylic hexameter	feminine penthemimeral, hepthemimeral
τεῦξε μέγα δρέπανον καὶ ἐπέφραδε παισὶ φίλοισιν·	-u u- uu- u u-uu -u u--	dactylic hexameter	masculine penthemimeral, trithemimeral
εἶπε δὲ θαρσύνουσα, φίλον τετιημένη ἦτορ·	-u u ---u u- uu-uu --	dactylic hexameter	feminine penthemimeral, hepthemimeral
παῖδες ἐμοὶ καὶ πατρὸς ἀτασθάλου, αἴ κʼἐθέλητε	-u u- - -u u-uu - uu--	dactylic hexameter	feminine penthemimeral, trithemimeral
πείθεσθαι, πατρός κε κακὴν τισαίμεθα λώβην	--- -- u u- --uu --	dactylic hexameter	masculine penthemimeral, hepthemimeral, trithemimeral
ὑμετέρου· πρότερος γὰρ ἀεικέα μήσατο ἔργα.	-uu- uu- u u-uu -uu --	dactylic hexameter	masculine penthemimeral, trithemimeral
ὣς φάτο· τοὺς δ᾽ἄρα πάντας ἕλεν δέος, οὐδέ τις αὐτῶν	- uu - uu -u u- uu -u u --	dactylic hexameter	feminine penthemimeral, hepthemimeral, trithemimeral
φθέγξατο. θαρσήσας δὲ μέγας Κρόνος ἀγκυλομήτης	-uu --- u u- uu -uu--	dactylic hexameter	masculine penthemimeral, hepthemimeral
ἂψ αὖτις μύθοισι προσηύδα μητέρα κεδνήν·	- -- --u u-- -uu --	dactylic hexameter	feminine penthemimeral, trithemimeral
μῆτερ, ἐγώ κεν τοῦτό γ᾽ὑποσχόμενος τελέσαιμι	-u u- - -u u-uu- uu--	dactylic hexameter	feminine penthemimeral, trithemimeral
ἔργον, ἐπεὶ πατρός γε δυσωνύμου οὐκ ἀλεγίζω	-u u- -- u u-uu - uu--	dactylic hexameter	masculine penthemimeral, trithemimeral
ἡμετέρου· πρότερος γὰρ ἀεικέα μήσατο ἔργα.	-uu- uu- u u-uu -uu --	dactylic hexameter	masculine penthemimeral, trithemimeral
ὣς φάτο· γήθησεν δὲ μέγα φρεσὶ Γαῖα πελώρη·	- uu --- u u- uu -u u--	dactylic hexameter	masculine penthemimeral, hepthemimeral
εἷσε δέ μιν κρύψασα λόχῳ· ἐνέθηκε δὲ χερσὶν	-u u - --u u- uu-u u --	dactylic hexameter	feminine penthemimeral, hepthemimeral, trithemimeral
ἅρπην καρχαρόδοντα· δόλον δ᾽ὑπεθήκατο πάντα.	-- -uu-u u- uu-uu --	dactylic hexameter	feminine penthemimeral, hepthemimeral
ἦλθε δὲ νύκτʼ ἐπάγων μέγας Οὐρανός, ἀμφὶ δὲ Γαίῃ	-u u - uu- uu -uu -u u --	dactylic hexameter	masculine penthemimeral, trithemimeral
ἱμείρων φιλότητος ἐπέσχετο καί ῥ᾽ἐτανύσθη	--- uu-u u-uu - uu--	dactylic hexameter	feminine penthemimeral, trithemimeral
πάντη· ὃ δ᾽ἐκ λοχέοιο πάις ὠρέξατο χειρὶ	-u u - uu-u u- --uu --	dactylic hexameter	feminine penthemimeral, hepthemimeral, trithemimeral
σκαιῇ, δεξιτερῇ δὲ πελώριον ἔλλαβεν ἅρπην	-- -uu- u u-uu -uu --	dactylic hexameter	masculine penthemimeral
μακρὴν καρχαρόδοντα, φίλου δ᾽ἀπὸ μήδεα πατρὸς	-- -uu-u u- uu -uu --	dactylic hexameter	feminine penthemimeral, hepthemimeral
ἐσσυμένως ἤμησε, πάλιν δ᾽ἔρριψε φέρεσθαι	-uu- --u u- --u u--	dactylic hexameter	feminine penthemimeral, hepthemimeral, trithemimeral
ἐξοπίσω· τὰ μὲν οὔ τι ἐτώσια ἔκφυγε χειρός·	-uu- u u - u u-uu -uu --	dactylic hexameter	masculine penthemimeral, trithemimeral
ὅσσαι γὰρ ῥαθάμιγγες ἀπέσσυθεν αἱματόεσσαι,	-- - uu-u u-uu -uu--	dactylic hexameter	feminine penthemimeral, trithemimeral
πάσας δέξατο Γαῖα· περιπλομένων δ᾽ἐνιαυτῶν	-- -uu -u u-uu- uu--	dactylic hexameter	feminine penthemimeral
γείνατʼ Ἐρινῦς τε κρατερὰς μεγάλους τε Γίγαντας,	-u u-- - uu- uu- u u--	dactylic hexameter	masculine penthemimeral, hepthemimeral
τεύχεσι λαμπομένους, δολίχʼ ἔγχεα χερσὶν ἔχοντας,	-uu -uu- uu -uu -u u--	dactylic hexameter	masculine penthemimeral
Νύμφας θ᾽ἃς Μελίας καλέουσʼ ἐπʼ ἀπείρονα γαῖαν.	-- - uu- uu- u u-uu --	dactylic hexameter	masculine penthemimeral, hepthemimeral, trithemimeral
μήδεα δ᾽ὡς τὸ πρῶτον ἀποτμήξας ἀδάμαντι	-uu - - -u u--- uu--	dactylic hexameter	feminine penthemimeral, trithemimeral
κάββαλʼ ἀπʼ ἠπείροιο πολυκλύστῳ ἐνὶ πόντῳ,	-u u ---u u--- uu --	dactylic hexameter	feminine penthemimeral
ὣς φέρετʼ ἂμ πέλαγος πουλὺν χρόνον, ἀμφὶ δὲ λευκὸς	- uu - uu- -- uu -u u --	dactylic hexameter	masculine penthemimeral, hepthemimeral, trithemimeral
ἀφρὸς ἀπʼ ἀθανάτου χροὸς ὤρνυτο· τῷ δ᾽ἔνι κούρη	-u u -uu- uu -uu - uu --	dactylic hexameter	masculine penthemimeral
ἐθρέφθη· πρῶτον δὲ Κυθήροισιν ζαθέοισιν	--- -- u u--- uu--	dactylic hexameter	masculine penthemimeral, trithemimeral
ἔπλητʼ, ἔνθεν ἔπειτα περίρρυτον ἵκετο Κύπρον.	-- -u u-u u-uu -uu --	dactylic hexameter	feminine penthemimeral
ἐκ δ᾽ἔβη αἰδοίη καλὴ θεός, ἀμφὶ δὲ ποίη	- uu --- -- uu -u u --	dactylic hexameter	masculine penthemimeral, hepthemimeral
ποσσὶν ὕπο ῥαδινοῖσιν ἀέξετο· τὴν δ᾽Ἀφροδίτην	-u u- uu-u u-uu - uu--	dactylic hexameter	feminine penthemimeral, trithemimeral
[ἀφρογενέα τε θεὰν καὶ ἐυστέφανον Κυθέρειαν	-uu- u u- u u-uu- uu--	dactylic hexameter	masculine penthemimeral, trithemimeral
κικλῄσκουσι θεοί τε καὶ ἀνέρες, οὕνεκʼ ἐν ἀφρῷ	---u u- u u -uu -u u --	dactylic hexameter	masculine penthemimeral
θρέφθη· ἀτὰρ Κυθέρειαν, ὅτι προσέκυρσε Κυθήροις·	-u u- uu-u u- uu-u u--	dactylic hexameter	feminine penthemimeral, hepthemimeral, trithemimeral
Κυπρογενέα δ᾽,ὅτι γέντο πολυκλύστῳ ἐνὶ Κύπρῳ·	-uu- uu -u u--- uu --	dactylic hexameter	feminine penthemimeral, trithemimeral
ἠδὲ φιλομμηδέα, ὅτι μηδέων ἐξεφαάνθη.	-u u--- uu -- -uu--	dactylic hexameter	masculine penthemimeral
τῇ δ᾽Ἔρος ὡμάρτησε καὶ Ἵμερος ἕσπετο καλὸς	- uu ---u u -uu -uu --	dactylic hexameter	feminine penthemimeral
γεινομένῃ τὰ πρῶτα θεῶν τ᾽ἐς φῦλον ἰούσῃ.	-uu- - -u u- - -u u--	dactylic hexameter	feminine penthemimeral, hepthemimeral, trithemimeral
ταύτην δ᾽ἐξ ἀρχῆς τιμὴν ἔχει ἠδὲ λέλογχε	-- - -- -- uu -u u--	dactylic hexameter	masculine penthemimeral, hepthemimeral, trithemimeral
μοῖραν ἐν ἀνθρώποισι καὶ ἀθανάτοισι θεοῖσι,	-u u ---u u -uu-u u--	dactylic hexameter	feminine penthemimeral
παρθενίους τ᾽ὀάρους μειδήματά τ᾽ἐξαπάτας τε	-uu- uu- --uu -uu- -	dactylic hexameter	masculine penthemimeral, trithemimeral
τέρψιν τε γλυκερὴν φιλότητά τε μειλιχίην τε.	-- - uu- uu-u u -uu- -	dactylic hexameter	masculine penthemimeral, trithemimeral
τοὺς δὲ πατὴρ Τιτῆνας ἐπίκλησιν καλέεσκε	- u u- --u u--- uu--	dactylic hexameter	feminine penthemimeral, trithemimeral
παῖδας νεικείων μέγας Οὐρανός, οὓς τέκεν αὐτός·	-- --- uu -uu - uu --	dactylic hexameter	masculine penthemimeral
φάσκε δὲ τιταίνοντας ἀτασθαλίῃ μέγα ῥέξαι	-u u ---u u-uu- uu --	dactylic hexameter	feminine penthemimeral
ἔργον, τοῖο δ᾽ἔπειτα τίσιν μετόπισθεν ἔσεσθαι.	-- -u u-u u- uu-u u--	dactylic hexameter	feminine penthemimeral, hepthemimeral
νὺξ δ᾽ἔτεκεν στυγερόν τε Μόρον καὶ Κῆρα μέλαιναν	- uu- uu- u u- - -u u--	dactylic hexameter	masculine penthemimeral, hepthemimeral, trithemimeral
καὶ Θάνατον, τέκε δ᾽Ὕπνον, ἔτικτε δὲ φῦλον Ὀνείρων·	- uu- uu -u u-u u -u u--	dactylic hexameter	feminine penthemimeral, trithemimeral
δεύτερον αὖ Μῶμον καὶ Ὀιζὺν ἀλγινόεσσαν	-uu - -- - -- -uu--	dactylic hexameter	masculine penthemimeral, trithemimeral
οὔ τινι κοιμηθεῖσα θεὰ τέκε Νὺξ ἐρεβεννή,	- uu ---u u- uu - uu--	dactylic hexameter	feminine penthemimeral, hepthemimeral
Ἑσπερίδας θ᾽,ᾗς μῆλα πέρην κλυτοῦ Ὠκεανοῖο	-uu- - -u u- uu -uu--	dactylic hexameter	feminine penthemimeral, hepthemimeral, trithemimeral
χρύσεα καλὰ μέλουσι φέροντά τε δένδρεα καρπόν.	-uu -u u-u u-u u -uu --	dactylic hexameter	feminine penthemimeral
καὶ Μοίρας καὶ Κῆρας ἐγείνατο νηλεοποίνους,	- -- - -u u-uu -uu--	dactylic hexameter	feminine penthemimeral, trithemimeral
Κλωθώ τε Λάχεσίν τε καὶ Ἄτροπον, αἵτε βροτοῖσι	-- - uu- u u -uu -u u--	dactylic hexameter	masculine penthemimeral, trithemimeral
γεινομένοισι διδοῦσιν ἔχειν ἀγαθόν τε κακόν τε,	-uu-u u-u u- uu- u u- -	dactylic hexameter	feminine penthemimeral, hepthemimeral
αἵτʼ ἀνδρῶν τε θεῶν τε παραιβασίας ἐφέπουσιν·	- -- u u- u u-uu- uu--	dactylic hexameter	masculine penthemimeral, trithemimeral
οὐδέ ποτε λήγουσι θεαὶ δεινοῖο χόλοιο,	-u u- --u u- --u u--	dactylic hexameter	feminine penthemimeral, hepthemimeral, trithemimeral
πρίν γ᾽ἀπὸ τῷ δώωσι κακὴν ὄπιν, ὅς τις ἁμάρτῃ.	- uu - --u u- uu - u u--	dactylic hexameter	feminine penthemimeral, hepthemimeral, trithemimeral
τίκτε δὲ καὶ Νέμεσιν, πῆμα θνητοῖσι βροτοῖσι,	-u u - uu- -- --u u--	dactylic hexameter	masculine penthemimeral, hepthemimeral, trithemimeral
Νὺξ ὀλοή· μετὰ τὴν δ᾽Ἀπάτην τέκε καὶ Φιλότητα	- uu- uu - uu- uu - uu--	dactylic hexameter	masculine penthemimeral, hepthemimeral, trithemimeral
Γῆράς τ᾽οὐλόμενον, καὶ Ἔριν τέκε καρτερόθυμον.	-- -uu- u u- uu -uu--	dactylic hexameter	masculine penthemimeral, hepthemimeral
αὐτὰρ Ἔρις στυγερὴ τέκε μὲν Πόνον ἀλγινόεντα	-u u- uu- uu - uu -uu--	dactylic hexameter	masculine penthemimeral, hepthemimeral, trithemimeral
Λήθην τε Λιμόν τε καὶ Ἄλγεα δακρυόεντα	-- - -- u u -uu -uu--	dactylic hexameter	masculine penthemimeral, trithemimeral
Ὑσμίνας τε Μάχας τε Φόνους τ᾽Ἀνδροκτασίας τε	--- u u- u u- --uu- -	dactylic hexameter	masculine penthemimeral, hepthemimeral, trithemimeral
Νείκεά τε ψευδέας τε Λόγους Ἀμφιλλογίας τε	-uu - -- u u- --uu- -	dactylic hexameter	masculine penthemimeral, hepthemimeral, trithemimeral
Δυσνομίην τ᾽Ἄτην τε, συνήθεας ἀλλήλῃσιν,	-uu- -- u u-uu ----	dactylic hexameter	masculine penthemimeral, trithemimeral
Ὅρκον θ᾽,ὃς δὴ πλεῖστον ἐπιχθονίους ἀνθρώπους	-- - - -u u-uu- ---	dactylic hexameter	feminine penthemimeral, trithemimeral
πημαίνει, ὅτε κέν τις ἑκὼν ἐπίορκον ὀμόσσῃ.	--- uu - u u- uu-u u--	dactylic hexameter	masculine penthemimeral, hepthemimeral, trithemimeral
Νηρέα δ᾽ἀψευδέα καὶ ἀληθέα γείνατο Πόντος,	-uu --- u u-uu -uu --	dactylic hexameter	masculine penthemimeral
πρεσβύτατον παίδων· αὐτὰρ καλέουσι γέροντα,	-uu- -- -- uu-u u--	dactylic hexameter	masculine penthemimeral, hepthemimeral, trithemimeral
οὕνεκα νημερτής τε καὶ ἤπιος, οὐδὲ θεμιστέων	-uu --- u u -uu -u u--	dactylic hexameter	masculine penthemimeral
λήθεται, ἀλλὰ δίκαια καὶ ἤπια δήνεα οἶδεν·	-uu -u u-u u -uu -uu --	dactylic hexameter	feminine penthemimeral
αὖτις δ᾽αὖ Θαύμαντα μέγαν καὶ ἀγήνορα Φόρκυν	-- - --u u- u u-uu --	dactylic hexameter	feminine penthemimeral, hepthemimeral, trithemimeral
Γαίῃ μισγόμενος καὶ Κητὼ καλλιπάρῃον	-- -uu- - -- -uu--	dactylic hexameter	masculine penthemimeral
Εὐρυβίην τ᾽ἀδάμαντος ἐνὶ φρεσὶ θυμὸν ἔχουσαν.	-uu- uu-u u- uu -u u--	dactylic hexameter	feminine penthemimeral, hepthemimeral, trithemimeral
Νηρῆος δ᾽ἐγένοντο μεγήρατα τέκνα θεάων	--- uu-u u-uu -u u--	dactylic hexameter	feminine penthemimeral, trithemimeral
πόντῳ ἐν ἀτρυγέτῳ καὶ Δωρίδος ἠυκόμοιο,	-u u -uu- - -uu -uu--	dactylic hexameter	masculine penthemimeral
κούρης Ὠκεανοῖο, τελήεντος ποταμοῖο,	-- -uu-u u--- uu--	dactylic hexameter	feminine penthemimeral
Πλωτώ τ᾽Εὐκράντη τε Σαώ τ᾽Ἀμφιτρίτη τε	-- --- u u- ---- -	dactylic hexameter	masculine penthemimeral, hepthemimeral
Εὐδώρη τε Θέτις τε Γαλήνη τε Γλαύκη τε	--- u u- u u-- - -- -	dactylic hexameter	masculine penthemimeral, trithemimeral
Κυμοθόη Σπειώ τε Θόη θ᾽Ἀλίη τ᾽ἐρόεσσα	-uu- -- u u- uu- uu--	dactylic hexameter	masculine penthemimeral, hepthemimeral, trithemimeral
Πασιθέη τ᾽Ἐρατώ τε καὶ Εὐνίκη ῥοδόπηχυς	-uu- uu- u u --- uu--	dactylic hexameter	masculine penthemimeral, trithemimeral
καὶ Μελίτη χαρίεσσα καὶ Εὐλιμένη καὶ Ἀγαυὴ	- uu- uu-u u -uu- u u--	dactylic hexameter	feminine penthemimeral, trithemimeral
Δωτώ τε Πρωτώ τε Φέρουσά τε Δυναμένη τε	-- - -- u u-u u -uu- -	dactylic hexameter	masculine penthemimeral, trithemimeral
Νησαίη τε καὶ Ἀκταίη καὶ Πρωτομέδεια	--- u u --- - -uu--	dactylic hexameter	hepthemimeral, trithemimeral
Δωρὶς καὶ Πανόπεια καὶ εὐειδὴς Γαλάτεια	-- - uu-u u --- uu--	dactylic hexameter	feminine penthemimeral, trithemimeral
Ἱπποθόη τ᾽ἐρόεσσα καὶ Ἱππονόη ῥοδόπηχυς	-uu- uu-u u -uu- uu--	dactylic hexameter	feminine penthemimeral, trithemimeral
Κυμοδόκη θ᾽,ἣ κύματʼ ἐν ἠεροειδέι πόντῳ	-uu- - -u u -uu-uu --	dactylic hexameter	feminine penthemimeral, trithemimeral
πνοιάς τε ζαέων ἀνέμων σὺν Κυματολήγῃ	-- - uu- uu- - -uu--	dactylic hexameter	masculine penthemimeral, hepthemimeral, trithemimeral
ῥεῖα πρηΰνει καὶ ἐυσφύρῳ Ἀμφιτρίτῃ,	-- --- u u-uu ----	dactylic hexameter	masculine penthemimeral
Κυμώ τ᾽Ἠιόνη τε ἐυστέφανός θ᾽Ἁλιμήδη	-- -uu- u u-uu- uu--	dactylic hexameter	masculine penthemimeral
Γλαυκονόμη τε φιλομμειδὴς καὶ Ποντοπόρεια	-uu- u u--- - -uu--	dactylic hexameter	hepthemimeral, trithemimeral
Ληαγόρη τε καὶ Εὐαγόρη καὶ Λαομέδεια	-uu- u u -uu- - -uu--	dactylic hexameter	hepthemimeral, trithemimeral
Πουλυνόη τε καὶ Αὐτονόη καὶ Λυσιάνασσα	-uu- u u -uu- - -uu--	dactylic hexameter	hepthemimeral, trithemimeral
Εὐάρνη τε φυήν τ᾽ἐρατὴ καὶ εἶδος ἄμωμος	--- u u- uu- - -u u--	dactylic hexameter	masculine penthemimeral, hepthemimeral, trithemimeral
καὶ Ψαμάθη χαρίεσσα δέμας δίη τε Μενίππη	- uu- uu-u u- -- u u--	dactylic hexameter	feminine penthemimeral, hepthemimeral, trithemimeral
Νησώ τ᾽Εὐπόμπη τε Θεμιστώ τε Προνόη τε	-- --- u u-- - uu- -	dactylic hexameter	masculine penthemimeral
Νημερτής θ᾽,ἣ πατρὸς ἔχει νόον ἀθανάτοιο.	--- - -u u- uu -uu--	dactylic hexameter	feminine penthemimeral, hepthemimeral, trithemimeral
αὗται μὲν Νηρῆος ἀμύμονος ἐξεγένοντο	-- - --u u-uu -uu--	dactylic hexameter	feminine penthemimeral, trithemimeral
κοῦραι πεντήκοντα, ἀμύμονα ἔργα ἰδυῖαι.	-- ---u u-uu -u u--	dactylic hexameter	feminine penthemimeral
Θαύμας δ᾽Ὠκεανοῖο βαθυρρείταο θύγατρα	-- -uu-u u---u u--	dactylic hexameter	feminine penthemimeral
ἠγάγετʼ Ἠλέκτρην· ἣ δ᾽ὠκεῖαν τέκεν Ἶριν	-uu --- - --- uu --	dactylic hexameter	masculine penthemimeral
ἠυκόμους θ᾽Ἁρπυίας Ἀελλώ τ᾽Ὠκυπέτην τε,	-uu- --u u-- -uu- -	dactylic hexameter	feminine penthemimeral, trithemimeral
αἵ ῥ᾽ἀνέμων πνοιῇσι καὶ οἰωνοῖς ἅμʼ ἕπονται	- uu- --u u --- u u--	dactylic hexameter	feminine penthemimeral, trithemimeral
ὠκείῃς πτερύγεσσι· μεταχρόνιαι γὰρ ἴαλλον.	--- uu-u u-uu- u u--	dactylic hexameter	feminine penthemimeral, trithemimeral
Φόρκυϊ δ᾽αὖ Κητὼ Γραίας τέκε καλλιπαρῄους	-uu - -- -- uu -uu--	dactylic hexameter	masculine penthemimeral, hepthemimeral, trithemimeral
ἐκ γενετῆς πολιάς, τὰς δὴ Γραίας καλέουσιν	- uu- uu- - - -- uu--	dactylic hexameter	masculine penthemimeral, hepthemimeral, trithemimeral
ἀθάνατοί τε θεοὶ χαμαὶ ἐρχόμενοί τ᾽ἄνθρωποι,	-uu- u u- uu -uu- ---	dactylic hexameter	masculine penthemimeral, trithemimeral
Πεμφρηδώ τ᾽ἐύπεπλον Ἐνυώ τε κροκόπεπλον,	--- uu-u u-- - uu--	dactylic hexameter	feminine penthemimeral, trithemimeral
Γοργούς θ᾽,αἳ ναίουσι πέρην κλυτοῦ Ὠκεανοῖο	-- - --u u- uu -uu--	dactylic hexameter	feminine penthemimeral, hepthemimeral, trithemimeral
ἐσχατιῇ πρὸς Νυκτός, ἵνʼ Ἑσπερίδες λιγύφωνοι,	-uu- - -u u -uu- uu--	dactylic hexameter	feminine penthemimeral, trithemimeral
Σθεννώ τ᾽Εὐρυάλη τε Μέδουσά τε λυγρὰ παθοῦσα.	-- -uu- u u-u u -u u--	dactylic hexameter	masculine penthemimeral
ἣ μὲν ἔην θνητή, αἳ δ᾽ἀθάνατοι καὶ ἀγήρῳ,	- u u- -- - -uu- u u--	dactylic hexameter	masculine penthemimeral, trithemimeral
αἱ δύο· τῇ δὲ μιῇ παρελέξατο Κυανοχαίτης	- uu - u u- uu-uu -uu--	dactylic hexameter	masculine penthemimeral, trithemimeral
ἐν μαλακῷ λειμῶνι καὶ ἄνθεσιν εἰαρινοῖσιν.	- uu- --u u -uu -uu--	dactylic hexameter	feminine penthemimeral, trithemimeral
τῆς δ᾽ὅτε δὴ Περσεὺς κεφαλὴν ἀπεδειροτόμησεν,	- uu - -- uu- uu-uu--	dactylic hexameter	masculine penthemimeral, hepthemimeral, trithemimeral
ἔκθορε Χρυσαωρ τε μέγας καὶ Πήγασος ἵππος.	--- uu- u u- - -uu --	dactylic hexameter	masculine penthemimeral, hepthemimeral, trithemimeral
τῷ μὲν ἐπώνυμον ἦεν, ὅτʼ Ὠκεανοῦ περὶ πηγὰς	- u u-uu -u u -uu- uu --	dactylic hexameter	feminine penthemimeral
γένθʼ, ὃ δ᾽ἄορ χρύσειον ἔχων μετὰ χερσὶ φίλῃσιν.	- u u- --u u- uu -u u--	dactylic hexameter	feminine penthemimeral, hepthemimeral, trithemimeral
χὠ μὲν ἀποπτάμενος προλιπὼν χθόνα, μητέρα μήλων,	- u u-uu- uu- uu -uu --	dactylic hexameter	masculine penthemimeral, hepthemimeral
ἵκετʼ ἐς ἀθανάτους· Ζηνὸς δ᾽ἐν δώμασι ναίει	-u u -uu- -- - -uu --	dactylic hexameter	masculine penthemimeral, hepthemimeral
βροντήν τε στεροπήν τε φέρων Διὶ μητιόεντι.	-- - uu- u u- uu -uu--	dactylic hexameter	masculine penthemimeral, hepthemimeral, trithemimeral
Χρυσάωρ δ᾽ἔτεκεν τρικέφαλον Γηρυονῆα	--- uu- uu-- -uu--	dactylic hexameter	masculine penthemimeral, trithemimeral
μιχθεὶς Καλλιρόῃ κούρῃ κλυτοῦ Ὠκεανοῖο.	-- -uu- -- uu -uu--	dactylic hexameter	masculine penthemimeral, hepthemimeral
τὸν μὲν ἄρʼ ἐξενάριξε βίη Ἡρακληείη	- u u -uu-u u- -----	dactylic hexameter	feminine penthemimeral, hepthemimeral
βουσὶ παρʼ εἰλιπόδεσσι περιρρύτῳ εἰν Ἐρυθείῃ	-u u -uu-u u-uu - uu--	dactylic hexameter	feminine penthemimeral
ἤματι τῷ ὅτε περ βοῦς ἤλασεν εὐρυμετώπους	-uu - uu - - -uu -uu--	dactylic hexameter	masculine penthemimeral, trithemimeral
Τίρυνθʼ εἰς ἱερὴν διαβὰς πόρον Ὠκεανοῖο	-- - uu- uu- uu -uu--	dactylic hexameter	masculine penthemimeral, hepthemimeral, trithemimeral
Ὄρθον τε κτείνας καὶ βουκόλον Εὐρυτίωνα	-- - -- - -uu -uu--	dactylic hexameter	masculine penthemimeral, trithemimeral
σταθμῷ ἐν ἠερόεντι πέρην κλυτοῦ Ὠκεανοῖο.	-u u -uu-u u- uu -uu--	dactylic hexameter	feminine penthemimeral, hepthemimeral
ἣ δ᾽ἔτεκʼ ἄλλο πέλωρον ἀμήχανον, οὐδὲν ἐοικὸς	- uu -u u-u u-uu -u u--	dactylic hexameter	feminine penthemimeral
θνητοῖς ἀνθρώποις οὐδʼ ἀθανάτοισι θεοῖσιν,	-- --- - -uu-u u--	dactylic hexameter	masculine penthemimeral
σπῆι ἔνι γλαφυρῷ θείην κρατερόφρονʼ Ἔχιδναν,	-u u- uu- -- uu-u u--	dactylic hexameter	masculine penthemimeral, hepthemimeral, trithemimeral
ἥμισυ μὲν νύμφην ἑλικώπιδα καλλιπάρῃον,	-uu - -- uu-uu -uu--	dactylic hexameter	masculine penthemimeral, trithemimeral
ἥμισυ δ᾽αὖτε πέλωρον ὄφιν δεινόν τε μέγαν τε	-uu -u u-u u- -- u u- -	dactylic hexameter	feminine penthemimeral, hepthemimeral
αἰόλον ὠμηστὴν ζαθέης ὑπὸ κεύθεσι γαίης.	-uu --- uu- uu -uu --	dactylic hexameter	masculine penthemimeral, hepthemimeral
ἔνθα δέ οἱ σπέος ἐστὶ κάτω κοίλῃ ὑπὸ πέτρῃ	-u u - uu -u u- -- uu --	dactylic hexameter	feminine penthemimeral, hepthemimeral, trithemimeral
τηλοῦ ἀπʼ ἀθανάτων τε θεῶν θνητῶν τ᾽ἀνθρώπων·	-u u -uu- u u- -- ---	dactylic hexameter	masculine penthemimeral, hepthemimeral
ἔνθʼ ἄρα οἱ δάσσαντο θεοὶ κλυτὰ δώματα ναίειν.	- uu - --u u- uu -uu --	dactylic hexameter	feminine penthemimeral, hepthemimeral, trithemimeral
ἣ δ᾽ἔρυτʼ εἰν Ἀρίμοισιν ὑπὸ χθονὶ λυγρὴ Ἔχιδνα,	- uu - uu-u u- uu -u u--	dactylic hexameter	feminine penthemimeral, hepthemimeral, trithemimeral
ἀθάνατος νύμφη καὶ ἀγήραος ἤματα πάντα.	-uu- -- u u-uu -uu --	dactylic hexameter	masculine penthemimeral, trithemimeral
τῇ δὲ Τυφάονά φασι μιγήμεναι ἐν φιλότητι	- u u-uu -u u-uu - uu--	dactylic hexameter	feminine penthemimeral
δεινόν θ᾽ὑβριστήν τ᾽ἄνομόν θ᾽ἑλικώπιδι κούρῃ·	-- --- uu- uu-uu --	dactylic hexameter	masculine penthemimeral, hepthemimeral
ἣ δ᾽ὑποκυσαμένη τέκετο κρατερόφρονα τέκνα.	- uu-uu- uu- uu-uu --	dactylic hexameter	masculine penthemimeral, hepthemimeral
Ὄρθον μὲν πρῶτον κύνα γείνατο Γηρυονῆι·	-- - -- uu -uu -uu--	dactylic hexameter	masculine penthemimeral, trithemimeral
δεύτερον αὖτις ἔτικτεν ἀμήχανον, οὔ τι φατειὸν	-uu -u u-u u-uu - u u--	dactylic hexameter	feminine penthemimeral
Κέρβερον ὠμηστήν, Ἀίδεω κύνα χαλκεόφωνον,	-uu --- uu- uu -uu--	dactylic hexameter	masculine penthemimeral, hepthemimeral
πεντηκοντακέφαλον, ἀναιδέα τε κρατερόν τε·	---uu-u u-uu - uu- -	dactylic hexameter	feminine penthemimeral
τὸ τρίτον Ὕδρην αὖτις ἐγείνατο λυγρὰ ἰδυῖαν	- uu -- -u u-uu -u u--	dactylic hexameter	feminine penthemimeral
Λερναίην, ἣν θρέψε θεὰ λευκώλενος Ἥρη	--- - -u u- --uu --	dactylic hexameter	feminine penthemimeral, hepthemimeral, trithemimeral
ἄπλητον κοτέουσα βίῃ Ἡρακληείῃ.	--- uu-u u- -----	dactylic hexameter	feminine penthemimeral, hepthemimeral, trithemimeral
καὶ τὴν μὲν Διὸς υἱὸς ἐνήρατο νηλέι χαλκῷ	- - - uu -u u-uu -uu --	dactylic hexameter	feminine penthemimeral, trithemimeral
Ἀμφιτρυωνιάδης σὺν ἀρηιφίλῳ Ἰολάῳ	-uu-uu- u u-uu- uu--	dactylic hexameter	masculine penthemimeral
Ηρακλέης βουλῇσιν Ἀθηναίης ἀγελείης.	-uu- --u u--- uu--	dactylic hexameter	feminine penthemimeral, trithemimeral
ἣ δὲ Χίμαιραν ἔτικτε πνέουσαν ἀμαιμάκετον πῦρ,	- u u-u u-u u-u u-uu- -	dactylic hexameter	feminine penthemimeral
δεινήν τε μεγάλην τε ποδώκεά τε κρατερήν τε·	-- - uu- u u-uu - uu- -	dactylic hexameter	masculine penthemimeral, trithemimeral
τῆς δ᾽ἦν τρεῖς κεφαλαί· μία μὲν χαροποῖο λέοντος,	- - - uu- uu - uu-u u--	dactylic hexameter	masculine penthemimeral, hepthemimeral, trithemimeral
ἣ δὲ χιμαίρης, ἣ δ᾽ὄφιος, κρατεροῖο δράκοντος,	- u u-- - uu- uu-u u--	dactylic hexameter	masculine penthemimeral, hepthemimeral
[πρόσθε λέων, ὄπιθεν δὲ δράκων, μέσση δὲ χίμαιρα,	-u u- uu- u u- -- u u--	dactylic hexameter	masculine penthemimeral, hepthemimeral, trithemimeral
[δεινὸν ἀποπνείουσα πυρὸς μένος αἰθομένοιο.	-u u---u u- uu -uu--	dactylic hexameter	feminine penthemimeral, hepthemimeral
τὴν μὲν Πήγασος εἷλε καὶ ἐσθλὸς Βελλεροφόντης.	- - -uu -u u -- -uu--	dactylic hexameter	feminine penthemimeral
ἣ δ᾽ἄρα Φῖκʼ ὀλοὴν τέκε Καδμείοισιν ὄλεθρον	- uu - uu- uu ---u u--	dactylic hexameter	masculine penthemimeral, trithemimeral
Ὅρθῳ ὑποδμηθεῖσα Νεμειαῖόν τε λέοντα,	-u u---u u--- u u--	dactylic hexameter	feminine penthemimeral
τόν ῥ᾽Ἥρη θρέψασα Διὸς κυδρὴ παράκοιτις	- -- --u u- -- uu--	dactylic hexameter	feminine penthemimeral, hepthemimeral, trithemimeral
γουνοῖσιν κατένασσε Νεμείης, πῆμʼ ἀνθρώποις.	--- uu-u u-- - ---	dactylic hexameter	feminine penthemimeral, trithemimeral
ἔνθʼ ἄρʼ ὃ οἰκείων ἐλεφαίρετο φῦλʼ ἀνθρώπων,	- u u --- uu-uu - ---	dactylic hexameter	masculine penthemimeral
κοιρανέων Τρητοῖο Νεμείης ἠδʼ Ἀπέσαντος·	-uu- --u u-- - uu--	dactylic hexameter	feminine penthemimeral, trithemimeral
ἀλλά ἑ ἲς ἐδάμασσε βίης Ἡρακληείης.	-u u - uu-u u- -----	dactylic hexameter	feminine penthemimeral, hepthemimeral, trithemimeral
Κητὼ δ᾽ὁπλότατον Φόρκυι φιλότητι μιγεῖσα	-- -uu- -- uu-u u--	dactylic hexameter	masculine penthemimeral, hepthemimeral
γείνατο δεινὸν ὄφιν, ὃς ἐρεμνῆς κεύθεσι γαίης	-uu -u u- u u-- -uu --	dactylic hexameter	masculine penthemimeral
πείρασιν ἐν μεγάλοις παγχρύσεα μῆλα φυλάσσει.	-uu - uu- --uu -u u--	dactylic hexameter	masculine penthemimeral, trithemimeral
τοῦτο μὲν ἐκ Κητοῦς καὶ Φόρκυνος γένος ἐστίν.	-u u - -- - --- uu --	dactylic hexameter	masculine penthemimeral, trithemimeral
Τηθὺς δ᾽Ὠκεανῷ Ποταμοὺς τέκε δινήεντας,	-- -uu- uu- uu ----	dactylic hexameter	masculine penthemimeral, hepthemimeral
Νεῖλόν τ᾽Ἀλφειόν τε καὶ Ἠριδανὸν βαθυδίνην	-- --- u u -uu- uu--	dactylic hexameter	masculine penthemimeral
Στρυμόνα Μαίανδρόν τε καὶ Ἴστρον καλλιρέεθρον	-uu --- u u -- -uu--	dactylic hexameter	masculine penthemimeral
Φᾶσίν τε Ῥῆσόν τ᾽Ἀχελώιόν τ᾽ἀργυροδίνην	-- - -- uu-uu -uu--	dactylic hexameter	masculine penthemimeral, trithemimeral
Νέσσον τε Ῥοδίον θ᾽Ἁλιάκμονά θ᾽Ἑπτάπορόν τε	-- - uu- uu-uu -uu- -	dactylic hexameter	masculine penthemimeral, trithemimeral
Γρήνικόν τε καὶ Αἴσηπον θεῖόν τε Σιμοῦντα	--- u u --- -- u u--	dactylic hexameter	hepthemimeral, trithemimeral
Πηνειόν τε καὶ Ἕρμον ἐυρρείτην τε Κάικον	--- u u -u u--- u u--	dactylic hexameter	feminine penthemimeral, trithemimeral
Σαγγάριόν τε μέγαν Λάδωνά τε Παρθένιόν τε	-uu- u u- --u u -uu- -	dactylic hexameter	masculine penthemimeral, trithemimeral
Εὔηνόν τε καὶ Ἄρδησκον θεῖόν τε Σκάμανδρον.	--- u u --- -- u u--	dactylic hexameter	hepthemimeral, trithemimeral
τίκτε δὲ θυγατέρων ἱερὸν γένος, αἳ κατὰ γαῖαν	-u u -uu- uu- uu - uu --	dactylic hexameter	masculine penthemimeral, hepthemimeral
ἄνδρας κουρίζουσι σὺν Ἀπόλλωνι ἄνακτι	-- ---u u ---u u--	dactylic hexameter	feminine penthemimeral
καὶ Ποταμοῖς, ταύτην δὲ Διὸς πάρα μοῖραν ἔχουσι,	- uu- -- u u- uu -u u--	dactylic hexameter	masculine penthemimeral, hepthemimeral, trithemimeral
Πειθώ τ᾽Ἀδμήτη τε Ἰάνθη τ᾽Ἠλέκτρη τε	-- --- u u-- --- -	dactylic hexameter	masculine penthemimeral
Δωρίς τε Πρυμνώ τε καὶ Οὐρανίη θεοειδὴς	-- - -- u u -uu- uu--	dactylic hexameter	masculine penthemimeral, trithemimeral
Ἱππώ τε Κλυμένη τε Ῥόδειά τε Καλλιρόη τε	-- - uu- u u-u u -uu- -	dactylic hexameter	masculine penthemimeral, trithemimeral
Ζευξώ τε Κλυτίη τε Ἰδυῖά τε Πασιθόη τε	-- - uu- u u-u u -uu- -	dactylic hexameter	masculine penthemimeral, trithemimeral
Πληξαύρη τε Γαλαξαύρη τ᾽ἐρατή τε Διώνη	--- u u--- uu- u u--	dactylic hexameter	hepthemimeral, trithemimeral
Μηλόβοσίς τε Φόη τε καὶ εὐειδὴς Πολυδώρη	-uu- u u- u u --- uu--	dactylic hexameter	masculine penthemimeral, trithemimeral
Κερκηίς τε φυὴν ἐρατὴ Πλουτώ τε βοῶπις	--- u u- uu- -- u u--	dactylic hexameter	masculine penthemimeral, hepthemimeral, trithemimeral
Περσηίς τ᾽Ἰάνειρά τ᾽Ἀκάστη τε Ξάνθη τε	--- uu-u u-- - -- -	dactylic hexameter	feminine penthemimeral, trithemimeral
Πετραίη τ᾽ἐρόεσσα Μενεσθώ τ᾽Εὐρώπη τε	--- uu-u u-- --- -	dactylic hexameter	feminine penthemimeral, trithemimeral
Μῆτίς τ᾽Εὐρυνόμη τε Τελεστώ τε Κροκοπεπλος	-- -uu- u u-- - uu--	dactylic hexameter	masculine penthemimeral
Χρυσηίς τ᾽Ἀσίη τε καὶ ἱμερόεσσα Καλυψὼ	--- uu- u u -uu-u u--	dactylic hexameter	masculine penthemimeral, trithemimeral
Εὐδώρη τε Τύχη τε καὶ Ἀμφιρὼ Ὠκυρόη τε	--- u u- u u -uu -uu- -	dactylic hexameter	masculine penthemimeral, trithemimeral
καὶ Στύξ, ἣ δή σφεων προφερεστάτη ἐστὶν ἁπασέων.	- - - - - uu-uu -u u--	dactylic hexameter	masculine penthemimeral, trithemimeral
αὗται δ᾽Ὠκεανοῦ καὶ Τηθύος ἐξεγένοντο	-- -uu- - -uu -uu--	dactylic hexameter	masculine penthemimeral
πρεσβύταται κοῦραι· πολλαί γε μέν εἰσι καὶ ἄλλαι.	-uu- -- -- u u -u u --	dactylic hexameter	masculine penthemimeral, hepthemimeral, trithemimeral
τρὶς γὰρ χίλιαί εἰσι τανύσφυροι Ὠκεανῖναι,	- - -uu -u u-uu -uu--	dactylic hexameter	feminine penthemimeral
αἵ ῥα πολυσπερέες γαῖαν καὶ βένθεα λίμνης	- u u-uu- -- - -uu --	dactylic hexameter	masculine penthemimeral, hepthemimeral
πάντη ὁμῶς ἐφέπουσι, θεάων ἀγλαὰ τέκνα.	-u u- uu-u u-- -uu --	dactylic hexameter	feminine penthemimeral, trithemimeral
τόσσοι δ᾽αὖθʼ ἕτεροι ποταμοὶ καναχηδὰ ῥέοντες,	-- - uu- uu- uu-u u--	dactylic hexameter	masculine penthemimeral, hepthemimeral, trithemimeral
υἱέες Ὠκεανοῦ, τοὺς γείνατο πότνια Τηθύς·	-uu -uu- - -uu -uu --	dactylic hexameter	masculine penthemimeral
τῶν ὄνομʼ ἀργαλέον πάντων βροτὸν ἀνέρʼ ἐνισπεῖν,	- uu -uu- -- uu -u u--	dactylic hexameter	masculine penthemimeral, hepthemimeral
οἳ δὲ ἕκαστοι ἴσασιν, ὅσοι περιναιετάωσιν.	- u u-u u-u u- uu-uu--	dactylic hexameter	feminine penthemimeral, hepthemimeral
θεία δ᾽Ἠέλιόν τε μέγαν λαμπράν τε Σελήνην	-- -uu- u u- -- u u--	dactylic hexameter	masculine penthemimeral, hepthemimeral
Ἠῶ θ᾽,ἣ πάντεσσιν ἐπιχθονίοισι φαείνει	-- - --u u-uu-u u--	dactylic hexameter	feminine penthemimeral, trithemimeral
ἀθανάτοις τε θεοῖσι, τοὶ οὐρανὸν εὐρὺν ἔχουσι,	-uu- u u-u u -uu -u u--	dactylic hexameter	feminine penthemimeral, trithemimeral
γείναθʼ ὑποδμηθεῖσʼ Ὑπερίονος ἐν φιλότητι.	-u u--- uu-uu - uu--	dactylic hexameter	masculine penthemimeral
Κρίῳ δ᾽Εὐρυβίν τέκεν ἐν φιλότητι μιγεῖσα	-- --- uu - uu-u u--	dactylic hexameter	masculine penthemimeral, hepthemimeral
Ἀστραῖόν τε μέγαν Πάλλαντά τε δῖα θεάων	--- u u- --u u -u u--	dactylic hexameter	masculine penthemimeral, trithemimeral
Πέρσην θ᾽,ὃς καὶ πᾶσι μετέπρεπεν ἰδμοσύνῃσιν.	-- - - -u u-uu -uu--	dactylic hexameter	feminine penthemimeral, trithemimeral
Ἀστραίῳ δ᾽Ἠὼς ἀνέμους τέκε καρτεροθύμους,	--- -- uu- uu -uu--	dactylic hexameter	masculine penthemimeral, hepthemimeral, trithemimeral
ἀργέστην Ζέφυρον Βορέην τ᾽αἰψηροκέλευθον	--- uu- uu- --uu--	dactylic hexameter	masculine penthemimeral, hepthemimeral, trithemimeral
καὶ Νότον, ἐν φιλότητι θεὰ θεῷ εὐνηθεῖσα.	- uu - uu-u u- uu ----	dactylic hexameter	feminine penthemimeral, hepthemimeral, trithemimeral
τοὺς δὲ μέτʼ ἀστέρα τίκτεν Ἑωσφόρον Ἠριγένεια	- u u -uu -u u-uu -uu--	dactylic hexameter	feminine penthemimeral
ἄστρα τε λαμπετόωντα, τά τ᾽οὐρανὸς ἐστεφάνωται.	-u u -uu-u u -uu -uu--	dactylic hexameter	feminine penthemimeral
Στὺξ δ᾽ἔτεκʼ Ὠκεανοῦ θυγάτηρ Πάλλαντι μιγεῖσα	- uu -uu- uu- --u u--	dactylic hexameter	masculine penthemimeral, hepthemimeral
Ζῆλον καὶ Νίκην καλλίσφυρον ἐν μεγάροισιν·	-- - -- --uu - uu--	dactylic hexameter	masculine penthemimeral, trithemimeral
καὶ Κράτος ἠδὲ Βίην ἀριδείκετα γείνατο τέκνα,	- uu -u u- uu-uu -uu --	dactylic hexameter	masculine penthemimeral
τῶν οὐκ ἔστʼ ἀπάνευθε Διὸς δόμος, οὐδέ τις ἕδρη,	- - - uu-u u- uu -u u --	dactylic hexameter	feminine penthemimeral, hepthemimeral, trithemimeral
οὐδʼ ὁδός, ὅππη μὴ κείνοις θεὸς ἡγεμονεύῃ,	- uu -- - -- uu -uu--	dactylic hexameter	masculine penthemimeral, hepthemimeral
ἀλλʼ αἰεὶ πὰρ Ζηνὶ βαρυκτύπῳ ἑδριόωνται.	- -- - -u u-uu -uu--	dactylic hexameter	feminine penthemimeral, trithemimeral
ὣς γὰρ ἐβούλευσεν Στὺξ ἄφθιτος Ὠκεανίνη	- u u--- - -uu -uu--	dactylic hexameter	masculine penthemimeral
ἤματι τῷ, ὅτε πάντας Ὀλύμπιος ἀστεροπητὴς	-uu - uu -u u-uu -uu--	dactylic hexameter	feminine penthemimeral, trithemimeral
ἀθανάτους ἐκάλεσσε θεοὺς ἐς μακρὸν Ὄλυμπον,	-uu- uu-u u- - -u u--	dactylic hexameter	feminine penthemimeral, hepthemimeral, trithemimeral
εἶπε δ᾽,ὃς ἂν μετὰ εἷο θεῶν Τιτῆσι μάχοιτο,	-u u - uu -u u- --u u--	dactylic hexameter	feminine penthemimeral, hepthemimeral, trithemimeral
μή τινʼ ἀπορραίσειν γεράων, τιμὴν δὲ ἕκαστον	- u u--- uu- -- u u--	dactylic hexameter	masculine penthemimeral, hepthemimeral
ἑξέμεν, ἣν τὸ πάρος γε μετʼ ἀθανάτοισι θεοῖσιν	-uu - u u- u u -uu-u u--	dactylic hexameter	masculine penthemimeral, trithemimeral
τὸν δ᾽ἔφαθʼ, ὅστις ἄτιμος ὑπὸ Κρόνου ἠδʼ ἀγέραστος,	- uu -u u-u u- uu - uu--	dactylic hexameter	feminine penthemimeral, hepthemimeral
τιμῆς καὶ γεράων ἐπιβησέμεν, ἧ θέμις ἐστίν.	-- - uu- uu-uu - uu --	dactylic hexameter	masculine penthemimeral, trithemimeral
ἦλθε δ᾽ἄρα πρώτη Στὺξ ἄφθιτος Οὔλυμπόνδε	-u u- -- - -uu ----	dactylic hexameter	masculine penthemimeral, trithemimeral
σὺν σφοῖσιν παίδεσσι φίλου διὰ μήδεα πατρός.	- -- --u u- uu -uu --	dactylic hexameter	feminine penthemimeral, hepthemimeral, trithemimeral
τὴν δὲ Ζεὺς τίμησε, περισσὰ δὲ δῶρα δέδωκεν.	- - - --u u-u u -u u--	dactylic hexameter	feminine penthemimeral, trithemimeral
αὐτὴν μὲν γὰρ ἔθηκε θεῶν μέγαν ἔμμεναι ὅρκον,	-- - u u-u u- uu -uu --	dactylic hexameter	feminine penthemimeral, hepthemimeral, trithemimeral
παῖδας δ᾽ἤματα πάντα ἑοῦ μεταναιέτας εἶναι.	-- -uu -u u- uu-uu --	dactylic hexameter	feminine penthemimeral, hepthemimeral
ὣς δ᾽αὔτως πάντεσσι διαμπερές, ὥς περ ὑπέστη,	- -- --u u-uu - u u--	dactylic hexameter	feminine penthemimeral, trithemimeral
ἐξετέλεσσʼ· αὐτὸς δὲ μέγα κρατεῖ ἠδὲ ἀνάσσει.	-uu- -- u u- uu -u u--	dactylic hexameter	masculine penthemimeral, hepthemimeral, trithemimeral
φοίβη δ᾽αὖ Κοίου πολυήρατον ἦλθεν ἐς εὐνήν·	-- - -- uu-uu -u u --	dactylic hexameter	masculine penthemimeral, trithemimeral
κυσαμένη δὴ ἔπειτα θεὰ θεοῦ ἐν φιλότητι	-uu- u u-u u- uu - uu--	dactylic hexameter	feminine penthemimeral, hepthemimeral, trithemimeral
Λητὼ κυανόπεπλον ἐγείνατο, μείλιχον αἰεί,	-- -uu-u u-uu -uu --	dactylic hexameter	feminine penthemimeral
ἤπιον ἀνθρώποισι καὶ ἀθανάτοισι θεοῖσιν,	-uu ---u u -uu-u u--	dactylic hexameter	feminine penthemimeral
μείλιχον ἐξ ἀρχῆς, ἀγανώτατον ἐντὸς Ὀλύμπου.	-uu - -- uu-uu -u u--	dactylic hexameter	masculine penthemimeral, trithemimeral
γείνατο δ᾽Ἀστερίην ἐυώνυμον, ἥν ποτε Πέρσης	-uu -uu- uu-uu - uu --	dactylic hexameter	masculine penthemimeral
ἠγάγετʼ ἐς μέγα δῶμα φίλην κεκλῆσθαι ἄκοιτιν.	-uu - uu -u u- --u u--	dactylic hexameter	feminine penthemimeral, hepthemimeral, trithemimeral
ἢ δ᾽ὑποκυσαμένη Ἑκάτην τέκε, τὴν περὶ πάντων	- uu-uu- uu- uu - uu --	dactylic hexameter	masculine penthemimeral, hepthemimeral
Ζεὺς Κρονίδης τίμησε· πόρεν δέ οἱ ἀγλαὰ δῶρα,	- uu- --u u- u u -uu --	dactylic hexameter	feminine penthemimeral, hepthemimeral, trithemimeral
μοῖραν ἔχειν γαίης τε καὶ ἀτρυγέτοιο θαλάσσης.	-u u- -- u u -uu-u u--	dactylic hexameter	masculine penthemimeral, trithemimeral
ἣ δὲ καὶ ἀστερόεντος ἀπʼ οὐρανοῦ ἔμμορε τιμῆς	- u u -uu-u u -uu -uu --	dactylic hexameter	feminine penthemimeral
ἀθανάτοις τε θεοῖσι τετιμένη ἐστὶ μάλιστα.	-uu- u u-u u-uu -u u--	dactylic hexameter	feminine penthemimeral, trithemimeral
καὶ γὰρ νῦν, ὅτε πού τις ἐπιχθονίων ἀνθρώπων	- - - uu - u u-uu- ---	dactylic hexameter	masculine penthemimeral, trithemimeral
ἔρδων ἱερὰ καλὰ κατὰ νόμον ἱλάσκηται,	-- -uu -u u- uu ----	dactylic hexameter	feminine penthemimeral, hepthemimeral
κικλῄσκει Ἑκάτην. πολλή τέ οἱ ἕσπετο τιμὴ	--- uu- -- u u -uu --	dactylic hexameter	masculine penthemimeral, hepthemimeral, trithemimeral
ῥεῖα μάλʼ, ᾧ πρόφρων γε θεὰ ὑποδέξεται εὐχάς,	-u u - -- u u- uu-uu --	dactylic hexameter	masculine penthemimeral, hepthemimeral, trithemimeral
καί τέ οἱ ὄλβον ὀπάζει, ἐπεὶ δύναμίς γε πάρεστιν.	- u u -u u-u u- uu- u u--	dactylic hexameter	feminine penthemimeral, hepthemimeral
ὅσσοι γὰρ Γαίης τε καὶ Οὐρανοῦ ἐξεγένοντο	-- - -- u u -uu -uu--	dactylic hexameter	masculine penthemimeral, trithemimeral
καὶ τιμὴν ἔλαχον, τούτων ἔχει αἶσαν ἁπάντων.	- -- uu- -- uu -u u--	dactylic hexameter	masculine penthemimeral, hepthemimeral, trithemimeral
οὐδέ τί μιν Κρονίδης ἐβιήσατο οὐδέ τ᾽ἀπηύρα,	-u u - uu- uu-uu -u u--	dactylic hexameter	masculine penthemimeral, trithemimeral
ὅσσʼ ἔλαχεν Τιτῆσι μετὰ προτέροισι θεοῖσιν,	- uu- --u u- uu-u u--	dactylic hexameter	feminine penthemimeral, hepthemimeral, trithemimeral
ἀλλʼ ἔχει, ὡς τὸ πρῶτον ἀπʼ ἀρχῆς ἔπλετο δασμός,	- uu - - -u u -- -uu --	dactylic hexameter	feminine penthemimeral, trithemimeral
καὶ γέρας ἐν γαίῃ τε καὶ οὐρανῷ ἠδὲ θαλάσσῃ·	- uu - -- u u -uu -u u--	dactylic hexameter	masculine penthemimeral, trithemimeral
οὐδʼ, ὅτι μουνογενής, ἧσσον θεὰ ἔμμορε τιμῆς,	- uu -uu- -- uu -uu --	dactylic hexameter	masculine penthemimeral, hepthemimeral
ἀλλʼ ἔτι καὶ πολὺ μᾶλλον, ἐπεὶ Ζεὺς τίεται αὐτήν.	- uu - uu -u u- - -uu --	dactylic hexameter	feminine penthemimeral, hepthemimeral, trithemimeral
ᾧ δ᾽ἐθέλει, μεγάλως παραγίγνεται ἠδʼ ὀνίνησιν·	- uu- uu- uu-uu - uu--	dactylic hexameter	masculine penthemimeral, trithemimeral
ἔν τε δίκῃ βασιλεῦσι παρʼ αἰδοίοισι καθίζει,	- u u- uu-u u ---u u--	dactylic hexameter	feminine penthemimeral, trithemimeral
ἔν τ᾽ἀγορῇ λαοῖσι μεταπρέπει, ὅν κ᾽ἐθέλῃσιν·	- uu- --u u-uu - uu--	dactylic hexameter	feminine penthemimeral, trithemimeral
ἠδʼ ὁπότʼ ἐς πόλεμον φθεισήνορα θωρήσσωνται	- uu - uu- --uu ----	dactylic hexameter	masculine penthemimeral, trithemimeral
ἀνέρες, ἔνθα θεὰ παραγίγνεται, οἷς κ᾽ἐθέλῃσι	-uu -u u- uu-uu - uu--	dactylic hexameter	masculine penthemimeral
νίκην προφρονέως ὀπάσαι καὶ κῦδος ὀρέξαι.	-- -uu- uu- - -u u--	dactylic hexameter	masculine penthemimeral, hepthemimeral
ἐσθλὴ δ᾽αὖθʼ ὁπότʼ ἄνδρες ἀεθλεύωσιν ἀγῶνι,	-- - uu -u u---u u--	dactylic hexameter	feminine penthemimeral, trithemimeral
ἔνθα θεὰ καὶ τοῖς παραγίγνεται ἠδʼ ὀνίνησιν·	-u u- - - uu-uu - uu--	dactylic hexameter	masculine penthemimeral, trithemimeral
νικήσας δὲ βίῃ καὶ κάρτεϊ καλὸν ἄεθλον	--- u u- - -uu -u u--	dactylic hexameter	masculine penthemimeral, trithemimeral
ῥεῖα φέρει χαίρων τε, τοκεῦσι δὲ κῦδος ὀπάζει.	-u u- -- u u-u u -u u--	dactylic hexameter	masculine penthemimeral, trithemimeral
ἐσθλὴ δ᾽ἱππήεσσι παρεστάμεν, οἷς κ᾽ἐθέλῃσιν.	-- ---u u-uu - uu--	dactylic hexameter	feminine penthemimeral
καὶ τοῖς, οἳ γλαυκὴν δυσπέμφελον ἐργάζονται,	- - - -- --uu ----	dactylic hexameter	masculine penthemimeral, trithemimeral
εὔχονται δ᾽Ἑκάτῃ καὶ ἐρικτύπῳ Ἐννοσιγαίῳ,	--- uu- u u-uu -uu--	dactylic hexameter	masculine penthemimeral, trithemimeral
ῥηιδίως ἄγρην κυδρὴ θεὸς ὤπασε πολλήν,	-uu- -- -- uu -uu --	dactylic hexameter	masculine penthemimeral, hepthemimeral, trithemimeral
ῥεῖα δ᾽ἀφείλετο φαινομένην, ἐθέλουσά γε θυμῷ.	-u u-uu -uu- uu-u u --	dactylic hexameter	hepthemimeral
ἐσθλὴ δ᾽ἐν σταθμοῖσι σὺν Ἑρμῇ ληίδʼ ἀέξειν·	-- - --u u -- -u u--	dactylic hexameter	feminine penthemimeral, trithemimeral
βουκολίας δ᾽ἀγέλας τε καὶ αἰπόλια πλατέʼ αἰγῶν	-uu- uu- u u -uu- uu --	dactylic hexameter	masculine penthemimeral, trithemimeral
ποίμνας τ᾽εἰροπόκων ὀίων, θυμῷ γ᾽ἐθέλουσα,	-- -uu- uu- -- uu--	dactylic hexameter	masculine penthemimeral, hepthemimeral
ἐξ ὀλίγων βριάει κἀκ πολλῶν μείονα θῆκεν.	- uu- uu- - -- -uu --	dactylic hexameter	masculine penthemimeral, trithemimeral
οὕτω τοι καὶ μουνογενὴς ἐκ μητρὸς ἐοῦσα	-- - - -uu- - -u u--	dactylic hexameter	hepthemimeral, trithemimeral
πᾶσι μετʼ ἀθανάτοισι τετίμηται γεράεσσιν.	-u u -uu-u u--- uu--	dactylic hexameter	feminine penthemimeral
θῆκε δέ μιν Κρονίδης κουροτρόφον, οἳ μετʼ ἐκείνην	-u u - uu- --uu - u u--	dactylic hexameter	masculine penthemimeral, trithemimeral
ὀφθαλμοῖσιν ἴδοντο φάος πολυδερκέος Ἠοῦς.	---u u-u u- uu-uu --	dactylic hexameter	feminine penthemimeral, hepthemimeral
οὕτως ἐξ ἀρχῆς κουροτρόφος, αἳ δέ τε τιμαί.	-- - -- --uu - u u --	dactylic hexameter	masculine penthemimeral, trithemimeral
Ῥείη δὲ δμηθεῖσα Κρόνῳ τέκε φαίδιμα τέκνα,	-- - --u u- uu -uu --	dactylic hexameter	feminine penthemimeral, hepthemimeral, trithemimeral
Ἱστίην Δήμητρα καὶ Ἥρην χρυσοπέδιλον	--- --u u -- -uu--	dactylic hexameter	feminine penthemimeral, trithemimeral
ἴφθιμόν τ᾽Ἀίδην, ὃς ὑπὸ χθονὶ δώματα ναίει	--- uu- u u- uu -uu --	dactylic hexameter	masculine penthemimeral, hepthemimeral, trithemimeral
νηλεὲς ἦτορ ἔχων, καὶ ἐρίκτυπον Ἐννοσίγαιον	-uu -u u- u u-uu -uu--	dactylic hexameter	masculine penthemimeral
Ζῆνά τε μητιόεντα, θεῶν πατέρʼ ἠδὲ καὶ ἀνδρῶν,	-u u -uu-u u- uu -u u --	dactylic hexameter	feminine penthemimeral, hepthemimeral
τοῦ καὶ ὑπὸ βροντῆς πελεμίζεται εὐρεῖα χθών.	- u u- -- uu-uu --- -	dactylic hexameter	masculine penthemimeral, trithemimeral
καὶ τοὺς μὲν κατέπινε μέγας Κρόνος, ὥς τις ἕκαστος	- - - uu-u u- uu - u u--	dactylic hexameter	feminine penthemimeral, hepthemimeral, trithemimeral
νηδύος ἐξ ἱερῆς μητρὸς πρὸς γούναθʼ ἵκοιτο,	-uu - uu- -- - -u u--	dactylic hexameter	masculine penthemimeral, hepthemimeral, trithemimeral
τὰ φρονέων, ἵνα μή τις ἀγαυῶν Οὐρανιώνων	- uu- uu - u u-- -uu--	dactylic hexameter	masculine penthemimeral, trithemimeral
ἄλλος ἐν ἀθανάτοισιν ἔχοι βασιληίδα τιμήν.	-u u -uu-u u- uu-uu --	dactylic hexameter	feminine penthemimeral, hepthemimeral
πεύθετο γὰρ Γαίης τε καὶ Οὐρανοῦ ἀστερόεντος,	-uu - -- u u -uu -uu--	dactylic hexameter	masculine penthemimeral, trithemimeral
οὕνεκά οἱ πέπρωτο ἑῷ ὑπὸ παιδὶ δαμῆναι	-uu - --u u- uu -u u--	dactylic hexameter	feminine penthemimeral, hepthemimeral, trithemimeral
καὶ κρατερῷ περ ἐόντι, Διὸς μεγάλου διὰ βουλάς·	- uu- u u-u u- uu- uu --	dactylic hexameter	feminine penthemimeral, hepthemimeral, trithemimeral
τῷ ὅ γ᾽ἄρʼ οὐκ ἀλαὸς σκοπιὴν ἔχεν, ἀλλὰ δοκεύων	- u u - uu- uu- uu -u u--	dactylic hexameter	masculine penthemimeral, hepthemimeral, trithemimeral
παῖδας ἑοὺς κατέπινε· Ῥέην δ᾽ἔχε πένθος ἄλαστον.	-u u- uu-u u- uu -u u--	dactylic hexameter	feminine penthemimeral, hepthemimeral, trithemimeral
ἀλλʼ ὅτε δὴ Δίʼ ἔμελλε θεῶν πατέρʼ ἠδὲ καὶ ἀνδρῶν	- uu - u u-u u- uu -u u --	dactylic hexameter	feminine penthemimeral, hepthemimeral, trithemimeral
τέξεσθαι, τότʼ ἔπειτα φίλους λιτάνευε τοκῆας	--- u u-u u- uu-u u--	dactylic hexameter	feminine penthemimeral, hepthemimeral, trithemimeral
τοὺς αὐτῆς, Γαῖάν τε καὶ Οὐρανὸν ἀστερόεντα,	- -- -- u u -uu -uu--	dactylic hexameter	masculine penthemimeral, trithemimeral
μῆτιν συμφράσσασθαι, ὅπως λελάθοιτο τεκοῦσα	-- ---u u- uu-u u--	dactylic hexameter	feminine penthemimeral, hepthemimeral
παῖδα φίλον, τίσαιτο δ᾽ἐρινῦς πατρὸς ἑοῖο	-u u- --u u-- -u u--	dactylic hexameter	feminine penthemimeral, trithemimeral
παίδων θ᾽,οὓς κατέπινε μέγας Κρόνος ἀγκυλομήτης.	-- - uu-u u- uu -uu--	dactylic hexameter	feminine penthemimeral, hepthemimeral, trithemimeral
οἳ δὲ θυγατρὶ φίλῃ μάλα μὲν κλύον ἠδʼ ἐπίθοντο,	- u u-u u- uu - uu - uu--	dactylic hexameter	masculine penthemimeral, hepthemimeral
καί οἱ πεφραδέτην, ὅσα περ πέπρωτο γενέσθαι	- - -uu- uu - --u u--	dactylic hexameter	masculine penthemimeral, hepthemimeral
ἀμφὶ Κρόνῳ βασιλῆι καὶ υἱέι καρτεροθύμῳ.	-u u- uu-u u -uu -uu--	dactylic hexameter	feminine penthemimeral, trithemimeral
πέμψαν δ᾽ἐς Λύκτον, Κρήτης ἐς πίονα δῆμον,	-- - -- -- - -uu --	dactylic hexameter	masculine penthemimeral, hepthemimeral, trithemimeral
ὁππότʼ ἄρʼ ὁπλότατον παίδων τέξεσθαι ἔμελλε,	-u u -uu- -- --u u--	dactylic hexameter	masculine penthemimeral, hepthemimeral
Ζῆνα μέγαν· τὸν μέν οἱ ἐδέξατο Γαῖα πελώρη	-u u- - - u u-uu -u u--	dactylic hexameter	masculine penthemimeral, trithemimeral
Κρήτῃ ἐν εὐρείῃ τραφέμεν ἀτιταλλέμεναί τε.	-u u --- uu- uu-uu- -	dactylic hexameter	masculine penthemimeral, hepthemimeral
ἔνθα μιν ἷκτο φέρουσα θοὴν διὰ νύκτα μέλαιναν	-u u -u u-u u- uu -u u--	dactylic hexameter	feminine penthemimeral, hepthemimeral
πρώτην ἐς Λύκτον· κρύψεν δέ ἑ χερσὶ λαβοῦσα	-- - -- -- u u -u u--	dactylic hexameter	masculine penthemimeral, hepthemimeral, trithemimeral
ἄντρῳ ἐν ἠλιβάτῳ, ζαθέης ὑπὸ κεύθεσι γαίης,	-u u -uu- uu- uu -uu --	dactylic hexameter	masculine penthemimeral, hepthemimeral
Αἰγαίῳ ἐν ὄρει πεπυκασμένῳ ὑλήεντι.	--- u u- uu-uu ----	dactylic hexameter	masculine penthemimeral, trithemimeral
τῷ δὲ σπαργανίσασα μέγαν λίθον ἐγγυάλιξεν	- - -uu-u u- uu -uu--	dactylic hexameter	feminine penthemimeral, hepthemimeral
Οὐρανίδῃ μέγʼ ἄνακτι, θεῶν προτέρῳ βασιλῆι.	-uu- u u-u u- uu- uu--	dactylic hexameter	feminine penthemimeral, hepthemimeral, trithemimeral
τὸν τόθʼ ἑλὼν χείρεσσιν ἑὴν ἐσκάτθετο νηδὺν	- u u- --u u- --uu --	dactylic hexameter	feminine penthemimeral, hepthemimeral, trithemimeral
σχέτλιος· οὐδʼ ἐνόησε μετὰ φρεσίν, ὥς οἱ ὀπίσσω	-uu - uu-u u- uu - u u--	dactylic hexameter	feminine penthemimeral, hepthemimeral, trithemimeral
ἀντὶ λίθου ἑὸς υἱὸς ἀνίκητος καὶ ἀκηδὴς	-u u- uu -u u--- u u--	dactylic hexameter	feminine penthemimeral, trithemimeral
λείπεθʼ, ὅ μιν τάχʼ ἔμελλε βίῃ καὶ χερσὶ δαμάσσας	-u u - u u-u u- - -u u--	dactylic hexameter	feminine penthemimeral, hepthemimeral, trithemimeral
τιμῆς ἐξελάειν, ὃ δ᾽ἐν ἀθανάτοισι ἀνάξειν.	-- -uu- u u -uu-u u--	dactylic hexameter	masculine penthemimeral
καρπαλίμως δ᾽ἄρʼ ἔπειτα μένος καὶ φαίδιμα γυῖα	-uu- u u-u u- - -uu --	dactylic hexameter	feminine penthemimeral, hepthemimeral, trithemimeral
ηὔξετο τοῖο ἄνακτος· ἐπιπλομένων δ᾽ἐνιαυτῶν	-uu -u u-u u-uu- uu--	dactylic hexameter	feminine penthemimeral
Γαίης ἐννεσίῃσι πολυφραδέεσσι δολωθεὶς	-- -uu-u u-uu-u u--	dactylic hexameter	feminine penthemimeral
ὃν γόνον ἄψ ἀνέηκε μέγας Κρόνος ἀγκυλομήτης	- uu - uu-u u- uu -uu--	dactylic hexameter	feminine penthemimeral, hepthemimeral, trithemimeral
[νικηθεὶς τέχνῃσι βίηφί τε παιδὸς ἑοῖο.	--- --u u-u u -u u--	dactylic hexameter	feminine penthemimeral, trithemimeral
πρῶτον δ᾽ἐξέμεσεν λίθον, ὃν πύματον κατέπινεν·	-- -uu- uu - uu- uu--	dactylic hexameter	masculine penthemimeral, hepthemimeral
τὸν μὲν Ζεὺς στήριξε κατὰ χθονὸς εὐρυοδείης	- - - --u u- uu -uu--	dactylic hexameter	feminine penthemimeral, hepthemimeral, trithemimeral
Πυθοῖ ἐν ἠγαθέῃ γυάλοις ὕπο Παρνησοῖο	-u u -uu- uu- uu ----	dactylic hexameter	masculine penthemimeral, hepthemimeral
σῆμʼ ἔμεν ἐξοπίσω, θαῦμα θνητοῖσι βροτοῖσιν.	- uu -uu- -- --u u--	dactylic hexameter	masculine penthemimeral, hepthemimeral
λῦσε δὲ πατροκασιγνήτους ὀλοῶν ὑπὸ δεσμῶν	-u u -uu--- uu- uu --	dactylic hexameter	hepthemimeral
Οὐρανίδας, οὓς δῆσε πατὴρ ἀεσιφροσύνῃσιν·	-uu- - -u u- uu-uu--	dactylic hexameter	feminine penthemimeral, hepthemimeral, trithemimeral
οἳ οἱ ἀπεμνήσαντο χάριν ἐυεργεσιάων,	- u u---u u- uu-uu--	dactylic hexameter	feminine penthemimeral, hepthemimeral
δῶκαν δὲ βροντὴν ἠδʼ αἰθαλόεντα κεραυνὸν	-- - -- - -uu-u u--	dactylic hexameter	masculine penthemimeral, trithemimeral
καὶ στεροπήν· τὸ πρὶν δὲ πελώρη Γαῖα κεκεύθει·	- uu- - - u u-- -u u--	dactylic hexameter	masculine penthemimeral, trithemimeral
τοῖς πίσυνος θνητοῖσι καὶ ἀθανάτοισιν ἀνάσσει.	- uu- --u u -uu-u u--	dactylic hexameter	feminine penthemimeral, trithemimeral
κούρην δ᾽Ἰαπετὸς καλλίσφυρον Ὠκεανίνην	-- -uu- --uu -uu--	dactylic hexameter	masculine penthemimeral
ἠγάγετο Κλυμένην καὶ ὁμὸν λέχος εἰσανέβαινεν.	-uu- uu- u u- uu -uu--	dactylic hexameter	masculine penthemimeral, hepthemimeral, trithemimeral
ἣ δέ οἱ Ἄτλαντα κρατερόφρονα γείνατο παῖδα·	- u u --- uu-uu -uu --	dactylic hexameter	masculine penthemimeral
τίκτε δ᾽ὑπερκύδαντα Μενοίτιον ἠδὲ Προμηθέα	-u u---u u-uu -u u--	dactylic hexameter	feminine penthemimeral
ποικίλον αἰολόμητιν, ἁμαρτίνοόν τ᾽Ἐπιμηθέα	-uu -uu-u u-uu- uu--	dactylic hexameter	feminine penthemimeral
ὃς κακὸν ἐξ ἀρχῆς γένετʼ ἀνδράσιν ἀλφηστῇσιν·	- uu - -- uu -uu ----	dactylic hexameter	masculine penthemimeral, trithemimeral
πρῶτος γάρ ῥα Διὸς πλαστὴν ὑπέδεκτο γυναῖκα	-- - u u- -- uu-u u--	dactylic hexameter	masculine penthemimeral, hepthemimeral, trithemimeral
παρθένον. ὑβριστὴν δὲ Μενοίτιον εὐρύοπα Ζεὺς	-uu --- u u-uu -uu- -	dactylic hexameter	masculine penthemimeral
εἰς Ἔρεβος κατέπεμψε βαλὼν ψολόεντι κεραυνῷ	- uu- uu-u u- uu-u u--	dactylic hexameter	feminine penthemimeral, hepthemimeral, trithemimeral
εἵνεκʼ ἀτασθαλίης τε καὶ ἠνορέης ὑπερόπλου.	-u u-uu- u u -uu- uu--	dactylic hexameter	masculine penthemimeral
Ἄτλας δ᾽οὐρανὸν εὐρὺν ἔχει κρατερῆς ὑπʼ ἀνάγκης	-- -uu -u u- uu- u u--	dactylic hexameter	feminine penthemimeral, hepthemimeral
πείρασιν ἐν γαίης, πρόπαρ Εσπερίδων λιγυφώνων,	-uu - -- uu -uu- uu--	dactylic hexameter	masculine penthemimeral, trithemimeral
ἑστηὼς κεφαλῇ τε καὶ ἀκαμάτῃσι χέρεσσιν·	--- uu- u u -uu-u u--	dactylic hexameter	masculine penthemimeral, trithemimeral
ταύτην γάρ οἱ μοῖραν ἐδάσσατο μητίετα Ζεύς.	-- - - -u u-uu -uu- -	dactylic hexameter	feminine penthemimeral, trithemimeral
δῆσε δ᾽ἀλυκτοπέδῃσι Προμηθέα ποικιλόβουλον	-u u-uu-u u-uu -uu--	dactylic hexameter	feminine penthemimeral
δεσμοῖς ἀργαλέοισι μέσον διὰ κίονʼ ἐλάσσας·	-- -uu-u u- uu -u u--	dactylic hexameter	feminine penthemimeral, hepthemimeral
καί οἱ ἐπʼ αἰετὸν ὦρσε τανύπτερον· αὐτὰρ ὅ γ᾽ἧπαρ	- u u -uu -u u-uu -u u --	dactylic hexameter	feminine penthemimeral
ἤσθιεν ἀθάνατον, τὸ δ᾽ἀέξετο ἶσον ἁπάντη	-uu -uu- u u-uu -u u--	dactylic hexameter	masculine penthemimeral
νυκτός ὅσον πρόπαν ἦμαρ ἔδοι τανυσίπτερος ὄρνις.	-u u- uu -u u- uu-uu --	dactylic hexameter	feminine penthemimeral, hepthemimeral, trithemimeral
τὸν μὲν ἄρʼ Ἀλκμήνης καλλισφύρου ἄλκιμος υἱὸς	- u u --- --uu -uu --	dactylic hexameter	masculine penthemimeral
Ἡρακλέης ἔκτεινε, κακὴν δ᾽ἀπὸ νοῦσον ἄλαλκεν	-uu- --u u- uu -u u--	dactylic hexameter	feminine penthemimeral, hepthemimeral, trithemimeral
Ἰαπετιονίδῃ καὶ ἐλύσατο δυσφροσυνάων	-uu-uu- u u-uu -uu--	dactylic hexameter	masculine penthemimeral
οὐκ ἀέκητι Ζηνὸς Ὀλυμπίου ὑψιμέδοντος,	- uu-- -u u-uu -uu--	dactylic hexameter	feminine penthemimeral
ὄφρʼ Ἡρακλῆος Θηβαγενέος κλέος εἴη	- ---- --uu- uu --	dactylic hexameter	masculine penthemimeral
πλεῖον ἔτʼ ἢ τὸ πάροιθεν ἐπὶ χθόνα πουλυβότειραν.	-u u - u u-u u- uu -uu--	dactylic hexameter	feminine penthemimeral, hepthemimeral, trithemimeral
ταῦτʼ ἄρα ἁζόμενος τίμα ἀριδείκετον υἱόν·	- uu -uu- uu ---uu --	dactylic hexameter	masculine penthemimeral
καί περ χωόμενος παύθη χόλου, ὃν πρὶν ἔχεσκεν,	- - -uu- -- uu - u u--	dactylic hexameter	masculine penthemimeral, hepthemimeral
οὕνεκʼ ἐρίζετο βουλὰς ὑπερμενέι Κρονίωνι.	-u u-uu -u u-uu- uu--	dactylic hexameter	feminine penthemimeral
καὶ γὰρ ὅτʼ ἐκρίνοντο θεοὶ θνητοί τ᾽ἄνθρωποι	- u u ---u u- -- ---	dactylic hexameter	feminine penthemimeral, hepthemimeral
Μηκώνῃ, τότʼ ἔπειτα μέγαν βοῦν πρόφρονι θυμῷ	--- u u-u u- - -uu --	dactylic hexameter	feminine penthemimeral, hepthemimeral, trithemimeral
δασσάμενος προέθηκε, Διὸς νόον ἐξαπαφίσκων.	-uu- uu-u u- uu -uu--	dactylic hexameter	feminine penthemimeral, hepthemimeral, trithemimeral
τοῖς μὲν γὰρ σάρκας τε καὶ ἔγκατα πίονα δημῷ	- - - -- u u -uu -uu --	dactylic hexameter	masculine penthemimeral, trithemimeral
ἐν ῥινῷ κατέθηκε καλύψας γαστρὶ βοείῃ,	- -- uu-u u-- -u u--	dactylic hexameter	feminine penthemimeral, trithemimeral
τῷ δ᾽αὖτʼ ὀστέα λευκὰ βοὸς δολίῃ ἐπὶ τέχνῃ	- - -uu -u u- uu- uu --	dactylic hexameter	feminine penthemimeral, hepthemimeral
εὐθετίσας κατέθηκε καλύψας ἀργέτι δημῷ.	-uu- uu-u u-- -uu --	dactylic hexameter	feminine penthemimeral, trithemimeral
δὴ τότε μιν προσέειπε πατὴρ ἀνδρῶν τε θεῶν τε·	- uu - uu-u u- -- u u- -	dactylic hexameter	feminine penthemimeral, hepthemimeral, trithemimeral
Ἰαπετιονίδη, πάντων ἀριδείκετʼ ἀνάκτων,	-uu-uu- -- uu-u u--	dactylic hexameter	masculine penthemimeral, hepthemimeral
ὦ πέπον, ὡς ἑτεροζήλως διεδάσσαο μοίρας.	- uu - uu--- uu-uu --	dactylic hexameter	hepthemimeral, trithemimeral
ὣς φάτο κερτομέων Ζεὺς ἄφθιτα μήδεα εἰδώς.	- uu -uu- - -uu -uu --	dactylic hexameter	masculine penthemimeral
τὸν δ᾽αὖτε προσέειπε Προμηθεὺς ἀγκυλομήτης	- -- uu-u u-- -uu--	dactylic hexameter	feminine penthemimeral, trithemimeral
ἦκʼ ἐπιμειδήσας, δολίης δ᾽οὐ λήθετο τέχνης·	- uu--- uu- - -uu --	dactylic hexameter	masculine penthemimeral, hepthemimeral
ζεῦ κύδιστε μέγιστε θεῶν αἰειγενετάων,	- --u u-u u- --uu--	dactylic hexameter	feminine penthemimeral, hepthemimeral
τῶν δ᾽ἕλεʼ, ὁπποτέρην σε ἐνὶ φρεσὶ θυμὸς ἀνώγει.	- uu -uu- u u- uu -u u--	dactylic hexameter	masculine penthemimeral, hepthemimeral
Φῆ ῥα δολοφρονέων· Ζεὺς δ᾽ἄφθιτα μήδεα εἰδὼς	- u u-uu- - -uu -uu --	dactylic hexameter	masculine penthemimeral
γνῶ ῥ᾽οὐδʼ ἠγνοίησε δόλον· κακὰ δ᾽ὄσσετο θυμῷ	- - ---u u- uu -uu --	dactylic hexameter	feminine penthemimeral, hepthemimeral
θνητοῖς ἀνθρώποισι, τὰ καὶ τελέεσθαι ἔμελλεν.	-- ---u u - uu-u u--	dactylic hexameter	feminine penthemimeral, hepthemimeral
χερσὶ δ᾽ὅ γ᾽ἀμφοτέρῃσιν ἀνείλετο λευκὸν ἄλειφαρ.	-u u -uu-u u-uu -u u--	dactylic hexameter	feminine penthemimeral
χώσατο δὲ φρένας ἀμφί, χόλος δέ μιν ἵκετο θυμόν,	-uu - uu -u u- u u -uu --	dactylic hexameter	feminine penthemimeral, hepthemimeral, trithemimeral
ὡς ἴδεν ὀστέα λευκὰ βοὸς δολίῃ ἐπὶ τέχνῃ.	- uu -uu -u u- uu- uu --	dactylic hexameter	feminine penthemimeral, hepthemimeral
ἐκ τοῦ δ᾽ἀθανάτοισιν ἐπὶ χθονὶ φῦλʼ ἀνθρώπων	- - -uu-u u- uu - ---	dactylic hexameter	feminine penthemimeral, hepthemimeral
καίουσʼ ὀστέα λευκὰ θυηέντων ἐπὶ βωμῶν.	-- -uu -u u--- uu --	dactylic hexameter	feminine penthemimeral
τὸν δὲ μέγʼ ὀχθήσας προσέφη νεφεληγερέτα Ζεύς·	- u u --- uu- uu-uu- -	dactylic hexameter	masculine penthemimeral, hepthemimeral
Ἰαπετιονίδη, πάντων πέρι μήδεα εἰδώς,	-uu-uu- -- uu -uu --	dactylic hexameter	masculine penthemimeral, hepthemimeral
ὦ πέπον, οὐκ ἄρα πω δολίης ἐπιλήθεο τέχνης.	- uu - uu - uu- uu-uu --	dactylic hexameter	masculine penthemimeral, hepthemimeral, trithemimeral
ὣς φάτο χωόμενος Ζεὺς ἄφθιτα μήδεα εἰδώς·	- uu -uu- - -uu -uu --	dactylic hexameter	masculine penthemimeral
ἐκ τούτου δὴ ἔπειτα δόλου μεμνημένος αἰεὶ	- -- u u-u u- --uu --	dactylic hexameter	feminine penthemimeral, hepthemimeral, trithemimeral
οὐκ ἐδίδου Μελίῃσι πυρὸς μένος ἀκαμάτοιο	- uu- uu-u u- uu -uu--	dactylic hexameter	feminine penthemimeral, hepthemimeral, trithemimeral
θνητοῖς ἀνθρώποις, οἳ ἐπὶ χθονὶ ναιετάουσιν.	-- --- u u- uu -uu--	dactylic hexameter	masculine penthemimeral, hepthemimeral
ἀλλά μιν ἐξαπάτησεν ἐὺς πάις Ἰαπετοῖο	-u u -uu-- - uu -uu--	dactylic hexameter	hepthemimeral
κλέψας ἀκαμάτοιο πυρὸς τηλέσκοπον. αὐγὴν	-u u---u u- --uu --	dactylic hexameter	feminine penthemimeral, hepthemimeral
ἐν κοΐλῳ νάρθηκι· δάκεν δέ ἑ νειόθι θυμόν,	- uu- --u u- u u -uu --	dactylic hexameter	feminine penthemimeral, hepthemimeral, trithemimeral
Ζῆνʼ ὑψιβρεμέτην, ἐχόλωσε δέ μιν φίλον ἦτορ,	- --uu- uu-u u - uu --	dactylic hexameter	masculine penthemimeral
ὡς ἴδʼ ἐν ἀνθρώποισι πυρὸς τηλέσκοπον αὐγήν.	- u u ---u u- --uu --	dactylic hexameter	feminine penthemimeral, hepthemimeral
αὐτίκα δ᾽ἀντὶ πυρὸς τεῦξεν κακὸν ἀνθρώποισιν·	-uu -u u- -- uu ----	dactylic hexameter	masculine penthemimeral, hepthemimeral
γαίης γὰρ σύμπλασσε περικλυτὸς Ἀμφιγυήεις	-- - --u u-uu -uu--	dactylic hexameter	feminine penthemimeral, trithemimeral
παρθένῳ αἰδοίῃ ἴκελον Κρονίδεω διὰ βουλάς.	-uu --- uu- uu- uu --	dactylic hexameter	masculine penthemimeral, hepthemimeral
ζῶσε δὲ καὶ κόσμησε θεὰ γλαυκῶπις Ἀθήνη	-u u - --u u- --u u--	dactylic hexameter	feminine penthemimeral, hepthemimeral, trithemimeral
ἀργυφέη ἐσθῆτι· κατὰ κρῆθεν δὲ καλύπτρην	-uu- --u u- -- u u--	dactylic hexameter	feminine penthemimeral, hepthemimeral, trithemimeral
δαιδαλέην χείρεσσι κατέσχεθε, θαῦμα ἰδέσθαι·	-uu- --u u-uu -u u--	dactylic hexameter	feminine penthemimeral, trithemimeral
[ἀμφὶ δέ οἱ στεφάνους, νεοθηλέος ἄνθεα ποίης,	-u u - uu- uu-uu -uu --	dactylic hexameter	masculine penthemimeral, trithemimeral
[ἱμερτοὺς περίθηκε καρήατι Παλλὰς Ἀθήνη.	--- uu-u u-uu -u u--	dactylic hexameter	feminine penthemimeral, trithemimeral
ἀμφὶ δέ οἱ στεφάνην χρυσέην κεφαλῆφιν ἔθηκε,	-u u - uu- uu- uu-u u--	dactylic hexameter	masculine penthemimeral, hepthemimeral, trithemimeral
τὴν αὐτὸς ποίησε περικλυτὸς Ἀμφιγυήεις	- -- --u u-uu -uu--	dactylic hexameter	feminine penthemimeral, trithemimeral
ἀσκήσας παλάμῃσι, χαριζόμενος Διὶ πατρί.	--- uu-u u-uu- uu --	dactylic hexameter	feminine penthemimeral, trithemimeral
τῇ δ᾽ἐνὶ δαίδαλα πολλὰ τετεύχατο, θαῦμα ἰδέσθαι,	- uu -uu -u u-uu -u u--	dactylic hexameter	feminine penthemimeral
κνώδαλʼ, ὅσʼ ἤπειρος πολλὰ τρέφει ἠδὲ θάλασσα,	-u u --- -- uu -u u--	dactylic hexameter	masculine penthemimeral, hepthemimeral
τῶν ὅ γε πόλλʼ ἐνέθηκε,—χάρις δ᾽ἀπελάμπετο πολλή,—	- u u - uu-uu- uu-uu --	dactylic hexameter	hepthemimeral, trithemimeral
θαυμάσια, ζῴοισιν ἐοικότα φωνήεσσιν.	-uu- --u u-uu ----	dactylic hexameter	feminine penthemimeral, trithemimeral
αὐτὰρ ἐπεὶ δὴ τεῦξε καλὸν κακὸν ἀντʼ ἀγαθοῖο.	-u u- - -u u- uu - uu--	dactylic hexameter	feminine penthemimeral, hepthemimeral, trithemimeral
ἐξάγαγʼ, ἔνθα περ ἄλλοι ἔσαν θεοὶ ἠδʼ ἄνθρωποι,	-uu -u u -u u- uu - ---	dactylic hexameter	feminine penthemimeral, hepthemimeral
κόσμῳ ἀγαλλομένην γλαυκώπιδος ὀβριμοπάτρης.	-u u-uu- --uu -uu--	dactylic hexameter	masculine penthemimeral
θαῦμα δ᾽ἔχʼ ἀθανάτους τε θεοὺς θνητούς τ᾽ἀνθρώπους,	-u u -uu- u u- -- ---	dactylic hexameter	masculine penthemimeral, hepthemimeral
ὡς εἶδον δόλον αἰπύν, ἀμήχανον ἀνθρώποισιν.	- -- uu -u u-uu ----	dactylic hexameter	feminine penthemimeral, trithemimeral
ἐκ τῆς γὰρ γένος ἐστὶ γυναικῶν θηλυτεράων,	- - - uu -u u-- -uu--	dactylic hexameter	feminine penthemimeral, trithemimeral
[τῆς γὰρ ὀλώιόν ἐστι γένος καὶ φῦλα γυναικῶν,	- u u-uu -u u- - -u u--	dactylic hexameter	feminine penthemimeral, hepthemimeral
πῆμα μέγʼ αἳ θνητοῖσι μετʼ ἀνδράσι ναιετάουσιν	-u u - --u u -uu -uu--	dactylic hexameter	feminine penthemimeral, trithemimeral
οὐλομένης πενίης οὐ σύμφοροι, ἀλλὰ κόροιο.	-uu- uu- - -uu -u u--	dactylic hexameter	masculine penthemimeral, trithemimeral
ὡς δ᾽ὁπότʼ ἐν σμήνεσσι κατηρεφέεσσι μέλισσαι	- uu - --u u-uu-u u--	dactylic hexameter	feminine penthemimeral, trithemimeral
κηφῆνας βόσκωσι, κακῶν ξυνήονας ἔργων—	--- --u u- --uu --	dactylic hexameter	feminine penthemimeral, hepthemimeral, trithemimeral
αἳ μέν τε πρόπαν ἦμαρ ἐς ἠέλιον καταδύντα	- - - uu -u u -uu- uu--	dactylic hexameter	feminine penthemimeral, trithemimeral
ἠμάτιαι σπεύδουσι τιθεῖσί τε κηρία λευκά,	-uu- --u u-u u -uu --	dactylic hexameter	feminine penthemimeral, trithemimeral
οἳ δ᾽ἔντοσθε μένοντες ἐπηρεφέας κατὰ σίμβλους	- --u u-u u-uu- uu --	dactylic hexameter	feminine penthemimeral
ἀλλότριον κάματον σφετέρην ἐς γαστέρʼ ἀμῶνται—	-uu- uu- uu- - -u u--	dactylic hexameter	masculine penthemimeral, hepthemimeral, trithemimeral
ὣς δ᾽αὔτως ἄνδρεσσι κακὸν θνητοῖσι γυναῖκας	- -- --u u- --u u--	dactylic hexameter	feminine penthemimeral, hepthemimeral, trithemimeral
Ζεὺς ὑψιβρεμέτης θῆκεν, ξυνήονας ἔργων	- --uu- -- --uu --	dactylic hexameter	masculine penthemimeral, hepthemimeral
ἀργαλέων· ἕτερον δὲ πόρεν κακὸν ἀντʼ ἀγαθοῖο·	-uu- uu- u u- uu - uu--	dactylic hexameter	masculine penthemimeral, hepthemimeral, trithemimeral
ὅς κε γάμον φεύγων καὶ μέρμερα ἔργα γυναικῶν	- u u- -- - -uu -u u--	dactylic hexameter	masculine penthemimeral, trithemimeral
μὴ γῆμαι ἐθέλῃ, ὀλοὸν δ᾽ἐπὶ γῆρας ἵκοιτο	- -- uu- uu- uu -u u--	dactylic hexameter	masculine penthemimeral, hepthemimeral, trithemimeral
χήτεϊ γηροκόμοιο· ὅ γ᾽οὐ βιότου ἐπιδευὴς	-uu -uu-u u - uu- uu--	dactylic hexameter	feminine penthemimeral, hepthemimeral
ζώει, ἀποφθιμένου δὲ διὰ κτῆσιν δατέονται	-u u-uu- u u- -- uu--	dactylic hexameter	masculine penthemimeral, hepthemimeral
χηρωσταί· ᾧ δ᾽αὖτε γάμου μετὰ μοῖρα γένηται,	--- - -u u- uu -u u--	dactylic hexameter	feminine penthemimeral, hepthemimeral, trithemimeral
κεδνὴν δ᾽ἔσχεν ἄκοιτιν ἀρηρυῖαν πραπίδεσσι,	-- -u u-u u--- uu--	dactylic hexameter	feminine penthemimeral
τῷ δέ τ᾽ἀπʼ αἰῶνος κακὸν ἐσθλῷ ἀντιφερίζει	- u u --- uu -- -uu--	dactylic hexameter	masculine penthemimeral
ἐμμενές· ὃς δέ κε τέτμῃ ἀταρτηροῖο γενέθλης,	-uu - u u -u u---u u--	dactylic hexameter	feminine penthemimeral, trithemimeral
ζώει ἐνὶ στήθεσσιν ἔχων ἀλίαστον ἀνίην	-u u- --u u- uu-u u--	dactylic hexameter	feminine penthemimeral, hepthemimeral, trithemimeral
θυμῷ καὶ κραδίῃ, καὶ ἀνήκεστον κακόν ἐστιν.	-- - uu- u u--- uu --	dactylic hexameter	masculine penthemimeral, trithemimeral
ὣς οὐκ ἔστι Διὸς κλέψαι νόον οὐδὲ παρελθεῖν.	- - -u u- -- uu -u u--	dactylic hexameter	masculine penthemimeral, hepthemimeral
οὐδὲ γὰρ Ἰαπετιονίδης ἀκάκητα Προμηθεὺς	-u u -uu-uu- uu-u u--	dactylic hexameter	hepthemimeral
τοῖό γ᾽ὑπεξήλυξε βαρὺν χόλον, ἀλλʼ ὑπʼ ἀνάγκης	-u u---u u- uu - u u--	dactylic hexameter	feminine penthemimeral, hepthemimeral
καὶ πολύιδριν ἐόντα μέγας κατὰ δεσμὸς ἐρύκει.	- --u u-u u- uu -u u--	dactylic hexameter	feminine penthemimeral, hepthemimeral
Βριάρεῳ δ᾽ὡς πρῶτα πατὴρ ὠδύσσατο θυμῷ	-uu- - -u u- --uu --	dactylic hexameter	feminine penthemimeral, hepthemimeral, trithemimeral
Κόττῳ τ᾽ἠδὲ Γύῃ, δῆσεν κρατερῷ ἐνὶ δεσμῷ	-- -u u- -- uu- uu --	dactylic hexameter	masculine penthemimeral, hepthemimeral
ἠνορέην ὑπέροπλον ἀγώμενος ἠδὲ καὶ εἶδος	-uu- uu-u u-uu -u u --	dactylic hexameter	feminine penthemimeral, trithemimeral
καὶ μέγεθος· κατένασσε δ᾽ὑπὸ χθονὸς εὐρυοδείης.	- uu- uu-u u- uu -uu--	dactylic hexameter	feminine penthemimeral, hepthemimeral, trithemimeral
ἔνθʼ οἵ γ᾽ἄλγεʼ ἔχοντες ὑπὸ χθονὶ ναιετάοντες	- - -u u-u u- uu -uu--	dactylic hexameter	feminine penthemimeral, hepthemimeral
εἵατʼ ἐπʼ ἐσχατιῇ, μεγάλης ἐν πείρασι γαίης,	-u u -uu- uu- - -uu --	dactylic hexameter	masculine penthemimeral, hepthemimeral
δηθὰ μάλʼ ἀχνύμενοι, κραδίῃ μέγα πένθος ἔχοντες.	-u u -uu- uu- uu -u u--	dactylic hexameter	masculine penthemimeral, hepthemimeral
ἀλλά σφεας Κρονίδης τε καὶ ἀθάνατοι θεοὶ ἄλλοι,	-- - uu- u u -uu- uu --	dactylic hexameter	masculine penthemimeral, trithemimeral
οὓς τέκεν ἠύκομος Ῥείη Κρόνου ἐν φιλότητι,	- uu -uu- -- uu - uu--	dactylic hexameter	masculine penthemimeral, hepthemimeral
Γαίης φραδμοσύνῃσιν ἀνήγαγον ἐς φάος αὖτις·	-- -uu-u u-uu - uu --	dactylic hexameter	feminine penthemimeral
αὐτὴ γάρ σφιν ἅπαντα διηνεκέως κατέλεξε	-- - u u-u u-uu- uu--	dactylic hexameter	feminine penthemimeral, trithemimeral
σὺν κείνοις νίκην τε καὶ ἀγλαὸν εὖχος ἀρέσθαι.	- -- -- u u -uu -u u--	dactylic hexameter	masculine penthemimeral, trithemimeral
δηρὸν γὰρ μάρναντο πόνον θυμαλγέʼ ἔχοντες	-- - --u u- --u u--	dactylic hexameter	feminine penthemimeral, hepthemimeral, trithemimeral
Τιτῆνές τε θεοὶ καὶ ὅσοι Κρόνου ἐξεγένοντο,	--- u u- u u- uu -uu--	dactylic hexameter	masculine penthemimeral, hepthemimeral, trithemimeral
ἀντίον ἀλλήλοισι διὰ κρατερὰς ὑσμίνας,	-uu ---u u- uu- ---	dactylic hexameter	feminine penthemimeral, hepthemimeral
οἳ μὲν ἀφʼ ὑψηλῆς Ὄθρυος Τιτῆνες ἀγαυοί,	- u u --- uu- --u u--	dactylic hexameter	masculine penthemimeral, hepthemimeral
οἳ δ᾽ἄρʼ ἀπʼ Οὐλύμποιο θεοί, δωτῆρες ἐάων,	- u u ---u u- --u u--	dactylic hexameter	feminine penthemimeral, hepthemimeral
οὓς τέκεν ἠύκομος Ῥείη Κρόνῳ εὐνηθεῖσα.	- uu -uu- -- uu ----	dactylic hexameter	masculine penthemimeral, hepthemimeral
οἵ ῥα τότʼ ἀλλήλοισι χόλον θυμαλγέʼ ἔχοντες	- u u ---u u- --u u--	dactylic hexameter	feminine penthemimeral, hepthemimeral
συνεχέως ἐμάχοντο δέκα πλείους ἐνιαυτούς·	-uu- uu-u u- -- uu--	dactylic hexameter	feminine penthemimeral, hepthemimeral, trithemimeral
οὐδέ τις ἦν ἔριδος χαλεπῆς λύσις οὐδὲ τελευτὴ	-u u - uu- uu- uu -u u--	dactylic hexameter	masculine penthemimeral, hepthemimeral, trithemimeral
οὐδετέροις, ἶσον δὲ τέλος τέτατο πτολέμοιο.	-uu- -- u u- uu- uu--	dactylic hexameter	masculine penthemimeral, hepthemimeral, trithemimeral
ἀλλʼ ὅτε δὴ κείνοισι παρέσχεθεν ἄρμενα πάντα,	- uu - --u u-uu -uu --	dactylic hexameter	feminine penthemimeral, trithemimeral
νέκταρ τ᾽ἀμβροσίην τε, τά περ θεοὶ αὐτοὶ ἔδουσι,	-- -uu- u u - uu -u u--	dactylic hexameter	masculine penthemimeral, hepthemimeral
πάντων ἐν στήθεσσιν ἀέξετο θυμὸς ἀγήνωρ.	-- - --u u-uu -u u--	dactylic hexameter	feminine penthemimeral, trithemimeral
ὡς νέκταρ τ᾽ἐπάσαντο καὶ ἀμβροσίην ἐρατεινήν,	- -- uu-u u -uu- uu--	dactylic hexameter	feminine penthemimeral, trithemimeral
δὴ τότε τοῖς μετέειπε πατὴρ ἀνδρῶν τε θεῶν τε·	- uu - uu-u u- -- u u- -	dactylic hexameter	feminine penthemimeral, hepthemimeral, trithemimeral
κέκλυτε μευ, Γαίης τε καὶ Οὐρανοῦ ἀγλαὰ τέκνα,	-uu - -- u u -uu -uu --	dactylic hexameter	masculine penthemimeral, trithemimeral
ὄφρʼ εἴπω, τά με θυμὸς ἐνὶ στήθεσσι κελεύει.	- -- u u -u u- --u u--	dactylic hexameter	feminine penthemimeral, hepthemimeral, trithemimeral
ἤδη γὰρ μάλα δηρὸν ἐναντίοι ἀλλήλοισι	-- - uu -u u-uu ----	dactylic hexameter	feminine penthemimeral, trithemimeral
νίκης καὶ κράτεος πέρι μαρνάμεθʼ ἤματα πάντα	-- - uu- uu -uu -uu --	dactylic hexameter	masculine penthemimeral, trithemimeral
Τιτῆνές τε θεοὶ καὶ ὅσοι Κρόνου ἐκγενόμεσθα.	--- u u- u u- uu -uu--	dactylic hexameter	masculine penthemimeral, hepthemimeral, trithemimeral
ὑμεῖς δὲ μεγάλην τε βίην καὶ χεῖρας ἀάπτους	-- - uu- u u- - -u u--	dactylic hexameter	masculine penthemimeral, hepthemimeral, trithemimeral
φαίνετε Τιτήνεσσιν ἐναντίοι ἐν δαῒ λυγρῇ	-uu ---u u-uu - uu --	dactylic hexameter	feminine penthemimeral
μνησάμενοι φιλότητος ἐνηέος, ὅσσα παθόντες	-uu- uu-u u-uu -u u--	dactylic hexameter	feminine penthemimeral, trithemimeral
ἐς φάος ἂψ ἀφίκεσθε δυσηλεγέος ὑπὸ δεσμοῦ	- uu - uu-u u-uu- uu --	dactylic hexameter	feminine penthemimeral, trithemimeral
ἡμετέρας διὰ βουλὰς ὑπὸ ζόφου ἠερόεντος.	-uu- uu -u u- uu -uu--	dactylic hexameter	feminine penthemimeral, hepthemimeral, trithemimeral
ὣς φάτο· τὸν δ᾽ἐξαῦτις ἀμείβετο Κόττος ἀμύμων·	- uu - --u u-uu -u u--	dactylic hexameter	feminine penthemimeral, trithemimeral
Δαιμόνιʼ, οὐκ ἀδάητα πιφαύσκεαι· ἀλλὰ καὶ αὐτοὶ	-uu - uu-u u-uu -u u --	dactylic hexameter	feminine penthemimeral, trithemimeral
ἴδμεν, ὅ τοι περὶ μὲν πραπίδες, περὶ δ᾽ἐστὶ νόημα,	-u u - uu - uu- uu -u u--	dactylic hexameter	masculine penthemimeral, hepthemimeral, trithemimeral
ἀλκτὴρ δ᾽ἀθανάτοισιν ἀρῆς γένεο κρυεροῖο.	-- -uu-u u- uu- uu--	dactylic hexameter	feminine penthemimeral, hepthemimeral
σῇσι δ᾽ἐπιφροσύνῃσιν ὑπὸ ζόφου ἠερόεντος	-u u-uu-u u- uu -uu--	dactylic hexameter	feminine penthemimeral, hepthemimeral
ἄψορρον δʼ ἐξαῦτις ἀμειλίκτων ὑπὸ δεσμῶν	--- --u u--- uu --	dactylic hexameter	feminine penthemimeral, trithemimeral
ἠλύθομεν, Κρόνου υἱὲ ἄναξ, ἀνάελπτα παθόντες.	-uu- uu -u u- uu-u u--	dactylic hexameter	feminine penthemimeral, hepthemimeral, trithemimeral
τῷ καὶ νῦν ἀτενεῖ τε νόῳ καὶ ἐπίφρονι βουλῇ	- - - uu- u u- u u-uu --	dactylic hexameter	masculine penthemimeral, hepthemimeral, trithemimeral
ῥυσόμεθα κράτος ὑμὸν ἐν αἰνῇ δηϊοτῆτι	-uu- uu -u u -- -uu--	dactylic hexameter	feminine penthemimeral, trithemimeral
μαρνάμενοι Τιτῆσιν ἀνὰ κρατερὰς ὑσμίνας.	-uu- --u u- uu- ---	dactylic hexameter	feminine penthemimeral, hepthemimeral, trithemimeral
ὣς φάτʼ· ἐπῄνεσσαν δὲ θεοί, δωτῆρες ἐάων,	- u u--- u u- --u u--	dactylic hexameter	masculine penthemimeral, hepthemimeral
μῦθον ἀκούσαντες· πολέμου δ᾽ἐλιλαίετο θυμὸς	-u u--- uu- uu-uu --	dactylic hexameter	masculine penthemimeral, hepthemimeral
μᾶλλον ἔτʼ ἢ τὸ πάροιθε· μάχην δ᾽ἀμέγαρτον ἔγειραν	-u u - u u-u u- uu-u u--	dactylic hexameter	feminine penthemimeral, hepthemimeral, trithemimeral
πάντες, θήλειαι τε καὶ ἄρσενες, ἤματι κείνῳ,	-- --- u u -uu -uu --	dactylic hexameter	masculine penthemimeral
Τιτῆνές τε θεοὶ καὶ ὅσοι Κρόνου ἐξεγένοντο,	--- u u- u u- uu -uu--	dactylic hexameter	masculine penthemimeral, hepthemimeral, trithemimeral
οὕς τε Ζεὺς Ἐρέβευσφιν ὑπὸ χθονὸς ἧκε φόωσδε	- - - uu-u u- uu -u u--	dactylic hexameter	feminine penthemimeral, hepthemimeral, trithemimeral
δεινοί τε κρατεροί τε, βίην ὑπέροπλον ἔχοντες.	-- - uu- u u- uu-u u--	dactylic hexameter	masculine penthemimeral, hepthemimeral, trithemimeral
τῶν ἑκατὸν μὲν χεῖρες ἀπʼ ὤμων ἀίσσοντο	- uu- - -u u -- ----	dactylic hexameter	feminine penthemimeral, trithemimeral
πᾶσιν ὁμῶς, κεφαλαὶ δὲ ἑκάστῳ πεντήκοντα	-u u- uu- u u-- ----	dactylic hexameter	masculine penthemimeral, trithemimeral
ἐξ ὤμων ἐπέφυκον ἐπὶ στιβαροῖσι μέλεσσιν.	- -- uu-u u- uu-u u--	dactylic hexameter	feminine penthemimeral, hepthemimeral, trithemimeral
οἳ τότε Τιτήνεσσι κατέσταθεν ἐν δαῒ λυγρῇ	- uu ---u u-uu - uu --	dactylic hexameter	feminine penthemimeral
πέτρας ἠλιβάτους στιβαρῇς ἐν χερσὶν ἔχοντες.	-- -uu- uu- - -u u--	dactylic hexameter	masculine penthemimeral, hepthemimeral
Τιτῆνες δ᾽ἑτέρωθεν ἐκαρτύναντο φάλαγγας	--- uu-u u---u u--	dactylic hexameter	feminine penthemimeral, trithemimeral
προφρονέως, χειρῶν τε βίης θ᾽ἅμα ἔργον ἔφαινον	-uu- -- u u- uu -u u--	dactylic hexameter	masculine penthemimeral, hepthemimeral, trithemimeral
ἀμφότεροι· δεινὸν δὲ περίαχε πόντος ἀπείρων,	-uu- -- u u-uu -u u--	dactylic hexameter	masculine penthemimeral, trithemimeral
γῆ δὲ μέγʼ ἐσμαράγησεν, ἐπέστενε δ᾽οὐρανὸς εὐρὺς	- u u -uu-u u-uu -uu --	dactylic hexameter	feminine penthemimeral
σειόμενος, πεδόθεν δὲ τινάσσετο μακρὸς Ὄλυμπος	-uu- uu- u u-uu -u u--	dactylic hexameter	masculine penthemimeral, trithemimeral
ῥιπῇ ὕπʼ ἀθανάτων, ἔνοσις δ᾽ἵκανε βαρεῖα	-u u -uu- uu- uu- ---	dactylic hexameter	masculine penthemimeral, hepthemimeral
Τάρταρον ἠερόεντα, ποδῶν τ᾽αἰπεῖα ἰωὴ	-uu -uu-u u- --u u--	dactylic hexameter	feminine penthemimeral, hepthemimeral
ἀσπέτου ἰωχμοῖο βολάων τε κρατεράων·	-uu ---u u-- - uu--	dactylic hexameter	feminine penthemimeral
ὣς ἄρʼ ἐπʼ ἀλλήλοις ἵεσαν βέλεα στονόεντα.	- u u --- uu- uu- uu--	dactylic hexameter	masculine penthemimeral, hepthemimeral
φωνὴ δ᾽ἀμφοτέρων ἵκετʼ οὐρανὸν ἀστερόεντα	-- -uu- uu -uu -uu--	dactylic hexameter	masculine penthemimeral
κεκλομένων· οἳ δὲ ξύνισαν μεγάλῳ ἀλαλητῷ.	-uu- - - uu- uu- uu--	dactylic hexameter	masculine penthemimeral, hepthemimeral, trithemimeral
οὐδʼ ἄρʼ ἔτι Ζεὺς ἴσχεν ἑὸν μένος, ἀλλά νυ τοῦ γε	- u u- - -u u- uu -u u - -	dactylic hexameter	feminine penthemimeral, hepthemimeral, trithemimeral
εἶθαρ μὲν μένεος πλῆντο φρένες, ἐκ δέ τε πᾶσαν	-- - uu- -- uu - u u --	dactylic hexameter	masculine penthemimeral, hepthemimeral, trithemimeral
φαῖνε βίην· ἄμυδις δ᾽ἄρʼ ἀπʼ οὐρανοῦ ἠδʼ ἀπʼ Ὀλύμπου	-u u- uu- u u -uu - u u--	dactylic hexameter	masculine penthemimeral, trithemimeral
ἀστράπτων ἔστειχε συνωχαδόν· οἱ δὲ κεραυνοὶ	--- --u u-uu - u u--	dactylic hexameter	feminine penthemimeral, trithemimeral
ἴκταρ ἅμα βροντῇ τε καὶ ἀστεροπῇ ποτέοντο	-u u- -- u u -uu- uu--	dactylic hexameter	masculine penthemimeral, trithemimeral
χειρὸς ἄπο στιβαρῆς, ἱερὴν φλόγα εἰλυφόωντες	-u u- uu- uu- uu -uu--	dactylic hexameter	masculine penthemimeral, hepthemimeral, trithemimeral
ταρφέες· ἀμφὶ δὲ γαῖα φερέσβιος ἐσμαράγιζε	-uu -u u -u u-uu -uu--	dactylic hexameter	feminine penthemimeral
καιομένη, λάκε δ᾽ἀμφὶ πυρὶ μεγάλʼ ἄσπετος ὕλη.	-uu- uu -u u- uu -uu --	dactylic hexameter	feminine penthemimeral, hepthemimeral, trithemimeral
ἔζεε δὲ χθὼν πᾶσα καὶ Ὠκεανοῖο ῥέεθρα	-uu - - -u u -uu-u u--	dactylic hexameter	feminine penthemimeral, trithemimeral
πόντος τ᾽ἀτρύγετος· τοὺς δ᾽ἄμφεπε θερμὸς ἀυτμὴ	-- -uu- - -uu -u u--	dactylic hexameter	masculine penthemimeral
Τιτῆνας χθονίους, φλὸξ δ᾽αἰθέρα δῖαν ἵκανεν	--- uu- - -uu -u u--	dactylic hexameter	masculine penthemimeral, trithemimeral
ἄσπετος, ὄσσε δ᾽ἄμερδε καὶ ἰφθίμων περ ἐόντων	-uu -u u-u u --- u u--	dactylic hexameter	feminine penthemimeral
αὐγὴ μαρμαίρουσα κεραυνοῦ τε στεροπῆς τε.	-- ---u u-- - uu- -	dactylic hexameter	feminine penthemimeral
καῦμα δὲ θεσπέσιον κάτεχεν Χάος· εἴσατο δ᾽ἄντα	-u u -uu- uu- uu -uu --	dactylic hexameter	masculine penthemimeral, hepthemimeral
ὀφθαλμοῖσιν ἰδεῖν ἠδʼ οὔασι ὄσσαν ἀκοῦσαι	---u u- - -uu -u u--	dactylic hexameter	masculine penthemimeral
αὔτως, ὡς εἰ Γαῖα καὶ Οὐρανὸς εὐρὺς ὕπερθε	-- - - -u u -uu -u u--	dactylic hexameter	feminine penthemimeral, trithemimeral
πίλνατο· τοῖος γάρ κε μέγας ὑπὸ δοῦπος ὀρώρει	-uu -- - u u- uu -u u--	dactylic hexameter	masculine penthemimeral, hepthemimeral
τῆς μὲν ἐρειπομένης, τοῦ δ᾽ὑψόθεν ἐξεριπόντος·	- u u-uu- - -uu -uu--	dactylic hexameter	masculine penthemimeral
τόσσος δοῦπος ἔγεντο θεῶν ἔριδι ξυνιόντων.	-- -u u-u u- uu- uu--	dactylic hexameter	feminine penthemimeral, hepthemimeral
σὺν δ᾽ἄνεμοι ἔνοσίν τε κονίην τ᾽ἐσφαράγιζον	- uu- uu- u u-- -uu--	dactylic hexameter	masculine penthemimeral, trithemimeral
βροντήν τε στεροπήν τε καὶ αἰθαλόεντα κεραυνόν,	-- - uu- u u -uu-u u--	dactylic hexameter	masculine penthemimeral, trithemimeral
κῆλα Διὸς μεγάλοιο, φέρον δ᾽ἰαχήν τ᾽ἐνοπήν τε	-u u- uu-u u- uu- uu- -	dactylic hexameter	feminine penthemimeral, hepthemimeral, trithemimeral
ἐς μέσον ἀμφοτέρων· ὄτοβος δ᾽ἄπλητος ὀρώρει	- uu -uu- uu- --u u--	dactylic hexameter	masculine penthemimeral, hepthemimeral
σμερδαλέης ἔριδος, κάρτος δ᾽ἀνεφαίνετο ἔργων.	-uu- uu- -- uu-uu --	dactylic hexameter	masculine penthemimeral, hepthemimeral, trithemimeral
ἐκλίνθη δὲ μάχη· πρὶν δ᾽ἀλλήλοις ἐπέχοντες	--- u u- - --- uu--	dactylic hexameter	masculine penthemimeral, trithemimeral
ἐμμενέως ἐμάχοντο διὰ κρατερὰς ὑσμίνας.	-uu- uu-u u- uu- ---	dactylic hexameter	feminine penthemimeral, hepthemimeral, trithemimeral
οἳ δ᾽ἄρʼ ἐνὶ πρώτοισι μάχην δριμεῖαν ἔγειραν	- u u- --u u- --u u--	dactylic hexameter	feminine penthemimeral, hepthemimeral, trithemimeral
Κόττος τε Βριάρεώς τε Γύης τ᾽ἄατος πολέμοιο,	-- - uu- u u- uu- uu--	dactylic hexameter	masculine penthemimeral, hepthemimeral, trithemimeral
οἵ ῥα τριηκοσίας πέτρας στιβαρῶν ἀπὸ χειρῶν	- u u-uu- -- uu- uu --	dactylic hexameter	masculine penthemimeral, hepthemimeral
πέμπον ἐπασσυτέρας, κατὰ δ᾽ἐσκίασαν βελέεσσι	-u u-uu- uu -uu- uu--	dactylic hexameter	masculine penthemimeral
Τιτῆνας, καὶ τοὺς μὲν ὑπὸ χθονὸς εὐρυοδείης	--- - - u u- uu -uu--	dactylic hexameter	masculine penthemimeral, hepthemimeral, trithemimeral
πέμψαν καὶ δεσμοῖσιν ἐν ἀργαλέοισιν ἔδησαν	-- - --u u -uu-u u--	dactylic hexameter	feminine penthemimeral, trithemimeral
χερσὶν νικήσαντες ὑπερθύμους περ ἐόντας,	-- ---u u--- u u--	dactylic hexameter	feminine penthemimeral
τόσσον ἔνερθʼ ὑπὸ γῆς, ὅσον οὐρανός ἐστʼ ἀπὸ γαίης·	-u u- uu - uu -uu - uu --	dactylic hexameter	masculine penthemimeral, trithemimeral
τόσσον γάρ τ᾽ἀπὸ γῆς ἐς Τάρταρον ἠερόεντα.	-- - uu - - -uu -uu--	dactylic hexameter	masculine penthemimeral, trithemimeral
ἐννέα γὰρ νύκτας τε καὶ ἤματα χάλκεος ἄκμων	-uu - -- u u -uu -uu --	dactylic hexameter	masculine penthemimeral, trithemimeral
οὐρανόθεν κατιὼν δεκάτῃ κ᾽ἐς γαῖαν ἵκοιτο·	-uu- uu- uu- - -u u--	dactylic hexameter	masculine penthemimeral, hepthemimeral, trithemimeral
ἐννέα δ᾽αὖ νύκτας τε καὶ ἤματα χάλκεος ἄκμων	-uu - -- u u -uu -uu --	dactylic hexameter	masculine penthemimeral, trithemimeral
ἐκ γαίης κατιὼν δεκάτῃ κ᾽ἐς Τάρταρον ἵκοι.	- -- uu- uu- - -uu --	dactylic hexameter	masculine penthemimeral, hepthemimeral, trithemimeral
τὸν πέρι χάλκεον ἕρκος ἐλήλαται· ἀμφὶ δέ μιν νὺξ	- uu -uu -u u-uu -u u - -	dactylic hexameter	feminine penthemimeral
τριστοιχεὶ κέχυται περὶ δειρήν· αὐτὰρ ὕπερθεν	--- uu- uu -- -u u--	dactylic hexameter	masculine penthemimeral, trithemimeral
γῆς ῥίζαι πεφύασι καὶ ἀτρυγέτοιο θαλάσσης.	- -- uu-u u -uu-u u--	dactylic hexameter	feminine penthemimeral, trithemimeral
ἔνθα θεοὶ Τιτῆνες ὑπὸ ζόφῳ ἠερόεντι	-u u- --u u- uu -uu--	dactylic hexameter	feminine penthemimeral, hepthemimeral, trithemimeral
κεκρύφαται βουλῇσι Διὸς νεφεληγερέταο	-uu- --u u- uu-uu--	dactylic hexameter	feminine penthemimeral, hepthemimeral, trithemimeral
χώρῳ ἐν εὐρώεντι, πελώρης ἔσχατα γαίης.	-u u ---u u-- -uu --	dactylic hexameter	feminine penthemimeral
τοῖς οὐκ ἐξιτόν ἐστι. θύρας δ᾽ἐπέθηκε Ποσειδέων	- - -uu -u u- uu-u u--	dactylic hexameter	feminine penthemimeral, hepthemimeral
χαλκείας, τεῖχος δὲ περοίχεται ἀμφοτέρωθεν.	--- -- u u-uu -uu--	dactylic hexameter	masculine penthemimeral, trithemimeral
ἔνθα Γύης Κόττος τε καὶ Ὀβριάρεως μεγάθυμος	-u u- -- u u -uu- uu--	dactylic hexameter	masculine penthemimeral, trithemimeral
ναίουσιν, φύλακες πιστοὶ Διὸς αἰγιόχοιο.	--- uu- -- uu -uu--	dactylic hexameter	masculine penthemimeral, hepthemimeral, trithemimeral
ἔνθα δὲ γῆς δνοφερῆς καὶ Ταρτάρου ἠερόεντος	-u u - uu- - -uu -uu--	dactylic hexameter	masculine penthemimeral, trithemimeral
πόντου τ᾽ἀτρυγέτοιο καὶ οὐρανοῦ ἀστερόεντος	-- -uu-u u -uu -uu--	dactylic hexameter	feminine penthemimeral
ἑξείης πάντων πηγαὶ καὶ πείρατʼ ἔασιν	--- -- -- - -u u--	dactylic hexameter	masculine penthemimeral, hepthemimeral, trithemimeral
ἀργαλέʼ εὐρώεντα, τά τε στυγέουσι θεοί περ,	-uu ---u u - uu-u u- -	dactylic hexameter	feminine penthemimeral, hepthemimeral
χάσμα μέγʼ, οὐδέ κε πάντα τελεσφόρον εἰς ἐνιαυτὸν	-u u -u u -u u-uu - uu--	dactylic hexameter	feminine penthemimeral
οὖδας ἵκοιτʼ, εἰ πρῶτα πυλέων ἔντοσθε γένοιτο,	-u u- - -u u- --u u--	dactylic hexameter	feminine penthemimeral, hepthemimeral, trithemimeral
ἀλλά κεν ἔνθα καὶ ἔνθα φέροι πρὸ θύελλα θυέλλῃ	-u u -u u -u u- u u-u u--	dactylic hexameter	feminine penthemimeral, hepthemimeral
ἀργαλέη· δεινὸν δὲ καὶ ἀθανάτοισι θεοῖσι	-uu- -- u u -uu-u u--	dactylic hexameter	masculine penthemimeral, trithemimeral
τοῦτο τέρας. Νυκτὸς δ᾽ἐρεβεννῆς οἰκία δεινὰ	-u u- -- uu-- -uu --	dactylic hexameter	masculine penthemimeral, trithemimeral
ἕστηκεν νεφέλῃς κεκαλυμμένα κυανέῃσιν.	--- uu- uu-uu -uu--	dactylic hexameter	masculine penthemimeral, trithemimeral
τῶν πρόσθʼ Ἰαπετοῖο πάις ἔχει οὐρανὸν εὐρὺν	- - -uu-u u- uu -uu --	dactylic hexameter	feminine penthemimeral, hepthemimeral
ἑστηὼς κεφαλῇ τε καὶ ἀκαμάτῃσι χέρεσσιν	--- uu- u u -uu-u u--	dactylic hexameter	masculine penthemimeral, trithemimeral
ἀστεμφέως, ὅθι Νύξ τε καὶ Ἡμέρη ἆσσον ἰοῦσαι	--- uu - u u -uu -u u--	dactylic hexameter	masculine penthemimeral, trithemimeral
ἀλλήλας προσέειπον, ἀμειβόμεναι μέγαν οὐδὸν	--- uu-u u-uu- uu --	dactylic hexameter	feminine penthemimeral, trithemimeral
χάλκεον· ἣ μὲν ἔσω καταβήσεται, ἣ δὲ θύραζε	-uu - u u- uu-uu - u u--	dactylic hexameter	masculine penthemimeral, trithemimeral
ἔρχεται, οὐδέ ποτʼ ἀμφοτέρας δόμος ἐντὸς ἐέργει,	-uu -u u -uu- uu -u u--	dactylic hexameter	hepthemimeral
ἀλλʼ αἰεὶ ἑτέρη γε δόμων ἔκτοσθεν ἐοῦσα	- -- uu- u u- --u u--	dactylic hexameter	masculine penthemimeral, hepthemimeral, trithemimeral
γαῖαν ἐπιστρέφεται, ἣ δ᾽αὖ δόμου ἐντὸς ἐοῦσα	-u u-uu- - - uu -u u--	dactylic hexameter	masculine penthemimeral, hepthemimeral
μίμνει τὴν αὐτῆς ὥρην ὁδοῦ, ἔστʼ ἂν ἵκηται,	-- - -- -- uu - u u--	dactylic hexameter	masculine penthemimeral, hepthemimeral, trithemimeral
ἣ μὲν ἐπιχθονίοισι φάος πολυδερκὲς ἔχουσα,	- u u-uu-u u- uu-u u--	dactylic hexameter	feminine penthemimeral, hepthemimeral
ἣ δ᾽Ὕπνον μετὰ χερσί, κασίγνητον Θανάτοιο.	- -- uu -u u--- uu--	dactylic hexameter	feminine penthemimeral, trithemimeral
Νὺξ ὀλοή, νεφέλῃ κεκαλυμμένη ἠεροειδεῖ.	- uu- uu- uu-uu -uu--	dactylic hexameter	masculine penthemimeral, trithemimeral
ἔνθα δὲ Νυκτὸς παῖδες ἐρεμνῆς οἰκίʼ ἔχουσιν,	-u u -- -u u-- -u u--	dactylic hexameter	feminine penthemimeral
Ὕπνος καὶ Θάνατος, δεινοὶ θεοί· οὐδέ ποτʼ αὐτοὺς	-- - uu- -- - -u u --	dactylic hexameter	masculine penthemimeral, hepthemimeral, trithemimeral
Ἠέλιος φαέθων ἐπιδέρκεται ἀκτίνεσσιν	-uu- uu- uu-uu ----	dactylic hexameter	masculine penthemimeral, trithemimeral
οὐρανὸν εἲς ἀνιὼν οὐδʼ οὐρανόθεν καταβαίνων.	-uu - uu- - -uu- uu--	dactylic hexameter	masculine penthemimeral, trithemimeral
τῶν δ᾽ἕτερος γαῖάν τε καὶ εὐρέα νῶτα θαλάσσης	- uu- -- u u -uu -u u--	dactylic hexameter	masculine penthemimeral, trithemimeral
ἥσυχος ἀνστρέφεται καὶ μείλιχος ἀνθρώποισι,	-uu -uu- - -uu ----	dactylic hexameter	masculine penthemimeral
τοῦ δὲ σιδηρέη μὲν κραδίη, χάλκεον δέ οἱ ἦτορ	- u u-- - uu- -- u u --	dactylic hexameter	masculine penthemimeral, hepthemimeral
νηλεὲς ἐν στήθεσσιν· ἔχει δ᾽ὃν πρῶτα λάβῃσιν	-uu - --u u- - -u u--	dactylic hexameter	feminine penthemimeral, hepthemimeral, trithemimeral
ἀνθρώπων· ἐχθρὸς δὲ καὶ ἀθανάτοισι θεοῖσιν.	--- -- u u -uu-u u--	dactylic hexameter	masculine penthemimeral, trithemimeral
ἔνθα θεοῦ χθονίου πρόσθεν δόμοι ἠχήεντες	-u u- uu- -- uu ----	dactylic hexameter	masculine penthemimeral, hepthemimeral, trithemimeral
ἰφθίμου τ᾽Ἀίδεω καὶ ἐπαινῆς Περσεφονείης	--- uu- u u-- -uu--	dactylic hexameter	masculine penthemimeral, trithemimeral
ἑστᾶσιν, δεινὸς δὲ κύων προπάροιθε φυλάσσει	--- -- u u- uu-u u--	dactylic hexameter	masculine penthemimeral, hepthemimeral, trithemimeral
νηλειής, τέχνην δὲ κακὴν ἔχει· ἐς μὲν ἰόντας	--- -- u u- uu - u u--	dactylic hexameter	masculine penthemimeral, hepthemimeral, trithemimeral
σαίνει ὁμῶς οὐρῇ τε καὶ οὔασιν ἀμφοτέροισιν,	-u u- -- u u -uu -uu--	dactylic hexameter	masculine penthemimeral, trithemimeral
ἐξελθεῖν δ᾽οὐκ αὖτις ἐᾷ πάλιν, ἀλλὰ δοκεύων	--- - -u u- uu -u u--	dactylic hexameter	feminine penthemimeral, hepthemimeral, trithemimeral
ἐσθίει, ὅν κε λάβῃσι πυλέων ἔκτοσθεν ἰόντα.	-uu - u u-u u- --u u--	dactylic hexameter	feminine penthemimeral, hepthemimeral, trithemimeral
[ἰφθίμου τ᾽Ἀίδεω καὶ ἐπαινῆς Περσεφονείης.	--- uu- u u-- -uu--	dactylic hexameter	masculine penthemimeral, trithemimeral
ἔνθα δὲ ναιετάει στυγερὴ θεὸς ἀθανάτοισι,	-u u -uu- uu- uu -uu--	dactylic hexameter	masculine penthemimeral, hepthemimeral
δεινὴ Στύξ, θυγάτηρ ἀψορρόου Ὠκεανοῖο	-- - uu- --uu -uu--	dactylic hexameter	masculine penthemimeral, trithemimeral
πρεσβυτάτη· νόσφιν δὲ θεῶν κλυτὰ δώματα ναίει	-uu- -- u u- uu -uu --	dactylic hexameter	masculine penthemimeral, hepthemimeral, trithemimeral
μακρῇσιν πέτρῃσι κατηρεφέʼ· ἀμφὶ δὲ πάντη	--- --u u-uu -u u --	dactylic hexameter	feminine penthemimeral, trithemimeral
κίοσιν ἀργυρέοισι πρὸς οὐρανὸν ἐστήρικται.	-uu -uu-u u -uu ----	dactylic hexameter	feminine penthemimeral
παῦρα δὲ Θαύμαντος θυγάτηρ πόδας ὠκέα Ἶρις	-u u --- uu- uu -uu --	dactylic hexameter	masculine penthemimeral, hepthemimeral
ἀγγελίην πωλεῖται ἐπʼ εὐρέα νῶτα θαλάσσης.	-uu- --u u -uu -u u--	dactylic hexameter	feminine penthemimeral, trithemimeral
ὁππότʼ ἔρις καὶ νεῖκος ἐν ἀθανάτοισιν ὄρηται	-u u- - -u u -uu-u u--	dactylic hexameter	feminine penthemimeral, trithemimeral
καί ῥ᾽ὅστις ψεύδηται Ὀλύμπια δώματʼ ἐχόντων,	- -- --u u-uu -u u--	dactylic hexameter	feminine penthemimeral, trithemimeral
Ζεὺς δέ τε Ἶριν ἔπεμψε θεῶν μέγαν ὅρκον ἐνεῖκαι	- u u -u u-u u- uu -u u--	dactylic hexameter	feminine penthemimeral, hepthemimeral
τηλόθεν ἐν χρυσέῃ προχόῳ πολυώνυμον ὕδωρ	-uu - uu- uu- uu-uu --	dactylic hexameter	masculine penthemimeral, hepthemimeral, trithemimeral
ψυχρόν, ὅτʼ ἐκ πέτρης καταλείβεται ἠλιβάτοιο	-u u - -- uu-uu -uu--	dactylic hexameter	masculine penthemimeral, trithemimeral
ὑψηλῆς· πολλὸν δὲ ὑπὸ χθονὸς εὐρυοδείης	--- -- u u- uu -uu--	dactylic hexameter	masculine penthemimeral, hepthemimeral, trithemimeral
ἐξ ἱεροῦ ποταμοῖο ῥέει διὰ νύκτα μέλαιναν	- uu- uu-u u- uu -u u--	dactylic hexameter	feminine penthemimeral, hepthemimeral, trithemimeral
Ὠκεανοῖο κέρας· δεκάτη δ᾽ἐπὶ μοῖρα δέδασται·	-uu-u u- uu- uu -u u--	dactylic hexameter	masculine penthemimeral, hepthemimeral
ἐννέα μὲν περὶ γῆν τε καὶ εὐρέα νῶτα θαλάσσης	-uu - uu - u u -uu -u u--	dactylic hexameter	masculine penthemimeral, trithemimeral
δίνῃς ἀργυρέῃς εἱλιγμένος εἰς ἅλα πίπτει,	-- -uu- --uu - uu --	dactylic hexameter	masculine penthemimeral
ἣ δὲ μίʼ ἐκ πέτρης προρέει μέγα πῆμα θεοῖσιν.	- u u - -- uu- uu -u u--	dactylic hexameter	masculine penthemimeral, hepthemimeral, trithemimeral
ὅς κεν τὴν ἐπίορκον ἀπολλείψας ἐπομόσσῃ	- - - uu-u u--- uu--	dactylic hexameter	feminine penthemimeral, trithemimeral
ἀθανάτων, οἳ ἔχουσι κάρη νιφόεντος Ὀλύμπου,	-uu- u u-u u- uu-u u--	dactylic hexameter	feminine penthemimeral, hepthemimeral, trithemimeral
κεῖται νήυτμος τετελεσμένον εἰς ἐνιαυτόν·	-- -- ---uu - uu--	dactylic hexameter	
οὐδέ ποτʼ ἀμβροσίης καὶ νέκταρος ἔρχεται ἆσσον	-u u -uu- - -uu -uu --	dactylic hexameter	masculine penthemimeral
βρώσιος, ἀλλά τε κεῖται ἀνάπνευστος καὶ ἄναυδος	-uu -u u -u u--- u u--	dactylic hexameter	feminine penthemimeral
στρωτοῖς ἐν λεχέεσσι, κακὸν δέ ἑ κῶμα καλύπτει.	-- - uu-u u- u u -u u--	dactylic hexameter	feminine penthemimeral, hepthemimeral, trithemimeral
αὐτὰρ ἐπεὶ νοῦσον τελέσῃ μέγαν εἰς ἐνιαυτόν,	-u u- -- uu- uu - uu--	dactylic hexameter	masculine penthemimeral, hepthemimeral, trithemimeral
ἄλλος γ᾽ἐξ ἄλλου δέχεται χαλεπώτερος ἄεθλος.	-- - -- uu- uu-uu --	dactylic hexameter	masculine penthemimeral, hepthemimeral, trithemimeral
εἰνάετες δὲ θεῶν ἀπαμείρεται αἰὲν ἐόντων,	-uu- u u- uu-uu -u u--	dactylic hexameter	masculine penthemimeral, trithemimeral
οὐδέ ποτʼ ἐς βουλὴν ἐπιμίσγεται οὐδʼ ἐπὶ δαῖτας	-u u - -- uu-uu - uu --	dactylic hexameter	masculine penthemimeral, trithemimeral
ἐννέα πάντα ἔτεα· δεκάτῳ δ᾽ἐπιμίσγεται αὖτις	-uu -u u- uu- uu-uu --	dactylic hexameter	masculine penthemimeral, hepthemimeral
εἴρας ἐς ἀθανάτων, οἳ Ὀλύμπια δώματʼ ἔχουσιν.	-u u -uu- u u-uu -u u--	dactylic hexameter	masculine penthemimeral
τοῖον ἄρʼ ὅρκον ἔθεντο θεοὶ Στυγὸς ἄφθιτον ὕδωρ	-u u -u u-u u- uu -uu --	dactylic hexameter	feminine penthemimeral, hepthemimeral
ὠγύγιον, τὸ δ᾽ἵησι καταστυφέλου διὰ χώρου.	-uu- u u-u u-uu- uu --	dactylic hexameter	feminine penthemimeral, trithemimeral
ἔνθα δὲ γῆς δνοφερῆς καὶ Ταρτάρου ἠερόεντος	-u u - uu- - -uu -uu--	dactylic hexameter	masculine penthemimeral, trithemimeral
πόντου τ᾽ἀτρυγέτοιο καὶ οὐρανοῦ ἀστερόεντος	-- -uu-u u -uu -uu--	dactylic hexameter	feminine penthemimeral
ἑξείης πάντων πηγαὶ καὶ πείρατʼ ἔασιν	--- -- -- - -u u--	dactylic hexameter	masculine penthemimeral, hepthemimeral, trithemimeral
ἀργαλέʼ εὐρώεντα, τά τε στυγέουσι θεοί περ.	-uu ---u u - uu-u u- -	dactylic hexameter	feminine penthemimeral, hepthemimeral
ἔνθα δὲ μαρμάρεαί τε πύλαι καὶ χάλκεος οὐδὸς	-u u -uu- u u- - -uu --	dactylic hexameter	masculine penthemimeral, hepthemimeral
ἀστεμφής, ῥίζῃσι διηνεκέεσσιν ἀρηρώς,	--- --u u-uu-u u--	dactylic hexameter	feminine penthemimeral, trithemimeral
αὐτοφυής· πρόσθεν δὲ θεῶν ἔκτοσθεν ἁπάντων	-uu- -- u u- --u u--	dactylic hexameter	masculine penthemimeral, hepthemimeral, trithemimeral
Τιτῆνες ναίουσι, πέρην Χάεος ζοφεροῖο.	--- --u u- uu- uu--	dactylic hexameter	feminine penthemimeral, hepthemimeral, trithemimeral
αὐτὰρ ἐρισμαράγοιο Διὸς κλειτοὶ ἐπίκουροι	-u u-uu-u u- -- uu--	dactylic hexameter	feminine penthemimeral, hepthemimeral
δώματα ναιετάουσιν ἐπʼ Ὠκεανοῖο θεμέθλοις,	-uu -uu-u u -uu-u u--	dactylic hexameter	feminine penthemimeral
Κόττος τ᾽ἠδὲ Γύης· Βριάρεών γε μὲν ἠὺν ἐόντα	-- -u u- uu- u u -u u--	dactylic hexameter	masculine penthemimeral, hepthemimeral
γαμβρὸν ἑὸν ποίησε βαρύκτυπος Ἐννοσίγαιος,	-u u- --u u-uu -uu--	dactylic hexameter	feminine penthemimeral, trithemimeral
δῶκε δὲ Κυμοπόλειαν ὀπυίειν, θυγατέρα ἥν.	-u u -uu-u u-- -uu- -	dactylic hexameter	feminine penthemimeral
αὐτὰρ ἐπεὶ Τιτῆνας ἀπʼ οὐρανοῦ ἐξέλασεν Ζεύς,	-u u- --u u -uu -uu- -	dactylic hexameter	feminine penthemimeral, trithemimeral
ὁπλότατον τέκε παῖδα Τυφωέα Γαῖα πελώρη	-uu- uu -u u-uu -u u--	dactylic hexameter	feminine penthemimeral, trithemimeral
Ταρτάρου ἐν φιλότητι διὰ χρυσέην Ἀφροδίτην·	-uu - uu-u u- uu- uu--	dactylic hexameter	feminine penthemimeral, hepthemimeral, trithemimeral
οὗ χεῖρες μὲν ἔασιν ἐπʼ ἰσχύι, ἔργματʼ ἔχουσαι,	- -- u u-u u -- -u u--	dactylic hexameter	feminine penthemimeral, trithemimeral
καὶ πόδες ἀκάματοι κρατεροῦ θεοῦ· ἐκ δέ οἱ ὤμων	- uu -uu- uu- uu - u u --	dactylic hexameter	masculine penthemimeral, hepthemimeral
ἣν ἑκατὸν κεφαλαὶ ὄφιος, δεινοῖο δράκοντος,	- uu- uu- uu- --u u--	dactylic hexameter	masculine penthemimeral, hepthemimeral, trithemimeral
γλώσσῃσιν δνοφερῇσι λελιχμότες, ἐκ δέ οἱ ὄσσων	--- uu-u u-uu - u u --	dactylic hexameter	feminine penthemimeral, trithemimeral
θεσπεσίῃς κεφαλῇσιν ὑπʼ ὀφρύσι πῦρ ἀμάρυσσεν·	-uu- uu-u u -uu - uu--	dactylic hexameter	feminine penthemimeral, trithemimeral
πασέων δ᾽ἐκ κεφαλέων πῦρ καίετο δερκομένοιο·	-- - -u- - -uu -uu--	lyric	
φωναὶ δ᾽ἐν πάσῃσιν ἔσαν δεινῇς κεφαλῇσι	-- - --u u- -- uu--	dactylic hexameter	feminine penthemimeral, hepthemimeral, trithemimeral
παντοίην ὄπʼ ἰεῖσαι ἀθέσφατον· ἄλλοτε μὲν γὰρ	--- u u-u u-uu -uu - -	dactylic hexameter	feminine penthemimeral, trithemimeral
φθέγγονθʼ ὥστε θεοῖσι συνιέμεν, ἄλλοτε δ᾽αὖτε	-- -u u-u u-uu -uu --	dactylic hexameter	feminine penthemimeral
ταύρου ἐριβρύχεω, μένος ἀσχέτου, ὄσσαν ἀγαύρου,	-u u-uu- uu -uu -u u--	dactylic hexameter	masculine penthemimeral
ἄλλοτε δ᾽αὖτε λέοντος ἀναιδέα θυμὸν ἔχοντος,	-uu -u u-u u-uu -u u--	dactylic hexameter	feminine penthemimeral
ἄλλοτε δ᾽αὖ σκυλάκεσσιν ἐοικότα, θαύματʼ ἀκοῦσαι,	-uu - uu-u u-uu -u u--	dactylic hexameter	feminine penthemimeral, trithemimeral
ἄλλοτε δ᾽αὖ ῥοίζεσχʼ, ὑπὸ δ᾽ἤχεεν οὔρεα μακρά.	-uu - -- uu -uu -uu --	dactylic hexameter	masculine penthemimeral, trithemimeral
καί νύ κεν ἔπλετο ἔργον ἀμήχανον ἤματι κείνῳ	- u u -uu -u u-uu -uu --	dactylic hexameter	feminine penthemimeral
καί κεν ὅ γε θνητοῖσι καὶ ἀθανάτοισιν ἄναξεν,	- u u - --u u -uu-u u--	dactylic hexameter	feminine penthemimeral, trithemimeral
εἰ μὴ ἄρʼ ὀξὺ νόησε πατὴρ ἀνδρῶν τε θεῶν τε.	- u u -u u-u u- -- u u- -	dactylic hexameter	feminine penthemimeral, hepthemimeral
σκληρὸν δ᾽ἐβρόντησε καὶ ὄβριμον, ἀμφὶ δὲ γαῖα	-- ---u u -uu -u u --	dactylic hexameter	feminine penthemimeral
σμερδαλέον κονάβησε καὶ οὐρανὸς εὐρὺς ὕπερθε	-uu- uu-u u -uu -u u--	dactylic hexameter	feminine penthemimeral, trithemimeral
πόντος τ᾽Ὠκεανοῦ τε ῥοαὶ καὶ Τάρταρα γαίης.	-- -uu- u u- - -uu --	dactylic hexameter	masculine penthemimeral, hepthemimeral
ποσσὶ δ᾽ὕπʼ ἀθανάτοισι μέγας πελεμίζετʼ Ὄλυμπος	-u u -uu-u u- uu-u u--	dactylic hexameter	feminine penthemimeral, hepthemimeral
ὀρνυμένοιο ἄνακτος· ἐπεστενάχιζε δὲ γαῖα.	-uu-u u-u u-uu-u u --	dactylic hexameter	feminine penthemimeral
καῦμα δ᾽ὑπʼ ἀμφοτέρων κάτεχεν ἰοειδέα πόντον	-u u -uu- uu- uu-uu --	dactylic hexameter	masculine penthemimeral, hepthemimeral
βροντῆς τε στεροπῆς τε, πυρός τ᾽ἀπὸ τοῖο πελώρου,	-- - uu- u u- uu -u u--	dactylic hexameter	masculine penthemimeral, hepthemimeral, trithemimeral
πρηστήρων ἀνέμων τε κεραυνοῦ τε φλεγέθοντος.	--- uu- u u-- - uu--	dactylic hexameter	masculine penthemimeral, trithemimeral
ἔζεε δὲ χθὼν πᾶσα καὶ οὐρανὸς ἠδὲ θάλασσα·	-uu - - -u u -uu -u u--	dactylic hexameter	feminine penthemimeral, trithemimeral
θυῖε δ᾽ἄρʼ ἀμφʼ ἀκτὰς περί τ᾽ἀμφί τε κύματα μακρὰ	-u u - -- uu -u u -uu --	dactylic hexameter	masculine penthemimeral, trithemimeral
ῥιπῇ ὕπʼ ἀθανάτων, ἔνοσις δ᾽ἄσβεστος ὀρώρει·	-u u -uu- uu- --u u--	dactylic hexameter	masculine penthemimeral, hepthemimeral
τρέε δ᾽Ἀίδης, ἐνέροισι καταφθιμένοισιν ἀνάσσων,	- uu- uu-u u-uu-u u--	dactylic hexameter	feminine penthemimeral, trithemimeral
Τιτῆνές θ᾽ὑποταρτάριοι, Κρόνον ἀμφὶς ἐόντες,	--- uu-uu- uu -u u--	dactylic hexameter	hepthemimeral, trithemimeral
ἀσβέστου κελάδοιο καὶ αἰνῆς δηιοτῆτος.	--- uu-u u -- -uu--	dactylic hexameter	feminine penthemimeral, trithemimeral
Ζεὺς δ᾽ἐπεὶ οὖν κόρθυνεν ἑὸν μένος, εἵλετο δ᾽ὅπλα,	- uu - --u u- uu -uu --	dactylic hexameter	feminine penthemimeral, hepthemimeral, trithemimeral
βροντήν τε στεροπήν τε καὶ αἰθαλόεντα κεραυνόν,	-- - uu- u u -uu-u u--	dactylic hexameter	masculine penthemimeral, trithemimeral
πλῆξεν ἀπʼ Οὐλύμποιο ἐπάλμενος· ἀμφὶ δὲ πάσας	-u u ---u u-uu -u u --	dactylic hexameter	feminine penthemimeral
ἔπρεσε θεσπεσίας κεφαλὰς δεινοῖο πελώρου.	-uu -uu- uu- --u u--	dactylic hexameter	masculine penthemimeral, hepthemimeral
αὐτὰρ ἐπεὶ δή μιν δάμασεν πληγῇσιν ἱμάσσας,	-u u- - - uu- --u u--	dactylic hexameter	masculine penthemimeral, hepthemimeral, trithemimeral
ἤριπε γυιωθείς, στενάχιζε δὲ γαῖα πελώρη.	-uu --- uu-u u -u u--	dactylic hexameter	masculine penthemimeral
φλὸξ δὲ κεραυνωθέντος ἀπέσσυτο τοῖο ἄνακτος	- u u---u u-uu -u u--	dactylic hexameter	feminine penthemimeral
οὔρεος ἐν βήσσῃσιν ἀιδνῇς παιπαλοέσσῃς,	-uu - --- -- -uu--	dactylic hexameter	trithemimeral
πληγέντος. πολλὴ δὲ πελώρη καίετο γαῖα	--- -- u u-- -uu --	dactylic hexameter	masculine penthemimeral, trithemimeral
ἀτμῇ θεσπεσίῃ καὶ ἐτήκετο κασσίτερος ὣς	-- -uu- u u-uu -uu- -	dactylic hexameter	masculine penthemimeral
τέχνῃ ὕπʼ αἰζηῶν ἐν ἐυτρήτοις χοάνοισι	-u u --- u u--- uu--	dactylic hexameter	masculine penthemimeral
θαλφθείς, ἠὲ σίδηρος, ὅ περ κρατερώτατός ἐστιν.	-- -u u-u u - uu-uu --	dactylic hexameter	feminine penthemimeral, hepthemimeral
οὔρεος ἐν βήσσῃσι δαμαζόμενος πυρὶ κηλέῳ	-uu - --u u-uu- uu --	dactylic hexameter	feminine penthemimeral, trithemimeral
τήκεται ἐν χθονὶ δίῃ ὑφʼ Ἡφαιστου παλάμῃσιν.	-uu - uu -u u --- uu--	dactylic hexameter	feminine penthemimeral, trithemimeral
ὣς ἄρα τήκετο γαῖα σέλαι πυρὸς αἰθομένοιο.	- uu -uu -u u- uu -uu--	dactylic hexameter	feminine penthemimeral, hepthemimeral
ῥῖψε δέ μιν θυμῷ ἀκαχὼν ἐς Τάρταρον εὐρύν.	-u u - -- uu- - -uu --	dactylic hexameter	masculine penthemimeral, hepthemimeral, trithemimeral
ἐκ δὲ Τυφωέος ἔστʼ ἀνέμων μένος ὑγρὸν ἀέντων,	- u u-uu - uu- uu -u u--	dactylic hexameter	masculine penthemimeral, hepthemimeral
νόσφι Νότου Βορέω τε καὶ ἀργέστεω Ζεφύροιο·	-u u- uu- u u --- uu--	dactylic hexameter	masculine penthemimeral, trithemimeral
οἵ γε μὲν ἐκ θεόφιν γενεή, θνητοῖς μέγʼ ὄνειαρ·	- u u - uu- uu- -- u u--	dactylic hexameter	masculine penthemimeral, hepthemimeral, trithemimeral
οἱ δ᾽ἄλλοι μαψαῦραι ἐπιπνείουσι θάλασσαν·	- -- --u u---u u--	dactylic hexameter	feminine penthemimeral, trithemimeral
αἳ δή τοι πίπτουσαι ἐς ἠεροειδέα πόντον,	- - - --u u -uu-uu --	dactylic hexameter	feminine penthemimeral, trithemimeral
πῆμα μέγα θνητοῖσι, κακῇ θυίουσιν ἀέλλῃ·	-u u- --u u- --u u--	dactylic hexameter	feminine penthemimeral, hepthemimeral, trithemimeral
ἄλλοτε δ᾽ἄλλαι ἄεισι διασκιδνᾶσί τε νῆας	-uu -u u-u u---u u --	dactylic hexameter	feminine penthemimeral
ναύτας τε φθείρουσι· κακοῦ δ᾽οὐ γίγνεται ἀλκὴ	-- - --u u- - -uu --	dactylic hexameter	feminine penthemimeral, hepthemimeral, trithemimeral
ἀνδράσιν, οἳ κείνῃσι συνάντωνται κατὰ πόντον·	-uu - --u u--- uu --	dactylic hexameter	feminine penthemimeral, trithemimeral
αἳ δ᾽αὖ καὶ κατὰ γαῖαν ἀπείριτον ἀνθεμόεσσαν	- - - uu -u u-uu -uu--	dactylic hexameter	feminine penthemimeral, trithemimeral
ἔργʼ ἐρατὰ φθείρουσι χαμαιγενέων ἀνθρώπων	- uu- --u u-uu- ---	dactylic hexameter	feminine penthemimeral, trithemimeral
πιμπλεῖσαι κόνιός τε καὶ ἀργαλέου κολοσυρτοῦ.	--- uu- u u -uu- uu--	dactylic hexameter	masculine penthemimeral, trithemimeral
αὐτὰρ ἐπεί ῥα πόνον μάκαρες θεοὶ ἐξετέλεσσαν,	-u u- u u- uu- uu -uu--	dactylic hexameter	masculine penthemimeral, hepthemimeral, trithemimeral
Τιτήνεσσι δὲ τιμάων κρίναντο βίηφι,	---u u --- --u u--	dactylic hexameter	hepthemimeral
δή ῥα τότʼ ὤτρυνον βασιλευέμεν ἠδὲ ἀνάσσειν	- u u --- uu-uu -u u--	dactylic hexameter	masculine penthemimeral
Γαίης φραδμοσύνῃσιν Ὀλύμπιον εὐρύοπα Ζῆν	-- -uu-u u-uu -uu- -	dactylic hexameter	feminine penthemimeral
ἀθανάτων· ὃ δὲ τοῖσιν ἑὰς διεδάσσατο τιμάς.	-uu- u u -u u- uu-uu --	dactylic hexameter	feminine penthemimeral, hepthemimeral, trithemimeral
Ζεὺς δὲ θεῶν βασιλεὺς πρώτην ἄλοχον θέτο Μῆτιν	- u u- uu- -- uu- uu --	dactylic hexameter	masculine penthemimeral, hepthemimeral, trithemimeral
πλεῖστα τε ἰδυῖαν ἰδὲ θνητῶν ἀνθρώπων.	-u u --- -- -- ---	dactylic hexameter	masculine penthemimeral, hepthemimeral
ἀλλʼ ὅτε δὴ ἄρʼ ἔμελλε θεὰν γλαυκῶπιν Ἀθήνην	- uu - u u-u u- --u u--	dactylic hexameter	feminine penthemimeral, hepthemimeral, trithemimeral
τέξεσθαι, τότʼ ἔπειτα δόλῳ φρένας ἐξαπατήσας	--- u u-u u- uu -uu--	dactylic hexameter	feminine penthemimeral, hepthemimeral, trithemimeral
αἱμυλίοισι λόγοισιν ἑὴν ἐσκάτθετο νηδὺν	-uu-u u-u u- --uu --	dactylic hexameter	feminine penthemimeral, hepthemimeral
Γαίης φραδμοσύνῃσι καὶ Οὐρανοῦ ἀστερόεντος.	-- -uu-u u -uu -uu--	dactylic hexameter	feminine penthemimeral
τὼς γάρ οἱ φρασάτην, ἵνα μὴ βασιληίδα τιμὴν	- - - uu- uu - uu-uu --	dactylic hexameter	masculine penthemimeral, hepthemimeral, trithemimeral
ἄλλος ἔχοι Διὸς ἀντὶ θεῶν αἰειγενετάων.	-u u- uu -u u- --uu--	dactylic hexameter	feminine penthemimeral, hepthemimeral, trithemimeral
ἐκ γὰρ τῆς εἵμαρτο περίφρονα τέκνα γενέσθαι·	- - - --u u-uu -u u--	dactylic hexameter	feminine penthemimeral, trithemimeral
πρώτην μὲν κούρην γλαυκώπιδα Τριτογένειαν	-- - -- --uu -uu--	dactylic hexameter	masculine penthemimeral, trithemimeral
ἶσον ἔχουσαν πατρὶ μένος καὶ ἐπίφρονα βουλήν.	-u u-- -u u- u u-uu --	dactylic hexameter	feminine penthemimeral, hepthemimeral
αὐτὰρ ἔπειτʼ ἄρα παῖδα θεῶν βασιλῆα καὶ ἀνδρῶν	-u u- uu -u u- uu-u u --	dactylic hexameter	feminine penthemimeral, hepthemimeral, trithemimeral
ἤμελλεν τέξεσθαι, ὑπέρβιον ἦτορ ἔχοντα·	--- --u u-uu -u u--	dactylic hexameter	feminine penthemimeral, trithemimeral
ἀλλʼ ἄρα μιν Ζεὺς πρόσθεν ἑὴν ἐσκάτθετο νηδύν,	- uu - - -u u- --uu --	dactylic hexameter	feminine penthemimeral, hepthemimeral, trithemimeral
ὡς δή οἱ φράσσαιτο θεὰ ἀγαθόν τε κακόν τε.	- - - --u u- uu- u u- -	dactylic hexameter	feminine penthemimeral, hepthemimeral, trithemimeral
δεύτερον ἠγάγετο λιπαρὴν Θέμιν, ἣ τέκεν Ὥρας,	-uu -uu- uu- uu - uu --	dactylic hexameter	masculine penthemimeral, hepthemimeral
Εὐνομίην τε Δίκην τε καὶ Εἰρήνην τεθαλυῖαν,	-uu- u u- u u --- uu--	dactylic hexameter	masculine penthemimeral, trithemimeral
αἳ ἔργʼ ὠρεύουσι καταθνητοῖσι βροτοῖσι,	- - ---u u---u u--	dactylic hexameter	feminine penthemimeral
Μοίρας θ᾽,ᾗ πλείστην τιμὴν πόρε μητίετα Ζεύς,	-- - -- -- uu -uu- -	dactylic hexameter	masculine penthemimeral, hepthemimeral, trithemimeral
Κλωθώ τε Λάχεσίν τε καὶ Ἄτροπον, αἵτε διδοῦσι	-- - uu- u u -uu -u u--	dactylic hexameter	masculine penthemimeral, trithemimeral
θνητοῖς ἀνθρώποισιν ἔχειν ἀγαθόν τε κακόν τε.	-- ---u u- uu- u u- -	dactylic hexameter	feminine penthemimeral, hepthemimeral
τρεῖς δέ οἱ Εὐρυνομη Χάριτας τέκε καλλιπαρῄους,	- u u -uu- uu- uu -uu--	dactylic hexameter	masculine penthemimeral, hepthemimeral
Ὠκεανοῦ κούρη, πολυήρατον εἶδος ἔχουσα,	-uu- -- uu-uu -u u--	dactylic hexameter	masculine penthemimeral, trithemimeral
Ἀγλαΐην τε καὶ Εὐφροσύνην Θαλίην τ᾽ἐρατεινήν·	-uu- u u -uu- uu- uu--	dactylic hexameter	hepthemimeral, trithemimeral
τῶν καὶ ἀπὸ βλεφάρων ἔρος εἴβετο δερκομενάων	- u u- uu- uu -uu -uu--	dactylic hexameter	masculine penthemimeral, trithemimeral
λυσιμελής· καλὸν δέ θ᾽ὑπʼ ὀφρύσι δερκιόωνται.	-uu- -- u u -uu -uu--	dactylic hexameter	masculine penthemimeral, trithemimeral
αὐτὰρ ὁ Δήμητρος πολυφόρβης ἐς λέχος ἦλθεν,	-u u --- uu-- - uu --	dactylic hexameter	masculine penthemimeral
ἣ τέκε Περσεφόνην λευκώλενον, ἣν Ἀιδωνεὺς	- uu -uu- --uu - uu--	dactylic hexameter	masculine penthemimeral
ἥρπασε ἧς παρὰ μητρός· ἔδωκε δὲ μητίετα Ζεύς.	-uu - uu -u u-u u -uu- -	dactylic hexameter	feminine penthemimeral, trithemimeral
μνημοσύνης δ᾽ἐξαῦτις ἐράσσατο καλλικόμοιο,	-uu- --u u-uu -uu--	dactylic hexameter	feminine penthemimeral, trithemimeral
ἐξ ἧς οἱ Μοῦσαι χρυσάμπυκες ἐξεγένοντο	- - - -- --uu -uu--	dactylic hexameter	masculine penthemimeral, trithemimeral
ἐννέα, τῇσιν ἅδον θαλίαι καὶ τέρψις ἀοιδῆς.	-uu -u u- uu- - -u u--	dactylic hexameter	masculine penthemimeral, hepthemimeral
Λητὼ δ᾽Ἀπόλλωνα καὶ Ἄρτεμιν ἰοχέαιραν,	-- ---u u -uu -uu--	dactylic hexameter	feminine penthemimeral
ἱμερόεντα γόνον περὶ πάντων Οὐρανιώνων,	-uu-u u- uu -- -uu--	dactylic hexameter	masculine penthemimeral
γείνατʼ ἄρʼ αἰγιόχοιο Διὸς φιλότητι μιγεῖσα.	-u u -uu-u u- uu-u u--	dactylic hexameter	feminine penthemimeral, hepthemimeral
λοισθοτάτην δ᾽Ἥρην θαλερὴν ποιήσατʼ ἄκοιτιν·	-uu- -- uu- --u u--	dactylic hexameter	masculine penthemimeral, hepthemimeral, trithemimeral
ἣ δ᾽Ἥβην καὶ Ἄρηα καὶ Εἰλείθυιαν ἔτικτε	- -- u u-u u ---u u--	dactylic hexameter	feminine penthemimeral, trithemimeral
μιχθεῖσʼ ἐν φιλότητι θεῶν βασιλῆι καὶ ἀνδρῶν.	-- - uu-u u- uu-u u --	dactylic hexameter	feminine penthemimeral, hepthemimeral, trithemimeral
αὐτὸς δ᾽ἐκ κεφαλῆς γλαυκώπιδα Τριτογένειαν	-- - uu- --uu -uu--	dactylic hexameter	masculine penthemimeral, trithemimeral
δεινὴν ἐγρεκύδοιμον ἀγέστρατον Ἀτρυτώνην	-- -uu-u u-uu ----	dactylic hexameter	feminine penthemimeral
πότνιαν, ᾗ κέλαδοί τε ἅδον πόλεμοί τε μάχαι τε,	-uu - uu- u u- uu- u u- -	dactylic hexameter	masculine penthemimeral, hepthemimeral, trithemimeral
Ἥρη δ᾽Ἥφαιστον κλυτὸν οὐ φιλότητι μιγεῖσα	-- --- uu - uu-u u--	dactylic hexameter	masculine penthemimeral, hepthemimeral
γείνατο, καὶ ζαμένησε καὶ ἤρισε ᾧ παρακοίτῃ,	-uu - uu-u u -uu - uu--	dactylic hexameter	feminine penthemimeral, trithemimeral
ἐκ πάντων τέχνῃσι κεκασμένον Οὐρανιώνων.	- -- --u u-uu -uu--	dactylic hexameter	feminine penthemimeral, trithemimeral
<Ἥρη δὲ ζαμένησε καὶ ἤρισε ᾧ παρακοίτῃ.>	-- - uu-u u -uu - uu--	dactylic hexameter	feminine penthemimeral, trithemimeral
<ἐκ ταύτης δ᾽ἔριδος ἣ μὲν τέκε φαίδιμον υἱὸν>	- -- uu- - - uu -uu --	dactylic hexameter	masculine penthemimeral, hepthemimeral, trithemimeral
<Ἥφαιστον, φιλότητος ἄτερ Διὸς αἰγιόχοιο,>	--- uu-u u- uu -uu--	dactylic hexameter	feminine penthemimeral, hepthemimeral, trithemimeral
<ἐκ πάντων παλάμῃσι κεκασμένον Οὐρανιώνων·>	- -- uu-u u-uu -uu--	dactylic hexameter	feminine penthemimeral, trithemimeral
<αὐτὰρ ὅ γ᾽Ὠκεανοῦ καὶ Τηθύος ἠυκόμοιο>	-u u -uu- - -uu -uu--	dactylic hexameter	masculine penthemimeral
<κούρῃ νόσφʼ Ἥρης παρελέξατο καλλιπαρήῳ,>	-- - -- uu-uu -uu--	dactylic hexameter	masculine penthemimeral, trithemimeral
<ἐξαπαφὼν Μῆτιν καίπερ πολυδήνεʼ ἐοῦσαν.>	-uu- -- -- uu-u u--	dactylic hexameter	masculine penthemimeral, hepthemimeral, trithemimeral
<συμμάρψας δ᾽ὅ γε χερσὶν ἑὴν ἐγκάτθετο νηδὺν>	--- u u -u u- --uu --	dactylic hexameter	feminine penthemimeral, hepthemimeral, trithemimeral
<δείσας, μὴ τέξῃ κρατερώτερον ἄλλο κεραυνοῦ.>	-- - -- uu-uu -u u--	dactylic hexameter	masculine penthemimeral, trithemimeral
<τοὔνεκά μιν Κρονίδης ὑψίζυγος αἰθέρι ναίων>	-uu - uu- --uu -uu --	dactylic hexameter	masculine penthemimeral, trithemimeral
<κάππιεν ἐξαπίνης· ἣ δ᾽αὐτίκα Παλλάδʼ Ἀθήνην>	-uu -uu- - -uu -u u--	dactylic hexameter	masculine penthemimeral
<κύσατο· τὴν μὲν ἔτικτε πατὴρ ἀνδρῶν τε θεῶν τε>	-uu - u u-u u- -- u u- -	dactylic hexameter	feminine penthemimeral, hepthemimeral, trithemimeral
<πὰρ κορυφὴν Τρίτωνος ἐπʼ ὄχθῃσιν ποταμοῖο.>	- uu- --u u --- uu--	dactylic hexameter	feminine penthemimeral, trithemimeral
<Μῆτις δ᾽αὖτε Ζηνὸς ὑπὸ σπλάγχνοις λελαθυῖα>	-- -- -u u- -- uu--	dactylic hexameter	feminine penthemimeral, hepthemimeral
<ἧστο, Ἀθηναίης μήτηρ, τέκταινα δικαίων>	-u u--- -- --u u--	dactylic hexameter	masculine penthemimeral, hepthemimeral
<πλεῖστα θεῶν τε ἰδυῖα καταθνητῶν τ᾽ἀνθρώπων,>	-u u- u u-u u--- ---	dactylic hexameter	feminine penthemimeral, trithemimeral
<ἔνθα θεὰ παρέδεκτο ὅθεν παλάμαις περὶ πάντων>	-u u- uu-u u- uu- uu --	dactylic hexameter	feminine penthemimeral, hepthemimeral, trithemimeral
<ἀθανάτων ἐκέκασθʼ οἳ Ὀλύμπια δώματʼ ἔχουσιν,>	-uu- uu- u u-uu -u u--	dactylic hexameter	masculine penthemimeral, trithemimeral
[αἰγίδα ποιήσασα φοβέστρατον ἔντος Ἀθήνης·	-uu ---u u-uu -u u--	dactylic hexameter	feminine penthemimeral
<σὺν τῇ ἐγείνατό μιν πολεμήια τεύχεʼ ἔχουσαν.>	- u u-uu - uu-uu -u u--	dactylic hexameter	masculine penthemimeral
Ἐκ δ᾽Ἀμφιτρίτης καὶ ἐρικτύπου Ἐννοσιγαίου	- ---- u u-uu -uu--	dactylic hexameter	masculine penthemimeral
Τρίτων εὐρυβίης γένετο μέγας, ὅστε θαλάσσης	-- -uu- uu- uu -u u--	dactylic hexameter	masculine penthemimeral, hepthemimeral
πυθμένʼ ἔχων παρὰ μητρὶ φίλῃ καὶ πατρὶ ἄνακτι	-u u- uu -u u- - -u u--	dactylic hexameter	feminine penthemimeral, hepthemimeral, trithemimeral
ναίει χρύσεα δῶ, δεινὸς θεός. αὐτὰρ Ἄρηι	-- -uu - -- uu -u u--	dactylic hexameter	masculine penthemimeral, hepthemimeral
ῥινοτόρῳ Κυθέρεια Φόβον καὶ Δεῖμον ἔτικτε	-uu- uu-u u- - -u u--	dactylic hexameter	feminine penthemimeral, hepthemimeral, trithemimeral
δεινούς, οἵτʼ ἀνδρῶν πυκινὰς κλονέουσι φάλαγγας	-- - -- uu- uu-u u--	dactylic hexameter	masculine penthemimeral, hepthemimeral, trithemimeral
ἐν πολέμῳ κρυόεντι σὺν Ἄρηι πτολιπόρθῳ,	- uu- uu-u u --- uu--	dactylic hexameter	feminine penthemimeral, trithemimeral
Ἁρμονίην θ᾽,ἣν Κάδμος ὑπέρθυμος θέτʼ ἄκοιτιν.	-uu- - -u u--- u u--	dactylic hexameter	feminine penthemimeral, trithemimeral
Ζηνὶ δ᾽ἄρʼ Ἀτλαντὶς Μαίη τέκε κύδιμον Ἑρμῆν,	-u u --- -- uu -uu --	dactylic hexameter	masculine penthemimeral, hepthemimeral
κήρυκʼ ἀθανάτων, ἱερὸν λέχος εἰσαναβᾶσα.	-u u--- uu- uu -uu--	dactylic hexameter	masculine penthemimeral, hepthemimeral
Καδμείη δ᾽ἄρα οἱ Σεμέλη τέκε φαίδιμον υἱὸν	--- uu - uu- uu -uu --	dactylic hexameter	masculine penthemimeral, hepthemimeral, trithemimeral
μιχθεῖσʼ ἐν φιλότητι, Διώνυσον πολυγηθέα,	-- - uu-u u--- uu---	lyric	
ἀθάνατον θνητή· νῦν δ᾽ἀμφότεροι θεοί εἰσιν.	-uu- -- - -uu- uu --	dactylic hexameter	masculine penthemimeral, trithemimeral
Ἀλκμήνη δ᾽ἄρʼ ἔτικτε βίην Ἡρακληείην	--- u u-u u- -----	dactylic hexameter	feminine penthemimeral, hepthemimeral, trithemimeral
μιχθεῖσʼ ἐν φιλότητι Διὸς νεφεληγερέταο.	-- - uu-u u- uu-uu--	dactylic hexameter	feminine penthemimeral, hepthemimeral, trithemimeral
ἀγλαΐην δ᾽Ἥφαιστος, ἀγακλυτὸς ἀμφιγυήεις,	-uu- --u u-uu -uu--	dactylic hexameter	feminine penthemimeral, trithemimeral
ὁπλοτάτην Χαρίτων θαλερὴν ποιήσατʼ ἄκοιτιν.	-uu- uu- uu- --u u--	dactylic hexameter	masculine penthemimeral, hepthemimeral, trithemimeral
χρυσοκόμης δὲ Διώνυσος ξανθὴν Ἀριάδνην,	-uu- u u--- -- uu--	dactylic hexameter	hepthemimeral, trithemimeral
κούρην Μίνωος, θαλερὴν ποιήσατʼ ἄκοιτιν.	-- --- uu- --u u--	dactylic hexameter	masculine penthemimeral, hepthemimeral
τὴν δέ οἱ ἀθάνατον καὶ ἀγήρω θῆκε Κρονίων.	- u u -uu- u u-- -u u--	dactylic hexameter	masculine penthemimeral
ἥβην δ᾽Ἀλκμήνης καλλισφύρου ἄλκιμος υἱός,	-- --- --uu -uu --	dactylic hexameter	masculine penthemimeral
ἲς Ἡρακλῆος, τελέσας στονόεντας ἀέθλους,	- ---- uu- uu-u u--	dactylic hexameter	masculine penthemimeral, hepthemimeral
παῖδα Διὸς μεγάλοιο καὶ Ἥρης χρυσοπεδίλου,	-u u- uu-u u -- -uu--	dactylic hexameter	feminine penthemimeral, trithemimeral
αἰδοίην θέτʼ ἄκοιτιν ἐν Οὐλύμπῳ νιφόεντι,	--- u u-u u --- uu--	dactylic hexameter	feminine penthemimeral, trithemimeral
ὄλβιος, ὃς μέγα ἔργον ἐν ἀθανάτοισιν ἀνύσσας	-uu - uu -u u -uu-u u--	dactylic hexameter	feminine penthemimeral, trithemimeral
ναίει ἀπήμαντος καὶ ἀγήραος ἤματα πάντα.	-u u--- u u-uu -uu --	dactylic hexameter	masculine penthemimeral
ἠελίῳ δ᾽ἀκάμαντι τέκεν κλυτὸς Ὠκεανίνη	-uu- uu-u u- uu -uu--	dactylic hexameter	feminine penthemimeral, hepthemimeral, trithemimeral
Περσηὶς Κίρκην τε καὶ Αἰήτην βασιλῆα.	--- -- u u --- uu--	dactylic hexameter	masculine penthemimeral, trithemimeral
Αἰήτης δ᾽υἱὸς φαεσιμβρότου Ἠελίοιο	--- -- uu-uu -uu--	dactylic hexameter	masculine penthemimeral, trithemimeral
κούρην Ὠκεανοῖο τελήεντος ποταμοῖο	-- -uu-u u--- uu--	dactylic hexameter	feminine penthemimeral
γῆμε θεῶν βουλῇσιν Ἰδυῖαν καλλιπάρῃον.	-u u- --u u-- -uu--	dactylic hexameter	feminine penthemimeral, trithemimeral
ἣ δέ οἱ Μήδειαν ἐύσφυρον ἐν φιλότητι	- - - --u u-uu - uu--	dactylic hexameter	feminine penthemimeral, trithemimeral
γείναθʼ ὑποδμηθεῖσα διὰ χρυσέην Ἀφροδίτην.	-u u---u u- uu- uu--	dactylic hexameter	feminine penthemimeral, hepthemimeral
ὑμεῖς μὲν νῦν χαίρετʼ, Ὀλύμπια δώματʼ ἔχοντες,	-- - - -u u-uu -u u--	dactylic hexameter	feminine penthemimeral, trithemimeral
νῆσοί τ᾽ἤπειροί τε καὶ ἁλμυρὸς ἔνδοθι πόντος.	-- --- u u -uu -uu --	dactylic hexameter	masculine penthemimeral
νῦν δὲ θεάων φῦλον ἀείσατε, ἡδυέπειαι	- u u-- -u u-uu -uu--	dactylic hexameter	feminine penthemimeral
Μοῦσαι Ὀλυμπιάδες, κοῦραι Διὸς αἰγιόχοιο,	-u u-uu- -- uu -uu--	dactylic hexameter	masculine penthemimeral, hepthemimeral
ὅσσαι δὴ θνητοῖσι παρʼ ἀνδράσιν εὐνηθεῖσαι	-- - --u u -uu ----	dactylic hexameter	feminine penthemimeral, trithemimeral
ἀθάναται γείναντο θεοῖς ἐπιείκελα τέκνα.	-uu- --u u- uu-uu --	dactylic hexameter	feminine penthemimeral, hepthemimeral, trithemimeral
Δημήτηρ μὲν Πλοῦτον ἐγείνατο, δῖα θεάων,	--- - -u u-uu -u u--	dactylic hexameter	feminine penthemimeral, trithemimeral
Ἰασίωνʼ ἥρωι μιγεῖσʼ ἐρατῇ φιλότητι	-uu- --u u- uu- uu--	dactylic hexameter	feminine penthemimeral, hepthemimeral, trithemimeral
νειῷ ἔνι τριπόλῳ, Κρήτης ἐν πίονι δήμῳ,	-u u- uu- -- - -uu --	dactylic hexameter	masculine penthemimeral, hepthemimeral, trithemimeral
ἐσθλόν, ὃς εἶσʼ ἐπὶ γῆν τε καὶ εὐρέα νῶτα θαλάσσης	-u u - uu - u u -uu -u u--	dactylic hexameter	masculine penthemimeral, trithemimeral
πάντη· τῷ δὲ τυχόντι καὶ οὗ κ᾽ἐς χεῖρας ἵκηται,	-- - u u-u u - - -u u--	dactylic hexameter	feminine penthemimeral, hepthemimeral, trithemimeral
τὸν δ᾽ἀφνειὸν ἔθηκε, πολὺν δέ οἱ ὤπασεν ὄλβον.	- --u u-u u- u u -uu --	dactylic hexameter	feminine penthemimeral, hepthemimeral
Κάδμῳ δ᾽Ἁρμονίη, θυγάτηρ χρυσέης Ἀφροδιτης,	-- -uu- uu- -- uu--	dactylic hexameter	masculine penthemimeral, hepthemimeral
Ἰνὼ καὶ Σεμέλην καὶ Ἀγαυὴν καλλιπάρῃον	-- - uu- u u-- -uu--	dactylic hexameter	masculine penthemimeral, trithemimeral
Αὐτονόην θ᾽,ἣν γῆμεν Ἀρισταῖος βαθυχαίτης,	-uu- - -u u--- uu--	dactylic hexameter	feminine penthemimeral, trithemimeral
γείνατο καὶ Πολύδωρον ἐυστεφάνῳ ἐνὶ Θήβῃ.	-uu - uu-u u-uu- uu --	dactylic hexameter	feminine penthemimeral, trithemimeral
κούρη δ᾽Ὠκεανοῦ, Χρυσάορι καρτεροθύμῳ	-- -uu- --uu -uu--	dactylic hexameter	masculine penthemimeral
μιχθεῖσʼ ἐν φιλότητι πολυχρύσου Ἀφροδίτης,	-- - uu-u u-uu -u--	lyric	
Καλλιρόη τέκε παῖδα βροτῶν κάρτιστον ἁπάντων,	-uu- uu -u u- --u u--	dactylic hexameter	feminine penthemimeral, hepthemimeral, trithemimeral
Γηρυονέα, τὸν κτεῖνε βίη Ἡρακληείη	-uu- - -u u- -----	dactylic hexameter	feminine penthemimeral, hepthemimeral, trithemimeral
βοῶν ἕνεκʼ εἰλιπόδων ἀμφιρρύτῳ εἰν Ἐρυθείῃ.	- uu -uu- --uu - uu--	dactylic hexameter	masculine penthemimeral
Τιθωνῷ δ᾽Ἠὼς τέκε Μέμνονα χαλκοκορυστήν,	--- -- uu -uu -uu--	dactylic hexameter	masculine penthemimeral, trithemimeral
Αἰθιόπων βασιλῆα, καὶ Ἠμαθίωνα ἄνακτα.	-uu- uu-u u -uu-u u--	dactylic hexameter	feminine penthemimeral, trithemimeral
αὐτὰρ ὑπαὶ Κεφάλῳ φιτύσατο φαίδιμον υἱόν,	-u u- uu- --uu -uu --	dactylic hexameter	masculine penthemimeral, trithemimeral
ἴφθιμον Φαέθοντα, θεοῖς ἐπιείκελον ἄνδρα.	--- uu-u u- uu-uu --	dactylic hexameter	feminine penthemimeral, hepthemimeral, trithemimeral
τόν ῥα νέον τέρεν ἄνθος ἔχοντʼ ἐρικυδέος ἥβης	- u u- uu -u u- uu-uu --	dactylic hexameter	feminine penthemimeral, hepthemimeral, trithemimeral
παῖδʼ ἀταλὰ φρονέοντα φιλομμειδὴς Ἀφροδίτη	- uu- uu-u u--- uu--	dactylic hexameter	feminine penthemimeral, trithemimeral
ὦρτʼ ἀναρεψαμένη, καί μιν ζαθέοις ἐνὶ νηοῖς	- uu-uu- - - uu- uu --	dactylic hexameter	masculine penthemimeral, hepthemimeral
νηοπόλον νύχιον ποιήσατο, δαίμονα δῖον.	-uu- uu- --uu -uu --	dactylic hexameter	masculine penthemimeral, trithemimeral
κούρην δ᾽Αἰήταο διοτρεφέος βασιλῆος	-- ---u u-uu- uu--	dactylic hexameter	feminine penthemimeral
Αἰσονίδης βουλῇσι θεῶν αἰειγενετάων	-uu- --u u- --uu--	dactylic hexameter	feminine penthemimeral, hepthemimeral, trithemimeral
ἦγε παρʼ Αἰήτεω, τελέσας στονόεντας ἀέθλους,	-u u --- uu- uu-u u--	dactylic hexameter	masculine penthemimeral, hepthemimeral
τοὺς πολλοὺς ἐπέτελλε μέγας βασιλεὺς ὑπερήνωρ,	- -- uu-u u- uu- uu--	dactylic hexameter	feminine penthemimeral, hepthemimeral, trithemimeral
ὑβριστὴς Πελίης καὶ ἀτάσθαλος, ὀβριμοεργός.	--- uu- u u-uu -uu--	dactylic hexameter	masculine penthemimeral, trithemimeral
τοὺς τελέσας Ἰαωλκὸν ἀφίκετο, πολλὰ μογήσας,	- uu- uu-u u-uu -u u--	dactylic hexameter	feminine penthemimeral, trithemimeral
ὠκείης ἐπὶ νηὸς ἄγων ἑλικώπιδα κούρην	--- uu -u u- uu-uu --	dactylic hexameter	feminine penthemimeral, hepthemimeral, trithemimeral
Αἰσονίδης, καί μιν θαλερὴν ποιήσατʼ ἄκοιτιν.	-uu- - - uu- --u u--	dactylic hexameter	masculine penthemimeral, hepthemimeral, trithemimeral
καί ῥ᾽ἥ γε δμηθεῖσʼ ὑπʼ Ἰήσονι, ποιμένι λαῶν,	- - - -- u u-uu -uu --	dactylic hexameter	masculine penthemimeral, trithemimeral
Μήδειον τέκε παῖδα, τὸν οὔρεσιν ἔτρεφε Χείρων	--- uu -u u -uu -uu --	dactylic hexameter	feminine penthemimeral, trithemimeral
Φιλυρίδης· μεγάλου δὲ Διὸς νόος ἐξετελεῖτο.	-uu- uu- u u- uu -uu--	dactylic hexameter	masculine penthemimeral, hepthemimeral, trithemimeral
αὐτὰρ Νηρῆος κοῦραι,· ἁλίοιο γέροντος,	-- --- -- uu-u u--	dactylic hexameter	masculine penthemimeral, hepthemimeral
ἦ τοι μὲν Φῶκον Ψαμάθη τέκε δῖα θεάων	- - - -- uu- uu -u u--	dactylic hexameter	masculine penthemimeral, hepthemimeral, trithemimeral
Αἰακοῦ ἐν φιλότητι διὰ χρυσέην Ἀφροδίτην,	-uu - uu-u u- uu- uu--	dactylic hexameter	feminine penthemimeral, hepthemimeral, trithemimeral
Πηλέι δὲ δμηθεῖσα θεὰ Θέτις ἀργυρόπεζα	-uu - --u u- uu -uu--	dactylic hexameter	feminine penthemimeral, hepthemimeral, trithemimeral
γείνατʼ Ἀχιλλῆα ῥηξήνορα θυμολέοντα.	-u u--- --uu -uu--	dactylic hexameter	masculine penthemimeral
Αἰνείαν δ᾽ἄρʼ ἔτικτεν ἐυστέφανος Κυθέρεια	--- u u-u u-uu- uu--	dactylic hexameter	feminine penthemimeral, trithemimeral
Ἀγχίσῃ ἥρωι μιγεῖσʼ ἐρατῇ φιλότητι	-uu --- -- uu- uu--	dactylic hexameter	masculine penthemimeral, hepthemimeral
Ἴδης ἐν κορυφῇσι πολυπτύχου ὑληέσσης.	-- - uu-u u-uu ----	dactylic hexameter	feminine penthemimeral, trithemimeral
Κίρκη δ᾽,Ἠελίου θυγάτηρ Ὑπεριονίδαο,	-- -uu- uu- uu-uu--	dactylic hexameter	masculine penthemimeral, hepthemimeral
γείνατʼ Ὀδυσσῆος ταλασίφρονος ἐν φιλότητι	-u u--- uu-uu - uu--	dactylic hexameter	masculine penthemimeral
Ἄγριον ἠδὲ Λατῖνον ἀμύμονά τε κρατερόν τε·	-uu -u u-u u-uu - uu- -	dactylic hexameter	feminine penthemimeral
[Τηλέγονον δ᾽ἄρʼ ἔτικτε διὰ χρυσέην Ἀφροδίτην.	-uu- u u-u u- uu- uu--	dactylic hexameter	feminine penthemimeral, hepthemimeral, trithemimeral
οἳ δή τοι μάλα τῆλε μυχῷ νήσων ἱεράων	- - - uu -u u- -- uu--	dactylic hexameter	feminine penthemimeral, hepthemimeral, trithemimeral
πᾶσιν Τυρσηνοῖσιν ἀγακλειτοῖσιν ἄνασσον.	-- ---u u---u u--	dactylic hexameter	feminine penthemimeral
Ναυσίθοον δ᾽Ὀδυσῆι Καλυψὼ δῖα θεάων	-uu- uu-u u-- -u u--	dactylic hexameter	feminine penthemimeral, trithemimeral
γείνατο Ναυσίνοόν τε μιγεῖσʼ ἐρατῇ φιλότητι.	-uu -uu- u u- uu- uu--	dactylic hexameter	masculine penthemimeral, hepthemimeral
αὗται μὲν θνητοῖσι παρʼ ἀνδράσιν εὐνηθεῖσαι	-- - --u u -uu ----	dactylic hexameter	feminine penthemimeral, trithemimeral
ἀθάναται γείναντο θεοῖς ἐπιείκελα τέκνα.	-uu- --u u- uu-uu --	dactylic hexameter	feminine penthemimeral, hepthemimeral, trithemimeral
νῦν δὲ γυναικῶν φῦλον ἀείσατε, ἡδυέπειαι	- u u-- -u u-uu -uu--	dactylic hexameter	feminine penthemimeral
Μοῦσαι Ὀλυμπιάδες, κοῦραι Διὸς αἰγιόχοιο.	-u u-uu- -- uu -uu--	dactylic hexameter	masculine penthemimeral, hepthemimeral
