Ὦ ἄνα, Λητοῦς υἱέ, Διὸς τέκος, οὔποτε σεῖο	- uu -- -u u- uu -uu --	dactylic hexameter	feminine penthemimeral, hepthemimeral
λήσομαι ἀρχόμενος οὐδ᾽ ἀποπαυόμενος,	-uu -uu- - uu-uu-	dactylic pentameter	
ἀλλ᾽ αἰεὶ πρῶτόν τε καὶ ὕστατον ἔν τε μέσοισιν	- -- -- u u -uu - u u--	dactylic hexameter	masculine penthemimeral, trithemimeral
ἀείσω· σὺ δέ μοι κλῦθι καὶ ἐσθλὰ δίδου.	--- u u - -u u -u u-	dactylic pentameter	
Φοῖβε ἄναξ, ὅτε μέν σε θεὰ τέκε πότνια Λητώ,	-u u- uu - u u- uu -uu --	dactylic hexameter	masculine penthemimeral, hepthemimeral, trithemimeral
φοίνικος ῥαδινῇς χερσὶν ἐφαψαμένη,	--- uu- -u u-uu-	dactylic pentameter	
ἀθανάτων κάλλιστον, ἐπὶ τροχοειδέϊ λίμνῃ,	-uu- --u u- uu-uu --	dactylic hexameter	feminine penthemimeral, hepthemimeral, trithemimeral
πᾶσα μὲν ἐπλήσθη Δῆλος ἀπειρεσίη	-u u --- -u u-uu-	dactylic pentameter	
ὀδμῆς ἀμβροσίης, ἐγέλασσε δὲ γαῖα πελώρη	-- -uu- uu-u u -u u--	dactylic hexameter	masculine penthemimeral
γήθησεν δὲ βαθὺς πόντος ἁλὸς πολιῆς.	--- u u- -u u- uu-	dactylic pentameter	
Ἄρτεμι θηροφόνη, θύγατερ Διός, ἣν Ἀγαμέμνων	-uu -uu- uu- uu - uu--	dactylic hexameter	masculine penthemimeral, hepthemimeral
εἵσαθ᾽ ὅτ᾽ ἐς Τροίην ἔπλεε νηυσὶ θοῇς,	-u u - -- -uu -u u-	dactylic pentameter	
εὐχομένῳ μοι κλῦθι, κακὰς δ᾽ἀπὸ κῆρας ἄλαλκε·	-uu- - -u u- uu -u u--	dactylic hexameter	feminine penthemimeral, hepthemimeral, trithemimeral
σοὶ μὲν τοῦτο, θεά, σμικρόν, ἐμοὶ δὲ μέγα.	- - -u u- -u u- u u-	dactylic pentameter	
Μοῦσαι καὶ Χάριτες, κοῦραι Διός, αἵ ποτε Κάδμου	-- - uu- -- uu - uu --	dactylic hexameter	masculine penthemimeral, hepthemimeral, trithemimeral
ἐς γάμον ἐλθοῦσαι καλὸν ἀείσατ᾽ ἔπος·	- uu --- -u u-u u-	dactylic pentameter	
"ὅττι καλόν, φίλον ἐστι, τὸ δ᾽οὐ καλὸν οὐ φίλον ἐστίν·"	-u u- uu -u u - uu - uu --	dactylic hexameter	feminine penthemimeral, hepthemimeral, trithemimeral
τοῦτ᾽ ἔπος ἀθανάτων ἦλθε διὰ στομάτων.	- uu -uu- -u u- uu-	dactylic pentameter	
Κύρνε, σοφιζομένῳ μὲν ἐμοὶ σφρηγὶς ἐπικείσθω	-u u-uu- u u- -- uu--	dactylic hexameter	masculine penthemimeral, hepthemimeral
τοῖσδ᾽ ἔπεσιν, λήσει δ᾽οὔποτε κλεπτόμενα,	- uu- -- -uu -uu-	dactylic pentameter	
οὐδέ τις ἀλλάξει κάκιον τοὐσθλοῦ παρεόντος,	-u u --- uu- -- uu--	dactylic hexameter	masculine penthemimeral, hepthemimeral
ὧδε δὲ πᾶς τις ἐρεῖ· "Θεύγνιδός ἐστιν ἔπη	-u u - u u- -uu -u u-	dactylic pentameter	
τοῦ Μεγαρέως πάντας δὲ κατ᾽ ἀνθρώπους ὀνομαστοῦ,"	- uu- -- u u --- uu--	dactylic hexameter	masculine penthemimeral, trithemimeral
ἀστοῖσιν δ᾽οὔπω πᾶσιν ἁδεῖν δύναμαι·	--- -- -u u- uu-	dactylic pentameter	
οὐδὲν θαυμαστόν, Πολυπαΐδη· οὐδὲ γὰρ ὁ Ζεὺς	-- --- uu-uu -u u - -	dactylic hexameter	masculine penthemimeral
οὔθ᾽ ὕων πάντεσσ᾽ ἁνδάνει οὔτ᾽ ἀνέχων.	- -- -- -uu - uu-	dactylic pentameter	
σοὶ δ᾽ἐγὼ εὖ φρονέων ὑποθήσομαι, οἷά περ αὐτός,	- uu - uu- uu-uu -u u --	dactylic hexameter	masculine penthemimeral, trithemimeral
Κύρν᾽, ἀπὸ τῶν ἀγαθῶν παῖς ἔτ᾽ ἐὼν ἔμαθον.	- uu - uu- - u u- uu-	dactylic pentameter	
πέπνυσο, μηδ᾽ αἰσχροῖσιν ἐπ᾽ ἔργμασι μηδ᾽ ἀδίκοισιν	-uu - --u u -uu - uu--	dactylic hexameter	feminine penthemimeral, trithemimeral
τιμὰς μηδ᾽ ἀρετὰς ἕλκεο μηδ᾽ ἄφενος.	-- - uu- -uu - uu-	dactylic pentameter	
ταῦτα μὲν οὕτως ἴσθι· κακοῖσι δὲ μὴ προσομίλει	-u u -- -u u-u u - uu--	dactylic hexameter	feminine penthemimeral
ἀνδράσιν, ἀλλ᾽ αἰεὶ τῶν ἀγαθῶν ἔχεο·	-uu - -- - uu- uu-	dactylic pentameter	
καὶ παρὰ τοῖσιν πῖνε καὶ ἔσθιε, καὶ μετὰ τοῖσιν	- uu -- -u u -uu - uu --	dactylic hexameter	feminine penthemimeral
ἵζε καὶ ἅνδανε τοῖς, ὧν μεγάλη δύναμις.	-u u -uu - - uu- uu-	dactylic pentameter	
ἐσθλῶν μὲν γὰρ ἄπ᾽ ἐσθλὰ μαθήσεαι· ἢν δὲ κακοῖσιν	-- - u u -u u-uu - u u--	dactylic hexameter	feminine penthemimeral, trithemimeral
συμμίσγῃς, ἀπολεῖς καὶ τὸν ἐόντα νόον.	--- uu- - u u-u u-	dactylic pentameter	
ταῦτα μαθὼν ἀγαθοῖσιν ὁμίλεε, καὶ ποτε φήσεις	-u u- uu-u u-uu - uu --	dactylic hexameter	feminine penthemimeral, trithemimeral
εὖ συμβουλεύειν τοῖσι φίλοισιν ἐμέ.	- ---- -u u-u u-	dactylic pentameter	
Κύρνε, κύει πόλις ἥδε, δέδοικα δὲ μὴ τέκῃ ἄνδρα	-u u- uu -u u-u u - uu --	dactylic hexameter	feminine penthemimeral, trithemimeral
εὐθυντῆρα κακῆς ὕβριος ἡμετέρης.	---u u- -uu -uu-	dactylic pentameter	
ἀστοὶ μὲν γὰρ ἔθ᾽ οἵδε σαόφρονες, ἡγεμόνες δὲ	-- - u u -u u-uu -uu- -	dactylic hexameter	feminine penthemimeral, trithemimeral
τετράφαται πολλὴν ἐς κακότητα πεσεῖν.	-uu- -- - uu-u u-	dactylic pentameter	
οὐδεμίαν πω, Κύρν᾽, ἀγαθοὶ πόλιν ὤλεσαν ἄνδρες·	-uu- - - uu- uu -uu --	dactylic hexameter	masculine penthemimeral, hepthemimeral, trithemimeral
ἀλλ᾽ ὅταν ὑβρίζειν τοῖσι κακοῖσιν ἅδῃ	- uu --- -u u-u u-	dactylic pentameter	
δῆμόν τε φθείρωσι δίκας τ᾽ἀδίκοισι διδῶσιν	-- - --u u- uu-u u--	dactylic hexameter	feminine penthemimeral, hepthemimeral, trithemimeral
οἰκείων κερδέων εἵνεκα καὶ κράτεος,	--- -- -uu - uu-	dactylic pentameter	
ἔλπεο μὴ δηρὸν κείνην πόλιν ἀτρεμιεῖσθαι	-uu - -- -- uu -uu--	dactylic hexameter	masculine penthemimeral, hepthemimeral, trithemimeral
μηδ᾽ εἰ νῦν κεῖται πολλῇ ἐν ἡσυχίῃ,	- - - -- -u u -uu-	dactylic pentameter	
εὖτ᾽ ἂν τοῖσι κακοῖσι φίλ᾽ ἀνδράσι ταῦτα γένηται	- - -u u-u u -uu -u u--	dactylic hexameter	feminine penthemimeral
κέρδεα δημοσίῳ σὺν κακῷ ἐρχόμενα.	-uu -uu- - uu -uu-	dactylic pentameter	
ἐκ τῶν γὰρ στάσιές τε καὶ ἔμφυλοι φόνοι ἀνδρῶν	- - - uu- u u --- uu --	dactylic hexameter	masculine penthemimeral, trithemimeral
μούναρχοί θ᾽·ἃ πόλει μήποτε τῇδε ἅδοι.	--- u u- -uu -u u-	dactylic pentameter	
Κύρνε πόλις μὲν ἔθ᾽ ἥδε πόλις, λαοὶ δὲ δὴ ἄλλοι,	-u u- u u -u u- -- u u --	dactylic hexameter	feminine penthemimeral, hepthemimeral, trithemimeral
οἳ πρόσθ᾽ οὔτε δίκας ᾔδεσαν οὔτε νόμους,	- - -u u- -uu -u u-	dactylic pentameter	
ἀλλ᾽ ἀμφὶ πλευραῖσι δορὰς αἰγῶν κατέτριβον,	- -- --u u- -- uu--	dactylic hexameter	feminine penthemimeral, hepthemimeral, trithemimeral
ἔζω δ᾽ὥστ᾽ ἔλαφοι τῆσδ᾽ ἐνεμοντο πό ληος	-- - uu- - uu-u u -	dactylic pentameter	
καὶ νῦν εἰσ᾽ ἀγαθοί, πολυπαΐδη· οἱ δὲ πρὶν ἐσθλοὶ	- - - uu- uu-uu - u u --	dactylic hexameter	masculine penthemimeral, trithemimeral
νῦν δειλοί. τίς κεν ταῦτ᾽ ἀνεχοιτ᾽ ἐσορῶν;	- -- - - - uu- uu-	dactylic pentameter	
ἀλλήλους δ᾽ἀπατῶσιν ἐπ᾽ ἀλλήλοισι γελῶντες,	--- uu-u u ---u u--	dactylic hexameter	feminine penthemimeral, trithemimeral
οὔτε κακῶν γνώμας εἰδότες οὔτ᾽ ἀγαθῶν.	-u u- -- -uu - uu-	dactylic pentameter	
μηδένα τῶνδε φίλον ποιεῦ, Πολυπαΐδη, ἀστῶν	-uu -u u- -- uu-uu --	dactylic hexameter	masculine penthemimeral, hepthemimeral
ἐκ θυμοῦ χρείης εἵνεκα μηδεμιῆς·	- -- -- -uu -uu-	dactylic pentameter	
ἀλλὰ δόκει μὲν πᾶσιν ἀπὸ γλώσσης φίλος εἶναι,	-u u- - -u u- -- uu --	dactylic hexameter	feminine penthemimeral, hepthemimeral, trithemimeral
χρῆμα δὲ συμμείξῃς μηδενὶ μηδ᾽ ὁτιοῦν	-u u --- -uu - uu-	dactylic pentameter	
σπουδαῖον· γνώσῃ γὰρ ὀϊζυρῶν φρένας ἀνδρῶν,	--- -- u u--- uu --	dactylic hexameter	masculine penthemimeral, trithemimeral
ὥς σφιν ἐπ᾽ ἔργοισιν πίστις ἔπ᾽ οὐδεμία,	- u u --- -u u -uu-	dactylic pentameter	
ἀλλὰ δόλους τ᾽ἀπάτας τε πολυπλοκίας τ᾽ἐφίλησαν	-u u- uu- u u-uu- uu--	dactylic hexameter	masculine penthemimeral, trithemimeral
οὕτως ὡς ἄνδρες μηκέτι σῳζόμενοι.	-- - -- -uu -uu-	dactylic pentameter	
μήποτε, Κύρνε, κακῷ πίσυνος βούλευε σὺν ἀνδρί,	-uu -u u- uu- --u u --	dactylic hexameter	masculine penthemimeral, hepthemimeral
εὖτ᾽ ἂν σπουδαῖον πρῆγμ᾽ ἐθέλῃς τελέσαι,	- - --- - uu- uu-	dactylic pentameter	
ἀλλὰ μετ᾽ ἐσθλὸν ἰὼν βούλευ καὶ πολλὰ μογήσας	-u u -u u- -- - -u u--	dactylic hexameter	masculine penthemimeral, hepthemimeral
καὶ μακρὴν ποσσὶν, Κύρν᾽, ὁδὸν ἐκτελέσας.	- -- -- - uu -uu-	dactylic pentameter	
πρῆξιν μηδὲ φίλοισιν ὅλως ἀνακοινέο πᾶσι·	-- -u u-u u- uu-uu --	dactylic hexameter	feminine penthemimeral, hepthemimeral
παῦροί τοι πολλῶν πιστὸν ἔχουσι νόον.	-- - -- -u u-u u-	dactylic pentameter	
Παύροισιν πίσυνος μεγάλ᾽ ἀνδράσιν ἔργ᾽ ἐπιχείρει,	--- uu- uu -uu - uu--	dactylic hexameter	masculine penthemimeral, trithemimeral
μή ποτ᾽ ἀνήκεστον, Κύρνε, λάβῃς ἀνίην.	- u u--- -u u- uu-	dactylic pentameter	
πιστὸς ἀνὴρ χρυσοῦ τε καὶ ἀργύρου ἀντερύσασθαι	-u u- -- u u -uu -uu--	dactylic hexameter	masculine penthemimeral, trithemimeral
ἄξιος ἐν χαλεπῇ, Κύρνε, διχοστασίῃ.	-uu - uu- -u u-uu-	dactylic pentameter	
παύρους εὑρήσεις, Πολυπαΐδη, ἄνδρας ἑταίρους	-- --- uu-uu -u u--	dactylic hexameter	masculine penthemimeral
πιστοὺς ἐν χαλεποῖς πρήγμασι γινομένους,	-- - uu- -uu -uu-	dactylic pentameter	
οἵτινες ἂν τολμῷεν ὁμόφρονα θυμὸν ἔχοντες	-uu - --u u-uu -u u--	dactylic hexameter	feminine penthemimeral, trithemimeral
ἶσον τῶν ἀγαθῶν τῶν τε κακῶν μετέχειν.	-- - uu- - u u- uu-	dactylic pentameter	
τούτων οὐχ εὕροις διζήμενος, οὐδ᾽ ἐπὶ πάντας	-- - -- --uu - uu --	dactylic hexameter	masculine penthemimeral, trithemimeral
ἀνθρώπους, οὓς ναῦς μὴ μία πάντας ἄγοι,	--- - - - uu -u u-	dactylic pentameter	
οἷσιν ἐπὶ γλώσσῃ τε καὶ ὀφθαλμοῖσιν ἔπεστιν	-u u- -- u u ---u u--	dactylic hexameter	masculine penthemimeral, trithemimeral
αἰδώς, οὐδ᾽ αἰσχρὸν χρῆμ᾽ ἔπι κέρδος ἄγει.	-- - -- - uu -u u-	dactylic pentameter	
μή μ᾽ἔπεσιν μὲν στέργε νόον δ᾽ἔχε καὶ φρένας ἄλλῃ,	- uu- - -u u- uu - uu --	dactylic hexameter	feminine penthemimeral, hepthemimeral, trithemimeral
εἴ με φιλεῖς καί σοι πιστὸς ἔνεστι νόος,	- u u- - - -u u-u u-	dactylic pentameter	
ἀλλὰ φίλει καθαρὸν θέμενος νόον, ἤ μ᾽ἀποειπὼν	-u u- uu- uu- uu - uu--	dactylic hexameter	masculine penthemimeral, hepthemimeral, trithemimeral
ἔχθαιρ᾽ ἀμφαδίην νεῖκος ἀειράμενος.	-- -uu- -u u-uu-	dactylic pentameter	
ὃς δὲ μιῇ γλώσσῃ δίχ᾽ ἔχει νόον, οὗτος ἑταῖρος	- u u- -- u u- uu -u u--	dactylic hexameter	masculine penthemimeral, hepthemimeral, trithemimeral
δεινός, Κύρν᾽, ἐχθρὸς βέλτερος ἢ φίλος ὤν.	-- - -- -uu - uu -	dactylic pentameter	
ἤν τις ἐπαινήσῃ σε τόσον χρόνον ὅσσον ὁρῴη	- u u--- u u- uu -u u--	dactylic hexameter	masculine penthemimeral, hepthemimeral
νοσφισθεὶς δ᾽ἄλλῃ γλῶσσαν ἱῇσι κακήν,	--- -- -u u-u u-	dactylic pentameter	
τοιοῦτός τοι ἑταῖρος ἀνὴρ φίλος οὔτι μάλ᾽ ἐσθλός,	--- u u-u u- uu -u u --	dactylic hexameter	feminine penthemimeral, hepthemimeral, trithemimeral
ὅς κ᾽εἴπῃ γλώσσῃ λῷα φρονῇ δ᾽ἕτερα.	- -- -- -u u- uu-	dactylic pentameter	
ἀλλ᾽ εἴη τοιοῦτος ἐμοὶ φίλος, ὃς τὸν ἑταῖρον	- -- --u u- uu - u u--	dactylic hexameter	feminine penthemimeral, hepthemimeral, trithemimeral
γινώσκων ὀργὴν καὶ βαρὺν ὄντα φέρει	--- -- - uu -u u-	dactylic pentameter	
ἀντὶ κασιγνήτου. σὺ δέ μοι, φίλε, ταῦτ᾽ ἐνὶ θυμῷ	-u u--- u u - uu - uu --	dactylic hexameter	masculine penthemimeral, hepthemimeral
φράζεο, καί ποτέ μου μνήσεαι ἐξοπίσω.	-uu - uu - -uu -uu-	dactylic pentameter	
μηδείς σ᾽ἀνθρώπων πείσαι κακὸν ἄνδρα φιλῆσαι,	-- --- -- uu -u u--	dactylic hexameter	masculine penthemimeral, hepthemimeral
Κύρνε· τί δ᾽ἔστ᾽ ὄφελος δειλὸς ἀνὴρ φίλος ὤν;	-u u - uu- -u u- uu -	dactylic pentameter	
οὔτ᾽ ἄν σ᾽ἐκ χαλεποῖο πόνου ῥύσαιτο καὶ ἄτης,	- - - uu-u u- --u u --	dactylic hexameter	feminine penthemimeral, hepthemimeral, trithemimeral
οὔτε τι ἐσθλὸν ἔχων τοῦ μεταδοῦν ἐθέλοι.	-u u -u u- - uu- uu-	dactylic pentameter	
δειλοὺς εὖ ἕρδοντι ματαιοτάτη χάρις ἐστίν·	-- - --u u-uu- uu --	dactylic hexameter	feminine penthemimeral, trithemimeral
ἶσον καὶ σπείρειν πόντον ἁλὸς πολιῆς.	-- - -- -u u- uu-	dactylic pentameter	
οὔτε γὰρ ἂν πόντον σπείρων βαθὺ λήϊον ἀμῷς,	-u u - -- -- uu -uu --	dactylic hexameter	masculine penthemimeral, hepthemimeral, trithemimeral
οὔτε κακοὺς εὖ δρῶν εὖ πάλιν ἀντιλάβοις.	-u u- - - - uu -uu-	dactylic pentameter	
ἄπληστον γὰρ ἔχουσι κακοὶ νόον· ἢν δ᾽ἓν ἁμάρτῃς,	--- u u-u u- uu - u u--	dactylic hexameter	feminine penthemimeral, hepthemimeral, trithemimeral
τῶν πρόσθεν πάντων ἐκκέχυται φιλότης·	- -- -- -uu- uu-	dactylic pentameter	
οἱ δ᾽ἀγαθοὶ τὸ κάκιστον ἀμαυρίσκουσι παθόντες,	- uu- u u-u u---u u--	dactylic hexameter	feminine penthemimeral, trithemimeral
μνῆμα δ᾽ἔχουσ᾽ ἀγαθῶν καὶ χάριν ἐξοπίσω.	-u u- uu- - uu -uu-	dactylic pentameter	
μήποτέ τοι κακὸν ἄνδρα φίλον ποιεῖσθαι ἑταῖρον,	-uu - uu -u u- --u u--	dactylic hexameter	feminine penthemimeral, hepthemimeral, trithemimeral
ἀλλ᾽ αἰεὶ φεύγειν ὥστε κακὸν λιμένα.	- -- -- -u u- uu-	dactylic pentameter	
πολλοί τοι πόσιος καὶ βρώσιός εἰσιν ἑταῖροι,	-- - uu- - -uu -u u--	dactylic hexameter	masculine penthemimeral, trithemimeral
ἐν δὲ σπουδαίῳ πρήγματι παυρότεροι.	- - --- -uu -uu-	dactylic pentameter	
κιβδήλου δ᾽ἀνδρὸς γνῶναι χαλεπώτερον οὐδέν,	--- -- -- uu-uu --	dactylic hexameter	masculine penthemimeral, hepthemimeral, trithemimeral
Κύρν᾽, οὐδ᾽ εὐλαβιης ἔσθ᾽ ὅτι δεῖ πλέονος.	- - -uu- - uu - uu-	dactylic pentameter	
χρυσοῦ κιβδήλοιο καὶ ἀργύρου ἀνσχετὸς ἄτη,	-- ---u u -uu -uu --	dactylic hexameter	feminine penthemimeral
Κύρνε, καὶ ἐξευρεῖν ῥᾴδιον ἀνδρὶ σοφῷ·	-u u --- -uu -u u-	dactylic pentameter	
εἰ δὲ φίλου νόος ἀνδρὸς ἐνὶ στήθεσσι λελήθῃ	- u u- uu -u u- --u u--	dactylic hexameter	feminine penthemimeral, hepthemimeral, trithemimeral
ψυδρὸς ἐών, δόλιον δ᾽ἐν φρεσὶν ἦτορ ἔχῃ,	-u u- uu- - uu -u u-	dactylic pentameter	
τοῦτο θεὸς κιβδηλότατον ποίησε βροτοῖσιν,	-u u- --uu- --u u--	dactylic hexameter	hepthemimeral, trithemimeral
καὶ γνῶναι πάντων τοῦτ᾽ ἀνιηρότατον.	- -- -- - uu-uu-	dactylic pentameter	
οὐ γὰρ ἂν εἰδείης ἀνδρὸς νόον οὐδὲ γυναικός,	- u u --- -- uu -u u--	dactylic hexameter	masculine penthemimeral, hepthemimeral
πρὶν πειρηθείης ὥσπερ ὑποζυγίου·	- ---- -u u-uu-	dactylic pentameter	
οὐδέ κεν εἰκάσσαις ὥσπερ ποτ᾽ ἐς ὤνιον ἐλθών·	-u u --- -- u u -uu --	dactylic hexameter	masculine penthemimeral, hepthemimeral
πολλάκι γὰρ γνώμην ἐξαπατῶσ᾽ ἰδέαι.	-uu - -- -uu- uu-	dactylic pentameter	
μήτ᾽ ἀρετὴν εὔχου, Πολυπαΐδη, ἔξοχος εἶναι,	- uu- -- uu-uu -uu --	dactylic hexameter	masculine penthemimeral, trithemimeral
μήτ᾽ ἄφενος· μοῦνον δ᾽ἀνδρὶ γένοιτο τύχη.	- uu- -- -u u-u u-	dactylic pentameter	
οὐδὲν ἐν ἀνθρώποισι πατρὸς καὶ μητρὸς ἄμεινον	-u u ---u u- - -u u--	dactylic hexameter	feminine penthemimeral, hepthemimeral
ἔπλετο τοῖς ὁσίη, Κύρνε, μέμηλε δίκη.	-uu - uu- -u u-u u-	dactylic pentameter	
οὐδείς, Κύρν᾽, ἄτης καὶ κέρδεος αἴτιος αὐτός,	-- - -- - -uu -uu --	dactylic hexameter	masculine penthemimeral, trithemimeral
ἀλλὰ θεοὶ τούτων δώτορες ἀμφοτέρων·	-u u- -- -uu -uu-	dactylic pentameter	
οὐδέ τις ἀνθρώπων ἐργάζεται ἐν φρεσὶν εἰδὼς	-u u --- --uu - uu --	dactylic hexameter	masculine penthemimeral
ἐς τέλος εἴτ᾽ ἀγαθὸν κίνυται εἴτε κακόν.	- uu - uu- -uu -u u-	dactylic pentameter	
πολλάκι γὰρ δοκέων θήσειν κακὸν ἐσθλὸν ἔθηκεν	-uu - uu- -- uu -u u--	dactylic hexameter	masculine penthemimeral, hepthemimeral, trithemimeral
καί τε δοκῶν θήσειν ἐσθλὸν ἔθηκε κακόν.	- u u- -- -u u-u u-	dactylic pentameter	
οὐδέ τῳ ἀνθρώπων παραγίνεται ὅσσα θέλῃσιν·	-u u --- uu-uu -u u--	dactylic hexameter	masculine penthemimeral
ἴσχει γὰρ χαλεπῆς πείρατ᾽ ἀμηχανίης.	-- - uu- -u u-uu-	dactylic pentameter	
ἄνθρωποι δὲ μάταια νομίζομεν, εἰδοτες οὐδέν·	--- u u-u u-uu -uu --	dactylic hexameter	feminine penthemimeral, trithemimeral
θεοὶ δὲ κατὰ σφέτερον πάντα τελοῦσι νόον.	- u u- -uu -u u-u u-	lyric	
οὐδείς πω ξεῖνον, Πολυπαΐδη, ἐξαπατήσας	-- - -- uu-uu -uu--	dactylic hexameter	masculine penthemimeral, trithemimeral
οὐδ᾽ ἱκέτην θνητῶν ἀθανάτους ἔλαθεν.	- uu- -- -uu- uu-	dactylic pentameter	
βούλεο δ᾽εὐσεβέων ὀλίγοις σὺν χρήμασιν οἰκεῖν	-uu -uu- uu- - -uu --	dactylic hexameter	masculine penthemimeral, hepthemimeral
ἢ πλουτεῖν ἀδίκως χρήματα πασάμενος.	- -- uu- -uu -uu-	dactylic pentameter	
ἐν δὲ δικαιοσύνῃ συλλήβδην πᾶσ᾽ ἀρετή 'στι,	- u u-uu- --- - uu- -	dactylic hexameter	masculine penthemimeral
πᾶς δέ τ᾽ἀνὴρ ἀγαθός, Κύρνε, δίκαιος ἐών.	- u u- uu- -u u-u u-	dactylic pentameter	
χρήματα μὲν δαίμων καὶ παγκάκῳ ἀνδρὶ δίδωσιν,	-uu - -- - -uu -u u--	dactylic hexameter	masculine penthemimeral, trithemimeral
Κύρν᾽· ἀρετῆς δ᾽ὀλίγοις ἀνδράσι μοῖρ᾽ ἕπεται.	- uu- uu- -uu - uu-	dactylic pentameter	
Γ̔́βριν, Κύρνε, θεὸς πρῶτον κακῷ ὤπασεν ἀνδρί,	-- -u u- -- uu -uu --	dactylic hexameter	masculine penthemimeral, hepthemimeral
οὗ μέλλει χώρην μηδεμίαν θέμεναι.	- -- -- -uu- uu-	dactylic pentameter	
τίκτει τοι κόρος ὕβριν, ὅταν κακῷ ὄλβος ἕπηται	-- - uu -u u- uu -u u--	dactylic hexameter	feminine penthemimeral, hepthemimeral, trithemimeral
ἀνθρώπῳ, καὶ ὅτῳ μὴ νόος ἄρτιος ᾖ.	--- u u- - uu -uu -	dactylic pentameter	
μήποτέ μοι πενίην θυμοφθόρον ἀνδρὶ χολωθεὶς	-uu - uu- --uu -u u--	dactylic hexameter	masculine penthemimeral, trithemimeral
μηδ᾽ ἀχρημοσύνην οὐλομένην πρόφερε·	- --uu- -uu- uu-	dactylic pentameter	
Ζεὺς γάρ τοι τὸ τάλαντον ἐπιρρέπει ἄλλοτε ἄλλως,	- - - u u-u u-uu -uu --	dactylic hexameter	feminine penthemimeral, trithemimeral
ἄλλοτε μὲν πλουτεῖν, ἄλλοτε μηδὲν ἔχειν.	-uu - -- -uu -u u-	dactylic pentameter	
μήποτε, Κύρν᾽, ἀγορᾶσθαι ἔπος μέγα· οἶδε γὰρ οὐδεὶς	-uu - uu-u u- uu -u u --	dactylic hexameter	feminine penthemimeral, hepthemimeral, trithemimeral
ἀνθρώπων ὅτι νὺξ χἠμέρη ἀνδρὶ τελεῖ.	--- uu - -uu -u u-	dactylic pentameter	
πολλοί τοι χρῶνται δειλαῖς φρεσί, δαίμονι δ᾽ἐσθλῷ,	-- - -- -- uu -uu --	dactylic hexameter	masculine penthemimeral, hepthemimeral, trithemimeral
οἷς τὸ κακὸν δοκέον γίγνεται εἰς ἀγαθόν·	- u u- uu- -uu - uu-	dactylic pentameter	
εἰσὶν δ᾽οἳ βουλῇ τ᾽ἀγαθῇ καὶ δαίμονι δειλῷ	-- - -- uu- - -uu --	dactylic hexameter	masculine penthemimeral, hepthemimeral, trithemimeral
μοχθίζουσι, τέλος δ᾽ἔργμασιν οὐχ ἕπεται.	---u u- -uu - uu-	dactylic pentameter	
οὐδεὶς ἀνθρώπων οὔτ᾽ ὄλβιος οὔτε πενιχρὸς	-- --- - -uu -u u--	dactylic hexameter	masculine penthemimeral
οὔτε κακὸς νόσφιν δαίμονος οὔτ᾽ ἀγαθός.	-u u- -- -uu - uu-	dactylic pentameter	
ἄλλ᾽ ἄλλῳ κακόν ἐστι, τὸ δ᾽ἀτρεκὲς ὄλβιος οὐδεὶς	- -- uu -u u -uu -uu --	dactylic hexameter	feminine penthemimeral, trithemimeral
ἀνθρώπων ὁπόσους ἠέλιος καθορᾷ.	--- uu- -uu- uu-	dactylic pentameter	
ὃν δὲ θεοὶ τιμώσ᾽, ὃν χὠ μωμεύμενος αἰνεῖ·	- u u- -- - - --uu --	dactylic hexameter	masculine penthemimeral, hepthemimeral, trithemimeral
ἀνδρὸς δὲ σπουδὴ γίνεται οὐδεμία.	-- - -- -uu -uu-	dactylic pentameter	
θεοῖς εὔχου· θεοῖς ἐστιν ἔπι κράτος· οὔτοι ἄτερ θεῶν	- -- - -u u- uu -u u- -	dactylic hexameter	feminine penthemimeral, hepthemimeral, trithemimeral
γίνεται ἀνθρώποις οὔτ᾽ ἀγάθ᾽ οὔτε κακά.	-uu --- - uu -u u-	dactylic pentameter	
ἄνδρ᾽ ἀγαθὸν πενίη πάντων δάμνησι μάλιστα	- uu- uu- -- --u u--	dactylic hexameter	masculine penthemimeral, hepthemimeral, trithemimeral
καὶ γήρως πολιοῦ, Κύρνε, καὶ ἠπιάλου·	- -- uu- -u u -uu-	dactylic pentameter	
ἣν δὴ χρὴ φεύγοντα καὶ ἐς βαθυκήτεα πόντον	- - - --u u - uu-uu --	dactylic hexameter	feminine penthemimeral, hepthemimeral, trithemimeral
ῥιπτεῖν καὶ πετρέων, Κύρνε, κατ᾽ ἠλιβάτων.	-- - uu- -u u -uu-	dactylic pentameter	
πᾶς γὰρ ἀνὴρ πενίῃ δεδμημένος οὔτε τι εἰπεῖν	- u u- uu- --uu -u u --	dactylic hexameter	masculine penthemimeral, trithemimeral
οὔθ᾽ ἕρξαι δύναται, γλῶσσα δέ οἱ δέδεται.	- -- uu- -u u - uu-	dactylic pentameter	
χρὴ γὰρ ὁμῶς ἐπὶ γῆν τε καὶ εὐρέα νῶτα θαλάσσης	- u u- uu - u u -uu -u u--	dactylic hexameter	masculine penthemimeral, trithemimeral
δίζησθαι χαλεπῆς, Κύρνε, λύσιν πενίης.	--- uu- -u u- uu-	dactylic pentameter	
τεθνάμεναι, φίλε Κύρνε, πενιχρῷ βέλτερον ἀνδρὶ	-uu- uu -u u-- -uu --	dactylic hexameter	feminine penthemimeral, trithemimeral
ἢ ζώειν χαλεπῇ τειρόμενον πενίῃ.	- -- uu- -uu- uu-	dactylic pentameter	
κριοὺς μὲν καὶ ὄνους διζήμεθα, Κύρνε, καὶ ἵππους	-- - u u- --uu -u u --	dactylic hexameter	masculine penthemimeral, trithemimeral
εὐγενέας, καὶ τις βούλεται ἐξ ἀγαθῶν	-uu- - - -uu - uu-	dactylic pentameter	
πάσασθαι· γῆμαι δὲ κακὴν κακοῦ οὐ μελεδαίνει	--- -- u u- uu - uu--	dactylic hexameter	masculine penthemimeral, hepthemimeral, trithemimeral
ἐσθλὸς ἀνήρ, ἤν τις χρήματα πολλὰ διδῷ·	-u u- - - -uu -u u-	dactylic pentameter	
οὐδὲ γυνὴ κακοῦ ἀνδρὸς ἀναίνεται εἶναι ἄκοιτις	-u u- uu -u u-uu -u u--	dactylic hexameter	feminine penthemimeral, trithemimeral
πλουσίου, ἀλλ᾽ ἀφνεὸν βούλεται ἀντ᾽ ἀγαθοῦ.	-uu - -- -uu - uu-	dactylic pentameter	
χρήματα γὰρ τιμῶσι· καὶ ἐκ κακοῦ ἐσθλὸς ἔγημεν	-uu - --u u - uu -u u--	dactylic hexameter	feminine penthemimeral, hepthemimeral, trithemimeral
καὶ κακὸς ἐξ ἀγαθοῦ· πλοῦτος ἔμειξε γένος.	- uu - uu- -u u-u u-	dactylic pentameter	
οὕτω μὴ θαύμαζε γένος, Πολυπαΐδη, ἀστῶν	-- - --u u- uu-uu --	dactylic hexameter	feminine penthemimeral, hepthemimeral, trithemimeral
μαυροῦσθαι· σὺν γὰρ μίσγεται ἐσθλὰ κακοῖς.	--- - - -uu -u u-	dactylic pentameter	
αὐτὸς ὁ τοιαύτην εἰδὼς κακόπατριν ἐοῦσαν	-u u --- -- uu-u u--	dactylic hexameter	masculine penthemimeral, hepthemimeral
εἰς οἴκους ἄγεται χρήμασι πείθομενος,	- -- uu- -uu -uu-	dactylic pentameter	
εὔδοξος κακόδοξον, ἐπεὶ κρατερή μιν ἀνάγκη	--- uu-u u- uu- u u--	dactylic hexameter	feminine penthemimeral, hepthemimeral, trithemimeral
ἐντύει, ἥτ᾽ ἀνδρὸς τλήμονα θῆκε νόον.	-uu - -- -uu -u u-	dactylic pentameter	
χρῆμα δ᾽ὃ μὲν Διόθεν καὶ σὺν δίκῃ ἀνδρὶ γένηται	-u u - uu- - - uu -u u--	dactylic hexameter	masculine penthemimeral, hepthemimeral, trithemimeral
καὶ καθαρῶς, αἰεὶ παρμόνιμον τελέθει·	- uu- -- -uu- uu-	dactylic pentameter	
εἰ δ᾽ἀδίκως παρὰ καιρὸν ἀνὴρ φιλοκερδέϊ θυμῷ	- uu- uu -u u- uu-uu --	dactylic hexameter	feminine penthemimeral, hepthemimeral, trithemimeral
κτήσεται, εἴθ᾽ ὅρκῳ πὰρ τὸ δίκαιον ἑλών,	-uu - -- - u u-u u-	dactylic pentameter	
αὐτίκα μέν τι φέρειν κέρδος δοκεῖ, ἐς δὲ τελευτὴν	-uu - u u- -- uu - u u--	dactylic hexameter	masculine penthemimeral, hepthemimeral, trithemimeral
αὖθις ἔγεντο κακόν, θεῶν δ᾽ὑπερέσχε νόος.	-u u-u u- - uu-u u-	dactylic pentameter	
ἀλλὰ τάδ᾽ ἀνθρώπων ἀπατᾷ νόον· οὐ γὰρ ἐπ᾽ αὐτοῦ	-u u --- uu- uu - u u --	dactylic hexameter	masculine penthemimeral, hepthemimeral
τίνονται μάκαρες πρήγματος ἀμπλακίας·	--- uu- -uu -uu-	dactylic pentameter	
ἀλλ᾽ ὁ μὲν αὐτὸς ἔτεισε κακὸν χρέος, οὐδὲ φίλοισιν	- u u -u u-u u- uu -u u--	dactylic hexameter	feminine penthemimeral, hepthemimeral
ἄτην ἐξοπίσω παισὶν ἐπεκρέμασεν·	-- -uu- -u u-uu-	dactylic pentameter	
ἄλλον δ᾽οὐ κατέμαρψε δίκη· θάνατος γὰρ ἀναιδὴς	-- - uu-u u- uu- u u--	dactylic hexameter	feminine penthemimeral, hepthemimeral, trithemimeral
πρόσθεν ἐπὶ βλεφάροις ἕζετο κῆρα φέρων.	-u u- uu- -uu -u u-	dactylic pentameter	
οὐδείς τοι φεύγοντι φίλος καὶ πιστὸς ἑταῖρος·	-- - --u u- - -u u--	dactylic hexameter	feminine penthemimeral, hepthemimeral, trithemimeral
τῆς δὲ φυγῆς ἐστιν τοῦτ᾽ ἀνιηρότερον.	- u u- -- - uu-uu-	dactylic pentameter	
οἶνόν τοι πίνειν πουλὺν κακόν· ἢν δέ τις αὐτὸν	-- - -- -- uu - u u --	dactylic hexameter	masculine penthemimeral, hepthemimeral, trithemimeral
πίνῃ ἐπισταμένως, οὐ κακὸς ἀλλ᾽ ἀγαθός.	-u u-uu- - uu - uu-	dactylic pentameter	
θυμέ, φίλους κατὰ πάντας ἐπίστρεφε ποικίλον ἦθος,	-u u- uu -u u-uu -uu --	dactylic hexameter	feminine penthemimeral, trithemimeral
ὀργὴν συμμίσγων ἥντιν᾽ ἕκαστος ἔχει.	-- --- -u u-u u-	dactylic pentameter	
πουλύπου ὀργὴν ἴσχε πολυπλόκου, ὃς ποτὶ πέτρῃ	-uu -- -u u-uu - uu --	dactylic hexameter	feminine penthemimeral
τῇ προσομιλήσῃ τοῖος ἰδεῖν ἐφάνη·	- uu--- -u u- uu-	dactylic pentameter	
νῦν μὲν τῇδ᾽ ἐφέπου, τότε δ᾽ἀλλοῖος χρόα γίνου.	- - - uu- uu --- uu --	dactylic hexameter	masculine penthemimeral, trithemimeral
κρέσσων τοι σοφίη γίνεται ἀτροπίης.	-- - uu- -uu -uu-	dactylic pentameter	
μηδὲν ἄγαν ἄσχαλλε ταρασσομένων πολιητέων,	-u u- --u u-uu- uu--	dactylic hexameter	feminine penthemimeral, trithemimeral
Κύρνε, μέσην δ᾽ἔρχευ τὴν ὁδὸν ὥσπερ ἐγώ.	-u u- -- - uu -u u-	dactylic pentameter	
†ὅστις τοι δοκέει τὸν πλησίον ἴδμεναι οὐδέν,	-- - uu- - -uu -uu --	dactylic hexameter	masculine penthemimeral, trithemimeral
ἀλλ᾽ αὐτὸς μοῦνος ποικίλα δήνἐ ἔχειν,	- -- -- -uu -u u-	dactylic pentameter	
κεῖνός γ᾽ἄφρων ἐστὶ νόου βεβλαμμένος ἐσθλοῦ.	-- -- -u u- --uu --	dactylic hexameter	feminine penthemimeral, hepthemimeral
ἴσως γὰρ πάντες ποικίλ᾽ ἐπιστάμεθα,	-- - -- -u u-uu-	dactylic pentameter	
ἀλλ᾽ ὁ μὲν οὐκ ἐθέλει κακοκερδείῃσιν ἕπεσθαι,	- u u - uu- uu---u u--	dactylic hexameter	masculine penthemimeral, trithemimeral
τῷ δὲ δολοπλοκίαι μᾶλλον ἄπιστοι ἅδον.	- u u-uu- -u u-u u-	dactylic pentameter	
πλούτου δ᾽οὐδὲν τέρμα πεφασμένον ἀνθρώποισιν·	-- -- -u u-uu ----	dactylic hexameter	feminine penthemimeral
οἳ γὰρ νῦν ἡμῶν πλεῖστον ἔχουσι βίον,	- - - -- -u u-u u-	dactylic pentameter	
διπλάσιον σπεύδουσι. τίς ἂν κορέσειεν ἅπαντας;	-uu- --u u - uu-u u--	dactylic hexameter	feminine penthemimeral, hepthemimeral, trithemimeral
χρήματά τοι θνητοῖς γίνεται ἀφροσύνη·	-uu - -- -uu -uu-	dactylic pentameter	
ἄτη δ᾽ἐξ αὐτῆς ἀναφαίνεται, ἣν ὁπότε Ζεὺς	-- - -- uu-uu - uu- -	dactylic hexameter	masculine penthemimeral, trithemimeral
πέμψῃ τειρομένοις, ἄλλοτε ἄλλος ἔχει.	-- -uu- -uu -u u-	dactylic pentameter	
ἀκρόπολις καὶ πύργος ἐὼν κενεόφρονι δήμῳ,	-uu- - -u u- uu-uu --	dactylic hexameter	feminine penthemimeral, hepthemimeral, trithemimeral
Κύρν᾽, ὀλίγης τιμῆς ἔμμορεν ἐσθλὸς ἀνήρ.	- uu- -- -uu -u u-	dactylic pentameter	
οὐδὲν ἔτι πρέπει ἧμιν ἅτ᾽ ἀνδράσι σῳζομένοισιν·	-u u- uu -u u -uu -uu--	dactylic hexameter	feminine penthemimeral, trithemimeral
ἀλλ᾽ ὡς πάγχυ πόλει, Κύρνε, ἁλωσομένῃ.	- - -u u- -u u-uu-	dactylic pentameter	
σοὶ μὲν ἐγὼ πτέρ᾽ ἔδωκα, σὺν οἷς ἐπ᾽ ἀπείρονα πόντον	- u u- u u-u u - u u-uu --	dactylic hexameter	feminine penthemimeral, hepthemimeral, trithemimeral
πωτήσει καὶ γῆν πᾶσαν ἀειρόμενος	--- - - -u u-uu-	dactylic pentameter	
ῥηϊδίως· θοίνῃς δὲ καὶ εἰλαπίνῃσι παρέσσῃ	-uu- -- u u -uu-u u--	dactylic hexameter	masculine penthemimeral, trithemimeral
ἐν πάσαις, πολλῶν κείμενος ἐν στόμασιν,	- -- -- -uu - uu-	dactylic pentameter	
καί σε σὺν αὐλίσκοισι λιγυφθόγγοις νέοι ἄνδρες	- u u ---u u--- uu --	dactylic hexameter	feminine penthemimeral
εὐκόσμως ἐρατοὶ καλά τε καὶ λιγέα	--- uu- -u u - uu-	dactylic pentameter	
ᾁσονται. καὶ ὅταν δνοφερῆς ὑπὸ κεύθεσι γαίης	--- u u- uu- uu -uu --	dactylic hexameter	masculine penthemimeral, hepthemimeral, trithemimeral
βῇς πολυκωκύτους εἰς Ἀΐδαο δόμους,	- uu--- - uu-u u-	dactylic pentameter	
οὐδέποτ᾽ οὐδὲ θανὼν ἀπολεῖς κλέος, ἀλλὰ μελήσεις	-uu -u u- uu- uu -u u--	dactylic hexameter	masculine penthemimeral, hepthemimeral
ἄφθιτον ἀνθρώποις αἰὲν ἔχων ὄνομα,	-uu --- -u u- uu-	dactylic pentameter	
Κύρνε, καθ᾽ Ἐλλάδα γῆν στρωφώμενος ἠδ᾽ ἀνὰ νήσους,	-u u -uu - --uu - uu --	dactylic hexameter	masculine penthemimeral
ἰχθυόεντα περῶν πόντον ἐπ᾽ ἀτρύγετον,	-uu-u u- -u u -uu-	dactylic pentameter	
οὐχ ἵππων νώτοισιν ἐφήμενος, ἀλλά σε πέμψει	- -- --u u-uu -u u --	dactylic hexameter	feminine penthemimeral, trithemimeral
ἀγλαὰ Μουσάων δῶρα ἰοστεφάνων	-uu --- -u u-uu-	dactylic pentameter	
πᾶσιν ὅσοισι μέμηλε, καὶ ἐσσομένοισιν ἀοιδὴ	-u u-u u-u u -uu-u u--	dactylic hexameter	feminine penthemimeral
ἔσσῃ ὁμῶς, ὄφρ᾽ ᾖ γῆ τε καὶ ἠέλιος.	-u u- - - - u u -uu-	dactylic pentameter	
αὐτὰρ ἐγὼν ὀλίγης παρὰ σεῦ οὐ τυγχάνω αἰδοῦς,	-u u- uu- uu - - -uu --	dactylic hexameter	masculine penthemimeral, hepthemimeral, trithemimeral
ἀλλ᾽ ὥσπερ μικρὸν παῖδα λόγοις μ᾽ἀπατᾷς.	- -- -- -u u- uu-	dactylic pentameter	
κάλλιστον τὸ δικαιότατον, λῷστον δ᾽ὑγιαίνειν,	--- u u-uu- -- uu--	dactylic hexameter	hepthemimeral, trithemimeral
πρᾶγμα δὲ τερπνότατον τοῦ τις ἐρᾷ τὸ τυχεῖν.	-u u -uu- - u u- u u-	dactylic pentameter	
ἵππος ἐγὼ καλὴ καὶ ἀεθλίη, ἀλλὰ κάκιστον	-u u- -- u u-uu -u u--	dactylic hexameter	masculine penthemimeral, trithemimeral
ἄνδρα φέρω, καί μοι τοῦτ᾽ ἀνιηρότατον·	-u u- - - - uu-uu-	dactylic pentameter	
πολλάκι δ᾽ἠμέλλησα διαρρήξασα χαλινὸν	-uu ---u u---u u--	dactylic hexameter	feminine penthemimeral
φεύγεν, ἀπωσαμένη τὸν κακὸν ἡνίοχον.	-u u-uu- - uu -uu-	dactylic pentameter	
οὔ μοι πίνεται οἶνος, ἐπεὶ παρὰ παιδὶ τερείνῃ	- - -uu -u u- uu -u u--	dactylic hexameter	feminine penthemimeral, hepthemimeral
ἄλλος ἀνὴρ κατέχει πολλὸν ἐμοῦ κακίων·	-u u- uu- -u u- uu-	dactylic pentameter	
ψυχρόν μοι παρὰ τῇδε φίλοι πίνουσι τοκῆες,	-- - uu -u u- --u u--	dactylic hexameter	feminine penthemimeral, hepthemimeral, trithemimeral
ὥστε κάμ᾽ ὑδρείῳ καί με γοῶσα φέρει,	-u u --- - u u-u u-	dactylic pentameter	
ἔνθα μέσην περὶ παῖδα βαλὼν ἀγκῶν᾽ ἐφίλησα	-u u- uu -u u- -- uu--	dactylic hexameter	feminine penthemimeral, hepthemimeral, trithemimeral
δειρήν, ἡ δὲ τέρεν φθέγγετ᾽ ἀπὸ στόματος.	-- - u u- -u u- uu-	dactylic pentameter	
Γνωτή τοι πενίη γε καὶ ἀλλοτρίη περ ἐοῦσα·	-- - uu- u u -uu- u u--	dactylic hexameter	masculine penthemimeral, trithemimeral
οὔτε γὰρ εἰς ἀγορὴν ἔρχεται οὔτε δίκας·	-u u - uu- -uu -u u-	dactylic pentameter	
πάντῃ γὰρ τοὔλασσον ἔχει, πάντῃ δ᾽ἐπίμυκτος,	-- - --u u- -- uu--	dactylic hexameter	feminine penthemimeral, hepthemimeral, trithemimeral
πάντῃ δ᾽ἐχθρὴ ὁμῶς γίνεται ἔνθα περ ᾖ.	-- -u u- -uu -u u -	dactylic pentameter	
ἴσως τοι τὰ μὲν ἄλλα θεοὶ θνητοῖς ἀνθρώποις	-- - u u -u u- -- ---	dactylic hexameter	feminine penthemimeral, hepthemimeral, trithemimeral
γῆρας τ᾽οὐλόμενον καὶ νεότητ᾽ ἔδοσαν·	-- -uu- - uu- uu-	dactylic pentameter	
τῶν πάντων δ᾽ὃ κάκιστον ἐν ἀνθρώποις θανάτου τε	- -- u u-u u --- uu- -	dactylic hexameter	feminine penthemimeral, trithemimeral
καὶ πασέων νούσων ἐστὶ πονηρότερον,	- uu- -- -u u-uu-	dactylic pentameter	
παῖδας ἐπεὶ θρέψαιο καὶ ἄρμενα πάντα παράσχοις,	-u u- --u u -uu -u u--	dactylic hexameter	feminine penthemimeral, trithemimeral
χρήματα δ᾽ἐγκαταθῇς πόλλ᾽ ἀνιηρὰ παθών,	-uu -uu- - uu-u u-	dactylic pentameter	
τὸν πατέρ᾽ ἐχθαίρουσι, καταρῶνται δ᾽ἀπολέσθαι,	- uu ---u u--- uu--	dactylic hexameter	feminine penthemimeral
καὶ στυγέουσ᾽ ὥσπερ πτωχὸν ἐσερχόμενον.	- uu- -- -u u-uu-	dactylic pentameter	
εἰκός τοι κακὸν ἄνδρα κακῶς τὰ δίκαια νομίζειν,	-- - uu -u u- u u-u u--	dactylic hexameter	feminine penthemimeral, hepthemimeral, trithemimeral
μηδεμίαν κατόπισθ᾽ ἁζόμενον νέμεσιν·	-uu- uu- -uu- uu-	dactylic pentameter	
δειλῷ γάρ τ᾽ἀπάλαμνα βροτῷ πάρα πόλλ᾽ ἀνελέσθαι	-- - uu-u u- uu - uu--	dactylic hexameter	feminine penthemimeral, hepthemimeral, trithemimeral
πὰρ ποδός, ἡγεῖσθαί θ᾽ὡς καλὰ πάντα τιθεῖ.	- uu --- - uu -u u-	dactylic pentameter	
ἀστῶν μηδενὶ πιστὸς ἐὼν πόδα τῶνδε πρόβαινε,	-- -uu -u u- uu -u u--	dactylic hexameter	feminine penthemimeral, hepthemimeral
μήθ᾽ ὅρκῳ πίσυνος μήτε φιλημοσύνῃ,	- -- uu- -u u-uu-	dactylic pentameter	
μηδ᾽ εἰ Ζῆν᾽ ἐθέλῃ παρέχειν βασιλῆα μέγιστον	- - - uu- uu- uu-u u--	dactylic hexameter	masculine penthemimeral, hepthemimeral, trithemimeral
ἔγγυον ἀθανάτων πιστὰ τιθεῖν ἐθέλων.	-uu -uu- -u u- uu-	dactylic pentameter	
οὐ γάρ τοι πόλει ὧδε καλοψόγῳ ἁνδάνει οὐδὲν	- - - uu -u u-uu -uu --	dactylic hexameter	feminine penthemimeral, trithemimeral
ὡς δί᾽ ὅτι ζῷεν πολλοὶ ἀνολβότερον·	- u u- -- -u u-uu-	dactylic pentameter	
νῦν δὲ τὰ τῶν ἀγαθῶν κακὰ γίνεται ἐσθλὰ κακοῖσιν	- u u - uu- uu -uu -u u--	dactylic hexameter	masculine penthemimeral, trithemimeral
ἀνδράσιν· ἡγέονται δ᾽ἐκτραπέλοισι νόμοις·	-uu --- -uu-u u-	dactylic pentameter	
αἰδὼς μὲν γὰρ ὄλωλεν, ἀναιδείη δὲ καὶ ὕβρις	-- - u u-u u--- u u --	dactylic hexameter	feminine penthemimeral, trithemimeral
νικήσασα δίκην γῆν κατὰ πᾶσαν ἔχει.	---u u- - uu -u u-	dactylic pentameter	
οὐδὲ λέων αἰεὶ κρέα δαίνυται, ἀλλά μιν ἔμπης	-u u- -- uu -uu -u u --	dactylic hexameter	masculine penthemimeral, trithemimeral
καὶ κρατερόν περ ἐόνθ᾽ αἱρεῖ ἀμηχανίη.	- uu- u u- -u u-uu-	dactylic pentameter	
Κωτίλῳ ἀνθρώπῳ σιγᾶν χαλεπώτατον ἄχθος,	-uu --- -- uu-uu --	dactylic hexameter	masculine penthemimeral, hepthemimeral
φθεγγόμενος δ᾽ἀδδὴς οἷσι παρῇ πέλεται,	-uu- -- -u u- uu-	dactylic pentameter	
ἐχθαίρουσι δὲ πάντες, ἀναγκαίη δ᾽ἐπίμειξις	---u u -u u--- uu--	dactylic hexameter	feminine penthemimeral
ἀνδρὸς τοιούτου συμποσίῳ τελέθει.	-- --- -uu- uu-	dactylic pentameter	
οὐδεὶς λῇ φίλος εἶναι ἐπὴν κακὸν ἀνδρὶ γένηται,	-- - uu -u u- uu -u u--	dactylic hexameter	feminine penthemimeral, hepthemimeral, trithemimeral
οὐδ᾽ ᾧ κ᾽ἐκ γαστρός, Κύρνε, μιᾶς γεγόνῃ.	- - - -- -u u- uu-	dactylic pentameter	
πικρὸς καὶ γλυκὺς ἴσθι καὶ ἁρπαλέος καὶ ἀπηνὴς	-- - uu -u u -uu- u u--	dactylic hexameter	feminine penthemimeral, trithemimeral
λάτρισι καὶ δμωσὶν γείτοσί τ᾽ἀγχιθύροις.	-uu - -- -uu -uu-	dactylic pentameter	
οὐ χρὴ κιγκλίξειν ἀγαθὸν βίον, ἀλλ᾽ ἀτρεμίζειν,	- - --- uu- uu - uu--	dactylic hexameter	masculine penthemimeral, hepthemimeral
τὸν δὲ κακὸν κινεῖν ἔστ᾽ ἄν ἐς ὄρθ᾽ ἐλάσῃς.	- u u- -- - u u - uu-	dactylic pentameter	
τοὶ κακοὶ οὐ πάντες κακοὶ ἐκ γαστρὸς γεγόνασιν,	- uu - -- uu - -- uu--	dactylic hexameter	masculine penthemimeral, hepthemimeral, trithemimeral
ἀλλ᾽ ἄνδρεσσι κακοῖς συνθέμενοι φιλίην	- --u u- -uu- uu-	dactylic pentameter	
ἔργα τε δείλ᾽ ἔμαθον καὶ ἔπη δύσφημα καὶ ὕβριν,	-u u - uu- u u- --u u --	dactylic hexameter	masculine penthemimeral, hepthemimeral, trithemimeral
ἐλπόμενοι κείνους πάντα λέγειν ἔτυμα.	-uu- -- -u u- uu-	dactylic pentameter	
ἐν μὲν συσσίτοισιν ἀνὴρ πεπνυμένος εἶναι,	- - ---u u- --uu --	dactylic hexameter	feminine penthemimeral, hepthemimeral
πάντα δέ μιν λήθειν ὡς ἀπεόντα δοκεῖ·	-u u - -- - uu-u u-	dactylic pentameter	
εἰς δὲ φέρει τὰ γελοῖα, θύρηφι δὲ καρτερός ἐστι,	- u u- u u-u u-u u -uu --	dactylic hexameter	feminine penthemimeral, trithemimeral
γινώσκων ὀργὴν ἥντιν᾽ ἕκαστος ἔχει.	--- -- -u u-u u-	dactylic pentameter	
ἐν μὲν μαινομένοις μάλα μαίνομαι, ἐν δὲ δικαίοις	- - -uu- uu -uu - u u--	dactylic hexameter	masculine penthemimeral
πάντων ἀνθρώπων εἰμὶ δικαιότατος.	-- --- -u u-uu-	dactylic pentameter	
πολλοί τοι πλουτοῦσι κακοί, ἀγαθοὶ δὲ πένονται·	-- - --u u- uu- u u--	dactylic hexameter	feminine penthemimeral, hepthemimeral, trithemimeral
ἀλλ᾽ ἡμεῖς τούτοις οὐ διαμειψόμεθα	- -- -- - uu-uu-	dactylic pentameter	
τῆς ἀρετῆς τὸν πλοῦτον, ἐπεὶ τὸ μὲν ἔμπεδον αἰεί,	- uu- - -u u- u u -uu --	dactylic hexameter	feminine penthemimeral, hepthemimeral, trithemimeral
χρήματα δ᾽ἀνθρώπων ἄλλοτε ἄλλος ἔχει.	-uu --- -uu -u u-	dactylic pentameter	
Κύρν᾽, ἀγαθὸς μὲν ἀνὴρ γνώμην ἔχει ἔμπεδον αἰεί,	- uu- u u- -- uu -uu --	dactylic hexameter	masculine penthemimeral, hepthemimeral, trithemimeral
τολμᾷ δ᾽ἔν τε κακοῖς κείμενος ἔν τ᾽ἀγαθοῖς·	-- - u u- -uu - uu-	dactylic pentameter	
εἰ δὲ θεὸς κακῷ ἀνδρὶ βίον καὶ πλοῦτον ὀπάσσῃ,	- u u- uu -u u- - -u u--	dactylic hexameter	feminine penthemimeral, hepthemimeral, trithemimeral
ἀφραίνων κακίην οὐ δύναται κατέχειν.	--- uu- - uu- uu-	dactylic pentameter	
μήποτ᾽ ἐπὶ σμικρῇ προφάσει φίλον ἄνδρ᾽ ἀπολέσσαι	-u u- -- uu- uu - uu--	dactylic hexameter	masculine penthemimeral, hepthemimeral, trithemimeral
πειθόμενος χαλεπῇ, Κύρνε, διαιβολίῃ.	-uu- uu- -u u-uu-	dactylic pentameter	
εἴ τις ἁμαρτωλῇσι φίλων ἐπὶ παντὶ χολῷτο,	- u u---u u- uu -u u--	dactylic hexameter	feminine penthemimeral, hepthemimeral
οὔποτ᾽ ἂν ἀλλήλοις ἄρθμιοι οὐδὲ φίλοι	-u u --- -uu -u u-	dactylic pentameter	
εἶεν. ἁμαρτωλαὶ γὰρ ἐ᾽ ἀνθρώποισιν ἕπονται	-u u--- u u ---u u--	dactylic hexameter	masculine penthemimeral
θνητοῖς, Κύρνε· θεοὶ δ᾽οὐκ ἐθέλουσι φέρειν.	-- -u u- - uu-u u-	dactylic pentameter	
χὠ βραδὺς ὢν εὔβουλος ἕλεν ταχὺν ἄνδρα διώκων,	- uu - --u u- uu -u u--	dactylic hexameter	feminine penthemimeral, hepthemimeral, trithemimeral
Κύρνε, σὺν εὐθείῃ θεῶν δίκῃ ἀθανάτων.	-u u --- - uu -uu-	dactylic pentameter	
ἥσυχος ὥσπερ ἐγὼ μέσσην ὁδὸν ἔρχεο ποσσίν,	-uu -u u- -- uu -uu --	dactylic hexameter	masculine penthemimeral, hepthemimeral
μηδ᾽ ἑτέροισι δίδου, Κύρνε, τὰ τῶν ἑτέρων.	- uu-u u- -u u - uu-	dactylic pentameter	
οὐκ ἔστιν φεύγοντι φίλος καὶ πιστὸς ἑταῖρος·	- -- --u u- - -u u--	dactylic hexameter	feminine penthemimeral, hepthemimeral, trithemimeral
τῆς δὲ φυγῆς ἐστιν τοῦτ᾽ ἀνιηρότατον.	- u u- -- - u-uuu-	lyric	
μήποτε φεύγοντ᾽ ἄνδρ᾽ ἐπὶ ἐλπίδι, Κύρνε, φιλήσῃς·	-uu -- - uu -uu -u u--	dactylic hexameter	masculine penthemimeral
οὔτι γὰρ οἴκαδε βὰς γίνεται αὐτὸς ἔτι.	-u u -uu - -uu -u u-	dactylic pentameter	
μηδὲν ἄγαν σπεύδειν· πάντων μέσ᾽ ἄριστα· καὶ οὕτως,	-u u- -- -- u u-u u --	dactylic hexameter	masculine penthemimeral, hepthemimeral, trithemimeral
Κύρν᾽, ἕξεις ἀρετήν, ἥντε λαβεῖν χαλεπόν.	- -- uu- -u u- uu-	dactylic pentameter	
Ζεύς μοι τῶν τε φίλων δοίη τίσιν οἵ με φιλεῦσιν,	- - - u u- -- uu - u u--	dactylic hexameter	masculine penthemimeral, hepthemimeral, trithemimeral
τῶν τ᾽ἐχθρῶν μεῖζον, Κύρνε, δυνησαμένων·	- -- -- -u u-uu-	dactylic pentameter	
χοὔτως ἂν δοκέοιμι μετ᾽ ἀνθρώπων θεὸς εἶναι,	-- - uu-u u --- uu --	dactylic hexameter	feminine penthemimeral, trithemimeral
εἴ μ᾽ἀποτεισάμενον μοῖρα κίχοι θανάτου.	- uu-uu- -u u- uu-	dactylic pentameter	
ἀλλὰ Ζεῦ τέλεσόν μοι Ὀλύμπιε καίριον εὐχήν,	-- - uu- u u-uu -uu --	dactylic hexameter	masculine penthemimeral, trithemimeral
δὸς δέ μοι ἀντὶ κακῶν καί τι παθεῖν ἀγαθόν·	- u u -u u- - u u- uu-	dactylic pentameter	
τεθναίην δ᾽εἰ μή τι κακῶν ἄμπαυμα μεριμνέων	--- - - u u- --u u--	dactylic hexameter	masculine penthemimeral, hepthemimeral, trithemimeral
εὑροίμην, δοίην τ᾽ἀντ᾽ ἀνιῶν ἀνίας.	--- -- - uu- uu-	dactylic pentameter	
αἶσα γὰρ οὕτως ἐστί· τίσις δ᾽οὐ φαίνεται ἡμῖν	-u u -- -u u- - -uu --	dactylic hexameter	feminine penthemimeral, hepthemimeral
ἀνδρῶν οἳ τἀμὰ χρήματ᾽ ἔχουσι βίῃ	-- - uu -- uu- uu	lyric	
συλήσαντες· ἐγὼ δὲ κύων ἐπέρησα χαράδρην	---u u- u u- uu-u u--	dactylic hexameter	masculine penthemimeral, hepthemimeral
χειμάρρῳ ποταμῷ πάντ᾽ ἀποσεισάμενος.	--- uu- - uu-uu-	dactylic pentameter	
τῶν εἴη μέλαν αἷμα πιεῖν, ἐπί τ᾽ἐσθλὸς ὄροιτο	- -- uu -u u- uu -u u--	dactylic hexameter	feminine penthemimeral, hepthemimeral, trithemimeral
δαίμων, ὃς κατ᾽ ἐμὸν νοῦν τελέσειε τάδε.	-- - u u- - uu-u u-	dactylic pentameter	
Ά̂ δειλὴ Πενίη, τί μένεις προλιποῦς α παρ᾽ ἄλλον	- -- uu- u u- uu- u u --	dactylic hexameter	masculine penthemimeral, hepthemimeral, trithemimeral
ἄνδρ᾽ ἰέναι; μὴ δή μ᾽οὐκ ἐθέλοντα φίλει,	- uu- - - - uu-u u-	dactylic pentameter	
ἀλλ᾽ ἴθι καὶ δόμον ἄλλον ἐποίχεο, μηδὲ μεθ᾽ ἡμέων	- uu - uu -u u-uu -u u --	dactylic hexameter	feminine penthemimeral, trithemimeral
αἰεὶ δυστήνου τοῦδε βίου μέτεχε.	-- --- -u u- uu-	dactylic pentameter	
τόλμα, Κύρνε, κακοῖσιν, ἐπεὶ κἀσθλοῖσιν ἔχαιρες,	-- -u u-u u- --u u--	dactylic hexameter	feminine penthemimeral, hepthemimeral
εὖτέ σε καὶ τούτων μοῖρ᾽ ἐπέβαλλεν ἔχειν·	-u u - -- - uu-u u-	dactylic pentameter	
ὡς δέ περ ἐξ ἀγαθῶν ἔλαβες κακόν, ὣς δὲ καὶ αὖτις	- u u - uu- uu- uu - u u --	dactylic hexameter	masculine penthemimeral, hepthemimeral, trithemimeral
ἐκδῦναι πειρῶ θεοῖσιν ἐπευχόμενος,	--- -- -u u-uu-	dactylic pentameter	
μηδὲ λίην ἐπίφαινε· κακὸν δέ τι, Κύρν᾽, ἐπιφαίνων	-u u- uu-u u- u u - uu--	dactylic hexameter	feminine penthemimeral, hepthemimeral, trithemimeral
παύρους κηδεμόνας σῆς κακότητος ἔχεις.	-- -uu- - uu-u u-	dactylic pentameter	
ἀνδρός τοι κραδίη μινύθει μέγα πῆμα παθόντος,	-- - uu- uu- uu -u u--	dactylic hexameter	masculine penthemimeral, hepthemimeral, trithemimeral
Κύρν᾽, ἀποτεινυμένου δ᾽αὔξεται ἐξοπίσω.	- uu-uu- -uu -uu-	dactylic pentameter	
εὖ κώτιλλε τὸν ἐχθρόν· ὅταν δ᾽ὑποχείριος ἔλθῃ,	- --u u -u u- uu-uu --	dactylic hexameter	feminine penthemimeral, hepthemimeral
τεῖσαί νιν πρόφασιν μηδεμίαν θέμενος.	-- - uu- -uu- uu-	dactylic pentameter	
ἴσχε νόῳ, γλώσσης δὲ τὸ μείλιχον αἰὲν ἐπέστω·	-u u- -- u u -uu -u u--	dactylic hexameter	masculine penthemimeral, trithemimeral
δειλῶν τοι τελέθει καρδίη ὀξυτέρη.	-- - uu- -uu -uu-	dactylic pentameter	
οὐ δύναμαι γνῶναι νόον ἀστῶν ὅντιν᾽ ἔχουσιν·	- uu- -- uu -- -u u--	dactylic hexameter	masculine penthemimeral, trithemimeral
οὔτε γὰρ εὖ ἕρδων ἁνδάνω οὔτε κακῶς.	-u u - -- -uu -u u-	dactylic pentameter	
μωμεῦνται δέ με πολλοί, ὁμῶς κακοὶ ἠδὲ καὶ ἐσθλοί,	--- u u -u u- uu -u u --	dactylic hexameter	feminine penthemimeral, hepthemimeral, trithemimeral
μιμεῖσθαι δ᾽οὐδεὶς τῶν ἀσόφων δύναται.	--- -- - uu- uu-	dactylic pentameter	
μή μ᾽ἀέκοντα λίην κεντῶν ὑπ᾽ ἄμαξαν ἔλαυνε	- uu-u u- -- u u-u u--	dactylic hexameter	masculine penthemimeral, hepthemimeral
εἰς φιλότητα βίῃ, Κύρνε, προσελκόμενος.	- uu-u u- -u u-uu-	dactylic pentameter	
†Ζεῦ φίλε, θαυμάζω σε· σὺ γὰρ πάντεσσιν ἀνάσσεις	- uu --- u u - --u u--	dactylic hexameter	masculine penthemimeral, hepthemimeral
τιμὴν αὐτὸς ἔχων καὶ μεγάλην δύναμιν,	-- -u u- - uu- uu-	dactylic pentameter	
ἀνθρώπων δ᾽εὖ οἶσθα νόον καὶ θυμὸν ἑκάστου,	--- - -u u- - -u u--	dactylic hexameter	feminine penthemimeral, hepthemimeral, trithemimeral
σὸν δὲ κράτος πάντων ἔσθ᾽ ὕπατον, βασιλεῦ·	- u u- -- - uu- uu-	dactylic pentameter	
πῶς δή σευ, Κρονίδη, τολμᾷ νόος ἄνδρας ἀλιτροὺς	- - - uu- -- uu -u u--	dactylic hexameter	masculine penthemimeral, hepthemimeral, trithemimeral
ἐν ταὐτῇ μοίρῃ τόν τε δίκαιον ἔχειν,	- -- -- - u u-u u-	dactylic pentameter	
ἤν τ᾽ἐπὶ σωφροσύνην τρεφθῇ νόος, ἤν τε πρὸς ὕβριν	- uu -uu- -- uu - u u --	dactylic hexameter	masculine penthemimeral, hepthemimeral
ἀνθρώπων ἀδίκοις ἔργμασι πειθομένων;	--- uu- -uu -uu-	dactylic pentameter	
οὐδέ τι κεκριμένον πρὸς δαίμονός ἐστι βροτοῖσιν,	-u u -uu- - -uu -u u--	dactylic hexameter	masculine penthemimeral
οὐδ᾽ ὁδὸς ἥν τις ἰὼν ἀθανάτοισιν ἅδοι.	- uu - u u- -uu-u u-	dactylic pentameter	
ἔμπης δ᾽ὄλβον ἔχουσιν ἀπήμονα· τοὶ δ᾽ἀπὸ δειλῶν	-- -u u-u u-uu - uu --	dactylic hexameter	feminine penthemimeral
ἔργων ἴσχοντες θυμὸν ὅμως πενίην	-- --- -u u- uu-	dactylic pentameter	
μητέρ᾽ ἀμηχανίης ἔλαβον, τὰ δίκαια φιλεῦντες,	-u u-uu- uu- u u-u u--	dactylic hexameter	masculine penthemimeral, hepthemimeral
ἥτ᾽ ἀνδρὸς παράγει θυμὸν ἐς ἀμπλακίην,	- -- uu- -u u -uu-	dactylic pentameter	
βλάπτουσ᾽ ἐν στήθεσσι φρένας κρατερῆς ὑπ᾽ ἀνάγκης·	-- - --u u- uu- u u--	dactylic hexameter	feminine penthemimeral, hepthemimeral, trithemimeral
τολμᾷ δ᾽οὐκ ἐθέλων αἴσχεα πολλὰ φέρειν,	-- - uu- -uu -u u-	dactylic pentameter	
χρημοσύνῃ εἴκων, ἣ δὴ κακὰ πάντα διδάσκει,	-uu- -- - - uu -u u--	dactylic hexameter	masculine penthemimeral, hepthemimeral, trithemimeral
ψεύδεά τ᾽ἐξαπάτας τ᾽οὐλομένας τ᾽ἔριδας	-uu -uu- -uu- uu-	dactylic pentameter	
ἄνδρα καὶ οὐκ ἐθέλοντα, κακὸν δέ οἱ οὐδὲν ἔοικεν·	-u u - uu-u u- u u -u u--	dactylic hexameter	feminine penthemimeral, hepthemimeral, trithemimeral
ἡ γὰρ καὶ χαλεπὴν τίκτει ἀμηχανίην.	- - - uu- -u u-uu-	dactylic pentameter	
ἐν πενίῃ δ᾽ὅ τε δειλὸς ἀνὴρ ὅ τε πολλὸν ἀμείνων	- uu- u u -u u- u u -u u--	dactylic hexameter	feminine penthemimeral, hepthemimeral, trithemimeral
φαίνεται, εὖτ᾽ ἂν δὴ χρημοσύνη κατέχῃ.	-uu - - - -uu- uu-	dactylic pentameter	
τοῦ μὲν γὰρ τὰ δίκαια φρονεῖ νόος οὗτέ περ αἰεὶ	- - - u u-u u- uu -u u --	dactylic hexameter	feminine penthemimeral, hepthemimeral, trithemimeral
ἰθεῖα γνώμη στήθεσιν ἐμπεφύῃ·	--- -- -uu -uu-	dactylic pentameter	
τοῦ δ᾽αὖτ᾽ οὔτε κακοῖς ἕπεται νόος οὔτ᾽ ἀγαθοῖσιν,	- - -u u- uu- uu - uu--	dactylic hexameter	masculine penthemimeral, hepthemimeral
τὸν δ᾽ἀγαθὸν τολμᾶν χρὴ τά τε καὶ τὰ φέρειν.	- uu- -- - u u - u u-	dactylic pentameter	
αἰδεῖσθαι δὲ φίλους φεύγειν τ᾽ὀλεσήνορας ὅρκους	--- u u- -- uu-uu --	dactylic hexameter	masculine penthemimeral, hepthemimeral, trithemimeral
ἐντρέπευ, ἀθανάτων μῆνιν ἀλευόμενος.	-uu -uu- -u u-uu-	dactylic pentameter	
μηδὲν ἄγαν σπεύδειν· καιρὸς δ᾽ἐπὶ πᾶσιν ἄριστος	-u u- -- -- uu -u u--	dactylic hexameter	masculine penthemimeral, hepthemimeral, trithemimeral
ἔργμασιν ἀνθρώπων· πολλάκι δ᾽εἰς ἀρετὴν	-uu --- -uu - uu-	dactylic pentameter	
σπεύδει ἀνὴρ κέρδος διζήμενος, ὅντινα δαίμων	-u u- -- --uu -uu --	dactylic hexameter	masculine penthemimeral, trithemimeral
πρόφρων εἰς μεγάλην ἀμπλακίην παράγει,	-- - uu- -uu- uu-	dactylic pentameter	
καί οἱ ἔθηκε δοκεῖν, ἅ μὲν ᾖ κακά, ταῦτ᾽ ἀγάθ᾽ εἶναι	- u u-u u- u u - uu - uu --	dactylic hexameter	masculine penthemimeral, hepthemimeral
εὐμαρέως, ἃ δ᾽ἂν ᾖ χρήσιμα, ταῦτα κακά.	-uu- u u - -uu -u u-	dactylic pentameter	
φίλτατος ὢν ἥμαρτες· ἐγὼ δέ σοι αἴτιος οὐδέν,	-uu - --u u- u u -uu --	dactylic hexameter	feminine penthemimeral, hepthemimeral, trithemimeral
ἀλλ᾽ αὐτὸς γνώμης οὐκ ἀγαθῆς ἔτυχες.	- -- -- - uu- uu-	dactylic pentameter	
οὐδένα θησαυρὸν παισὶν κατανήσει ἀμείνω	-uu --- -- uu-u u--	dactylic hexameter	masculine penthemimeral, hepthemimeral
αἰδοῦς, ἥτ᾽ ἀγαθοῖς ἀνδράσι, Κύρν᾽, ἕπεται.	-- - uu- -uu - uu-	dactylic pentameter	
οὐδενὸς ἀνθρώπων κακίων δοκεῖ εἶναι ἑταῖρος	-uu --- uu- uu -u u--	dactylic hexameter	masculine penthemimeral, hepthemimeral
ᾧ γνώμη θ᾽ἕπεται, Κύρνε, καὶ ᾧ δύναμις.	- -- uu- -u u - uu-	dactylic pentameter	
πίνων δ᾽οὐχ οὕτως θωρήξομαι, οὐδέ με οἶνος	-- - -- --uu -u u --	dactylic hexameter	masculine penthemimeral, trithemimeral
ἐξαρεῖ, ὥστ᾽ εἰπεῖν δεινὸν ἔπος περὶ σοῦ.	-uu - -- -u u- uu -	dactylic pentameter	
οὐδέν᾽ ὁμοῖον ἐμοὶ δύναμαι διζήμενος εὑρεῖν	-u u-u u- uu- --uu --	dactylic hexameter	masculine penthemimeral, hepthemimeral
πιστὸν ἑταῖρον, ὅτῳ μήτις ἔνεστι δόλος·	-u u-u u- -u u-u u-	dactylic pentameter	
ἐς βάσανον δ᾽ἐλθὼν παρατριβόμενός τε μολίβδῳ	- uu- -- uu-uu- u u--	dactylic hexameter	masculine penthemimeral, trithemimeral
χρυσὸς ὑπερτερίης ἄμμιν ἔνεστι τύπος.	-u u-uu- -u u-u u-	dactylic pentameter	
πολλά με καὶ συνιέντα παρέρχεται· ἀλλ᾽ ὑπ᾽ ἀνάγκης	-u u - uu-u u-uu - u u--	dactylic hexameter	feminine penthemimeral, trithemimeral
σιγῶ γινῴσκων ἡμετέρην δύναμιν.	-- --- -uu- uu-	dactylic pentameter	
πολλοῖς ἀνθρώπων γλώσσῃ θύραι οὐκ ἐπίκεινται	-- --- -- uu - uu--	dactylic hexameter	masculine penthemimeral, hepthemimeral
ἁρμόδιαι, καί σφιν πόλλ᾽ ἀλάλητα μέλει·	-uu- - - - uu-u u-	dactylic pentameter	
πολλάκι γὰρ τὸ κακὸν κατακείμενον ἔνδον ἄμεινον,	-uu - u u- uu-uu -u u--	dactylic hexameter	masculine penthemimeral, trithemimeral
ἔστε δ᾽ἂν ἐξέλθῃ λώϊον ἦν τὸ καλόν.	-u u --- -uu - u u-	dactylic pentameter	
πάντων μὲν μὴ φῦναι ἐπιχθονίοισιν ἄριστον	-- - - -u u-uu-u u--	dactylic hexameter	feminine penthemimeral, trithemimeral
μηδ᾽ ἐσιδεῖν αὐγὰς ὀξέος ἠελίου·	- uu- -- -uu -uu-	dactylic pentameter	
φύντα δ᾽ὅπως ὤκιστα πύλας Ἀΐδαο περῆσαι	-u u- --u u- uu-u u--	dactylic hexameter	feminine penthemimeral, hepthemimeral, trithemimeral
καὶ κεῖσθαι πολλὴν γῆν ἐπαμησάμενον.	- -- -- - uu-uu-	dactylic pentameter	
†φῦσαι καὶ θρέψαι ῥᾷον βροτὸν ἢ φρένας ἐσθλὰς	-- - -- -- uu - uu --	dactylic hexameter	masculine penthemimeral, hepthemimeral, trithemimeral
ἐνθέμεν· οὐδείς πω τοῦτό γ᾽ἐπεφράσατο,	-uu -- - -u u-uu-	dactylic pentameter	
ὅστις σώφρον᾽ ἔθηκε τὸν ἄφρονα κἀκ κακοῦ ἐσθλόν.	-- -u u-u u -uu - uu --	dactylic hexameter	feminine penthemimeral
εἰ δ᾽Ἀσκληπιάδαις τοῦτό γ᾽ἔδωκε θεός,	- --uu- -u u-u u-	dactylic pentameter	
ἰᾶσθαι κακότητα καὶ ἀτηρὰς φρένας ἀνδρῶν,	--- uu-u u --- uu --	dactylic hexameter	feminine penthemimeral, trithemimeral
πολλοὺς ἂν μισθοὺς καὶ μεγάλους ἔφερον·	-- - -- - uu- uu-	dactylic pentameter	
εἰ δ᾽ἦν ποιητόν τε καὶ ἔνθετον ἀνδρὶ νόημα,	- - --- u u -uu -u u--	dactylic hexameter	masculine penthemimeral
οὔποτ᾽ ἂν ἐξ ἀγαθοῦ πατρὸς ἔγεντο κακός,	-u u - uu- -u u-u u-	dactylic pentameter	
πειθόμενος μύθοισι σαόφροσιν. ἀλλὰ διδάσκων	-uu- --u u-uu -u u--	dactylic hexameter	feminine penthemimeral, trithemimeral
οὔποτε ποιήσεις τὸν κακὸν ἀνδρ᾽ ἀγαθόν.	-uu --- - uu - uu-	dactylic pentameter	
νήπιος, ὃς τὸν ἐμὸν μὲν ἔχει νόον ἐν φυλακῇσιν,	-uu - u u- u u- uu - uu--	dactylic hexameter	masculine penthemimeral, hepthemimeral, trithemimeral
τῶν δ᾽αὐτοῦ ἰδίων ούδεν ἐπιστρέφεται.	- -- uu- -u u-uu-	dactylic pentameter	
οὐδεὶς γὰρ πάντ᾽ ἐστὶ πανόλβιος· ἀλλ᾽ ὁ μὲν ἐσθλὸς	-- - - -u u-uu - u u --	dactylic hexameter	feminine penthemimeral, trithemimeral
τολμᾷ ἔχων τὸ κακὸν κοὐκ ἐπίδηλος ὅμως·	-u u- u u- - uu-u u-	dactylic pentameter	
δειλὸς δ᾽οὔτ᾽ ἀγαθοῖς τις ἐπίσταται οὔτε κακοἰσιν	-- - uu- u u-uu -u u--	dactylic hexameter	masculine penthemimeral, trithemimeral
θυμὸν ἔχων μίμνειν. ἀθανάτων δὲ δόσεις	-u u- -- -uu- u u-	dactylic pentameter	
παντοῖαι θνητοῖσιν ἐπέρχοντ᾽· ἀλλ᾽ ἐτιτολμᾶν	--- --u u-- - uu--	dactylic hexameter	feminine penthemimeral, trithemimeral
χρὴ δῶρ᾽ ἀθανάτων οἷα διδοῦσιν ἔχειν.	- - -uu- -u u-u u-	dactylic pentameter	
εἴ μ᾽ἐθέλεις πλύνειν, κεφαλῆς ἀμίαντον ἀπ᾽ ἄκρης	- uu- -- uu- uu-u u --	dactylic hexameter	masculine penthemimeral, hepthemimeral, trithemimeral
αἰεὶ λευκὸν ὕδωρ ῥεύσεται ἡμετέρης·	-- -u u- -uu -uu-	dactylic pentameter	
εὑρήσεις δὲ με πᾶσιν ἐπ᾽ ἔργμασιν ὥσπερ ἄπεφθον	--- u u -u u -uu -u u--	dactylic hexameter	feminine penthemimeral, trithemimeral
χρυσόν, ἐρυθρὸν ἰδεῖν τριβόμενον βασάνῳ,	-u u-u u- -uu- uu-	dactylic pentameter	
τοῦ χροιῆς καθύπερθε μέλας οὐχ ἅπτεται ἰὸς	- -- uu-u u- - -uu --	dactylic hexameter	feminine penthemimeral, hepthemimeral, trithemimeral
οὐδ᾽ εὐρώς, αἰεὶ δ᾽ἄνθος ἔχει καθαρόν.	- -- -- -u u- uu-	dactylic pentameter	
Ὤνθρωπ᾽, εἰ γνώμης ἔλαχες μέρος ὥσπερ ἀνοιης	-- - -- uu- uu -u u--	dactylic hexameter	masculine penthemimeral, hepthemimeral, trithemimeral
καὶ σώφρων οὕτως ὥσπερ ἄφρων ἐγένου,	- -- -- -u u- uu-	dactylic pentameter	
πολλοῖς ἂν ζηλωτὸς ἐφαίνεο τῶνδε πολιτῶν	-- - --u u-uu -u u--	dactylic hexameter	feminine penthemimeral, trithemimeral
οὕτως ὥσπερ νῦν οὐδενὸς ἄξιος εἶ.	-- -- - -uu -uu -	dactylic pentameter	
οὔτοι σύμφορόν ἐστι γυνὴ νέα ἀνδρὶ γέροντι·	-- -uu -u u- uu -u u--	dactylic hexameter	feminine penthemimeral, hepthemimeral
οὐ γὰρ πηδαλίῳ πείθεραι ὡς ἄκατος,	- - -uu- -uu - uu-	dactylic pentameter	
ὀυδ᾽ ἄγκυραι ἔχουσιν, ἀπορρήξασα δὲ δεσμὰ	- --u u-u u---u u --	dactylic hexameter	feminine penthemimeral
πολλάκις ἐκ νυκτῶν ἄλλον ἔχει λιμένα.	-uu - -- -u u- uu-	dactylic pentameter	
Μήπορ᾽ ἐπ᾽ ἀπρήκτοισι νόον ἔχε, μηδὲ μενοίνα	-u u ---u u- uu -u u--	dactylic hexameter	feminine penthemimeral, hepthemimeral
χρήματα τῶν ἄνυσις γίνεται οὐδεμία.	-uu - uu- -uu -uu-	dactylic pentameter	
εὐμαρέως τοι χρῆμα θεοὶ δόσαν οὔτε τι δειλὸν	-uu- - -u u- uu -u u --	dactylic hexameter	feminine penthemimeral, hepthemimeral, trithemimeral
οὔτ ἀγαθόν· χαλεπῷ δ᾽ἔργματι κῦδος ἔπι.	- uu- uu- -uu -u u-	dactylic pentameter	
ἀμφ᾽ ἀρετῇ τρίβου καί τοι τὰ δίκαια φίλ᾽ ἔστω,	- uu- -- - - u u-u u --	dactylic hexameter	masculine penthemimeral, hepthemimeral, trithemimeral
μηδέ σε νικάτω κέρδος ὅτ᾽ αἰσχρὸν ἔῃ.	-u u --- -u u -u u-	dactylic pentameter	
μηδένα τῶνδ᾽ ἀέκοντα μένειν κατέρυκε παρ᾽ ἡμῖν,	-uu - uu-u u- uu-u u --	dactylic hexameter	feminine penthemimeral, hepthemimeral, trithemimeral
μηδὲ θύραζε κέλεὐ οὐκ ἐθέλοντ᾽ ἰέναι,	-u u-u u- - uu- uu-	dactylic pentameter	
μηδ᾽ εὕδοντ᾽ ἐπέγειρε, Σιμωνίδη, ὅντιν᾽ ἂν ἡμῶν	- -- uu-u u-uu -u u --	dactylic hexameter	feminine penthemimeral, trithemimeral
θωρηχθέντ᾽ οἴνῳ μαλθακὸς ὕπνος ἕλῃ,	--- -- -uu -u u-	dactylic pentameter	
μηδὲ τὸν ἀγρυπνέοντα κέλευ᾽ ἀέκοντα καθεύδειν·	-u u ---u u- uu-u u--	dactylic hexameter	feminine penthemimeral, hepthemimeral
πᾶν γὰρ ἀναγκαῖον χρῆμ᾽ ἀνιηρὸν ἔφυ·	- u u--- - uu-u u-	dactylic pentameter	
τῷ πίνειν δ᾽ἐθέλοντι παρασταδὸν οἰνοχοείτω.	- -- uu-u u-uu -uu--	dactylic hexameter	feminine penthemimeral, trithemimeral
οὐ πάσας νύκτας γίνεται ἁβρὰ παθεῖν.	- -- -- -uu -u u-	dactylic pentameter	
αὐτὰρ ἐγώ, μέτρον γὰρ ἔχω μελιηδέος οἴνου,	-u u- -- u u- uu-uu --	dactylic hexameter	masculine penthemimeral, hepthemimeral, trithemimeral
ὕπνου λυσικάκου μνήσομαι οἴκαδ᾽ ἰών,	-- -uu- -uu -u u-	dactylic pentameter	
ἥξω δ᾽ὡς οἶνος χαριέστατος ἀνδρὶ πεπόσθαι·	-- - -- uu-uu -u u--	dactylic hexameter	masculine penthemimeral, trithemimeral
οὔτε τι νήφων εἶμ᾽ οὔτε λίην μεθύων.	-u u -- - -u u- uu-	dactylic pentameter	
ὃς δ᾽ἂν ὑπερβάλλῃ πόσιος μέτρον, οὐκέτι κεῖνος	- u u--- uu- uu -uu --	dactylic hexameter	masculine penthemimeral, hepthemimeral
τῆς αὐτοῦ γλώσσης καρτερὸς οὐδὲ νόου,	- -- -- -uu -u u-	dactylic pentameter	
μυθεῖται δ᾽ἀπάλαμνα τὰ νήφοσι γίνεται αἰσχρά,	--- uu-u u -uu -uu --	dactylic hexameter	feminine penthemimeral, trithemimeral
αἰδεῖται θ᾽ἕρδων οὐδέν, ὅταν μεθύῃ,	--- -- -u u- uu-	dactylic pentameter	
τὸ πρὶν ἐὼν σώφρων, τότε νήπιος. ἀλλὰ σὺ ταῦτα	- u u- -- uu -uu -u u --	dactylic hexameter	masculine penthemimeral, trithemimeral
γινῴσκων μὴ πῖν᾽ οἶνον ὑπερβολάδην,	--- - - -u u-uu-	dactylic pentameter	
ἀλλ᾽ ἢ πρὶν μεθύειν ὑπανίστασο, μηδὲ βιάσθω	- - - uu- uu-uu -u u--	dactylic hexameter	masculine penthemimeral, trithemimeral
γαστήρ σ᾽ὥστε κακὸν λάτριν ἐφημέριον,	-- -u u- -u u-uu-	dactylic pentameter	
ἢ παρεὼν μὴ πῖνε. σὺ δ᾽Ἔγχεε τοῦτο μάταιον	- uu- - -u u -uu -u u--	dactylic hexameter	feminine penthemimeral, trithemimeral
κωτίλλεις αἰεί· τοὔνεκά τοι μεθύεις.	--- -- -uu - uu-	dactylic pentameter	
ἡ μὲν γὰρ φέρεται φιλοτήσιος, ἡ δὲ πρόκειται,	- - - uu- uu-uu - u u--	dactylic hexameter	masculine penthemimeral, trithemimeral
τὴν δὲ θεοῖς σπένδεις, τὴν δ᾽ἐπὶ χειρὸς ἔχεις·	- u u- -- - uu -u u-	dactylic pentameter	
ἀρνεῖσθαι δ᾽οὐκ οἶδας. ἀνίκητος δὲ τοι οὗτος,	--- - -u u--- u u --	dactylic hexameter	feminine penthemimeral, trithemimeral
ὃς πολλὰς πίνων μή τι μάταιον ἐρεῖ.	- -- -- - u u-u u-	dactylic pentameter	
ὑμεῖς δ᾽εὖ μυθεῖσθε παρὰ κρητῆρι μένοντες,	-- - --u u- --u u--	dactylic hexameter	feminine penthemimeral, hepthemimeral, trithemimeral
ἀλλήλων ἔριδος δὴν ἀπερυκόμενοι,	--- uu- - uu-uu-	dactylic pentameter	
ἐς τὸ μέσον φωνεῦντες ὁμῶς ἑνὶ καὶ συνάπασι·	- u u- --u u- uu - uu--	dactylic hexameter	feminine penthemimeral, hepthemimeral, trithemimeral
χοὔτως συμπόσιον γίνεται οὐκ ἄχαρι.	-- -uu- -uu - uu-	dactylic pentameter	
ἄφρονος ἀνδρὸς ὁμῶς καὶ σώφρονος οἶνος, ὅταν δὴ	-uu -u u- - -uu -u u- -	dactylic hexameter	masculine penthemimeral
πίνῃ ὑπὲρ μέτρον, κοῦφον ἔθηκε νόον.	-u u- -- -u u-u u-	dactylic pentameter	
†εν πυρὶ μὲν χρυσόν τε καὶ ἄργυρον ἴδριες ἄνδρες	- uu - -- u u -uu -uu --	dactylic hexameter	masculine penthemimeral, trithemimeral
γινῴσκουσ᾽, ἀνδρὸς δ᾽οἶνος ἔδειξε νόον,	--- -- -u u-u u-	dactylic pentameter	
καὶ μάλα περ πινυτοῦ, τὸν ὑπὲρ μέτρον ἤρατο πίνων,	- uu - uu- u u- uu -uu --	dactylic hexameter	masculine penthemimeral, hepthemimeral, trithemimeral
ὥστε καταισχῦναι καὶ πρὶν ἐόντα σοφόν.	-u u--- - u u-u u-	dactylic pentameter	
Οἰνοβαρέω κεφαλήν, Ὀνομάκριτε, καί με βιᾶται	-uu- uu- uu-uu - u u--	dactylic hexameter	masculine penthemimeral, trithemimeral
οἶνος, ἀτὰρ γνώμης οὐκέτ᾽ ἐγὼ ταμίης	-u u- -- -u u- uu-	dactylic pentameter	
ἡμετέρης, τὸ δὲ δῶμα περιτρέχει. ἀλλ᾽ ἄγ᾽ ἀναστὰς	-uu- u u -u u-uu - u u--	dactylic hexameter	feminine penthemimeral, trithemimeral
πειρηθῶ μή πως καὶ πόδας οἶνος ἔχει	--- - - - uu -u u-	dactylic pentameter	
καὶ νόον ἐν στήθεσσι. δέδοικα δὲ μή τι μάταιον	- uu - --u u-u u - u u--	dactylic hexameter	feminine penthemimeral, trithemimeral
ἕρξω θωρηχθεὶς καὶ μέγ᾽ ὄνειδος ἔχω.	-- --- - u u-u u-	dactylic pentameter	
οἶνος πινόμενος πουλὺς κακόν· ἢν δὲ τις αὐτὸν	-- -uu- -- uu - u u --	dactylic hexameter	masculine penthemimeral, hepthemimeral
πίνῃ ἐπισταμένως, οὐ κακὸν ἀλλ᾽ ἀγαθόν.	-u u-uu- - uu - uu-	dactylic pentameter	
†ἦλθες δή, Κλεάριστε, βαθὺν διὰ πόντον ἀνύσσας,	-- - uu-u u- uu -u u--	dactylic hexameter	feminine penthemimeral, hepthemimeral, trithemimeral
ἐνθάδ᾽ ἐπ᾽ οὐδὲν ἔχοντ᾽, ὦ τάλαν, οὐδὲν ἔχων.	-u u -u u- - uu -u u-	dactylic pentameter	
νηός τοι πλευρῇσιν ὑπὸ ζυγὰ θήσομεν ἡμεῖς,	-- - --u u- uu -uu --	dactylic hexameter	feminine penthemimeral, hepthemimeral, trithemimeral
Κλεάρισθ᾽, οἰ̔̂ ἔχομεν χοἶα διδοῦσι θεοί·	-- - uu- -- u-u u-	lyric	
οὔτε τι τῶν ὄντων ἀποθήσομαι, οὔτε τι μεῖζον	-u u - -- uu-uu -u u --	dactylic hexameter	masculine penthemimeral, trithemimeral
σῆς ἕνεκα ξενίης ἄλλοθεν οἰσόμεθα,	- uu- uu- -uu -uu-	dactylic pentameter	
τῶν δ᾽ὄντων τἄριστα παρέξομεν. ἢν δέ τις ἔλθῃ	- -- --u u-uu - u u --	dactylic hexameter	feminine penthemimeral, trithemimeral
σεῦ φίλος ὤν, κατάειφ᾽ ὡς φιλότητος ἔχεις·	- uu - uu- - uu-u u-	dactylic pentameter	
ἤν δέ τις εἰρωτᾶ τὸν ἐμὸν βίον, ὦδέ οἱ εἰπεῖν·	- u u --- u u- uu -u u --	dactylic hexameter	masculine penthemimeral, hepthemimeral
ὡς εὖ μὲν χαλεπῶς, ὡς χαλεπῶς δὲ μάλ εὖ,	- - - uu- - uu- u u -	dactylic pentameter	
ὥσθ᾽ ἕνα μὲν ξεῖνον πατρωϊον οὐκ ἀπολείπειν,	- uu - -- --uu - uu--	dactylic hexameter	masculine penthemimeral, trithemimeral
ξείνια δὲ πλεόνεσσ᾽ οὐ δυνατὸς παρέχειν.	-uu - uu- - uu- uu-	dactylic pentameter	
οὔ σε μάτην, ὦ Πλοῦτε, βροτοὶ τιμῶσι μάλιστα·	- u u- - -u u- --u u--	dactylic hexameter	feminine penthemimeral, hepthemimeral, trithemimeral
ἦ γὰρ ῥηϊδίως τὴν κακότητα φέρεις.	- - -uu- - uu-u u-	dactylic pentameter	
καὶ γάρ τοι πλοῦτον μὲν ἔχειν ἀγαθοῖσιν ἔοικεν,	- - - -- u u- uu-u u--	dactylic hexameter	masculine penthemimeral, hepthemimeral, trithemimeral
ἡ πενίη δὲ κακῷ σύμφορος ἀνδρὶ φέρειν.	- uu- u u- -uu -u u-	dactylic pentameter	
ὤ μοι ἐγὼν ἥβης καὶ γήραος οὐλομένοιο,	- u u- -- - -uu -uu--	dactylic hexameter	masculine penthemimeral, trithemimeral
τοῦ μὲν ἐπερχομένου, τῆς δ᾽ἀπονισομένης.	- u u-uu- - uu-uu-	dactylic pentameter	
οὐδένα πω προὔδωκα φίλον καὶ πιστὸν ἑταῖρον,	-uu - --u u- - -u u--	dactylic hexameter	feminine penthemimeral, hepthemimeral, trithemimeral
οὐδ᾽ ἐν ἐμῇ ψυχῇ δούλιον οὐδὲν ἔνι.	- u u- -- -uu -u u-	dactylic pentameter	
αἰεί μοι φίλον ἦτορ ἰαίνεται, ὁππότ᾽ ἀκούσω	-- - uu -u u-uu -u u--	dactylic hexameter	feminine penthemimeral, trithemimeral
αὐλῶν φθεγγομένων ἱμερόεσσαν ὄπα.	-- -uu- -uu-u u-	dactylic pentameter	
χαίρω δ᾽ἐμπίνων καὶ ὑπ᾽ αὐλητῆρος ἀείδων,	-- --- u u ---u u--	dactylic hexameter	masculine penthemimeral
χαίρω δ᾽εὔφθογγον χερσὶ λύρην ὀχέων.	-- --- -u u- uu-	dactylic pentameter	
οὔποτε δουλείη κεφαλὴν ἰθεῖα πέφυκεν,	-uu --- uu- --u u--	dactylic hexameter	masculine penthemimeral, hepthemimeral
ἀλλ᾽ αἰεὶ σκολιή, καὐχένα λοξὸν ἔχει.	- -- uu- -uu -u u-	dactylic pentameter	
οὔτε γὰρ ἐκ σκίλλης ῥόδα φύεται οὐδ᾽ ὑάκινθος,	-u u - -- uu -uu - uu--	dactylic hexameter	masculine penthemimeral, trithemimeral
οὔτε ποτ᾽ ἐκ δούλης τέκνον ἐλευθέριον.	-u u - -- -u u-uu-	dactylic pentameter	
οὗτος ἀνήρ, φίλε Κύρνε, πέδας χαλκεύεται αὐτῷ,	-u u- uu -u u- --uu --	dactylic hexameter	feminine penthemimeral, hepthemimeral, trithemimeral
εἰ μὴ ἐμὴν γνώμην ἐξαπατῶσι θεοί.	- u u- -- -uu-u u-	dactylic pentameter	
δειμαίνω μὴ τήνδε μόλιν, Πολυπαΐδη, ὕβρις,	--- - -u u- uu-uu --	dactylic hexameter	feminine penthemimeral, hepthemimeral, trithemimeral
ἥπερ Κενταύρους ὠμοφάγους, ὀλέσῃ.	-- --- -uu- uu-	dactylic pentameter	
χρή με παρὰ στάθμην καὶ γνώμονα τήνδε δικάσσαι,	- u u- -- - -uu -u u--	dactylic hexameter	masculine penthemimeral, trithemimeral
Κύρνε, δίκην, ἶσόν τ᾽ἀμφοτέροισι δόμεν,	-u u- -- -uu-u u-	dactylic pentameter	
μάντεσί τ᾽οἰωνοῖς τε καὶ αἰθομένοις ἱεροῖσιν,	-uu --- u u -uu- uu--	dactylic hexameter	masculine penthemimeral
ὄφρα μὴ ἀμπλακίης αἰσχρὸν ὄνειδος ἔχω.	-u u -uu- -u u-u u-	dactylic pentameter	
μηδένα πῃ κακότητι βιάζεο· τῷ δὲ δικαίῳ	-uu - uu-u u-uu - u u--	dactylic hexameter	feminine penthemimeral, trithemimeral
τῆς εὐεργεσίης οὐδὲν ἀρειότερον.	- --uu- -u u-uu-	dactylic pentameter	
Ἄγγελος ἄφθογγος πόλεμον πολύδακρυν ἐγείρει,	-uu --- uu- uu-u u--	dactylic hexameter	masculine penthemimeral, hepthemimeral
Κύρν᾽, ἀπὸ τηλαυγέος φαινόμενος σκοπιῆς.	- uu --- -uu- uu-	dactylic pentameter	
ἀλλ᾽ ἵπποις ἔμβαλλε ταχυπτέρνοισι χαλινούς·	- -- --u u---u u--	dactylic hexameter	feminine penthemimeral, trithemimeral
δῄων γάρ σφ᾽ ἀνδρῶν ἀντιάσειν δοκέω.	-- - -- -uu- uu-	dactylic pentameter	
οὐ πολλὴν τὸ μεσηγὺ διαπρήξουσι κέλευθον,	- -- u u-u u---u u--	dactylic hexameter	feminine penthemimeral, trithemimeral
εἰ μὴ ἐμὴν γνώμην ἐξαπατῶσι θεοί.	- u u- -- -uu-u u-	dactylic pentameter	
χρὴ τολμᾶν χαλεποῖσιν ἐν ἄλγεσι κείμενον ἄνδρα,	- -- uu-u u -uu -uu --	dactylic hexameter	feminine penthemimeral, trithemimeral
πρός τε θεῶν αἰτεῖν ἔκλυσιν ἀθανάτων.	- u u- -- -uu -uu-	dactylic pentameter	
φράζεο· κίνδυνός τοι ἐπὶ ξυροῦ ἵσταται ἀκμῇς·	-uu --- u u- uu -uu --	dactylic hexameter	masculine penthemimeral, hepthemimeral
ἄλλοτε πόλλ᾽ ἕξεις, ἄλλοτε παυρότερα,	-uu - -- -uu -uu-	dactylic pentameter	
ὥστε σε μήτε λίην ἀφνεὸν κτεάτεσσι γενέσθαι	-u u -u u- -- uu-u u--	dactylic hexameter	masculine penthemimeral, hepthemimeral
χρὴ μήτ᾽ ἐς πολλὴν χρημοσύνην ἐλάσαι.	- - - -- -uu- uu-	dactylic pentameter	
εἴη μοι τὰ μὲν αὐτὸν ἔχειν, τὰ δὲ πόλλ᾽ ἐπιδοῦναι	-- - u u -u u- u u - uu--	dactylic hexameter	feminine penthemimeral, hepthemimeral, trithemimeral
χρήματα τῶν ἐχθρῶν τοῖσι φίλοισιν ἔχειν.	-uu - -- -u u-u u-	dactylic pentameter	
κεκλῆσθαί τ᾽ἐς δαῖτα παρέζεσθαί τε παρ᾽ ἐσθλὸν	--- - -u u--- u u --	dactylic hexameter	feminine penthemimeral, trithemimeral
ἄνδρα χρεὼν σοφίην πᾶσαν ἐπιστάμενον·	-u u- uu- -u u-uu-	dactylic pentameter	
τοῦ συνιεῖν θ᾽ὁπόταν τι λέγῃ σοφόν, ὄφρα διδαχθῇς	- uu- uu- u u- uu -u u--	dactylic hexameter	masculine penthemimeral, hepthemimeral, trithemimeral
καὶ τοῦτ᾽ εἰς οἶκον κέρδος ἔχων ἀπίῃς.	- - - -- -u u- uu-	dactylic pentameter	
ἥβῃ τερπόμενος παίζω· δηρὸν γὰρ ἔνερθεν	-- -uu- -- -- u u--	dactylic hexameter	masculine penthemimeral, hepthemimeral
γῆς ὀλέσας ψυχὴν κείσομαι ὥστε λίθος	- uu- -- -uu -u u-	dactylic pentameter	
ἄφθογγος, λείψω δ᾽ἐρατὸν φάος ἠελίοιο,	--- -- uu- uu -uu--	dactylic hexameter	masculine penthemimeral, hepthemimeral, trithemimeral
ἔμπης δ᾽ἐσθλὸς ἐὼν ὄψομαι οὐδὲν ἔτι.	-- -u u- -uu -u u-	dactylic pentameter	
δόξα μὲν ἀνθρώποισι κακὸν μέγα, πεῖρα δ᾽ἄριστον·	-u u ---u u- uu -u u--	dactylic hexameter	feminine penthemimeral, hepthemimeral
πολλοὶ ἀπείρητοι δόξαν ἔχουσ᾽ ἀγαθῶν.	-u u--- -u u- uu-	dactylic pentameter	
εὖ ἕρδων εὖ πάσχε· τί κ᾽ἄγγελον ἄλλον ἴαλλοις;	- -- - -u u -uu -u u--	dactylic hexameter	feminine penthemimeral, trithemimeral
τῆς εὐεργεσίης ῥῃδίη ἀγγελίη.	- --uu- -uu -uu-	dactylic pentameter	
οἵ με φίλοι προδιδοῦσιν, ἐπεὶ τόν γ᾽ἐχθρὸν ἀλεῦμαι	- u u- uu-u u- - -u u--	dactylic hexameter	feminine penthemimeral, hepthemimeral, trithemimeral
ὥστε κυβερνήτης χοιράδας εἰναλίας.	-u u--- -uu -uu-	dactylic pentameter	
Ῥήϊον ἐξ ἀγαθοῦ θεῖναι κακὸν ἠ κ᾽κακοῦ ἐσθλόν.	-uu - uu- -- uu - uu --	dactylic hexameter	masculine penthemimeral, hepthemimeral, trithemimeral
μή με δίδασκ᾽· οὔτοι τηλίκος εἰμὶ μαθεῖν.	- u u- -- -uu -u u-	dactylic pentameter	
ἐχθαίρω κακὸν ἄνδρα, καλυψαμένη δὲ πάρειμι	--- uu -u u-uu- u u--	dactylic hexameter	feminine penthemimeral, trithemimeral
σμικρῆς ὄρνιθος κοῦφον ἔχουσα νόον.	-- --- -u u-u u-	dactylic pentameter	
ἐχθαίρω δὲ γυναῖκα περίδρομον, ἄνδρα τε μάργον	--- u u-u u-uu -u u --	dactylic hexameter	feminine penthemimeral, trithemimeral
ὃς τὴν ἀλλοτρίην βούλετ᾽ ἄρουραν ἀροῦν.	- - -uuu -u u-u u-	lyric	
ἀλλὰ τὰ μὲν προβέβηκεν, ἀμήχανόν ἐστι γενέσθαι	-u u - uu-u u-uu -u u--	dactylic hexameter	feminine penthemimeral, trithemimeral
ἀργά· τὰ δ᾽ἐξοπίσω, τῶν φυλακὴ μελέτω.	-u u -uu- - uu- uu-	dactylic pentameter	
πᾶσίν τοι κίνδυνος ἐπ᾽ ἔργμασιν, οὐδέ τις οἶδεν	-- - --u u -uu -u u --	dactylic hexameter	feminine penthemimeral, trithemimeral
πῇ σχήσειν μέλλει πρήγματος ἀρχομένου.	- -- -- -uu -uu-	dactylic pentameter	
ἀλλ᾽ ὁ μὲν εὐδοκιμεῖν πειρώμενος οὐ προνοήσας	- u u -uu- --uu - uu--	dactylic hexameter	masculine penthemimeral
εἰς μεγάλην ἄτην καὶ χαλεπὴν ἔπεσεν,	- uu- -- - uu- uu-	dactylic pentameter	
τῷ δὲ καλῶς ποιεῦντι θεὸς περὶ πάντα τίθησιν	- u u- --u u- uu -u u--	dactylic hexameter	feminine penthemimeral, hepthemimeral, trithemimeral
συντυχίην ἀγαθήν, ἔκλυσιν ἀφροσύνης.	-uu- uu- -uu -uu-	dactylic pentameter	
τολμᾶν χρὴ τὰ διδοῦσι θεοὶ θνητοῖσι βροτοῖσιν,	-- - u u-u u- --u u--	dactylic hexameter	feminine penthemimeral, hepthemimeral, trithemimeral
ῥηϊδίως δὲ φέρειν ἀμφοτέρων τὸ λάχος.	-uu- u u- -uu- u u-	dactylic pentameter	
μήτε κακοῖσιν ἀσῶ τι λίην φρένα μήτ᾽ ἀγαθοῖσιν	-u u-u u- u u- uu - uu--	dactylic hexameter	masculine penthemimeral, hepthemimeral
τερφθῇς ἐξαπίνης πρὶν τέλος ἄκρον ἰδεῖν.	-- -uu- - uu -u u-	dactylic pentameter	
ἄνθρωπ᾽, ἀλλήλοισιν ἀπόπροθεν ὦμεν ἑταῖροι·	-- ---u u-uu -u u--	dactylic hexameter	feminine penthemimeral
πλὴν πλούτου παντὸς χρήματός ἐστι κόρος.	- -- -- -uu -u u-	dactylic pentameter	
δὴν δὴ καὶ φίλοι εἶμεν· ἀτάρ τ᾽ἄλλοισιν ὁμίλει	- - - uu -u u- --u u--	dactylic hexameter	feminine penthemimeral, hepthemimeral, trithemimeral
ἀνδράσιν, οἳ τὸν σὸν μᾶλλον ἴσασι νόον.	-uu - - - -u u-u u-	dactylic pentameter	
οὔ μ᾽ἔλαθες φοιτῶν κατ᾽ ἀμαξιτὸν ἣν ἄρα καὶ πρὶν	- uu- -- u u-uu - uu - -	dactylic hexameter	masculine penthemimeral, trithemimeral
ἠλάστρεις κλέπτων ἡμετέρην φιλίην.	--- -- -uu- uu-	dactylic pentameter	
ἔρρε, θεοῖσίν τ᾽ἐχθρὲ καὶ ἀνθρώποισιν ἄπιστε,	-u u-- -u u ---u u--	dactylic hexameter	feminine penthemimeral
ψυχρὸν ὃν ἐν κόλπῳ ποικίλον εἶχον ὄφιν.	-u u - -- -uu -u u-	dactylic pentameter	
τοιάδε καὶ Μάγνητας ἀπώλεσεν ἔργα καὶ ὕβρις	-uu - --u u-uu -u u --	dactylic hexameter	feminine penthemimeral, trithemimeral
οἷα τὰ νῦν ἱερὴν τήνδε πόλιν κατέχει.	-u u - uu- -u u- uu-	dactylic pentameter	
πολλῷ τοι πλέονας λιμοῦ κόρος ὤλεσεν ἤδη	-- - uu- -- uu -uu --	dactylic hexameter	masculine penthemimeral, hepthemimeral, trithemimeral
ἄνδρας ὅσοι μοίρης πλεῖον ἔχειν ἔθελον.	-u u- -- -u u- uu-	dactylic pentameter	
ἀρχῇ ἔρι ψεύδους μικρὰ χάρις· εἰς δὲ τελευτὴν	-u u- -- uu -- - u u--	dactylic hexameter	masculine penthemimeral, trithemimeral
αἰσχρὸν δὴ κέρδος καὶ κακὸν ἀμφότερα	-- - -- - uu -uu-	dactylic pentameter	
γίνεται. οὐδέ τι καλόν, ὅτῳ ψεῦδος προσαμαρτῇ	-uu -u u -u u- -- uu--	dactylic hexameter	feminine penthemimeral, hepthemimeral
ἀνδρὶ καὶ ἐξέλθῃ πρῶτον ἀπὸ στόματος.	-u u --- -u u- uu-	dactylic pentameter	
οὐ χαλεπὸν ψέξαι τὸν πλησίον, οὐδὲ μὲν αὐτὸν	- uu- -- - -uu -u u --	dactylic hexameter	masculine penthemimeral, trithemimeral
αἰνῆσαι· δειλοῖς ἀνδράσι ταῦτα μέλει·	--- -- -uu -u u-	dactylic pentameter	
σιγᾶν δ᾽οὐκ ἐθέλουσι κακοὶ κακὰ λεσχάζοντες·	-- - uu-u u- uu ----	dactylic hexameter	feminine penthemimeral, hepthemimeral, trithemimeral
οἱ δ᾽ἀγαθοὶ πάντων μέτρον ἴσασιν ἔχειν.	- uu- -- -u u-u u-	dactylic pentameter	
οὐδένα παμπήδην ἀγαθὸν καὶ μέτριον ἄνδρα	-uu --- uu- - -uu --	dactylic hexameter	masculine penthemimeral, hepthemimeral
τῶν νῦν ἀνθρώπων ἠέλιος καθορᾷ.	- - --- -uu- uu-	dactylic pentameter	
οὔτι μάλ᾽ ἀνθρώποις καταθύμια πάντα τελεῖται·	-u u --- uu-uu -u u--	dactylic hexameter	masculine penthemimeral
πολλὸν γὰρ θνητῶν κρέσσονες ἀθάνατοι.	-- - -- -uu -uu-	dactylic pentameter	
πόλλ᾽ ἐν ἀμηχανίῃσι κυλίνδομαι ἀχνύμενος κῆρ·	- u u-uu-u u-uu -uu- -	dactylic hexameter	feminine penthemimeral
ἄκρην γὰρ πενίην οὐχ ὑπερεδράμομεν.	-- - uu- - uu-uu-	dactylic pentameter	
πᾶς τις πλούσιον ἄνδρα τίει, ἀτίει δὲ πενιχρόν·	- - -uu -u u- uu- u u--	dactylic hexameter	feminine penthemimeral, hepthemimeral
πᾶσιν δ᾽ἀνθρώποις αὐτὸς ἔνεστι νόος.	-- --- -u u-u u-	dactylic pentameter	
παντοῖαι κακότητες ἐν ἀνθρώποισιν ἔασιν	--- uu-u u ---u u--	dactylic hexameter	feminine penthemimeral, trithemimeral
παντοῖαι δ᾽ἀρεταὶ καὶ βιότου παλάμαι.	--- uu- - uu- uu-	dactylic pentameter	
ἀργαλέον φρονέοντα παρ᾽ ἄφροσι πόλλ᾽ ἀγορεύειν,	-uu- uu-u u -uu - uu--	dactylic hexameter	feminine penthemimeral, trithemimeral
καὶ σιγᾶν αἰεί· τοῦτο γὰρ οὐ δυνατόν.	- -- -- -u u - uu-	dactylic pentameter	
αἰσχρόν τοι μεθύοντα παρ᾽ ἀνδράσι νήφοσιν εἶναι	-- - uu-u u -uu -uu --	dactylic hexameter	feminine penthemimeral, trithemimeral
αἰσχρὸν δ᾽εἰ νήφων πὰρ μεθύουσι μένει.	-- - -- - uu-u u-	dactylic pentameter	
ἥβη καὶ νεότης ἐπικουφίζει νόον ἀνδρός,	-- - uu- uu--- uu --	dactylic hexameter	masculine penthemimeral, trithemimeral
πολλῶν δ᾽ἐξαίρει θυμὸν ἐς ἀμπλακίην.	-- --- -u u -uu-	dactylic pentameter	
ᾯτινι μὴ θυμοῦ κρέσσων νόος, αἰὲν ἐν ἄταις,	-uu - -- -- uu -u u --	dactylic hexameter	masculine penthemimeral, hepthemimeral, trithemimeral
Κύρνε, καὶ ἐν μεγάλαις κεῖται ἀμηχανίαις.	-u u - uu- -u u-uu-	dactylic pentameter	
βουλεύου δὶς καὶ τρὶς ὅ τοί κ᾽ἐπὶ τὸν νόον ἔλθῃ·	--- - - u u - uu - uu --	dactylic hexameter	masculine penthemimeral, hepthemimeral, trithemimeral
ἀτηρὸς γάρ τοι λάβρος ἀνὴρ τελέθει.	--- - - -u u- uu-	dactylic pentameter	
ἀνδράσι τοῖς ἀγαθοῖς ἕπεται γνώμη τε καὶ αἰδώς·	-uu - uu- uu- -- u u --	dactylic hexameter	masculine penthemimeral, hepthemimeral, trithemimeral
οἳ νῦν ἐν πολλοῖς ἀτρεκέως ὀλίγοι.	- - - -- -uu- uu-	dactylic pentameter	
ἐλπὶς καὶ κίνδυνος ἐν ἀνθρώποισιν ὁμοῖα	-- - --u u ---u u--	dactylic hexameter	feminine penthemimeral, trithemimeral
οὗτοι γὰρ χαλεποὶ δαίμονες ἀμφότεροι.	-- - uu- -uu -uu-	dactylic pentameter	
πολλάκι πὰρ δόξαν τε καὶ ἐλπίδα γίνεται εὖ ῥεῖν	-uu - -- u u -uu -uu - -	dactylic hexameter	masculine penthemimeral, trithemimeral
ἔργ᾽ ἀνδρῶν, βουλαῖς δ᾽οὐκ ἐπέγεντο τέλος.	- -- -- - uu-u u-	dactylic pentameter	
οὔτοι κ᾽εἰδείης οὔτ᾽ εὔνοον οὔτε μὲν ἐχθρόν,	-- --- - -uu -u u --	dactylic hexameter	masculine penthemimeral
εἰ μὴ σπουδαίου πρήγματος ἀντιτύχοις.	- - --- -uu -uu-	dactylic pentameter	
πολλοὶ πὰρ κρητῆρι φίλοι γίνονται ἑταῖροι,	-- - --u u- --u u--	dactylic hexameter	feminine penthemimeral, hepthemimeral, trithemimeral
ἐν δὲ σπουδαίῳ πρήγματι παυρότεροι.	- - --- -uu -uu-	dactylic pentameter	
παύρους κηδεμόνας πιστοὺς εὕροις κεν ἑταίρους	-- -uu- -- -- u u--	dactylic hexameter	masculine penthemimeral, hepthemimeral
κείμενος ἐν μεγάλῃ θυμὸν ἀμηχανίῃ.	-uu - uu- -u u-uu-	dactylic pentameter	
ἤδη νῦν αἰδὼς μὲν ἐν ἀνθρώποισιν ὄλωλεν,	-- - -- u u ---u u--	dactylic hexameter	masculine penthemimeral, trithemimeral
αὐτὰρ ἀναιδείη γαῖαν ἐπιστρέφεται.	-u u--- -u u-uu-	dactylic pentameter	
ἆ δειλὴ Πενίη, τί ἐμοῖς ἐπικειμένη ὤμοις	- -- uu- u u- uu-uu --	dactylic hexameter	masculine penthemimeral, hepthemimeral, trithemimeral
σῶμα καταισχύνεις καὶ νόον ἡμέτερον,	-u u--- - uu -uu-	dactylic pentameter	
αἰσχρὰ δέ μ᾽οὐκ ἐθέλοντα βίῃ καὶ δειλὰ διδάσκεις	-u u - uu-u u- - -u u--	dactylic hexameter	feminine penthemimeral, hepthemimeral, trithemimeral
ἐσθλὰ μετ᾽ ἀνθρώπων καὶ κάλ᾽ ἐπιστάμενον;	-u u --- - u u-uu-	dactylic pentameter	
εὐδαίμων εἴην καὶ θεοῖς φίλος ἀθανάτοισιν,	--- -- - - uu -uu--	dactylic hexameter	masculine penthemimeral, hepthemimeral, trithemimeral
Κύρν᾽· ἀρετῆς δ᾽ἄλλης οὐδεμιῆς ἔραμαι.	- uu- -- -uu- uu-	dactylic pentameter	
σύν τοι, Κύρνε, παθόντι κακῶς ἀνιώμεθα πάντες·	- - -u u-u u- uu-uu --	dactylic hexameter	feminine penthemimeral, hepthemimeral
ἀλλά τοι ἀλλότριον κῆδος ἐφημέριον.	-u u -uu- -u u-uu-	dactylic pentameter	
μηδὲν ἄγαν χαλεποῖσιν ἀσῶ φρένα μηδ᾽ ἀγαθοῖσιν	-u u- uu-u u- uu - uu--	dactylic hexameter	feminine penthemimeral, hepthemimeral, trithemimeral
χαῖρ᾽, ἐπεὶ ἔστ᾽ ἀνδρὸς πάντα φέρειν ἀγαθοῦ.	- uu - -- -u u- uu-	dactylic pentameter	
†οὐδ᾽ ὀμόσαι χρὴ τοῦθ᾽, ὅτι μήποτε πρῆγμα τόδ᾽ ἔσται·	- uu- - - uu -uu -u u --	dactylic hexameter	masculine penthemimeral, trithemimeral
θεοὶ γάρ τοι νεμεσῶσ᾽, οἷσιν ἔπεστι τέλος·	- - - uu- -u u-- u-	lyric	
καὶ πρῆξαι μέντοι τι. καὶ ἐκ κακοῦ ἐσθλὸν ἔγεντο,	- -- -- u u - uu -u u--	dactylic hexameter	masculine penthemimeral, hepthemimeral, trithemimeral
καὶ κακὸν ἐξ ἀγαθοῦ· καί τε πενιχρὸς ἀνὴρ	- uu - uu- - u u-u u-	dactylic pentameter	
αἶψα μάλ᾽ ἐπλούτησε· καὶ ὃς μάλα πολλὰ πέπαται,	-u u ---u u - uu -u u--	dactylic hexameter	feminine penthemimeral, hepthemimeral
ἐξαπίνης πάντ᾽ οὖν ὤλεσε νυκτὶ μιῇ·	-uu- - - -uu -u u-	dactylic pentameter	
καὶ σώφρων ἥμαρτε καὶ ἄφρονι πολλάκι δόξα	- -- --u u -uu -uu --	dactylic hexameter	feminine penthemimeral, trithemimeral
ἕσπετο, καὶ τιμῆς καὶ κακὸς ὢν ἔλαχεν.	-uu - -- - uu - uu-	dactylic pentameter	
εἰ μὲν χρήματ᾽ ἔχοιμι, Σιμωνίδη, οἷάπερ ἤθη	- - -u u-u u-uu -uu --	dactylic hexameter	feminine penthemimeral
οὐκ ἂν ἀνιώμην τοῖς ἀγαθοῖσι συνών·	- u u--- - uu-u u-	dactylic pentameter	
νῦν δέ με γινῴσκοντα παρέρχεται, εἰμὶ δ᾽ἄφωνος	- u u ---u u-uu -u u--	dactylic hexameter	feminine penthemimeral
χρημοσύνῃ, πολλῶν γνοὺς ἂν ἄμεινον ἐτέων,	-uu- -- - u u-u u-	dactylic pentameter	
οὕνεκα νῦν φερόμεσθα καθ᾽ ἱστία λευκὰ βαλόντες	-uu - uu-u u -uu -u u--	dactylic hexameter	feminine penthemimeral, trithemimeral
μηλίου ἐκ πόντου νύκτα διὰ δνοφέρην·	-uu - -- -u u- uu-	dactylic pentameter	
ἀντλεῖν δ᾽οὐκ ἐθέλουσιν· ὑπερβάλλει δὲ θάλασσα	-- - uu-u u--- u u--	dactylic hexameter	feminine penthemimeral, trithemimeral
ἀμφοτέρων τοίχων· ἦ μάλα τις χαλεπῶς	-uu- -- - uu - uu-	dactylic pentameter	
σῴζεται οἷ ἕρδουσι· κυβερνήτην μὲν ἔπαυσαν	-uu - --u u--- u u--	dactylic hexameter	feminine penthemimeral, trithemimeral
ἐσθλόν, ὅτις φυλακὴν εἶχεν ἐπισταμένως,	-u u- uu- -u u-uu-	dactylic pentameter	
χρήματα δ᾽ἁρπάζουσι βίῃ· κόσμος δ᾽ἀπόλωλεν,	-uu ---u u- -- uu--	dactylic hexameter	feminine penthemimeral, hepthemimeral
δασμὸς δ᾽οὐκέτ᾽ ἴσος γίνεται ἐς τὸ μέσον·	-- -u u- -uu - u u-	dactylic pentameter	
φορτηγοὶ δ᾽ἄρχουσι, κακοὶ δ᾽ἀγαθῶν καθύπερθεν·	--- --u u- uu- uu--	dactylic hexameter	feminine penthemimeral, hepthemimeral, trithemimeral
δειμαίνω μή πως ναῦν κατὰ κῦμα πίῃ.	--- - - - uu -u u-	dactylic pentameter	
ταῦτά μοι ᾐνίχθω κεχρησμένα τοῖς ἀγαθοῖσιν·	-u u --- --uu - uu--	dactylic hexameter	masculine penthemimeral
γινώσκοι δ᾽ἄν τις καὶ κακός, ἂν σοφὸς ᾖ.	--- - - - uu - uu -	dactylic pentameter	
πολλοὶ πλοῦτον ἔχουσιν ἀΐδριες· οἱ δὲ τὰ καλὰ	-- -u u-u u-uu - u u --	dactylic hexameter	feminine penthemimeral
ζητοῦσιν χαλεπῇ τειρόμενοι πενίῃ·	--- uu- -uu- uu-	dactylic pentameter	
ἕρδειν δ᾽ἀμφοτέροισιν ἀμηχανίη παράκειται·	-- -uu-u u-uu- uu--	dactylic hexameter	feminine penthemimeral
εἴργει γὰρ τοὺς μὲν χρήματα, τοὺς δὲ νόος.	-- - - - -uu - u u-	dactylic pentameter	
οὐκ ἔστι θνητοῖσι πρὸς ἀθανάτους μαχέσασθαι,	- -- --u u -uu- uu--	dactylic hexameter	feminine penthemimeral, trithemimeral
οὐδὲ δίκην εἰπεῖν· οὐδενὶ τοῦτο θέμις.	-u u- -- -uu -u u-	dactylic pentameter	
οὐ χρὴ πημαίνειν ὅτε μὴ πημαντέον εἴη,	- - --- uu - --uu --	dactylic hexameter	masculine penthemimeral, hepthemimeral
οὐδ᾽ ἕρδειν ὅτι μὴ λώϊον ᾖ τελέσαι.	- -- uu - -uu - uu-	dactylic pentameter	
χαίρων ἐκτελέσειας ὁδὸν μεγάλου διὰ πόντου,	-- -uu-u u- uu- uu --	dactylic hexameter	feminine penthemimeral, hepthemimeral
καί σε Ποσειδάων χάρμα φίλοις ἀγάγοι.	- u u--- -u u- uu-	dactylic pentameter	
πολλούς τοι κόρος ἄνδρας ἀπώλεσεν ἀφραίνοντας·	-- - uu -u u-uu ----	dactylic hexameter	feminine penthemimeral, trithemimeral
γνῶναι γὰρ χαλεπὸν μέτρον, ὅτ᾽ ἐσθλὰ παρῇ·	-- - uu- -u u -u u-	dactylic pentameter	
οὐ δύναμαί σοι, θυμέ, παρασχεῖν ἄρμενα πάντα·	- uu- - -u u-- -uu --	dactylic hexameter	feminine penthemimeral, trithemimeral
τέτλαθι· τῶν δὲ καλῶν οὔτι σὺ μοῦνος ἐρᾷς.	-uu - u u- -u u -u u-	dactylic pentameter	
εὖ μὲν ἔχοντος ἐμοῦ πολλοὶ φίλοι· ἢν δέ τι δεινὸν	- u u-u u- -- uu - u u --	dactylic hexameter	masculine penthemimeral, hepthemimeral
συγκύρσῃ, παῦροι πιστὸν ἔχουσι νόον.	--- -- -u u-u u-	dactylic pentameter	
†πλήθει δ᾽ἀνθρώπων ἀρετὴ μία γίνεται ἥδε,	-- --- uu- uu -uu --	dactylic hexameter	masculine penthemimeral, hepthemimeral
πλουτεῖν· τῶν δ᾽ἄλλων οὐδἒν ἄρ᾽ ἦν ὄφελος,	-- - -- -u u - uu-	dactylic pentameter	
οὐδ᾽ εἰ σωφροσύνην μὲν ἔχοις Ῥαδαμάνθυος αὐτοῦ,	- - -uu- u u- uu-uu --	dactylic hexameter	masculine penthemimeral, hepthemimeral
πλείονα δ᾽εἰδείης Σισύφου Αἰολίδεω,	-uu --- -uu -uu-	dactylic pentameter	
ὅστε καὶ ἐξ Ἀΐδεω πολυϊδρείῃσιν ἀνῆλθεν,	-u u - uu- uu---u u--	dactylic hexameter	masculine penthemimeral, trithemimeral
πείσας Περσεφόνην αἱμύλιοισι λόγοις,	-- -uu- -uu-u u-	dactylic pentameter	
ἥτε βροτοῖς παρέχει λήθην βλάπτουσα νόοιο,	-u u- uu- -- --u u--	dactylic hexameter	masculine penthemimeral, hepthemimeral, trithemimeral
ἄλλος δ᾽οὔπω τις τοῦτό γ᾽ἐπεφράσατο,	-- -- - -u u-uu-	dactylic pentameter	
ὅντινα δὴ θανάτοιο μέλαν νέφος ἀμφικαλύψῃ,	-uu - uu-u u- uu -uu--	dactylic hexameter	feminine penthemimeral, hepthemimeral, trithemimeral
ἔλθῃ δ᾽ἐς σκιερὸν χῶρον ἀποφθιμένων,	-- - uu- -u u-uu-	dactylic pentameter	
κυανέας τε πύλας παραμείψεται, αἵτε θανόντων	-uu- u u- uu-uu -u u--	dactylic hexameter	masculine penthemimeral, trithemimeral
ψυχὰς εἴργουσιν καίπερ ἀναινομένας·	-- --- -u u-uu-	dactylic pentameter	
ἀλλ᾽ ἄρα καὶ κεῖθεν πάλιν ἤλυθε Σίσυφος ἥρως	- uu - -- uu -uu -uu --	dactylic hexameter	masculine penthemimeral, trithemimeral
ἐς φάος ἠελίου σφῇσι πολυφροσύναις·	- uu -uu- -u u-uu-	dactylic pentameter	
οὐδ᾽ εἰ ψεύδεα μὲν ποιοῖς ἐτύμοισιν ὁμοῖα,	- - -uu - -- uu-u u--	dactylic hexameter	masculine penthemimeral, hepthemimeral
γλῶσσαν ἔχων ἀγαθὴν Νέστορος ἀντιθέου,	-u u- uu- -uu -uu-	dactylic pentameter	
ὠκύτερος δ᾽εἴησθα πόδας ταχέων Ἁρπυιῶν	-uu- --u u- uu- ---	dactylic hexameter	feminine penthemimeral, hepthemimeral, trithemimeral
καὶ παίδων Βορέω, τῶν ἄφαρ εἰσὶ πόδες.	- -- uu- - uu -u u-	dactylic pentameter	
ἀλλὰ χρὴ πάντας γνώμην ταύτην καταθέσθαι,	-- - -- -- -- uu--	dactylic hexameter	masculine penthemimeral, hepthemimeral, trithemimeral
ὡς πλοῦτος πλείστην πᾶσιν ἔχει δύναμιν.	- -- -- -u u- uu-	dactylic pentameter	
ἶσόν τοι πλουτοῦσιν, ὅτῳ πολὺς ἄργυρός ἐστιν	-- - --u u- uu -uu --	dactylic hexameter	feminine penthemimeral, hepthemimeral, trithemimeral
καὶ χρυσὸς καὶ γῆς πυροφόρου πεδία	- -- - - -uu- uu-	dactylic pentameter	
ἵπποι θ᾽ἡμίονοί τε, καὶ ᾧ τὰ δέοντα πάρεστι	-- -uu- u u - u u-u u--	dactylic hexameter	masculine penthemimeral, hepthemimeral
γαστρί τε καὶ πλευραῖς καὶ ποσὶν ἁβρὰ παθεῖν,	-u u - -- - uu -u u-	dactylic pentameter	
παιδός τ᾽ ἠδὲ γυναικός· ὅταν δέ κε τῶν ἀφίκηται	-- -u u-u u- u u - uu--	dactylic hexameter	feminine penthemimeral, hepthemimeral
ὥρη, σὺν δ᾽ ἥβη γίνεται ἁρμοδία,	-- - -- -uu -uu-	dactylic pentameter	
ταῦτ᾽ ἄφενος θνητοῖσι· τὰ γὰρ περιώσια πάντα	- uu- --u u - uu-uu --	dactylic hexameter	feminine penthemimeral, hepthemimeral, trithemimeral
χρήματ᾽ ἔχων οὐδεὶς ἔρχεται εἰς Ἀΐδεω,	-u u- -- -uu - uu-	dactylic pentameter	
οὐδ᾽ ἂν ἄποινα διδοὺς θάνατον φύγοι οὐδὲ βαρείας	- u u-u u- uu- uu -u u--	dactylic hexameter	masculine penthemimeral, hepthemimeral
νούσους οὐδὲ κακὸν γῆρας ἐπερχόμενον.	-- -u u- -u u-uu-	dactylic pentameter	
φροντίδες ἀνθρώπων ἔλαχον πτέρα ποικίλ᾽ ἔχουσαι,	-uu --- uu- uu -u u--	dactylic hexameter	masculine penthemimeral, hepthemimeral
μυρόμεναι ψυχῆς εἵνεκα καὶ βιότου.	-uu- -- -uu - uu-	dactylic pentameter	
†Ζεῦ πάτερ, εἴθε γένοιτο θεοῖς θίλα τοῖς μὲν ἀλιτροῖς	- uu -u u-u u- uu - u u--	dactylic hexameter	feminine penthemimeral, hepthemimeral
ὕβριν ἁδεῖν, εἴ σφιν τοῦτο γένοιτο φίλον	-u u- - - -u u-u u-	dactylic pentameter	
θυμῷ, σχέτλια δ᾽ἔργα μετὰ φρεσὶ θ᾽ὅστις ἀθηρὴς	-- -uu -u u- uu -u u--	dactylic hexameter	feminine penthemimeral, hepthemimeral
ἐργάζοιτο θεῶν μηδὲν ὀπιζόμενος,	---u u- -u u-uu-	dactylic pentameter	
αὐτὸν ἔπειτα πάλιν τεῖσαι κακά, μηδ᾽ ἔτ᾽ ὀπίσσω	-u u-u u- -- uu - u u--	dactylic hexameter	masculine penthemimeral, hepthemimeral
πατρὸς ἀτασθαλίαι παισὶ γένοιντο κακόν·	-u u-uu- -u u-u u-	dactylic pentameter	
παῖδές θ᾽οἵτ᾽ ἀδίκου πατρὸς τὰ δίκαια νοεῦντες	-- - uu- -- u u-u u--	dactylic hexameter	masculine penthemimeral, hepthemimeral, trithemimeral
ποιῶσιν, Κρονίδη, σὸν χόλον ἁζόμενοι,	--- uu- - uu -uu-	dactylic pentameter	
ἐξ ἀρχῆς τὰ δίκαια μετ᾽ ἀστοῖσιν φιλέοντες,	- -- u u-u u --- uu--	dactylic hexameter	feminine penthemimeral, trithemimeral
μήτιν᾽ ὑπερβασίην ἀντιτίνειν πατέρων.	-u u-uu- -uu- uu-	dactylic pentameter	
ταῦτ᾽ εἴη μακάρεσσι θεοῖς φίλα· νῦν δ᾽ὁ μὲν ἕρδων	- -- uu-u u- uu - u u --	dactylic hexameter	feminine penthemimeral, hepthemimeral, trithemimeral
ἐκφεύγει, τὸ κακὸν δ᾽ἄλλος ἔπειτα φέρει.	--- u u- -u u-u u-	dactylic pentameter	
καὶ τοῦτ᾽, ἀθανάτων βασιλεῦ, πῶς ἐστι δίκαιον,	- - -uu- uu- - -u u--	dactylic hexameter	masculine penthemimeral, hepthemimeral
ἔργων ὅστις ἀνὴρ ἐκτὸς ἐὼν ἀδίκων	-- -u u- -u u- uu-	dactylic pentameter	
μήτιν᾽ ὑπερβασίην παρέχων μηδ᾽ ὅρκον ἀλιτρόν,	-u u-uu- uu- - -u u--	dactylic hexameter	masculine penthemimeral, hepthemimeral
ἀλλὰ δίκαιος ἐών, μὴ τὰ δίκαια πάθῃ;	-u u-u u- - u u-u u-	dactylic pentameter	
τίς δή κεν βροτὸς ἄλλος, ὁρῶν πρὸς τοῦτον, ἔπειτα	- - - uu -u u- - -u u--	dactylic hexameter	feminine penthemimeral, hepthemimeral, trithemimeral
ἅζοιτ᾽ ἀθανάτους, καί τινα θυμὸν ἔχων,	-- -uu- - uu -u u-	dactylic pentameter	
ὁππότ᾽ ἀνὴρ ἄδικος καὶ ἀτάσθαλος, οὔτε τευ ἀνδρὸς	-u u- uu- u u-uu -u u --	dactylic hexameter	masculine penthemimeral, trithemimeral
οὔτε τευ ἀθανάτων μῆνιν ἀλευόμενος,	-u u -uu- -u u-uu-	dactylic pentameter	
ὑβρίζῃ πλούτῳ κεκορημένος, οἱ δὲ δίκαιοι	--- -- uu-uu - u u--	dactylic hexameter	masculine penthemimeral, trithemimeral
τρυχῶνται χαλεπῇ τειρόμενοι πενίῃ;	--- uu- -uu- uu-	dactylic pentameter	
ταῦτα μαθών, φίλ᾽ ἑταῖρε, δικαίως χρήματα ποιοῦ,	-u u- u u-u u-- -uu --	dactylic hexameter	feminine penthemimeral, trithemimeral
σώφρονα θυμὸν ἔχων ἐκτὸς ἀτασθαλίης,	-uu -u u- -u u-uu-	dactylic pentameter	
αἰεὶ τῶνδ᾽ ἐπέων μεμνημένος· εἰς δὲ τελευτὴν	-- - uu- --uu - u u--	dactylic hexameter	masculine penthemimeral, trithemimeral
αἰνήσεις μύθῳ σώφρονι πειθόμενος.	--- -- -uu -uu-	dactylic pentameter	
Ζεὺς μὲν τῆσδε πόληος ὑπειρέχοι αἰθέρι ναίων	- - -u u-u u-uu -uu --	dactylic hexameter	feminine penthemimeral
αἰεὶ δεξιτέρην χεῖρ᾽ ἐπ᾽ ἀπημοσύνῃ,	-- -uu- - u u-uu-	dactylic pentameter	
ἄλλοι τ᾽ἀθάνατοι μάκαρες θεοί· αὐτὰρ Ἀπόλλων	-- -uu- uu- uu -u u--	dactylic hexameter	masculine penthemimeral, hepthemimeral
ὀρθώσαι γλῶσσαν καὶ νόον ἡμέτερον·	--- -- - uu -uu-	dactylic pentameter	
φόρμιγξ δ᾽αὖ φθέγγοιθ᾽ ἱερὸν μέλος ἠδὲ καὶ αὐλός·	-- - -- uu- uu -u u --	dactylic hexameter	masculine penthemimeral, hepthemimeral, trithemimeral
ἡμεῖς δὲ σπονδαῖς θεοὺς ἀπαρεσσάμενοι	-- - -- - uu-uu-	dactylic pentameter	
πίνωμεν, χαρίεντα μετ᾽ ἀλλήλοισι λέγοντες,	--- uu-u u ---u u--	dactylic hexameter	feminine penthemimeral, trithemimeral
μηδὲν τὸν Μήδων δειδιότες πόλεμον.	-- - -- -uu- uu-	dactylic pentameter	
ὧδ᾽ εἴη κεν ἄμεινον ὁμόφρονα θυμὸν ἔχοντας	- -- u u-u u-uu -u u--	dactylic hexameter	feminine penthemimeral, trithemimeral
νόσφι μεριμνάων εὐφροσύνως διάγειν	-u u--- -uu- uu-	dactylic pentameter	
τερπομένους, τηλοῦ δὲ κακὰς ἀπὸ κῆρας ἀμῦναι,	-uu- -- u u- uu -u u--	dactylic hexameter	masculine penthemimeral, hepthemimeral, trithemimeral
γῆράς τ᾽οὐλόμενον καὶ θανάτοιο τέλος.	-- -uu- - uu-u u-	dactylic pentameter	
χρὴ Μουσῶν θεράποντα καὶ ἄγγελον, εἴ τι περισσὸν	- -- uu-u u -uu - u u--	dactylic hexameter	feminine penthemimeral, trithemimeral
εἰδείη, σοφίης μὴ φθονερὸν τελέθειν,	--- uu- - uu- uu-	dactylic pentameter	
ἀλλὰ τὰ μὲν μῶσθαι, τὰ δὲ δεικνύναι, ἄλλα δὲ ποιεῖν·	-u u - -- u u -uu -u u --	dactylic hexameter	masculine penthemimeral, trithemimeral
τί σφιν χρήσηται μοῦνος ἐπιστάμενος;	- - --- -u u-uu-	dactylic pentameter	
†Φοῖβε ἄναξ, αὐτὸς μὲν ἐπύργωσας πόλιν ἄκρην,	-u u- -- u u--- uu --	dactylic hexameter	masculine penthemimeral, trithemimeral
Ἀλκαθόῳ Πέλοπος παιδὶ χαριζόμενος·	-uu- uu- -u u-uu-	dactylic pentameter	
αὐτὸς δὲ στρατὸν ὑβριστὴν Μήδων ἀπέρυκε	-- - uu --- -- uu--	dactylic hexameter	hepthemimeral, trithemimeral
τῆσδε πόλευς, ἵνα σοι λαοὶ ἔν εὐφροσύνῃ	-u u- uu - -u u -uu-	dactylic pentameter	
ἦρος ἐπερχομένου κλειτὰς πέμπωσ᾽ ἑκατόμβας,	-u u-uu- -- -- uu--	dactylic hexameter	masculine penthemimeral, hepthemimeral
τερπόμενοι κιθάρῃ καὶ θαλίῃ ἐρατῇ	-uu- uu- - uu- uu-	dactylic pentameter	
παιάνων τε χοροῖς ἰαχῇσί τε σὸν περὶ βωμόν.	--- u u- uu-u u - uu --	dactylic hexameter	masculine penthemimeral, trithemimeral
ἦ γὰρ ἔγωγε δέδοικ᾽ ἀφραδίην ἐσορῶν	- u u-u u- -uu- uu-	dactylic pentameter	
καὶ στάσιν Ἑλλήνων λαοφθόρον. ἀλλὰ σύ, Φοῖβε,	- uu --- --uu -u u --	dactylic hexameter	masculine penthemimeral
ἵλαος ἡμετέρην τήνδε φύλασσε πόλιν.	-uu -uu- -u u-u u-	dactylic pentameter	
†ἦλθον μὲν γὰρ ἔγωγε καὶ εἰς Σικελήν ποτε γαῖαν,	-- - u u-u u - uu- uu --	dactylic hexameter	feminine penthemimeral, hepthemimeral, trithemimeral
ἦλθον δ᾽Εὐβοίης ἀμπελόεν πεδίον,	-- --- -uu- uu-	dactylic pentameter	
Σπάρτην δ᾽ Εὐρώτα δονακοτρόφου ἀγλαὸν ἄστυ·	-- --- uu-uu -uu --	dactylic hexameter	masculine penthemimeral
καί μ᾽ ἐφίλευν προφρόνως πάντες ἐπερχόμενον·	- uu- uu- -u u-uu-	dactylic pentameter	
ἀλλ᾽ οὔτις μοι τέρψις ἐπὶ φρένας ἦλθεν ἐκείνων·	- -- - -u u- uu -u u--	dactylic hexameter	feminine penthemimeral, hepthemimeral, trithemimeral
οὕτως οὐδὲν ἄρ᾽ ἦν φίλτερον ἄλλο πάτρης.	-- -u u - -uu -u u-	dactylic pentameter	
μήποτέ μοι μελέδημα νεώτερον ἄλλο φανείη	-uu - uu-u u-uu -u u--	dactylic hexameter	feminine penthemimeral, trithemimeral
ἀντ᾽ ἐρατῆς σοφίης, ἀλλὰ τόδ᾽ αἰὲν ἔχων	- uu- uu- -u u -u u-	dactylic pentameter	
τερποίμην φόρμιγγι καὶ ὀρχηθμῷ καὶ ἀοιδῇ,	--- --u u --- u u--	dactylic hexameter	feminine penthemimeral, trithemimeral
καὶ μετὰ τῶν ἀγαθῶν ἐσθλὸν ἔχοιμι νόον.	- uu - uu- -u u-u u-	dactylic pentameter	
μήτε τινὰ ξείνων δηλεύμενος ἔργμασι λυγροῖς	-u u- -- --uu -uu --	dactylic hexameter	masculine penthemimeral, trithemimeral
μήτε τιν᾽ ἐνδήμων, ἀλλὰ δίκαιος ἐών,	-u u --- -u u-u u-	dactylic pentameter	
τὴν σαυτοῦ φρένα τέρπε· δυσηλεγέων δὲ πολιτῶν	- -- uu -u u-uu- u u--	dactylic hexameter	feminine penthemimeral, trithemimeral
ἄλλος τοί σε κακῶς, ἄλλος ἄμεινον ἐρεῖ.	-- - u u- -u u-u u-	dactylic pentameter	
τοὺς ἀγαθοὺς ἄλλος μάλα μέμφεται, ἄλλος ἐπαινεῖ·	- uu- -- uu -uu -u u--	dactylic hexameter	masculine penthemimeral, trithemimeral
τῶν δὲ κακῶν μνήμη γίνεται οὐδεμία.	- u u- -- -uu -uu-	dactylic pentameter	
ἀνθρώπων δ᾽ἄψεκτος ἐπὶ χθονὶ γίνεται οὐδείς·	--- --u u- uu -uu --	dactylic hexameter	feminine penthemimeral, hepthemimeral, trithemimeral
ἀλλ᾽ ὣς λώϊον, εἰ μὴ πλεόνεσσι μέλοι.	- - -uu - - uu-u u-	dactylic pentameter	
οὐδεὶς ἀνθρώπων οὔτ᾽ ἔσσεται οὔτε πέφυκεν,	-- --- - -uu -u u--	dactylic hexameter	masculine penthemimeral
ὅστις πᾶσιν ἁδὼν δύσεται εἰς Ἀΐδεω·	-- -u u- -uu - uu-	dactylic pentameter	
οὐδὲ γὰρ ὃς θνητοῖσι καὶ ἀθανάτοισιν ἀνάσσει,	-u u - --u u -uu-u u--	dactylic hexameter	feminine penthemimeral, trithemimeral
Ζεὺς Κρονίδης, θνητοῖς πᾶσιν ἁδεῖν δύναται.	- uu- -- -u u- uu-	dactylic pentameter	
τόρνου καὶ στάθμης καὶ γνώμονος ἄνδρα θεωρὸν	-- - -- - -uu -u u--	dactylic hexameter	masculine penthemimeral, trithemimeral
εὐθύτερον χρὴ ἔμεν, Κύρνε, φυλασσόμενον,	-uu- u u- -u u-uu-	dactylic pentameter	
ᾧτινί κεν Πυθῶνι θεοῦ χρήσασ᾽ ἱέρεια	-uu - --u u- -- uu--	dactylic hexameter	feminine penthemimeral, hepthemimeral, trithemimeral
ὀμφὴν σημήνῃ πίονος ἐξ ἀδύτου·	-- --- -uu - uu-	dactylic pentameter	
οὔτε τι γὰρ προσθεὶς οὐδέν κ᾽ἔτι φάρμακον εὕροις,	-u u - -- -- uu -uu --	dactylic hexameter	masculine penthemimeral, hepthemimeral, trithemimeral
οὔτ᾽ ἀφελὼν πρὸς θεῶν ἀμπλακίην προφύγοις.	- uu- - - -uu- uu-	dactylic pentameter	
χρῆμ᾽ ἔπαθον θανάτου μὲν ἀεικέος οὔτι κάκιον,	- uu- uu- u u-uu -u u--	dactylic hexameter	masculine penthemimeral, trithemimeral
τῶν δ᾽ἄλλων πάντων, Κύρν᾽, ἀνιηρότατον·	- -- -- - uu-uu-	dactylic pentameter	
οἵ με φίλοι προὔδωκαν. ἐγὼ δ᾽ἐχθροῖσι πελασθεὶς	- u u- --u u- --u u--	dactylic hexameter	feminine penthemimeral, hepthemimeral, trithemimeral
ἐδήσω καὶ τοὺς ὅντιν᾽ ἔχουσι νόον.	--- - - -u u-u u-	dactylic pentameter	
βοῦς μοι ἐπὶ γλώσσῃ κρατερῷ ποδὶ λὰξ ἐπιβαίνων	- u u- -- uu- uu - uu--	dactylic hexameter	masculine penthemimeral, hepthemimeral, trithemimeral
ἴσχει κωτίλλειν καίπερ ἐπιστάμενον.	-- --- -u u-uu-	dactylic pentameter	
Κύρν᾽, ἔμπης δ᾽ὅτι μοῖρα παθεῖν οὐκ ἔσθ᾽ ὑπαλύξαι·	- -- uu -u u- - - uu--	dactylic hexameter	feminine penthemimeral, hepthemimeral, trithemimeral
ὅττι δὲ μοῖρα παθεῖν οὔτι δέδοικα παθεῖν.	-u u -u u- -u u-u u-	dactylic pentameter	
ἐς πολυάρητον κακὸν ἥκομεν, ἔνθα μάλιστα,	- uu--- uu -uu -u u--	dactylic hexameter	masculine penthemimeral
Κύρνε, συναμφοτέρους μοῖρα λάβοι θανάτου.	-u u-uu- -u u- uu-	dactylic pentameter	
οἵ κ᾽ἀπογηράσκοντας ἀτιμάζωσι τοκῆας,	- uu---u u---u u--	dactylic hexameter	feminine penthemimeral
τούτων τοι χώρη, Κύρν᾽, ὀλίγη τελέθει.	-- - -- - uu- uu-	dactylic pentameter	
μήτε τιν᾽ αὖξε τύραννον ἐπ᾽ ἐλπίδι κέρδεσιν εἴκων,	-u u -u u-u u -uu -uu --	dactylic hexameter	feminine penthemimeral
μήτε κτεῖνε θεῶν ὅρκια συνθέμενος.	-- -u u- -uu -uu-	dactylic pentameter	
πῶς ὑμῖν τέτληκεν ὑπ᾽ αὐλητῆρος ἀείδειν	- -- --u u ---u u--	dactylic hexameter	feminine penthemimeral, trithemimeral
θυμός, γῆς δ᾽οὖρος φαίνεται ἐξ ἀγορῆς	-- - -- -uu - uu-	dactylic pentameter	
ἥτε τρέφει καρποῖσιν ἐν εἰλαπίναις ῥοφέοντας	-u u- --u u -uu- uu--	dactylic hexameter	feminine penthemimeral, trithemimeral
ἀνθεῦντάς τε κόμας πορφυρέοις στεφάνοις;	--- u u- -uu- uu-	dactylic pentameter	
ἀλλ᾽ ἄγε δή, σκύθα, κεῖρε κόμην, ἀπόπαυε δὲ κῶμον,	- uu - uu -u u- uu-u u --	dactylic hexameter	feminine penthemimeral, hepthemimeral, trithemimeral
πένθει δ᾽εὐώδη χῶρον ἀπολλύμενον.	-- --- -u u-uu-	dactylic pentameter	
πίστει χρήματ᾽ ὄλεσσα, ἀπιστίῃ δ᾽ἐσάωσα·	-- -u u-u u--- uu--	dactylic hexameter	feminine penthemimeral
γνώμη δ᾽ἀργαλέη γίνεται ἀμφοτέρων.	-- -uu- -uu -uu-	dactylic pentameter	
πάντα τάδ᾽ ἐν κοράκεσσι καὶ ἐν φθόρῳ, οὐδέ τις ἡμῖν	-u u - uu-u u - uu -u u --	dactylic hexameter	feminine penthemimeral, hepthemimeral, trithemimeral
αἴτιος ἀθανάτων, Κύρνε, θεῶν μακάρων.	-uu -uu- -u u- uu-	dactylic pentameter	
ἀλλ᾽ ἀνδρῶν τε βίη καὶ κέρδεα δειλὰ καὶ ὕβρις	- -- u u- - -uu -u u --	dactylic hexameter	masculine penthemimeral, trithemimeral
πολλῶν ἐξ ἀγαθῶν ἐς κακότητ᾽ ἔβαλεν.	-- - uu- - uu- uu-	dactylic pentameter	
δισσαί τοι πόσιος κῆρες δειλοῖσι βροτοῖσιν,	-- - uu- -- --u u--	dactylic hexameter	masculine penthemimeral, hepthemimeral, trithemimeral
δίψα τε λυσιμελὴς καὶ μέθυσις χαλεπή·	-u u -uu- - uu- uu-	dactylic pentameter	
τούτων δ᾽ἂν τὸ μέσον στρωφήσομαι, οὐδέ με πείσεις	-- - u u- --uu -u u --	dactylic hexameter	masculine penthemimeral, trithemimeral
οὔτε τι μὴ πίνειν οὔτε λίην μεθύειν.	-u u - -- -u u- uu-	dactylic pentameter	
οἶνος ἐμοὶ τὰ μὲν ἄλλα χαρίζεται, ἓν δ᾽ἀχάριστος,	-u u- u u -u u-uu - uu--	dactylic hexameter	feminine penthemimeral, trithemimeral
εὖτ᾽ ἂν θωρήξας μ᾽ἄνδρα πρὸς ἐχθρὸν ἄγῃ·	- - --- -u u -u u-	dactylic pentameter	
ἀλλ᾽ ὅτε τἀγκαθύπερθεν ἐόνθ᾽ ὑπένερθε γένηται,	- uu -uu-u u- uu-u u--	dactylic hexameter	feminine penthemimeral, hepthemimeral
τουτάκις οἴκαδ᾽ ἴμεν παυσάμενοι πόσιος.	-uu -u u- -uu- uu-	dactylic pentameter	
εὖ μὲν κείμενον ἄστυ κακῶς θέμεν εὐμαρές ἐστιν,	- - -uu -u u- uu -uu --	dactylic hexameter	feminine penthemimeral, hepthemimeral
εὖ δὲ θέμεν τὸ κακῶς κείμενον ἀργαλέον.	- u u- u u- -uu -uu-	dactylic pentameter	
λὰξ ἐπίβα δήμῳ κενεόφρονι, τύπτε δὲ κέντρῳ	- uu- -- uu-uu -u u --	dactylic hexameter	masculine penthemimeral, trithemimeral
ὀξέϊ, καὶ ζεύγλην δύσλοφον ἀμφιτίθει·	-uu - -- -uu -uu-	dactylic pentameter	
οὐ γὰρ ἔθ᾽ εὑρήσεις δῆμον φιλοδέσποτον ὧδε	- u u --- -- uu-uu --	dactylic hexameter	masculine penthemimeral, hepthemimeral
ἀνθρώπων ὁπόσους ἠέλιος καθορᾷ.	--- uu- -uu- uu-	dactylic pentameter	
Ζεὺς ἄνδρ᾽ ἐξολέσειεν Ὀλύμπιος, ὃς τὸν ἑταῖρον	- - -uu-u u-uu - u u--	dactylic hexameter	feminine penthemimeral
μαλθακὰ κωτίλλων ἐξαπατᾶν ἐθέλει.	-uu --- -uu- uu-	dactylic pentameter	
Ἥδεα μὲν καὶ πρόσθεν, ἀτὰρ πολὺ λώϊα δὴ νῦν,	-uu - - -u u- uu -uu - -	dactylic hexameter	feminine penthemimeral, hepthemimeral, trithemimeral
οὕνεκα τοῖς δειλοῖς οὐδεμί᾽ ἐστὶ χάρις.	-uu - -- -uu -u u-	dactylic pentameter	
†πολλάκι δὴ πόλις ἥδε δί᾽ ἡγεμόνων κακότητα	-uu - uu -u u -uu- uu--	dactylic hexameter	feminine penthemimeral, trithemimeral
ὥσπερ κεκλιμένη ναῦς παρὰ γῆν ἔδραμεν.	-- -uu- - uu - uu-	dactylic pentameter	
τῶν δὲ φίλων εἰ μέν τις ὁρᾷ μέ τι δειλὸν ἔχοντα,	- u u- - - u u- u u -u u--	dactylic hexameter	masculine penthemimeral, hepthemimeral, trithemimeral
αὐχέν᾽ ἀποστρέψας οὐδ᾽ ἐσορᾶν ἐθέλει·	-u u--- - uu- uu-	dactylic pentameter	
ἢν δέ τί μοί ποθεν ἐσθλόν, ἃ παυράκι γίνεται ἀνδρί,	- u u - uu -u u -uu -uu --	dactylic hexameter	feminine penthemimeral, trithemimeral
πολλοὺς ἀσπασμοὺς καὶ φιλότητας ἔχω.	-- --- - uu-u u-	dactylic pentameter	
οἵ με φίλοι προδιδοῦσι καὶ οὐκ ἐθέλουσί τι δοῦναι	- u u- uu-u u - uu-u u --	dactylic hexameter	feminine penthemimeral, hepthemimeral, trithemimeral
ἀνδρῶν φαινομένων· ἀλλ᾽ ἐγὼ αὐτομάτη	-- -uu- - uu -uu-	dactylic pentameter	
ἑσπεριή τ᾽ἔξειμι καὶ ὀρθρίη αὖτις ἔσειμι,	-uu- --u u -uu -u u--	dactylic hexameter	feminine penthemimeral, trithemimeral
ἦμος ἀλεκτρυόνων φθόγγος ἐγειρομένων.	-u u-uu- -u u-uu-	dactylic pentameter	
πολλοῖς ἀχρήστοισι θεὸς διδοῖ ἀνδράσιν ὄλβον,	-- ---u u- uu -uu --	dactylic hexameter	feminine penthemimeral, hepthemimeral
ὅστις μήτ᾽ αὐτῷ βέλτερος οὐδὲν ἐὼν	-- - -- -uu -u u-	dactylic pentameter	
μήτε φίλοις. ἀρετῆς δὲ μέγα κλέος οὔποτ᾽ ὀλεῖται·	-u u- uu- u u- uu -u u--	dactylic hexameter	masculine penthemimeral, hepthemimeral, trithemimeral
αἰχμητὴς γὰρ ἀνὴρ γῆν τε καὶ ἄστυ σαοῖ.	--- u u- - u u -u u-	dactylic pentameter	
ἔν μοι ἔπειτα πέσοι μέγας οὐρανὸς εὐρὺς ὕπερθεν	- u u-u u- uu -uu -u u--	dactylic hexameter	masculine penthemimeral
χάλκεος, ἀνθρώπων δεῖμα χαμαιγενέων,	-uu --- -u u-uu-	dactylic pentameter	
εἰ μὴ ἐγὼ τοῖσιν μὲν ἐπαρκέσω οἵ με φιλεῦσι,	- u u- -- u u-uu - u u--	dactylic hexameter	masculine penthemimeral, trithemimeral
τοῖς δ᾽ἐχθροῖς ἀνίη καὶ μέγα πῆμ᾽ ἔσομαι.	- -- uu- - uu - uu-	dactylic pentameter	
Οἶνε, τὰ μέν σ᾽αἰνῶ, τὰ δὲ μέμφομαι· οὐδέ σε πάμπαν	-u u - -- u u -uu -u u --	dactylic hexameter	masculine penthemimeral, trithemimeral
οὔτε ποτ᾽ ἐχθαίρειν οὔτε φιλεῖν δύναμαι.	-u u --- -u u- uu-	dactylic pentameter	
ἐσθλὸν καὶ κακόν ἐσσι· τίς ἄν σέ γε μωμήσαιτο,	-- - uu -u u - u u ----	dactylic hexameter	feminine penthemimeral, hepthemimeral, trithemimeral
τίς δ᾽ἂν ἐπαινήσαι, μέτρον ἔχων σοφίης;	- u u--- -u u- uu-	dactylic pentameter	
Ἥβα μοι, φίλε θυμέ· τάχ᾽ αὖ τινες ἄλλοι ἔσονται	-- - uu -u u - uu -u u--	dactylic hexameter	feminine penthemimeral, hepthemimeral, trithemimeral
ἄνδρες, ἐγὼ δὲ θανὼν γαῖα μέλαιν᾽ ἔσομαι.	-u u- u u- -u u- uu-	dactylic pentameter	
†πῖν᾽ οἶνον, τὸν ἐμοὶ κορυφῇς ὕπο Τηϋγέτοιο	- -- u u- uu- uu -uu--	dactylic hexameter	masculine penthemimeral, hepthemimeral, trithemimeral
ἄμπελοι ἤνεγκαν, τὰς ἐφύτευσ᾽ ὁ γέρων	-uu --- - uu- u u-	dactylic pentameter	
οὔρεος ἐν βήσσῃσι θεοῖσι φίλος Θεότιμος	-uu - --u u-u u- uu--	dactylic hexameter	feminine penthemimeral, trithemimeral
ἐκ Πλατανιστοῦντος ψυχρὸν ὕδωρ ἐπάγων·	- uu--- -u u- uu-	dactylic pentameter	
τοῦ πίνων ἀπὸ μὲν χαλεπὰς σκεδάσεις μελεδώνας,	- -- uu - uu- uu- uu--	dactylic hexameter	masculine penthemimeral, hepthemimeral, trithemimeral
θωρηχθεὶς δ᾽ἔσεαι πολλὸν ἐλαφρότερος.	--- uu- -u u-uu-	dactylic pentameter	
εἰρήνη καὶ Πλοῦτος ἔχοι πόλιν, ὄφρα μετ᾽ ἄλλων	--- - -u u- uu -u u --	dactylic hexameter	feminine penthemimeral, hepthemimeral, trithemimeral
κωμάζοιμι· κακοῦ δ᾽οὐκ ἔραμαι πολέμου.	---u u- - uu- uu-	dactylic pentameter	
μηδὲ λίην κήρυκος ἀν᾽ οὖς ἔχε μακρὰ βοῶντος·	-u u- --u u - uu -u u--	dactylic hexameter	feminine penthemimeral, hepthemimeral, trithemimeral
οὐ γὰρ πατρῴας γῆς πέρι μαρνάμεθα.	- - --- - uu -uu-	dactylic pentameter	
ἀλλ᾽ αἰσχρὸν παρεόντα καὶ ὠκυπόδων ἐπιβάντα	- -- uu-u u -uu- uu--	dactylic hexameter	feminine penthemimeral, trithemimeral
ἵππων μὴ πόλεμον δακρυόεντ᾽ ἐσιδεῖν.	-- - uu- -uu- uu-	dactylic pentameter	
οἴ μοι ἀναλκείης· ἀπὸ μὲν Κήρινθος ὄλωλεν,	- u u--- uu - --u u--	dactylic hexameter	masculine penthemimeral, hepthemimeral
Ληλάντου δ᾽ἀγαθὸν κείρεται οἰνόπεδον·	--- uu- -uu -uu-	dactylic pentameter	
οἱ δ᾽ἀγαθοὶ φεύγουσι, πόλιν δὲ κακοὶ διέπουσιν.	- uu- --u u- u u- uu--	dactylic hexameter	feminine penthemimeral, hepthemimeral, trithemimeral
ὡς δὴ Κυψελιδέων Ζεὺς ὀλέσειε γένος.	- - -uu- - uu-u u-	dactylic pentameter	
γνώμης δ᾽οὐδὲν ἄμεινον ἀνὴρ ἔχει αὐτὸς ἐν αὐτῷ	-- -u u-u u- uu -u u --	dactylic hexameter	feminine penthemimeral, hepthemimeral
οὐδ᾽ ἀγνωμοσύνης, Κύρν᾽, ὀδυνηρότερον.	- --uu- - uu-uu-	dactylic pentameter	
Ζεὺς εἰ πάντ᾽ ἄνδρεσσι καταθνητοῖς χαλέπαινεν,	- - - --u u--- uu--	dactylic hexameter	feminine penthemimeral, trithemimeral
γινῴσκων καὶ νοῦν οἷον ἕκαστος ἔχει	--- - - -u u-u u-	dactylic pentameter	
αὐτὸς ἐνὶ στήθεσσι καὶ ἔργματα τῶν τε δικαίων	-u u- --u u -uu - u u--	dactylic hexameter	feminine penthemimeral, trithemimeral
τῶν τ᾽ἀδίκων, μέγα κεν πῆμα βροτοῖσιν ἐπῆν.	- uu- uu - -u u-u u-	dactylic pentameter	
ἔστιν ὁ μὲν χείρων ὁ δ᾽ἀμείνων ἔργον ἕκαστον·	-u u - -- u u-- -u u--	dactylic hexameter	masculine penthemimeral, trithemimeral
οὐδεὶς δ᾽ἀνθρώπων αὐτὸς ἅπαντα σοφός.	-- --- -u u-u u-	dactylic pentameter	
†ὅστις ἀνάλωσιν τηρεῖ κατὰ χρήματα θηκῶν,	-u u--- -- uu -uu --	dactylic hexameter	masculine penthemimeral, hepthemimeral
κυδίστην ἀρετὴν τοῖς συνιεῖσιν ἔχει.	--- uu- - uu-u u-	dactylic pentameter	
εἰ μὲν γὰρ κατιδεῖν βιότου τέλος ἦν, ὁπόσον τις	- - - uu- uu- uu - uu- -	dactylic hexameter	masculine penthemimeral, hepthemimeral, trithemimeral
ἤμελλ᾽ ἐκτελέσας εἰς Ἀΐδαο περᾶν,	-- -uu- - uu-u u-	dactylic pentameter	
εἰκὸς ἂν ἦν, ὃς μὲν πλείω χρόνον αἶσαν ἔμιμνε,	-u u - - - -- uu -u u--	dactylic hexameter	masculine penthemimeral, hepthemimeral, trithemimeral
φείδεσθαι μᾶλλον τοῦτον, ἵν᾽ εἶχε βίον·	--- -- -u u -u u-	dactylic pentameter	
νῦν δ᾽οὐκ ἔστιν. ὃ δὴ καὶ ἐμοὶ μέγα πένθος ὄρωρεν,	- - -u u - u u- uu -u u--	dactylic hexameter	masculine penthemimeral, hepthemimeral
καὶ δάκνομαι ψυχήν, καὶ δίχα θυμὸν ἔχω.	- uu- -- - uu -u u-	dactylic pentameter	
ἐν τριόδῳ δ᾽ἕστηκα· δὔ εἰσὶ πρόσθεν ὁδοί μοι·	- uu- --u u -- -u u- -	dactylic hexameter	feminine penthemimeral, trithemimeral
φροντίζω τούτων ἥντιν᾽ ἴω πρότερην·	--- -- -u u- uu-	dactylic pentameter	
ἢ μηδὲν δαπανῶν τρύχω βίον ἐν κακότητι,	- -- uu- -- uu - uu--	dactylic hexameter	masculine penthemimeral, hepthemimeral, trithemimeral
ἢ ζώω τερπνῶς ἔργα τελῶν ὀλίγα.	- -- -- -u u- uu-	dactylic pentameter	
εἶδον μὲν γὰρ ἔγωγ᾽, ὃς ἐφείδετο, κοὔποτε γαστρὶ	-- - u u- u u-uu -uu --	dactylic hexameter	masculine penthemimeral, trithemimeral
σῖτον ἐλευθέριον πλούσιος ὢν ἐδίδου,	-u u-uu- -uu - uu-	dactylic pentameter	
ἀλλὰ πρὶν ἐκτελέσαι κατέβη δόμον Ἄϊδος εἴσω,	-u u -uu- uu- uu -uu --	dactylic hexameter	masculine penthemimeral, hepthemimeral
χρήματα δ᾽ἀνθρώπων οὑπιτυχὼν ἔλαβεν·	-uu --- -uu- uu-	dactylic pentameter	
ὥστ᾽ ἐς ἄκαιρα πονεῖν καὶ μὴ δόμεν ᾧ κε θέλῃσι.	- u u-u u- - - uu - u u--	dactylic hexameter	masculine penthemimeral, hepthemimeral
εἶδον δ᾽ἄλλον, ὃς ᾗ γαστρὶ χαριζόμενος	-- -u u - -u u-uu-	dactylic pentameter	
χρήματα μὲν διέτριψεν, ἔφη δ᾽Ὑπάγω φρένα τέρψας·	-uu - uu-u u- uu- uu --	dactylic hexameter	feminine penthemimeral, hepthemimeral, trithemimeral
πτωχεύει δὲ φίλους πάντας, ὅπου τιν᾽ ἴδῃ.	--- u u- -u u- u u-	dactylic pentameter	
οὕτω, Δημόκλεις, κατὰ χρήματ᾽ ἄριστον ἁπάντων	-- --- uu -u u-u u--	dactylic hexameter	masculine penthemimeral
τὴν δαπάνην θέσθαι καὶ μελέτην ἐχέμεν.	- uu- -- - uu- uu-	dactylic pentameter	
οὔτε γὰρ ἂν προκαμὼν ἄλλῳ καμάτου μεταδοίης,	-u u - uu- -- uu- uu--	dactylic hexameter	masculine penthemimeral, hepthemimeral, trithemimeral
οὔτ᾽ ἂν πτωχεύων δουλοσύνην τελέοις·	- - --- -uu- uu-	dactylic pentameter	
οὐδ᾽, εἰ γῆρας ἵκοιο, τὰ χρήματα πάντ᾽ ἀποδραίη.	- - -u u-u u -uu - uu--	dactylic hexameter	feminine penthemimeral
ἐν δὲ τοιῷδε γένει χρήματ᾽ ἄριστον ἔχειν·	- u u-u u- -u u-u u-	dactylic pentameter	
ἢν μὲν γὰρ πλουτῇς, πολλοὶ φίλοι, ἢν δὲ πένηαι,	- - - -- -- uu - u u--	dactylic hexameter	masculine penthemimeral, hepthemimeral, trithemimeral
παῦροι, κοὐκέθ᾽ ὁμῶς αὐτὸς ἀνὴρ ἀγαθός.	-- -u u- -u u- uu-	dactylic pentameter	
φείδεσθαι μὲν ἄμεινον, ἐπ(εὶ) οὐδὲ θανὀντ᾽ ἀποκλαίει	--- u u-u u -u u- uu--	dactylic hexameter	feminine penthemimeral, trithemimeral
οὐδείς, ἢν μὴ ὁρᾷ χρήματα λειπόμενα.	-- - u u- -uu -uu-	dactylic pentameter	
παύροις ἀνθρώπων ἀρετὴ καὶ κάλλος ὀπηδεῖ·	-- --- uu- - -u u--	dactylic hexameter	masculine penthemimeral, hepthemimeral
ὄλβιος, ὃς τούτων ἀμφοτέρων ἔλαχεν.	-uu - -- -uu- uu-	dactylic pentameter	
πάντες μιν τιμῶσιν· ὁμῶς νέοι οἵ τε κατ᾽ αὐτὸν	-- - --u u- uu - u u --	dactylic hexameter	feminine penthemimeral, hepthemimeral, trithemimeral
χώρης εἴκουσιν τοί τε παλαιότεροι·	-- --- - u u-uu-	dactylic pentameter	
γηράσκων δ᾽ἀστοῖσι μεταπρέπει, οὐδέ τις αὐτὸν	--- --u u-uu -u u --	dactylic hexameter	feminine penthemimeral, trithemimeral
βλάπτειν οὔτ᾽ αἰδοῦς οὔτε δίκης ἐθέλει.	-- - -- -u u- uu-	dactylic pentameter	
οὐ δύναμαι φωνῇ λίγ᾽ ἀειδέμεν ὥσπερ ἀηδών·	- uu- -- u u-uu -u u--	dactylic hexameter	masculine penthemimeral, trithemimeral
καὶ γὰρ τὴν προτέρην νύκτ᾽ ἐπὶ κῶμον ἔβην.	- - - uu- - uu -u u-	dactylic pentameter	
οὐδὲ τὸν αὐλητὴν προφασίζομαι· ἀλλά με γῆρυς	-u u --- uu-uu -u u --	dactylic hexameter	masculine penthemimeral
ἐκλείπει σοφίης οὐκ ἐπιδευόμενον.	--- uu- - uu-uu-	dactylic pentameter	
ἐγγύθεν αὐλητῆρος ἀείσομαι ὧδε καταστὰς	-uu ---u u-uu -u u--	dactylic hexameter	feminine penthemimeral
δεξιός, ἀθανάτοις θεοῖσιν ἐπευχόμενος.	-uu -uu- -u u-uu-	dactylic pentameter	
εἶμι παρὰ στάθμην ὀρθὴν ὁδόν, οὐδετέρωσε	-u u- -- -- uu -uu--	dactylic hexameter	masculine penthemimeral, hepthemimeral, trithemimeral
κλινόμενος· χρὴ γάρ μ᾽ἄρτια πάντα νοεῖν.	-uu- - - -uu -u u-	dactylic pentameter	
πατρίδα κοσμήσω, λιπαρὴν πόλιν, οὔτ᾽ ἐπὶ δήμῳ	-uu --- uu- uu - uu --	dactylic hexameter	masculine penthemimeral, hepthemimeral
τρέψας οὔτ᾽ ἀδίκοις ἀνδράσι πειθόμενος.	-- - uu- -uu -uu-	dactylic pentameter	
νεβρὸν ὑπὲξ ἐλάφοιο λέων ὣς ἀλκὶ πεποιθὼς	-u u- uu-u u- - -u u--	dactylic hexameter	feminine penthemimeral, hepthemimeral, trithemimeral
ποσσὶ καταιμάρψας αἵματος οὐκ ἔπιον·	-u u--- -uu - uu-	dactylic pentameter	
τειχέων δ᾽ὑψηλῶν ἐπιβὰς πόλιν οὐκ ἀλάπαξα·	-- --- uu- uu - uu--	dactylic hexameter	masculine penthemimeral, hepthemimeral
ζευξάμενος δ᾽ἵππους ἅρματος οὐκ ἐπέβην·	-uu- -- -uu - uu-	dactylic pentameter	
πρήξας δ᾽οὐκ ἔπρηξα, καὶ οὐκ ἐτέλεσσα τελέσσας,	-- - --u u - uu-u u--	dactylic hexameter	feminine penthemimeral, hepthemimeral, trithemimeral
δρήσας δ᾽οὐκ ἔδρησ᾽, ἤνυσα δ᾽οὐκ ἀνύσας.	-- - -- -uu - uu-	dactylic pentameter	
δειλοὺς εὖ ἕρδοντι δύω κακά· τῶν τε γὰρ αὐτοῦ	-- - --u u- uu - u u --	dactylic hexameter	feminine penthemimeral, hepthemimeral, trithemimeral
χήρευσε κτεάνων, καὶ χάρις οὐδεμία.	--- uu- - uu -uu-	dactylic pentameter	
εἴ τι παθὼν ἀπ᾽ ἐμεῦ ἀγαθὸν μέγα μὴ χάριν οἶδας,	- u u- u u- uu- uu - uu --	dactylic hexameter	masculine penthemimeral, hepthemimeral, trithemimeral
χρῄζων ἡμετέρους αὖτις ἵκοιο δόμους.	-- -uu- -u u-u u-	dactylic pentameter	
ἔστε μὲν αὐτὸς ἔπινον ἀπὸ κρήνης μελανύδρου,	-u u -u u-u u- -- uu--	dactylic hexameter	feminine penthemimeral, hepthemimeral
ἡδύ τέ μοί τι δόκει καὶ καλὸν εἶμεν ὕδωρ·	-u u - u u- - uu -u u-	dactylic pentameter	
νῦν δ᾽ἤδη τεθόλωται, ὕδωρ δ᾽ἀναμίσγεται ὕλῃ·	- -- uu-u u- uu-uu --	dactylic hexameter	feminine penthemimeral, hepthemimeral, trithemimeral
ἄλλης δὴ κρήνης πίομαι ἡδυπότου.	-- - -- -uu -uu-	dactylic pentameter	
†μήποτ᾽ ἐπαινήσῃς πρὶν ἂν εἰδῇς ἄνδρα σαφηνέως,	-u u--- u u -- -u u--	dactylic hexameter	masculine penthemimeral
ὀργὴν καὶ θυμὸν καὶ τρόπον ὅντιν᾽ ἔχει.	-- - -- - uu -u u-	dactylic pentameter	
πολλοί τοι κίβδηλον ἐπίκλοπον ἦθος ἔχοντες	-- - --u u-uu -u u--	dactylic hexameter	feminine penthemimeral, trithemimeral
κρύπτουσ᾽, ἐνθέμενοι ῥυθμὸν ἐφημέριον·	-- -uu- -u u-uu-	dactylic pentameter	
τούτων δ᾽ἐκφαίνει πάντων χρόνος ἦθος ἑκάστου.	-- --- -- uu -u u--	dactylic hexameter	masculine penthemimeral, hepthemimeral
καὶ γὰρ ἐγὼ γνώμης πολλὸν ἄρ᾽ ἐκτὸς ἔβην·	- u u- -- -u u -u u-	dactylic pentameter	
ἔφθην δ᾽αἰνήσας πρίν σου κατὰ πάντα δαῆναι	-- --- - - uu -u u--	dactylic hexameter	masculine penthemimeral, hepthemimeral
ἤθεα· νῦν δ᾽ἤδη νηῦς ἅθ᾽ ἑκὰς διέχω.	-uu - -- - u u- uu-	dactylic pentameter	
τίς δ᾽ἀρετὴ πίνοντ᾽ ἐπιοίνιον ἆθλον ἑλέσθαι;	- uu- -- uu-uu -u u--	dactylic hexameter	masculine penthemimeral, trithemimeral
πολλάκι τοι νικᾷ καὶ κακὸς ἄνδρ᾽ ἀγαθόν.	-uu - -- - uu - uu-	dactylic pentameter	
†οὐδεὶς ἀνθρώπων, ὅτε πρῶτ᾽ ἐπὶ γαῖα καλύψῃ	-- --- uu - uu -u u--	dactylic hexameter	masculine penthemimeral, hepthemimeral
εἴς τ᾽Ἔρεβος καταβῇ δώματα Περσεφόνης,	- uu- uu- -uu -uu-	dactylic pentameter	
τέρπεται οὔτε λύρης οὔτ᾽ αὐλητῆρος ἀκούων,	-uu -u u- - ---u u--	dactylic hexameter	masculine penthemimeral
οὔτε Διωνύσου δῶρ᾽ ἔτ᾽ ἀειρόμενος.	-u u--- - u u-uu-	dactylic pentameter	
ταῦτ᾽ ἐσορῶν κραδίην εὖ πείσομαι, ὄφρα τ᾽ἐλαφρὰ	- uu- uu- - -uu -u u--	dactylic hexameter	masculine penthemimeral, trithemimeral
γούνατα καὶ κεφαλὴν ἀτρεμέως προφέρω.	-uu - uu- -uu- uu-	dactylic pentameter	
μή μοι ἀνὴρ εἴη γλώσσῃ φίλος, ἀλλὰ καὶ ἔργῳ·	- u u- -- -- uu -u u --	dactylic hexameter	masculine penthemimeral, hepthemimeral, trithemimeral
χερσίν τε σπεύδοι χρήμασί τ᾽ἀμφότερα.	-- - -- -uu -uu-	dactylic pentameter	
μηδὲ παρὰ κρητῆρι λόγοισιν ἐμὴν φρένα θέλγοι,	-u u- --u u-u u- uu --	dactylic hexameter	feminine penthemimeral, trithemimeral
ἀλλ᾽ ἕρδων φαίνοιτ᾽, εἴ τι δύναιτ᾽, ἀγαθός.	- -- -- - u u- uu-	dactylic pentameter	
ἡμεῖς δ᾽ἐν θαλίῃσι φίλον καταθώμεθα θυμόν,	-- - uu-u u- uu-uu --	dactylic hexameter	feminine penthemimeral, hepthemimeral, trithemimeral
ὄφρα τι τερπωλῆς ἔργ᾽ ἐρατεινὰ φέρῃ.	-u u --- - uu-u u-	dactylic pentameter	
αἶψα γὰρ ὥστε νόημα παρέρχεται ἀγλαὸς ἥβη·	-u u -u u-u u-uu -uu --	dactylic hexameter	feminine penthemimeral
οὐδ᾽ ἵππων ὁρμὴ γίνεται ὠκυτέρη,	- -- -- -uu -uu-	dactylic pentameter	
αἵτε ἄνακτα φέρουσι δορυσσόον ἐς πόνον ἀνδρῶν	-u u-u u-u u-uu - uu --	dactylic hexameter	feminine penthemimeral
λάβρως πυροφόρῳ τερπόμεναι πεδίῳ.	-- -uu- -uu- uu-	dactylic pentameter	
πῖν᾽ ὁπόταν πίνωσιν· ὅταν δέ τι θυμὸν ἀσηθῇς,	- uu- --u u- u u -u u--	dactylic hexameter	feminine penthemimeral, hepthemimeral, trithemimeral
μηδεὶς ἀνθρώπων γνῷ σε βαρυνόμενον.	-- --- - u u-uu-	dactylic pentameter	
ἄλλοτέ τοι πάσχων ἀνιήσεαι, ἄλλοτε δ᾽ἕρδων	-uu - -- uu-uu -uu --	dactylic hexameter	masculine penthemimeral, trithemimeral
χαιρήσεις· δύναται δ᾽ἄλλοτε ἄλλος ἀνήρ.	--- uu- -uu -u u-	dactylic pentameter	
εἰ θείης, Ἀκάδημε, μ᾽ἐφίμερον ὕμνον ἀείδειν,	- -- uu-u u-uu -u u--	dactylic hexameter	feminine penthemimeral, trithemimeral
ἆθλον δ᾽ἐν μέσσῳ παῖς καλὸν ἄνθος ἔχων	-- - -- - uu -u u-	dactylic pentameter	
σοί τ᾽εἴη καὶ ἐμοὶ σοφίης πέρι δηρισάντοιν,	- -- u u- uu- uu ----	dactylic hexameter	masculine penthemimeral, hepthemimeral, trithemimeral
γνοίης χ᾽ὅσσον ὄνων κρέσσονες ἡμίονοι.	-- -u u- -uu -uu-	dactylic pentameter	
τῆμος δ᾽ἠέλιος μὲν ἐν αἰθέρι μώνυχας ἵππους	-- -uu- u u -uu -uu --	dactylic hexameter	masculine penthemimeral
ἄρτι παραλλάσσοι μέσσατον ἦμαρ ἐλῶν,	-u u--- -uu -u u-	dactylic pentameter	
δείπνου δηὖτ᾽ ἀλέγοιμεν ὅσου τινὰ θυμὸς ἀνώγοι,	-- - uu-u u- uu -u u--	dactylic hexameter	feminine penthemimeral, hepthemimeral, trithemimeral
παντοίων ἀγαθῶν γαστρὶ χαριζόμενοι,	--- uu- -u u-uu-	dactylic pentameter	
χέρνιβα δ᾽αἶψα θύραζε φέροι στεφανώματα δ᾽ἕσσαι	-uu -u u-u u- uu-uu --	dactylic hexameter	feminine penthemimeral, hepthemimeral
εὐειδὴς ῥαδιναῖς χερσὶ Λάκαινα κόρη.	--- uu- -u u-u u-	dactylic pentameter	
ἥδ᾽ ἀρετή, τόδ᾽ ἄεθλον ἐν ἀνθρώποισιν ἄριστον	- uu- u u-u u ---u u--	dactylic hexameter	feminine penthemimeral, trithemimeral
κάλλιστόν τε φέρειν γίνεται ἀνδρὶ σοφῷ,	--- u u- -uu -u u-	dactylic pentameter	
ξυνὸν δ᾽ἐσθλὸν τοῦτο πόληΐ τε παντί τε δήμῳ,	-- -- -u u-u u -u u --	dactylic hexameter	feminine penthemimeral
ὅστις ἂν εὖ διαβὰς ἐν προμάχοισι μένῃ.	-u u - uu- - uu-u u-	dactylic pentameter	
†ξυνὸν δ᾽ἀνθρώποις ὑποθήσομαι, ὄφρα τις ἡβᾷ	-- --- uu-uu -u u --	dactylic hexameter	masculine penthemimeral
ἀγλαὸν ἄνθος ἔχων καὶ φρεσὶν ἐσθλὰ νοῇ,	-uu -u u- - uu -u u-	dactylic pentameter	
τῶν αὐτοῦ κτεάνων εὖ πάσχεμεν· οὐ γὰρ ἀνηβᾶν	- -- uu- - -uu - u u--	dactylic hexameter	masculine penthemimeral, trithemimeral
δὶς πέλεται πρὸς θεῶν οὐδὲ λύσις θανάτου	- uu- - - -u u- uu-	dactylic pentameter	
θνητοῖς ἀνθρώποισι· καλὸν δ᾽ἐπὶ γῆρας ἐλέγχει	-- ---u u- uu -u u--	dactylic hexameter	feminine penthemimeral, hepthemimeral
οὐλόμενον, κεφαλῆς δ᾽ἅπτεται ἀκροτάτης.	-uu- uu- -uu -uu-	dactylic pentameter	
ἄ μάκαρ εὐδαίμων τε καὶ ὄλβιος, ὅστις ἄπειρος	- uu --- u u -uu -u u--	dactylic hexameter	masculine penthemimeral
ἄθλων εἰς Ἀΐδεω δῶμα μέλαν καταβῇ,	-- - uu- -u u- uu-	dactylic pentameter	
πρίν τ᾽ἐχθροὺς πτῆξαι καὶ ὑπερβῆναί περ ἀνάγκῃ	- -- -- u u--- u u--	dactylic hexameter	masculine penthemimeral, trithemimeral
ἐξετάσαι τε φίλους ὅντιν᾽ ἔχουσι νόον.	-uu- u u- -u u-u u-	dactylic pentameter	
αὐτίκα μοι κατὰ μὲν χροιὴν ῥέει ἄσπετος ἱδρώς,	-uu - uu - -- uu -uu --	dactylic hexameter	masculine penthemimeral, hepthemimeral, trithemimeral
πτοιῶμαι δ᾽ἐσορῶν ἄνθος ὁμηλικίης	--- uu- -u u-uu-	dactylic pentameter	
τερπνὸν ὁμῶς καὶ καλόν, ἐπεὶ πλέον ὤφελεν εἶναι·	-u u- - -u u- uu -uu --	dactylic hexameter	feminine penthemimeral, hepthemimeral, trithemimeral
ἀλλ᾽ ὀλιγοχρόνιος γίνεται ὥσπερ ὄναρ	- uu-uu- -uu -u u-	dactylic pentameter	
ἥβη τιμήεσσα, τὸ δ᾽οὐλόμενον καὶ ἄμορφον	-- ---u u -uu- u u--	dactylic hexameter	feminine penthemimeral
αὐτίχ᾽ ὑπὲρ κεφαλῆς γῆρας ὑπερκρέμαται.	-u u- uu- -u u-uu-	dactylic pentameter	
οὔποτε τοῖς ἐχθροῖσιν ὑπὸ ζυγὸν αὐχένα θήσω	-uu - --u u- uu -uu --	dactylic hexameter	feminine penthemimeral, hepthemimeral, trithemimeral
δύσλοφον, οὐδ᾽ εἴ μοι Τμῶλος ἔπεστι κάρῃ.	-uu - - - -u u-u u-	dactylic pentameter	
δειλοί τοι κακότητι ματαιότεροι νόον εἰσίν,	-- - uu-u u-uu- uu --	dactylic hexameter	feminine penthemimeral, trithemimeral
τῶν δ᾽ἀγαθῶν αἰεὶ πρήξιες ἰθύτεραι.	- uu- -- -uu -uu-	dactylic pentameter	
ῥηϊδίη τοι πρῆξις ἐν ἀνθρώποις κακότητος,	-uu- - -u u --- uu--	dactylic hexameter	feminine penthemimeral, trithemimeral
τοῦ δ᾽ἀγαθοῦ χαλεπή, Κύρνε, πέλει παλάμη.	- uu- uu- -u u- uu-	dactylic pentameter	
τόλμα, θυμέ, κακοῖσιν ὅμως ἄτλητα πεπονθώς·	-- -u u-u u- --u u--	dactylic hexameter	feminine penthemimeral, hepthemimeral
δειλῶν τοι κραδίη γίνεται ὀξυτέρη.	-- - uu- -uu -uu-	dactylic pentameter	
μηδὲ σύ γ᾽ἀπρήκτοισιν ἐπ᾽ ἔργμασιν ἄλγος ἀέξων	-u u ---u u -uu -u u--	dactylic hexameter	feminine penthemimeral
ὄχθει, μηδ᾽ ἄχθευ, μηδὲ φίλους ἀνία,	-- - -- -u u- uu-	dactylic pentameter	
μηδ᾽ ἐχθροὺς εὔφραινε. θεῶν δ᾽εἱμαρμένα δῶρα	- -- --u u- --uu --	dactylic hexameter	feminine penthemimeral, hepthemimeral, trithemimeral
οὐκ ἂν ῥηϊδίως θνητὸς ἀνὴρ προφύγοι,	- - -uu- -u u- uu-	dactylic pentameter	
οὔτ᾽ ἂν πορφυρέης καταδὺς ἐς πυθμένα λίμνης,	- - -uu- uu- - -uu --	dactylic hexameter	masculine penthemimeral, hepthemimeral
οὔθ᾽ ὅταν αὐτὸν ἔχῃ Τάρταρος ἠερόεις.	- uu -u u- -uu -uu-	dactylic pentameter	
ἄνδρα τοί ἐστ᾽ ἀγαθὸν χαλεπώτατον ἐξαπατῆσαι,	-u u - uu- uu-uu -uu--	dactylic hexameter	masculine penthemimeral, trithemimeral
ὡς ἐμοὶ ἐν γνώμῃ, Κύρνε, πάλαι κέκριται.	- uu - -- -u u- uu-	dactylic pentameter	
Ἤιδεα μὲν καὶ πρόσθεν, ἀτὰρ πολὺ λώϊα δὴ νῦν,	-uu - - -u u- uu -uu - -	dactylic hexameter	feminine penthemimeral, hepthemimeral, trithemimeral
οὕνεκα τοῖς δειλοῖς οὐδεμί᾽ ἐστὶ χάρις.	-uu - -- -uu -u u-	dactylic pentameter	
ἄφρονες ἄνθρωποι καὶ νήπιοι, οἵτινες οἶνον	-uu --- - -uu -uu --	dactylic hexameter	masculine penthemimeral
μὴ πίνωσ᾽ ἄστρου Σειρίου ἀρχομένου.	- -- -- -uu -uu-	dactylic pentameter	
δεῦρο σὺν αὐλητῆρι· παρὰ κλαίοντι γελῶντες	-u u ---u u- --u u--	dactylic hexameter	feminine penthemimeral, hepthemimeral
πίνωμεν κείνου κήδεσι τερπόμενοι.	--- -- -uu -uu-	dactylic pentameter	
Εὕδωμεν· φυλακὴ δὲ πόλευς φυλάκεσσι μελήσει	--- uu- u u- uu-u u--	dactylic hexameter	masculine penthemimeral, hepthemimeral, trithemimeral
Ἀστυφέλης ἐρατῆς πατρίδος ἡμετέρης.	-uu- uu- -uu -uu-	dactylic pentameter	
ναὶ μὰ Δἴ, εἴ τις τῶνδε καὶ ἐγκεκαλυμμἑνος εὕδει,	- u u - - -u u -uu-uu --	dactylic hexameter	feminine penthemimeral, trithemimeral
ἡμέτερον κῶμον δέξεται ἁρπαλέως.	-uu- -- -uu -uu-	dactylic pentameter	
νῦν μὲν πίνοντες τερπώμεθα, καλὰ λέγοντες·	- - --- --uu -u u--	dactylic hexameter	masculine penthemimeral
ἅσσα δ᾽ἔπειτ᾽ ἔσται, ταῦτα θεοῖσι μέλει.	-u u- -- -u u-u u-	dactylic pentameter	
†σοὶ δ᾽ἐγὼ οἷά τε παιδὶ πατὴρ ὑποθήσομαι αὐτὸς	- uu -u u -u u- uu-uu --	dactylic hexameter	feminine penthemimeral, hepthemimeral
ἐσθλά· σὺ δ᾽ἐν θυμῷ καὶ φρεσὶ ταῦτα βάλευ.	-u u - -- - uu -u u-	dactylic pentameter	
μήποτ᾽ ἐπειγόμενος πράξῃς κακόν, ἀλλὰ βαθείῃ	-u u-uu- -- uu -u u--	dactylic hexameter	masculine penthemimeral, hepthemimeral
τῇ φρενὶ βούλευσαι σωσιδίκῳ τε νόῳ·	- uu --- -uu- u u-	dactylic pentameter	
τῶν γὰρ μαινομένων πέτεται θυμός τε νόος τε,	- - -uu- uu- -- u u- -	dactylic hexameter	masculine penthemimeral, hepthemimeral
βουλὴ δ᾽εἰς ἀγαθὸν καὶ νόον ἐσθλὸν ἄγει.	-- - uu- - uu -u u-	dactylic pentameter	
ἀλλὰ λόγον μὲν τοῦτον ἐάσομεν, αὐτὰρ ἐμοὶ σὺ	-u u- - -u u-uu -u u- -	dactylic hexameter	feminine penthemimeral, trithemimeral
αὔλει, καὶ Μουσῶν μνησόμεθ᾽ ἀμφότεροι·	-- - -- -uu -uu-	dactylic pentameter	
αὗται γὰρ τάδ᾽ ἔδωκαν ἔχειν κεχαρις μένα δῶρα	-- - u u-u u- uu- uu --	dactylic hexameter	feminine penthemimeral, hepthemimeral, trithemimeral
σοὶ καὶ ἐμοί, συνέμεν δ᾽ἀμφιπερικτίοσιν.	- u u- uu- -uu-uu-	dactylic pentameter	
Τιμαγόρα, πολλῶν ὀργὴν ἀπάτερθεν ὁρῶντι	-uu- -- -- uu-u u--	dactylic hexameter	masculine penthemimeral, hepthemimeral, trithemimeral
γινῴσκειν χαλεπόν, καίπερ ἐόντι σοφῷ·	--- uu- -u u-u u-	dactylic pentameter	
οἱ μὲν γὰρ κακότητα κατακρύψαντες ἔχουσι	- - - uu-u u---u u--	dactylic hexameter	feminine penthemimeral, trithemimeral
πλούτῳ, τοὶ δ᾽ἀρετὴν οὐλομένῃ πενίῃ.	-- - uu- -uu- uu-	dactylic pentameter	
ἐν δ᾽ἥβῃ πάρα μὲν ξὺν ὁμήλικι πάννυχον εὕδειν	- -- uu - u u-uu -uu --	dactylic hexameter	masculine penthemimeral, trithemimeral
ἱμερτῶν ἔργων ἐξ ἔρον ἱέμενον,	--- -- - uu -uu-	dactylic pentameter	
ἔστι δὲ κωμάζοντα μετ᾽ αὐλητῆρος ἀείδειν.	-u u ---u u ---u u--	dactylic hexameter	feminine penthemimeral
οὐδέν τοι τούτων ἄλλ᾽ ἔπι τερπνότερον	-- - -- - uu -uu-	dactylic pentameter	
ἀνδράσιν οὐδὲ γυναιξί. τί μοι πλοῦτός τε καὶ αἰδώς;	-uu -u u-u u - -- u u --	dactylic hexameter	feminine penthemimeral, hepthemimeral
τερπωλὴ νικᾷ πάντα σὺν εὐφροσύνῃ.	--- -- -u u -uu-	dactylic pentameter	
ἄφρονες ἄνθρωποι καὶ νήπιοι, οἵτε θανόντας	-uu --- - -uu -u u--	dactylic hexameter	masculine penthemimeral
κλαίουσ᾽, οὐδ᾽ ἥβης ἄνθος ἀπολλύμενον.	-- - -- -u u-uu-	dactylic pentameter	
τέρπεό μοι, φίλε θυμέ· τάχ᾽ αὖ τινες ἄλλοι ἔσονται	--- - uu -u u - uu -u u--	lyric	
ἄνδρες, ἐγὼ δὲ θανὼν γαῖα μέλαιν᾽ ἔσομαι.	-u u- u u- -u u- uu-	dactylic pentameter	
Κύρνε, φίλους πρὸς πάντας ἐπίστρεφε ποικίλον ἦθος,	-u u- - -u u-uu -uu --	dactylic hexameter	feminine penthemimeral, trithemimeral
συμμίσγων ὀργὴν οἷος ἕκαστος ἔφυ·	--- -- -u u-u u-	dactylic pentameter	
νῦν μὲν τῷδ᾽ ἐφέπευ, τοτὲ δ᾽ἀλλοῖος πέλευ ὀργήν.	- - - uu- uu --- uu --	dactylic hexameter	masculine penthemimeral, trithemimeral
κρεῖσσόν τοι σοφίη καὶ μεγαλῆς ἀρετῆς.	-- - uu- - uu- uu-	dactylic pentameter	
πρήγματος ἀπρήκτου χαλεπώτατόν ἐστι τελευτὴν	-uu --- uu-uu -u u--	dactylic hexameter	masculine penthemimeral
γνῶναι ὅπως μέλλει τοῦτο θεὸς τελέσαι·	-u u- -- -u u- uu-	dactylic pentameter	
ὄρφνη γὰρ τέταται, πρὸ δὲ τοῦ μέλλοντος ἔσεσθαι	-- - uu- u u - --u u--	dactylic hexameter	masculine penthemimeral, hepthemimeral, trithemimeral
οὐ ξυνετὰ θνητοῖς πείρατ᾽ ἀμηχανίης.	- uu- -- -u u-uu-	dactylic pentameter	
οὐδένα τῶν ἐχθρῶν μωμήσομαι ἐσθλὸν ἐόντδ,	-uu - -- --uu -u --	lyric	
οὐδὲ μὲν αἰνήσω δειλὸν ἐόντα φίλον.	-u u --- -u u-u u-	dactylic pentameter	
Κύρνε, κύει πόλις ἥδε, δέδοικα δὲ μὴ τέκῃ ἄνδραβ	-u u- uu -u u-u u - uu --	dactylic hexameter	feminine penthemimeral, trithemimeral
ὑβριστήν, χαλεπῆς ἡγεμόνα στάσιος·	--- uu- -uu- uuu	lyric	
ἀστοὶ μὲν γὰρ ἔασι σαόφρονες, ἡγεμόνες δὲ	-- - u u-- u-uu -uu- -	lyric	
τετράφαται πολλὴν ἐς κακότητα πεσεῖν.	-uu- -- - uu-u u-	dactylic pentameter	
μή μ᾽ἔπεσιν μὲν στέργε, νόον δ᾽ἔχε καὶ φρένας ἄλλῃ,	- uu- - -u u- uu - uu --	dactylic hexameter	feminine penthemimeral, hepthemimeral, trithemimeral
εἴ με φιλεῖς καί σοι πιστὸς ἔνεστι νόος·	- u u- - - -u u-u u-	dactylic pentameter	
ἀλλὰ φίλει καθαρὸν θέμενος νόον ἤ μ᾽ἀποειπὼν	-u u- uu- uu- uu - uu--	dactylic hexameter	masculine penthemimeral, hepthemimeral, trithemimeral
ἔχθαιρ᾽, ἐμφανέως νεῖκος ἀειράμενος.	-- -uu- -u u-uu-	dactylic pentameter	
οὕτω χρὴ τον γ᾽ἐσθλὸν ἐπιστρέψαντα νόημα	-- - - -u u---u u--	dactylic hexameter	feminine penthemimeral, trithemimeral
ἔμπεδον αἰὲν ἔχειν ἐς τέλος ἀνδρὶ φίλῳ.	-uu -u u- - uu -u u-	dactylic pentameter	
Δημῶναξ, σοὶ πολλὰ φέρειν βαρύ· οὐ γὰρ ἐπίστῃ	--- - -u u- uu - u u--	dactylic hexameter	feminine penthemimeral, hepthemimeral, trithemimeral
τοῦθ᾽ ἕρδειν ὅτι σοι μὴ καταθύμιον ᾖ.	- -- uu - - uu-uu -	dactylic pentameter	
Κάστορ καὶ Πολύδευκες, οἳ ἐν Λακεδαίμονι δίῃ	-- - uu-u u - uu-uu --	dactylic hexameter	feminine penthemimeral, hepthemimeral, trithemimeral
ναίετ᾽ ἐπ᾽ Εὐρώτᾳ, καλλιρόῳ ποταμῷ,	-u u --- -uu- uu-	dactylic pentameter	
εἴ ποτε βουλεύσαιμι φίλῳ κακόν, αὐτὸς ἔχοιμι,	- uu ---u u- uu -u u--	dactylic hexameter	feminine penthemimeral, hepthemimeral
εἰ δέ τι κεῖνος ἐμοί, δὶς τόσον αὐτὸς ἔχοι.	- u u -u u- - uu -u u-	dactylic pentameter	
Ἀργαλέως μοι θυμὸς ἔχει περὶ σῆς φιλότητος·	-uu- - -u u- uu - uu--	dactylic hexameter	feminine penthemimeral, hepthemimeral, trithemimeral
οὔτε γὰρ ἐχθαίρειν οὔτε φιλεῖν δύναμαι,	-u u --- -u u- uu-	dactylic pentameter	
γινῴσκων χαλεπὸν μέν, ὅταν φίλος ἀνδρὶ γένηται,	--- uu- u u- uu -u u--	dactylic hexameter	masculine penthemimeral, hepthemimeral, trithemimeral
ἐχθαίρειν, χαλεπὸν δ᾽οὐκ ἐθέλοντα φιλεῖν.	--- uu- - uu-u u-	dactylic pentameter	
σκέπτεο δὴ νῦν ἄλλον· ἐμοί γε μὲν οὔτις ἀνάγκη	-uu - - -u u- u u -u u--	dactylic hexameter	feminine penthemimeral, hepthemimeral, trithemimeral
τοῦθ᾽ ἕρδειν· τῶν μοι πρόσθε χάριν τίθεσο.	- -- - - -u u- uu-	dactylic pentameter	
ἤδη καὶ πτερύγεσσιν ἐπαίρομαι ὥστε πετεινὸν	-- - uu-u u-uu -u u--	dactylic hexameter	feminine penthemimeral, trithemimeral
ἐκ λινέης νεφέλης ἄνδρα κακὸν προφυγών,	- uu- uu- -u u- uu-	dactylic pentameter	
βρόκχον ἀπορρήξας· σὺ δ᾽ἐμῆς φιλότητος ἁμαρτὼν	-u u--- u u- uu-u u--	dactylic hexameter	masculine penthemimeral, hepthemimeral
ὕστερον ἡμετέρην γνώσῃ ἐπιφροσύνην.	-uu -uu- -u u-uu-	dactylic pentameter	
ὅστις σοι βούλευσεν ἐμεῦ πέρι καὶ σ᾽ἐκέλευσεν	-- - --u u- uu - uu--	dactylic hexameter	feminine penthemimeral, hepthemimeral, trithemimeral
οἴχεσθαι προλιπόνθ᾽ ἡμετέρην φιλίην·	--- uu- -uu- uu-	dactylic pentameter	
ὕβρις καὶ Μάγνητας ἀπώλεσε καὶ Κολοφῶνα	-- - --u u-uu - uu--	dactylic hexameter	feminine penthemimeral, trithemimeral
καὶ Σμύρνην· πάντως, Κύρνε, καὶ ὔμμ᾽ ἀπολεῖ.	- -- -- -u u - uu-	dactylic pentameter	
δόξα μὲν ἀνθρώποισι κακὸν μέγα, πεῖρα δ᾽ἄριστον·	-u u ---u u- uu -u u--	dactylic hexameter	feminine penthemimeral, hepthemimeral
πολλοὶ ἀπείρητοι δόξαν ἔχουσ᾽ ἀγαθοί.	-u u--- -u u- uu-	dactylic pentameter	
ἐς βάσανον δ᾽ἐλθὼν παρατριβόμενός τε μολίβδῳ	- uu- -- uu-uu- u u--	dactylic hexameter	masculine penthemimeral, trithemimeral
χρυσὸς ἄπεφθος ἐὼν δῆλος ἅπασιν ἔσῃ.	-u u-u u- -u u-u u-	dactylic pentameter	
ὤ μοι ἐγὼ δειλός· καὶ δὴ κατάχαρμα μὲν ἐχθροῖς	- u u- -- - - uu-u u --	dactylic hexameter	masculine penthemimeral, hepthemimeral, trithemimeral
τοῖς δὲ φίλοισι πόνος δεινὰ παθὼν γενόμην.	- u u-u u- -u u- uu-	dactylic pentameter	
Κύρν᾽, οἱ πρόσθ᾽ ἀγαθοὶ νῦν αὖ κακοί, οἱ δὲ κακοὶ πρὶν	- - - uu- - - uu - u u- -	dactylic hexameter	masculine penthemimeral, hepthemimeral, trithemimeral
νῦν ἀγαθοί. τίς κεν ταῦτ᾽ ἀνέχοιτ᾽ ἐσορῶν,	- uu- - - - uu- uu-	dactylic pentameter	
τοὺς ἀγαθοὺς μὲν ἀτιμοτέρους, κακίους δὲ λαχόντας	- uu- u u-uu- uu- u u--	dactylic hexameter	hepthemimeral, trithemimeral
τιμῆς; μνηστεύει δ᾽ἐκ κακοῦ ἐσθλὸς ἀνήρ·	-- --- - uu -u u-	dactylic pentameter	
ἀλλήλους δ᾽ἀπατῶντες ἐπ᾽ ἀλλήλοισι γελῶσιν,	--- uu-u u ---u u--	dactylic hexameter	feminine penthemimeral, trithemimeral
οὔτ᾽ ἀγαθῶν μνήμην εἰδότες οὔτε κακῶν.	- uu- -- -uu -u u-	dactylic pentameter	
πολλὰ δ᾽ἀμηχανίῃσι κυλίνδομαι ἀχνύμενος κῆρ·	-u u-uu-u u-uu -uu- -	dactylic hexameter	feminine penthemimeral
ἀρχὴν γὰρ πενίης οὐχ ὑπερεδράμομεν.	-- - uu- - uu-uu-	dactylic pentameter	
χρήματ᾽ ἔχων πενίην μ᾽ὠνείδισας· ἀλλὰ τὰ μέν μοι	-u u- uu- --uu -u u - -	dactylic hexameter	masculine penthemimeral, trithemimeral
ἔστι, τὰ δ᾽ἐργάσομαι θεοῖσιν ἐπευξάμενος.	-u u -uu- -u u-uu-	dactylic pentameter	
Πλοῦτε, θεῶν κάλλιστε καὶ ἱμεροέστατε πάντων,	-u u- --u u -uu-uu --	dactylic hexameter	feminine penthemimeral, trithemimeral
σὺν σοὶ καὶ κακὸς ὢν γίνεται ἐσθλὸς ἀνήρ.	- - - uu - -uu -u u-	dactylic pentameter	
ἥβης μέτρον ἔχοιμι, θιλοῖ δέ με Φοῖβος Ἀπόλλων	-- -u u-u u- u u -u u--	dactylic hexameter	feminine penthemimeral, hepthemimeral
Λητοϊδης καὶ Ζεὺς ἀθανάτων βασιλεύς,	-uu- - - -uu- uu-	dactylic pentameter	
ὄφρα δίκῃ ζώοιμι κακῶν ἔκτοσθεν ἁπάντων,	-u u- --u u- --u u--	dactylic hexameter	feminine penthemimeral, hepthemimeral, trithemimeral
ἥβῃ καὶ πλούτῳ θυμὸν ἰαινόμενος.	-- - -- -u u-uu-	dactylic pentameter	
μή με κακῶν μίμνῃσκε· πέπονθά τοι οἷά τ᾽Ὀδυσσεύς,	- u u- --u u-u u -u u--	dactylic hexameter	feminine penthemimeral, trithemimeral
ὅστ᾽ Ἀΐδεω μέγα δῶμ᾽ ἤλυθεν ἐξαναδύς,	- uu- uu - -uu -uu-	dactylic pentameter	
ὃς δὴ καὶ μνηστῆρας ἀνείλετο νηλέϊ θυμῷ	- - - --u u-uu -uu --	dactylic hexameter	feminine penthemimeral, trithemimeral
Πηνελόπης εὔφρων κουριδίης ἀλόχου,	-uu- -- -uu- uu-	dactylic pentameter	
ἥ μιν δήθ᾽ ὑπέμεινε φίλῳ παρὰ παιδὶ μένουσα	- - - uu-u u- uu -u u--	dactylic hexameter	feminine penthemimeral, hepthemimeral, trithemimeral
ὄφρα τε γῆς ἐπέβη δειμαλέους τε μυχούς.	-u u - uu- -uu- u u-	dactylic pentameter	
Ἐμπίομαι πενίης θυμοφθόρου οὐ μελεδαίνων	-uu- uu- --uu - uu--	dactylic hexameter	masculine penthemimeral, trithemimeral
οὐδ᾽ ἀνδρῶν ἐχθρῶν οἵ με λέγουσι κακῶς·	- -- -- - u u-u u-	dactylic pentameter	
ἀλλ᾽ ἥβην ἐρατὴν ὀλοφύρομαι, ἥ μ᾽ἐπιλείπει,	- -- uu- uu-uu - uu--	dactylic hexameter	masculine penthemimeral, trithemimeral
κλαίω δ᾽ἀργαλέον γῆρας ἐπερχόμενον.	-- -uu- -u u-uu-	dactylic pentameter	
Κύρνε, παροῦσι φίλοισι κακοῦ καταπαύσομεν ἀρχήν,	-u u-u u-u u- uu-uu --	dactylic hexameter	feminine penthemimeral, hepthemimeral
ζητῶμεν δ᾽ἕλκει φάρμακα φυομένῳ.	--- -- -uu -uu-	dactylic pentameter	
†ἐλπὶς ἐν ἀνθρώποισι μόνη θεὸς ἐσθλὴ ἔτ᾽ ἐστίν,	-u u ---u u- uu -u u --	dactylic hexameter	feminine penthemimeral, hepthemimeral
ἄλλοι δ᾽Οὔλυμπόνδ᾽ ἐκπρολιπόντες ἔβαν·	-- --- -uu-u u-	dactylic pentameter	
ᾤχετο μὲν Πίστις, μεγάλη θεός, ᾤχετο δ᾽ἀνδρῶν	-uu - -- uu- uu -uu --	dactylic hexameter	masculine penthemimeral, hepthemimeral, trithemimeral
σωφροσύνη, Χάριτές τ᾽,ὦ φίλε, γῆν ἔλιπον.	-uu- uu- - uu - uu-	dactylic pentameter	
ὅρκοι δ᾽οὐκέτι πιστοὶ ἐν ἀνθρώποισι δίκαιοι,	-- -uu -u u ---u u--	dactylic hexameter	feminine penthemimeral
οὐδὲ θεοὺς οὐδεὶς ἅζεται ἀθανάτους·	-u u- -- -uu -uu-	dactylic pentameter	
εὐσεβέων δ᾽ἀνδρῶν γένος ἔφθιται, οὐδὲ θέμιστας	-uu- -- uu -uu -u u--	dactylic hexameter	masculine penthemimeral, trithemimeral
οὐκέτι γινῴσκουσ᾽ οὐδὲ μὲν εὐνομίας.	-uu --- -u u -uu-	dactylic pentameter	
ἀλλ᾽ ὄφρα τις ζώῃ καὶ ὁρᾷ φάος ἠελίοιο	- uu - -- u u- uu -uu--	dactylic hexameter	masculine penthemimeral, hepthemimeral, trithemimeral
εὐσεβέων περὶ θεοὺς Ἐλπίδα προσσεβέτω·	-uu- uu - -uu -uu-	dactylic pentameter	
εὐχέσθω δὲ θεοῖσι κατ᾽ ἀγλαὰ μηρία καίων	--- u u-u u -uu -uu --	dactylic hexameter	feminine penthemimeral, trithemimeral
ἐλπίδι τε πρώτῃ καὶ πυμάτῃ θυέτω.	-uu - -- - uu- uu-	dactylic pentameter	
φραζέσθω δ᾽ἀδίκων ἀνδρῶν σκολιὸν λόγον αἰεί,	--- uu- -- uu- uu --	dactylic hexameter	masculine penthemimeral, hepthemimeral, trithemimeral
οἳ θεῶν ἀθανάτων οὐδὲν ὀπιζόμενοι	- - -uu- -u u-uu-	dactylic pentameter	
αἰὲν ἐπ᾽ ἀλλοτρίοις κτεάνοις ἐπέχουσι νόημα,	-u u -uu- uu- uu-u u--	dactylic hexameter	masculine penthemimeral, hepthemimeral
αἰσχρὰ κακοῖς ἔργοις σύμβολα θηκάμενοι.	-u u- -- -uu -uu-	dactylic pentameter	
μήποτε τὸν παρεόντα μεθεὶς φίλον ἄλλον ἐρεύνα	-uu - uu-u u- uu -u u--	dactylic hexameter	feminine penthemimeral, hepthemimeral, trithemimeral
δειλῶν ἀνθρώπων ῥήμασι πειθόμενος.	-- --- -uu -uu-	dactylic pentameter	
εἴη μοι πλουτοῦντι κακῶν ἀπάτερθε μεριμνέων	-- - --u u- uu-u u--	dactylic hexameter	feminine penthemimeral, hepthemimeral, trithemimeral
ζώειν ἀβλαβέως μηδὲν ἔχοντι κακόν.	-- -uu- -u u-u u-	dactylic pentameter	
οὐκ ἔραμαι πλουτεῖν οὐδ᾽ εὔχομαι, ἀλλά μοι εἴη	- uu- -- - -uu -u u --	dactylic hexameter	masculine penthemimeral, trithemimeral
ζῆν ἀπὸ τῶν ὀλίγων μηδὲν ἔχοντι κακόν.	- uu - uu- -u u-u u-	dactylic pentameter	
πλοῦτος καὶ σοφίη θνητοῖς ἀμαχώτατον αἰεί·	-- - uu- -- uu-uu --	dactylic hexameter	masculine penthemimeral, hepthemimeral, trithemimeral
οὔτε γὰρ ἂν πλούτου θυμὸν ὑπερκορέσαις,	-u u - -- -u u-uu-	dactylic pentameter	
ὣς δ᾽αὔτως σοφίην ὁ σοφώτατος οὐκ ἀποφεύγε;,	- -- uu- u u-uu - uu--	dactylic hexameter	masculine penthemimeral, trithemimeral
ἀλλ᾽ ἔραται, θυμὸν δ᾽οὐ δύναται τελέσαι.	- uu- -- - uu- uu-	dactylic pentameter	
ὦ νέοι οἷ νῦν ἄνδρες, "ἐμοί γε μεν οὔτις ἀνάγκη	- uu - - -u u- u u -u u--	dactylic hexameter	feminine penthemimeral, hepthemimeral, trithemimeral
ταῦθ᾽ ἕρδειν· τῶν μοι πρόσθε χάριν τίθεσο."	- -- - - -u u- uu-	dactylic pentameter	
οὐδένα θησαυρὸν παισὶν κατανῆσαι ἄμεινον·	-uu --- -- uu-u u--	dactylic hexameter	masculine penthemimeral, hepthemimeral
αἰτοῦσιν δ᾽ἀγαθοῖς ἀνδράσι, Κύρνε, δίδου.	--- uu- -uu -u u-	dactylic pentameter	
"οὐδεὶς γὰρ πάντ᾽ ἐστὶ πανόλβιος· ἀλλ᾽ ὁ μὲν ἐσθλὸς	-- - - -u u-uu - u u --	dactylic hexameter	feminine penthemimeral, trithemimeral
τολμᾷ ἔχων τὸ κακόν, κοὐκ ἐπίδηλον ὅμως·	-u u- u u- - uu-u u-	dactylic pentameter	
δειλὸς δ᾽οὔτ᾽ ἀγαθοῖς τις ἐπίσταται οὔτε κακοῖσι	-- - uu- u u-uu -u u--	dactylic hexameter	masculine penthemimeral, trithemimeral
θυμὸν ὁμῶς μίσγειν. ἀθανάτων τε δόσεις	-u u- -- -uu- u u-	dactylic pentameter	
παντοῖαι θνητοῖσιν ἐπέρχοντ᾽· ἀλλ᾽ ἐπιτολμᾶν	--- --u u-- - uu--	dactylic hexameter	feminine penthemimeral, trithemimeral
χρὴ δῶρ᾽ ἀθανάτων οἷα διδοῦσιν ἔχειν."	- - -uu- -u u-u u-	dactylic pentameter	
ὀφθαλμοὶ καὶ γλῶσσα καὶ οὔατα καὶ νόος ἀνδρὶ	--- - -u u -uu - uu --	dactylic hexameter	feminine penthemimeral, trithemimeral
ἐν μέσσῳ στηθέων εὐξυνέτῳ φύεται.	- -- -- -uu- uu-	dactylic pentameter	
τοιοῦτός τοι ἀνὴρ ἔστω φίλος, ὃς τὸν ἑταῖρον	--- u u- -- uu - u u--	dactylic hexameter	masculine penthemimeral, hepthemimeral, trithemimeral
γινῴσκων ὀργὴν καὶ βαρὺν ὄντα φέρει	--- -- - uu -u u-	dactylic pentameter	
ἀντὶ κασιγνήτου. σὺ δέ μοι, φίλε, τοῦτ᾽ ἐνὶθυμῷ	-u u--- u u - uu - uu--	dactylic hexameter	masculine penthemimeral, hepthemimeral
φράζεο, καί ποτέ μου μνήσεαι ἐξοπίσω.	-uu - uu - -uu -uu-	dactylic pentameter	
οὔτιν᾽ ὁμοῖον ἐμοὶ δύναμαι διζήμενος εὑρεῖν	-u u-u u- uu- --uu --	dactylic hexameter	masculine penthemimeral, hepthemimeral
πιστὸν ἑταῖρον ὅτῳ μή τις ἔνεστι δόλος·	-u u-u u- - u u-u u-	dactylic pentameter	
ἐς βάσανον δ᾽ἐλθὼν παρατριβόμενός τε μολίβδῳ	- uu- -- uu-uu- u u--	dactylic hexameter	masculine penthemimeral, trithemimeral
χρυσός, ὑπερτερίης ἄμμιν ἔνεστι τύπος.	-u u-uu- -u u-u u-	dactylic pentameter	
τοῖς ἀγαθοἷς σύμμισγε, κακοῖσι δὲ μήποθ᾽ ὁμαρτεῖ,	- uu- --u u-u u -u u--	dactylic hexameter	feminine penthemimeral, trithemimeral
εὖτ᾽ ἂν ὁδοῦ τελέῃς τέρματ᾽ ἐπ᾽ ἐμπορίην.	- u u- uu- -u u -uu-	dactylic pentameter	
τῶν ἀγαθῶν ἐσθλὴ μὲν ἀπόκρισις ἐσθλὰ δὲ ἔργα·	- uu- -- u u-uu -u u --	dactylic hexameter	masculine penthemimeral, trithemimeral
τῶν δὲ κακῶν ἄνεμοι δειλὰ φέρουσιν ἔπη.	- u u- uu- -u u-u u-	dactylic pentameter	
ἐκ καχεταιρειης κακὰ γίνεται· εὖ δὲ καὶ αὐτὸς	- uu--- uu -uu - u u --	dactylic hexameter	masculine penthemimeral
γνώσῃ, ἐπεὶ μεγάλους ἤλιτες ἀθανάτους.	-u u- uu- -uu -uu-	dactylic pentameter	
γνώμην, Κύρνε, θεοὶ θνητοῖσι διδοῦσιν ἄριστον	-- -u u- --u u-u u--	dactylic hexameter	masculine penthemimeral
ἀνθρώποις· γνώμη πείρατα παντὸς ἔχει.	--- -- -uu -u u-	dactylic pentameter	
ὢ μάκαρ, ὅστις δή μιν ἔχει φρεσίν· ἦ πολὺ κρέσσων	- uu -- - u u- uu - uu --	dactylic hexameter	masculine penthemimeral, hepthemimeral
ὕβριος οὐλομένης λευγαλέου τε κόρου·	-uu -uu- -uu- u u-	dactylic pentameter	
ἔστι δὲ ταῦτα βροτοῖσι κακῶν τῶν οὔτι κάκιον·	-u u -u u-u u- - -u u--	dactylic hexameter	feminine penthemimeral, hepthemimeral
πᾶσα γὰρ ἐκ τούτων, Κύρνε, πέλει κακότης.	-u u - -- -u u- uu-	dactylic pentameter	
εἴ κ᾽εἴης ἔργων αἰσχρῶν ἀπαθὴς καὶ ἀεργός,	- -- -- -- uu- u u--	dactylic hexameter	masculine penthemimeral, hepthemimeral, trithemimeral
Κύρνε, μέγιστόν κεν πεῖραρ ἔχοις ἀρετῆς.	-u u-- - -u u- uu-	dactylic pentameter	
τολμᾶν χρὴ χαλεποῖσιν ἐν ἄλγεσιν ἦτορ ἔχοντα,	-- - uu-u u -uu -u u--	dactylic hexameter	feminine penthemimeral, trithemimeral
πρὸς δὲ θεῶν αἰτεῖν ἔκλυσιν ἀθανάτων.	- u u- -- -uu -uu-	dactylic pentameter	
Κύρνε, θεοὺς αἰδοῦ καὶ δείδιθι· τοῦτο γὰρ ἄνδρα	-u u- -- - -uu -u u --	dactylic hexameter	masculine penthemimeral, trithemimeral
εἴργει μήθ᾽ ἕρδειν μήτε λέγειν ἀσεβῆ·	-- - -- -u u- uu-	dactylic pentameter	
δημοφάγον δὲ τύραννον, ὅπως ἐθέλῃς, κατακλῖναι	-uu- u u-u u- uu- uu--	dactylic hexameter	feminine penthemimeral, hepthemimeral, trithemimeral
οὐ νέμεσις πρὸς θεῶν γίνεται οὐδεμία.	- uu- - - -uu -uu-	dactylic pentameter	
οὐδένα, Κύρν᾽, αὐγαὶ φαεσιβρότου ἠελίοιο	-uu - -- uu-uu -uu--	dactylic hexameter	masculine penthemimeral, trithemimeral
ἄνδρ᾽ ἐφορῶσ᾽ ᾧ μὴ μῶμος ἐπικρέμαται.	- uu- - - -u u-uu-	dactylic pentameter	
ἀστῶν δ᾽οὐ δύναμαι γνῶναι νόον ὅντιν᾽ ἔχουσιν·	-- - uu- -- uu -u u--	dactylic hexameter	masculine penthemimeral, hepthemimeral, trithemimeral
οὔτε γὰρ εὖ ἕρδων ἁνδάνω οὔτε κακῶς.	-u u - -- -uu -u u-	dactylic pentameter	
νοῦς ἀγαθὸν καὶ γλῶσσ᾽· ἀτὰρ ἐν παύροισι πέφυκεν	- uu- - - uu - --u u--	dactylic hexameter	masculine penthemimeral, hepthemimeral, trithemimeral
ἀνδράσιν οἳ τούτων ἀμφοτέρων ταμίαι.	-uu - -- -uu- uu-	dactylic pentameter	
οὔτις ἄποινα διδοὺς θάνατον φύγοι, οὐδὲ βαρεῖαν	-u u-u u- uu- uu -u u--	dactylic hexameter	masculine penthemimeral, hepthemimeral
δυστυχίην, εἰ μὴ μοῖρ᾽ ἐπὶ τέρμα βάλοι·	-uu- - - - uu -u u-	dactylic pentameter	
οὐδ᾽ ἂν δυσφροσύνης ὅτε δὴ θεὸς ἄλγεα πέμποι,	- - -uu- uu - uu -uu --	dactylic hexameter	masculine penthemimeral, hepthemimeral
θνητὸς ἀνὴρ δώροις ἱλάμενος προφύγοι.	-u u- -- -uu- uu-	dactylic pentameter	
οὐκ ἔραμαι κλισμῷ βασιληΐῳ ἐγκατακεῖσθαι	- uu- -- uu-uu -uu--	dactylic hexameter	masculine penthemimeral, trithemimeral
τεθνέως, ἀλλά τι μοι ζῶντι γένοιτ᾽ ἀγαθόν.	-- -u u - -u u- uu-	dactylic pentameter	
ἀσπάλαθοι δὲ τάπησιν ὁμοῖον στρῶμα θανόντι·	-uu- u u-u u-- -u u--	dactylic hexameter	feminine penthemimeral, trithemimeral
εὔκολος ἢ σκληρῷ κλίνεται ἢ μαλακῷ.	-uu - -- -uu - uu-	dactylic pentameter	
μήτι θεοὺς ἐπίορκον ἐπόμνυθι· οὐ γὰρ ἀνυστὸν	-u u- uu-u u-uu - u u--	dactylic hexameter	feminine penthemimeral, trithemimeral
ἀθανάτους κρύψαι χρεῖος ὀφειλόμενον.	-uu- -- -u u-uu-	dactylic pentameter	
ὄρνιθος φωνήν, Πολυπαίδη, ὀξὺ βοώσης	--- -- uu-- -u u--	dactylic hexameter	masculine penthemimeral, trithemimeral
ἤκουσ᾽, ἥτε βροτοῖς ἄγγελος ἦλθ᾽ ἀρότου	-- -u u- -uu - uu-	dactylic pentameter	
ὡραίου· καί μοι κραδίην ἐπάταξε μέλαιναν	--- - - uu- uu-u u--	dactylic hexameter	masculine penthemimeral, hepthemimeral, trithemimeral
ὅττι μοι εὐανθεῖς ἄλλοι ἔχουσιν ἀγρούς,	-u u --- -u u-u u-	dactylic pentameter	
οὐδ᾽ ἐμοὶ ἡμίονοι κύφων᾽ ἕλκουσιν ἀρότρου,	- uu -uu- -- --u u--	dactylic hexameter	masculine penthemimeral, hepthemimeral
τῆς μάλα μισητῆς εἵνεκα ναυτιλίης.	- uu --- -uu -uu-	dactylic pentameter	
οὐκ εἶμ᾽, οὐδ᾽ ἐπ᾽ ἐμοῦ κεκλαύσεται οὐδ᾽ ἐπὶ τύμβῳ	- - - u u- --uu - uu --	dactylic hexameter	masculine penthemimeral, trithemimeral
οἰμωχθεὶς ὑπὸ γῆν εἶσι τύραννος ἀνήρ,	--- uu - -u u-u u-	dactylic pentameter	
οὐδ᾽ ἂν ἐκεῖνος ἐμοῦ τεθνηότος οὔτ᾽ ἀνιῷτο	- u u-u u- --uu - uu--	dactylic hexameter	masculine penthemimeral
οὔτε κατὰ βλεφάρων θέρμα βάλοι δάκρυα.	-u u- uu- -u u- uu-	dactylic pentameter	
οὔτε σε κωμάζειν ἀπερύκομεν οὔτε καλοῦμεν,	-u u --- uu-uu -u u--	dactylic hexameter	masculine penthemimeral
ἀργαλέος παρεών, καὶ φίλος εὔτ᾽ ἂν ἀπῇς.	-uu- uu- - uu - u u-	dactylic pentameter	
αἴθων μὲν γένος εἰμί, πόλιν δ᾽εὐτείχεα Θήβην	-- - uu -u u- --uu --	dactylic hexameter	feminine penthemimeral, hepthemimeral, trithemimeral
οἰκῶ πατρῴας γῆς ἀπερυκόμενος.	-- --- - uu-uu-	dactylic pentameter	
μή μ᾽ἀφελῶς παίζουσα φίλους δένναζε τοκῆας,	- uu- --u u- --u u--	dactylic hexameter	feminine penthemimeral, hepthemimeral, trithemimeral
Ἄργυρι. σοὶ μὲν γὰρ δούλιον ἦμαρ ἔπι·	-uu - - - -uu -u u-	dactylic pentameter	
ἡμῖν δ᾽ἄλλα μέν ἐστι, γύναι, κακὰ πόλλ᾽ ἐπεὶ ἐκ γῆς	-- -u u -u u- uu - uu - -	dactylic hexameter	feminine penthemimeral, hepthemimeral
φεύγομεν, ἀργαλέη δ᾽οὐκ ἔπι δουλοσύνη,	-uu -uu- - uu -uu-	dactylic pentameter	
οὐδ᾽ ἡμᾶς περνᾶσι· πόλις γε μέν ἐστι καὶ ἡμῖν	- -- --u u- u u -u u --	dactylic hexameter	feminine penthemimeral, hepthemimeral, trithemimeral
καλὴ Ληθαίῳ κεκλιμένη πεδίῳ.	-- --- -uu- uu-	dactylic pentameter	
μήποτε πὰρ κλαίοντα καθεζόμενοι γελάσωμεν	-uu - --u u-uu- uu--	dactylic hexameter	feminine penthemimeral, trithemimeral
τοῖς αὐτῶν ἀγαθοῖς, Κύρν᾽, ἐπιτερπόμενοι.	- -- uu- - uu-uu-	dactylic pentameter	
ἐχθρῷ μὲν χαλεπὸν τὸν δυσμενῆ ἐξαπατῆσαι	-- - uu- - -uu -uu--	dactylic hexameter	masculine penthemimeral, trithemimeral
Κύρνε, φίλον δὲ φίλῳ ῥᾴδιον ἐξαπατᾶν.	-u u- u u- -uu -uu-	dactylic pentameter	
πολλὰ φέρειν εἴωθε δέος θνητοῖσι βροτοῖσι	-u u- --u u- --u u--	dactylic hexameter	feminine penthemimeral, hepthemimeral, trithemimeral
πταίσματα τῆς γνώμης, Κύρνε, ταρασσομένης.	-uu - -- -u u-uu-	dactylic pentameter	
οὐδέν, Κύρν᾽, ὀργῆς ἀδικώτερον, ἣ τὸν ἔχοντα	-- - -- uu-uu - u u--	dactylic hexameter	masculine penthemimeral, trithemimeral
πημαίνει θυμῷ δειλὰ χαριζομένη.	--- -- -u u-uu-	dactylic pentameter	
οὐδέν, Κύρν᾽ ἀγαθῆς γλυκερώτερόν ἐστι γυναικός·	-- - uu- uu-uu -u u--	dactylic hexameter	masculine penthemimeral, trithemimeral
μάρτυς ἐγώ, σὺ δ᾽ἐμοὶ γίγνου ἀληθοσύνης.	-u u- u u- -u u-uu-	dactylic pentameter	
ἤδη γάρ με κέκληκε θαλάσσιος οἴκαδε νεκρὸς	-- - u u-u u-uu -uu --	dactylic hexameter	feminine penthemimeral, trithemimeral
τεθνηκὼς ζῳῷ φθεγγόμενος στόματι.	--- -- -uu- uu-	dactylic pentameter	
Σχέτλἰ Ἔρως, μανίαι σ᾽ἐτιθηνήσαντο λαβοῦσαι·	-u u- uu- uu---u u--	dactylic hexameter	masculine penthemimeral, trithemimeral
ἐκ σέθεν ὤλετο μὲν Ἰλίου ἀκρόπολις,	- uu -uu - -uu -uu-	dactylic pentameter	
ὤλετο δ᾽Αἰγείδης Θησεὺς μέγας, ὤλετο δ᾽Αἴας	-uu --- -- uu -uu --	dactylic hexameter	masculine penthemimeral, hepthemimeral
ἐσθλὸς Ὀϊλιάδης σῇσιν ἀτασθαλίῃς.	-u u-uu- -u u-uu-	dactylic pentameter	
ὦ παῖ, ἄκουσον ἐμεῦ δαμάσας φρένας· οὔτοι ἀπειθῆ	- u u-u u- uu- uu -u u--	dactylic hexameter	masculine penthemimeral, hepthemimeral
μῦθον ἐρῶ τῇ σῇ καρδίῃ οὐδ᾽ ἄχαριν·	-u u- - - -uu - uu-	dactylic pentameter	
ἀλλὰ τλῆθι νόῳ συνιεῖν ἔπος· οὔτοι ἀνάγκη	-- -u u- uu- uu -u u--	dactylic hexameter	masculine penthemimeral, hepthemimeral
τοῦθ᾽ ἕρδειν ὅτι σοι μὴ καταθύμιον ᾖ.	- -- uu - - uu-uu -	dactylic pentameter	
μήποτε τὸν παρεόντα μεθεὶς φίλον ἄλλον ἐρεύνα	-uu - uu-u u- uu -u u--	dactylic hexameter	feminine penthemimeral, hepthemimeral, trithemimeral
δειλῶν ἀνθρώπων ῥήμασι πειθόμενος·	-- --- -uu -uu-	dactylic pentameter	
πολλάκι τοι παρ᾽ ἐμοὶ κατὰ σοῦ λέξουσι μάταια	-uu - u u- uu - --u u--	dactylic hexameter	masculine penthemimeral, hepthemimeral, trithemimeral
καὶ παρὰ σοὶ κατ᾽ ἐμοῦ· τῶν δὲ σὺ μὴ ξύνιε.	- uu - u u- - u u - uu-	dactylic pentameter	
χαιρήσεις τῇ πρόσθε παροιχομένῃ φιλότητι,	--- - -u u-uu- uu--	dactylic hexameter	feminine penthemimeral, trithemimeral
τῆς δὲ παρερχομένης οὐκέτ᾽ ἔσῃ ταμίης.	- u u-uu- -u u- uu-	dactylic pentameter	
δὴν δὴ καὶ φίλοι εἶμεν· ἔπειτ᾽ ἄλλοισιν ὁμίλει	- - - uu -u u- --u u--	dactylic hexameter	feminine penthemimeral, hepthemimeral, trithemimeral
ἦθος ἔχων δόλιον πίστιος ἀντίτυπον.	-u u- uu- -uu -uu-	dactylic pentameter	
οὔποθ᾽ ὕδωρ καὶ πῦρ συμμείξεται, οὐδέ ποθ᾽ ἡμεῖς	-u u- - - --uu -u u --	dactylic hexameter	masculine penthemimeral, trithemimeral
πιστοὶ ἐπ᾽ ἀλλήλοις καὶ φίλοι ἐσσόμεθα.	-u u --- - uu -uu-	dactylic pentameter	
φρόντισον ἔχθος ἐμὸν καὶ ὑπέρβασιν, ἴσθι δὲ θυμῷ	-uu -u u- u u-uu -u u --	dactylic hexameter	masculine penthemimeral
ὥς σ᾽ἐφ᾽ ἁμαρτωλῇ τείσομαι ὡς δύναμαι.	- u u--- -uu - uu-	dactylic pentameter	
παῖ, σὺ μὲν αὔτως ἵππῳ, ἐπεὶ σκιρτῶν ἐκορέσθης	- u u -- -u u- -- uu--	dactylic hexameter	feminine penthemimeral, hepthemimeral
αὖθις ἐπὶ σταθμοὺς ἤλυθες ἡμετέρους	-u u- -- -uu -uu-	dactylic pentameter	
ἡνίοχόν τε ποθῶν ἀγαθὸν λειμῶνα τε καλὸν	-uu- u u- uu- --u u --	dactylic hexameter	masculine penthemimeral, hepthemimeral, trithemimeral
κρήνην τε ψυχρὴν ἄλσεά τε σκιερά.	-- - -- -uu - uu-	dactylic pentameter	
ὄλβιος, ᾧ παῖδές τε φίλοι καὶ μώνυχες ἵπποι	-uu - -- u u- - -uu --	dactylic hexameter	masculine penthemimeral, hepthemimeral, trithemimeral
θηρευταί τε κύνες καὶ ξένοι ἀλλοδαποί.	--- u u- - uu -uu-	dactylic pentameter	
ὅστις μὴ παῖδάς τε φιλεῖ καὶ μώνυχας ἵππους	-- - -- u u- - -uu --	dactylic hexameter	masculine penthemimeral, hepthemimeral, trithemimeral
καὶ κύνας, οὔποτέ οἱ θυμὸς ἐν εὐφροσύνῃ·	- uu -uu - -u u -uu-	dactylic pentameter	
ὦ παῖ, κιγκαλιδεῦσι πολυπλάγκτοισιν ὁμοιοῖ	- - -uu-u u---u u--	dactylic hexameter	feminine penthemimeral
ὀργήν, ἄλλοτε τοῖς, ἄλλοτε τοῖσι φίλος.	-- -uu - -uu -u u-	dactylic pentameter	
ὦ παῖ, τὴν μορφὴν μὲν ἔφυς καλός, ἀλλ᾽ ἐπίκειται	- - - -- u u- uu - uu--	dactylic hexameter	masculine penthemimeral, hepthemimeral, trithemimeral
καρτερὸς ἀγνοιῶν σῇ κεφαλῇ στέφανος·	-uu --- - uu- uu-	dactylic pentameter	
ἰκτίνου γὰρ ἔχεις ἀγχιστρόφου ἐν φρεσὶν ἦθος	--- u u- --uu - uu --	dactylic hexameter	masculine penthemimeral, trithemimeral
ἄλλων ἀνθρώπων ῥήμασι πειθόμενος.	-- --- -uu -uu-	dactylic pentameter	
ὦ παῖ, ὃς εὖ ἕρδοντι κακὴν ἀπέδωκας ἀμοιβήν,	- u u - --u u- uu-u u--	dactylic hexameter	feminine penthemimeral, hepthemimeral, trithemimeral
οὐδέ τις ἀντ᾽ ἀγαθῶν ἐστι χάρις παρὰ σοί,	-u u - uu- -u u- uu -	dactylic pentameter	
οὐδέν πώ μ᾽ὤνησας· ἐγὼ δέ σε πολλάκις ἤδη	-- - --u u- u u -uu --	dactylic hexameter	feminine penthemimeral, hepthemimeral, trithemimeral
εὖ ἕρδων αἰδοῦς οὐδεμιῆς ἔτυχον.	- -- -- -uu- uu-	dactylic pentameter	
παῖς τε καὶ ἵππος ὁμοῖον ἔχει νόον· οὔτε γὰρ ἵππος	- u u -u u-u u- uu -u u --	dactylic hexameter	feminine penthemimeral, hepthemimeral
ἡνίοχον κλαίει κείμενον ἐν κονίῃ,	-uu- -- -uu - uu-	dactylic pentameter	
ἀλλὰ τὸν ὕστερον ἄνδρα φέρει κριθαῖσι κορεσθείς·	-u u -uu -u u- --u u--	dactylic hexameter	feminine penthemimeral, hepthemimeral
ὣς δ᾽αὔτως καὶ παῖς τὸν παρεόντα φιλεῖ.	- -- - - - uu-u u-	dactylic pentameter	
ὦ ραῖ, μαργοσύνῃς ἀπὸ μὲν νόον ὤλεσας ἐσθλόν,	- - -uu- uu - uu -uu --	dactylic hexameter	masculine penthemimeral, hepthemimeral
αἰσχύνη τε φίλοις ἡμετέροις ἐγένου·	--- u u- -uu- uu-	dactylic pentameter	
ἄμμε δ᾽ἀνέψυξας μικρὸν χρόνον, ἐκ δὲ θυελλῶν	-u u--- -- uu - u u--	dactylic hexameter	masculine penthemimeral, hepthemimeral
ἦκά γ᾽ἐνωρμίσθην νυκτὸς ἐπειγομένης.	-u u--- -u u-uu-	dactylic pentameter	
ὡραῖος καὶ Ἔρως ἐπιτέλλεται, ἡνίκα περ γῆ	--- u u- uu-uu -uu - -	dactylic hexameter	masculine penthemimeral, trithemimeral
ἄνθεσιν εἰαρινοῖς θάλλει ἀεξομένη·	-uu -uu- -u u-uu-	dactylic pentameter	
τῆμος Ἔρως προλιπὼν Κύπρον, περικαλλέα νῆσον,	-u u- uu- -- uu-uu --	dactylic hexameter	masculine penthemimeral, hepthemimeral, trithemimeral
εἶσιν ἐπ᾽ ἀνθρώπους χάρμα φέρων κατὰ γῆν.	-u u --- -u u- uu -	dactylic pentameter	
ὅστις σοι βούλευσεν ἐμεῦ πέρι, καί σ᾽ἐκέλευσεν	-- - --u u- uu - uu--	dactylic hexameter	feminine penthemimeral, hepthemimeral, trithemimeral
οἴχεσθαι προλιπόνθ᾽ ἡμετέρην φιλίην.	--- uu- -uu- uu-	dactylic pentameter	
νεβρὸν ὑπὲξ ἐλάφοιο λέων ὣς ἀλκὶ πεποιθὼς	-u u- uu-u u- - -u u--	dactylic hexameter	feminine penthemimeral, hepthemimeral, trithemimeral
ποσσὶ καταιμάρψας αἵματος οὐκ ἔπιον.	-u u--- -uu - uu-	dactylic pentameter	
οὐκ ἐθέλω σε κακῶς ἕρδειν, οὐδ᾽ εἴ μοι ἄμεινον	- uu- u u- -- - - u u--	dactylic hexameter	masculine penthemimeral, hepthemimeral, trithemimeral
πρὸς θεῶ ἀθανάτων ἔσσεται, ὦ καλὲ παῖ·	- uu -uu- -uu - uu -	dactylic pentameter	
οὐ γὰρ ἁμαρτωλαῖσιν ἐπὶ σμικραῖσι κάθημαι,	- u u---u u- --u u--	dactylic hexameter	feminine penthemimeral, hepthemimeral
τῶν δὲ καλῶν παίδων οὐ τίσις οὐδ᾽ ἀδίκων.	- u u- -- - uu - uu-	dactylic pentameter	
ὦ παῖ, μή μ᾽ἀδίκει (ἔτι σοι καταθύμιος εἶναι	- - - uu- uu - uu-uu --	dactylic hexameter	masculine penthemimeral, hepthemimeral, trithemimeral
βούλομ᾽) ἐπιφροσύνῃ τοῦτο συνεὶς ἀγαθῇ·	-u u-uu- -u u- uu-	dactylic pentameter	
οὐ γάρ τοί με δόλῳ παρελεύσεαι οὐδ᾽ ἀπατήσεις·	- - - u u- uu-uu - uu--	dactylic hexameter	masculine penthemimeral, trithemimeral
νικήσας γὰρ ἔχεις τὸ πλέον ἐξοπίσω,	--- u u- - uu -uu-	dactylic pentameter	
ἀλλά σ᾽ἐγὼ τρώσω φεύγοντά με, ὥς ποτέ φασιν	-u u- -- --u u - uu --	dactylic hexameter	masculine penthemimeral, trithemimeral
Ἰασίου κούρην ᾔθεον Ἱππομένην,	-uu- -- -uu -uu-	dactylic pentameter	
ὡραίην περ ἐοῦσαν, ἀναινομένην γάμον ἀνδρῶν	--- u u-u u-uu- uu --	dactylic hexameter	feminine penthemimeral, trithemimeral
φεύγειν· ζωσαμένη δ᾽ἔργ᾽ ἀτέλεστα τέλει,	-- -uu- - uu-u u-	dactylic pentameter	
πατρὸς νοσφισθεῖσα δόμων, ξανθὴ Ἀταλάντη·	-- ---u u- -- uu--	dactylic hexameter	feminine penthemimeral, hepthemimeral
ᾤχετο δ᾽ὑψηλὰς ἐς κορυφὰς ὀρέων,	-uu --- - uu- uu-	dactylic pentameter	
φεύγουσ᾽ ἱμερόεντα γάμον χρυσῆς Ἀφροδίτης	-- -uu-u u- -- uu--	dactylic hexameter	feminine penthemimeral, hepthemimeral
δῶρα· τέλος δ᾽ἔγνω καὶ μάλ᾽ ἀναινομένη.	-u u- -- - u u-uu-	dactylic pentameter	
ὦ παῖ, μή με κακοῖσιν ἐν ἄλγεσι θυμὸν ὀρίνῃς	- - - u u-u u -uu -u u--	dactylic hexameter	feminine penthemimeral, trithemimeral
μηδέ με σὴ φιλότης δώματα Περσεφόνης	-u u - uu- -uu -uu-	dactylic pentameter	
οἴχηται προφέρουσα· θεῶν δ᾽ἐποπίζεο μῆνιν	--- uu-u u- uu-uu --	dactylic hexameter	feminine penthemimeral, hepthemimeral, trithemimeral
βάξιν τ᾽ἀνθρώπων ἤπια νωσάμενος.	-- --- -uu -uu-	dactylic pentameter	
ὦ παῖ, μέχρι τίνος με προφεύξεαι; ὥς σε διώκων	- - -u u- u u-uu - u u--	dactylic hexameter	masculine penthemimeral
δίζημ᾽. ἀλλὰ τί μοι τέρμα γένοιτο κιχεῖν	-- -u u - -u u-u u-	dactylic pentameter	
σῆς ὀργῆς. σὺ δὲ μάργον ἔχων καὶ ἀγήνορα θυμὸν	- -- u u -u u- u u-uu --	dactylic hexameter	feminine penthemimeral, hepthemimeral, trithemimeral
φεύγεις, ἰκτίνου σχέτλιον ἦθος ἔχων.	-- --- -uu -u u-	dactylic pentameter	
ἀλλ᾽ ἐπίμεινον, ἐμοὶ δὲ δίδου χάριν. οὐκέτι δηρὸν	- uu-u u- u u- uu -uu --	dactylic hexameter	masculine penthemimeral, hepthemimeral
ἕξεις Κυπρογενοῦς δῶρον ἰοστεφάνου.	-- -uu- -u u-uu-	dactylic pentameter	
θυμῷ γνοὺς ὅτι παιδείας πολυηράτου ἄνθος	-- - uu --- uu-uu --	dactylic hexameter	hepthemimeral, trithemimeral
ὠκύτερον σταδίου, τοῦτο συνεὶς χάλασον	-uu- uu- -u u- uu-	dactylic pentameter	
δεσμοῦ, μήποτε καὶ σὺ βιήσεαι, ὄβριμε παίδων,	-- -uu - u u-uu -uu --	dactylic hexameter	masculine penthemimeral
Κυπρογενοῦς δ᾽ἔργων ἀντιάσεις χαλεπῶν,	-uu- -- -uu- uu-	dactylic pentameter	
ὥσπερ ἐγὼ νῦν ὧδ᾽ ἐπὶ σοί. σὺ δὲ ταῦτα φύλαξαι,	-u u- - - uu - u u -u u--	dactylic hexameter	masculine penthemimeral, hepthemimeral, trithemimeral
μηδέ σε νικήσῃ παῖδ᾽ ἀδαῆ κακότης.	-u u --- - uu- uu-	dactylic pentameter	
οὔ μ᾽ἔλαθες κλέψας, ὦ παῖ· καὶ γάρ σε διώμμαι.	- uu- -- - - - - u u--	dactylic hexameter	masculine penthemimeral, hepthemimeral, trithemimeral
τούτοις οἷσπερ νῦν ἄρθμιος ἠδὲ φίλος	-- -- - -uu -u u-	dactylic pentameter	
ἔπλευ, ἐμὴν δὲ μεθῆκας ἀτίμητον φιλότητα·	-u u- u u-u u--- uu--	dactylic hexameter	feminine penthemimeral, trithemimeral
οὐ μὲν δὴ τούτοις γ᾽ἦσθα φίλος πρότερον,	- - - -- -u u- uu-	dactylic pentameter	
ἀλλ᾽ ἐγὼ ἐκ πάντων σ᾽ἐδόκουν θήσεσθαι ἑταῖρον	- uu - -- uu- --u u--	dactylic hexameter	masculine penthemimeral, hepthemimeral, trithemimeral
πιστόν· καὶ δὴ νῦν ἄλλον ἔχεισθα φίλον.	-- - - - -u u-u u-	dactylic pentameter	
ἀλλ᾽ ὁ μὲν εὖ ἕρδων κεῖμαι· σὲ δὲ μήτις ἁπάντων	- u u - -- -- u u -u u--	dactylic hexameter	masculine penthemimeral, hepthemimeral, trithemimeral
ἀνθρώπων ἐσορῶν παιδοφιλεῖν ἐθέλοι.	--- uu- -uu- uu-	dactylic pentameter	
Ὤιμοι ἐγὼ δειλός· καὶ δὴ κατάχαρμα μὲν ἐχθροῖς	-u u- -- - - uu-u u --	dactylic hexameter	masculine penthemimeral, hepthemimeral, trithemimeral
τοῖς δὲ φίλοισι πόνος δεινὰ παθὼν γενόμην.	- u u-u u- -u u- uu-	dactylic pentameter	
ὦ παῖ, ἐπεί τοι δῶκε θεὰ χάριν ἱμερόεσσαν	- u u- - -u u- uu -uu--	dactylic hexameter	feminine penthemimeral, hepthemimeral, trithemimeral
Κύπρις, σὸν δ᾽εἶδος πᾶσι νέοισι μέλει,	-- - -- -u u-u u-	dactylic pentameter	
τῶνδ᾽ ἐπάκουσον ἐπῶν καὶ ἐμὴν χάριν ἔνθεο θυμῷ,	- uu-u u- u u- uu -uu --	dactylic hexameter	masculine penthemimeral, hepthemimeral
γνοὺς ἔρον ὡς χαλεπὸς γίνεται ἀνδρὶ φέρειν.	- uu - uu- -uu -u u-	dactylic pentameter	
Κυπρογένη, παῦσόν με πόνων, σκέδασον δὲ μερίμνας	-uu- -- u u- uu- u u--	dactylic hexameter	masculine penthemimeral, hepthemimeral, trithemimeral
θυμοβόρους, στρέψον δ᾽αὖθις ἐς εὐφροσύνας,	-uu- -- -u u -uu-	dactylic pentameter	
μερμήρας δ᾽ἀπόπαυε κακάς, δὸς δ᾽εὔφρονι θυμῷ	--- uu-u u- - -uu --	dactylic hexameter	feminine penthemimeral, hepthemimeral, trithemimeral
μέτρ᾽ ἥβης τελέσαντ᾽ ἔργματα σωφροσύνης.	- -- uu- -uu -uu-	dactylic pentameter	
ὦ παῖ, ἕως ἂν ἔχῃς λείαν γένυν, οὔποτε σαίνων	- u u- u u- -- uu -uu --	dactylic hexameter	masculine penthemimeral, hepthemimeral, trithemimeral
παύσομαι, οὐδ᾽ εἴ μοι μόρσιμόν ἐστι θανεῖν.	-uu - - - -uu -u u-	dactylic pentameter	
σοί τε διδόντι τι καλὸν ἐμοί τ᾽οὐκ αἰσχρὸν ἐρῶντι	- u u-u u -u u- - -u u--	dactylic hexameter	feminine penthemimeral, hepthemimeral
αἰτεῖν. ἀλλὰ γονεων λίσσομαι ἡμετέρων,	-- -u u- -uu -uu-	dactylic pentameter	
αἴδεό μ᾽,ὦ παῖ καλὲ, διδοὺς χάριν, ἢ εἴ ποτε καὶ σὺ	-uu - - -u u- uu - uu - -	dactylic hexameter	feminine penthemimeral, hepthemimeral, trithemimeral
ἥξεις Κυπρογενοῦς δῶρον ἰοστεφάνου	-- -uu- -u u-uu-	dactylic pentameter	
χρηΐζων, καὶ ἐπ᾽ ἄλλον ἐλεύσεαι, ἀλλά σε δαίμων	--- u u -u u-uu -u u --	dactylic hexameter	feminine penthemimeral, trithemimeral
δοίη τῶν αὐτῶν ἀντιτυχεῖν ἐπέων.	-- - -- -uu- uu-	dactylic pentameter	
ὄλβιος, ὅστις ἐρῶν γυμνάζεται οἴκαδε δ᾽ἐλθὼν	-uu -u u- --uu -uu --	dactylic hexameter	masculine penthemimeral
εὕδει σὺν καλῷ παιδὶ πανημέριος.	-- - -- -u u-uu-	dactylic pentameter	
οὐκέτ᾽ ἐρῶ παιδός, χαλεπὰς δ᾽ἀπελάκτισ᾽ ἀνίας,	-u u- -- uu- uu-u u--	dactylic hexameter	masculine penthemimeral, hepthemimeral, trithemimeral
μοχθούς τ᾽ἀργαλέους ἄσμενος ἐξέφυγον,	-- -uu- -uu -uu-	dactylic pentameter	
ἐκλέλυμαι δὲ πόθου πρὸς ἐϋστεφάνου Κυθερείης·	-uu- u u- u u-uu- uu--	dactylic hexameter	masculine penthemimeral, trithemimeral
σοὶ δ᾽,ὦ παῖ, χάρις ἔστ᾽ οὐδεμία πρὸς ἐμοῦ.	- - - uu - -uu- u u-	dactylic pentameter	
αἰαῖ, παιδὸς ἐρῶ ἁπαλόχροος, ὅς με φίλοισιν	-- -u u- uu-uu - u u--	dactylic hexameter	masculine penthemimeral
πᾶσι μάλ᾽ ἐκφαίνει κοὐκ ἐθέλοντος ἐμοῦ.	-u u --- - uu-u u-	dactylic pentameter	
τλήσομαι οὐ κρύψας ἀεκούσια πολλὰ βίαια·	-uu - -- uu-uu -u u--	dactylic hexameter	masculine penthemimeral, trithemimeral
οὐ γὰρ ἐπ᾽ αἰκελίῳ παιδὶ δαμεὶς ἐφάνην.	- u u -uu- -u u- uu-	dactylic pentameter	
Παιδοφιλεῖν δέ τι τερπνόν, ἐπεί ποτε καὶ Γανυμήδους	-uu- u u -u u- uu - uu--	dactylic hexameter	feminine penthemimeral, hepthemimeral, trithemimeral
ἠράσατο Κρονίδης ἀθανάτων βασιλεύς,	-uu- uu- -uu- uu-	dactylic pentameter	
ἁρπάξας δ᾽ἐς Ὄλυμπον ἀνήγαγε, καί μιν ἔθηκε	--- u u-u u-uu - u u--	dactylic hexameter	feminine penthemimeral, trithemimeral
δαίμονα παιδείης ἄνθος ἔχοντ᾽ ἐρατόν.	-uu --- -u u- uu-	dactylic pentameter	
οὕτω μὴ θαύμαζε, Σιμωνίδη, οὕνεκα κἀγὼ	-- - --u u-uu -uu --	dactylic hexameter	feminine penthemimeral, trithemimeral
ἐξεφάνην καλοῦ παιδὸς ἔρωτι δαμείς.	-uu- -- -u u-u u-	dactylic pentameter	
ὦ παῖ, μὴ κώμαζε, γέροντι δὲ πείθεο μύθῳ·	- - - --u u-u u -uu --	dactylic hexameter	feminine penthemimeral, trithemimeral
οὔτοι κωμάζειν σύμφορον ἀνδρὶ νέῳ.	-- --- -uu -u u-	dactylic pentameter	
πικρὸς καὶ γλυκύς ἐστι καὶ ἁρπαλέος καὶ ἀπηνής,	-- - uu -u u -uu- u u--	dactylic hexameter	feminine penthemimeral, trithemimeral
ὄφρα τέλειος ἔῃ, Κύρνε, νέοισιν ἔρως.	-u u-u u- -u u-u u-	dactylic pentameter	
ἢν γάρ τις τελέσῃ, γλυκὺ γίνεται· ἢν δὲ διώκων	- - - uu- uu -uu - u u--	dactylic hexameter	masculine penthemimeral, trithemimeral
μὴ τελέσῃ, πάντων τοῦτ᾽ ἀνιηρότατον.	- uu- -- - uu-uu-	dactylic pentameter	
αἰεὶ παιδοφίλῃσιν ἐπὶ ζυγὸν αὐχένι κεῖται	-- -uu-u u- uu -uu --	dactylic hexameter	feminine penthemimeral, hepthemimeral
δύσλοφον, ἀργαλέον μνῆμα φιλοξενίης.	-uu -uu- -u u-uu-	dactylic pentameter	
χρὴ γάρ τοι περὶ παῖδα πονούμενον εἰς φιλότητα	- - - uu -u u-uu - uu--	dactylic hexameter	feminine penthemimeral, trithemimeral
ὥσπερ κληματίνῳ χεῖρα πυρὶ προσάγειν.	-- -uu- -u u- uu-	dactylic pentameter	
ναῦς πέτρῃ προσέκυρσας ἐμῆς φιλότητος ἁμαρτών,	- -- uu-u u- uu-u u--	dactylic hexameter	feminine penthemimeral, hepthemimeral, trithemimeral
ὦ παῖ, καὶ σαπροῦ πείσματος ἀντελάβου.	- - - -- -uu -uu-	dactylic pentameter	
οὐδαμά σ᾽οὐδ᾽ ἀπεὼν δηλήσομαι, οὐδέ με πείσει	-uu - uu- --uu -u u --	dactylic hexameter	masculine penthemimeral, trithemimeral
οὐδεὶς ἀνθρώπων ὡς σύ με μή σε φιλεῖν.	-- --- - u u - u u-	dactylic pentameter	
ὦ παίδων κάλλιστε καὶ ἱμεροέστατε πάντων,	- -- --u u -uu-uu --	dactylic hexameter	feminine penthemimeral, trithemimeral
στῆθ᾽ αὐτοῦ καί μου παῦρ᾽ ἐπάκουσον ἔπη·	- -- - - - uu-u u-	dactylic pentameter	
παιδός τοι χάρις ἐστί, γυναικὶ δὲ πίστις ἑταίρῃ	-- - uu -u u-u u -u u--	dactylic hexameter	feminine penthemimeral, trithemimeral
οὐδεμί᾽, ἀλλ᾽ αἰεὶ τὸν παρέοντα φιλεῖ.	-uu - -- - uu-u u-	dactylic pentameter	
παιδὸς ἔρως καλὸς μὲν ἔχειν, καλὸς δ᾽ἀποθέσθαι·	-u u- -- u u- -- uu--	dactylic hexameter	masculine penthemimeral, hepthemimeral, trithemimeral
πολλὸν δ᾽εὑρέσθαι ῥῃτερον ἢ τελέσαι.	-- --- -uu - uu-	dactylic pentameter	
μυρία δ᾽ἐξ αὐτοῦ κρέμαται κακά, μυρία δ᾽ἐσθλά·	-uu - -- uu- uu -uu --	dactylic hexameter	masculine penthemimeral, hepthemimeral, trithemimeral
ἀλλὰ ταλαντείῃ καί τις ἔνεστι χάρις.	-u u--- - u u-u u-	dactylic pentameter	
οὐδαμά πω κατέμεινας ἐμὴν χάριν, ἀλλ᾽ ὑπὸ πᾶσαν	-uu - uu-u u- uu - uu --	dactylic hexameter	feminine penthemimeral, hepthemimeral, trithemimeral
αἰεὶ σπουδαίως ἔρχεαι ἀγγελίην.	-- --- -uu -uu-	dactylic pentameter	
ὄλβιος, ὅστις παιδὸς ἐρῶν οὐκ οἶδε θάλασσαν,	-uu -- -u u- - -u u--	dactylic hexameter	feminine penthemimeral, hepthemimeral
οὐδέ οἱ ἐν πόντῳ νὺξ ἐπιοῦσα μέλει.	-u u - -- - uu-u u-	dactylic pentameter	
καλὸς ἐὼν κακότητι φρενῶν δειλοῖσιν ὁμιλεῖς	-u u- uu-u u- --u u--	dactylic hexameter	feminine penthemimeral, hepthemimeral, trithemimeral
ἀνδράσι, καὶ διὰ τοῦτ᾽ αἰσχρὸν ὄνειδος ἔχεις,	-uu - uu - -u u-u u-	dactylic pentameter	
ὦ παῖ· ἐγὼ δ᾽ἀέκων τῆς σῆς φιλότητος ἁμαρτὼν	- u u- uu- - - uu-u u--	dactylic hexameter	masculine penthemimeral, hepthemimeral, trithemimeral
ὠνήμην ἕρδων οἷά τ᾽ἐλεύθερος ὤν.	--- -- -u u-uu -	dactylic pentameter	
ἄνθρωφ᾽, οἵ σ᾽ἐδόκουν χρυσἧς παρὰ δῶρον ἔχοντα	-- - uu- -- uu -u u--	dactylic hexameter	masculine penthemimeral, hepthemimeral, trithemimeral
ἐλθεῖν Κυπρογενοῦς δῶρον ἰοστεφάνου	-- -uu- -u u-uu-	dactylic pentameter	
γίνεται ἀνθρώποισιν ἔχειν χαλεπώτατον ἄχθος,	-uu ---u u- uu-uu --	dactylic hexameter	feminine penthemimeral, hepthemimeral
ἂν μὴ Κυπρογενὴς δῷ λύσιν ἐκ χαλεπῶν.	- - -uu- - uu - uu-	dactylic pentameter	
Κυπρογενὲς Κυθέρεια δολοπλόκε, σοί τι περισσὸν	-uu- uu-u u-uu - u u--	dactylic hexameter	feminine penthemimeral, trithemimeral
Ζεὺς τόδε τιμήσας δῶρον ἔδωκεν ἔχειν·	- uu --- -u u-u u-	dactylic pentameter	
δαμνᾷς ἀνθρώπων πυκινὰς φρένας, οὐδέ τίς ἐστιν	-- --- uu- uu -u u --	dactylic hexameter	masculine penthemimeral, hepthemimeral
οὕτως ἴφθιμος καὶ σοφὸς ὥστε φυγεῖν.	-- --- - uu -u u-	dactylic pentameter	
