Ἁδύ τι τὸ ψιθύρισμα καὶ ἁ πίτυς αἰπόλε τήνα,	-u u - uu-u u - uu -uu --	dactylic hexameter	feminine penthemimeral, hepthemimeral, trithemimeral
ἃ ποτὶ ταῖς παγαῖσι μελίσδεται, ἁδὺ δὲ καὶ τὺ	- uu - --u u-uu -u u - -	dactylic hexameter	feminine penthemimeral, trithemimeral
συρίσδες· μετὰ Πᾶνα τὸ δεύτερον ἆθλον ἀποισῇ.	--- uu -u u -uu -u u--	dactylic hexameter	feminine penthemimeral, trithemimeral
αἴκα τῆνος ἕλῃ κεραὸν τράγον, αἶγα τὺ λαψῇ.	-- -u u- uu- uu -u u --	dactylic hexameter	masculine penthemimeral, hepthemimeral
αἴκα δ᾽αἶγα λάβῃ τῆνος γέρας, ἐς τὲ καταρρεῖ	-- -u u- -- uu - u u--	dactylic hexameter	masculine penthemimeral, hepthemimeral
ἁ χίμαρος· χιμάρῳ δὲ καλὸν κρέας, ἕστέ κ᾽ἀμέλξῃς.	- uu- uu- u u- uu -u u--	dactylic hexameter	masculine penthemimeral, hepthemimeral, trithemimeral
Ἅδιον ὦ ποιμὴν τὸ τεὸν μέλος ἢ τὸ καταχὲς	-uu - -- u u- uu - u u--	dactylic hexameter	masculine penthemimeral, hepthemimeral, trithemimeral
τῆν᾽ ἀπὸ τᾶς πέτρας καταλείβεται ὑψόθεν ὕδωρ.	- uu - -- uu-uu -uu --	dactylic hexameter	masculine penthemimeral, trithemimeral
αἴκα ταὶ Μοῖσαι τὰν οἰίδα δῶρον ἄγωνται,	-- - -- - -uu -u u--	dactylic hexameter	masculine penthemimeral, trithemimeral
ἄρνα τὺ σακίταν λαψῇ γέρας· αἰ δέ κ᾽ἀρέσκῃ	-u u --- -- uu - u u--	dactylic hexameter	masculine penthemimeral, hepthemimeral
τήναις ἄρνα λαβεῖν, τὺ δὲ τὰν ὄιν ὕστερον ἀξῇ.	-- -u u- u u - - -uu --	dactylic hexameter	masculine penthemimeral, hepthemimeral
λῇς ποτὶ τᾶν Νυμφᾶν, λῇς αἰπόλε τεῖδε καθίξας,	- uu - -- - -uu -u u--	dactylic hexameter	masculine penthemimeral, trithemimeral
ὡς τὸ κάταντες τοῦτο γεώλοφον αἵ τε μυρῖκαι,	- u u-- -u u-uu - u u--	dactylic hexameter	feminine penthemimeral
συρίσδεν; τὰς δ᾽αἶγας ἐγὼν ἐν τῷδε νομευσῶ.	--- - -u u- - -u u--	dactylic hexameter	feminine penthemimeral, hepthemimeral, trithemimeral
οὐ θέμις ὦ ποιμὴν τὸ μεσαμβρινόν, οὐ θέμις ἄμμιν	- uu - -- u u-uu - uu --	dactylic hexameter	masculine penthemimeral, trithemimeral
συρίσδεν. τὸν Πᾶνα δεδοίκαμες· ἦ γὰρ ἀπ᾽ ἄγρας	--- - -u u-uu - u u --	dactylic hexameter	feminine penthemimeral, trithemimeral
τανίκα κεκμακὼς ἀμπαύεται· ἔστι δὲ πικρός,	-uu --- --uu -u u --	dactylic hexameter	masculine penthemimeral
καί οἱ ἀεὶ δριμεῖα χολὰ ποτὶ ῥινὶ κάθηται.	- u u- --u u- uu -u u--	dactylic hexameter	feminine penthemimeral, hepthemimeral, trithemimeral
ἀλλὰ τὺ γὰρ δὴ Θύρσι τὰ Δάφνιδος ἄλγε᾽ ἀείδες	-u u - - -u u -uu -u u--	dactylic hexameter	feminine penthemimeral, trithemimeral
καὶ τᾶς βουκολικᾶς ἐπὶ τὸ πλέον ἵκεο μοίσας,	- - -uu- uu - uu -uu --	dactylic hexameter	masculine penthemimeral, hepthemimeral
δεῦρ᾽ ὑπὸ τὰν πτελέαν ἑσδώμεθα, τῶ τε Πριήπω	- uu - uu- --uu - u u--	dactylic hexameter	masculine penthemimeral, trithemimeral
καὶ τᾶν Κραναιᾶν κατεναντίον, ᾇπερ ὁ θῶκος	- - --- uu-uu -u u --	dactylic hexameter	masculine penthemimeral
τῆνος ὁ ποιμενικὸς καὶ ταὶ δρύες. αἰ δέ κ᾽ἀείσῃς	-u u -uu- - - uu - u u--	dactylic hexameter	masculine penthemimeral, hepthemimeral
ὡς ὅκα τὸν Λιβύαθε ποτὶ Χρόμιν ᾆσας ἐρίσδων,	- uu - uu-u u- uu -u u--	dactylic hexameter	feminine penthemimeral, hepthemimeral, trithemimeral
αἶγα δέ τοι δωσῶ διδυματόκον ἐς τρὶς ἀμέλξαι,	-u u - -- uu-uu - u u--	dactylic hexameter	masculine penthemimeral, trithemimeral
ἃ δύ᾽ ἔχοισ᾽ ἐρίφως ποταμέλγεται ἐς δύο πέλλας,	- u u- uu- uu-uu - uu --	dactylic hexameter	masculine penthemimeral, trithemimeral
καὶ βαθὺ κισσύβιον κεκλυσμένον ἁδέι κηρῷ,	- uu -uu- --uu -uu --	dactylic hexameter	masculine penthemimeral
ἀμφῶες, νεοτευχές, ἔτι γλυφάνοιο ποτόσδον.	--- uu-u u- uu-u u--	dactylic hexameter	feminine penthemimeral, hepthemimeral, trithemimeral
τῶ περὶ μὲν χείλη μαρύεται ὑψόθι κισσός,	- uu - -- uu-- -uu --	dactylic hexameter	masculine penthemimeral, trithemimeral
κισσὸς ἑλιχρύσῳ κεκονιμένος· ἁ δὲ κατ᾽ αὐτὸν	-u u--- uu-uu - u u --	dactylic hexameter	masculine penthemimeral
καρπῷ ἕλιξ εἱλεῖται ἀγαλλομένα κροκόεντι.	-u u- --u u-uu- uu--	dactylic hexameter	feminine penthemimeral, trithemimeral
ἔντοσθεν δὲ γυνά, τί θεῶν δαίδαλμα τέτυκται,	--- u u- u u- --u u--	dactylic hexameter	masculine penthemimeral, hepthemimeral, trithemimeral
ἀσκητὰ πέπλῳ τε καὶ ἄμπυκι. πὰρ δέ οἱ ἄνδρες	--- -- u u -uu - u u --	dactylic hexameter	masculine penthemimeral, trithemimeral
καλὸν ἐθειράζοντες ἀμοιβαδὶς ἄλλοθεν ἄλλος	-u u---u u-uu -uu --	dactylic hexameter	feminine penthemimeral
νεικείουσ᾽ ἐπέεσσι. τὰ δ᾽οὐ φρενὸς ἅπτεται αὐτᾶς·	--- uu-u u - uu -uu --	dactylic hexameter	feminine penthemimeral, hepthemimeral, trithemimeral
ἀλλ᾽ ὁκὰ μὲν τῆνον ποτιδέρκεται ἄνδρα γελᾶσα,	- uu - -- uu-uu -u u--	dactylic hexameter	masculine penthemimeral, trithemimeral
ἄλλοκα δ᾽αὖ ποτὶ τὸν ῥιπτεῖ νόον. οἱ δ᾽ὑπ᾽ ἔρωτος	-uu - uu - -- uu - u u--	dactylic hexameter	masculine penthemimeral, hepthemimeral, trithemimeral
δηθὰ κυλοιδιόωντες ἐτώσια μοχθίζοντι.	-u u-uu-u u-uu ---	lyric	
τοῖς δὲ μετὰ γριπεύς τε γέρων πέτρα τε τέτυκται	- u u- -- u u- -- u u--	dactylic hexameter	masculine penthemimeral, hepthemimeral, trithemimeral
λεπράς, ἐφ᾽ ᾇ σπεύδων μέγα δίκτυον ἐς βόλον ἕλκει	-u u - -- uu -uu - uu --	dactylic hexameter	masculine penthemimeral, trithemimeral
ὁ πρέσβυς, κάμνοντι τὸ καρτερὸν ἀνδρὶ ἐοικώς.	- -- --u u -uu -u u--	dactylic hexameter	feminine penthemimeral, trithemimeral
φαίης κεν γυίων νιν ὅσον σθένος ἐλλοπιεύειν·	-- - -- u u- uu -uu--	dactylic hexameter	masculine penthemimeral, hepthemimeral, trithemimeral
ὧδέ οἱ ᾠδήκαντι κατ᾽ αὐχένα πάντοθεν ἶνες	-u u ---u u -uu -uu --	dactylic hexameter	feminine penthemimeral
καὶ πολιῷ περ ἐόντι, τὸ δὲ σθένος ἄξιον ἅβας.	- uu- u u-u u - uu -uu --	dactylic hexameter	feminine penthemimeral, hepthemimeral, trithemimeral
τυτθὸν δ᾽ὅσσον ἄπωθεν ἁλιτρύτοιο γέροντος	-- -u u-u u---u u--	dactylic hexameter	feminine penthemimeral
πυρναίαις σταφυλαῖσι καλὸν βέβριθεν ἀλωά,	--- uu-u u- --u u--	dactylic hexameter	feminine penthemimeral, hepthemimeral, trithemimeral
τὰν ὀλίγος τις κῶρος ἐφ᾽ αἱμασιαῖσι φυλάσσει	- uu- - -u u -uu-u u--	dactylic hexameter	feminine penthemimeral, trithemimeral
ἥμενος· ἀμφὶ δέ νιν δύ᾽ ἀλώπεκες ἁ μὲν ἀν᾽ ὄρχως	-uu -u u - u u-uu - u u --	dactylic hexameter	masculine penthemimeral
φοιτῇ σινομένα τὰν τρώξιμον, ἁ δ᾽ἐπὶ πήρᾳ	-- -uu- - -uu - uu --	dactylic hexameter	masculine penthemimeral
πάντα δόλον κεύθοισα τὸ παιδίον οὐ πρὶν ἀνησεῖν	-u u- --u u -uu - u u--	dactylic hexameter	feminine penthemimeral, trithemimeral
φατὶ πρὶν ἢ ἀκράτιστον ἐπὶ ξηροῖσι καθίξῃ.	-u u - uu-u u- --u u--	dactylic hexameter	feminine penthemimeral, hepthemimeral, trithemimeral
αὐτὰρ ὅγ᾽ ἀνθερίκοισι καλὰν πλέκει ἀκριδοθήραν	-u u -uu-u u- uu -uu--	dactylic hexameter	feminine penthemimeral, hepthemimeral
σχοίνῳ ἐφαρμόσδων· μέλεται δέ οἱ οὔτέ τι πήρας	-u u--- uu- u u -u u --	dactylic hexameter	masculine penthemimeral, hepthemimeral
οὔτε φυτῶν τοσσῆνον, ὅσον περὶ πλέγματι γαθεῖ.	-u u- --u u- uu -uu --	dactylic hexameter	feminine penthemimeral, hepthemimeral, trithemimeral
παντᾷ δ᾽ἀμφὶ δέπας περιπέπταται ὑγρὸς ἄκανθος·	-- -u u- uu-uu -u u--	dactylic hexameter	masculine penthemimeral
αἰολικόν τι θέαμα, τέρας κέ τυ θυμὸν ἀτύξαι.	-uu- u u-u u- u u -u u--	dactylic hexameter	feminine penthemimeral, hepthemimeral, trithemimeral
τῶ μὲν ἐγὼ πορθμεῖ Καλυδωνίῳ αἶγά τ᾽ἔδωκα	- u u- -- uu-uu -u u--	dactylic hexameter	masculine penthemimeral, trithemimeral
ὦνον καὶ τυρόεντα μέγαν λευκοῖο γάλακτος·	-- - uu-u u- --u u--	dactylic hexameter	feminine penthemimeral, hepthemimeral, trithemimeral
οὐδέ τί πω ποτὶ χεῖλος ἐμὸν θίγεν, ἀλλ᾽ ἔτι κεῖται	-u u - uu -u u- uu - uu --	dactylic hexameter	feminine penthemimeral, hepthemimeral, trithemimeral
ἄχραντον. τῷ καί τυ μάλα πρόφρων ἀρεσαίμαν,	--- - - u u- -- uu--	dactylic hexameter	masculine penthemimeral, hepthemimeral, trithemimeral
αἴκά μοι τὺ φίλος τὸν ἐφίμερον ὕμνον ἀείσῃς.	-- - u u- u u-uu -u u--	dactylic hexameter	masculine penthemimeral, trithemimeral
κοὔτί τυ κερτομέω. πόταγ᾽ ὦγαθέ· τὰν γὰρ ἀοιδὰν	-u u -uu- uu -uu - u u--	dactylic hexameter	masculine penthemimeral
οὔτί πᾳ εἰς Ἀίδαν γε τὸν ἐκλελάθοντα φυλαξεῖς.	-u u - uu- u u -uu-u u--	dactylic hexameter	masculine penthemimeral, trithemimeral
Ἄρχετε βουκολικᾶς Μοῖσαι φίλαι ἄρχετ᾽ ἀοιδᾶς.	-uu -uu- -- uu -u u--	dactylic hexameter	masculine penthemimeral, hepthemimeral
Θύρσις ὅδ᾽ ὡξ Αἴτνας, καὶ Θύρσιδος ἁδέα φωνά.	-u u - -- - -uu -uu --	dactylic hexameter	masculine penthemimeral, trithemimeral
πᾷ ποκ᾽ ἄρ᾽ ἦσθ᾽, ὅκα Δάφνις ἐτάκετο, πᾷ ποκα Νύμφαι;	- u u - uu -u u-uu - uu --	dactylic hexameter	feminine penthemimeral, trithemimeral
ἢ κατὰ Πηνειῶ καλὰ τέμπεα; ἢ κατὰ Πίνδω;	- uu --- uu -uu - uu --	dactylic hexameter	masculine penthemimeral
οὐ γὰρ δὴ ποταμοῖο μέγαν ῥόον εἴχετ᾽ Ἀνάπω,	- - - uu-u u- uu -u u--	dactylic hexameter	feminine penthemimeral, hepthemimeral, trithemimeral
οὐδ᾽ Αἴτνας σκοπιάν, οὐδ᾽ Ἄκιδος ἱερὸν ὕδωρ.	- -- uu- - -uu -uu --	dactylic hexameter	masculine penthemimeral, trithemimeral
ἄρχετε βουκολικᾶς Μοῖσαι φίλαι ἄρχετ᾽ ἀοιδᾶς.	-uu -uu- -- uu -u u--	dactylic hexameter	masculine penthemimeral, hepthemimeral
τῆνον μὰν θῶες, τῆνον λύκοι ὠρύσαντο,	-- - -- -- uu ----	dactylic hexameter	masculine penthemimeral, hepthemimeral, trithemimeral
τῆνον χὡκ δρυμοῖο λέων ἔκλαυσε θανόντα.	-- - --u u- --u u--	dactylic hexameter	feminine penthemimeral, hepthemimeral, trithemimeral
ἄρχετε βουκολικᾶς Μοῖσαι φίλαι ἄρχετ᾽ ἀοιδᾶς.	-uu -uu- -- uu -u u--	dactylic hexameter	masculine penthemimeral, hepthemimeral
πολλαί οἱ πὰρ ποσσὶ βόες, πολλοὶ δέ τε ταῦροι,	-- - - -u u- -- u u --	dactylic hexameter	feminine penthemimeral, hepthemimeral, trithemimeral
πολλαὶ δ᾽αὖ δαμάλαι καὶ πόρτιες ὠδύραντο.	-- - uu- - -uu ----	dactylic hexameter	masculine penthemimeral, trithemimeral
ἄρχετε βουκολικᾶς Μοῖσαι φίλαι ἄρχετ᾽ ἀοιδᾶς.	-uu -uu- -- uu -u u--	dactylic hexameter	masculine penthemimeral, hepthemimeral
ἦνθ᾽ Ἑρμῆς πράτιστος ἀπ᾽ ὤρεος, εἶπε δέ· "Δάφνι,	- -- --u u -uu -u u --	dactylic hexameter	feminine penthemimeral, trithemimeral
τίς τυ κατατρύχει; τίνος ὦγαθὲ τόσσον ἐρᾶσαι;"	- u u--- uu -uu -u u--	dactylic hexameter	masculine penthemimeral
ἄρχετε βουκολικᾶς Μοῖσαι φίλαι ἄρχετ᾽ ἀοιδᾶς.	-uu -uu- -- uu -u u--	dactylic hexameter	masculine penthemimeral, hepthemimeral
ἦνθον τοὶ βοῦται, τοὶ ποιμένες, ᾡπόλοι ἦνθον·	-- - -- - -uu -uu --	dactylic hexameter	masculine penthemimeral, trithemimeral
πάντες ἀνηρώτευν, τί πάθοι κακόν. ἦνθ᾽ ὁ Πρίηπος	-u u--- u u- uu - u u--	dactylic hexameter	masculine penthemimeral, hepthemimeral
κἤφα· "Δάφνι τάλαν, τί τὺ τάκεαι, ἁ δέ τε κώρα	-u u-u u- u u -uu - u u --	dactylic hexameter	masculine penthemimeral
πάσας ἀνὰ κράνας, πάντ᾽ ἄλσεα ποσσὶ φορεῖται	-u u- -- - -uu -u u--	dactylic hexameter	masculine penthemimeral, trithemimeral
(ἄρχετε βουκολικᾶς Μοῖσαι φίλαι ἄρχετ᾽ ἀοιδᾶς)	-uu -uu- -- uu -u u--	dactylic hexameter	masculine penthemimeral, hepthemimeral
ζάτεισ᾽; ἆ δύσερώς τις ἄγαν καὶ ἀμήχανος ἐσσί.	-- - uu- u u- u u-uu --	dactylic hexameter	masculine penthemimeral, hepthemimeral, trithemimeral
βούτας μὰν ἐλέγευ, νῦν δ᾽αἰπόλῳ ἀνδρὶ ἔοικας.	-- - uu- - -uu -u u--	dactylic hexameter	masculine penthemimeral, trithemimeral
ᾡπόλος ὅκκ᾽ ἐσορῇ τὰς μηκάδας οἷα βατεῦνται,	-uu - uu- - -uu -u u--	dactylic hexameter	masculine penthemimeral, trithemimeral
τάκεται ὀφθαλμώς, ὅτι οὐ τράγος αὐτὸς ἔγεντο.	-uu --- uu - uu -u u--	dactylic hexameter	masculine penthemimeral, hepthemimeral
ἄρχετε βουκολικᾶς Μοῖσαι φίλαι ἄρχετ᾽ ἀοιδᾶς.	-uu -uu- -- uu -u u--	dactylic hexameter	masculine penthemimeral, hepthemimeral
καὶ τὺ δ᾽ἐπεί κ᾽ἐσορῇς τὰς παρθένος οἶα γελᾶντι,	- u u- uu- - -uu -u u--	dactylic hexameter	masculine penthemimeral, trithemimeral
τάκεαι ὀφθαλμώς, ὅτι οὐ μετὰ ταῖσι χορεύεις."	-uu --- uu - uu -u u--	dactylic hexameter	masculine penthemimeral, hepthemimeral
τὼς δ᾽οὐδὲν ποτελέξαθ᾽ ὁ βουκόλος, ἀλλὰ τὸν αὐτῶ	- -- uu-u u -uu -u u --	dactylic hexameter	feminine penthemimeral, trithemimeral
ἄνυε πικρὸν ἔρωτα, καὶ ἐς τέλος ἄνυε μοίρας·	-uu -u u-u u - uu -uu --	dactylic hexameter	feminine penthemimeral, hepthemimeral
ἄρχετε βουκολικᾶς Μοῖσαι πάλιν ἄρχετ᾽ ἀοιδᾶς.	-uu -uu- -- uu -u u--	dactylic hexameter	masculine penthemimeral, hepthemimeral
ἦνθέ γε μὰν ἁδεῖα καὶ ἁ Κύπρις γελάοισα,	-u u - --u u - -- uu--	dactylic hexameter	feminine penthemimeral, hepthemimeral, trithemimeral
λάθρια μὲν γελάοισα, βαρὺν δ᾽ἀνὰ θυμὸν ἔχοισα,	-uu - uu-u u- uu -u u--	dactylic hexameter	feminine penthemimeral, hepthemimeral, trithemimeral
κεἶπε· "τύ θην τὸν Ἔρωτα κατεύχεο Δάφνι λυγιξεῖν·	-u u - u u-u u-uu -u u--	dactylic hexameter	feminine penthemimeral, trithemimeral
ἦ ῥ᾽οὐκ αὐτὸς Ἔρωτος ὑπ᾽ ἀργαλέω ἐλυγίχθης;"	- - -u u-u u -uu- u--	lyric	
ἄρχετε βουκολικᾶς Μοῖσαι πάλιν ἄρχετ᾽ ἀοιδᾶς.	-uu -uu- -- uu -u u--	dactylic hexameter	masculine penthemimeral, hepthemimeral
τὰν δ᾽ἄρα χὡ Δάφνις ποταμείβετο· "Κύπρι βαρεῖα,	- uu - -- uu-uu -u u--	dactylic hexameter	masculine penthemimeral, trithemimeral
Κύπρι νεμεσσατά, Κύπρι θνατοῖσιν ἀπεχθής·	-u u-uu -- --- --	lyric	
ἤδη γὰρ φράσδῃ πάνθ᾽ ἅλιον ἄμμι δεδύκειν·	-- - -- - -uu -u u--	dactylic hexameter	masculine penthemimeral, trithemimeral
Δάφνις κἠν Ἀίδα κακὸν ἔσσεται ἄλγος Ἔρωτι.	-- - uu- uu -uu -u u--	dactylic hexameter	masculine penthemimeral, trithemimeral
ἄρχετε βουκολικᾶς Μοῖσαι πάλιν ἄρχετ᾽ ἀοιδᾶς.	-uu -uu- -- uu -u u--	dactylic hexameter	masculine penthemimeral, hepthemimeral
ὧ λέγεται τὰν Κύπριν ὁ βουκόλος, ἕρπε ποτ᾽ Ἴδαν,	- uu- - -u u -uu -u u --	dactylic hexameter	feminine penthemimeral, trithemimeral
ἕρπε ποτ᾽ Ἀγχίσην. τηνεῖ δρύες, ἔνθα κύπειρος·	-u u --- -- uu -u u--	dactylic hexameter	masculine penthemimeral, hepthemimeral
ἄρχετε βουκολικᾶς Μοῖσαι φίλαι ἄρχετ᾽ ἀοιδᾶς.	-uu -uu- -- uu -u u--	dactylic hexameter	masculine penthemimeral, hepthemimeral
ὡραῖος χὥδωνις, ἐπεὶ καὶ μᾶλα νομεύει.	--- --u u- - -u u--	dactylic hexameter	feminine penthemimeral, hepthemimeral, trithemimeral
καὶ πτῶκας βάλλει καὶ θηρία πάντα διώκει.	- -- -- - -uu -u u--	dactylic hexameter	masculine penthemimeral, trithemimeral
ἄρχετε βουκολικᾶς Μοῖσαι φίλαι ἄρχετ᾽ ἀοιδᾶς.	-uu -uu- -- uu -u u--	dactylic hexameter	masculine penthemimeral, hepthemimeral
αὖθις ὅπως στασῇ Διομήδεος ἆσσον ἰοῖσα,	-u u- -- uu-uu -u u--	dactylic hexameter	masculine penthemimeral, trithemimeral
καὶ λέγε· τὸν βούταν νικῶ Δάφνιν, ἀλλὰ μάχευ μοι."	- uu - -- -- uu -u u- -	dactylic hexameter	masculine penthemimeral, hepthemimeral, trithemimeral
ἄρχετε βουκολικᾶς Μοῖσαι πάλιν ἄρχετ᾽ ἀοιδᾶς.	-uu -uu- -- uu -u u--	dactylic hexameter	masculine penthemimeral, hepthemimeral
ὦ λύκοι, ὦ θῶες, ὦ ἀν᾽ ὤρεα φωλάδες ἄρκτοι,	- uu - -- u u -uu -uu --	dactylic hexameter	masculine penthemimeral, trithemimeral
χαίρεθ᾽. ὁ βουκόλος ὔμμιν ἐγὼ Δάφνις οὐκέτ᾽ ἀν᾽ ὕλαν,	-u u -uu -u u- uu -u u --	dactylic hexameter	feminine penthemimeral, hepthemimeral
οὐκέτ᾽ ἀνὰ δρυμώς, οὐκ ἄλσεα. χαῖρ᾽ Ἀρέθοισα,	-u u- -- - -uu - uu--	dactylic hexameter	masculine penthemimeral, trithemimeral
καὶ ποταμοί, τοὶ χεῖτε καλὸν κατὰ Θύμβριδος ὕδωρ.	- uu- - -u u- uu -uu --	dactylic hexameter	feminine penthemimeral, hepthemimeral, trithemimeral
ἄρχετε βουκολικᾶς Μοῖσαι πάλιν ἄρχετ᾽ ἀοιδᾶς.	-uu -uu- -- uu -u u--	dactylic hexameter	masculine penthemimeral, hepthemimeral
Δάφνις ἐγὼν ὅδε τῆνος ὁ τὰς βόας ὧδε νομεύων,	-u u- uu -u u - uu -u u--	dactylic hexameter	feminine penthemimeral, hepthemimeral, trithemimeral
Δάφνις ὁ τὼς ταύρως καὶ πόρτιας ὧδε ποτίσδων.	-u u - -- - -uu -u u--	dactylic hexameter	masculine penthemimeral, trithemimeral
ἄρχετε βουκολικᾶς Μοῖσαι πάλιν ἄρχετ᾽ ἀοιδᾶς.	-uu -uu- -- uu -u u--	dactylic hexameter	masculine penthemimeral, hepthemimeral
ὦ Πὰν Πάν, εἴτ᾽ ἐσσὶ κατ᾽ ὤρεα μακρὰ Λυκαίω,	- - - - -u u -uu -u u--	dactylic hexameter	feminine penthemimeral, trithemimeral
εἴτε τύ γ᾽ἀμφιπολεῖς μέγα Μαίναλον, ἔνθ᾽ ἐπὶ νᾶσον	-u u -uu- uu -uu - uu --	dactylic hexameter	masculine penthemimeral
τὰν Σικελάν, Ἑλίκας δὲ λίπ᾽ ἠρίον αἰπύ τε σᾶμα	- uu- uu- u u -uu -u u --	dactylic hexameter	masculine penthemimeral, trithemimeral
τῆνο Λυκαονίδαο, τὸ καὶ μακάρεσσιν ἀγητόν.	-u u-uu-u u - uu-u u--	dactylic hexameter	feminine penthemimeral, hepthemimeral
λήγετε βουκολικᾶς Μοῖσαι ἴτε λήγετ᾽ ἀοιδᾶς.	-uu -uu- -- uu -u u--	dactylic hexameter	masculine penthemimeral, hepthemimeral
ἔνθ᾽ ὦναξ καὶ τάνδε φέρευ πακτοῖο μελίπνουν	- -- - -u u- --u u--	dactylic hexameter	feminine penthemimeral, hepthemimeral, trithemimeral
ἐκ κηρῶ σύριγγα καλάν, περὶ χεῖλος ἑλικτάν.	- -- --u u- uu -u u--	dactylic hexameter	feminine penthemimeral, hepthemimeral, trithemimeral
ἦ γὰρ ἐγὼν ὑπ᾽ ἔρωτος ἐς Ἅιδαν ἕλκομαι ἤδη.	- u u- u u-u u -- -uu --	dactylic hexameter	feminine penthemimeral, trithemimeral
λήγετε βουκολικᾶς Μοῖσαι ἴτε λήγετ᾽ ἀοιδᾶς.	-uu -uu- -- uu -u u--	dactylic hexameter	masculine penthemimeral, hepthemimeral
νῦν δ᾽ἴα μὲν φορέοιτε βάτοι, φορέοιτε δ᾽ἄκανθαι,	- uu - uu-u u- uu-u u--	dactylic hexameter	feminine penthemimeral, hepthemimeral, trithemimeral
ἁ δὲ καλὰ νάρκισσος ἐπ᾽ ἀρκεύθοισι κομάσαι·	- u u- --u u ---u u--	dactylic hexameter	feminine penthemimeral, trithemimeral
πάντα δ᾽ἔναλλα γένοιτο, καὶ ἁ πίτυς ὄχνας ἐνείκαι.	-u u-u u-u u - uu - ---	dactylic hexameter	feminine penthemimeral, hepthemimeral
Δάφνις ἐπεὶ θνάσκει· καὶ τὼς κύνας ὥλαφος ἕλκοι,	-u u- -- - - uu -uu --	dactylic hexameter	masculine penthemimeral, hepthemimeral, trithemimeral
κἠξ ὀρέων τοὶ σκῶπες ἀηδόσι γαρύσαιντο.	- uu- - -u u-uu ----	dactylic hexameter	feminine penthemimeral, trithemimeral
λήγετε βουκολικᾶς Μοῖσαι ἴτε λήγετ᾽ ἀοιδᾶς.	-uu -uu- -- uu -u u--	dactylic hexameter	masculine penthemimeral, hepthemimeral
χὡ μὲν τόσσ᾽ εἰπὼν ἀπεπαύσατο· τὸν δ᾽Ἀφροδίτα	- - - -- uu-uu - ----	lyric	
ἤθελ᾽ ἀνορθῶσαι· τά γε μὰν λίνα πάντα λελοίπει	-u u--- u u - uu -u u--	dactylic hexameter	masculine penthemimeral, hepthemimeral
ἐκ Μοιρᾶν, χὡ Δάφνις ἔβα ῥόον. ἔκλυσε δίνα	- -- - -u u- uu -uu --	dactylic hexameter	feminine penthemimeral, hepthemimeral, trithemimeral
τὸν Μοίσαις φίλον ἄνδρα, τὸν οὐ Νύμφαισιν ἀπεχθῆ.	- -- uu -u u - --u --	lyric	
λήγετε βουκολικᾶς Μοῖσαι ἴτε λήγετ᾽ ἀοιδᾶς.	-uu -uu- -- uu -u u--	dactylic hexameter	masculine penthemimeral, hepthemimeral
καὶ τὺ δίδου τὰν αἶγα τό τε σκύφος, ὥς κεν ἀμέλξας	- u u- - -u u - uu - u u--	dactylic hexameter	feminine penthemimeral, hepthemimeral, trithemimeral
σπείσω ταῖς Μοίσαις. ὦ χαίρετε πολλάκι Μοῖσαι,	-- - -- - -uu -uu --	dactylic hexameter	masculine penthemimeral, trithemimeral
χαίρετ᾽· ἐγὼ δ᾽ὔμμιν καὶ ἐς ὕστερον ἅδιον ᾀσῶ.	-u u- -- u u -uu -uu --	dactylic hexameter	masculine penthemimeral, trithemimeral
πλῆρές τοι μέλιτος τὸ καλὸν στόμα Θύρσι γένοιτο,	-- - uu- u u- uu -u u--	dactylic hexameter	masculine penthemimeral, hepthemimeral, trithemimeral
πλῆρές τοι σχαδόνων, καὶ ἀπ᾽ Αἰγίλω ἰσχάδα τρώγοις	-- - uu- u u -uu -uu --	dactylic hexameter	masculine penthemimeral, trithemimeral
ἁδεῖαν, τέττιγος ἐπεὶ τύγα φέρτερον ᾁδεις.	--- --u u- uu -uu --	dactylic hexameter	feminine penthemimeral, hepthemimeral, trithemimeral
ἠνίδε τοι τὸ δέπας· θᾶσαι φίλος, ὡς καλὸν ὄσδει·	-uu - u u- -- uu - uu --	dactylic hexameter	masculine penthemimeral, hepthemimeral, trithemimeral
Ὡρᾶν πεπλύσθαί νιν ἐπὶ κράναισι δοκησεῖς.	-- --- u u- --u u--	dactylic hexameter	masculine penthemimeral, hepthemimeral
ὧδ᾽ ἴθι Κισσαίθα, τὺ δ᾽ἄμελγέ νιν. αἱ δὲ χίμαιραι,	- uu --- u u-u u - u u--	dactylic hexameter	masculine penthemimeral
οὐ μὴ σκιρτασεῖτε, μὴ ὁ τράγος ὔμμιν ἀναστῇ.	- - ---u u - uu -u u--	dactylic hexameter	feminine penthemimeral, hepthemimeral
πᾷ μοι ταὶ δάφναι; φέρε Θεστυλί· πᾷ δὲ τὰ φίλτρα;	- - - -- uu -uu - u u --	dactylic hexameter	masculine penthemimeral, trithemimeral
στέψον τὰν κελέβαν φοινικέῳ οἰὸς ἀώτῳ,	-- - uu- --uu -u u--	dactylic hexameter	masculine penthemimeral, trithemimeral
ὡς τὸν ἐμὸν βαρὺν εὖντα φίλον καταθύσομαι ἄνδρα,	- u u- uu -u u- uu-uu --	dactylic hexameter	feminine penthemimeral, hepthemimeral, trithemimeral
ὅς μοι δωδεκαταῖος ἀφ᾽ ὧ τάλας οὐδέποθ᾽ ἵκει,	- - -uu-u u - uu -uu --	dactylic hexameter	feminine penthemimeral, hepthemimeral
οὐδ᾽ ἔγνω πότερον τεθνάκαμες ἢ ζοοὶ εἰμές.	- -- uu- --uu - uu --	dactylic hexameter	masculine penthemimeral, trithemimeral
οὐδὲ θύρας ἄραξεν ἀνάρσιος. ἦ ῥά οἱ ἀλλᾷ	-u u- --u u-uu - u u --	dactylic hexameter	feminine penthemimeral, trithemimeral
ᾤχετ᾽ ἔχων ὅ τ᾽Ἔρως ταχινὰς φρένας ἅ τ᾽Ἀφροδίτα;	-u u- u u- uu- uu - ----	lyric	
βασεῦμαι ποτὶ τὰν Τιμαγήτοιο παλαίστραν	--- uu - uu--- ---	dactylic hexameter	masculine penthemimeral, trithemimeral
αὔριον, ὥς νιν ἴδω, καὶ μέμψομαι οἷά με ποιεῖ.	-uu - u u- - -uu -u u --	dactylic hexameter	masculine penthemimeral, trithemimeral
νῦν δέ νιν ἐκ θυέων καταθύσομαι. ἀλλὰ Σελάνα,	- u u - uu- uu-uu -u u--	dactylic hexameter	masculine penthemimeral, trithemimeral
φαῖνε καλόν· τὶν γὰρ ποταείσομαι ἅσυχα, δαῖμον,	-u u- - - uu-uu -uu --	dactylic hexameter	masculine penthemimeral, trithemimeral
τᾷ χθονίᾳ θ᾽Ἑκάτᾳ, τὰν καὶ σκύλακες τρομέοντι	- uu- uu- - - uu- uu--	dactylic hexameter	masculine penthemimeral, hepthemimeral, trithemimeral
ἐρχομέναν νεκύων ἀνά τ᾽ἠρία καὶ μέλαν αἷμα.	-uu- uu- uu -uu - uu --	dactylic hexameter	masculine penthemimeral, trithemimeral
χαῖρ᾽ Ἑκάτα δασπλῆτι, καὶ ἐς τέλος ἄμμιν ὀπάδει.	- uu- --u u - uu -u u--	dactylic hexameter	feminine penthemimeral, hepthemimeral, trithemimeral
φάρμακα ταῦτ᾽ ἔρδοισα χερείονα μήτέ τι Κίρκης	-uu - --u u-uu -u u --	dactylic hexameter	feminine penthemimeral, trithemimeral
μήτέ τι Μηδείας μήτε ξανθᾶς Περιμήδας.	-u u --- -- -- uu--	dactylic hexameter	masculine penthemimeral, hepthemimeral
Ἶυγξ, ἕλκε τὺ τῆνον ἐμὸν ποτὶ δῶμα τὸν ἄνδρα.	-- -u u -u u- uu -u u --	dactylic hexameter	feminine penthemimeral, hepthemimeral
ἄλφιτά τοι πρᾶτον πυρὶ τάκεται· ἀλλ᾽ ἐπίπασσε	-uu - -- uu -uu - uu--	dactylic hexameter	masculine penthemimeral, trithemimeral
Θεστυλί. δειλαία, πᾷ τὰς φρένας ἐκπεπότασαι;	-uu --- - - uu -uu--	dactylic hexameter	masculine penthemimeral, hepthemimeral
ἦ ῥά γε τρισμυσαρὰ καὶ τὶν ἐπίχαρμα τέτυγμαι;	- u u -uu- - - uu-u u--	dactylic hexameter	masculine penthemimeral, hepthemimeral
πάσσ᾽ ἅμα καὶ λέγε ταῦτα· "τὰ Δέλφιδος ὀστία πάσσω."	- uu - uu -u u -uu -uu --	dactylic hexameter	feminine penthemimeral, trithemimeral
ἶυγξ, ἕλκε τὺ τῆνον ἐμὸν ποτὶ δῶμα τὸν ἄνδρα.	-- -u u -u u- uu -u u --	dactylic hexameter	feminine penthemimeral, hepthemimeral
Δέλφις ἔμ᾽ ἀνίασεν· ἐγὼ δ᾽ἐπὶ Δέλφιδι δάφναν	-u u -uu- -- uu -uu --	dactylic hexameter	masculine penthemimeral, hepthemimeral
αἴθω· χὡς αὕτα λακεῖ μέγα καππυρίσασα	-- - -- -- uu -uu--	dactylic hexameter	masculine penthemimeral, hepthemimeral, trithemimeral
κἠξαπίνας ἅφθη, κοὐδὲ σποδὸν εἴδομες αὐτᾶς,	-uu- -- -- uu -uu --	dactylic hexameter	masculine penthemimeral, hepthemimeral, trithemimeral
οὕτω τοι καὶ Δέλφις ἐνὶ φλογὶ σάρκ᾽ ἀμαθύνοι.	-- - - -u u- uu - uu--	dactylic hexameter	feminine penthemimeral, hepthemimeral, trithemimeral
ἶυγξ, ἕλκε τὺ τῆνον ἐμὸν ποτὶ δῶμα τὸν ἄνδρα.	-- -u u -u u- uu -u u --	dactylic hexameter	feminine penthemimeral, hepthemimeral
ὡς τοῦτον τὸν κηρὸν ἐγὼ σὺν δαίμονι τάκω,	- -- - -u u- - -uu --	dactylic hexameter	feminine penthemimeral, hepthemimeral, trithemimeral
ὣς τάκοιθ᾽ ὑπ᾽ ἔρωτος ὁ Μύνδιος αὐτίκα Δέλφις.	- -- u u-u u -uu -uu --	dactylic hexameter	feminine penthemimeral, trithemimeral
χὡς δινεῖθ᾽ ὅδε ῥόμβος ὁ χάλκεος ἐξ Ἀφροδίτας,	- -- uu -u u -uu - ----	lyric	
ὣς τῆνος δινοῖτο ποθ᾽ ἁμετέραισι θύραισιν.	- -- --u u -uu-u u--	dactylic hexameter	feminine penthemimeral, trithemimeral
ἶυγξ, ἕλκε τὺ τῆνον ἐμὸν ποτὶ δῶμα τὸν ἄνδρα.	-- -u u -u u- uu -u u --	dactylic hexameter	feminine penthemimeral, hepthemimeral
νῦν θυσῶ τὰ πίτυρα. τὺ δ᾽Ἄρτεμι καὶ τὸν ἐν Ἅιδα	- -- u u-u u -uu - u u --	dactylic hexameter	feminine penthemimeral, trithemimeral
κινήσαις ἀδάμαντα καὶ εἴ τί περ ἀσφαλὲς ἄλλο.	--- uu-u u - u u -uu --	dactylic hexameter	feminine penthemimeral, hepthemimeral, trithemimeral
Θεστυλί, ταὶ κύνες ἄμμιν ἀνὰ πτόλιν ὠρύονται.	-uu - uu -u u- uu ----	dactylic hexameter	feminine penthemimeral, hepthemimeral, trithemimeral
ἁ θεὸς ἐν τριόδοισι· τὸ χαλκίον ὡς τάχος ἄχει.	- uu - uu-u u -uu - uu --	dactylic hexameter	feminine penthemimeral, trithemimeral
ἶυγξ, ἕλκε τὺ τῆνον ἐμὸν ποτὶ δῶμα τὸν ἄνδρα.	-- -u u -u u- uu -u u --	dactylic hexameter	feminine penthemimeral, hepthemimeral
ἠνίδε σιγῇ μὲν πόντος, σιγῶντι δ᾽ἀῆται·	-uu -- - -- --u u--	dactylic hexameter	masculine penthemimeral, hepthemimeral
ἁ δ᾽ἐμὰ οὐ σιγῇ στέρνων ἔντοσθεν ἀνία,	- uu - -- -- --u u--	dactylic hexameter	masculine penthemimeral, hepthemimeral, trithemimeral
ἀλλ᾽ ἐπὶ τήνῳ πᾶσα καταίθομαι, ὅς με τάλαιναν	- uu -- -u u-uu - u u--	dactylic hexameter	feminine penthemimeral
ἀντὶ γυναικὸς ἔθηκε κακὰν καὶ ἀπάρθενον ἦμεν.	-u u-u u-u u- u u-uu --	dactylic hexameter	feminine penthemimeral, hepthemimeral
ἶυγξ, ἕλκε τὺ τῆνον ἐμὸν ποτὶ δῶμα τὸν ἄνδρα.	-- -u u -u u- uu -u u --	dactylic hexameter	feminine penthemimeral, hepthemimeral
ἐς τρὶς ἀποσπένδω καὶ τρὶς τάδε πότνια φωνέω·	- u u--- - - uu -uu --	dactylic hexameter	masculine penthemimeral, hepthemimeral
εἴτε γυνὰ τήνῳ παρακέκλιται εἴτε καὶ ἀνήρ,	-u u- -- uu-uu -u u --	dactylic hexameter	masculine penthemimeral, trithemimeral
τόσσον ἔχοι λάθας, ὅσσόν ποκα Θησέα φαντὶ	-u u- uu -- -- -uu --	dactylic hexameter	trithemimeral
ἐν Δίᾳ λασθῆμεν ἐυπλοκάμω Ἀριάδνας.	- -- --u u-uu- u--	lyric	
ἶυγξ, ἕλκε τὺ τῆνον ἐμὸν ποτὶ δῶμα τὸν ἄνδρα.	-- -u u -u u- uu -u u --	dactylic hexameter	feminine penthemimeral, hepthemimeral
ἱππομανὲς φυτόν ἐστι παρ᾽ Ἀρκάσι· τῷ δ᾽ἐπὶ πᾶσαι	-uu- uu -u u -uu - uu --	dactylic hexameter	feminine penthemimeral, trithemimeral
καὶ πῶλοι μαίνονται ἀν᾽ ὤρεα καὶ θοαὶ ἵπποι.	- -- --u u -uu - uu --	dactylic hexameter	feminine penthemimeral, trithemimeral
ὣς καὶ Δέλφιν ἴδοιμι, καὶ ἐς τόδε δῶμα περάσαι	- - -u u-u u - uu -u u--	dactylic hexameter	feminine penthemimeral, hepthemimeral
μαινομένῳ ἴκελος λιπαρᾶς ἔκτοσθε παλαίστρας.	-uu- uu- uu- --u u--	dactylic hexameter	masculine penthemimeral, hepthemimeral, trithemimeral
ἶυγξ, ἕλκε τὺ τῆνον ἐμὸν ποτὶ δῶμα τὸν ἄνδρα.	-- -u u -u u- uu -u u --	dactylic hexameter	feminine penthemimeral, hepthemimeral
τοῦτ᾽ ἀπὸ τᾶς χλαίνας τὸ κράσπεδον ὤλεσε Δέλφις,	- uu - -- - -uu -uu --	dactylic hexameter	masculine penthemimeral, trithemimeral
ὡγὼ νῦν τίλλοισα κατ᾽ ἀγρίῳ ἐν πυρὶ βάλλω.	-- - --u u -uu - uu --	dactylic hexameter	feminine penthemimeral, trithemimeral
αἰαῖ Ἔρως ἀνιηρέ, τί μευ μέλαν ἐκ χροὸς αἷμα	-u u- uu-u u - uu - uu --	dactylic hexameter	feminine penthemimeral, hepthemimeral, trithemimeral
ἐμφὺς ὡς λιμνᾶτις ἅπαν ἐκ βδέλλα πέπωκας;	-- - --u u- - -u u--	dactylic hexameter	feminine penthemimeral, hepthemimeral, trithemimeral
ἶυγξ, ἕλκε τὺ τῆνον ἐμὸν ποτὶ δῶμα τὸν ἄνδρα.	-- -u u -u u- uu -u u --	dactylic hexameter	feminine penthemimeral, hepthemimeral
σαύραν τοι τρίψασα ποτὸν κακὸν αὔριον οἰσῶ.	-- - --u u- uu -uu --	dactylic hexameter	feminine penthemimeral, hepthemimeral, trithemimeral
Θεστυλί, νῦν δὲ λαβοῖσα τὺ τὰ θρόνα ταῦθ᾽ ὑπόμαξον	-uu - u u-u u - uu - uu--	dactylic hexameter	feminine penthemimeral, hepthemimeral, trithemimeral
τᾶς τήνω φλιᾶς καθ᾽ ὑπέρτερον, ἇς ἔτι καὶ νύξ,	- -- -- u u-uu - uu - -	dactylic hexameter	masculine penthemimeral, trithemimeral
καὶ λέγ᾽ ἐπιφθύζοισα· "τὰ Δέλφιδος ὀστία μάσσω."	- u u---u u -uu -uu --	dactylic hexameter	feminine penthemimeral
ἶυγξ, ἕλκε τὺ τῆνον ἐμὸν ποτὶ δῶμα τὸν ἄνδρα.	-- -u u -u u- uu -u u --	dactylic hexameter	feminine penthemimeral, hepthemimeral
νῦν δὴ μώνα ἐοῖσα πόθεν τὸν ἔρωτα δακρύσω;	- - -u u-u u- u u-u u--	dactylic hexameter	feminine penthemimeral, hepthemimeral
ἐκ τίνος ἄρξωμαι; τίς μοι κακὸν ἄγαγε τοῦτο;	- uu --- - - uu -uu --	dactylic hexameter	masculine penthemimeral, hepthemimeral
ἦνθ᾽ ἁ τῶ Εὐβούλοιο κανηφόρος ἄμμιν Ἀναξὼ	- u u ---u u-uu -u u--	dactylic hexameter	feminine penthemimeral
ἄλσος ἐς Ἀρτέμιδος, τᾷ δὴ τόκα πολλὰ μὲν ἄλλα	-u u -uu- - - uu -u u --	dactylic hexameter	masculine penthemimeral, hepthemimeral
θηρία πομπεύεσκε περισταδόν, ἐν δὲ λέαινα.	-uu ---u u-uu - u u--	dactylic hexameter	feminine penthemimeral
φράζεό μευ τὸν ἔρωθ᾽ ὅθεν ἵκετο, πότνα Σελάνα.	-uu - u u- uu -uu -u u--	dactylic hexameter	masculine penthemimeral, trithemimeral
καί μ᾽ἁ Θευχαρίδα Θρᾷσσα τροφὸς ἁ μακαρῖτις	- - -uu- -- uu - uu--	dactylic hexameter	masculine penthemimeral, hepthemimeral
ἀγχίθυρος ναίοισα κατεύξατο καὶ λιτάνευσε	-uu- --u u-uu - uu--	dactylic hexameter	feminine penthemimeral, trithemimeral
τὰν πομπὰν θάσασθαι· ἐγὼ δέ οἱ ἁ μεγάλοιτος	- -- --u u- u u - uu--	dactylic hexameter	feminine penthemimeral, hepthemimeral, trithemimeral
ὡμάρτευν βύσσοιο καλὸν σύροισα χιτῶνα,	--- --u u- --u u--	dactylic hexameter	feminine penthemimeral, hepthemimeral, trithemimeral
κἀμφιστειλαμένα τὰν ξυστίδα τὰν Κλεαρίστας.	---uu- - -uu - uu--	dactylic hexameter	masculine penthemimeral
φράζεό μευ τὸν ἔρωθ᾽ ὅθεν ἵκετο, πότνα Σελάνα.	-uu - u u- uu -uu -u u--	dactylic hexameter	masculine penthemimeral, trithemimeral
ἤδη δ᾽εὖσα μέσον κατ᾽ ἀμαξιτόν, ᾇ τὰ Λύκωνος,	-- -u u- u u-uu - u u--	dactylic hexameter	masculine penthemimeral
εἶδον ὁμοῦ Δέλφιν τε καὶ Εὐδάμιππον ἰόντας.	-u u- -- u u ---u u--	dactylic hexameter	masculine penthemimeral, trithemimeral
τοῖς δ᾽ἦν ξανθοτέρα μὲν ἑλιχρύσοιο γενειάς,	- - -uu- u u---u u--	dactylic hexameter	masculine penthemimeral
στήθεα δὲ στίλβοντα πολὺ πλέον ἢ τὺ Σελάνα,	-uu - --u u- uu - u u--	dactylic hexameter	feminine penthemimeral, hepthemimeral, trithemimeral
ὡς ἀπὸ γυμνασίοιο καλὸν πόνον ἄρτι λιπόντων.	- uu -uu-u u- uu -u u--	dactylic hexameter	feminine penthemimeral, hepthemimeral
φράζεό μευ τὸν ἔρωθ᾽ ὅθεν ἵκετο, πότνα Σελάνα.	-uu - u u- uu -uu -u u--	dactylic hexameter	masculine penthemimeral, trithemimeral
χὡς ἴδον, ὡς ἐμάνην, ὥς μευ πέρι θυμὸς ἰάφθη	- uu - uu- - - uu -u u--	dactylic hexameter	masculine penthemimeral, hepthemimeral, trithemimeral
δειλαίας· τὸ δὲ κάλλος ἐτάκετο, κοὔτέ τι πομπᾶς	--- u u -u u-uu -u u --	dactylic hexameter	feminine penthemimeral, trithemimeral
τήνας ἐφρασάμαν, οὐδ᾽ ὡς πάλιν οἴκαδ᾽ ἀπῆνθον	-- -uu- - - uu -u u--	dactylic hexameter	masculine penthemimeral, hepthemimeral
ἔγνων· ἀλλά μέ τις καπυρὰ νόσος ἐξεσάλαξε,	-- -u u - uu- uu -uu--	dactylic hexameter	masculine penthemimeral, hepthemimeral
κείμαν δ᾽ἐν κλιντῆρι δέκ᾽ ἄματα καὶ δέκα νύκτας.	-- - --u u -uu - uu --	dactylic hexameter	feminine penthemimeral, trithemimeral
φράζεό μευ τὸν ἔρωθ᾽ ὅθεν ἵκετο, πότνα Σελάνα.	-uu - u u- uu -uu -u u--	dactylic hexameter	masculine penthemimeral, trithemimeral
καί μευ χρὼς μὲν ὁμοῖος ἐγίνετο πολλάκι θάψῳ,	- - - u u-u u-uu -uu --	dactylic hexameter	feminine penthemimeral, trithemimeral
ἔρρευν δ᾽ἐκ κεφαλᾶς πᾶσαι τρίχες, αὐτὰ δὲ λοιπὰ	-- - uu- -- uu -u u --	dactylic hexameter	masculine penthemimeral, hepthemimeral, trithemimeral
ὀστί᾽ ἔτ᾽ ἦς καὶ δέρμα. καὶ ἐς τίνος οὐκ ἐπέρασα	-u u - - -u u - uu - uu--	dactylic hexameter	feminine penthemimeral, hepthemimeral, trithemimeral
ἢ ποίας ἔλιπον γραίας δόμον, ἅτις ἐπᾷδεν;	- -- uu- -- uu -u u--	dactylic hexameter	masculine penthemimeral, hepthemimeral, trithemimeral
ἀλλ᾽ ἦς οὐδὲν ἐλαφρόν· ὁ δέ χρόνος ἄνυτο φεύγων.	- - -u u-u u - uu -uu --	dactylic hexameter	feminine penthemimeral, hepthemimeral
φράζεό μευ τὸν ἔρωθ᾽ ὅθεν ἵκετο, πότνα Σελάνα.	-uu - u u- uu -uu -u u--	dactylic hexameter	masculine penthemimeral, trithemimeral
χοὕτω τᾷ δούλᾳ τὸν ἀλαθέα μῦθον ἔλεξα·	-- - -- u u-uu -u u--	dactylic hexameter	masculine penthemimeral, trithemimeral
"εἰ δ᾽ἄγε Θεστυλί μοι χαλεπᾶς νόσω εὑρέ τι μῆχος.	- uu -uu - uu- uu -u u --	dactylic hexameter	masculine penthemimeral, hepthemimeral
πᾶσαν ἔχει με τάλαιναν ὁ Μύνδιος· ἀλλὰ μολοῖσα	-u u- u u-u u -uu -u u--	dactylic hexameter	feminine penthemimeral, trithemimeral
τήρησον ποτὶ τὰν Τιμαγήτοιο παλαίστραν·	--- uu - uu--- ---	dactylic hexameter	masculine penthemimeral, trithemimeral
τηνεῖ γὰρ φοιτῇ, τηνεῖ δέ οἱ ἁδὺ καθῆσθαι."	-- - -- -- u u -u u--	dactylic hexameter	masculine penthemimeral, hepthemimeral, trithemimeral
φράζεό μευ τὸν ἔρωθ᾽ ὅθεν ἵκετο, πότνα Σελάνα.	-uu - u u- uu -uu -u u--	dactylic hexameter	masculine penthemimeral, trithemimeral
"κἠπεί κά νιν ἐόντα μάθῃς μόνον, ἅσυχα νεῦσον,	-- - u u-u u- uu -uu --	dactylic hexameter	feminine penthemimeral, hepthemimeral, trithemimeral
κεἴφ᾽ ὅτι Σιμαίθα τυ καλεῖ, καὶ ὑφαγέο τᾷδε."	- uu --- u u- u u-uu --	dactylic hexameter	masculine penthemimeral, hepthemimeral
ὣς ἐφάμαν· ἁ δ᾽ἦνθε καὶ ἄγαγε τὸν λιπαρόχρων	- uu- - -u u -uu - uu--	dactylic hexameter	feminine penthemimeral, trithemimeral
εἰς ἐμὰ δώματα Δέλφιν· ἐγὼ δέ νιν ὡς ἐνόησα	- uu -uu -u u- u u - uu--	dactylic hexameter	feminine penthemimeral, hepthemimeral
ἄρτι θύρας ὑπὲρ οὐδὸν ἀμειβόμενον ποδὶ κούφῳ	-u u- uu -u u-uu- uu --	dactylic hexameter	feminine penthemimeral, trithemimeral
(φράζεό μευ τὸν ἔρωθ᾽ ὅθεν ἵκετο, πότνα Σελάνα)	-uu - u u- uu -uu -u u--	dactylic hexameter	masculine penthemimeral, trithemimeral
πᾶσα μὲν ἐψύχθην χιόνος πλέον, ἐν δὲ μετώπῳ	-u u -- --- uu - u u--	dactylic hexameter	hepthemimeral
ἱδρώς μευ κοχύδεσκεν ἴσον νοτίαισιν ἐέρσαις,	-- - uu-u u- uu-u u--	dactylic hexameter	feminine penthemimeral, hepthemimeral, trithemimeral
οὐδέ τι φωνᾶσαι δυνάμαν, οὐδ᾽ ὅσσον ἐν ὕπνῳ	-u u --- uu- - -u u --	dactylic hexameter	masculine penthemimeral, hepthemimeral
κνυζεῦνται φωνεῦντα φίλαν ποτὶ ματέρα τέκνα·	--- --u u- uu -uu --	dactylic hexameter	feminine penthemimeral, hepthemimeral, trithemimeral
ἀλλ᾽ ἐπάγην δαγῦδι καλὸν χρόα πάντοθεν ἴσα.	- uu- --u u- uu -uu --	dactylic hexameter	feminine penthemimeral, hepthemimeral, trithemimeral
φράζεό μευ τὸν ἔρωθ᾽ ὅθεν ἵκετο, πότνα Σελάνα.	-uu - u u- uu -uu -u u--	dactylic hexameter	masculine penthemimeral, trithemimeral
καί μ᾽ἐσιδὼν ὥστοργος, ἐπὶ χθονὸς ὄμματα πήξας	- uu- --u u- -- -uu --	lyric	
ἕξετ᾽ ἐπὶ κλιντῆρι καὶ ἑζόμενος φάτο μῦθον·	-u u- --u u -uu- uu --	dactylic hexameter	feminine penthemimeral, trithemimeral
ἦ ῥά με Σιμαίθα τόσον ἔφθασας, ὅσσον ἐγώ θην	- u u --- uu -uu -u u- -	dactylic hexameter	masculine penthemimeral
πρᾶν ποκα τὸν χαρίεντα τρέχων ἔφθασσα Φιλῖνον,	- uu - uu-u u- --u u--	dactylic hexameter	feminine penthemimeral, hepthemimeral, trithemimeral
ἐς τὸ τεὸν καλέσασα τόδε στέγος ἤ με παρῆμεν.	- u u- uu-u u- uu - u u--	dactylic hexameter	feminine penthemimeral, hepthemimeral, trithemimeral
φράζεό μευ τὸν ἔρωθ᾽ ὅθεν ἵκετο, πότνα Σελάνα.	-uu - u u- uu -uu -u u--	dactylic hexameter	masculine penthemimeral, trithemimeral
ἦνθον γάρ κεν ἐγώ, ναὶ τὸν γλυκὺν ἦνθον Ἔρωτα,	-- - u u- - - uu -u u--	dactylic hexameter	masculine penthemimeral, hepthemimeral, trithemimeral
ἢ τρίτος ἠὲ τέταρτος ἐὼν φίλος αὐτίκα νυκτός,	- uu -u u-u u- uu -uu --	dactylic hexameter	feminine penthemimeral, hepthemimeral
μᾶλα μὲν ἐν κόλποισι Διωνύσοιο φυλάσσων,	-u u - --u u---u u--	dactylic hexameter	feminine penthemimeral, trithemimeral
κρατὶ δ᾽ἔχων λεύκαν, Ἡρακλέος ἱερὸν ἔρνος,	-u u- -- --uu -uu --	dactylic hexameter	masculine penthemimeral, trithemimeral
πάντοθε πορφυρέαισι περὶ ζώστραισιν ἑλικτάν.	-uu -uu-u u- --u u--	dactylic hexameter	feminine penthemimeral, hepthemimeral
φράζεό μευ τὸν ἔρωθ᾽ ὅθεν ἵκετο, πότνα Σελάνα.	-uu - u u- uu -uu -u u--	dactylic hexameter	masculine penthemimeral, trithemimeral
καί μ᾽εἰ μέν κ᾽ἐδέχεσθε, τάδ᾽ ἦς φίλα· καὶ γὰρ ἐλαφρὸς	- - - uu-u u - uu - u u--	dactylic hexameter	feminine penthemimeral, hepthemimeral, trithemimeral
καὶ καλὸς πάντεσσι μετ᾽ ἠιθέοισι καλεῦμαι·	- -- --u u -uu-u u--	dactylic hexameter	feminine penthemimeral, trithemimeral
εὗδόν τ᾽,εἴ κε μόνον τὸ καλὸν στόμα τεῦς ἐφίλασα·	-- - u u- u u- uu - uu--	dactylic hexameter	masculine penthemimeral, hepthemimeral, trithemimeral
εἰ δ᾽ἀλλᾷ μ᾽ὠθεῖτε καὶ ἁ θύρα εἴχετο μοχλῷ,	- -- --u u - uu -uu --	dactylic hexameter	feminine penthemimeral, hepthemimeral, trithemimeral
πάντως καὶ πελέκεις καὶ λαμπάδες ἦνθον ἐφ᾽ ὑμέας.	-- - uu- - -uu -u u ---	lyric	
φράζεό μευ τὸν ἔρωθ᾽ ὅθεν ἵκετο, πότνα Σελάνα.	-uu - u u- uu -uu -u u--	dactylic hexameter	masculine penthemimeral, trithemimeral
νῦν δὲ χάριν μὲν ἔφαν τᾷ Κύπριδι πρᾶτον ὀφείλειν,	- u u- u u- - -uu -u u--	dactylic hexameter	masculine penthemimeral, trithemimeral
καὶ μετὰ τὰν Κύπριν τύ με δευτέρα ἐκ πυρὸς εἵλευ	- uu - -- u u -uu - uu --	dactylic hexameter	masculine penthemimeral, trithemimeral
ὦ γύναι ἐσκαλέσασα τεὸν ποτὶ τοῦτο μέλαθρον	- uu -uu-u u- uu -u u--	dactylic hexameter	feminine penthemimeral, hepthemimeral
αὔτως ἡμίφλεκτον· Ἔρως δ᾽ἄρα καὶ Λιπαραίω	-- ---u u- uu - uu--	dactylic hexameter	feminine penthemimeral, hepthemimeral
πολλάκις Ἡφαίστοιο σέλας φλογερώτερον αἴθει.	-uu ---u u- uu-uu --	dactylic hexameter	feminine penthemimeral, hepthemimeral
φράζεό μευ τὸν ἔρωθ᾽ ὅθεν ἵκετο, πότνα Σελάνα.	-uu - u u- uu -uu -u u--	dactylic hexameter	masculine penthemimeral, trithemimeral
"σὺν δὲ κακαῖς μανίαις καὶ παρθένον ἐκ θαλάμοιο	- u u- uu- - -uu - uu--	dactylic hexameter	masculine penthemimeral, trithemimeral
καὶ νύμφαν ἐφόβησ᾽ ἔτι δέμνια θερμὰ λιποῖσαν	- -- uu- uu -uu -u u--	dactylic hexameter	masculine penthemimeral, trithemimeral
ἀνέρος." ὣς ὁ μὲν εἶπεν· ἐγὼ δέ οἱ ἁ ταχυπειθὴς	-uu - u u -u u- u u - uu--	dactylic hexameter	feminine penthemimeral, hepthemimeral, trithemimeral
χειρὸς ἐφαψαμένα μαλακῶν ἔκλιν᾽ ἐπὶ λέκτρων.	-u u-uu- uu- -- uu --	dactylic hexameter	masculine penthemimeral, hepthemimeral
καὶ ταχὺ χρὼς ἐπὶ χρωτὶ πεπαίνετο, καὶ τὰ πρόσωπα	- uu - uu -u u-uu - u u--	dactylic hexameter	feminine penthemimeral, trithemimeral
θερμότερ᾽ ἦς ἢ πρόσθε, καὶ ἐψιθυρίσδομες ἁδύ·	-uu - - -u u -uu-uu --	dactylic hexameter	feminine penthemimeral, trithemimeral
χὥς κά τοι μὴ μακρὰ φίλα θρυλέοιμι Σελάνα,	- - - - -u u- uu-u u--	dactylic hexameter	feminine penthemimeral, hepthemimeral, trithemimeral
ἐπράχθη τὰ μέγιστα, καὶ ἐς πόθον ἤνθομες ἄμφω.	-- - --u u - uu -uu --	dactylic hexameter	feminine penthemimeral, hepthemimeral, trithemimeral
κοὔτέ τι τῆνος ἐμὶν ἐπεμέμψατο μέσφα τό γ᾽ἐχθές,	-u u -u u- uu-uu -u - -	lyric	
οὔτ᾽ ἐγὼ αὖ τήνῳ. ἀλλ᾽ ἦνθέ μοι ἅ τε Φιλίστας	- uu - -- - -u u - u u--	dactylic hexameter	masculine penthemimeral, trithemimeral
μάτηρ τᾶς ἀλαᾶς αὐλητρίδος ἅ τε Μελιξοῦς	-- - uu- --uu - u u--	dactylic hexameter	masculine penthemimeral, trithemimeral
σάμερον, ἁνίκα πέρ τε ποτ᾽ ὠρανὸν ἔτρεχον ἵπποι	-uu -uu - u u -uu -uu --	dactylic hexameter	masculine penthemimeral
Ἀῶ τὰν ῥοδόπαχυν ἀπ᾽ Ὠκεανοῖο φέροισαι.	-- - uu-u u -uu-u u--	dactylic hexameter	feminine penthemimeral, trithemimeral
κεἶπέ μοι ἄλλά τε πολλὰ καὶ ὡς ἄρα Δέλφις ἐρᾶται,	-u u -u u -u u - uu -u u--	dactylic hexameter	feminine penthemimeral, hepthemimeral
κεἴτέ νιν αὖτε γυναικὸς ἔχει πόθος εἴτε καὶ ἀνδρός,	-u u -u u-u u- uu -u u --	dactylic hexameter	feminine penthemimeral, hepthemimeral
οὐκ ἔφατ᾽ ἀτρεκὲς ἴδμεν, ἀτὰρ τόσον· αἰὲν Ἔρωτος	- uu -uu - -- uu -u u--	dactylic hexameter	masculine penthemimeral, hepthemimeral
ἀκράτω ἐπεχεῖτο καὶ ἐς τέλος ᾤχετο φεύγων,	-uu ---u u - uu -uu --	dactylic hexameter	feminine penthemimeral, hepthemimeral
καὶ φάτο οἱ στεφάνοισι τὰ δώματα τῆνα πυκάσδειν.	- uu - uu-u u -uu -u u--	dactylic hexameter	feminine penthemimeral, trithemimeral
ταῦτά μοι ἁ ξείνα μυθήσατο· ἔστι δ᾽ἀλαθής·	-u u - -- --uu -u u--	dactylic hexameter	masculine penthemimeral, trithemimeral
ἦ γάρ μοι καὶ τρὶς καὶ τετράκις ἄλλοκ᾽ ἐφοίτη,	- - - - - - -uu -u u--	dactylic hexameter	masculine penthemimeral, trithemimeral
καὶ παρ᾽ ἐμὶν ἐτίθει τὰν Δωρίδα πολλάκις ὄλπαν·	- u u- uu- - -uu -uu --	dactylic hexameter	masculine penthemimeral, trithemimeral
νῦν δέ τε δωδεκαταῖος ἀφ᾽ ὧτέ νιν οὐδὲ ποτεῖδον.	- u u -uu-u u -u u -u u--	dactylic hexameter	feminine penthemimeral
ἦ ῥ᾽οὐκ ἄλλό τι τερπνὸν ἔχει, ἁμῶν δὲ λέλασται;	- - -u u -u u- -- u u--	dactylic hexameter	feminine penthemimeral, hepthemimeral
νῦν μὲν τοῖς φίλτροις καταθύσομαι· αἰ δ᾽ἔτι κἠμὲ	- - - -- uu-uu - uu --	dactylic hexameter	masculine penthemimeral, trithemimeral
λυπῇ, τὰν Ἀίδαο πύλαν ναὶ Μοίρας ἀραξεῖ.	-- - uu-u u- - -u u--	dactylic hexameter	feminine penthemimeral, hepthemimeral, trithemimeral
τοῖά οἱ ἐν κίστᾳ κακὰ φάρμακα φαμὶ φυλάσσειν,	-u u - -- uu -uu -u u--	dactylic hexameter	masculine penthemimeral, trithemimeral
Ἀσσυρίω δέσποινα παρὰ ξείνοιο μαθοῖσα.	-uu- --u u- --u u--	dactylic hexameter	feminine penthemimeral, hepthemimeral, trithemimeral
ἀλλὰ τὺ μὲν χαίροισα ποτ᾽ Ὠκεανὸν τρέπε πώλους,	-u u - --u u -uu- uu --	dactylic hexameter	feminine penthemimeral, trithemimeral
πότνι᾽· ἐγὼ δ᾽οἰσῶ τὸν ἐμὸν πόνον ὥσπερ ὑπέσταν.	-u u- -- u u- uu -u u--	dactylic hexameter	masculine penthemimeral, hepthemimeral, trithemimeral
χαῖρε Σελαναία λιπαρόχροε, χαίρετε δ᾽ἄλλοι	-u u--- uu-uu -uu --	dactylic hexameter	masculine penthemimeral
ἀστέρες, εὐκήλοιο κατ᾽ ἄντυγα Νυκτὸς ὀπαδοί.	-uu ---u u -uu -u u--	dactylic hexameter	feminine penthemimeral
Κωμάσδω ποτὶ τὰν Ἀμαρυλλίδα, ταὶ δέ μοι αἶγες	--- uu - uu-uu - u u --	dactylic hexameter	masculine penthemimeral, trithemimeral
βόσκονται κατ᾽ ὄρος, καὶ ὁ Τίτυρος αὐτὰς ἐλαύνει.	--- u u- u u -uu -u u--	dactylic hexameter	masculine penthemimeral, trithemimeral
Τίτυρ᾽ ἐμὶν τὸ καλὸν πεφιλαμένε, βόσκε τὰς αἶγας,	-u u- u u- uu-uu -u u --	dactylic hexameter	masculine penthemimeral, trithemimeral
καὶ ποτὶ τὰν κράναν ἄγε Τίτυρε, καὶ τὸν ἐνόρχαν	- uu - uu -u u-- - u u--	dactylic hexameter	feminine penthemimeral, trithemimeral
τὸν Λιβυκὸν κνάκωνα φυλάσσεο, μή τι κορύψῃ.	- uu- --u u-uu - u u--	dactylic hexameter	feminine penthemimeral, trithemimeral
Ὠ χαρίεσσ᾽ Ἀμαρυλλί, τί μ᾽οὐκέτι τοῦτο κατ᾽ ἄντρον	- uu- uu-u u -uu -u u --	dactylic hexameter	feminine penthemimeral, trithemimeral
παρκύπτοισα καλεῖς τὸν ἐρωτύλον; ἦ ῥά με μισεῖς;	---u u- u u-uu - u u --	dactylic hexameter	masculine penthemimeral
ἦ ῥά γέ τοι σιμὸς καταφαίνομαι ἐγγύθεν ἦμεν,	- u u - -- uu-uu -uu --	dactylic hexameter	masculine penthemimeral, trithemimeral
νύμφα, καὶ προγένειος; ἀπάγξασθαί με ποησεῖς.	-- - uu-u u--- u u--	dactylic hexameter	feminine penthemimeral, trithemimeral
ἠνίδε τοι δέκα μᾶλα φέρω· τηνῶθε καθεῖλον,	-uu - uu -u u- --u u--	dactylic hexameter	feminine penthemimeral, hepthemimeral, trithemimeral
ὧ μ᾽ἐκέλευ καθελεῖν τύ· καὶ αὔριον ἄλλά τοι οἰσῶ.	- uu- uu- u u -uu -u u --	dactylic hexameter	masculine penthemimeral, trithemimeral
θᾶσαι μὰν θυμαλγὲς ἐμὸν ἄχος· αἴθε γενοίμαν	-- - --u u- uu -u u--	dactylic hexameter	feminine penthemimeral, hepthemimeral, trithemimeral
ἁ βομβεῦσα μέλισσα καὶ ἐς τεὸν ἄντρον ἱκοίμαν	- --u u-u u - uu -u u--	dactylic hexameter	feminine penthemimeral, hepthemimeral
τὸν κισσὸν διαδὺς καὶ τὰν πτέριν, ᾇ τὺ πυκάσδῃ.	- -- uu- - - uu - u u--	dactylic hexameter	masculine penthemimeral, hepthemimeral, trithemimeral
νῦν ἔγνων τὸν Ἔρωτα· βαρὺς θεός· ἦ ῥα λεαίνας	- -- u u-u u- uu - u u--	dactylic hexameter	feminine penthemimeral, hepthemimeral, trithemimeral
μαζὸν ἐθήλαζε, δρυμῷ τέ νιν ἔτρεφε μάτηρ,	-u u--- -- u u -uu --	dactylic hexameter	masculine penthemimeral, hepthemimeral
ὅς με κατασμύχων καὶ ἐς ὀστίον ἄχρις ἰάπτει.	- u u--- u u -uu -u u--	dactylic hexameter	masculine penthemimeral
ὦ τὸ καλὸν ποθορεῦσα, τὸ πᾶν λίθος· ὦ κυάνοφρυ	- u u- uu-u u - uu - uu--	dactylic hexameter	feminine penthemimeral, hepthemimeral, trithemimeral
νύμφα, πρόσπτυξαί με τὸν αἰπόλον, ὥς τυ φιλάσω.	-- --- u u -uu - u u--	dactylic hexameter	masculine penthemimeral
ἔστι καὶ ἐν κενεοῖσι φιλάμασιν ἁδέα τέρψις.	-u u - uu-u u-uu -uu --	dactylic hexameter	feminine penthemimeral, trithemimeral
τὸν στέφανον τῖλαί με κατ᾽ αὐτίκα λεπτὰ ποησεῖς,	- uu- -- u u -uu -u u--	dactylic hexameter	masculine penthemimeral, trithemimeral
τόν τοι ἐγὼν Ἀμαρυλλὶ φίλα κισσοῖο φυλάσσω	- u u- uu-u u- --u u--	dactylic hexameter	feminine penthemimeral, hepthemimeral, trithemimeral
ἀμπλέξας καλύκεσσι καὶ εὐόδμοισι σελίνοις.	--- uu-u u --- u--	lyric	
(Ὤμοι ἐγώ, τί πάθω; τί ὁ δύσσοος; οὐχ ὑπακούεις;)	-u u- u u- u u -uu - uu--	dactylic hexameter	masculine penthemimeral, trithemimeral
τὰν βαίταν ἀποδὺς ἐς κύματα τηνῶ ἁλεῦμαι,	- -- uu- - -uu -u u--	dactylic hexameter	masculine penthemimeral, trithemimeral
ὧπερ τὼς θύννως σκοπιάζεται Ὄλπις ὁ γριπεύς·	-- - -- uu-uu -u u --	dactylic hexameter	masculine penthemimeral, trithemimeral
καἴκα δἠποθάνω, τό γε μὰν τεὸν ἁδὺ τέτυκται.	-- -uu- u u - uu -u u--	dactylic hexameter	masculine penthemimeral, hepthemimeral
ἔγνων πρᾶν, ὅκα μευ μεμναμένω, εἰ φιλέεις με,	-- - uu - --uu - uu- -	dactylic hexameter	masculine penthemimeral, trithemimeral
οὐδὲ τὸ τηλέφιλον ποτεμάξατο, τὸ πλατάγημα,	-u u -uu- uu-uu - uu--	dactylic hexameter	masculine penthemimeral
ἀλλ᾽ αὔτως ἁπαλῷ ποτὶ πάχεος ἐξεμαράνθη.	- -- uu- uu -uu -uu--	dactylic hexameter	masculine penthemimeral, trithemimeral
εἶπε καὶ ἀγροιῶτις ἀλαθέα κοσκινόμαντις,	-u u ---u u-uu -uu--	dactylic hexameter	feminine penthemimeral
ἁ πρᾶν ποιολογεῦσα Παραιβάτις, οὕνεκ᾽ ἐγὼ μὲν	- - -uu-u u-uu -u u- -	dactylic hexameter	feminine penthemimeral
τὶν ὅλος ἔγκειμαι, τὺ δέ μευ λόγον οὐδένα ποιῇ.	- uu --- u u - uu -uu --	dactylic hexameter	masculine penthemimeral, hepthemimeral
ἦ μάν τοι λευκὰν διδυματόκον αἶγα φυλάσσω,	- - - -- uu-uu -u u--	dactylic hexameter	masculine penthemimeral, trithemimeral
τάν με καὶ ἁ Μέρμνωνος ἐριθακὶς ἁ μελανόχρως	- u u - --u u-uu - uu--	dactylic hexameter	feminine penthemimeral, trithemimeral
αἰτεῖ, καὶ δωσῶ οἱ, ἐπεὶ τύ μοι ἐνδιαθρύπτῃ.	-- - -- u u- u u -uu--	dactylic hexameter	masculine penthemimeral, hepthemimeral, trithemimeral
Ἅλλεται ὀφθαλμός μευ ὁ δεξιός· ἦ ῥά γ᾽ἰδησῶ	-uu --- u u -uu - u u--	dactylic hexameter	masculine penthemimeral
αὐτάν; ᾀσεῦμαι ποτὶ τὰν πίτυν ὧδ᾽ ἀποκλινθείς,	-- --- uu - uu - uu--	dactylic hexameter	masculine penthemimeral, hepthemimeral
καί κέ μ᾽ἴσως ποτίδοι, ἐπεὶ οὐκ ἀδαμαντίνα ἐστίν.	- u u- uu- uu - uu-uu --	dactylic hexameter	masculine penthemimeral, hepthemimeral, trithemimeral
Ἱππομένης ὅκα δὴ τὰν παρθένον ἤθελε γᾶμαι,	-uu- uu - - -uu -uu --	dactylic hexameter	masculine penthemimeral, trithemimeral
μᾶλ᾽ ἐν χερσὶν ἑλὼν δρόμον ἄνυεν· ἁ δ᾽Ἀταλάντα	- - -u u- uu -uu - uu--	dactylic hexameter	masculine penthemimeral
ὡς ἴδεν, ὡς ἐμάνη, ὡς ἐς βαθὺν ἅλατ᾽ ἔρωτα.	- uu - uu- - - uu -u u--	dactylic hexameter	masculine penthemimeral, hepthemimeral, trithemimeral
τὰν ἀγέλαν χὡ μάντις ἀπ᾽ Ὄθρυος ἆγε Μελάμπους	- uu- - -u u -uu -u u--	dactylic hexameter	feminine penthemimeral, trithemimeral
ἐς Πύλον· ἁ δὲ Βίαντος ἐν ἀγκοίναισιν ἐκλίνθη,	- uu - u u-u u ---u u--	dactylic hexameter	feminine penthemimeral, trithemimeral
μάτηρ ἁ χαρίεσσα περίφρονος Ἀλφεσιβοίης.	-- - uu-u u-uu -uu--	dactylic hexameter	feminine penthemimeral, trithemimeral
τὰν δὲ καλὰν Κυθέρειαν ἐν ὤρεσι μᾶλα νομεύων	- u u- uu-u u -uu -u u--	dactylic hexameter	feminine penthemimeral, trithemimeral
οὐχ οὑτῶς ὥδωνις ἐπὶ πλέον ἄγαγε λύσσας,	- -- --u u- uu -uu --	dactylic hexameter	feminine penthemimeral, hepthemimeral, trithemimeral
ὥστ᾽ οὐδὲ φθίμενόν νιν ἄτερ μαζοῖο τίθητι;	- -- uu- u u- --u u--	dactylic hexameter	masculine penthemimeral, hepthemimeral, trithemimeral
ζαλωτὸς μὲν ἐμὶν ὁ τὸν ἄτροπον ὕπνον ἰαύων	--- u u- u u -uu -u u--	dactylic hexameter	masculine penthemimeral, trithemimeral
Ἐνδυμίων, ζαλῶ δὲ φίλα γύναι Ἰασίωνα,	-uu- -- u u- uu -uu--	dactylic hexameter	masculine penthemimeral, hepthemimeral, trithemimeral
ὃς τοσσῆν᾽ ἐκύρησεν, ὅσ᾽ οὐ πευσεῖσθε βέβαλοι.	- -- uu-u u - --u u--	dactylic hexameter	feminine penthemimeral, hepthemimeral, trithemimeral
Ἀλγέω τὰν κεφαλάν, τὶν δ᾽οὐ μέλει. οὐκέτ᾽ ἀείδω,	-- - uu- - - uu -u u--	dactylic hexameter	masculine penthemimeral, hepthemimeral, trithemimeral
κεισεῦμαι δὲ πεσών, καὶ τοὶ λύκοι ὧδέ μ᾽ἔδονται.	--- u u- - - uu -u u--	dactylic hexameter	masculine penthemimeral, hepthemimeral, trithemimeral
ὡς μέλι τοι γλυκὺ τοῦτο κατὰ βρόχθοιο γένοιτο.	- uu - uu -u u- -- ---	dactylic hexameter	feminine penthemimeral, hepthemimeral, trithemimeral
εἰπέ μοι ὦ Κορύδων, τίνος αἱ βόες; ἦ ῥα Φιλώνδα;	-u u - uu- uu - uu - u u--	dactylic hexameter	masculine penthemimeral, hepthemimeral, trithemimeral
οὔκ, ἀλλ᾽ Αἴγωνος· βόσκειν δέ μοι αὐτὰς ἔδωκεν.	- - --- -- u u -u u--	dactylic hexameter	masculine penthemimeral, hepthemimeral
ἦ πᾴ ψε κρύβδαν τὰ ποθέσπερα πάσας ἀμέλγεις;	- - - -- u u-uu -u u--	dactylic hexameter	masculine penthemimeral, trithemimeral
ἀλλ᾽ ὁ γέρων ὑφίητι τὰ μοσχία κἠμὲ φυλάσσει.	- u u- uu-u u -uu -u u--	dactylic hexameter	feminine penthemimeral, trithemimeral
αὐτὸς δ᾽ἐς τίν᾽ ἄφαντος ὁ βουκόλος ᾤχετο χώραν;	-- - u u-u u -uu -uu --	dactylic hexameter	feminine penthemimeral, trithemimeral
οὐκ ἄκουσας; ἄγων νιν ἐπ᾽ Ἀλφεὸν ᾤχετο Μίλων.	- --u u- u u -uu -uu --	dactylic hexameter	masculine penthemimeral
καὶ πόκα τῆνος ἔλαιον ἐν ὀφθαλμοῖσιν ὀπώπει;	- uu -u u-u u ---u u--	dactylic hexameter	feminine penthemimeral
φαντί νιν Ἡρακλῆι βίην καὶ κάρτος ἐρίσδειν.	-- - ---u u- - -u u--	lyric	
κἤμ᾽ ἔφαθ᾽ ἁ μάτηρ Πολυδεύκεος εἶμεν ἀμείνω.	- -- u u- uu-uu -u u--	dactylic hexameter	masculine penthemimeral, trithemimeral
κᾤχετ᾽ ἔχων σκαπάναν τε καὶ εἴκατι τουτόθε μᾶλα.	-u u- uu- u u -uu -uu --	dactylic hexameter	masculine penthemimeral, trithemimeral
πείσαι τοι Μίλων καὶ τὼς λύκος αὐτίκα λυσσῆν.	-- - -- - - uu -uu --	dactylic hexameter	masculine penthemimeral, hepthemimeral, trithemimeral
ταὶ δαμάλαι δ᾽αὐτὸν μυκώμεναι αἵδε ποθεῦντι.	- uu- -- --uu -u u--	dactylic hexameter	masculine penthemimeral, trithemimeral
δειλαῖαί γ᾽αὗται· τὸν βουκόλον ὡς κακὸν εὗρον.	--- -- - -uu - uu --	dactylic hexameter	masculine penthemimeral, trithemimeral
ἦ μὰν δειλαῖαί γε, καὶ οὐκέτι λῶντι νέμεσθαι.	- - --- u u -uu -u u--	dactylic hexameter	masculine penthemimeral
τήνας μὲν δή τοι τᾶς πόρτιος αὐτὰ λέλειπται	-- - - - - -uu -u u--	dactylic hexameter	masculine penthemimeral, trithemimeral
τὠστία. μὴ πρῶκας σιτίζεται ὥσπερ ὁ τέττιξ;	-uu - -- --uu -u u --	dactylic hexameter	masculine penthemimeral, trithemimeral
οὐ Δᾶν, ἀλλ᾽ ὁκὰ μέν νιν ἐπ᾽ Αἰσάροιο νομεύω	- - - uu - u u ---u u--	dactylic hexameter	masculine penthemimeral, trithemimeral
καὶ μαλακῶ χόρτοιο καλὰν κώμυθα δίδωμι,	- uu- --u u- --u u--	dactylic hexameter	feminine penthemimeral, hepthemimeral, trithemimeral
ἄλλοκα δὲ σκαίρει τὸ βαθύσκιον ἀμφὶ Λάτυμνον.	-uu - -- u u-uu -u u--	dactylic hexameter	masculine penthemimeral, trithemimeral
λεπτὸς μὰν χὡ ταῦρος ὁ πυρρίχος. εἴθε λάχοιεν	-- - - -u u -uu -u u--	dactylic hexameter	feminine penthemimeral, trithemimeral
τοὶ τῶ Λαμπριάδα, τοὶ δαμόται, ὅκκα θύωντι	- - -uu- - -uu -u u--	dactylic hexameter	masculine penthemimeral
τᾷ Ἥρᾳ, τοιόνδε· κακοχράσμων γὰρ ὁ δᾶμος.	- -- --u u--- u u --	dactylic hexameter	feminine penthemimeral, trithemimeral
καὶ μὰν ἐς Στομάλιμνον ἐλαύνεται ἔς τε τὰ Φύσκω,	- - - uu-u u-uu - u u --	dactylic hexameter	feminine penthemimeral, trithemimeral
καὶ ποτὶ τὸν Νήαιθον, ὅπᾳ καλὰ πάντα φύοντι,	- uu - --u u- uu -u u--	dactylic hexameter	feminine penthemimeral, hepthemimeral, trithemimeral
αἰγίπυρος καὶ κνύζα καὶ εὐώδης μελίτεια.	-uu- - -u u --- uu--	dactylic hexameter	feminine penthemimeral, trithemimeral
φεῦ φεῦ βασεῦνται καὶ ταὶ βόες ὦ τάλαν Αἴγων	- - --- - - uu - uu --	dactylic hexameter	masculine penthemimeral, hepthemimeral
εἰς Ἀίδαν, ὅκα καὶ τὺ κακᾶς ἠράσσαο νίκας,	- uu- uu - u u- --uu --	dactylic hexameter	masculine penthemimeral, hepthemimeral, trithemimeral
χἁ σῦριγξ εὐρῶτι παλύνεται, ἅν ποκ᾽ ἐπάξα.	- -- --u u-uu - u u--	dactylic hexameter	feminine penthemimeral, trithemimeral
οὐ τήνα γ᾽,οὐ Νύμφας, ἐπεὶ ποτὶ Πῖσαν ἀφέρπων	- -- - -u u- uu -u u--	dactylic hexameter	feminine penthemimeral, hepthemimeral, trithemimeral
δῶρον ἐμοί νιν ἔλειπεν· ἐγὼ δέ τις εἰμὶ μελικτάς,	-u u- u u-u u- u u -u u--	dactylic hexameter	feminine penthemimeral, hepthemimeral, trithemimeral
κεὖ μὲν τὰ Γλαύκας ἀγκρούομαι, εὖ δὲ τὰ Πύρρω.	- - - -- --uu - u u --	dactylic hexameter	masculine penthemimeral, trithemimeral
αἰνέω τάν τε Κρότωνα, καλὰ πόλις, ἅ τε Ζάκυνθος	-- - u u-u u- uu - u u--	dactylic hexameter	feminine penthemimeral, hepthemimeral, trithemimeral
καὶ τὸ ποταῷον, τὸ Λακίνιον ᾇπερ ὁ πύκτας	- u u--- u u-uu -u u --	dactylic hexameter	masculine penthemimeral
Αἴγων ὀγδώκοντα μόνος κατεδαίσατο μάζας.	-- ---u u- uu-uu --	dactylic hexameter	feminine penthemimeral, hepthemimeral
τηνεῖ καὶ τὸν ταῦρον ἀπ᾽ ὤρεος ἆγε πιάξας	-- - - -u u -uu -u u--	dactylic hexameter	feminine penthemimeral, trithemimeral
τᾶς ὁπλᾶς κἤδωκ᾽ Ἀμαρυλλίδι, ταὶ δὲ γυναῖκες	- -- -- uu-uu - u u--	dactylic hexameter	masculine penthemimeral, trithemimeral
μακρὸν ἀνάυσαν, χὡ βουκόλος ἐξεγέλασσεν.	-u u-- - --- -uu--	dactylic hexameter	masculine penthemimeral
ὦ χαρίεσσ᾽ Ἀμαρυλλί, μόνας σέθεν οὐδὲ θανοίσας	- uu- uu-u u- uu -u u--	dactylic hexameter	feminine penthemimeral, hepthemimeral, trithemimeral
λασεύμεσθ᾽· ὅσον αἶγες ἐμὶν φίλαι, ὅσσον ἀπέσβης.	--- uu -u u- uu -u u--	dactylic hexameter	feminine penthemimeral, hepthemimeral, trithemimeral
αἰαῖ τῶ σκληρῶ μάλα δαίμονος, ὅς με λελόγχει.	-- - -- uu -uu - u u--	dactylic hexameter	masculine penthemimeral, trithemimeral
θαρσεῖν χρὴ φίλε Βάττε· τάχ᾽ αὔριον ἔσσετ᾽ ἄμεινον.	-- - uu -u u -uu -u u--	dactylic hexameter	feminine penthemimeral, trithemimeral
ἐλπίδες ἐν ζωοῖσιν, ἀνέλπιστοι δὲ θανόντες.	-uu - --u u--- u u--	dactylic hexameter	feminine penthemimeral, trithemimeral
χὡ Ζεὺς ἄλλοκα μὲν πέλει αἴθριος, ἄλλοκα δ᾽ὕει.	- - -uu - uu -uu -uu --	dactylic hexameter	masculine penthemimeral
θαρσέω. βάλλε κάτωθε τὰ μοσχία· τᾶς γὰρ ἐλαίας	-- -u u-u u -uu - u u--	dactylic hexameter	feminine penthemimeral
τὸν θαλλὸν τρώγοντι τὰ δύσσοα. σίτθ᾽ ὁ λέπαργος.	- -- --u u -uu - u u--	dactylic hexameter	feminine penthemimeral, trithemimeral
σίτθ᾽ ἁ Κυμαίθα ποτὶ τὸν λόφον. οὐκ ἐσακούεις;	- - --- uu - uu - uu--	dactylic hexameter	masculine penthemimeral, hepthemimeral
ἡξῶ ναὶ τὸν Πᾶνα κακὸν τέλος αὐτίκα δωσῶν,	-- - - -u u- uu -uu --	dactylic hexameter	feminine penthemimeral, hepthemimeral, trithemimeral
εἰ μὴ ἄπει τουτῶθεν. ἴδ᾽ αὖ πάλιν ἅδε ποθέρπει.	- u u- --u u - uu -u u--	dactylic hexameter	feminine penthemimeral, hepthemimeral, trithemimeral
εἴθ᾽ ἦν μοι ῥοικὸν τὸ λαγωβόλον, ὥς τυ πάταξα.	- - - -- u u-uu - u u--	dactylic hexameter	masculine penthemimeral, trithemimeral
θᾶσαί μ᾽ὦ Κορύδων πὸτ τῶ Διός· ἁ γὰρ ἄκανθα	-- - uu- - - uu - u u--	dactylic hexameter	masculine penthemimeral, hepthemimeral, trithemimeral
ἀρμοῖ μ᾽ὧδ᾽ ἐπάταξ᾽ ὑπὸ τὸ σφυρόν. ὡς δὲ βαθεῖαι	-- - uu- uu - uu - u u--	dactylic hexameter	masculine penthemimeral, hepthemimeral, trithemimeral
τἀτρακτυλλίδες ἐντί. κακῶς ἁ πόρτις ὄλοιτο·	---uu -u u- - -u u--	dactylic hexameter	feminine penthemimeral, hepthemimeral
ἐς ταύταν ἐτύπην χασμεύμενος. ἦ ῥά γε λεύσσεις;	- -- uu- --uu - u u --	dactylic hexameter	masculine penthemimeral, trithemimeral
ναὶ ναί, τοῖς ὀνύχεσσιν ἔχω τέ νιν· ἅδε καὶ αὐτά.	- - - uu-u u- u u -u u --	dactylic hexameter	feminine penthemimeral, hepthemimeral, trithemimeral
ὁσσίχον ἐστὶ τὸ τύμμα καὶ ἁλίκον ἄνδρα δαμάζει.	-uu -u u -u u -uu -u u--	dactylic hexameter	feminine penthemimeral
εἰς ὄρος ὅκχ᾽ ἕρπῃς, μὴ νήλιπος ἔρχεο Βάττε.	- uu - -- - -uu -uu --	dactylic hexameter	masculine penthemimeral, trithemimeral
ἐν γὰρ ὄρει ῥάμνοί τε καὶ ἀσπάλαθοι κομέονται.	- u u- -- u u -uu- uu--	dactylic hexameter	masculine penthemimeral, trithemimeral
εἴπ᾽ ἄγε μ᾽ὦ Κορύδων, τὸ γερόντιον ἦ ῥα διώκει,	- uu - uu- u u-uu - u u--	dactylic hexameter	masculine penthemimeral, trithemimeral
τήναν τὰν κυάνοφρυν ἐρωτίδα, τᾶς ποκ᾽ ἐκνίσθη;	-- - uu-u u-uu - u u--	dactylic hexameter	feminine penthemimeral, trithemimeral
ἀκμάν γ᾽ὦ δειλαῖε· πρόαν γε μὲν αὐτὸς ἐπενθὼν	-- - --u u- u u -u u--	dactylic hexameter	feminine penthemimeral, hepthemimeral, trithemimeral
καὶ ποτὶ τᾷ μάνδρᾳ κατελάμβανον ἆμος ἐνήργει.	- uu - -- uu-uu -u u--	dactylic hexameter	masculine penthemimeral, trithemimeral
εὖ γ᾽ὤνθρωπε φιλοῖφα. τό τοι γένος ἢ Σατυρίσκοις	- --u u-u u - uu - uu--	dactylic hexameter	feminine penthemimeral, hepthemimeral
ἐγγύθεν ἢ Πάνεσσι κακοκνάμοισιν ἐρίσδεις.	-uu - --u u---u u--	dactylic hexameter	feminine penthemimeral, trithemimeral
αἶγες ἐμαί, τῆνον τὸν ποιμένα τόνδε Σιβύρτα	-u u- -- - -uu -u u--	dactylic hexameter	masculine penthemimeral, trithemimeral
φεύγετε τὸν Λάκωνα· τό μευ νάκος ἐχθὲς ἔκλεψεν.	-uu - --u u - uu - ---	dactylic hexameter	feminine penthemimeral, hepthemimeral, trithemimeral
οὐκ ἀπὸ τᾶς κράνας; σίττ᾽ ἀμνίδες. οὐκ ἐσορῆτε	- uu - -- - -uu - uu--	dactylic hexameter	masculine penthemimeral, trithemimeral
τόν μευ τὰν σύριγγα πρόαν κλέψαντα Κομάταν;	- - - --u u- --u u--	dactylic hexameter	feminine penthemimeral, hepthemimeral, trithemimeral
τὰν ποίαν σύριγγα; τὺ γάρ ποκα δῶλε Σιβύρτα	- -- --u u - uu -u u--	dactylic hexameter	feminine penthemimeral, hepthemimeral, trithemimeral
ἐκτάσα σύριγγα; τί δ᾽οὐκέτι σὺν Κορύδωνι	-uu --- - -uu - uu--	dactylic hexameter	masculine penthemimeral
ἀρκεῖ τοι καλάμας αὐλὸν ποππύσδεν ἔχοντι;	-- - uu- -- --u u--	dactylic hexameter	masculine penthemimeral, hepthemimeral, trithemimeral
τάν μοι ἔδωκε Λύκων ὦλεύθερε. τὶν δὲ τὸ ποῖον	- u u-u u- --uu - u u --	dactylic hexameter	masculine penthemimeral
Λάκων ἀγκλέψας πόκ᾽ ἔβα νάκος; εἰπὲ Κομάτα·	-- --- u u- uu -u u--	dactylic hexameter	masculine penthemimeral, hepthemimeral
οὐδὲ γὰρ Εὐμάρᾳ τῷ δεσπότᾳ ἦς τι ἐνεύδειν.	-u u --- - -uu - u u--	dactylic hexameter	masculine penthemimeral
τὸ Κροκύλος μοι ἔδωκε, τὸ ποικίλον, ἁνίκ᾽ ἔθυσε	- uu- u u-u u -uu -u u--	dactylic hexameter	feminine penthemimeral, trithemimeral
ταῖς Νύμφαις τὰν αἶγα· τὺ δ᾽ὦ κακὲ καὶ τόκ᾽ ἐτάκευ	- -- - -u u - uu - u u--	dactylic hexameter	feminine penthemimeral, hepthemimeral, trithemimeral
βασκαίνων, καὶ νῦν με τὰ λοίσθια γυμνὸν ἔθηκας.	--- - - u u -uu -u u--	dactylic hexameter	masculine penthemimeral, trithemimeral
οὐκ αὐτὸν τὸν Πᾶνα τὸν ἄκτιον, οὐ τέ γε Λάκων	- -- - -u u -uu - u u --	dactylic hexameter	feminine penthemimeral, trithemimeral
τὰν βαίταν ἀπέδυσ᾽ ὁ Καλαιθίδος, ἢ κατὰ τήνας	- -- uu- u u-uu - uu --	dactylic hexameter	masculine penthemimeral, trithemimeral
τᾶς πέτρας ὤνθρωπε μανεὶς ἐς Κρᾶθιν ἁλοίμαν.	- -- --u u- - -u u--	dactylic hexameter	feminine penthemimeral, hepthemimeral, trithemimeral
οὐ μὰν οὐκ αὐτὰς τὰς λιμνάδας ὦγαθὲ Νύμφας,	- - - -- - -uu -uu --	dactylic hexameter	masculine penthemimeral, trithemimeral
αἵτέ μοι ἵλαοί τε καὶ εὐμενέες τελέθοιεν,	-u u --- u u -uu- uu--	dactylic hexameter	masculine penthemimeral
οὔ τευ τὰν σύριγγα λαθὼν ἔκλεψε Κομάτας.	- - - --u u- --u u--	dactylic hexameter	feminine penthemimeral, hepthemimeral, trithemimeral
αἴ τοι πιστεύσαιμι, τὰ Δάφνιδος ἄλγε᾽ ἀροίμαν.	- - ---u u -uu -u u--	dactylic hexameter	feminine penthemimeral
ἀλλ᾽ ὦν αἴκα λῇς ἔριφον θέμεν, ἔστι μὲν οὐδὲν	- - -- - uu- uu -u u --	dactylic hexameter	masculine penthemimeral, hepthemimeral
ἱερόν, ἀλλά γε τοι διαείσομαι, ἕστέ κ᾽ἀπείπῃς.	-uu -u u - uu-uu -u u--	dactylic hexameter	masculine penthemimeral
ὗς ποτ᾽ Ἀθαναίαν ἔριν ἤρισεν. ἠνίδε κεῖται	- u u--- uu -uu -uu --	dactylic hexameter	masculine penthemimeral
ὥριφος· ἀλλά γε καὶ τὺ τὸν εὔβοτον ἀμνὸν ἔρισδε.	-uu -u u - u u -uu -u u--	dactylic hexameter	masculine penthemimeral
καὶ πῶς ὦ κίναδος τὺ τάδ᾽ ἔσσεται ἐξ ἴσω ἁμίν;	- - - u-- u u -uu - uu --	lyric	
τίς τρίχας ἀντ᾽ ἐρίων ἐποκίξατο; τίς δὲ παρεύσας	- uu - uu- uu-uu - u u--	dactylic hexameter	masculine penthemimeral, trithemimeral
αἰγὸς πρατοτόκοιο κακὰν κύνα δήλετ᾽ ἀμέλγειν;	-- -uu-u u- uu -u u--	dactylic hexameter	feminine penthemimeral, hepthemimeral
ὅστις νικασεῖν τὸν πλατίον ὡς τὺ πεποίθεις,	-- --- - -uu - u u--	dactylic hexameter	masculine penthemimeral
σφὰξ βομβέων τέττιγος ἐναντίον. ἀλλὰ γὰρ οὔ τοι	- -- --u u-uu -u u - -	dactylic hexameter	feminine penthemimeral, trithemimeral
ὥριφος ἰσοπαλής, τυῖδ᾽ ὁ τράγος οὗτος. ἔρισδε.	-uu -uu- - - uu -u u--	dactylic hexameter	masculine penthemimeral, hepthemimeral
μὴ σπεῦδ᾽· οὐ γάρ τοι πυρὶ θάλπεαι. ἅδιον ᾀσῇ	- - - - - uu -uu -uu --	dactylic hexameter	masculine penthemimeral, trithemimeral
τεῖδ᾽ ὑπὸ τὰν κότινον καὶ τἄλσεα ταῦτα καθίξας.	- uu - uu- - -uu -u u--	dactylic hexameter	masculine penthemimeral, trithemimeral
ψυχρὸν ὕδωρ τουτεῖ καταλείβεται· ὧδε πεφύκει	-u u- -- uu-uu -u u--	dactylic hexameter	masculine penthemimeral, trithemimeral
ποία χἁ στιβὰς ἅδε, καὶ ἀκρίδες ὧδε λαλεῦντι.	-- - uu -u u -uu -u u--	dactylic hexameter	feminine penthemimeral, trithemimeral
ἀλλ᾽ οὔ τι σπεύδω· μέγα δ᾽ἄχθομαι, εἰ τύ με τολμῇς	- - - -- uu -- - u u --	dactylic hexameter	masculine penthemimeral, trithemimeral
ὄμμασι τοῖς ὀρθοῖσι ποτιβλέπεν, ὅν ποκ᾽ ἐόντα	-uu - --u u-uu - u u--	dactylic hexameter	feminine penthemimeral, trithemimeral
παῖδ᾽ ἔτ᾽ ἐγὼν ἐδίδασκον. ἴδ᾽ ἁ χάρις ἐς τί ποθ᾽ ἕρπει.	- u u- uu-u u - uu - u u --	dactylic hexameter	feminine penthemimeral, hepthemimeral, trithemimeral
θρέψαι καὶ λυκιδεῖς, θρέψαι κύνας, ὥς τυ φάγωντι.	-- - uu- -- uu - u u--	dactylic hexameter	masculine penthemimeral, hepthemimeral, trithemimeral
καὶ πόκ᾽ ἐγὼ παρὰ τεῦς τι μαθὼν καλὸν ἢ καὶ ἀκούσας	- u u- uu - u u- uu - u u--	dactylic hexameter	masculine penthemimeral, hepthemimeral, trithemimeral
μέμναμ᾽; ὦ φθονερὸν τὺ καὶ ἀπρεπὲς ἀνδρίον αὔτως.	-- - uu- u u -uu -uu --	dactylic hexameter	masculine penthemimeral, trithemimeral
ἀλλὰ γὰρ ἕρφ᾽ ὦδ᾽, ἕρπε, καὶ ὕστατα βουκολιαξῇ.	-u u - - -u u -uu -uu--	dactylic hexameter	feminine penthemimeral, trithemimeral
οὐχ ἑρψῶ τηνεῖ· τουτεῖ δρύες, ὧδε κύπειρος,	- -- -- -- uu -u u--	dactylic hexameter	masculine penthemimeral, hepthemimeral, trithemimeral
ὧδε καλὸν βομβεῦντι ποτὶ σμήνεσσι μέλισσαι·	-u u- --u u- --u u--	dactylic hexameter	feminine penthemimeral, hepthemimeral, trithemimeral
ἔνθ᾽ ὕδατος ψυχρῶ κρᾶναι δύο· ταὶ δ᾽ἐπὶ δένδρει	- uu- -- -- uu - uu --	dactylic hexameter	masculine penthemimeral, hepthemimeral, trithemimeral
ὄρνιχες λαλαγεῦντι· καὶ ἁ σκιὰ οὐδὲν ὁμοία	--- uu-u u - uu -u u--	dactylic hexameter	feminine penthemimeral, hepthemimeral, trithemimeral
τᾷ παρὰ τίν· βάλλει δὲ καὶ ἁ πίτυς ὑψόθε κώνοις.	- uu - -- u u - uu -uu --	dactylic hexameter	masculine penthemimeral, hepthemimeral, trithemimeral
ἦ μὰν ἀρνακίδας τε καὶ εἴρια τεῖδε πατησεῖς,	- - -uu- u u -uu -u u--	dactylic hexameter	masculine penthemimeral
αἴκ᾽ ἔνθῃς, ὕπνω μαλακώτερα· ταὶ δὲ τραγεῖαι	- -- -- uu-uu - u u--	dactylic hexameter	masculine penthemimeral, trithemimeral
ταὶ παρὰ τὶν ὄσδοντι κακώτερον ἢ τύ περ ὄσδεις.	- uu - --u u-uu - u u --	dactylic hexameter	feminine penthemimeral, trithemimeral
στασῶ δὲ κρατῆρα μέγαν λευκοῖο γάλακτος	-- - --u u- --u u--	dactylic hexameter	feminine penthemimeral, hepthemimeral, trithemimeral
ταῖς Νύμφαις, στασῶ δὲ καὶ ἁδέος ἄλλον ἐλαίω.	- -- -- u u -uu -u u--	dactylic hexameter	masculine penthemimeral, trithemimeral
αἰ δέ κε καὶ τὺ μόλῃς, ἁπαλὰν πτέριν ὧδε πατησεῖς	- u u - u u- uu- uu -u u--	dactylic hexameter	masculine penthemimeral, hepthemimeral, trithemimeral
καὶ γλάχων᾽ ἀνθεῦσαν· ὑπεσσεῖται δὲ χιμαιρᾶν	- -- --u u--- u u--	dactylic hexameter	feminine penthemimeral, trithemimeral
δέρματα τῶν παρὰ τὶν μαλακώτερα τετράκις ἀρνῶν.	-uu - uu - uu-uu -uu --	dactylic hexameter	masculine penthemimeral, trithemimeral
στασῶ δ᾽ὀκτὼ μὲν γαυλὼς τῷ Πανὶ γάλακτος,	-- -- - -- - -u u--	dactylic hexameter	masculine penthemimeral, hepthemimeral
ὀκτὼ δὲ σκαφίδας μέλιτος πλέα κηρί᾽ ἐχοίσας.	-- - uu- uu- uu -u u--	dactylic hexameter	masculine penthemimeral, hepthemimeral, trithemimeral
αὐτόθε μοι ποτέρισδε καὶ αὐτόθε βουκολιάσδευ·	-uu - uu-u u -uu -uu--	dactylic hexameter	feminine penthemimeral, trithemimeral
τὰν σαυτῶ πατέων ἔχε τὰς δρύας. ἀλλὰ τίς ἄμμε	- -- uu- uu - uu -u u --	dactylic hexameter	masculine penthemimeral, hepthemimeral, trithemimeral
τίς κρινεῖ; αἴθ᾽ ἔνθοι πόθ᾽ ὁ βουκόλος ὧδ᾽ ὁ Λυκώπας.	- uu - -- u u -uu - u u--	dactylic hexameter	masculine penthemimeral, trithemimeral
οὐδὲν ἐγὼ τήνω ποτιδεύομαι· ἀλλὰ τὸν ἄνδρα,	-u u- -- uu-uu -u u --	dactylic hexameter	masculine penthemimeral, trithemimeral
αἰ λῇς, τὸν δρυτόμον βωστρήσομες, ὃς τὰς ἐρείκας	- - - uu- --uu - u u--	dactylic hexameter	masculine penthemimeral, trithemimeral
τήνας τὰς παρὰ τὶν ξυλοχίζεται· ἔστι δὲ Μόρσων.	-- - uu - uu-uu -u u --	dactylic hexameter	masculine penthemimeral, trithemimeral
βωστρέωμες. τὺ κάλει νιν. ἴθ᾽ ὦ ξένε μικκὸν ἄκουσον	--- u u- u u - uu -u u--	dactylic hexameter	masculine penthemimeral, hepthemimeral, trithemimeral
τεῖδ᾽ ἐνθών· ἄμμες γὰρ ἐρίσδομες, ὅστις ἀρείων	- -- -- u u-uu -u u--	dactylic hexameter	masculine penthemimeral, trithemimeral
βουκολιαστάς ἐστι. τὺ δ᾽ὦ φίλε μήτ᾽ ἐμὲ Μόρσων	-uu-- -u u - uu - uu --	dactylic hexameter	feminine penthemimeral, hepthemimeral
ἐν χάριτι κρίνῃς, μήτ᾽ ὦν τύγα τοῦτον ὀνάσῃς.	- uu- -- - - uu -u u--	dactylic hexameter	masculine penthemimeral, hepthemimeral, trithemimeral
ναὶ ποτὶ τᾶν Νυμφᾶν Μόρσων φίλε μήτε Κομάτᾳ	- uu - -- -- uu -u u--	dactylic hexameter	masculine penthemimeral, hepthemimeral, trithemimeral
τὸ πλέον ἰθύνῃς, μήτ᾽ ὦν τύγα τῷδε χαρίξῃ.	- uu --- - - uu -u u--	dactylic hexameter	masculine penthemimeral, hepthemimeral
ἅδέ τοι ἁ ποίμνα τῶ Θουρίω ἐστὶ Σιβύρτα,	-u u - -- - -uu -u u--	dactylic hexameter	masculine penthemimeral, trithemimeral
Εὐμάρα δὲ τὰς αἶγας ὁρῇς φίλε τῶ Συβαρίτα.	-uu - - -u u- uu - uu--	dactylic hexameter	feminine penthemimeral, hepthemimeral, trithemimeral
μή τύ τις ἠρώτη πὸτ τῶ Διός, αἴτε Σιβύρτα	- u u --- - - uu -u u--	dactylic hexameter	masculine penthemimeral, hepthemimeral
αἴτ᾽ ἐμόν ἐστι κάκιστε τὸ ποίμνιον; ὡς λάλος ἐσσί.	- uu -u u-u u -uu - uu --	dactylic hexameter	feminine penthemimeral
βέντισθ᾽ οὗτος, ἐγὼ μὲν ἀλαθέα πάντ᾽ ἀγορεύω	-- -u u- u u-uu - uu--	dactylic hexameter	masculine penthemimeral
κοὐδὲν καυχέομαι· τὺ δ᾽ἄγαν φιλοκέρτομος ἐσσί.	-- -uu- u u- uu-uu --	dactylic hexameter	masculine penthemimeral, hepthemimeral
εἶα λέγ᾽ εἴ τι λέγεις, καὶ τὸν ξένον ἐς πόλιν αὖθις	-u u - u u- - - uu - uu --	dactylic hexameter	masculine penthemimeral, hepthemimeral, trithemimeral
ζῶντ᾽ ἄφες· ὦ Παιάν, ἦ στωμύλος ἦσθα Κομάτα.	- uu - -- - -uu -u u--	dactylic hexameter	masculine penthemimeral, trithemimeral
ταὶ Μοῖσαί με φιλεῦντι πολὺ πλέον ἢ τὸν ἀοιδὸν	- -- u u-u u- uu - u u--	dactylic hexameter	feminine penthemimeral, hepthemimeral, trithemimeral
Δάφνιν· ἐγὼ δ᾽αὐταῖς χιμάρως δύο πρᾶν ποκ᾽ ἔθυσα.	-u u- -- uu- uu - u u--	dactylic hexameter	masculine penthemimeral, hepthemimeral, trithemimeral
καὶ γὰρ ἔμ᾽ ὡπόλλων φιλέει μέγα, καὶ καλὸν αὐτῷ	- u u --- uu- uu - uu --	dactylic hexameter	masculine penthemimeral, hepthemimeral
κριὸν ἐγὼ βόσκω. τὰ δὲ Κάρνεα καὶ δὴ ἐφέρπει.	-u u- -- u u -uu - u u--	dactylic hexameter	masculine penthemimeral, trithemimeral
πλὰν δύο τὰς λοιπὰς διδυματόκος αἶγας ἀμέλγω,	- uu - -- uu-uu -u u--	dactylic hexameter	masculine penthemimeral, trithemimeral
καί μ᾽ἁ παῖς ποθορεῦσα "τάλαν" λέγει "αὐτὸς ἀμέλγεις;"	- - - uu-u u- uu -u u--	dactylic hexameter	feminine penthemimeral, hepthemimeral, trithemimeral
φεῦ φεῦ Λάκων τοι ταλάρως σχεδὸν εἴκατι πληροῖ	- - -- - uu- uu -uu --	dactylic hexameter	masculine penthemimeral, hepthemimeral
τυρῶ καὶ τὸν ἄναβον ἐν ἄνθεσι παῖδα μολύνει.	-- - u u-u u -uu -u u--	dactylic hexameter	feminine penthemimeral, trithemimeral
βάλλει καὶ μάλοισι τὸν αἰπόλον ἁ Κλεαρίστα	-- - --u u -uu - uu--	dactylic hexameter	feminine penthemimeral, trithemimeral
τὰς αἶγας παρελᾶντα καὶ ἁδύ τι ποππυλιάσδει.	- -- uu-u u -u u -uu--	dactylic hexameter	feminine penthemimeral, trithemimeral
κἠμὲ γὰρ ὁ Κρατίδας τὸν ποιμένα λεῖος ὑπαντῶν	-u u - uu- - -uu -u u--	dactylic hexameter	masculine penthemimeral, trithemimeral
ἐκμαίνει· λιπαρὰ δὲ παρ᾽ αὐχένα σείετ᾽ ἔθειρα.	--- uu- u u -uu -u u--	dactylic hexameter	masculine penthemimeral, trithemimeral
ἀλλ᾽ οὐ σύμβλητ᾽ ἐστὶ κυνόσβατος οὐδ᾽ ἀνεμώνα	- - -- -u u-uu - uu--	dactylic hexameter	feminine penthemimeral
πρὸς ῥόδα, τῶν ἄνδηρα παρ᾽ αἱμασιαῖσι πεφύκει.	- uu - --u u -uu-u u--	dactylic hexameter	feminine penthemimeral, trithemimeral
οὐδὲ γὰρ οὐδ᾽ ἀκύλοις ὁμομαλίδες· αἱ μὲν ἔχοντι	-u u - uu- uu-uu - u u--	dactylic hexameter	masculine penthemimeral, trithemimeral
λυπρὸν ἀπὸ πρίνοιο λεπύριον, αἱ δὲ μελιχραί.	-u u- --u u-uu - u u--	dactylic hexameter	feminine penthemimeral, trithemimeral
κἠγὼ μὲν δωσῶ τᾷ παρθένῳ αὐτίκα φάσσαν	-- - -- - -uu -uu --	dactylic hexameter	masculine penthemimeral, trithemimeral
ἐκ τᾶς ἀρκεύθω καθελών· τηνεῖ γὰρ ἐφίσδει.	- - --- uu- -- u u--	dactylic hexameter	masculine penthemimeral, hepthemimeral
ἀλλ᾽ ἐγὼ ἐς χλαῖναν μαλακὸν πόκον, ὁππόκα πέξω	- uu - -- uu- uu -uu --	dactylic hexameter	masculine penthemimeral, hepthemimeral, trithemimeral
τὰν οἶν τὰν πέλλαν, Κρατίδᾳ δωρήσομαι αὐτός.	- - - -- uu- --uu --	dactylic hexameter	masculine penthemimeral, hepthemimeral, trithemimeral
σίττ᾽ ἀπὸ τᾶς κοτίνω ταὶ μηκάδες· ὧδε νέμεσθε,	- uu - uu- - -uu -u u--	dactylic hexameter	masculine penthemimeral, trithemimeral
ὡς τὸ κάταντες τοῦτο γεώλοφον αἵ τε μυρῖκαι.	- u u-- -u u-uu - u u--	dactylic hexameter	feminine penthemimeral
οὐκ ἀπὸ τᾶς δρυὸς οὗτος ὁ Κώναρος ἅ τε Κιναίθα;	- uu - uu -u u -uu - u u--	dactylic hexameter	feminine penthemimeral, trithemimeral
τουτεῖ βοσκησεῖσθε ποτ᾽ ἀντολάς, ὡς ὁ Φάλαρος.	-- ---u u -uu - u u--	dactylic hexameter	feminine penthemimeral
ἔστι δέ μοι γαυλὸς κυπαρίσσινος, ἔστι δὲ κρατήρ,	-u u - -- uu-uu -u u --	dactylic hexameter	masculine penthemimeral, trithemimeral
ἔργον Πραξιτέλευς· τᾷ παιδὶ δὲ ταῦτα φυλάσσω.	-- -uu- - -u u -u u--	dactylic hexameter	masculine penthemimeral
χἁμῖν ἐστι κύων φιλοποίμνιος, ὃς λύκος ἄγχει,	-- -u u- uu-uu - uu --	dactylic hexameter	masculine penthemimeral
ὃν τῷ παιδὶ δίδωμι τὰ θηρία πάντα διώκειν.	- - -u u-u u -uu -u u--	dactylic hexameter	feminine penthemimeral
ἀκρίδες, αἳ τὸν φραγμὸν ὑπερπαδῆτε τὸν ἁμόν,	-uu - - -u u---u u --	dactylic hexameter	feminine penthemimeral, trithemimeral
μή μευ λωβασεῖσθε τὰς ἀμπέλος· ἐντὶ γὰρ ἇβαι.	- - ---u u -uu -u u --	dactylic hexameter	feminine penthemimeral
τοὶ τέττιγες, ὁρῆτε τὸν αἰπόλον ὡς ἐρεθίζω·	- --u u-u u -uu - uu--	dactylic hexameter	feminine penthemimeral
οὑτῶς χὑμές θην ἐρεθίζετε τὼς καλαμευτάς.	-- -- - uu-uu - uu--	dactylic hexameter	masculine penthemimeral
μισέω τὰς δασυκέρκος ἀλώπεκας, αἳ τὰ Μίκωνος	-- - uu-u u-uu - u u--	dactylic hexameter	feminine penthemimeral, trithemimeral
αἰεὶ φοιτῶσαι τὰ ποθέσπερα ῥαγίζοντι.	-- --- u u-uu ----	dactylic hexameter	masculine penthemimeral
καὶ γὰρ ἐγὼ μισέω τὼς κανθάρος, οἳ τὰ Φιλώνδα	- u u- -- - -uu - u u--	dactylic hexameter	masculine penthemimeral, trithemimeral
σῦκα κατατρώγοντες ὑπανέμιοι φορέονται.	-u u---u u-uu- uu--	dactylic hexameter	feminine penthemimeral
ἦ οὐ μέμνᾳ, ὅκ᾽ ἐγώ τυ κατήλασα, καὶ τὺ σεσαρὼς	- -- u u- u u-uu - u u--	dactylic hexameter	masculine penthemimeral, trithemimeral
εὖ ποτεκιγκλίζευ καὶ τᾶς δρυὸς εἴχεο τήνας;	- uu--- - - uu -uu --	dactylic hexameter	masculine penthemimeral, hepthemimeral
τοῦτο μὲν οὐ μέμναμ᾽· ὅκα μάν ποκα τεῖδέ τυ δήσας	-u u - -- uu - uu -u u --	dactylic hexameter	masculine penthemimeral, hepthemimeral, trithemimeral
Εὐμάρας ἐκάθηρε καλῶς μάλα, τοῦτό γ᾽ἴσαμι.	-uu ---u u- uu -u u--	dactylic hexameter	feminine penthemimeral, hepthemimeral
ἦ δή τις Μόρσων πικραίνεται· ἦ οὐχὶ παρῄσθευ;	- - - -- --uu -u u--	dactylic hexameter	masculine penthemimeral, trithemimeral
σκίλλας ἰὼν γραίας ἀπὸ σάματος αὐτίκα τίλλειν.	-u u- -- uu -uu -uu --	dactylic hexameter	masculine penthemimeral, trithemimeral
κἠγὼ μὰν κνίζω Μόρσων τινά· καὶ τὺ δὲ λεύσσεις.	-- - -- -- uu - u u --	dactylic hexameter	masculine penthemimeral, hepthemimeral, trithemimeral
ἐνθὼν τὰν κυκλάμινον ὄρυσσέ νυν ἐς τὸν Ἄλεντα.	-- - uu-u u-u u - u u--	dactylic hexameter	feminine penthemimeral, trithemimeral
Ἱμέρα ἀνθ᾽ ὕδατος ῥείτω γάλα, καὶ τὺ δὲ Κράθι	-uu - uu- -- uu - - - --	lyric	
οἴνῳ πορφύροις, τὰ δέ τ᾽οἴσυα καρπὸν ἐνείκαι.	-- --- u u -uu -u u--	dactylic hexameter	masculine penthemimeral
ῥείτω χἁ Συβαρῖτις ἐμὶν μέλι, καὶ τὸ πότορθρον	-- - uu-u u- uu - u u--	dactylic hexameter	feminine penthemimeral, hepthemimeral, trithemimeral
ἁ παῖς ἀνθ᾽ ὕδατος τᾷ κάλπιδι κηρία βάψαι.	- - - uu- - -uu -uu --	dactylic hexameter	masculine penthemimeral, trithemimeral
ταὶ μὲν ἐμαὶ κύτισόν τε καὶ αἴγιλον αἶγες ἔδοντι,	- u u- uu- u u -uu -u u--	dactylic hexameter	masculine penthemimeral, trithemimeral
καὶ σχῖνον πατέοντι καὶ ἐν κομάροισι κέχυνται.	- -- uu-u u - uu-u u--	dactylic hexameter	feminine penthemimeral, hepthemimeral, trithemimeral
ταῖσι δ᾽ἐμαῖς ὀίεσσι πάρεστι μὲν ἁ μελίτεια	-u u- uu-u u-u u - uu--	dactylic hexameter	feminine penthemimeral, trithemimeral
φέρβεσθαι, πολλὸς δὲ καὶ ὡς ῥόδα κίσθος ἐπανθεῖ.	--- -- u u - uu -u u--	dactylic hexameter	masculine penthemimeral, hepthemimeral, trithemimeral
οὐκ ἔραμ᾽ Ἀλκίππας, ὅτι με πρᾶν οὐκ ἐφίλασε	- uu --- uu - - - uu--	dactylic hexameter	masculine penthemimeral, hepthemimeral
τῶν ὤτων καθελοῖσ᾽, ὅκά οἱ τὰν φάσσαν ἔδωκα.	- -- uu- uu - - -u u--	dactylic hexameter	masculine penthemimeral, hepthemimeral, trithemimeral
ἀλλ᾽ ἐγὼ Εὐμήδευς ἔραμαι μέγα· καὶ γὰρ ὅκ᾽ αὐτῷ	- uu --- uu- uu - u u --	dactylic hexameter	masculine penthemimeral, hepthemimeral
τὰν σύριγγ᾽ ὤρεξα, καλόν τί με κάρτ᾽ ἐφίλασεν.	- -- --u u- u u - uu--	dactylic hexameter	feminine penthemimeral, hepthemimeral, trithemimeral
οὐ θεμιτὸν Λάκων ποτ᾽ ἀηδόνα κίσσας ἐρίσδειν,	- uu- -- u u-uu -u u--	dactylic hexameter	masculine penthemimeral, trithemimeral
οὐδ᾽ ἔποπας κύκνοισι· τὺ δ᾽ὦ τάλαν ἐσσὶ φιλεχθής.	- uu- --u u - uu -u --	lyric	
παύσασθαι κέλομαι τὸν ποιμένα. τὶν δὲ Κομάτα	--- uu- - -uu - u u--	dactylic hexameter	masculine penthemimeral, trithemimeral
δωρεῖται Μόρσων τὰν ἀμνίδα· καὶ τὺ δὲ θύσας	--- -- - -uu - u u --	dactylic hexameter	masculine penthemimeral, trithemimeral
ταῖς Νύμφαις Μόρσωνι καλὸν κρέας αὐτίκα πέμψον.	- -- --u u- uu -uu --	dactylic hexameter	feminine penthemimeral, hepthemimeral, trithemimeral
πεμψῶ ναὶ τὸν Πᾶνα. φριμάσσεο πᾶσα τραγίσκων	-- - - -u u-uu -u u--	dactylic hexameter	feminine penthemimeral, trithemimeral
νῦν ἀγέλα· κἠγὼ γὰρ ἴδ᾽ ὡς μέγα τοῦτο καχαξῶ	- uu- -- u u - uu -u u--	dactylic hexameter	masculine penthemimeral, hepthemimeral, trithemimeral
κὰτ τῶ Λάκωνος τῶ ποιμένος, ὅττι πόκ᾽ ἤδη	- - --- - -uu -u u --	dactylic hexameter	masculine penthemimeral
ἀνυσάμαν τὰν ἀμνόν· ἐς ὠρανὸν ὔμμιν ἁλεῦμαι.	-uu- - -u u -uu -u u--	dactylic hexameter	feminine penthemimeral, trithemimeral
αἶγες ἐμαὶ θαρσεῖτε κερούτιδες· αὔριον ὔμμε	-u u- --u u-uu -uu --	dactylic hexameter	feminine penthemimeral, trithemimeral
πάσας ἐγὼ λουσῶ Συβαρίτιδος ἔνδοθι λίμνας.	-u u- -- uu-uu -uu --	dactylic hexameter	masculine penthemimeral, trithemimeral
οὗτος ὁ Λευκίτας ὁ κορυπτίλος, εἴ τιν᾽ ὀχευσεῖς	-u u -uu - --uu - u u--	dactylic hexameter	masculine penthemimeral
τᾶν αἰγῶν, φλασσῶ τυ πρὶν ἤ γ᾽ἐμὲ καλλιερῆσαι	- -- -- u u - uu -uu--	dactylic hexameter	masculine penthemimeral, hepthemimeral, trithemimeral
ταῖς Νύμφαις τὰν ἀμνόν. ὁ δ᾽αὖ πάλιν. ἀλλὰ γενοίμαν,	- -- - -u u - uu -u u--	dactylic hexameter	feminine penthemimeral, hepthemimeral, trithemimeral
αἰ μή τυ φλάσσαιμι, Μελάνθιος ἀντὶ Κομάτα.	- - - --u u-uu -u u--	dactylic hexameter	feminine penthemimeral, trithemimeral
Δαμοίτας χὡ Δάφνις ὁ βουκόλος εἰς ἕνα χῶρον	--- - -u u -uu - uu --	dactylic hexameter	feminine penthemimeral, trithemimeral
τὰν ἀγέλαν πόκ᾽ Ἄρατε συνάγαγον· ἦς δ᾽ὁ μὲν αὐτῶν	- uu- u u-u u-uu - u u --	dactylic hexameter	feminine penthemimeral, trithemimeral
πυρρός, ὁ δ᾽ἡμιγένειος· ἐπὶ κράναν δέ τιν᾽ ἄμφω	-u u -uu-u u- -- u u --	dactylic hexameter	feminine penthemimeral, hepthemimeral
ἑζόμενοι θέρεος μέσῳ ἄματι τοιάδ᾽ ἄειδον.	-uu- uu- uu -uu -u u--	dactylic hexameter	masculine penthemimeral, trithemimeral
πρᾶτος δ᾽ἄρξατο Δάφνις, ἐπεὶ καὶ πρᾶτος ἔρισδε.	-- -uu -u u- - -u u--	dactylic hexameter	feminine penthemimeral, hepthemimeral
βάλλει τοι Πολύφαμε τὸ ποίμνιον ἁ Γαλάτεια	-- - uu-u u -uu - uu--	dactylic hexameter	feminine penthemimeral, trithemimeral
μάλοισιν, δυσέρωτα τὸν αἰπόλον ἄνδρα καλεῦσα·	--- uu-u u -uu -u u--	dactylic hexameter	feminine penthemimeral, trithemimeral
καὶ τύ νιν οὐ ποθόρησθα τάλαν τάλαν, ἀλλὰ κάθησαι	- u u - uu-u u- uu -u u--	dactylic hexameter	feminine penthemimeral, hepthemimeral, trithemimeral
ἁδέα συρίσδων. πάλιν ἅδ᾽ ἴδε τὰν κύνα βάλλει,	-uu --- uu - uu - uu --	dactylic hexameter	masculine penthemimeral, hepthemimeral
ἅ τοι τᾶν ὀίων ἕπεται σκοπός· ἁ δὲ βαΰσδει	- - - uu- uu- uu - u u--	dactylic hexameter	masculine penthemimeral, hepthemimeral, trithemimeral
εἰς ἅλα δερκομένα, τὰ δέ νιν καλὰ κύματα φαίνει	- uu -uu- u u - uu -uu --	dactylic hexameter	masculine penthemimeral, hepthemimeral
ἅσυχα καχλάζοντα ἐπ᾽ αἰγιαλοῖο θέοισαν.	-uu ---u u -uu-u u--	dactylic hexameter	feminine penthemimeral
φράζεο μὴ τᾶς παιδὸς ἐπὶ κνάμαισιν ὀρούσῃ	-uu - - -u u- --u u--	dactylic hexameter	feminine penthemimeral, hepthemimeral, trithemimeral
ἐξ ἁλὸς ἐρχομένας, κατὰ δὲ χρόα καλὸν ἀμύξῃ.	- uu -uu- uu - uu -u u--	dactylic hexameter	masculine penthemimeral, hepthemimeral
ἁ δὲ καὶ αὐτόθε τοι διαθρύπτεται, ὡς ἀπ᾽ ἀκάνθας	- u u -uu - uu-uu - u u--	dactylic hexameter	masculine penthemimeral
ταὶ καπυραὶ χαῖται, τὸ καλὸν θέρος ἁνίκα φρύγει·	- uu- -- u u- uu -uu --	dactylic hexameter	masculine penthemimeral, hepthemimeral, trithemimeral
καὶ φεύγει φιλέοντα καὶ οὐ φιλέοντα διώκει,	- -- uu-u u - uu-u u--	dactylic hexameter	feminine penthemimeral, hepthemimeral, trithemimeral
καὶ τὸν ἀπὸ γραμμᾶς κινεῖ λίθον· ἦ γὰρ ἔρωτι	- u u- -- -- uu - u u--	dactylic hexameter	masculine penthemimeral, hepthemimeral, trithemimeral
πολλάκις ὦ Πολύφαμε τὰ μὴ καλὰ καλὰ πέφανται.	-uu - uu-u u - uu -u u--	dactylic hexameter	feminine penthemimeral, hepthemimeral, trithemimeral
τῷ δ᾽ἐπὶ Δαμοίτας ἀνεβάλλετο καὶ τάδ᾽ ἄειδεν.	- uu --- uu-uu - u u--	dactylic hexameter	masculine penthemimeral
εἶδον ναὶ τὸν Πᾶνα, τὸ ποίμνιον ἁνίκ᾽ ἔβαλλε,	-- - - -u u -uu -u u--	dactylic hexameter	feminine penthemimeral, trithemimeral
κοὔ μ᾽ἔλαθ᾽, οὔ, τὸν ἐμὸν ἕνα τὸν γλυκύν, ᾧπερ ὅρημι	- uu - u u- uu - uu -u u--	dactylic hexameter	masculine penthemimeral, hepthemimeral, trithemimeral
ἐς τέλος· αὐτὰρ ὁ μάντις ὁ Τήλεμος ἔχθρ᾽ ἀγορεύων	- uu -u u -u u -uu - uu--	dactylic hexameter	feminine penthemimeral
ἐχθρὰ φέροι ποτὶ οἶκον, ὅπως τεκέεσσι φυλάσσοι.	- -- uu -u u- uu-u u--	dactylic hexameter	feminine penthemimeral, hepthemimeral, trithemimeral
ἀλλὰ καὶ αὐτὸς ἐγὼ κνίζων πάλιν οὐ ποθόρημι,	-u u -u u- -- uu - uu--	dactylic hexameter	masculine penthemimeral, hepthemimeral
ἀλλ᾽ ἄλλαν τινὰ φαμὶ γυναῖκ᾽ ἔχεν· ἁ δ᾽ἀίοισα	- -- uu -u u- uu - uu--	dactylic hexameter	feminine penthemimeral, hepthemimeral, trithemimeral
ζαλοῖ μ᾽ὦ Παιὰν καὶ τάκεται, ἐκ δὲ θαλάσσας	-- - -- - -uu - u u--	dactylic hexameter	masculine penthemimeral, trithemimeral
οἰστρεῖ παπταίνοισα ποτ᾽ ἄντρά τε καὶ ποτὶ ποίμνας.	-- ---u u -u u - uu --	dactylic hexameter	feminine penthemimeral
σίξα δ᾽ὑλακτεῖν νιν καὶ τᾷ κυνί· καὶ γὰρ ὅκ᾽ ἤρων	-u u-- - - - uu - u u --	dactylic hexameter	masculine penthemimeral, hepthemimeral
αὐτᾶς, ἐκνυζεῖτο ποτ᾽ ἰσχία ῥύγχος ἔχοισα.	-- ---u u -uu -u u--	dactylic hexameter	feminine penthemimeral
ταῦτα δ᾽ἴσως ἐσορεῦσα ποεῦντά με πολλάκι πεμψεῖ	-u u- uu-u u-u u -uu --	dactylic hexameter	feminine penthemimeral, trithemimeral
ἄγγελον. αὐτὰρ ἐγὼ κλᾳξῶ θύρας, ἕστέ κ᾽ὀμόσσῃ	-uu -u u- -- uu -u u--	dactylic hexameter	masculine penthemimeral, hepthemimeral
αὐτά μοι στορεσεῖν καλὰ δέμνια τᾶσδ᾽ ἐπὶ νάσω.	-- - uu- uu -uu - uu --	dactylic hexameter	masculine penthemimeral, trithemimeral
καὶ γάρ θην οὐδ᾽ εἶδος ἔχω κακόν, ὥς με λέγοντι.	- - - - -u u- uu - u u--	dactylic hexameter	feminine penthemimeral, hepthemimeral, trithemimeral
ἦ γὰρ πρᾶν ἐς πόντον ἐσέβλεπον, ἦς δὲ γαλάνα,	- - - - -u u-uu - u u--	dactylic hexameter	feminine penthemimeral, trithemimeral
καὶ καλὰ μὲν τὰ γένεια, καλὰ δέ μευ ἁ μία κώρα,	- uu - u u-u u- u u - uu --	dactylic hexameter	feminine penthemimeral, hepthemimeral, trithemimeral
ὡς παρ᾽ ἐμὶν κέκριται, κατεφαίνετο, τῶν δέ τ᾽ὀδόντων	- u u- uu- uu-uu - u u--	dactylic hexameter	masculine penthemimeral, trithemimeral
λευκοτέραν αὐγὰν Παρίας ὑπέφαινε λίθοιο.	-uu- -- uu- uu-u u--	dactylic hexameter	masculine penthemimeral, hepthemimeral, trithemimeral
ὡς μὴ βασκανθῶ δέ, τρὶς εἰς ἐμὸν ἔπτυσα κόλπον·	- - --- u u - uu -uu --	dactylic hexameter	masculine penthemimeral, hepthemimeral
ταῦτα γὰρ ἁ γραία με Κοτυταρὶς ἐξεδίδαξε.	-u u - -- u u-uu -uu--	dactylic hexameter	masculine penthemimeral, trithemimeral
ἃ πρᾶν ἀμάντεσσι παρ᾽ Ἱπποκίωνι ποταύλει.	- - ---u u -uu-u u--	dactylic hexameter	feminine penthemimeral
τόσσ᾽ εἰπὼν τὸν Δάφνιν ὁ Δαμοίτας ἐφίλησε,	- -- - -u u --- uu--	dactylic hexameter	feminine penthemimeral, trithemimeral
χὡ μὲν τῷ σύριγγ᾽, ὁ δὲ τῷ καλὸν αὐλὸν ἔδωκεν.	- - - -- u u - uu -u u--	dactylic hexameter	masculine penthemimeral, hepthemimeral, trithemimeral
αὔλει Δαμοίτας, σύρισδε δὲ Δάφνις ὁ βούτας,	-- --- --u u -u u --	dactylic hexameter	masculine penthemimeral
ὠρχεῦντ᾽ ἐν μαλακᾷ ταὶ πόρτιες αὐτίκα ποίᾳ.	-- - uu- - -uu -uu --	dactylic hexameter	masculine penthemimeral, trithemimeral
νίκη μὰν οὐδάλλος, ἀνήσσατοι δ᾽ἐγένοντο.	-- - --u u--- uu--	dactylic hexameter	feminine penthemimeral, trithemimeral
Ἠς χρόνος ἁνίκ᾽ ἐγώ τε καὶ Εὔκριτος ἐς τὸν Ἅλεντα	- uu -u u- u u -uu - u u--	dactylic hexameter	masculine penthemimeral
εἵρπομες ἐκ πόλιος, σὺν καὶ τρίτος ἁμὶν Ἀμύντας·	-uu - uu- - - uu -u u--	dactylic hexameter	masculine penthemimeral, hepthemimeral, trithemimeral
τᾷ Δηοῖ γὰρ ἔτευχε θαλύσια καὶ Φρασίδαμος	- -- u u-u u-uu - uu--	dactylic hexameter	feminine penthemimeral, trithemimeral
κἀντιγένης, δύο τέκνα Λυκωπέος, εἴ τί περ ἐσθλὸν	-uu- uu -u u-uu - u u --	dactylic hexameter	feminine penthemimeral, trithemimeral
χᾳῶν τῶν ἐπάνωθεν, ἀπὸ Κλυτίας τε καὶ αὐτῶ	-- - uu-u u- uu- u u --	dactylic hexameter	feminine penthemimeral, hepthemimeral, trithemimeral
Χάλκωνος, Βούριναν ὃς ἐκ ποδὸς ἄνυσε κράναν	--- --u u - uu --- --	lyric	
εὖ ἐνερεισάμενος πέτρᾳ γόνυ· ταὶ δὲ παρ᾽ αὐτὰν	- uu-uu- -- uu - u u --	dactylic hexameter	masculine penthemimeral, hepthemimeral
αἴγειροι πτελέαι τε ἐύσκιον ἄλσος ὕφαινον,	--- uu- u u-uu -u u--	dactylic hexameter	masculine penthemimeral, trithemimeral
χλωροῖσιν πετάλοισι κατηρεφέες κομόωσαι.	--- uu-u u-uu- uu--	dactylic hexameter	feminine penthemimeral, trithemimeral
κοὔπω τὰν μεσάταν ὁδὸν ἄνυμες, οὐδὲ τὸ σᾶμα	-- - uu- uu -uu -u u --	dactylic hexameter	masculine penthemimeral, trithemimeral
ἁμὶν τὸ Βρασίλα κατεφαίνετο, καὶ τὸν ὁδίταν	-- - uu- uu-uu - u u--	dactylic hexameter	masculine penthemimeral, trithemimeral
ἐσθλὸν σὺν Μοίσαισι Κυδωνικὸν εὕρομες ἄνδρα,	-- - --u u-uu -uu --	dactylic hexameter	feminine penthemimeral, trithemimeral
οὔνομα μὲν Λυκίδαν, ἦς δ᾽αἰπόλος, οὐδέ κέ τίς νιν	-uu - uu- - -uu -u u - -	dactylic hexameter	masculine penthemimeral, trithemimeral
ἠγνοίησεν ἰδών, ἐπεὶ αἰπόλῳ ἔξοχ᾽ ἐῴκει.	---u u- uu -uu -u u--	dactylic hexameter	masculine penthemimeral
ἐκ μὲν γὰρ λασίοιο δασύτριχος εἶχε τράγοιο	- - - uu-u u-uu -u u--	dactylic hexameter	feminine penthemimeral, trithemimeral
κνακὸν δέρμ᾽ ὤμοισι νέας ταμίσοιο ποτόσδον,	-- - --u u- uu-u u--	dactylic hexameter	feminine penthemimeral, hepthemimeral, trithemimeral
ἀμφὶ δέ οἱ στήθεσσι γέρων ἐσφίγγετο πέπλος	-u u - --u u- --uu --	dactylic hexameter	feminine penthemimeral, hepthemimeral, trithemimeral
ζωστῆρι πλακερῷ, ῥοικὰν δ᾽ἔχεν ἀγριελαίω	--- uu- -- uu -uu--	dactylic hexameter	masculine penthemimeral, hepthemimeral, trithemimeral
δεξιτερᾷ κορύναν. καί μ᾽ἀτρέμας εἶπε σεσαρὼς	-uu- uu- - -uu -u u--	dactylic hexameter	masculine penthemimeral, trithemimeral
ὄμματι μειδιόωντι, γέλως δέ οἱ εἴχετο χείλευς·	-uu -uu-u u- u u -uu --	dactylic hexameter	feminine penthemimeral, hepthemimeral
"Σιμιχίδα, πᾷ δὴ τὸ μεσαμέριον πόδας ἕλκεις,	-uu- - - u u-uu- uu --	dactylic hexameter	masculine penthemimeral, trithemimeral
ἁνίκα δὴ καὶ σαῦρος ἐν αἱμασιαῖσι καθεύδει,	-uu - - -u u -uu-u u--	dactylic hexameter	feminine penthemimeral, trithemimeral
οὐδ᾽ ἐπιτυμβίδιαι κορυδαλλίδες ἠλαίνοντι;	- uu-uu- uu-uu ----	dactylic hexameter	masculine penthemimeral
ἦ μετὰ δαῖτα κλητὸς ἐπείγεαι; ἤ τινος ἀστῶν	- uu -- -u u-uu - uu --	dactylic hexameter	feminine penthemimeral
λανὸν ἔπι θρώσκεις; ὥς τοι ποσὶ νισσομένοιο	-u u- -- - - uu -uu--	dactylic hexameter	masculine penthemimeral, hepthemimeral, trithemimeral
πᾶσα λίθος πταίοισα ποτ᾽ ἀρβυλίδεσσιν ἀείδει."	-u u- --u u -uu-u u--	dactylic hexameter	feminine penthemimeral, trithemimeral
τὸν δ᾽ἐγὼ ἀμείφθην· "Λυκίδα φίλε, φαντί τυ πάντες	- uu --- uu- uu -u u --	dactylic hexameter	masculine penthemimeral, hepthemimeral
συριγκτὰν ἔμεναι μέγ᾽ ὑπείροχον ἔν τε νομεῦσιν	--- uu- u u-uu - u u--	dactylic hexameter	masculine penthemimeral, trithemimeral
ἔν τ᾽ἀμητήρεσσι. τὸ δὴ μάλα θυμὸν ἰαίνει	- ----u u - uu -u u--	dactylic hexameter	feminine penthemimeral, hepthemimeral
ἁμέτερον· καί τοι κατ᾽ ἐμὸν νόον ἰσοφαρίζειν	-uu- - - u u- uu -uu--	dactylic hexameter	masculine penthemimeral, hepthemimeral, trithemimeral
ἔλπομαι. ἁ δ᾽ὁδὸς ἅδε θαλυσιάς· ἦ γὰρ ἑταῖροι	-uu - uu -u u-uu - u u--	dactylic hexameter	feminine penthemimeral, trithemimeral
ἀνέρες εὐπέπλῳ Δαμάτερι δαῖτα τελεῦντι	-uu --- uu-- -u u--	dactylic hexameter	masculine penthemimeral
ὄλβω ἀπαρχόμενοι· μάλα γάρ σφισι πίονι μέτρῳ	-u u-uu- uu - uu -uu --	dactylic hexameter	masculine penthemimeral, hepthemimeral
ἁ δαίμων εὔκριθον ἀνεπλήρωσεν ἀλωάν.	- -- --u u---u u--	dactylic hexameter	feminine penthemimeral, trithemimeral
ἀλλ᾽ ἄγε δή, ξυνὰ γὰρ ὁδός, ξυνὰ δὲ καὶ ἀώς,	- uu - uu - -- uu - u --	lyric	
βουκολιασδώμεσθα· τάχ᾽ ὥτερος ἄλλον ὀνασεῖ.	-uu---u u -uu -u u--	dactylic hexameter	feminine penthemimeral
καὶ γὰρ ἐγὼ Μοισᾶν καπυρὸν στόμα, κἠμὲ λέγοντι	- u u- -- uu- uu -u u--	dactylic hexameter	masculine penthemimeral, hepthemimeral, trithemimeral
πάντες ἀοιδὸν ἄριστον· ἐγὼ δέ τις οὐ ταχυπειθής,	-u u-u u-u u- u u - uu--	dactylic hexameter	feminine penthemimeral, hepthemimeral
οὐ Δᾶν· οὐ γάρ πω κατ᾽ ἐμὸν νόον οὔτε τὸν ἐσθλὸν	- - - - - u u- uu -u u --	dactylic hexameter	masculine penthemimeral, hepthemimeral, trithemimeral
Σικελίδαν νίκημι τὸν ἐκ Σάμω οὔτε Φιλητᾶν	-uu- --u u - uu -u u--	dactylic hexameter	feminine penthemimeral, hepthemimeral, trithemimeral
ἀείδων, βάτραχος δὲ ποτ᾽ ἀκρίδας ὥς τις ἐρίσδω."	--- uu- u u -uu - u u--	dactylic hexameter	masculine penthemimeral, trithemimeral
ὣς ἐφάμαν ἐπίταδες· ὁ δ᾽αἰπόλος ἁδὺ γελάσσας,	- uu- uu-u u -uu -u u--	dactylic hexameter	feminine penthemimeral, trithemimeral
"τάν τοι" ἔφα "κορύναν δωρύττομαι, οὕνεκεν ἐσσὶ	- u u- uu- --uu -uu --	dactylic hexameter	masculine penthemimeral, trithemimeral
πᾶν ἐπ᾽ ἀλαθείᾳ πεπλασμένον ἐκ Διὸς ἔρνος.	- u u--- --uu - uu --	dactylic hexameter	masculine penthemimeral
ὥς μοι καὶ τέκτων μέγ᾽ ἀπέχθεται, ὅστις ἐρευνῇ	- - - -- u u-- -u u--	dactylic hexameter	masculine penthemimeral, trithemimeral
ἶσον ὄρευς κορυφᾷ τελέσαι δόμον εὐρυμέδοντος,	-u u- uu- uu- uu -uu--	dactylic hexameter	masculine penthemimeral, hepthemimeral, trithemimeral
καὶ Μοισᾶν ὄρνιχες, ὅσοι ποτὶ Χῖον ἀοιδὸν	- -- --u u- uu -u u--	dactylic hexameter	feminine penthemimeral, hepthemimeral, trithemimeral
ἀντία κοκκύζοντες ἐτώσια μοχθίζοντι.	-uu ---u u-uu ---	lyric	
ἀλλ᾽ ἄγε βουκολικᾶς ταχέως ἀρχώμεθ᾽ ἀοιδᾶς,	- uu -uu- uu- --u u--	dactylic hexameter	masculine penthemimeral, hepthemimeral
Σιμιχίδα· κἠγὼ μέν, ὅρη φίλος, εἴ τοι ἀρέσκει	-uu- -- u u- uu - u u--	dactylic hexameter	masculine penthemimeral, hepthemimeral, trithemimeral
τοῦθ᾽ ὅ τι πρᾶν ἐν ὄρει τὸ μελύδριον ἐξεπόνασα."	- u u - - -- u u-uu -uu--	lyric	
Ἔσσεται Ἀγεάνακτι καλὸς πλόος ἐς Μυτιλήναν,	-uu -uu-u u- uu - uu--	dactylic hexameter	feminine penthemimeral, hepthemimeral
χὥταν ἐφ᾽ ἑσπερίοις ἐρίφοις νότος ὑγρὰ διώκῃ	-u u -uu- uu- uu -u u--	dactylic hexameter	masculine penthemimeral, hepthemimeral
κύματα, χὡρίων ὅτ᾽ ἐπ᾽ ὠκεανῷ πόδας ἴσχῃ,	-uu --- u u -uu- uu --	dactylic hexameter	masculine penthemimeral
αἴκεν τὸν Λυκίδαν ὀπτεύμενον ἐξ Ἀφροδίτας	-- - uu- --uu - ----	lyric	
ῥύσηται· θερμὸς γὰρ ἔρως αὐτῶ με καταίθει.	--- -- u u- -- u u--	dactylic hexameter	masculine penthemimeral, hepthemimeral, trithemimeral
χἁλκυόνες στορεσεῦντι τὰ κύματα τάν τε θάλασσαν	-uu- uu-u u -uu - u u--	dactylic hexameter	feminine penthemimeral, trithemimeral
τόν τε νότον τόν τ᾽εὖρον, ὃς ἔσχατα φυκία κινεῖ·	- u u- - -u u -uu -uu --	dactylic hexameter	feminine penthemimeral, trithemimeral
ἁλκυόνες, γλαυκαῖς Νηρηίσι ταί τε μάλιστα	-uu- -- --uu - u u--	dactylic hexameter	masculine penthemimeral, trithemimeral
ὀρνίχων ἐφίλαθεν, ὅσαις τέ περ ἐξ ἁλὸς ἄγρα.	--- uu-u u- u u - uu --	dactylic hexameter	feminine penthemimeral, hepthemimeral, trithemimeral
Ἀγεάνακτι πλόον διζημένῳ ἐς Μυτιλήναν	-uu-u u- --uu - uu--	dactylic hexameter	masculine penthemimeral
ὥρια πάντα γένοιτο, καὶ εὔπλοξν ὅρμον ἵκοιτο.	-uu -u u-u u -- -u u--	dactylic hexameter	feminine penthemimeral
κἠγὼ τῆνο κατ᾽ ἆμαρ ἀνήτινον ἢ ῥοδόεντα	-- -u u -u u-uu - uu--	dactylic hexameter	feminine penthemimeral
ἢ καὶ λευκοΐων στέφανον περὶ κρατὶ φυλάσσων	- - -uu- uu- uu -u u--	dactylic hexameter	masculine penthemimeral, hepthemimeral
τὸν Πτελεατικὸν οἶνον ἀπὸ κρατῆρος ἀφυξῶ	- uu-uu -u u- --u u--	dactylic hexameter	feminine penthemimeral, hepthemimeral
πὰρ πυρὶ κεκλιμένος, κύαμον δέ τις ἐν πυρὶ φρυξεῖ.	- uu -uu- uu- u u - uu --	dactylic hexameter	masculine penthemimeral, hepthemimeral
χἁ στιβὰς ἐσσεῖται πεπυκασμένα ἕστ᾽ ἐπὶ πᾶχυν	- uu --- uu-uu - uu --	dactylic hexameter	masculine penthemimeral
κνύζᾳ τ᾽ἀσφοδέλῳ τε πολυγνάμπτῳ τε σελίνῳ.	-- -uu- u u--- u u--	dactylic hexameter	masculine penthemimeral
καὶ πίομαι μαλακῶς μεμνημένος Ἀγεάνακτος	- uu- uu- --uu -uu--	dactylic hexameter	masculine penthemimeral, trithemimeral
αὐταῖσιν κυλίκεσσι καὶ ἐς τρύγα χεῖλος ἐρείδων.	--- uu-u u - uu -u u--	dactylic hexameter	feminine penthemimeral, hepthemimeral, trithemimeral
αὐλησεῦντι δέ μοι δύο ποιμένες, εἷς μὲν Ἀχαρνεύς,	---u u - uu -uu - u u--	dactylic hexameter	masculine penthemimeral
εἷς δὲ Λυκωπίτας· ὁ δὲ Τίτυρος ἐγγύθεν ᾀσεῖ,	- u u-uu - u u-- -uu --	dactylic hexameter	masculine penthemimeral
ὥς ποκα τᾶς Ξενέας ἠράσσατο Δάφνις ὁ βούτας,	- uu - uu- --uu -u u --	dactylic hexameter	masculine penthemimeral, trithemimeral
χὡς ὄρος ἀμφ᾽ ἐπονεῖτο, καὶ ὡς δρύες αὐτὸν ἐθρήνευν,	- uu - uu-u u - uu -u u--	dactylic hexameter	feminine penthemimeral, hepthemimeral, trithemimeral
Ἱμέρα αἵτε φύοντι παρ᾽ ὄχθῃσιν ποταμοῖο,	-uu -u u-u u -- ----	dactylic hexameter	feminine penthemimeral
εὖτε χιὼν ὥς τις κατετάκετο μακρὸν ὑφ᾽ Αἷμον	-u u- - - uu-uu -u u --	dactylic hexameter	masculine penthemimeral, trithemimeral
ἢ Ἄθω ἢ Ῥοδόπαν ἢ Καύκασον ἐσχατόωντα.	- uu - uu- - -uu -uu--	dactylic hexameter	masculine penthemimeral, trithemimeral
ᾀσεῖ δ᾽ὥς ποκ᾽ ἔδεκτο τὸν αἰπόλον εὐρέα λάρναξ	-- - u u-u u -uu -uu --	dactylic hexameter	feminine penthemimeral, trithemimeral
ζωὸν ἐόντα κακαῖσιν ἀτασθαλίαισιν ἄνακτος,	-u u-u u-u u-uu-u u--	dactylic hexameter	feminine penthemimeral
ὥς τέ νιν αἱ σιμαὶ λειμωνόθε φέρβον ἰοῖσαι	- u u - -- --uu -u u--	dactylic hexameter	masculine penthemimeral, trithemimeral
κέδρον ἐς ἁδεῖαν μαλακοῖς ἄνθεσσι μέλισσαι,	-u u --- uu- --u u--	dactylic hexameter	masculine penthemimeral, hepthemimeral
οὕνεκά οἱ γλυκὺ Μοῖσα κατὰ στόματος χέε νέκταρ.	-uu - uu -u u- uu- uu --	dactylic hexameter	feminine penthemimeral, hepthemimeral, trithemimeral
ὦ μακαριστὲ Κομάτα, τύ θην τάδε τερπνὰ πεπόνθεις,	- uu-u u-u u - uu -u u--	dactylic hexameter	feminine penthemimeral, hepthemimeral
καὶ τὺ κατεκλᾴσθης ἐς λάρνακα, καὶ τὺ μελισσᾶν	- u u--- - -uu - u u--	dactylic hexameter	masculine penthemimeral
κηρία φερβόμενος ἔτος ὥριον ἐξεπόνασας.	-uu -uu- uu -uu -uu--	dactylic hexameter	masculine penthemimeral
αἴθ᾽ ἐπ᾽ ἐμεῦ ζωοῖς ἐναρίθμιος ὤφελες εἶμεν,	- u u- -- uu-uu -uu --	dactylic hexameter	masculine penthemimeral, trithemimeral
ὥς τοι ἐγὼν ἐνόμευον ἀν᾽ ὤρεα τὰς καλὰς αἶγας	- u u- uu-u u -uu - uu --	dactylic hexameter	feminine penthemimeral, trithemimeral
φωνᾶς εἰσαΐων, τὺ δ᾽ὑπὸ δρυσὶν ἢ ὑπὸ πεύκαις	-- -uu- u u- uu - uu --	dactylic hexameter	masculine penthemimeral, hepthemimeral
ἁδὺ μελισδόμενος κατεκέκλισο θεῖε Κομάτα.	-u u-uu- uu-uu -u u--	dactylic hexameter	masculine penthemimeral
χὡ μὲν τόσσ᾽ εἰπὼν ἀπεπαύσατο· τὸν δὲ μετ᾽ αὖθις	- - - -- uu-uu - u u --	dactylic hexameter	masculine penthemimeral, trithemimeral
κἠγὼ τοῖ᾽ ἐφάμαν· "Λυκίδα φίλε, πολλὰ μὲν ἄλλα	-- - uu- uu- uu -u u --	dactylic hexameter	masculine penthemimeral, hepthemimeral, trithemimeral
νύμφαι κἠμὲ δίδαξαν ἀν᾽ ὤρεα βουκολέοντα	-- -u u-u u -uu -uu--	dactylic hexameter	feminine penthemimeral
ἐσθλά, τά που καὶ Ζηνὸς ἐπὶ θρόνον ἄγαγε φάμα·	-u u - - -u u- uu -uu --	dactylic hexameter	feminine penthemimeral, hepthemimeral, trithemimeral
ἀλλὰ τόγ᾽ ἐκ πάντων μέγ᾽ ὑπείροχον, ᾧ τυ γεραίρειν	-u u - -- u u-uu - u u--	dactylic hexameter	masculine penthemimeral, trithemimeral
ἀρξεῦμ᾽· ἀλλ᾽ ὑπάκουσον, ἐπεὶ φίλος ἔπλεο Μοίσαις."	-- - uu-u u- uu -uu --	dactylic hexameter	feminine penthemimeral, hepthemimeral, trithemimeral
Σιμιχίδᾳ μὲν Ἔρωτες ἐπέπταρον· ἦ γὰρ ὁ δειλὸς	-uu- u u-u u-uu - u u --	dactylic hexameter	feminine penthemimeral, trithemimeral
τόσσον ἐρᾷ Μυρτοῦς, ὅσον εἴαρος αἶγες ἐρᾶντι.	-u u- -- uu -uu -u u--	dactylic hexameter	masculine penthemimeral, trithemimeral
ὥρατος δ᾽ὁ τὰ πάντα φιλαίτατος ἀνέρι τήνῳ	--- u u -u u-uu -uu --	dactylic hexameter	feminine penthemimeral, trithemimeral
παιδὸς ὑπὸ σπλάγχνοισιν ἔχει πόθον. οἶδεν Ἄριστις,	-u u- -- -- uu -u u--	dactylic hexameter	masculine penthemimeral, hepthemimeral, trithemimeral
ἐσθλὸς ἀνήρ, μέγ᾽ ἄριστος, ὃν οὐδέ κεν αὐτὸς ἀείδειν	-u u- u u-u u -u u -u u--	dactylic hexameter	feminine penthemimeral, trithemimeral
Φοῖβος σὺν φόρμιγγι παρὰ τριπόδεσσι μεγαίροι,	-- - --u u- uu-u u--	dactylic hexameter	feminine penthemimeral, hepthemimeral, trithemimeral
ὡς ἐκ παιδὸς Ἄρατος ὑπ᾽ ὀστέον αἴθετ᾽ ἔρωτι.	- - -u u-u u -uu -u u--	dactylic hexameter	feminine penthemimeral
τόν μοι Πάν, Ὁμόλας ἐρατὸν πέδον ὅστε λέλογχας,	- - - uu- uu- uu -u u--	dactylic hexameter	masculine penthemimeral, hepthemimeral, trithemimeral
ἄκλητον κείνοιο φίλας ἐς χεῖρας ἐρείσαις,	--- --u u- - -u u--	dactylic hexameter	feminine penthemimeral, hepthemimeral, trithemimeral
εἴτ᾽ ἐστ᾽ ἆρα Φιλῖνος ὁ μαλθακὸς εἴτέ τις ἄλλος.	- - -u u-u u -uu -u u --	dactylic hexameter	feminine penthemimeral
κἢν μὲν ταῦτ᾽ ἔρδῃς ὦ Πὰν φίλε, μή τί τυ παῖδες	- - - -- - - uu - u u --	dactylic hexameter	masculine penthemimeral, hepthemimeral, trithemimeral
Ἀρκαδικοὶ σκίλλαισιν ὑπὸ πλευράς τε καὶ ὤμους	-uu- --u u- -- u u --	dactylic hexameter	feminine penthemimeral, hepthemimeral, trithemimeral
τανίκα μαστίσδοιεν, ὅτε κρέα τυτθὰ παρείη·	-uu ---u u- uu -u u--	dactylic hexameter	feminine penthemimeral, hepthemimeral
εἰ δ᾽ἄλλως νεύσαις, κατὰ μὲν χρόα πάντ᾽ ὀνύχεσσι	- -- -- uu - uu - uu--	dactylic hexameter	masculine penthemimeral, hepthemimeral, trithemimeral
δακνόμενος κνάσαιο καὶ ἐν κνίδαισι καθεύδοις,	-uu- --u u - --u u--	dactylic hexameter	feminine penthemimeral, hepthemimeral, trithemimeral
εἴης δ᾽Ἠδωνῶν μὲν ἐν ὤρεσι χείματι μέσσῳ	-- --- u u -uu -uu --	dactylic hexameter	masculine penthemimeral
Ἕβρον πὰρ ποταμὸν τετραμμένος ἐγγύθεν ἄρκτω,	-- - uu- --uu -uu --	dactylic hexameter	masculine penthemimeral, trithemimeral
ἐν δὲ θέρει πυμάτοισι παρ᾽ Αἰθιόπεσσι νομεύοις	- u u- uu-u u -uu-u u--	dactylic hexameter	feminine penthemimeral, trithemimeral
πέτρᾳ ὕπο Βλεμύων, ὅθεν οὐκέτι Νεῖλος ὁρατός.	-u u- uu- uu -uu -u u--	dactylic hexameter	masculine penthemimeral, trithemimeral
ὔμμες δ᾽Ὕετίδος καὶ Βυβλίδος ἁδὺ λιπόντες	-- -uu- - -uu -u u--	dactylic hexameter	masculine penthemimeral
νᾶμα καὶ Οἰκεῦντα, ξανθᾶς ἕδος αἰπὺ Διώνας,	-u u --- -- uu -u u--	dactylic hexameter	masculine penthemimeral, hepthemimeral
ὦ μάλοισιν Ἔρωτες ἐρευθομένοισιν ὁμοῖοι,	- --u u-u u-uu-u u--	dactylic hexameter	feminine penthemimeral
βάλλετέ μοι τόξοισι τὸν ἱμερόεντα Φιλῖνον,	-uu - --u u -uu-u u--	dactylic hexameter	feminine penthemimeral, trithemimeral
βάλλετ᾽, ἐπεὶ τὸν ξεῖνον ὁ δύσμορος οὐκ ἐλεεῖ μευ.	-u u- - -u u -uu - uu- -	dactylic hexameter	feminine penthemimeral, trithemimeral
καὶ δὴ μὰν ἀπίοιο πεπαίτερος, αἱ δὲ γυναῖκες	- - - uu-u u-uu - u u--	dactylic hexameter	feminine penthemimeral, trithemimeral
"αἰαῖ" φαντὶ "Φιλῖνε, τό τοι καλὸν ἄνθος ἀπορρεῖ."	-- -u u-u u - uu -u u--	dactylic hexameter	feminine penthemimeral, hepthemimeral
μηκέτι τοι φρουρέωμες ἐπὶ προθύροισιν Ἄρατε,	-uu - --u u- uu-u u--	dactylic hexameter	feminine penthemimeral, hepthemimeral, trithemimeral
μηδὲ πόδας τρίβωμες· ὁ δ᾽ὄρθριος ἄλλον ἀλέκτωρ	-u u- --u u -uu -u u--	dactylic hexameter	feminine penthemimeral, trithemimeral
κοκκύζων νάρκαισιν ἀνιαραῖσι διδοίη,	--- --u u---u u--	dactylic hexameter	feminine penthemimeral, trithemimeral
εἷς δ᾽ἀπὸ τᾶσδε φέριστε Μόλων ἄγχοιτο παλαίστρας,	- uu -u u-u u- --u u--	dactylic hexameter	feminine penthemimeral, hepthemimeral
ἄμμιν δ᾽ἁσυχία τε μέλοι γραία τε παρείη,	-- -uu- u u- -- u u--	dactylic hexameter	masculine penthemimeral, hepthemimeral
ἅτις ἐπιφθύζοισα τὰ μὴ καλὰ νόσφιν ἐρύκοι.	-u u---u u - uu -u u--	dactylic hexameter	feminine penthemimeral, hepthemimeral
τόσσ᾽ ἐφάμαν· ὁ δέ μοι τὸ λαγωβόλον, ἁδὺ γελάσσας	- uu- u u - u u-uu -u u--	dactylic hexameter	masculine penthemimeral, trithemimeral
ὡς πάρος, ἐκ Μοισᾶν ξεινήιον ὤπασεν εἶμεν.	- uu - -- --uu -uu --	dactylic hexameter	masculine penthemimeral, trithemimeral
χὡ μὲν ἀποκλίνας ἐπ᾽ ἀριστερὰ τὰν ἐπὶ Πύξας	- u u-uu - --uu - uu --	dactylic hexameter	masculine penthemimeral
εἷρφ᾽ ὁδόν, αὐτὰρ ἐγώ τε καὶ Εὔκριτος ἐς Φρασιδάυω	- uu -u u- u u -uu - uu--	dactylic hexameter	masculine penthemimeral
στραφθέντες χὡ καλὸς Ἀμύντιχος ἔν τε βαθείαις	--- - -u u-uu - u u--	dactylic hexameter	feminine penthemimeral, trithemimeral
ἁδείας σχοίνοιο χαμευνίσιν ἐκλίνθημες	--- --u u-uu ----	dactylic hexameter	feminine penthemimeral, trithemimeral
ἔν τε νεοτμάτοισι γεγαθότες οἰναρέοισι.	- u u---u u-uu -uu--	dactylic hexameter	feminine penthemimeral
πολλαὶ δ᾽ἁμὶν ὕπερθε κατὰ κρατὸς δονέοντο	-- -u u-u u- -- uu--	dactylic hexameter	feminine penthemimeral, hepthemimeral
αἴγειροι πτελέαι τε· τὸ δ᾽ἐγγύθεν ἱερὸν ὕδωρ	--- uu- u u -uu -uu --	dactylic hexameter	masculine penthemimeral, trithemimeral
Νυμφᾶν ἐξ ἄντροιο κατειβόμενον κελάρυζε.	-- - --u u-uu- uu--	dactylic hexameter	feminine penthemimeral, trithemimeral
τοὶ δὲ ποτὶ σκιαραῖς ὀροδαμνίσιν αἰθαλίωνες	- u u- uu- uu-uu -uu--	dactylic hexameter	masculine penthemimeral, trithemimeral
τέττιγες λαλαγεῦντες ἔχον πόνον· ἁ δ᾽ὀλολυγὼν	--- uu-u u- uu - uu--	dactylic hexameter	feminine penthemimeral, hepthemimeral, trithemimeral
τηλόθεν ἐν πυκιναῖσι βάτων τρύζεσκεν ἀκάνθαις.	-uu - uu-u u- --u u--	dactylic hexameter	feminine penthemimeral, hepthemimeral, trithemimeral
ἄειδον κόρυδοι καὶ ἀκανθίδες, ἔστενε τρυγών,	--- uu- u u-uu -uu --	dactylic hexameter	masculine penthemimeral, trithemimeral
πωτῶντο ξουθαὶ περὶ πίδακας ἀμφὶ μέλισσαι.	--- -- uu -uu -u u--	dactylic hexameter	masculine penthemimeral, trithemimeral
πάντ᾽ ὦσδεν θέρεος μάλα πίονος, ὦσδε δ᾽ὀπώρας.	- -- uu- uu -uu -u u--	dactylic hexameter	masculine penthemimeral, trithemimeral
ὄχναι μὲν πὰρ ποσσί, παρὰ πλευραῖσι δὲ μᾶλα	- - - -- -- --u u --	dactylic hexameter	masculine penthemimeral, hepthemimeral, trithemimeral
δαψιλέως ἁμῖν ἐκυλίνδετο· τοὶ δ᾽ἐκέχυντο	-uu- -- uu-uu - uu--	dactylic hexameter	masculine penthemimeral, trithemimeral
ὄρπακες βραβίλοισι καταβρίθοντες ἔραζε·	--- uu-u u---u u--	dactylic hexameter	feminine penthemimeral, trithemimeral
τετράενες δὲ πίθων ἀπελύετο κρατὸς ἄλειφαρ.	-uu- u u- uu-uu -u u--	dactylic hexameter	masculine penthemimeral, trithemimeral
νύμφαι Κασταλίδες Παρνάσιον αἶπος ἔχοισαι,	-- -uu- --uu -u u--	dactylic hexameter	masculine penthemimeral
ἆρά γέ πᾳ τοιόνδε Φόλω κατὰ λάινον ἄντρον	-u u - --u u- uu -uu --	dactylic hexameter	feminine penthemimeral, hepthemimeral, trithemimeral
κρατῆρ᾽ Ἡρακλῆι γέρων ἐστήσατο Χείρων;	-- ---u u- --uu --	dactylic hexameter	feminine penthemimeral, hepthemimeral
ἆρά γέ πᾳ τῆνον τὸν ποιμένα τὸν ποτ᾽ Ἀνάπῳ,	-u u - -- - -uu - u u--	dactylic hexameter	masculine penthemimeral, trithemimeral
τὸν κρατερὸν Πολύφαμον, ὃς ὤρεσι νᾶας ἔβαλλε,	- uu- uu-u u -uu -u u--	dactylic hexameter	feminine penthemimeral, trithemimeral
τοῖον νέκταρ ἔπεισε κατ᾽ αὐλία ποσσὶ χορεῦσαι,	-- -u u-u u -uu -u u--	dactylic hexameter	feminine penthemimeral
οἷον δὴ τόκα πῶμα διεκρανάσατε Νύμφαι	-- - uu -u u-uu-- --	dactylic hexameter	feminine penthemimeral, trithemimeral
βωμῷ πὰρ Δάματρος ἀλῳάδος; ἇς ἐπὶ σωρῷ	-- - --u u-uu - uu --	dactylic hexameter	feminine penthemimeral, trithemimeral
αὖθις ἐγὼ πάξαιμι μέγα πτύον, ἁ δὲ γελάσσαι	-u u- --u u- uu - u u--	dactylic hexameter	feminine penthemimeral, hepthemimeral, trithemimeral
δράγματα καὶ μάκωνας ἐν ἀμφοτέραισιν ἔχοισα.	-uu - --u u -uu-u u--	dactylic hexameter	feminine penthemimeral, trithemimeral
Δάφνιδι τῷ χαρίεντι συνήντετο βουκολέοντι	-uu - uu-u u-uu -uu--	dactylic hexameter	feminine penthemimeral, trithemimeral
μᾶλα νέμων, ὡς φαντί, κατ᾽ ὤρεα μακρὰ Μενάλκας.	-u u- - -u u -uu -u u--	dactylic hexameter	feminine penthemimeral, trithemimeral
ἄμφω τώγ᾽ ἤστην πυρροτρίχω, ἄμφω ἀνάβω,	-- - -- --uu -u u--	dactylic hexameter	masculine penthemimeral, trithemimeral
ἄμφω συρίσδεν δεδαημένω, ἄμφω ἀείδεν.	-- --- uu-uu -u u--	dactylic hexameter	masculine penthemimeral
πρᾶτος δ᾽ὦν ποτὶ Δάφνιν ἰδὼν ἀγόρευε Μενάλκας·	-- - uu -u u- uu-u u--	dactylic hexameter	feminine penthemimeral, hepthemimeral, trithemimeral
"μυκητᾶν ἐπίουρε βοῶν Δάφνι, λῇς μοι ἀεῖσαι;	--- uu-u u- uu - u u--	dactylic hexameter	feminine penthemimeral, hepthemimeral, trithemimeral
φαμί τυ νικασεῖν, ὅσσον θέλω αὐτὸς ἀείδων."	-u u --- -- uu -u u--	dactylic hexameter	masculine penthemimeral, hepthemimeral
τὸν δ᾽ἄρα χὡ Δάφνις τοιῷδ᾽ ἀπαμείβετο μύθῳ·	- uu - -- -- uu-uu --	dactylic hexameter	masculine penthemimeral, hepthemimeral, trithemimeral
"ποιμὴν εἰροπόκων ὀίων συριγκτὰ Μενάλκα,	-- -uu- uu- --u u--	dactylic hexameter	masculine penthemimeral, hepthemimeral
οὔποτε νικασεῖς μ᾽,οὐδ᾽ εἴ τι πάθοις τύγ᾽ ἀείδων."	-uu --- - - u u- u u--	dactylic hexameter	masculine penthemimeral, hepthemimeral
χρῄσδεις ὧν ἐσιδεῖν; χρῄσδεις καταθεῖναι ἄεθλον;	-- - uu- -- uu-u u--	dactylic hexameter	masculine penthemimeral, hepthemimeral, trithemimeral
χρῄσδω τοῦτ᾽ ἐσιδεῖν, χρῄσδω καταθεῖναι ἄεθλον.	-- - uu- -- uu-u u--	dactylic hexameter	masculine penthemimeral, hepthemimeral, trithemimeral
καὶ τίνα θησεύμεσθ᾽, ὅτις ἁμῖν ἄρκιος εἴη;	- uu --- uu -- -uu --	dactylic hexameter	masculine penthemimeral
μόσχον ἐγὼ θησῶ· τὺ δὲ θὲς ἰσομάτορα ἀμνόν.	-u u- -- u u - uu-uu --	dactylic hexameter	masculine penthemimeral, hepthemimeral, trithemimeral
οὐ θησῶ ποκα ἀμνόν, ἐπεὶ χαλεπὸς ὁ πατήρ μευ	- -- uu -u u- uu- u u- -	dactylic hexameter	feminine penthemimeral, hepthemimeral, trithemimeral
χἁ μάτηρ, τὰ δὲ μᾶλα ποθέσπερα πάντ᾽ ἀριθμεῦντι.	- -- u u -u u-uu - uu--	dactylic hexameter	feminine penthemimeral, trithemimeral
ἀλλὰ τί μὰν θησεῖς; τί δὲ τὸ πλέον ἑξεῖ ὁ νικῶν;	-u u - -- u u - uu -u u --	dactylic hexameter	masculine penthemimeral, hepthemimeral, trithemimeral
σύριγγ᾽ ἃν ἐπόησα καλὰν ἐγὼ ἐννεάφωνον,	-- - uu-u u- uu -uu--	dactylic hexameter	feminine penthemimeral, hepthemimeral, trithemimeral
λευκὸν κηρὸν ἔχοισαν, ἴσον κάτω, ἶσον ἄνωθεν,	-- -u u-u u- uu -u u--	dactylic hexameter	feminine penthemimeral, hepthemimeral
ταύταν κατθείην, τὰ δὲ τῶ πατρὸς οὐ καταθησῶ.	-- --- u u - uu - uu--	dactylic hexameter	masculine penthemimeral, hepthemimeral
ἦ μάν τοι κἠγὼ σύριγγ᾽ ἔχω ἐννεάφωνον.	- - - -- -- uu -uu--	dactylic hexameter	masculine penthemimeral, hepthemimeral, trithemimeral
λευκὸν κηρὸν ἔχοισαν, ἴσον κάτω, ἶσον ἄνωθεν.	-- -u u-u u- uu -u u--	dactylic hexameter	feminine penthemimeral, hepthemimeral
πρώαν νιν συνέπαξ᾽· ἔτι καὶ τὸν δάκτυλον ἀλγέω	-- - uu- uu - - -uu --	dactylic hexameter	masculine penthemimeral, hepthemimeral, trithemimeral
τοῦτον, ἐπεὶ κάλαμός με διασχισθεὶς διέτμαξεν.	-u u- uu- u u--- uu--	dactylic hexameter	masculine penthemimeral, trithemimeral
ἀλλὰ τίς ἄμμε κρινεῖ; τίς ἐπάκοος ἔσσεται ἁμέων;	-u u -u u- u u-uu -uu --	dactylic hexameter	masculine penthemimeral
τῆνον πῶς ἐνταῦθα τὸν αἰπόλον ἢν καλέσωμες;	-- - --u u -uu - uu--	dactylic hexameter	feminine penthemimeral, trithemimeral
ᾧ ποτὶ ταῖς ἐρίφοις ὁ κύων ὁ φάλαρος ὑλακτεῖ.	- uu - uu- u u- u u-u u--	dactylic hexameter	masculine penthemimeral, hepthemimeral, trithemimeral
χοἱ μὲν παῖδες ἄυσαν, ὁ δ᾽αἰπόλος ἦνθ᾽ ἐπακοῦσαι.	- - -- -u u -uu - uu--	dactylic hexameter	feminine penthemimeral
χοἱ μὲν παῖδες ἄειδον, ὁ δ᾽αἰπόλος ἤθελε κρίνειν.	- - -u u-u u -uu -uu --	dactylic hexameter	feminine penthemimeral
πρᾶτος δ᾽ὦν ἄειδε λαχὼν ἰυκτὰ Μενάλκας,	-- - --u u- --u u--	dactylic hexameter	feminine penthemimeral, hepthemimeral, trithemimeral
εἶτα δ᾽ἀμοιβαίαν ὑπελάμβανε Δάφνις ἀοιδάν.	-u u--- uu-uu -u u--	dactylic hexameter	masculine penthemimeral
βουκολικάν· οὕτω δὲ Μενάλκας ἄρξατο πρᾶτος.	-uu- -- u u-- -uu --	dactylic hexameter	masculine penthemimeral, trithemimeral
Ἄγκεα καὶ ποταμοί, θεῖον γένος, αἴ τι Μενάλκας	-uu - uu- -- uu - u u--	dactylic hexameter	masculine penthemimeral, hepthemimeral, trithemimeral
πήποχ᾽ ὁ συριγκτὰς προσφιλὲς ᾆσε μέλος,	-u u --- -uu -u u-	dactylic pentameter	
βόσκοιτ᾽ ἐκ ψυχᾶς τὰς ἀμνάδας· ἢν δέ ποκ᾽ ἔνθῃ	-- - -- - -uu - u u --	dactylic hexameter	masculine penthemimeral, trithemimeral
Δάφνις ἔχων δαμάλας, μηδὲν ἔλασσον ἔχοι.	-u u- uu- -u u-u u-	dactylic pentameter	
κρᾶναι καὶ βοτάναι, γλυκερὸν φυτόν, αἴπερ ὁμοῖον	-- - uu- uu- uu -u u--	dactylic hexameter	masculine penthemimeral, hepthemimeral, trithemimeral
μουσίσδει Δάφνις ταῖσιν ἀηδονίσι,	--- -- -u u-uu-	dactylic pentameter	
τοῦτο τὸ βουκόλιον πιαίνετε· κἤν τι Μενάλκας	-u u -uu- --uu - u u--	dactylic hexameter	masculine penthemimeral
τεῖδ᾽ ἀγάγῃ, χαίρων ἄφθονα πάντα νέμοι.	- uu- -- -uu -u u-	dactylic pentameter	
ἔνθ᾽ ὄις, ἔνθ᾽ αἶγες διδυματόκοι, ἔνθα μέλισσαι	- - - -- uu-uu -u u--	dactylic hexameter	masculine penthemimeral, trithemimeral
σμήνεα πληροῦσιν, καὶ δρύες ὑψίτεραι,	-uu --- - uu -uu-	dactylic pentameter	
ἔνθ᾽ ὁ καλὸς Μίλων βαίνει ποσίν· αἰ δ᾽ἂν ἀφέρπῃ,	- u u- -- -- uu - u u--	dactylic hexameter	masculine penthemimeral, hepthemimeral, trithemimeral
χὡ ποιμὴν ξηρὸς τηνόθι χαἱ βοτάναι.	- -- -- -uu - uu-	dactylic pentameter	
παντᾷ ἔαρ, παντᾷ δὲ νομοί, παντᾷ δὲ γάλακτος	-u u- -- u u- -- u u--	dactylic hexameter	masculine penthemimeral, hepthemimeral, trithemimeral
οὔθατα πλήθουσιν, καὶ τὰ νέα τρέφεται,	-uu --- - u u- uu-	dactylic pentameter	
ἐνθ᾽ ἁ καλὰ παῖς ἐπινίσσεται· αἰ δ᾽ἂν ἀφέρπῃ,	- u u- - ---uu - u u--	dactylic hexameter	trithemimeral
χὡ τὰς βῶς βόσκὡν χαἱ βόες αὐότεραι.	- - - -- - uu -uu-	dactylic pentameter	
ὦ τράγε, τᾶν λευκᾶν αἰγῶν ἄνερ, ὧ βάθος ὕλας	- uu - -- -- uu - uu --	dactylic hexameter	masculine penthemimeral, hepthemimeral, trithemimeral
μυρίον, (ὦ σιμαὶ δεῦτ᾽ ἐφ᾽ ὕδωρ ἔριφοι·)	-uu - -- - u u- uu-	dactylic pentameter	
ἐν τήνῳ γὰρ τῆνος· ἴθ᾽ ὦ κόλε καὶ λέγε· Μίλων,	- -- - -u u - uu - uu --	dactylic hexameter	feminine penthemimeral, hepthemimeral, trithemimeral
ὁ Πρωτεὺς φώκας καὶ θεὸς ὢν ἔνεμε.	- -- -- - uu - uu-	dactylic pentameter	
μή μοι γᾶν Πέλοπος, μή μοι χρύσεια τάλαντα	- - - uu- - - --u u--	dactylic hexameter	masculine penthemimeral, hepthemimeral, trithemimeral
εἴη ἔχειν, μηδὲ πρόσθε θέειν ἀνέμων·	-u u- -- -u u- uu-	dactylic pentameter	
ἀλλ᾽ ὑπὸ τᾷ πέτρᾳ τᾷδ᾽ ᾁσομαι, ἀγκὰς ἔχων τυ,	- uu - -- - -uu -u u- -	dactylic hexameter	masculine penthemimeral, trithemimeral
σύννομα μᾶλ᾽ ἐσορῶν, τὰν Σικελὰν ἐς ἅλα.	-uu - uu- - uu- u u-	dactylic pentameter	
δένδρεσι μὲν χειμὼν φοβερὸν κακόν, ὕδασι δ᾽αὐχμός,	-uu - -- uu- uu -uu --	dactylic hexameter	masculine penthemimeral, hepthemimeral, trithemimeral
ὄρνισιν δ᾽ὕσπλαγξ, ἀγροτέροις δὲ λίνα,	--- -- -uu- u u-	dactylic pentameter	
ἀνδρὶ δὲ παρθενικᾶς ἁπαλᾶς πόθος. ὦ πάτερ ὦ Ζεῦ,	-u u -uu- uu- uu - uu - -	dactylic hexameter	masculine penthemimeral, hepthemimeral
οὐ μόνος ἠράσθην· καὶ τὺ γυναικοφίλας.	- uu --- - u u-uu-	dactylic pentameter	
ταῦτα μὲν ὦν δι᾽ ἀμοιβαίων οἱ παῖδες ἄεισαν·	-u u - u u--- - -u u--	dactylic hexameter	hepthemimeral, trithemimeral
τὰν πυμάταν δ᾽ᾠδὰν οὑτῶς ἐξᾶρχε Μενάλκας.	- uu- -- -- --u u--	dactylic hexameter	masculine penthemimeral, hepthemimeral, trithemimeral
Φεἰδευ τᾶν ἐρίφων, φείδευ λύκε τᾶν τοκάδων μευ,	-- - uu- -- uu - uu- -	dactylic hexameter	masculine penthemimeral, hepthemimeral, trithemimeral
μηδ᾽ ἀδίκει μ᾽,ὅτι μικκὸς ἐὼν πολλαῖσιν ὁμαρτέω.	- uu- uu -u u- --u u---	lyric	
ὦ Λάμπουρε κύον, οὕτω βαθὺς ὕπνος ἔχει τυ;	- --u u- -- uu -u u- -	dactylic hexameter	masculine penthemimeral, hepthemimeral
οὐ χρὴ κοιμᾶσθαι βαθέως σὺν παιδὶ νέμοντα.	- - --- uu- - -u u--	dactylic hexameter	masculine penthemimeral, hepthemimeral
ταὶ δ᾽ὄιες, μηδ᾽ ὔμμες ὀκνεῖθ᾽ ἁπαλᾶς κορέσασθαι	- -- - -u u- uu- uu--	dactylic hexameter	feminine penthemimeral, hepthemimeral, trithemimeral
ποίας· οὔτι καμεῖσθ᾽, ὅκκ᾽ αὖ πάλιν ἅδε φύηται.	-- -u u- - - uu -u u--	dactylic hexameter	masculine penthemimeral, hepthemimeral
σίττα νέμεσθε νέμεσθε, τὰ δ᾽οὔθατα πλήσατε πᾶσαι,	-u u-u u-u u -uu -uu --	dactylic hexameter	feminine penthemimeral
ὡς τὸ μὲν ὥρνες ἔχωντι, τὸ δ᾽ἐς ταλάρως ἀποθῶμαι.	- u u -u u-u u - uu- uu--	dactylic hexameter	feminine penthemimeral, hepthemimeral
δεύτερος αὖ Δάφνις λιγυρῶς ἀνεβάλλετ᾽ ἀείδειν·	-uu - -- uu- uu-u u--	dactylic hexameter	masculine penthemimeral, hepthemimeral, trithemimeral
κἠμὲ γὰρ ἐκ τὤντρω σύνοφρυς κόρα ἐχθὲς ἰδοῖσα	-u u - -- uu- uu -u u--	dactylic hexameter	masculine penthemimeral, hepthemimeral, trithemimeral
τὰς δαμάλας παρελᾶντα καλὸν καλὸν ἦμεν ἔφασκεν·	- uu- uu-u u- uu -u u--	dactylic hexameter	feminine penthemimeral, hepthemimeral, trithemimeral
οὐ μὰν οὐδὲ λόγον ἐκρίθην ἄπο, τὤμπικρον αὐτᾷ,	- - -u u- uu- uu -uu --	dactylic hexameter	masculine penthemimeral, hepthemimeral
ἀλλὰ κάτω βλέψας τὰν ἁμετέραν ὁδὸν εἷρπον.	-u u- -- u u-uu -- --	dactylic hexameter	masculine penthemimeral, trithemimeral
ἁδεῖ᾽ ἁ φωνὰ τᾶς πόρτιος, ἁδὺ τὸ πνεῦμα·	-- - -- - -uu -u u --	dactylic hexameter	masculine penthemimeral, trithemimeral
ἁδὺ δὲ χὡ μόσχος γαρύεται, ἁδὺ δὲ χἁ βῶς·	-u u - -- uu-u u- u - -	lyric	
ἁδὺ δὲ τῶ θέρεος παρ᾽ ὕδωρ ῥέον αἰθριοκοιτεῖν.	-u u - uu- u u- uu -uu--	dactylic hexameter	masculine penthemimeral, hepthemimeral, trithemimeral
τᾷ δρυῒ ταὶ βάλανοι κόσμος, τᾷ μαλίδι μᾶλα,	- uu - uu- -- - -uu --	dactylic hexameter	masculine penthemimeral, hepthemimeral, trithemimeral
τᾷ βοῒ δ᾽ἁ μόσχος, τῷ βουκόλῳ αἱ βόες αὐταί.	- uu - -- - -uu - uu --	dactylic hexameter	masculine penthemimeral, trithemimeral
Ὣς οἱ παῖδες ἄεισαν, ὁ δ᾽αἰπόλος ὧδ᾽ ἀγόρευεν·	- - -u u-u u -uu - uu--	dactylic hexameter	feminine penthemimeral
ἁδύ τι τὸ στόμα τευ καὶ ἐφίμερος ὦ Δάφνι φωνά.	-u u - uu - u u-uu - uu --	dactylic hexameter	masculine penthemimeral, trithemimeral
κρέσσον μελπομένω τευ ἀκουέμεν ἢ μέλι λείχειν.	-- -uu- u u-uu - uu --	dactylic hexameter	masculine penthemimeral
λάζεο τὰς σύριγγας· ἐνίκασας γὰρ ἀείδων.	-uu - --u u--- u u--	dactylic hexameter	feminine penthemimeral, trithemimeral
αἰ δέ τι λῇς με καὶ αὐτὸν ἅμ᾽ αἰπολέοντα διδάξαι,	- u u - u u -u u -uu-u u--	dactylic hexameter	feminine penthemimeral, trithemimeral
τήναν τὰν μιτύλαν δωσῶ τὰ δίδακτρά τοι αἶγα,	-- - uu- -- u u-u u --	dactylic hexameter	masculine penthemimeral, hepthemimeral, trithemimeral
ἅτις ὑπὲρ κεφαλᾶς αἰεὶ τὸν ἀμολγέα πληροῖ.	-u u- uu- -- u u-uu --	dactylic hexameter	masculine penthemimeral, hepthemimeral, trithemimeral
Ὡς μὲν ὁ παῖς ἐχάρη καὶ ἀνάλατο καὶ πλατάγησε	- u u - uu- u u-uu - uu--	dactylic hexameter	masculine penthemimeral, trithemimeral
νικάσας, οὑτῶς ἐπὶ ματέρι νεβρὸς ἅλοιτο.	-uu -- -u u-- -u u--	dactylic hexameter	feminine penthemimeral
ὡς δὲ κατεσμύχθη καὶ ἀνετράπετο φρένα λύπᾳ	- u u-- - --uu- uu --	dactylic hexameter	masculine penthemimeral
ὥτερος, οὕτω καὶ νύμφα γαμεθεῖσ᾽ ἀκάχοιτο.	-uu -- - -- uu- uu--	dactylic hexameter	masculine penthemimeral, hepthemimeral
κἠκ τούτω πρᾶτος παρὰ ποιμέσι Δάφνις ἔγεντο,	- -- -- uu -uu -u u--	dactylic hexameter	masculine penthemimeral, trithemimeral
καὶ Νύμφαν ἄκρηβος ἐὼν ἔτι Ναΐδα γᾶμεν.	- -- --u u- uu -uu --	dactylic hexameter	feminine penthemimeral, hepthemimeral, trithemimeral
Βουκολιάζεο Δάφνι, τὺ δ᾽ᾠδᾶς ἄρχεο πρᾶτος,	-uu-uu -u u -- -uu --	dactylic hexameter	feminine penthemimeral
ᾠδᾶς ἄρχεο Δάφνι, συναψάσθω δὲ Μενάλκας,	-- -uu -u u--- u u--	dactylic hexameter	feminine penthemimeral
μόσχως βουσὶν ὑφέντες, ὑπὸ στείραισι δὲ ταύρως.	-- -u u-u u- --u u --	dactylic hexameter	feminine penthemimeral, hepthemimeral
χοἱ μὲν ἁμᾷ βόσκοιντο καὶ ἐν φύλλοισι πλανῷντο	- u u- --u u - --u u--	dactylic hexameter	feminine penthemimeral, hepthemimeral, trithemimeral
μηδὲν ἀτιμαγελεῦντες· ἐμὶν δὲ τὺ βουκολιάζευ	-u u-uu-u u- u u -uu--	dactylic hexameter	feminine penthemimeral, hepthemimeral
ἐκτόθεν, ἄλλωθεν δὲ ποτικρίνοιτο Μενάλκας.	-uu --- u u---u u--	dactylic hexameter	masculine penthemimeral
Ἁδὺ μὲν ἁ μόσχος γαρύεται, ἁδὺ δὲ χἁ βοῦς,	-u u - -- uu-u u- u - -	lyric	
ἁδὺ δὲ χἁ σῦριγξ χὡ βουκόλος, ἁδὺ δὲ κἠγών.	-u u - -- - -uu -u u --	dactylic hexameter	masculine penthemimeral, trithemimeral
ἔστι δέ μοι παρ᾽ ὕδωρ ψυχρὸν στιβάς, ἐν δὲ νένασται	-u u - u u- -- uu - u u--	dactylic hexameter	masculine penthemimeral, hepthemimeral, trithemimeral
λευκᾶν ἐκ δαμαλᾶν καλὰ δέρματα, τάς μοι ἁπάσας	-- - uu- uu -uu - u u--	dactylic hexameter	masculine penthemimeral, trithemimeral
λὶψ κόμαρον τρωγοίσας ἀπὸ σκοπιᾶς ἐτίναξε.	- uu- --u u- uu- uu--	dactylic hexameter	feminine penthemimeral, hepthemimeral, trithemimeral
τῶ δὲ θέρευς φρύγοντος ἐγὼ τόσσον μελεδαίνω,	- u u- --u u- -- uu--	dactylic hexameter	feminine penthemimeral, hepthemimeral, trithemimeral
ὅσσον ἐρῶντε πατρὸς μύθων καὶ ματρὸς ἀκούειν.	-u u-u u- -- - -u u--	dactylic hexameter	masculine penthemimeral, hepthemimeral
οὑτῶς Δάφνις ἄεισεν ἐμίν, οὑτῶς δὲ Μενάλκας.	-- -u u-u u- -- u u--	dactylic hexameter	feminine penthemimeral, hepthemimeral
Αἴτνα μᾶτερ ἐμά, κἠγὼ καλὸν ἄντρον ἐνοικέω	-- -u u- -- uu -u u--	dactylic hexameter	masculine penthemimeral, hepthemimeral
κοίλαις ἐν πέτραισιν· ἔχω δέ τοι ὅσσ᾽ ἐν ὀνείρῳ	-- - --u u- u u - u u--	dactylic hexameter	feminine penthemimeral, hepthemimeral, trithemimeral
φαίνονται, πολλὰς μὲν ὄις, πολλὰς δὲ χιμαίρας,	--- -- - - -- u u--	dactylic hexameter	masculine penthemimeral, hepthemimeral, trithemimeral
ὧν μοι πρὸς κεφαλᾷ καὶ πρὸς ποσὶ κώεα κεῖται.	- - - uu- - - uu -uu --	dactylic hexameter	masculine penthemimeral, hepthemimeral, trithemimeral
ἐν πυρὶ δὲ δρυίνῳ χόρια ζεῖ, ἐν πυρὶ δ᾽αὖαι	- uu - -- uu- - - uu --	dactylic hexameter	masculine penthemimeral, hepthemimeral, trithemimeral
φαγοὶ χειμαίνοντος· ἔχω δέ τοι οὐδ᾽ ὅσον ὤραν	-- ---u u- u u - uu --	dactylic hexameter	feminine penthemimeral, hepthemimeral
χείματος ἢ νωδὸς καρύων ἀμύλοιο παρόντος.	-uu - -- uu- uu-u u--	dactylic hexameter	masculine penthemimeral, hepthemimeral, trithemimeral
τοῖς μὲν ἐπεπλατάγησα καὶ αὐτίκα δῶρον ἔδωκα,	- u u-uu-u u -uu -u u--	dactylic hexameter	feminine penthemimeral
Δάφνιδι μὲν κορύναν, τάν μοι πατρὸς ἔτρεφεν ἀγρός,	-uu - uu- - - uu -uu --	dactylic hexameter	masculine penthemimeral, hepthemimeral, trithemimeral
αὐτοφυῆ, τὰν οὐδ᾽ ἂν ἴσως μωμάσατο τέκτων,	-uu- - - u u- --uu --	dactylic hexameter	masculine penthemimeral, hepthemimeral, trithemimeral
τήνῳ δὲ στρόμβω καλὸν ὄστρακον, ὧ κρέας αὐτὸς	-- - -- uu -uu - uu --	dactylic hexameter	masculine penthemimeral, trithemimeral
σιτήθην πέτραισιν ἐν Ἰκαρίαισι δοκεύσας,	--- --u u -uu-u u--	dactylic hexameter	feminine penthemimeral, trithemimeral
πέντε ταμὼν πέντ᾽ οὖσιν· ὁ δ᾽ἐγκαναχήσατο κόχλῳ.	-u u- - -u u -uu-uu --	dactylic hexameter	feminine penthemimeral, trithemimeral
Βουκολικαὶ Μοῖσαι μάλα χαίρετε, φαίνετε δ᾽ᾠδάς,	-uu- -- uu -uu -uu --	dactylic hexameter	masculine penthemimeral, trithemimeral
τάς ποκ᾽ ἐγὼ τήνοισι παρὼν ἄεισα νομεῦσι,	- u u- --u u- --u u--	dactylic hexameter	feminine penthemimeral, hepthemimeral, trithemimeral
μηκέτ᾽ ἐπὶ γλώσσας ἄκρας ὀλοφυγγόνα φύσω.	-u u- -- -- uu-uu --	dactylic hexameter	masculine penthemimeral, hepthemimeral, trithemimeral
τέττιξ μὲν τέττιγι φίλος, μύρμακι δὲ μύρμαξ,	-- - --u u- --u u --	dactylic hexameter	feminine penthemimeral, hepthemimeral, trithemimeral
ἴρηκες δ᾽ἴρηξιν, ἐμὶν δέ τε μοῖσα καὶ ᾠδά.	--- --u u- u u -u u --	dactylic hexameter	feminine penthemimeral, hepthemimeral, trithemimeral
τᾶς μοι πᾶς εἴη πλεῖος δόμος. οὔτε γὰρ ὕπνος	- - - -- -- uu -u u --	dactylic hexameter	masculine penthemimeral, hepthemimeral, trithemimeral
οὔτ᾽ ἔαρ ἐξαπίνας γλυκερώτερον, οὔτε μελίσσαις	- uu -uu- uu-uu -u u--	dactylic hexameter	masculine penthemimeral
ἄνθεα· τόσσον ἐμὶν Μοῖσαι φίλαι. οὓς μὲν ὁρεῦντι	-uu -u u- -- uu - u u--	dactylic hexameter	masculine penthemimeral, hepthemimeral
γαθεῦσαι, τοὺς δ᾽οὔτι ποτῷ δαλήσατο Κίρκη.	--- - -u u- --uu --	dactylic hexameter	feminine penthemimeral, hepthemimeral, trithemimeral
