Εὐνείκα μ᾽ἐγέλαξε θέλοντά μιν ἁδὺ φιλῆσαι,	--- uu-u u-u u -u u--	dactylic hexameter	feminine penthemimeral, trithemimeral
καί μ᾽ἐπικερτομέοισα τάδ᾽ ἔννεπεν· "ἔρρ᾽ ἀπ᾽ ἐμεῖο.	- uu-uu-u u -uu - u u--	dactylic hexameter	feminine penthemimeral
βουκόλος ὢν ἐθέλεις με κύσαι τάλαν; οὐ μεμάθηκα	-uu - uu- u u- uu - uu--	dactylic hexameter	masculine penthemimeral, hepthemimeral, trithemimeral
ἀγροίκως φιλέειν, ἀλλ᾽ ἀστικὰ χείλεα θλίβειν.	--- uu- - -uu -uu --	dactylic hexameter	masculine penthemimeral, trithemimeral
μή τύ γέ μευ κύσσῃς τὸ καλὸν στόμα μηδ᾽ ἐν ὀνείροις.	- u u - -- u u- uu - u u--	dactylic hexameter	masculine penthemimeral, hepthemimeral, trithemimeral
οἷα βλέπεις, ὁπποῖα λαλεῖς, ὡς ἄγρια παίσδεις,	-u u- --u u- - -uu --	dactylic hexameter	feminine penthemimeral, hepthemimeral, trithemimeral
ὡς τρυφέρ᾽ αἰκάλλεις, ὡς κωτίλα ῥήματα φράσδεις·	- uu --- - -uu -uu --	dactylic hexameter	masculine penthemimeral
ὡς μαλακὸν τὸ γένειον ἔχεις, ὡς ἁδέα χαίταν.	- uu- u u-u u- - -uu --	dactylic hexameter	feminine penthemimeral, hepthemimeral, trithemimeral
χείλεά τοι νοσέοντι, χέρες δέ τοι ἐντὶ μέλαιναι,	-uu - uu-u u- u u -u u--	dactylic hexameter	feminine penthemimeral, hepthemimeral, trithemimeral
καὶ κακὸν ἐξόσδεις. ἀπ᾽ ἐμεῦ φύγε, μή με μολύνῃς."	- uu --- u u- uu - u u--	dactylic hexameter	masculine penthemimeral, hepthemimeral
τοιάδε μυθίζοισα τρὶς εἰς ἑὸν ἔπτυσε κόλπον,	-uu ---u u - uu -uu --	dactylic hexameter	feminine penthemimeral, hepthemimeral
καί μ᾽ἀπὸ τᾶς κεφαλᾶς ποτὶ τὼ πόδε συνεχὲς εἶδε	- uu - uu- uu - uu -uu --	dactylic hexameter	masculine penthemimeral, hepthemimeral, trithemimeral
χείλεσι μυχθίζοισα καὶ ὄμμασι λοξὰ βλέποισα,	-uu ---u u -uu -u u--	dactylic hexameter	feminine penthemimeral
καὶ πολὺ τᾷ μορφᾷ θηλύνετο, καί τι σεσαρὸς	- uu - -- --uu - u u--	dactylic hexameter	masculine penthemimeral, trithemimeral
καὶ σοβαρόν μ᾽ἐγέλαξεν. ἐμοὶ δ᾽ἄφαρ ἔζεσεν αἷμα,	- uu- uu-u u- uu -uu --	dactylic hexameter	feminine penthemimeral, hepthemimeral, trithemimeral
καὶ χρόα φοινίχθην ὑπὸ τὤλγεος ὡς ῥόδον ἕρσᾳ.	- uu --- uu -uu - uu --	dactylic hexameter	masculine penthemimeral
χἁ μὲν ἔβα με λιποῖσα· φέρω δ᾽ὑποκάρδιον ὀργάν,	- u u- u u-u u- uu-uu --	dactylic hexameter	feminine penthemimeral, hepthemimeral, trithemimeral
ὅττί με τὸν χαρίεντα κακὰ μωμήσαθ᾽ ἑταίρα.	-u u - uu-u u- --u u--	dactylic hexameter	feminine penthemimeral, hepthemimeral, trithemimeral
ποιμένες, εἴπατέ μοι τὸ κρήγυον· οὐ καλὸς ἐμμί;	-uu -uu - - -uu - uu --	dactylic hexameter	masculine penthemimeral
ἆρά τις ἐξαπίνας με θεὸς βροτὸν ἄλλον ἔτευξε;	-u u -uu- u u- uu -u u--	dactylic hexameter	masculine penthemimeral, hepthemimeral
καὶ γὰρ ἐμοὶ τὸ πάροιθεν ἐπάνθεεν ἁδύ τι κάλλος	- u u- u u-u u-uu -u u --	dactylic hexameter	feminine penthemimeral, trithemimeral
ὡς κισσὸς ποτὶ πρέμνον, ἐμὰν δ᾽ἐπύκαζεν ὑπήναν,	- -- uu -u u- uu-u u--	dactylic hexameter	feminine penthemimeral, hepthemimeral, trithemimeral
χαῖται δ᾽οἷα σέλινα περὶ κροτάφοισι κέχυντο,	-- -u u-u u- uu-u u--	dactylic hexameter	feminine penthemimeral, hepthemimeral
καὶ λευκὸν τὸ μέτωπον ἐπ᾽ ὀφρύσι λάμπε μελαίναις·	- -- u u-u u -uu -u u--	dactylic hexameter	feminine penthemimeral, trithemimeral
ὄμματά μοι γλαυκᾶς χαροπώτερα πολλὸν Ἀθάνας,	-uu - -- uu-uu -u u--	dactylic hexameter	masculine penthemimeral, trithemimeral
καὶ στόμα δ᾽αὖ πακτᾶς γλυκερώτερον, ἐκ στομάτων δὲ	- uu - -- uu-uu - uu- -	dactylic hexameter	masculine penthemimeral, trithemimeral
ἔρρεέ μοι φωνὰ γλυκερωτέρα ἢ μέλι κηρῶ.	-uu - -- uu-uu - uu --	dactylic hexameter	masculine penthemimeral, trithemimeral
ἁδὺ δέ μοι τὸ μέλισμα, καὶ ἢν σύριγγι μελίσδω,	-u u - u u-u u - --u u--	dactylic hexameter	feminine penthemimeral, hepthemimeral, trithemimeral
κἢν αὐλῷ δονέω, κἢν δώνακι, κἢν πλαγιαύλῳ.	- -- uu- - -uu - uu--	dactylic hexameter	masculine penthemimeral, trithemimeral
καὶ πᾶσαι καλόν με κατ᾽ ὤρεα φαντὶ γυναῖκες,	- -- -- u u -uu -u u--	dactylic hexameter	masculine penthemimeral, trithemimeral
καὶ πᾶσαί με φιλεῦντι· τὰ δ᾽ἀστικά μ᾽οὐκ ἐφίλασεν,	- -- u u-u u -uu - uu--	dactylic hexameter	feminine penthemimeral, trithemimeral
ἀλλ᾽ ὅτι βουκόλος ἐμμὶ παρέδραμε κοὔποτ᾽ ἀκούει,	- uu -uu -u u-uu -u u--	dactylic hexameter	feminine penthemimeral
ὡς ὁ καλὸς Διόνυσος ἐν ἄγκεσι πόρτιν ἔλαυνεν·	- u u- uu-u u -uu -u u--	dactylic hexameter	feminine penthemimeral, trithemimeral
οὐκ ἔγνω δ᾽,ὅτι Κύπρις ἐπ᾽ ἀνέρι μήνατο βούτᾳ	- -- uu -u u -uu -uu --	dactylic hexameter	feminine penthemimeral, trithemimeral
καὶ Φρυγίοις ἐνόμευσεν ἐν ὤρεσι καὶ τὸν Ἄδωνιν	- uu- uu-u u -uu - u u--	dactylic hexameter	feminine penthemimeral, trithemimeral
ἐν δρυμοῖσι φίλασε καὶ ἐν δρυμοῖσιν ἔκλαυσεν.	- --u u-u u - --u u--	dactylic hexameter	feminine penthemimeral, hepthemimeral
Ἐνδυμίων δὲ τίς ἦν; οὐ βουκόλος; ὅν γε Σελάνα	-uu- u u - - -uu - u u--	dactylic hexameter	masculine penthemimeral, trithemimeral
βουκολέοντα φίλασεν, ἀπ᾽ Οὐλύμπω δὲ μολοῖσα	-uu-u u-u u --- u u--	dactylic hexameter	feminine penthemimeral
λάθριον ἀν νάπος ἦλθε καὶ εἰς ἕνα παιδὶ κάθευδε.	-uu - uu -u u - uu -u u--	dactylic hexameter	feminine penthemimeral, hepthemimeral, trithemimeral
καὶ τὺ Ῥέα κλαίεις τὸν βουκόλον. οὐχὶ δὲ καὶ τὺ	- u u- -- - -uu -u u - -	dactylic hexameter	masculine penthemimeral, trithemimeral
ὦ Κρονίδα διὰ παῖδα βοηνόμον ὄρνις ἐπλάγχθης;	- uu- uu -u u-uu -u u--	dactylic hexameter	feminine penthemimeral, trithemimeral
Εὐνείκα δὲ μόνα τὸν βουκόλον οὐκ ἐφίλασεν,	--- u u- - -uu - uu--	dactylic hexameter	masculine penthemimeral, trithemimeral
ἁ Κυβέλας κρέσσων καὶ Κύπριδος ἠδὲ Σελάνας.	- uu- -- - -uu -u u--	dactylic hexameter	masculine penthemimeral, trithemimeral
μηκέτι μηδὲ σὺ Κύπρι τὸν ἁδέα μήτε κατ᾽ ἄστυ	-uu -u u -u u -uu -u u --	dactylic hexameter	feminine penthemimeral
μήτ᾽ ἐν ὄρει φιλέοις, μούνη δ᾽ἀνὰ νύκτα καθεύδοις.	- u u- uu- -- uu -u u--	dactylic hexameter	masculine penthemimeral, hepthemimeral, trithemimeral
Ἁ πενία Διόφαντε μόνα τὰς τέχνας ἐγείρει,	- uu- uu-u u- - -u u--	dactylic hexameter	feminine penthemimeral, hepthemimeral, trithemimeral
αὐτὰ τῶ μόχθοιο διδάσκαλος· οὐδὲ γὰρ εὕδειν	-- - --u u-uu -u u --	dactylic hexameter	feminine penthemimeral, trithemimeral
ἀνδράσιν ἐργατίναισι κακαὶ παρέχοντι μέριμναι.	-uu -uu-u u- uu-u u--	dactylic hexameter	feminine penthemimeral, hepthemimeral
κἂν ὀλίγον νυκτός τις ἐπιμύσσῃσι, τὸν ὕπνον	- uu- -- u u---u u --	dactylic hexameter	masculine penthemimeral, trithemimeral
αἰφνίδιον θορυβεῦσιν ἐφιστάμεναι μελεδῶναι.	-uu- uu-u u-uu- uu--	dactylic hexameter	feminine penthemimeral, trithemimeral
Ἰχθύος ἀγρευτῆρες ὅμως δύο κεῖντο γέροντες,	-uu ---u u- uu -u u--	dactylic hexameter	feminine penthemimeral, hepthemimeral
στρωσάμενοι βρύον αὖον ὑπὸ πλεκταῖς καλύβαισι,	-uu- uu -u u- -- uu--	dactylic hexameter	feminine penthemimeral, hepthemimeral, trithemimeral
κεκλιμένοι τοίχῳ τῷ φυλλίνῳ· ἐγγύθι δ᾽αὐτοῖν	-uu- -- - -uu -uu --	dactylic hexameter	masculine penthemimeral, trithemimeral
κεῖτο τὰ ταῖν χειροῖν ἀθλήματα, τοὶ καλαθίσκοι,	-u u - -- --uu - uu--	dactylic hexameter	masculine penthemimeral, trithemimeral
τοὶ κάλαμοι, τἄγκιστρα τὰ φυκιόεντα δέλητα	- uu- --u u -uu-u u--	dactylic hexameter	feminine penthemimeral, trithemimeral
ὁρμιαὶ κύρτοι τε καὶ ἐκ σχοίνων λαβύρινθοι,	--- -- u u - -- uu--	dactylic hexameter	masculine penthemimeral, hepthemimeral, trithemimeral
μήρινθοι κώπα τε γέρων τ᾽ἐπ᾽ ἐρείσμασι λέμβος·	--- -- u u- u u-uu --	dactylic hexameter	masculine penthemimeral, hepthemimeral, trithemimeral
νέρθεν τᾶς κεφαλᾶς φορμὸς βραχύς, εἷμά τ᾽ἐπί σφι	-- - uu- -- uu -u u- -	dactylic hexameter	masculine penthemimeral, hepthemimeral, trithemimeral
οὗτος τοῖς ἁλιεῦσιν ὁ πᾶς πόρος, οὗτος ὁ πλοῦτος.	-- - uu-u u - uu -u u --	dactylic hexameter	feminine penthemimeral, hepthemimeral, trithemimeral
οὐδεὶς δ᾽οὐ σισύραν εἶχ᾽ οὐ λίνα· πάντα περισσά,	-- - uu- - - uu -u u--	dactylic hexameter	masculine penthemimeral, hepthemimeral, trithemimeral
πάντ᾽ ἐδόκει τήνοις· ἁ γὰρ πενία σφας ἔτειρε	- uu- -- - - uu- u u--	dactylic hexameter	masculine penthemimeral, hepthemimeral, trithemimeral
οὐδεὶς δ᾽ἐν μέσσῳ γείτων· πενίᾳ δὲ παρ᾽ αὐτὰν	-- - -- -- uu- u u --	dactylic hexameter	masculine penthemimeral, hepthemimeral, trithemimeral
θλιβομέναν καλύβαν τρυφερὸν προσέναχε θάλασσα.	-uu- uu- uu- uu-u u--	dactylic hexameter	masculine penthemimeral, hepthemimeral, trithemimeral
κοὔπω τὸν μέσατον δρόμον ἄνυεν ἅρμα Σελάνας,	-- - uu- uu -uu -u u--	dactylic hexameter	masculine penthemimeral, trithemimeral
τοὺς δ᾽ἁλιεῖς ἤγειρε φίλος πόνος, ἐκ βλεφάρων δὲ	- uu- --u u- uu - uu- -	dactylic hexameter	feminine penthemimeral, hepthemimeral, trithemimeral
ὕπνον ἀπωσάμενοι σφετέραις φρεσὶν ἤρεθον αὐδάν.	-u u-uu- uu- uu -uu --	dactylic hexameter	masculine penthemimeral, hepthemimeral
ψεύδοντ᾽ ὦ φίλε πάντες, ὅσοι τὰς νύκτας ἔφασκον	-- - uu -u u- - -u u--	dactylic hexameter	feminine penthemimeral, hepthemimeral, trithemimeral
τῶ θέρεος μινύθειν, ὅτε τἄματα μακρὰ φέρει Ζεύς.	- uu- uu- uu -uu -u u- -	dactylic hexameter	masculine penthemimeral, trithemimeral
ἤδη μυρί᾽ ἐσεῖδον ὀνείρατα, κοὐδέπω ἀώς.	-- -u u-u u-uu -uu --	dactylic hexameter	feminine penthemimeral
μὴ λαθόμην; τί τὸ χρῆμα; χρόνον δ᾽αἱ νύκτες ἔχοντι.	- uu- u u -u u- - -u u--	dactylic hexameter	feminine penthemimeral, hepthemimeral, trithemimeral
Ἀσφαλίων, μέμφῃ τὸ καλὸν θέρος; οὐ γὰρ ὁ καιρὸς	-uu- -- u u- uu - u u --	dactylic hexameter	masculine penthemimeral, hepthemimeral, trithemimeral
αὐτομάτως παρέβα τὸν ἑὸν δρόμον· ἀλλὰ τὸν ὕπνον	-uu- uu- u u- uu -u u --	dactylic hexameter	masculine penthemimeral, hepthemimeral, trithemimeral
ἁ φροντὶς κόπτοισα μακρὰν τὰν νύκτα ποιεῖ τοι.	- -- --u u- - -u u- -	dactylic hexameter	feminine penthemimeral, hepthemimeral, trithemimeral
ἆρ᾽ ἔμαθες κρίνειν πόκ᾽ ἐνύπνια; χρηστὰ γὰρ εἶδον.	- uu- -- u u-uu -u u --	dactylic hexameter	masculine penthemimeral, trithemimeral
οὔ δε θέλω τὠμῶ φαντάσματος ἦμεν ἄμοιρον.	- u u- -- --uu -u u--	dactylic hexameter	masculine penthemimeral, trithemimeral
ὡς καὶ τὰν ἄγραν, τὠνείρατα πάντα μερίζευ.	- - - -- --uu -u u--	dactylic hexameter	masculine penthemimeral, trithemimeral
ὃς γὰρ ἂν εἰκάξῃ κατὰ τὸν νόον οὗτος ἄριστος	- u u --- uu - uu -u u--	dactylic hexameter	masculine penthemimeral, hepthemimeral
ἐστὶν ὀνειροκρίτας, ὁ διδάσκαλός ἐστι παρ᾽ ᾧ νοῦς.	-u u-uu- u u-uu -u u - -	dactylic hexameter	masculine penthemimeral
ἄλλως καὶ σχολά ἐστι· τί γὰρ ποιεῖν ἂν ἔχοι τις	-- - uu -u u - -- u u- -	dactylic hexameter	feminine penthemimeral, hepthemimeral, trithemimeral
κείμενος ἐν φύλλοις ποτὶ κύματι μηδὲ καθεύδων,	-uu - -- uu -uu -u u--	dactylic hexameter	masculine penthemimeral, trithemimeral
ἀλλ᾽ ὄνος ἐν ῥάμνῳ τό τε λύχνιον ἐν πρυτανείῳ·	- uu - -- u u -uu - uu--	dactylic hexameter	masculine penthemimeral, trithemimeral
φαντὶ γὰρ ἀγρυπνίαν τόδ᾽ ἔχειν. λέγε μοί ποτε νυκτὸς	-u u -uu- u u- uu - uu --	dactylic hexameter	masculine penthemimeral, hepthemimeral
ὄψιν, ἐπεὶ τά τις οἶδε λέγει μανύεν ἑταίρῳ.	-u u- u u -u u- uu- ---	dactylic hexameter	feminine penthemimeral, hepthemimeral, trithemimeral
δειλινὸν ὡς κατέδαρθον ἐν εἰναλίοισι πόνοισιν	-uu - uu-u u -uu-u u--	dactylic hexameter	feminine penthemimeral, trithemimeral
(οὐ μὰν ἦν πολύσιτος, ἐπεὶ δειπνεῦντες ἐν ὥρᾳ,	- - - uu-u u- --u u --	dactylic hexameter	feminine penthemimeral, hepthemimeral, trithemimeral
εἰ μέμνῃ, τᾶς γαστρὸς ἐφειδόμεθ᾽), εἶδον ἐμαυτὸν	- -- - -u u-uu -u u--	dactylic hexameter	feminine penthemimeral, trithemimeral
ἐν πέτρᾳ μεμαῶτα, καθεζόμενος δ᾽ἐδόκευον	- -- uu-u u-uu- uu--	dactylic hexameter	feminine penthemimeral, trithemimeral
ἰχθύας, ἐκ καλάμων δὲ πλάνον κατέσειον ἐδωδάν.	-uu - uu- u u- uu-u u--	dactylic hexameter	masculine penthemimeral, hepthemimeral, trithemimeral
καί τις τῶν τραφερῶν ὠρέξατο· καὶ γὰρ ἐν ὕπνοις	- - - uu- --uu - u u --	dactylic hexameter	masculine penthemimeral, trithemimeral
πᾶσα κύων ἄρκτον μαντεύεται, ἰχθύα κἠγών.	-u u- -- --uu -uu --	dactylic hexameter	masculine penthemimeral, trithemimeral
χὡ μὲν τὠγκίστρῳ ποτεφύετο, καὶ ῥέεν αἷμα,	- - --- uu-uu - uu --	dactylic hexameter	masculine penthemimeral
τὸν κάλαμον δ᾽ὑπὸ τῶ κινήματος ἀγκύλον εἶχον	- uu- uu - --uu -uu --	dactylic hexameter	masculine penthemimeral, trithemimeral
τὼ χέρε τεινόμενον περικλώμενον, εὐρὺν ἀγῶνα,	- uu -uu- uu-uu -u u--	dactylic hexameter	masculine penthemimeral
πῶς νιν ἕλω μέγαν ἰχθὺν ἀφαυροτέροισι σιδάροις.	- u u- uu -u u-uu-u u--	dactylic hexameter	feminine penthemimeral, trithemimeral
εἶθ᾽ ὑπομιμνάσκων τῶ τρώματος ἠρέμ᾽ ἔνυξα,	- uu--- - -uu -u u--	dactylic hexameter	masculine penthemimeral
καὶ νύξας ἐχάλαξα, καὶ οὐ φεύγοντος ἔτεινα.	- -- uu-u u - --u u--	dactylic hexameter	feminine penthemimeral, hepthemimeral, trithemimeral
ἤνυσα δ᾽ὦν τὸν ἄεθλον, ἀνείλκυσα χρύσεον ἰχθύν,	-uu - u u-u u-uu -uu --	dactylic hexameter	feminine penthemimeral, trithemimeral
παντᾷ τοι χρυσῷ πεπυκασμένον· εἶχε δὲ δεῖμα,	-- - -- uu-uu -u u --	dactylic hexameter	masculine penthemimeral, trithemimeral
μήτι Ποσειδάωνι πέλοι πεφιλημένος ἰχθὺς	-u u---u u- uu-uu --	dactylic hexameter	feminine penthemimeral, hepthemimeral
ἢ τάχα τᾶς γλαυκᾶς κειμήλιον Ἀμφιτρίτης.	- uu - -- --uu ----	dactylic hexameter	masculine penthemimeral, trithemimeral
ἠρέμα δ᾽αὐτὸν ἐγὼν ἐκ τὠγκίστρω ἀπέλυσα,	-uu -u u- - --- uu--	dactylic hexameter	masculine penthemimeral
μή ποτε τῶ στόματος τἀγκίστρια χρυσὸν ἔχοιεν.	- uu - uu- --uu -u u--	dactylic hexameter	masculine penthemimeral, trithemimeral
καὶ τὸν μὲν πίστευσα καλεῖν τὸν ἐπήρατον ἰχθύν,	- - - --u u- u u-uu --	dactylic hexameter	feminine penthemimeral, hepthemimeral, trithemimeral
ὤμοσα δ᾽οὐκέτι λοιπὸν ὑπὲρ πελάγους πόδα θεῖναι,	-uu -uu -u u- uu- uu --	dactylic hexameter	feminine penthemimeral, hepthemimeral
ἀλλὰ μενεῖν ἐπὶ γᾶς καὶ τῷ χρυσῷ βασιλεύσειν.	-u u- uu - - - -- uu--	dactylic hexameter	masculine penthemimeral, hepthemimeral, trithemimeral
ταῦτά με κἀξήγειρε, τὺ δ᾽ὦ ξένε λοιπὸν ἔρειδε	-u u ---u u - uu -u u--	dactylic hexameter	feminine penthemimeral, hepthemimeral
τὰν γνώμαν· ὅρκον γὰρ ἐγὼ τὸν ἐπώμοσα ταρβῶ.	- -- -- u u- u u-uu --	dactylic hexameter	masculine penthemimeral, hepthemimeral, trithemimeral
καὶ σύγε τί τρέσσεις; οὐκ ὤμοσας· οὐδὲ γὰρ ἰχθὺν	- uu - -- - -uu -u u --	dactylic hexameter	masculine penthemimeral, trithemimeral
χρύσεον ὡς ἴδες εὗρες, ἴσα δ᾽ἦν ψεύδεσιν ὄψις,	-uu - uu -u u- - -uu --	dactylic hexameter	feminine penthemimeral, hepthemimeral, trithemimeral
ἐλπὶς τῶν ὕπνων. ζάτει τὸν σάρκινον ἰχθύν,	-- - -- -- - -uu --	dactylic hexameter	masculine penthemimeral, hepthemimeral, trithemimeral
εἰ γάρ πᾳ κνώσσων ἔτ᾽ ἐτώσια ταῦτα ματεύσεις,	- - - -- u u-uu -u u--	dactylic hexameter	masculine penthemimeral, trithemimeral
μὴ σὺ θάνῃς λιμῷ καίτοι χρυσοῖσιν ὀνείροις.	- u u- -- -- --u u--	dactylic hexameter	masculine penthemimeral, hepthemimeral, trithemimeral
Ὕμνέομεν Λήδας τε καὶ αἰγιόχου Διὸς υἱώ,	-uu- -- u u -uu- uu --	dactylic hexameter	masculine penthemimeral, trithemimeral
Κάστορα καὶ φοβερὸν Πολυδεύκεα πὺξ ἐρεθίζειν	-uu - uu- uu-uu - uu--	dactylic hexameter	masculine penthemimeral, trithemimeral
χεῖρας ἐπιζεύξαντα μέσας βοέοισιν ἱμᾶσιν.	-u u---u u- uu-u u--	dactylic hexameter	feminine penthemimeral, hepthemimeral
ὑμνέομεν καὶ δὶς καὶ τὸ τρίτον ἄρσενα τέκνα	-uu- - - - - uu -uu --	dactylic hexameter	masculine penthemimeral, hepthemimeral, trithemimeral
κούρης Θεστιάδος, Λακεδαιμονίους δύ᾽ ἀδελφούς,	-- -uu- uu-uu- u u--	dactylic hexameter	masculine penthemimeral
ἀνθρώπων σωτῆρας ἐπὶ ξυροῦ ἤδη ἐόντων,	--- --u u- uu -u u--	dactylic hexameter	feminine penthemimeral, hepthemimeral, trithemimeral
ἵππων θ᾽αἱματόεντα ταρασσομένων καθ᾽ ὅμιλον,	-- -uu-u u-uu- u u--	dactylic hexameter	feminine penthemimeral
νηῶν θ᾽,αἳ δύνοντα καὶ οὐρανὸν ἐξανύοντα	-- - --u u -uu -uu--	dactylic hexameter	feminine penthemimeral, trithemimeral
ἄστρα βιαζόμεναι χαλεποῖς ἐνέκυρσαν ἀήταις.	-u u-uu- uu- uu-u u--	dactylic hexameter	masculine penthemimeral, hepthemimeral
οἱ δέ σφεων κατὰ πρύμναν ἀείραντες μέγα κῦμα,	- - - uu -u u--- uu --	dactylic hexameter	feminine penthemimeral, trithemimeral
ἠὲ καὶ ἐκ πρῴρηθεν, ἢ ὅππῃ θυμὸς ἑκάστου,	-u u - --u u -- -u u--	dactylic hexameter	feminine penthemimeral, trithemimeral
ἐς κοίλην ἔρριψαν, ἀνέρρηξαν δ᾽ἄρα τοίχους	- -- --u u--- uu --	dactylic hexameter	feminine penthemimeral, trithemimeral
ἀμφοτέρους· κρέμαται δὲ σὺν ἱστίῳ ἄρμενα πάντα	-uu- uu- u u -uu -uu --	dactylic hexameter	masculine penthemimeral, trithemimeral
εἰκῇ ἀποκλασθέντα· πολὺς δ᾽ἐξ οὐρανοῦ ὄμβρος	-u u---u u- - -uu --	dactylic hexameter	feminine penthemimeral, hepthemimeral
νυκτὸς ἐφερπούσης· παταγεῖ δ᾽εὐρεῖα θάλασσα,	-u u--- uu- --u u--	dactylic hexameter	masculine penthemimeral, hepthemimeral
κοπτομένη πνοιαῖς τε καὶ ἀρρήκτοισι χαλάζαις.	-uu- -- u u ---u u--	dactylic hexameter	masculine penthemimeral, trithemimeral
ἀλλ᾽ ἔμπης ὑμεῖς γε καὶ ἐκ βυθοῦ ἕλκετε νῆας	- -- -- u u - uu -uu --	dactylic hexameter	masculine penthemimeral, hepthemimeral, trithemimeral
αὐτοῖσιν ναύτῃσιν ὀιομένοις θανέεσθαι·	--- --u u-uu- uu--	dactylic hexameter	feminine penthemimeral, trithemimeral
αἶψα δ᾽ἀπολήγοντ᾽ ἄνεμοι, λιπαρὴ δὲ γαλάνη	-u u--- uu- uu- u u--	dactylic hexameter	masculine penthemimeral, hepthemimeral
ἀμπέλαγος· νεφέλαι δὲ διέδραμον ἄλλυδις ἄλλαι·	-uu- uu- u u-uu -uu --	dactylic hexameter	masculine penthemimeral, trithemimeral
ἐκ δ᾽ἄρκτοι τ᾽ἐφάνησαν, ὄνων τ᾽ἀνὰ μέσσον ἀμαυρὴ	- -- uu-u u- uu -u u--	dactylic hexameter	feminine penthemimeral, hepthemimeral, trithemimeral
φάτνη σημαίνοισα τὰ πρὸς πλόον εὔδια πάντα.	-- ---u u - uu -uu --	dactylic hexameter	feminine penthemimeral, hepthemimeral
ὦ ἄμφω θνητοῖσι βοηθόοι, ὦ φίλοι ἄμφω,	- -- --u u-uu - uu --	dactylic hexameter	feminine penthemimeral, trithemimeral
ἱππῆες κιθαρισταί, ἀεθλητῆρες ἀοιδοί·	--- uu-u u---u u--	dactylic hexameter	feminine penthemimeral, trithemimeral
Κάστορος ἢ πρώτου Πολυδεύκεος ἄρξομ᾽ ἀείδειν;	-uu - -- uu-uu -u u--	dactylic hexameter	masculine penthemimeral, trithemimeral
ἀμφοτέρους ὑμνέων Πολυδεύκεα πρῶτον ἀείσω.	-uu- -- uu-uu -u u--	dactylic hexameter	masculine penthemimeral, trithemimeral
Ἡ μὲν ἄρα προφυγοῦσα πέτρας εἰς ἓν ξυνιούσας	- u u- uu-u u- - - uu--	dactylic hexameter	feminine penthemimeral, hepthemimeral, trithemimeral
Ἀργὼ καὶ νιφόεντος ἀταρτηρὸν στόμα Πόντου	-- - uu-u u--- uu --	dactylic hexameter	feminine penthemimeral, trithemimeral
Βέβρυκας εἰσαφίκανε θεῶν φίλα τέκνα φέρουσα.	-uu -uu-u u- uu -u u--	dactylic hexameter	feminine penthemimeral, hepthemimeral
ἔνθα μιῆς πολλοὶ κατὰ κλίμακος ἀμφοτέρων ἒξ	-u u- -- uu -uu -uu- -	dactylic hexameter	masculine penthemimeral, trithemimeral
τοίχων ἄνδρες ἔβαινον Ἰησονίης ἀπὸ νηός.	-- -u u-u u-uu- uu --	dactylic hexameter	feminine penthemimeral
ἐκβάντες δ᾽ἐπὶ θῖνα βαθὺν καὶ ὑπήνεμον ἀκτὴν	--- uu -u u- u u-uu --	dactylic hexameter	feminine penthemimeral, hepthemimeral, trithemimeral
εὐνάς τ᾽ἐστόρνυντο πυρεῖά τε χερσὶν ἐνώμων.	-- ---u u-u u -u u--	dactylic hexameter	feminine penthemimeral
Κάστωρ δ᾽αἰολόπωλος ὅ τ᾽οἰνωπὸς Πολυδεύκης	-- -uu-u u --- uu--	dactylic hexameter	feminine penthemimeral
ἄμφω ἐρημάζεσκον ἀποπλαγχθέντες ἑταίρων,	-u u---u u---u u--	dactylic hexameter	feminine penthemimeral
παντοίην ἐν ὄρει θηεύμενοι ἄγριον ὕλην.	--- u u- --uu -uu --	dactylic hexameter	masculine penthemimeral, trithemimeral
εὗρον δ᾽ἀέναον κρήνην ὑπὸ λισσάδι πέτρῃ	-- -uu- -- uu -uu --	dactylic hexameter	masculine penthemimeral, hepthemimeral
ὕδατι πεπληθυῖαν ἀκηράτῳ· αἱ δ᾽ὑπένερθεν	-uu ---u u-uu - uu--	dactylic hexameter	feminine penthemimeral
λάλλαι κρυστάλλῳ ἠδ᾽ ἀργύρῳ ἰνδάλλοντο	-- --- - -uu ----	dactylic hexameter	masculine penthemimeral
ἐκ βυθοῦ· ὑψηλαὶ δὲ πεφύκεσαν ἀγχόθι πεῦκαι	- uu --- u u-uu -uu --	dactylic hexameter	masculine penthemimeral
λεῦκαί τε πλάτανοί τε καὶ ἀκρόκομοι κυπάρισσοι,	-- - uu- u u -uu- uu--	dactylic hexameter	masculine penthemimeral, trithemimeral
ἄνθεά τ᾽εὐώδη, λασίαις φίλα ἔργα μελίσσαις,	-uu --- uu- uu -u u--	dactylic hexameter	masculine penthemimeral, hepthemimeral
ὅσσ᾽ ἔαρος λήγοντος ἐπιβρύει ἀν λειμῶνας.	- uu- --u u-uu - ---	dactylic hexameter	feminine penthemimeral, trithemimeral
ἔνθα δ᾽ἀνὴρ ὑπέροπλος ἐνήμενος ἐνδιάασκε,	-u u- uu-u u-uu -uu--	dactylic hexameter	feminine penthemimeral, trithemimeral
δεινὸς ἰδεῖν, σκληραῖσι τεθλασμένος οὔατα πυγμαῖς·	-u u- --u u-uu -uu --	dactylic hexameter	feminine penthemimeral, trithemimeral
στήθεα δ᾽ἐσφαίρωτο πελώρια καὶ πλατὺ νῶτον	-uu ---u u-uu - uu --	dactylic hexameter	feminine penthemimeral
σαρκὶ σιδηρείῃ, σφυρήλατος οἷα κολοσσός.	-u u--- --uu -u u--	dactylic hexameter	masculine penthemimeral
ἐν δὲ μύες στερεοῖσι βραχίοσιν ἄκρον ὑπ᾽ ὦμον	- u u- uu-u u-uu -u u --	dactylic hexameter	feminine penthemimeral, trithemimeral
ἕστασαν ἠύτε πέτροι ὁλοίτροχοι, οὕστε κυλίνδων	-uu -uu -u u-uu -u u--	dactylic hexameter	feminine penthemimeral
χειμάρρους ποταμὸς μεγάλαις περιέξεσε δίναις·	--- uu- uu- uu-uu --	dactylic hexameter	masculine penthemimeral, hepthemimeral, trithemimeral
αὐτὰρ ὑπὲρ νώτοιο καὶ αὐχένος ᾐωρεῖτο	-u u- --u u -uu ----	dactylic hexameter	feminine penthemimeral, trithemimeral
ἄκρων δέρμα λέοντος ἀφημμένον ἐκ ποδεώνων.	-- -u u-u u-uu - uu--	dactylic hexameter	feminine penthemimeral
τὸν πρότερος προσέειπεν ἀεθλοφόρος Πολυδεύκης.	- uu- uu-u u-uu- uu--	dactylic hexameter	feminine penthemimeral, trithemimeral
χαῖρε ξεῖν᾽, ὅτις ἐσσί. τίνες βροτοί, ὧν ὅδε χῶρος;	-- - uu -u u- uu - uu --	dactylic hexameter	feminine penthemimeral, hepthemimeral, trithemimeral
χαίρω πῶς, ὅτε τ᾽ἄνδρας ὁρῶ, τοὺς μὴ πρὶν ὄπωπα;	-- - uu -u u- - - u u--	dactylic hexameter	feminine penthemimeral, hepthemimeral, trithemimeral
θάρσει. μήτ᾽ ἀδίκους μήτ᾽ ἐξ ἀδίκων φάθι λεύσσειν.	-- - uu- - - uu- uu --	dactylic hexameter	masculine penthemimeral, hepthemimeral, trithemimeral
θαρσέω, κοὐκ ἐκ σεῦ με διδάσκεσθαι τόδ᾽ ἔοικεν.	-- - - - u u--- u u--	dactylic hexameter	masculine penthemimeral, trithemimeral
ἄγριος εἶ, πρὸς πάντα παλίγκοτος, ἢ ὑπερόπτης;	-uu - - -u u-uu - uu--	dactylic hexameter	feminine penthemimeral, trithemimeral
τοιόσδ᾽ οἷον ὁρᾷς· τῆς σῆς γε μὲν οὐκ ἐπιβαίνω.	-- -u u- - - u u - uu--	dactylic hexameter	masculine penthemimeral, hepthemimeral
ἔλθοις, καὶ ξενίων γε τυχὼν πάλιν οἴκαδ᾽ ἱκάνοις.	-- - uu- u u- uu -u u--	dactylic hexameter	masculine penthemimeral, hepthemimeral, trithemimeral
μήτε σύ με ξείνιζε, τά τ᾽ἐξ ἐμεῦ οὐκ ἐν ἑτοίμῳ.	-u u - --u u - uu - u u--	dactylic hexameter	feminine penthemimeral, hepthemimeral, trithemimeral
δαιμόνι᾽, οὐδ᾽ ἂν τοῦδε πιεῖν ὕδατος σύγε δοίης;	-uu - - -u u- uu- uu --	dactylic hexameter	feminine penthemimeral, hepthemimeral, trithemimeral
γνώσεαι, εἴ σευ δῖψος ἀνειμένα χείλεα τέρσει.	-uu - - -u u-uu -uu --	dactylic hexameter	feminine penthemimeral, trithemimeral
ἄργυρος ἢ τίς ὁ μισθός, ἐρεῖς, ᾧ κέν σε πίθοιμεν;	-uu - u u -u u- - - u u--	dactylic hexameter	feminine penthemimeral, hepthemimeral, trithemimeral
εἷς ἑνὶ χεῖρας ἄειρον ἐναντίος ἀνδρὶ καταστάς.	- uu -u u-u u-uu -u u--	dactylic hexameter	feminine penthemimeral
πυγμάχος, ἢ καὶ ποσσὶ θενὼν σκέλος; ὄμματά γ᾽ὀρθὸς	-uu - - -u u- uu -uu --	dactylic hexameter	feminine penthemimeral, hepthemimeral, trithemimeral
πὺξ διατεινάμενος σφετέρης μὴ φείδεο τέχνης.	- uu-uu- uu- - -uu --	dactylic hexameter	masculine penthemimeral, hepthemimeral
τίς γάρ, ὅτῳ χεῖρας καὶ ἐμοὺς συνερείσω ἱμάντας;	- u u- -- u u- uu-u u--	dactylic hexameter	masculine penthemimeral, hepthemimeral, trithemimeral
ἐγγὺς ὁρᾷς· οὐ γύννις ἐὼν κεκλήσεθ᾽ ὁ πύκτης.	-u u- - -u u- --u u --	dactylic hexameter	feminine penthemimeral, hepthemimeral, trithemimeral
ἦ καὶ ἄεθλον ἑτοῖμον, ἐφ᾽ ᾧ δηρισόμεθ᾽ ἄμφω	- u u-u u-u u - --uu --	dactylic hexameter	feminine penthemimeral, hepthemimeral
σὸς μὲν ἐγώ, σὺ δ᾽ἐμὸς κεκλήσεαι, αἴκε κρατήσω.	- u u- u u- --uu -u u--	dactylic hexameter	masculine penthemimeral, trithemimeral
ὀρνίθων φοινικολόφων τοιοίδε κυδοιμοί.	--- --uu- --u u--	dactylic hexameter	hepthemimeral, trithemimeral
εἴτ᾽ οὖν ὀρνίθεσσιν ἐοικότες εἴτε λέουσι	- - ---u u-uu -u u--	dactylic hexameter	feminine penthemimeral
γινόμεθ᾽, οὐκ ἄλλῳ γε μαχεσσαίμεσθ᾽ ἐπ᾽ ἀέθλῳ.	-uu - -- u u--- u u--	dactylic hexameter	masculine penthemimeral, trithemimeral
Ἠ ῥ᾽Ἄμυκος, καὶ κόχλον ἑλὼν μυκήσατοκοίλην.	- uu- - -u u- --uu--	dactylic hexameter	feminine penthemimeral, hepthemimeral, trithemimeral
οἱ δὲ θοῶς συνάγερθεν ὑπὸ σκιερὰς πλατανίστους	- u u- uu-u u- uu- uu--	dactylic hexameter	feminine penthemimeral, hepthemimeral, trithemimeral
κόχλου φυσηθέντος ἀεὶ Βέβρυκες κομόωντες.	-- ---u u- uu- uu--	dactylic hexameter	feminine penthemimeral, hepthemimeral
ὣς δ᾽αὔτως ἥρωας ἰὼν ἐκαλέσσατο πάντας	- -- --u u- uu-uu --	dactylic hexameter	feminine penthemimeral, hepthemimeral, trithemimeral
Μαγνήσσης ἀπὸ νηὸς ὑπείροχος ἐν δαῒ Κάστωρ.	--- uu -u u-uu - uu --	dactylic hexameter	feminine penthemimeral, trithemimeral
οἱ δ᾽ἐπεὶ οὖν σπείρῃσιν ἐκαρτύναντο βοείαις	- uu - --u u---u u--	dactylic hexameter	feminine penthemimeral, trithemimeral
χεῖρας καὶ περὶ γυῖα μακροὺς εἵλιξαν ἱμάντας,	-- - uu -u u- --u u--	dactylic hexameter	feminine penthemimeral, hepthemimeral, trithemimeral
ἐς μέσσον σύναγον φόνον ἀλλήλοισι πνέοντες.	- -- uu- uu ---u u--	dactylic hexameter	masculine penthemimeral, trithemimeral
ἔνθα πολύς σφισι μόχθος ἐπειγομένοισιν ἐτύχθη,	-u u- uu -u u-uu-u u--	dactylic hexameter	feminine penthemimeral, trithemimeral
ὁππότερος κατὰ νῶτα λάβοι φάος ἠελίοιο·	-uu- uu -u u- uu -uu--	dactylic hexameter	feminine penthemimeral, hepthemimeral, trithemimeral
ἰδρείῃ μέγαν ἄνδρα παρήλυθες ὦ Πολύδευκες,	--- uu -u u-uu - uu--	dactylic hexameter	feminine penthemimeral, trithemimeral
βάλλετο δ᾽ἀκτίνεσσιν ἅπαν Ἀμύκοιο πρόσωπον.	-uu ---u u- uu-u u--	dactylic hexameter	feminine penthemimeral, hepthemimeral
αὐτὰρ ὅγ᾽ ἐν θυμῷ κεχολωμένος ἵετο πρόσσω,	-u u - -- uu-uu -uu --	dactylic hexameter	masculine penthemimeral, trithemimeral
χερσὶ τιτυσκόμενος. τοῦ δ᾽ἄκρον τύψε γένειον	-u u-uu- - -- -u u--	dactylic hexameter	masculine penthemimeral
Τυνδαρίδης ἐπιόντος· ὀρίνθη δὲ πλέον ἢ πρίν,	-uu- uu-u u-- - uu - -	dactylic hexameter	feminine penthemimeral, trithemimeral
σὺν δὲ μάχην ἐτάραξε, πολὺς δ᾽ἐπέκειτο νενευκὼς	- u u- uu-u u- uu-u u--	dactylic hexameter	feminine penthemimeral, hepthemimeral, trithemimeral
ἐς γαῖαν. Βέβρυκες δ᾽ἐπαΰτεον, οἱ δ᾽ἑτέρωθεν	- -- uu- uu-uu - uu--	dactylic hexameter	masculine penthemimeral, trithemimeral
ἥρωες κρατερὸν Πολυδεύκεα θαρσύνεσκον,	--- uu- uu-uu ----	dactylic hexameter	masculine penthemimeral, trithemimeral
δειδιότες μή πώς μιν ἐπιβρίσας δαμάσειε	-uu- - - u u--- uu--	dactylic hexameter	masculine penthemimeral, trithemimeral
χώρῳ ἐνὶ στεινῷ Τιτυῷ ἐναλίγκιος ἀνήρ.	-u u- -- uu- uu-uu --	dactylic hexameter	masculine penthemimeral, hepthemimeral, trithemimeral
ἤτοι ὅγ᾽ ἔνθα καὶ ἔνθα παριστάμενος Διὸς υἱὸς	-u u -u u -u u-uu- uu --	dactylic hexameter	feminine penthemimeral
ἀμφοτέρῃσιν ἄμυσσεν ἀμοιβαδίς, ἔσχεθε δ᾽ὁρμῆς	-uu-u u-u u-uu -uu --	dactylic hexameter	feminine penthemimeral
παῖδα Ποσειδάωνος ὑπερφίαλόν περ ἐόντα.	-u u---u u-uu- u u--	dactylic hexameter	feminine penthemimeral
ἔστη δὲ πληγαῖς μεθύων, ἐκ δ᾽ἔπτυσεν αἷμα	-- - -- uu- - -uu --	dactylic hexameter	masculine penthemimeral, hepthemimeral, trithemimeral
φοίνιον· οἱ δ᾽ἅμα πάντες ἀριστῆες κελάδησαν,	-uu - uu -u u--- uu--	dactylic hexameter	feminine penthemimeral, trithemimeral
ὡς ἴδον ἕλκεα λυγρὰ περὶ στόμα τε γναθμούς τε·	- uu -uu -u u- uu - -- -	dactylic hexameter	feminine penthemimeral, hepthemimeral
ὄμματα δ᾽οἰδήσαντος ἀπεστείνωτο προσώπου.	-uu ---u u---u u--	dactylic hexameter	feminine penthemimeral
τὸν μὲν ἄναξ ἐτάρασσεν ἐτώσια χερσὶ προδεικνὺς	- u u- uu-u u-uu -u u--	dactylic hexameter	feminine penthemimeral, trithemimeral
πάντοθεν· ἀλλ᾽ ὅτε δή μιν ἀμηχανέοντ᾽ ἐνόησε,	-uu - uu - u u-uu- uu--	dactylic hexameter	masculine penthemimeral, trithemimeral
μέσσης ῥινὸς ὕπερθε κατ᾽ ὀφρύος ἤλασε πυγμῇ,	-- -u u-u u -uu -uu --	dactylic hexameter	feminine penthemimeral
πᾶν δ᾽ἀπέσυρε μέτωπον ἐς ὀστέον. αὐτὰρ ὁ πληγεὶς	- uu-u u-u u -uu -u u --	dactylic hexameter	feminine penthemimeral
ὕπτιος ἐν φύλλοισι τεθηλόσιν ἐξετανύσθη.	-uu - --u u-uu -uu--	dactylic hexameter	feminine penthemimeral, trithemimeral
ἔνθα μάχη δριμεῖα πάλιν γένετ᾽ ὀρθωθέντος·	-u u- --u u- uu ----	dactylic hexameter	feminine penthemimeral, hepthemimeral, trithemimeral
ἀλλήλους δ᾽ὄλεκον στερεοῖς θείνοντες ἱμᾶσιν.	--- uu- uu- --u u--	dactylic hexameter	masculine penthemimeral, hepthemimeral, trithemimeral
ἀλλ᾽ ὁ μὲν ἐς στῆθός τε καὶ ἔξω χεῖρας ἐνώμα	- u u - -- u u -- -u u--	dactylic hexameter	masculine penthemimeral, trithemimeral
αὐχένος ἀρχηγὸς Βεβρύκων· ὁ δ᾽ἀεικέσι πληγαῖς	-uu --- uu- u u-uu --	dactylic hexameter	masculine penthemimeral, hepthemimeral
πᾶν συνέφυρε πρόσωπον ἀνίκητος Πολυδεύκης.	- uu-u u-u u--- uu--	dactylic hexameter	feminine penthemimeral
σάρκες δ᾽αἱ μὲν ἱδρῶτι συνίζανον, ἐκ μεγάλου δὲ	-- - u u-u u-uu - uu- -	dactylic hexameter	feminine penthemimeral, trithemimeral
αἶψ᾽ ὀλίγος γένετ᾽ ἀνδρός· ὁ δ᾽αἰεὶ πάσσονα γυῖα	- uu- uu -u u -- -uu --	dactylic hexameter	feminine penthemimeral, trithemimeral
ἁπτομένου φορέεσκε πόνου καὶ χροιῇ ἀμείνων.	-uu- uu-u u- - -u u--	dactylic hexameter	feminine penthemimeral, hepthemimeral, trithemimeral
πῶς γὰρ δὴ Διὸς υἱὸς ἀδηφάγον ἄνδρα καθεῖλεν;	- - - uu -u u-uu -u u--	dactylic hexameter	feminine penthemimeral, trithemimeral
εἰπὲ θεά, σὺ γὰρ οἶσθα· ἐγὼ δ᾽ἑτέρων ὑποφήτης	-u u- u u -u u- uu- uu--	dactylic hexameter	feminine penthemimeral, hepthemimeral, trithemimeral
φθέγξομαι, ὡς ἐθέλεις σύ, καὶ ὅππως τοι φίλον αὐτῇ.	-uu - uu- u u -- - uu --	dactylic hexameter	masculine penthemimeral, trithemimeral
Ἤτοι ὅγε ῥέξαί τι λιλαιόμενος μέγα ἔργον	-u u- -- u u-uu- uu --	dactylic hexameter	masculine penthemimeral, trithemimeral
σκαιῇ μὲν σκαιὴν Πολυδεύκεος ἔλλαβε χεῖρα,	-- - -- uu-uu -uu --	dactylic hexameter	masculine penthemimeral, trithemimeral
δοχμὸς ἀπὸ προβολῆς κλινθείς, ἑτέρῃ δ᾽ἐπιβαίνων	-u u- uu- -- uu- uu--	dactylic hexameter	masculine penthemimeral, hepthemimeral, trithemimeral
δεξιτερῆς ἤνεγκεν ἀπὸ λαγόνος πλατὺ γυῖον.	-uu- --u u- uu- uu --	dactylic hexameter	feminine penthemimeral, hepthemimeral, trithemimeral
καί κε τυχὼν ἔβλαψεν Ἀμυκλαίων βασιλῆα.	- u u- --u u--- uu--	dactylic hexameter	feminine penthemimeral, trithemimeral
ἀλλ᾽ ὅγ᾽ ὑπεξανέδυ κεφαλῇ, στιβαρῇ δ᾽ἅμα χειρὶ	- u u-uu- uu- uu- uu --	dactylic hexameter	masculine penthemimeral, hepthemimeral
πλῆξεν ὑπὸ σκαιὸν κρόταφον καὶ ἐπέμπεσεν ὤμῳ·	-u u- -- uu- u u-uu --	dactylic hexameter	masculine penthemimeral, hepthemimeral, trithemimeral
ἐκ δ᾽ἐχύθη μέλαν αἷμα θοῶς κροτάφοιο χανόντος·	- uu- uu -u u- uu-u u--	dactylic hexameter	feminine penthemimeral, hepthemimeral, trithemimeral
λαιῇ δὲ στόμα κόψε, πυκνοὶ δ᾽ἀράβησαν ὀδόντες·	-- - uu -u u- uu-u u--	dactylic hexameter	feminine penthemimeral, hepthemimeral, trithemimeral
αἰεὶ δ᾽ὀξυτέρῳ πιτύλῳ δηλεῖτο πρόσωπον,	-- -uu- uu- --u u--	dactylic hexameter	masculine penthemimeral, hepthemimeral
μέχρι συνηλοίησε παρήια. πᾶς δ᾽ἐπὶ γαίῃ	-u u---u u-uu - uu --	dactylic hexameter	feminine penthemimeral
κεῖτ᾽ ἀλλοφρονέων, καὶ ἀνέσχεθε νεῖκος ἀπαυδῶν	- --uu- u u-uu -u u--	dactylic hexameter	masculine penthemimeral
ἀμφοτέρας ἅμα χεῖρας, ἐπεὶ θανάτου σχεδὸν ἦεν.	-uu- uu -u u- uu- uu --	dactylic hexameter	feminine penthemimeral, hepthemimeral, trithemimeral
τὸν μὲν ἄρα κρατέων περ ἀτάσθαλον οὐδὲν ἔρεξας,	- u u- uu- u u-uu -u u--	dactylic hexameter	masculine penthemimeral, trithemimeral
ὦ πύκτη Πολύδευκες· ὄμοσσε δέ τοι μέγαν ὅρκον,	- -- uu-u u-u u - uu --	dactylic hexameter	feminine penthemimeral, trithemimeral
ὃν πατέρ᾽ ἐκ πόντοιο Ποσειδάωνα κικλήσκων,	- uu - --u u---u u--	dactylic hexameter	feminine penthemimeral, trithemimeral
μήποτ᾽ ἔτι ξείνοισιν ἑκὼν ἀνιηρὸς ἔσεσθαι.	-u u- --u u- uu-u u--	dactylic hexameter	feminine penthemimeral, hepthemimeral, trithemimeral
καὶ σὺ μὲν ὕμνησαί μοι ἄναξ. σὲ δὲ Κάστορ ἀείσω,	- u u --- u u- u u -u u--	dactylic hexameter	masculine penthemimeral, hepthemimeral
Τυνδαρίδη ταχύπωλε δορυσσόε χαλκεοθώρηξ.	-uu- uu-u u-uu -uu--	dactylic hexameter	feminine penthemimeral, trithemimeral
τὼ μὲν ἀναρπάξαντε δύω φερέτην Διὸς υἱὼ	- u u---u u- uu- uu --	dactylic hexameter	feminine penthemimeral, hepthemimeral
δοιὰς Λευκίπποιο κόρας· δοιὼ δ᾽ἄρα τώγε	-- ---u u- -- uu --	dactylic hexameter	feminine penthemimeral, hepthemimeral
ἐσσυμένως ἐδίωκον ἀδελφεὼ υἷ᾽ Ἀφαρῆος,	-uu- uu-u u-uu - uu--	dactylic hexameter	feminine penthemimeral, trithemimeral
γαμβρὼ μελλογάμω, Λυγκεὺς καὶ ὁ καρτερὸς Ἴδας.	-- -uu- -- u u -uu --	dactylic hexameter	masculine penthemimeral, hepthemimeral
ἀλλ᾽ ὅτε τύμβον ἵκανον ἀποφθιμένου Ἀφαρῆος,	- uu -u u-u u-uu- uu--	dactylic hexameter	feminine penthemimeral
ἐκ δίφρων ἅμα πάντες ἐπ᾽ ἀλλήλοισιν ὄρουσαν,	- -- uu -u u ---u u--	dactylic hexameter	feminine penthemimeral, trithemimeral
ἔγχεσι καὶ κοίλοισι βαρυνόμενοι σακέεσσι.	-uu - --u u-uu- uu--	dactylic hexameter	feminine penthemimeral, trithemimeral
Λυγκεὺς δ᾽αὖ μετέειπεν ὑπὲκ κόρυθος μέγ᾽ ἀύσας·	-- - uu-u u- uu- - --	dactylic hexameter	feminine penthemimeral, hepthemimeral, trithemimeral
δαιμόνιοι, τί μάχης ἱμείρετε; πῶς δ᾽ἐπὶ νύμφαις	-uu- u u- --uu - uu --	dactylic hexameter	masculine penthemimeral, trithemimeral
ἀλλοτρίαις χαλεποί, γυμναὶ δ᾽ἐν χερσὶ μάχαιραι;	-uu- uu- -- - -u u--	dactylic hexameter	masculine penthemimeral, hepthemimeral, trithemimeral
ἡμῖν τοι Λεύκιππος ἑὰς ἕδνωσε θύγατρας	-- - --u u- --u u--	dactylic hexameter	feminine penthemimeral, hepthemimeral, trithemimeral
τάσδε πολὺ προτέροις, ἡμῖν γάμος οὗτος ἐν ὅρκῳ·	-u u- uu- -- uu -u u --	dactylic hexameter	masculine penthemimeral, hepthemimeral, trithemimeral
ὑμεῖς δ᾽οὐ κατὰ κόσμον ἐπ᾽ ἀλλοτρίοις λεχέεσσιν	-- - uu -u u -uu- uu--	dactylic hexameter	feminine penthemimeral, trithemimeral
βουσὶ καὶ ἡμιόνοισι καὶ ἄλλοισι κτεάτεσσιν	-u u -uu-u u --- uu--	dactylic hexameter	feminine penthemimeral
ἄνδρα παρετρέψασθε, γάμον δ᾽ἐκλέπτετε δώροις.	-u u---u u- --uu --	dactylic hexameter	feminine penthemimeral, hepthemimeral
ἦ μὰν πολλάκις ὔμμιν ἐνώπιον ἀμφοτέροισιν	- - -uu -u u-uu -uu--	dactylic hexameter	feminine penthemimeral
αὐτὸς ἐγὼ τάδ᾽ ἔειπα καὶ οὐ πολύμυθος ἐών περ·	-u u- u u-u u - uu-u u- -	dactylic hexameter	feminine penthemimeral, hepthemimeral, trithemimeral
"οὐχ οὕτω φίλοι ἄνδρες ἀριστήεσσιν ἔοικε	- -- uu -u u---u u--	dactylic hexameter	feminine penthemimeral, trithemimeral
μνηστεύειν ἀλόχους, αἷς νυμφίοι ἤδη ἑτοῖμοι.	--- uu- - -uu -u u--	dactylic hexameter	masculine penthemimeral, trithemimeral
πολλή τοι Σπάρτη, πολλὴ δ᾽ἱππήλατος ̂Ἠλις,	-- - -- -- --uu --	dactylic hexameter	masculine penthemimeral, hepthemimeral, trithemimeral
Ἀρκαδίη τ᾽εὔμηλος Ἀχαιῶν τε πτολίεθρα,	-uu- --u u-- - uu--	dactylic hexameter	feminine penthemimeral, trithemimeral
Μεσσήνη τε καὶ Ἄργος ἅπασά τε Σισυφὶς ἀκτή·	--- u u -u u-u u -uu --	dactylic hexameter	feminine penthemimeral, trithemimeral
ἔνθα κόραι τοκέεσσιν ὑπὸ σφετέροισι τρέφονται	-u u- uu-u u- uu-u u--	dactylic hexameter	feminine penthemimeral, hepthemimeral, trithemimeral
μυρίαι οὔτε φυῆς ἐπιδευέες οὔτε νόοιο.	-uu -u u- uu-uu -u u--	dactylic hexameter	masculine penthemimeral
τάων εὐμαρὲς ὔμμιν ὀπυίειν ἅς κ᾽ἐθέλητε·	-- -uu -u u-- - uu--	dactylic hexameter	feminine penthemimeral
ὡς ἀγαθοῖς πολέες βούλοιντό κε πενθεροὶ εἶναι·	- uu- uu- --u u -uu --	dactylic hexameter	masculine penthemimeral, trithemimeral
ὑμεῖς δ᾽ἐν πάντεσσι διάκριτοι ἡρώεσσι,	-- - --u u-uu ----	dactylic hexameter	feminine penthemimeral, trithemimeral
καὶ πατέρες καὶ ἄνωθεν ἅπαν πατρώιον αἷμα.	- uu- u u-u u- --uu --	dactylic hexameter	feminine penthemimeral, hepthemimeral, trithemimeral
ἀλλὰ φίλοι τοῦτον μὲν ἐάσατε πρὸς τέλος ἐλθεῖν	-u u- -- u u-uu - uu --	dactylic hexameter	masculine penthemimeral, trithemimeral
ἄμμι γάμον· σφῷν δ᾽ἄλλον ἐπιφραζώμεθα πάντες."	-u u- - -u u---uu --	dactylic hexameter	feminine penthemimeral, trithemimeral
ἴσκον τοιάδε πολλά, τὰ δ᾽εἰς ὑγρὸν ᾤχετο κῦμα	-- -uu -u u - uu -uu --	dactylic hexameter	feminine penthemimeral, hepthemimeral
πνοιὴ ἔχουσ᾽ ἀνέμοιο, χάρις δ᾽οὐχ ἕσπετο μύθοις.	-u u- uu-u u- - -uu --	dactylic hexameter	feminine penthemimeral, hepthemimeral, trithemimeral
σφὼ γὰρ ἀκηλήτω καὶ ἀπηνέες. ἀλλ᾽ ἔτι καὶ νῦν	- u u--- u u-uu - uu - -	dactylic hexameter	masculine penthemimeral
πείθεσθ᾽· ἄμφω δ᾽ἄμμιν ἀνεψιὼ ἐκ πατρὸς ἐστόν.	-- -- -u u-uu - uu --	dactylic hexameter	feminine penthemimeral
εἰ δ᾽ὑμῖν κραδίη πόλεμον ποθεῖ, αἵματι δὲ χρὴ	- -- uu- uu- uu -uu - -	dactylic hexameter	masculine penthemimeral, hepthemimeral, trithemimeral
νεῖκος ἀναρρήξαντας ὁμοίιον ἔγχεα λοῦσαι,	-u u---u u-uu -uu --	dactylic hexameter	feminine penthemimeral
Ἴδας μὲν καὶ ὅμαιμος ἐμός, κρατερὸς Πολυδεύκης,	-- - u u-u u- uu- uu--	dactylic hexameter	feminine penthemimeral, hepthemimeral, trithemimeral
χεῖρας ἐρωήσουσιν ἀπεχθομένης ὑσμίνης,	-u u---u u-uu- ---	dactylic hexameter	feminine penthemimeral
νῶι δ᾽,ἐγὼ Κάστωρ τε, διακρινώμεθ᾽ ἄρηι	-u u- -- u u---u u--	dactylic hexameter	masculine penthemimeral, trithemimeral
ὁπλοτέρω γεγαῶτε. γονεῦσι δὲ μὴ πολὺ πένθος	-uu- uu-u u-u u - uu --	dactylic hexameter	feminine penthemimeral, trithemimeral
ἡμετέροισι λίπωμεν. ἅλις νέκυς ἐξ ἑνὸς οἴκου	-uu-u u-u u- uu - uu --	dactylic hexameter	feminine penthemimeral, hepthemimeral
εἶς· ἀτὰρ ὥλλοι πάντες ἐυφρανέουσιν ἑταίρους	- uu -- -u u-uu-u u--	dactylic hexameter	feminine penthemimeral
νυμφίοι ἀντὶ νεκρῶν, ὑμεναιώσουσι δὲ κούρας	-uu -u u- uu---u u --	dactylic hexameter	masculine penthemimeral
τάσδ᾽· ὀλίγῳ τοι ἔοικε κακῷ μέγα νεῖκος ἀναιρεῖν.	- uu- u u-u u- uu -u u--	dactylic hexameter	feminine penthemimeral, hepthemimeral, trithemimeral
εἶπε, τὰ δ᾽οὐκ ἄρ᾽ ἔμελλε θεὸς μεταμώνια θήσειν.	-u u - u u-u u- uu-uu --	dactylic hexameter	feminine penthemimeral, hepthemimeral, trithemimeral
τὼ μὲν γὰρ ποτὶ γαῖαν ἀπ᾽ ὤμων τεύχε᾽ ἔθεντο,	- - - uu -u u -- -u u--	dactylic hexameter	feminine penthemimeral, trithemimeral
ὣ γενεῇ προφέρεσκον· ὁ δ᾽ἐς μέσον ἤλυθε Λυγκεύς,	- uu- uu-u u - uu -uu --	dactylic hexameter	feminine penthemimeral, hepthemimeral, trithemimeral
σείων καρτερὸν ἔγχος ὑπ᾽ ἀσπίδος ἄντυγα πρώτην·	-- -uu -u u -uu -uu --	dactylic hexameter	feminine penthemimeral
ὣς δ᾽αὔτως ἄκρας ἐτινάξατο δούρατος ἀκμὰς	- -- -- uu-uu -uu --	dactylic hexameter	masculine penthemimeral, trithemimeral
Κάστωρ· ἀμφοτέροις δὲ λόφων ἐπένευον ἔθειραι.	-- -uu- u u- uu-u u--	dactylic hexameter	masculine penthemimeral, hepthemimeral
ἔγχεσι μὲν πρώτιστα τιτυσκόμενοι πόνον εἶχον	-uu - --u u-uu- uu --	dactylic hexameter	feminine penthemimeral, trithemimeral
ἀλλήλων, εἴ πού τι χροὸς γυμνωθὲν ἴδοιεν.	--- - - u u- --u u--	dactylic hexameter	masculine penthemimeral, hepthemimeral, trithemimeral
ἀλλ᾽ ἤτοι τὰ μὲν ἄκρα πάρος τινὰ δηλήσασθαι	- -- u u -u u- uu ----	dactylic hexameter	feminine penthemimeral, hepthemimeral, trithemimeral
δοῦρ᾽ ἐάγη, σακέεσσιν ἐνὶ δεινοῖσι παγέντα.	- uu- uu-u u- --u u--	dactylic hexameter	feminine penthemimeral, hepthemimeral, trithemimeral
τὼ δ᾽ἄορ ἐκ κολεοῖο ἐρυσσαμένω φόνον αὖτις	- uu - uu-u u-uu- uu --	dactylic hexameter	feminine penthemimeral, trithemimeral
τεῦχον ἐπ᾽ ἀλλήλοισι· μάχης δ᾽οὐ γίνετ᾽ ἐρωή.	-u u ---u u- - -u u--	dactylic hexameter	feminine penthemimeral, hepthemimeral
πολλὰ μὲν ἐς σάκος εὐρὺ καὶ ἱππόκομον τρυφάλειαν	-u u - uu -u u -uu- uu--	dactylic hexameter	feminine penthemimeral, trithemimeral
Κάστωρ, πολλὰ δ᾽ἔνυξεν ἀκριβὴς ὄμμασι Λυγκεὺς	-- -u u-u u-- -uu --	dactylic hexameter	feminine penthemimeral
τοῖο σάκος, φοίνικα δ᾽ὅσον λόφον ἵκετ᾽ ἀκωκή.	-u u- --u u- uu -u u--	dactylic hexameter	feminine penthemimeral, hepthemimeral, trithemimeral
τοῦ μὲν ἄκρην ἐκόλουσεν ἐπὶ σκαιὸν γόνυ χεῖρα	- u u- uu-u u- -- uu --	dactylic hexameter	feminine penthemimeral, hepthemimeral, trithemimeral
φάσγανον ὀξὺ φέροντος ὑπεξαναβὰς ποδὶ Κάστωρ	-uu -u u-u u-uu- uu --	dactylic hexameter	feminine penthemimeral
σκαιῷ· ὁ δὲ πληγεὶς ξίφος ἔκβαλεν, αἶψα δὲ φεύγειν	-u u - -- uu -uu -u u --	dactylic hexameter	masculine penthemimeral, trithemimeral
ὡρμήθη ποτὶ σῆμα πατρός, τόθι καρτερὸς Ἴδας	--- uu -u u- uu -uu --	dactylic hexameter	feminine penthemimeral, hepthemimeral, trithemimeral
κεκλιμένος θηεῖτο μάχην ἐμφύλιον ἀνδρῶν.	-uu- --u u- --uu --	dactylic hexameter	feminine penthemimeral, hepthemimeral, trithemimeral
ἀλλὰ μεταΐξας πλατὺ φάσγανον ὦσε διαπρὸ	-u u--- uu -uu -u u--	dactylic hexameter	masculine penthemimeral
Τυνδαρίδης λαγόνος τε καὶ ὀμφαλοῦ· ἔγκατα δ᾽εἴσω	-uu- uu- u u -uu -uu --	dactylic hexameter	masculine penthemimeral, trithemimeral
χαλκὸς ἄφαρ διέχευεν· ὁ δ᾽ἐς στόμα κεῖτο νενευκὼς	-u u- uu-u u - uu -u u--	dactylic hexameter	feminine penthemimeral, hepthemimeral, trithemimeral
Λυγκεύς, κὰδ δ᾽ἄρα οἱ βλεφάρων βαρὺς ἔδραμεν ὕπνος.	-- - uu - uu- uu -uu --	dactylic hexameter	masculine penthemimeral, hepthemimeral, trithemimeral
οὐ μὰν οὐδὲ τὸν ἄλλον ἐφ᾽ ἑστίῃ εἶδε πατρῴῃ	- - -u u -u u -uu -u u--	dactylic hexameter	feminine penthemimeral
παίδων Λαοκόωσσα φίλον γάμον ἐκτελέσαντα.	-- -uu-u u- uu -uu--	dactylic hexameter	feminine penthemimeral, hepthemimeral
ἦ γὰρ ὅγε στήλην Ἀφαρηίου ἐξανέχουσαν	- u u- -- uu-uu -uu--	dactylic hexameter	masculine penthemimeral, trithemimeral
τύμβου ἀναρρήξας ταχέως Μεσσήνιος Ἴδας	-u u--- uu- --uu --	dactylic hexameter	masculine penthemimeral, hepthemimeral
μέλλε κασιγνήτοιο βαλεῖν σφετέροιο φονῆα·	-u u---u u- uu-u u--	dactylic hexameter	feminine penthemimeral, hepthemimeral
ἀλλὰ Ζεὺς ἐπάμυνε, χερῶν δέ οἱ ἔκβαλε τυκτὴν	-- - uu-u u- u u -uu --	dactylic hexameter	feminine penthemimeral, hepthemimeral, trithemimeral
μάρμαρον, αὐτὸν δὲ φλογέῳ συνέφλεξε κεραυνῷ.	-uu -- - uu- uu-u u--	dactylic hexameter	masculine penthemimeral, hepthemimeral
οὕτως Τυνδαρίδαις πολεμιζέμεν οὐκ ἐν ἐλαφρῷ.	-- -uu- uu-uu - u u--	dactylic hexameter	masculine penthemimeral
αὐτοί τε κρατέοντε καὶ ἐκ κρατέοντος ἔφυσαν.	-- - uu-u u - uu-u u--	dactylic hexameter	feminine penthemimeral, hepthemimeral, trithemimeral
χαίρετε Λήδας τέκνα, καὶ ἡμετέροις κλέος ὕμνοις	-uu -- -u u -uu- uu --	dactylic hexameter	feminine penthemimeral
ἐσθλὸν ἀεὶ πέμποιτε· φίλοι δέ τε πάντες ἀοιδοὶ	-u u- --u u- u u -u u--	dactylic hexameter	feminine penthemimeral, hepthemimeral, trithemimeral
Τυνδαρίδαις Ἑλένῃ τε καὶ ἄλλοις ἡρώεσσιν,	-uu- uu- u u -- ----	dactylic hexameter	masculine penthemimeral, trithemimeral
Ἴλιον οἳ διέπερσαν ἀρήγοντες Μενελάῳ.	-uu - uu-u u--- uu--	dactylic hexameter	feminine penthemimeral, trithemimeral
ὑμῖν κῦδος ἄνακτες ἐμήσατο Χῖος ἀοιδός,	-- -u u-u u-uu -u u--	dactylic hexameter	feminine penthemimeral
ὑμνήσας Πριάμοιο πόλιν καὶ νῆας Ἀχαιῶν	--- uu-u u- - -u u--	dactylic hexameter	feminine penthemimeral, hepthemimeral, trithemimeral
Ἰλιάδας τε μάχας Ἀχιλῆά τε πύργον ἀυτῆς·	-uu- u u- uu-u u -u u--	dactylic hexameter	masculine penthemimeral, trithemimeral
ὑμῖν αὖ καὶ ἐγὼ λιγεῶν μειλίγματα Μουσέων,	-- - u u- uu- --uu --	dactylic hexameter	masculine penthemimeral, hepthemimeral, trithemimeral
οἷ᾽ αὐταὶ παρέχουσι καὶ ὡς ἐμὸς οἶκος ὑπάρχει,	- -- uu-u u - uu -u u--	dactylic hexameter	feminine penthemimeral, hepthemimeral, trithemimeral
τοῖα φέρω. γεράων δὲ θεοῖς κάλλιστον ἀοιδαί.	-u u- uu- u u- --u u--	dactylic hexameter	masculine penthemimeral, hepthemimeral, trithemimeral
Ἀνήρ τις πολύφιλτρος ἀπηνέος ἤρατ᾽ ἐφάβω,	-- - uu-u u-uu -u u--	dactylic hexameter	feminine penthemimeral, trithemimeral
τὰν μορφὰν ἀγαθῶ, τὸν δὲ τρόπον οὐκέθ᾽ ὁμοίω.	- -- uu- - - uu -u u--	dactylic hexameter	masculine penthemimeral, hepthemimeral, trithemimeral
μίσει τὸν φιλέοντα καὶ οὐδὲ ἓν ἅμερον εἶχε,	-- - uu-u u -u u -uu --	dactylic hexameter	feminine penthemimeral, trithemimeral
κοὐκ ᾔδει τὸν Ἔρωτα, τίς ἦν θεός, ἡλίκα τόξα	- -- u u-u u - uu -uu --	dactylic hexameter	feminine penthemimeral, hepthemimeral, trithemimeral
χερσὶ κρατεῖ, πῶς πικρὰ βέλη ποτικάρδια βάλλει·	-- -- - -- u- uu-uu --	lyric	
πάντα δὲ κἠν μύθοισι καὶ ἐν προσόδοισιν ἀτειρής.	-u u - --u u - uu-u u--	dactylic hexameter	feminine penthemimeral, hepthemimeral, trithemimeral
οὐδέ τι τῶν πυρσῶν παραμύθιον, οὐκ ἀμάρυγμα	-u u - -- uu-uu - uu--	dactylic hexameter	masculine penthemimeral, trithemimeral
χείλεος, οὐκ ὄσσων λιπαρὸν σέλας, οὐ ῥοδόμαλον,	-uu - -- uu- uu - uu--	dactylic hexameter	masculine penthemimeral, hepthemimeral, trithemimeral
οὐ λόγος, οὐχὶ φίλαμα, τὸ κουφίζει τὸν ἔρωτα.	- uu -u u-u u --- u u--	dactylic hexameter	feminine penthemimeral
οἷα δὲ θὴρ ὑλαῖος ὑποπτεύῃσι κυναγώς,	-u u - --u u---u u--	dactylic hexameter	feminine penthemimeral, trithemimeral
οὕτως πάντ᾽ ἐποίει ποτὶ τὸν φίλον· ἄγρια δ᾽αὐτῷ	-- - uu- uu - uu -uu --	dactylic hexameter	masculine penthemimeral, hepthemimeral, trithemimeral
χείλεα καὶ κῶραι δεινὸν βλέπος· εἶχε γὰρ ὄγκον·	-uu - -- -- uu -u u --	dactylic hexameter	masculine penthemimeral, hepthemimeral, trithemimeral
τᾷ δὲ χολᾷ τὸ πρόσωπον ἀμείβετο, φεῦγε δ᾽ἀπὸ χρὼς	- u u- u u-u u-uu -u u- -	dactylic hexameter	feminine penthemimeral, trithemimeral
ὕβριν τᾶς ὀργᾶς περικείμενος. ἀλλὰ καὶ οὕτως	-- - -- uu-uu -u u --	dactylic hexameter	masculine penthemimeral, trithemimeral
ἦν καλός· ἐξ ὀργᾶς ἐρεθίζετο μᾶλλον ἐραστάς.	- uu - -- uu-uu -u u--	dactylic hexameter	masculine penthemimeral, trithemimeral
λοίσθιον οὐκ ἤνεικε τόσαν φλόγα τᾶς Κυθερείας,	-uu - --u u- uu - uu--	dactylic hexameter	feminine penthemimeral, hepthemimeral, trithemimeral
ἀλλ᾽ ἐλθὼν ἔκλαιε ποτὶ στυγνοῖσι μελάθροις,	- -- --u u- --u u--	dactylic hexameter	feminine penthemimeral, hepthemimeral, trithemimeral
καὶ κύσε τὰν φλιάν, οὕτω δ᾽ἀνενείκατο φωνάν·	- uu - -- -- uu-uu --	dactylic hexameter	masculine penthemimeral, hepthemimeral, trithemimeral
"Ἄγριε παῖ καὶ στυγνέ, κακᾶς ἀνάθρεμμα λεαίνας,	-uu - - -u u- uu-u u--	dactylic hexameter	feminine penthemimeral, hepthemimeral, trithemimeral
λάινε παῖ καὶ ἔρωτος ἀνάξιε, δῶρά τοι ἦλθον	-uu - u u-u u-uu -u u --	dactylic hexameter	feminine penthemimeral, trithemimeral
λοίσθια ταῦτα φέρων, τὸν ἐμὸν βρόχον· οὐκέτι πὰρ σὲ	-uu -u u- u u- uu -uu - -	dactylic hexameter	masculine penthemimeral, hepthemimeral
κῶρ᾽ ἐθέλω λύπης κεχολωμένος, ἀλλὰ βαδίζω,	- uu- -- uu-uu -u u--	dactylic hexameter	masculine penthemimeral, trithemimeral
ἔνθα τύ μευ κατέκρινας, ὅπῃ λόγος ἦμεν ἀταρπὸν	-u u - uu-u u- uu -u u--	dactylic hexameter	feminine penthemimeral, hepthemimeral, trithemimeral
ξυνάν, τοῖσιν ἐρῶσι τὸ φάρμακον ἔνθα τὸ λᾶθος.	-- -u u-u u -uu -u u --	dactylic hexameter	feminine penthemimeral
ἀλλὰ καὶ ἢν ὅλον αὐτὸ λαβὼν ποτὶ χεῖλος ἀμέλξω,	-u u - uu -u u- uu -u u--	dactylic hexameter	feminine penthemimeral, hepthemimeral, trithemimeral
οὐδ᾽ οὕτως σβέσσω τὸν ἐμὸν χόλον. ἄρτι δὲ χαίρειν	- -- -- u u- uu -u u --	dactylic hexameter	masculine penthemimeral, hepthemimeral, trithemimeral
τοῖσι τεοῖς προθύροις ἐπιτέλλομαι. οἶδα τὸ μέλλον.	-u u- uu- uu-uu -u u --	dactylic hexameter	masculine penthemimeral, trithemimeral
καὶ τὸ ῥόδον καλόν ἐστι, καὶ ὁ χρόνος αὐτὸ μαραίνει·	- u u- uu -u u - uu -u u--	dactylic hexameter	feminine penthemimeral, hepthemimeral, trithemimeral
καὶ τὸ ἴον καλόν ἐστιν ἐν εἴαρι, καὶ ταχὺ γηρᾷ·	- u u- uu -u u -uu - uu --	dactylic hexameter	feminine penthemimeral, trithemimeral
λευκὸν τὸ κρίνον ἐστί, μαραίνεται ἁνίκα πίπτῃ·	-- - uu -u u-uu -uu --	dactylic hexameter	feminine penthemimeral, trithemimeral
ἁ δὲ χιὼν λευκά, καὶ τάκεται ἁνίκα πασθῇ.	- u u- -- - -uu -uu --	dactylic hexameter	masculine penthemimeral, trithemimeral
καὶ κάλλος καλόν ἐστι τὸ παιδικόν, ἀλλ᾽ ὀλίγον ζῇ.	- -- uu -u u -uu - uu- -	dactylic hexameter	feminine penthemimeral, trithemimeral
ἥξει καιρὸς ἐκεῖνος, ὁπανίκα καὶ τὺ φιλάσεις,	-- -u u-u u-uu - u u--	dactylic hexameter	feminine penthemimeral
ἁνίκα τὰν κραδίαν ὀπτεύμενος ἁλμυρὰ κλαύσῃ.	-uu - uu- --uu -uu --	dactylic hexameter	masculine penthemimeral, trithemimeral
ἀλλὰ τὺ παῖ καὶ τοῦτο πανύστατον ἁδύ τι ῥέξον·	-u u - - -u u-uu -u u --	dactylic hexameter	feminine penthemimeral, trithemimeral
ὁππόταν ἐξενθὼν ἠρτημένον ἐν προθύροισι	-uu --- --uu - uu--	dactylic hexameter	masculine penthemimeral
τοῖσι τεοῖσιν ἴδῃς τὸν τλάμονα, μή με παρένθῃς,	-u u-u u- - -uu - u u--	dactylic hexameter	masculine penthemimeral
στᾶθι δὲ καὶ βραχὺ κλαῦσον, ἐπισπείσας δὲ τὸ δάκρυ	-u u - uu -u u--- u u --	dactylic hexameter	feminine penthemimeral, trithemimeral
λῦσον τῶ σχοίνω με καὶ ἀμφίθες ἐκ ῥεθέων σῶν	-- - -- u u -uu - uu- -	dactylic hexameter	masculine penthemimeral, trithemimeral
εἵματα καὶ κρύψόν με, τὸ δ᾽αὖ πύματόν με φίλασον,	-uu - -- u u - uu- u u--	dactylic hexameter	masculine penthemimeral, hepthemimeral, trithemimeral
κἂν νεκρῷ χάρισαι τὰ σὰ χείλεα. μή με φοβαθῇς·	- -- uu- u u -uu - u u--	dactylic hexameter	masculine penthemimeral, trithemimeral
οὐ δύναμαι λυπεῖν σε, διαλλάξεις με φιλάσας.	- uu- -- u u--- u u--	dactylic hexameter	masculine penthemimeral, trithemimeral
χῶμα δέ μοι χῶσόν τι ὅ μευ κρύψει τὸν ἔρωτα.	-u u - -- u u - -- u u--	dactylic hexameter	masculine penthemimeral, hepthemimeral, trithemimeral
κἂν ἀπίῃς, τόδε μοι τρὶς ἐπαίασον· ὦ φίλε κεῖσαι.	- uu- uu - u u-uu - uu --	dactylic hexameter	masculine penthemimeral, trithemimeral
ἢν δὲ θέλῃς, καὶ τοῦτο· καλὸς δέ μοι ὤλεθ᾽ ἑταῖρος.	- u u- - -u u- u u -u u--	dactylic hexameter	feminine penthemimeral, hepthemimeral, trithemimeral
γράψον καὶ τόδε γράμμα, τὸ σοῖς τοίχοισι χαράξω·	-- - uu -u u - --u u--	dactylic hexameter	feminine penthemimeral, hepthemimeral, trithemimeral
"τοῦτον ἔρως ἔκτεινεν. ὁδοιπόρε, μὴ παροδεύσῃς,	-u u- --u u-uu - uu--	dactylic hexameter	feminine penthemimeral, trithemimeral
ἀλλὰ στὰς τόδε λέξον· ἀπηνέα εἶχεν ἑταῖρον."	-- - uu -u u-uu -u u--	dactylic hexameter	feminine penthemimeral, trithemimeral
̂Ὡδ᾽ εἰπὼν λίθον εἷλκεν, ἐρεισάμενος δ᾽ἐπὶ τοίχω	- -- uu -u u-uu- uu --	dactylic hexameter	feminine penthemimeral, trithemimeral
ἄχρι μέσων οὐδῶν φοβερὸν λίθον ἅπτετ᾽ ἀπ᾽ αὐτῶν,	-u u- -- uu- uu -u u --	dactylic hexameter	masculine penthemimeral, hepthemimeral, trithemimeral
τὰν λεπτὰν σχοινῖδα, βρόχον δ᾽ἐνέβαλλε τραχήλῳ,	- -- --u u- uu-u u--	dactylic hexameter	feminine penthemimeral, hepthemimeral, trithemimeral
τὰν ἕδραν δ᾽ἐκύλισεν ὑπὲκ ποδός, ἠδ᾽ ἐκρεμάσθη	- -- uu-u u- uu - uu--	dactylic hexameter	feminine penthemimeral, hepthemimeral, trithemimeral
νεκρός. ὁ δ᾽αὖτ᾽ ὤιξε θύρας καὶ τὸν νεκρὸν εἶδεν	-u u - --u u- - - uu --	dactylic hexameter	feminine penthemimeral, hepthemimeral, trithemimeral
αὐλᾶς ἐξ ἰδίας ἠρτημένον, οὐδ᾽ ἐλυγίχθη	-- - uu- --uu - uu--	dactylic hexameter	masculine penthemimeral, trithemimeral
τὰν ψυχάν, οὐ κλαῦσε νέον φόνον, ἀλλ᾽ ἐπὶ νεκρῷ	- -- - -u u- uu - uu --	dactylic hexameter	feminine penthemimeral, hepthemimeral, trithemimeral
εἵματα πάντ᾽ ἐμίανεν, ἐφαβικὰ βαῖνε δ᾽ἐς ἄθλα	-uu - uu-u u-uu -u u --	dactylic hexameter	feminine penthemimeral, trithemimeral
γυμναστῶν, καὶ τῆλε φίλων ἐπεμαίετο λουτρῶν,	--- - -u u- uu-uu --	dactylic hexameter	feminine penthemimeral, hepthemimeral, trithemimeral
καὶ ποτὶ τὸν θεὸν ἦλθε, τὸν ὕβρισε· λαϊνέας δὲ	- uu - uu -u u -uu -uu- -	dactylic hexameter	feminine penthemimeral, trithemimeral
ἵστατ᾽ ἀπὸ κρηπῖδος ἐς ὕδατα· τῷ δ᾽ἐφύπερθεν	-u u- --u u -uu - uu--	dactylic hexameter	feminine penthemimeral, trithemimeral
ἅλατο καὶ τὤγαλμα, κακὸν δ᾽ἔκτεινεν ἔφαβον·	-uu - --u u- --u u--	dactylic hexameter	feminine penthemimeral, hepthemimeral, trithemimeral
νᾶμα δ᾽ἐφοινίχθη· παιδὸς δ᾽ἐπενάχετο σῶμα.	-u u--- -- uu-uu --	dactylic hexameter	masculine penthemimeral, hepthemimeral
χαίρετε τοὶ φιλέοντες· ὁ γὰρ μισῶν ἐφονεύθη.	-uu - uu-u u - -- uu--	dactylic hexameter	feminine penthemimeral, hepthemimeral, trithemimeral
στέργετε δ᾽οἱ μισεῦντες· ὁ γὰρ θεὸς οἶδε δικάζειν.	-uu - --u u - uu -u u--	dactylic hexameter	feminine penthemimeral, hepthemimeral, trithemimeral
Ἡρακλέα δεκάμηνον ἐόντα πόχ᾽ ἁ Μιδεᾶτις	-uu- uu-u u-u u - uu--	dactylic hexameter	feminine penthemimeral, trithemimeral
Ἀλκμήνα καὶ νυκτὶ νεώτερον Ἰφικλῆα,	--- - -u u-uu ----	dactylic hexameter	feminine penthemimeral, trithemimeral
ἀμφοτέρους λούσασα καὶ ἐμπλήσασα γάλακτος,	-uu- --u u ---u u--	dactylic hexameter	feminine penthemimeral, trithemimeral
χαλκείαν κατέθηκεν ἐς ἀσπίδα, τὰν Πτερελάου	--- uu-u u -uu - uu--	dactylic hexameter	feminine penthemimeral, trithemimeral
Ἀμφιτρύων καλὸν ὅπλον ἀπεσκύλευσε πεσόντος.	-uu- uu -u u---u u--	dactylic hexameter	feminine penthemimeral, trithemimeral
ἁπτομένα δὲ γυνὰ κεφαλᾶς μυθήσατο παίδων·	-uu- u u- uu- --uu --	dactylic hexameter	masculine penthemimeral, hepthemimeral, trithemimeral
"εὕδετ᾽ ἐμὰ βρέφεα γλυκερὸν καὶ ἐγέρσιμον ὕπνον,	-u u- uu- uu- u u-uu --	dactylic hexameter	masculine penthemimeral, hepthemimeral, trithemimeral
εὕδετ᾽ ἐμὰ ψυχά, δύ᾽ ἀδελφεώ, εὔσοα τέκνα·	-u u- -- u u-uu -uu --	dactylic hexameter	masculine penthemimeral, trithemimeral
ὄλβιοι εὐνάζοισθε καὶ ὄλβιοι ἀῶ ἵκοισθε."	-uu ---u u -uu -u u--	dactylic hexameter	feminine penthemimeral
Ὣς φαμένα δίνασε σάκος μέγα· τοὺς δ᾽ἔλαβ᾽ ὕπνος.	- uu- uu- -- uu - uu --	dactylic hexameter	masculine penthemimeral, hepthemimeral, trithemimeral
ἆμος δὲ στρέφεται μεσονύκτιον ἐς δύσιν ἄρκτος	-- - uu- uu-uu - uu --	dactylic hexameter	masculine penthemimeral, trithemimeral
Ὠρίωνα κατ᾽ αὐτόν, ὁ δ᾽ἀμφαίνει μέγαν ὦμον,	---u u -u u --- uu --	dactylic hexameter	feminine penthemimeral
τᾶμος ἄρ᾽ αἰνὰ πέλωρα δύω πολυμήχανος Ἥρη	-u u -u u-u u- uu-uu --	dactylic hexameter	feminine penthemimeral, hepthemimeral
κυανέαις φρίσσοντας ὑπὸ σπείραισι δράκοντας	-uu- --u u- --u u--	dactylic hexameter	feminine penthemimeral, hepthemimeral, trithemimeral
ὦρσεν ἐπὶ πλατὺν οὐδόν, ὅθι σταθμὰ κοῖλα θυράων	-u u- uu -u u- uu -u u--	dactylic hexameter	feminine penthemimeral, hepthemimeral, trithemimeral
εἶκεν, ἀπειλήσασα φαγεῖν βρέφος Ἡρακλῆα.	-u u---u u- uu ----	dactylic hexameter	feminine penthemimeral, hepthemimeral
τὼ δ᾽ἐξειληθέντες ἐπὶ χθονὶ γαστέρας ἄμφω	- ----u u- uu -uu --	dactylic hexameter	feminine penthemimeral, hepthemimeral
αἱμοβόρους ἐκύλιον· ἀπ᾽ ὀφθαλμῶν δὲ κακὸν πῦρ	-uu- uu-u u --- u u- -	dactylic hexameter	feminine penthemimeral, trithemimeral
ἐρχομένοις λάμπεσκε, βαρὺν δ᾽ἐξέπτυον ἰόν.	-uu- --u u- --uu --	dactylic hexameter	feminine penthemimeral, hepthemimeral, trithemimeral
ἀλλ᾽ ὅτε δὴ παίδων λιχμώμενοι ἐγγύθεν ἦνθον,	- uu - -- --uu -uu --	dactylic hexameter	masculine penthemimeral, trithemimeral
καὶ τότ᾽ ἄρ᾽ ἐξέγροντο, Διὸς νοέοντος ἅπαντα,	- u u ---u u- uu-u u--	dactylic hexameter	feminine penthemimeral, hepthemimeral
Ἀλκμήνας φίλα τέκνα, φάος δ᾽ἀνὰ οἶκον ἐτύχθη.	--- uu -u u- uu -u u--	dactylic hexameter	feminine penthemimeral, hepthemimeral, trithemimeral
ἤτοι ὅγ᾽ εὐθὺς ἄυσεν, ὅπως κακὰ θηρί᾽ ἀνέγνω	-u u -- -u u- uu -u u--	dactylic hexameter	feminine penthemimeral, hepthemimeral
κοίλου ὑπὲρ σάκεος καὶ ἀναιδέας εἶδεν ὀδόντας,	-u u- uu- u u-uu -u u--	dactylic hexameter	masculine penthemimeral, trithemimeral
Ἰφικλέης, οὔλαν δὲ ποσὶν διελάκτισε χλαῖναν,	-uu- -- u u- uu-uu --	dactylic hexameter	masculine penthemimeral, hepthemimeral, trithemimeral
φευγέμεν ὁρμαίνων· ὁ δ᾽ἐναντίος εἴχετο χερσὶν	-uu --- u u-uu -uu --	dactylic hexameter	masculine penthemimeral
Ἡρακλέης, ἄμφω δὲ βαρεῖ ἐνεδήσατο δεσμῷ,	-uu- -- u u- uu-uu --	dactylic hexameter	masculine penthemimeral, hepthemimeral, trithemimeral
δραξάμενος φάρυγος, τόθι φάρμακα λυγρὰ κέκρυπται	-uu- uu- uu -uu -u u--	dactylic hexameter	masculine penthemimeral, trithemimeral
οὐλομένοις ὀφίεσσιν, ἃ καὶ θεοὶ ἐχθαίροντι.	-uu- uu-u u - uu ----	dactylic hexameter	feminine penthemimeral, hepthemimeral, trithemimeral
τὼ δ᾽αὖτε σπείραισιν ἑλισσέσθην περὶ παῖδα	- -- --u u--- uu --	dactylic hexameter	feminine penthemimeral, trithemimeral
ὀψίγονον γαλαθηνόν, ὑπὸ τροφῷ αἰὲν ἄδακρυν·	-uu- uu-u u- uu -u u--	dactylic hexameter	feminine penthemimeral, hepthemimeral, trithemimeral
ἂψ δὲ πάλιν διέλυον ἐπεὶ μογέοιεν ἀκάνθας,	- u u- uu-u u- uu-u u--	dactylic hexameter	feminine penthemimeral, hepthemimeral, trithemimeral
δεσμοῦ ἀναγκαίου πειρώμενοι ἔκλυσιν εὑρεῖν.	-u u--- --uu -uu --	dactylic hexameter	masculine penthemimeral
Ἀλκμήνα δ᾽ἐσάκουσε βοᾶς καὶ ἐπέγρετο πράτα·	--- uu-u u- u u--- --	lyric	
"Ἄνσταθ᾽ Ἀμφιτρύων· ἐμὲ γὰρ δέος ἴσχει ὀκνηρόν·	-- -uu- uu - uu -u u--	dactylic hexameter	masculine penthemimeral, hepthemimeral
ἄνστα, μηδὲ πόδεσσιν ἑοῖς ὑπὸ σάνδαλα θείῃς.	-- -u u-u u- uu -uu --	dactylic hexameter	feminine penthemimeral, hepthemimeral
οὐκ ἀίεις, παίδων ὁ νεώτερος ὅσσον ἀυτεῖ;	- uu- -- u u-uu -u u--	dactylic hexameter	masculine penthemimeral, trithemimeral
ἢ οὐ νοέεις, ὅτι νυκτὸς ἀωρί που, οἱ δέ τε τοῖχοι	- uu- uu -u u-u u - u u --	dactylic hexameter	feminine penthemimeral, trithemimeral
πάντες ἀριφραδέες, καθαρᾶς ἅπερ ἠριγενείας;	-u u-uu- uu- uu -uu--	dactylic hexameter	masculine penthemimeral, hepthemimeral
ἔστί τί μοι κατὰ δῶμα νεώτερον, ἔστι φίλ᾽ ἀνδρῶν."	-u u - uu -u u-uu -u u --	dactylic hexameter	feminine penthemimeral, trithemimeral
Ὣς φάθ᾽. ὁ δ᾽ἐξ εὐνᾶς ἀλόχῳ κατέβαινε πιθήσας·	- u u - -- uu- uu-u u--	dactylic hexameter	masculine penthemimeral, hepthemimeral, trithemimeral
δαιδάλεον δ᾽ὥρμασε μετὰ ξίφος, ὅ οἱ ὕπερθεν	-uu- --u u- uu - u u--	dactylic hexameter	feminine penthemimeral, hepthemimeral, trithemimeral
κλιντῆρος κεδρίνου περὶ πασσάλῳ αἰὲν ἄωρτο.	--- uu- uu -uu -u u--	dactylic hexameter	masculine penthemimeral, trithemimeral
ἤτοι ὅγ᾽ ὠριγνᾶτο νεοκλώστου τελαμῶνος,	-u u ---u u--- uu--	dactylic hexameter	feminine penthemimeral
κουφίζων ἑτέρᾳ κολεὸν μέγα, λώτινον ἔργον.	--- uu- uu- uu -uu --	dactylic hexameter	masculine penthemimeral, hepthemimeral, trithemimeral
ἀμφιλαφὴς δ᾽ἄρα παστὰς ἐνεπλήσθη πάλιν ὄρφνας·	-uu- uu -u u--- uu --	dactylic hexameter	feminine penthemimeral, trithemimeral
δμῶας δὴ τότ᾽ ἄυσεν ὕπνον βαρὺν ἐκφυσῶντας·	-- - u u-u u- uu ----	dactylic hexameter	feminine penthemimeral, hepthemimeral, trithemimeral
"οἴσετε πῦρ ὅτι θᾶσσον ἀπ᾽ ἐσχαρεῶνος ἑλόντες,	-uu - uu -u u -uu-u u--	dactylic hexameter	feminine penthemimeral, trithemimeral
δμῶες ἐμοί, στιβαροὺς δὲ θυρᾶν ἀνακόψατ᾽ ὀχῆας."	-u u- uu- u u- uu-u u--	dactylic hexameter	masculine penthemimeral, hepthemimeral, trithemimeral
"ἄνστατε δμῶες ταλασίφρονες. αὐτὸς ἀυτεῖ."	--- -- uu-uu -u u--	dactylic hexameter	masculine penthemimeral, trithemimeral
̂Ἠ ῥα γυνὰ Φοίνισσα μύλαις ἔπι κοῖτον ἔχουσα.	- u u- --u u- uu -u u--	dactylic hexameter	feminine penthemimeral, hepthemimeral, trithemimeral
οἱ δ᾽αἶψα προγένοντο λύχνοις ἅμα δαιομένοισι	- -- uu-u u- uu -uu--	dactylic hexameter	feminine penthemimeral, hepthemimeral, trithemimeral
δμῶες· ἐνεπλήσθη δὲ δόμος σπεύδοντος ἑκάστου.	-u u--- u u- --u u--	dactylic hexameter	masculine penthemimeral, hepthemimeral
ἤτοι ἄρ᾽ ὡς εἴδοντ᾽ ἐπιτίτθιον Ἡρακλῆα	-u u - -- uu-uu ----	dactylic hexameter	masculine penthemimeral, trithemimeral
θῆρε δύω χείρεσσιν ἀπρὶξ ἁπαλαῖσιν ἔχοντα,	-u u- --u u- uu-u u--	dactylic hexameter	feminine penthemimeral, hepthemimeral, trithemimeral
συμπλήγδην ἰάχησαν· ὁ δ᾽ἐς πατέρ᾽ Ἀμφιτρύωνα	--- uu-u u - uu -uu--	dactylic hexameter	feminine penthemimeral, hepthemimeral, trithemimeral
ἑρπετὰ δεικανάασκεν, ἐπάλλετο δ᾽ὑψόθι χαίρων	-uu -uu-u u-uu -uu --	dactylic hexameter	feminine penthemimeral
κουροσύνᾳ, γελάσας δὲ πάρος κατέθηκε ποδοῖιν	-uu- uu- u u- uu-u u--	dactylic hexameter	masculine penthemimeral, hepthemimeral, trithemimeral
πατρὸς ἑοῦ θανάτῳ κεκαρωμένα δεινὰ πέλωρα.	-u u- uu- uu-uu -u u--	dactylic hexameter	masculine penthemimeral, trithemimeral
Ἀλκμήνα μὲν ἔπειτα ποτὶ σφέτερον βάλε κόλπον	--- u u-u u- uu- uu --	dactylic hexameter	feminine penthemimeral, hepthemimeral, trithemimeral
ξηρὸν ὑπαὶ δείους ἀκρόχλοον Ἰφικλῆα·	-u u- -- --uu ----	dactylic hexameter	masculine penthemimeral, trithemimeral
Ἀμφιτρύων δὲ τὸν ἄλλον ὑπ᾽ ἀμνείαν θέτο χλαῖναν	-uu- u u -u u --- uu --	dactylic hexameter	feminine penthemimeral, trithemimeral
παῖδα, πάλιν δ᾽ἐς λέκτρον ἰὼν ἐμνάσατο κοίτου.	-u u- - -u u- --uu --	dactylic hexameter	feminine penthemimeral, hepthemimeral, trithemimeral
ὄρνιθες τρίτον ἄρτι τὸν ἔσχατον ὄρθρον ἄειδον·	--- uu -u u -uu -u u--	dactylic hexameter	feminine penthemimeral, trithemimeral
Τειρεσίαν τόκα μάντιν ἀλαθέα πάντα λέγοντα	-uu- uu -u u-uu -u u--	dactylic hexameter	feminine penthemimeral, trithemimeral
Ἀλκμήνα καλέσασα τέρας κατέλεξε νεοχμόν,	--- uu-u u- uu-u u--	dactylic hexameter	feminine penthemimeral, hepthemimeral, trithemimeral
καί νιν ὑποκρίνεσθαι, ὅπως τελέεσθαι ἔμελλεν,	- u u---u u- uu-u u--	dactylic hexameter	feminine penthemimeral, hepthemimeral
ἠνώγει. "μηδ᾽ εἴ τι θεοὶ νοέοντι πονηρόν,	--- - - u u- uu-u u--	dactylic hexameter	masculine penthemimeral, hepthemimeral, trithemimeral
αἰδόμενος σύ με κρύπτε· καὶ ὣς οὐκ ἔστιν ἀλύξαι	-uu- u u -u u - - -u u--	dactylic hexameter	feminine penthemimeral, hepthemimeral, trithemimeral
ἀνθρώποις ὅ τι Μοῖρα κατὰ κλωστῆρος ἐπείγει.	--- u u -u u- --u u--	dactylic hexameter	feminine penthemimeral, hepthemimeral, trithemimeral
ἀλλ᾽ Εὐηρείδα μάλα σε φρονέοντα διδάσκω."	- ---- uu - uu-u u--	dactylic hexameter	masculine penthemimeral, hepthemimeral
τόσσ᾽ ἔλεγεν βασίλεια· ὁ δ᾽ἀνταμείβετο τοίως·	- uu- uu-u u ---uu --	dactylic hexameter	feminine penthemimeral, trithemimeral
"θάρσει ἀριστοτόκεια γύναι, Περσήιον αἷμα.	-u u-uu-u u- --uu --	dactylic hexameter	feminine penthemimeral, hepthemimeral
θάρσει· μελλόντων δὲ τὸ λώιον ἐν φρεσὶ θέσθαι.	-- --- u u -uu - uu --	dactylic hexameter	masculine penthemimeral
ναὶ γὰρ ἐμὸν γλυκὺ φέγγος ἀποιχόμενον πάλαι ὄσσων,	- u u- uu -u u-uu- uu --	dactylic hexameter	feminine penthemimeral, trithemimeral
πολλαὶ Ἀχαιιάδων μαλακὸν περὶ γούνατι νῆμα	-u u-uu- uu- uu -uu --	dactylic hexameter	masculine penthemimeral, hepthemimeral
χειρὶ κατατρίψοντι ἀκρέσπερον ἀείδοισαι	-u u---u u-uu ----	dactylic hexameter	feminine penthemimeral
Ἀλκμήναν ὀνομαστί, σέβας δ᾽ἔσῃ Ἀργείαισι.	--- uu-u u- uu ----	dactylic hexameter	feminine penthemimeral, hepthemimeral, trithemimeral
τοῖος ἀνὴρ ὅδε μέλλει ἐς οὐρανὸν ἄστρα φέροντα	-u u- uu -u u -uu -u u--	dactylic hexameter	feminine penthemimeral, trithemimeral
ἀμβαίνειν τεὸς υἱός, ἀπὸ στέρνων πλατὺς ἥρως,	--- uu -u u- -- uu --	dactylic hexameter	feminine penthemimeral, hepthemimeral, trithemimeral
οὗ καὶ θηρία πάντα καὶ ἀνέρες ἥσσονες ἄλλοι.	- - -uu -u u -uu -uu --	dactylic hexameter	feminine penthemimeral
δώδεκά οἱ τελέσαντι πεπρωμένον ἐν Διὸς οἰκεῖν	-uu - uu-u u-uu - uu --	dactylic hexameter	feminine penthemimeral, trithemimeral
μόχθους, θνητὰ δὲ πάντα πυρὰ Τραχίνιος ἑξεῖ.	-- -u u -u u- uu-- --	dactylic hexameter	feminine penthemimeral, hepthemimeral
γαμβρὸς δ᾽ἀθανάτων κεκλήσεται, οἳ τάδ᾽ ἐπῶρσαν	-- -uu- --uu - u u--	dactylic hexameter	masculine penthemimeral
κνώδαλα φωλεύοντα βρέφος διαδηλήσασθαι.	-uu ---u u- uu----	dactylic hexameter	feminine penthemimeral, hepthemimeral
ἔσται δὴ τοῦτ᾽ ἆμαρ, ὁπηνίκα νεβρὸν ἐν εὐνᾷ	-- - - -u u-uu -u u --	dactylic hexameter	feminine penthemimeral, trithemimeral
καρχαρόδων σίνεσθαι ἰδὼν λύκος οὐκ ἐθελήσει.	-uu- --u u- uu - uu--	dactylic hexameter	feminine penthemimeral, hepthemimeral, trithemimeral
ἀλλὰ γύναι πῦρ μέν τοι ὑπὸ σποδῷ εὔτυκον ἔστω,	-u u- - - u u- uu -uu --	dactylic hexameter	masculine penthemimeral, hepthemimeral, trithemimeral
κάγκανα δ᾽ἀσπαλάθου ξύλ᾽ ἑτοιμάσατ᾽ ἢ παλιούρου	-uu -uu- u u-uu - uu--	dactylic hexameter	masculine penthemimeral
ἢ βάτου ἢ ἀνέμῳ δεδονημένον αὖον ἄχερδον·	- uu - uu- uu-uu -u u--	dactylic hexameter	masculine penthemimeral, trithemimeral
καῖε δὲ τώδ᾽ ἀγρίαισιν ἐπὶ σχίζαισι δράκοντε	-u u - uu-u u- --u u--	dactylic hexameter	feminine penthemimeral, hepthemimeral, trithemimeral
νυκτὶ μέσᾳ, ὅκα παῖδα κανεῖν τεὸν ἤθελον αὐτοί.	-u u- uu -u u- uu -uu --	dactylic hexameter	feminine penthemimeral, hepthemimeral, trithemimeral
ἦρι δὲ συλλέξασα κόνιν πυρὸς ἀμφιπόλων τις	-u u ---u u- uu -uu- -	dactylic hexameter	feminine penthemimeral, hepthemimeral
ῥιψάτω εὖ μάλα πᾶσαν ὑπὲρ ποταμοῖο φέρουσα	-uu - uu -u u- uu-u u--	dactylic hexameter	feminine penthemimeral, hepthemimeral, trithemimeral
ῥωγάδας ἐς πέτρας ὑπερούριον, ἂψ δὲ νέεσθαι	-uu - -- uu-uu - u u--	dactylic hexameter	masculine penthemimeral, trithemimeral
ἄστρεπτος· καθαρῷ δὲ πυρώσατε δῶμα θεείῳ	--- uu- u u-uu -u u--	dactylic hexameter	masculine penthemimeral, trithemimeral
πρᾶτον, ἔπειτα δ᾽ἅλεσσι μεμιγμένον, ὡς νενόμισται,	-u u-u u-u u-uu - uu--	dactylic hexameter	feminine penthemimeral
θαλλῷ ἐπιρραίνειν ἐστεμμένῳ ἀβλαβὲς ὕδωρ·	-u u--- --uu -uu --	dactylic hexameter	masculine penthemimeral
Ζηνὶ δ᾽ἐπιρρέξαι καθυπερτέρῳ ἄρσενα χοῖρον,	-u u--- uu-uu -uu --	dactylic hexameter	masculine penthemimeral
δυσμενέων αἰεὶ καθυπέρτεροι ὡς τελέθοιτε."	-uu- -- uu-uu - uu--	dactylic hexameter	masculine penthemimeral, trithemimeral
φᾶ, καὶ ἐρωήσας ἐλεφάντινον ᾤχετο δίφρον	- u u--- uu-uu -uu --	dactylic hexameter	masculine penthemimeral
Τειρεσίας πολλοῖσι βαρύς περ ἐὼν ἐνιαυτοῖς.	-uu- --u u- u u- uu--	dactylic hexameter	feminine penthemimeral, hepthemimeral, trithemimeral
Ἡρακλέης δ᾽ὑπὸ ματρὶ νέον φυτὸν ὣς ἐν ἀλωᾷ	-uu- uu -u u- uu - u u--	dactylic hexameter	feminine penthemimeral, hepthemimeral, trithemimeral
ἐτρέφετ᾽ Ἀργείου κεκλημένος Ἀμφιτρύωνος.	-uu --- --uu -uu--	dactylic hexameter	masculine penthemimeral
γράμματα μὲν τὸν παῖδα γέρων Λίνος ἐξεδίδαξεν,	-uu - - -u u- uu -uu--	dactylic hexameter	feminine penthemimeral, hepthemimeral, trithemimeral
υἱὸς Ἀπόλλωνος μελεδωνεὺς ἄγρυπνος ἥρως,	-u u--- uu-- -uu --	dactylic hexameter	masculine penthemimeral
τόξον δ᾽ἐντανύσαι καὶ ἐπίσκοπον εἶναι ὀϊστῶν	-- -uu- u u-uu -u u--	dactylic hexameter	masculine penthemimeral
Εὔρυτος ἐκ πατέρων μεγάλαις ἀφνειὸς ἀρούραις.	-uu - uu- uu- --u u--	dactylic hexameter	masculine penthemimeral, hepthemimeral, trithemimeral
αὐτὰρ ἀοιδὸν ἔθηκε καὶ ἄμφω χεῖρας ἔπλασσε	-u u-u u-u u -- -u u--	dactylic hexameter	feminine penthemimeral
πυξίνᾳ ἐν φόρμιγγι Φιλαμμονίδας εὔμολπος.	-uu - --u u-uu- ---	dactylic hexameter	feminine penthemimeral, trithemimeral
ὅσσα δ᾽ἀπὸ σκελέων ἑδροστρόφοι Ἀργόθεν ἄνδρες	-u u- uu- --uu -uu --	dactylic hexameter	masculine penthemimeral, trithemimeral
ἀλλάλους σφάλλοντι παλαίσμασιν, ὅσσά τε πύκται	--- --u u-uu -u u --	dactylic hexameter	feminine penthemimeral, trithemimeral
δεινοὶ ἐν ἱμάντεσσιν, ἅ τ᾽ἐς γαῖαν προπεσόντες	-u u ---u u - -- uu--	dactylic hexameter	feminine penthemimeral, hepthemimeral
πάμμαχοι ἐξεύροντο σοφίσματα σύμφορα τέχνᾳ,	-uu ---u u-uu -uu --	dactylic hexameter	feminine penthemimeral
πάντ᾽ ἔμαθ᾽ Ἑρμείαο διδασκόμενος παρὰ παιδὶ	- uu ---u u-uu- uu --	dactylic hexameter	feminine penthemimeral
Ἁρπαλύκῳ Φανοτῆι, τὸν οὐδ᾽ ἂν τηλόθι λεύσσων	-uu- uu-u u - - -uu --	dactylic hexameter	feminine penthemimeral, hepthemimeral, trithemimeral
θαρσαλέως τις ἔμεινεν ἀεθλεύοντ᾽ ἐν ἀγῶνι·	-uu- u u-u u--- u u--	dactylic hexameter	feminine penthemimeral, trithemimeral
τοῖον ἐπισκύνιον βλοσυρῷ ἐπέκειτο προσώπῳ.	-u u-uu- uu- uu-u u--	dactylic hexameter	masculine penthemimeral, hepthemimeral
ἵππους δ᾽ἐξελάσασθαι ὑφ᾽ ἅρματι, καὶ περὶ νύσσαν	-- -uu-u u -uu - uu --	dactylic hexameter	feminine penthemimeral
ἀσφαλέως κάμπτοντα τροχῷ σύριγγα φυλάξαι,	-uu- --u u- --u u--	dactylic hexameter	feminine penthemimeral, hepthemimeral, trithemimeral
Ἀμφιτρύων ὃν παῖδα φίλα φρονέων ἐδίδαξεν	-uu- - -u u- uu- uu--	dactylic hexameter	feminine penthemimeral, hepthemimeral, trithemimeral
αὐτός, ἐπεὶ μάλα πολλὰ θοῶν ἐξήρατ᾽ ἀγώνων	-u u- uu -u u- --u u--	dactylic hexameter	feminine penthemimeral, hepthemimeral, trithemimeral
Ἄργει ἐν ἱπποβότῳ κειμήλια, καί οἱ ἀαγεῖς	-u u -uu- --uu - u u--	dactylic hexameter	masculine penthemimeral
δίφροι, ἐφ᾽ ὧν ἐπέβαινε, χρόνῳ διέλυσαν ἱμάντας.	-u u - uu-u u- uu-u u--	dactylic hexameter	feminine penthemimeral, hepthemimeral, trithemimeral
δούρατι δὲ προβολαίῳ ὑπ᾽ ἀσπίδι ὦμον ἔχοντα	-uu - uu-u u -uu -u u--	dactylic hexameter	feminine penthemimeral, trithemimeral
ἀνδρὸς ὀρέξασθαι ξιφέων τ᾽ἀνέχεσθαι ἀμυχμόν,	-u u--- uu- uu-u u--	dactylic hexameter	masculine penthemimeral, hepthemimeral
κοσμῆσαί τε φάλαγγα λόχον τ᾽ἀναμετρήσασθαι	--- u u-u u- uu----	dactylic hexameter	feminine penthemimeral, hepthemimeral, trithemimeral
δυσμενέων ἐπιόντα καὶ ἱππήεσσι κελεῦσαι	-uu- uu-u u ---u u--	dactylic hexameter	feminine penthemimeral, trithemimeral
Κάστωρ Ἱππαλίδας δέδαεν, φυγὰς Ἄργεος ἐνθών,	-- -uu- uu- uu -uu --	dactylic hexameter	masculine penthemimeral, hepthemimeral
ὁππόκα κλᾶρον ἅπαντα καὶ οἰνόπεδον μέγα Τυδεὺς	-uu -u u-u u -uu- uu --	dactylic hexameter	feminine penthemimeral
ναῖε παρ᾽ Ἀδρήστοιο λαβὼν ἱππήλατον Ἄργος.	-u u ---u u- --uu --	dactylic hexameter	feminine penthemimeral, hepthemimeral
Κάστορι δ᾽οὔτις ὁμοῖος ἐν ἡμιθέοις πολεμιστὴς	-uu -u u-u u -uu- uu--	dactylic hexameter	feminine penthemimeral
ἄλλος ἔην πρὶν γῆρας ἀποτρῖψαι νεότητα.	-u u- - -u u--- uu--	dactylic hexameter	feminine penthemimeral, trithemimeral
̂Ὡδε μὲν Ἡρακλῆα φίλα παιδεύσατο μάτηρ.	-u u ---u u- --uu --	dactylic hexameter	feminine penthemimeral, hepthemimeral
εὐνὰ δ᾽ἦς τῷ παιδὶ τετυγμένα ἀγχόθι πατρὸς	-- - - -u u-uu -uu --	dactylic hexameter	feminine penthemimeral, trithemimeral
δέρμα λεόντειον μάλα οἱ κεχαρισμένον αὐτῷ,	-u u--- uu - uu-uu --	dactylic hexameter	masculine penthemimeral, hepthemimeral
δεῖπνον δὲ κρέα τ᾽ὀπτὰ καὶ ἐν κανέῳ μέγας ἄρτος	-- - uu -u u - uu- uu --	dactylic hexameter	feminine penthemimeral, hepthemimeral, trithemimeral
Δωρικός· ἀσφαλέως κε φυτοσκάφον ἄνδρα κορέσσαι.	-uu -uu- u u-uu -u u--	dactylic hexameter	masculine penthemimeral
αὐτὰρ ἐπ᾽ ἄματι τυννὸν ἄνευ πυρὸς αἴνυτο δόρπον.	-u u -uu -u u- uu -uu --	dactylic hexameter	feminine penthemimeral, hepthemimeral
εἵματα δ᾽οὐκ ἀσκητὰ μέσας ὑπὲρ ἕννυτο κνάμας.	-uu - --u u- uu --- --	lyric	
τὸν δ᾽ὁ γέρων προσέειπε φυτῶν ἐπίουρος ἀροτρεὺς	- u u- uu-u u- uu-u u--	dactylic hexameter	feminine penthemimeral, hepthemimeral, trithemimeral
παυσάμενος ἔργοιο, τό οἱ μετὰ χερσὶν ἔκειτο·	-uu- --u u - uu -u u--	dactylic hexameter	feminine penthemimeral, hepthemimeral, trithemimeral
"Ἔκ τοι ξεῖνε πρόφρων μυθήσομαι ὅσσ᾽ ἐρεείνεις,	- - -u u- --uu - uu--	dactylic hexameter	masculine penthemimeral
Ἑρμέω ἁζόμενος δεινὴν ὄπιν εἰνοδίοιο·	-uu -uu- -- uu -uu--	dactylic hexameter	masculine penthemimeral, hepthemimeral
τὸν γάρ φασι μέγιστον ἐπουρανίων κεχολῶσθαι,	- - -u u-u u-uu- uu--	dactylic hexameter	feminine penthemimeral
εἴ κεν ὁδοῦ ζαχρεῖον ἀνήνηταί τις ὁδίτην.	- u u- --u u--- u u--	dactylic hexameter	feminine penthemimeral, trithemimeral
ποῖμναι μὲν βασιλῆος εὔτριχες Αὐγείαο	-- - uu-- -uu ----	dactylic hexameter	trithemimeral
οὐ πᾶσαι βόσκονται ἴαν βόσιν οὐδ᾽ ἕνα χῶρον·	- -- --u u- uu - uu --	dactylic hexameter	feminine penthemimeral, hepthemimeral, trithemimeral
ἀλλ᾽ αἱ μέν ῥα νάοντος ἐπ᾽ ὄχθαις ἀμφ᾽ Ἐλισοῦντος,	- - - u u-u u -- - uu--	dactylic hexameter	feminine penthemimeral, trithemimeral
αἱ δ᾽ἱερὸν θείοιο παρὰ ῥόον Ἀλφειοῖο,	- uu- --u u- uu ----	dactylic hexameter	feminine penthemimeral, hepthemimeral, trithemimeral
αἱ δ᾽ἐπὶ Βουπρασίου πολυβότρυος, αἱ δὲ καὶ ὧδε.	- uu -uu- uu-uu - u u --	dactylic hexameter	masculine penthemimeral
χωρὶς δὴ σηκοί σφι τετυγμένοι εἰσὶν ἑκάσταις.	-- - -- u u-uu -u u--	dactylic hexameter	masculine penthemimeral, trithemimeral
αὐτὰρ βουκολίοισι περιπλήθουσί περ ἔμπης	-- -uu-u u---u u --	dactylic hexameter	feminine penthemimeral
πάντεσσιν νομοὶ ὧδε τεθηλότες αἰὲν ἔασι,	--- uu -u u-uu -u u--	dactylic hexameter	feminine penthemimeral, trithemimeral
Μηνίου ἀμμέγα τῖφος, ἐπεὶ πολυειδέα ποίην	-uu -uu -u u- uu-uu --	dactylic hexameter	feminine penthemimeral, hepthemimeral
λειμῶνες θαλέθουσιν ὑπόδροσοι εἰαμεναί τε	--- uu-u u-uu -uu- -	dactylic hexameter	feminine penthemimeral, trithemimeral
εἰς ἅλις, ἥ ῥα βόεσσι μένος κεραῇσιν ἀέξει.	- uu - u u-u u- uu-u u--	dactylic hexameter	feminine penthemimeral, hepthemimeral, trithemimeral
αὖλις δέ σφισιν ἥδε τεῆς ἐπὶ δεξιὰ χειρὸς	-- - uu -u u- uu -uu --	dactylic hexameter	feminine penthemimeral, hepthemimeral, trithemimeral
φαίνεται εὖ μάλα πᾶσα πέρην ποταμοῖο ῥέοντος,	-uu - uu -u u- uu-u u--	dactylic hexameter	feminine penthemimeral, hepthemimeral, trithemimeral
κείνῃ, ὅθι πλατάνιστοι ἐπηεταναὶ πεφύασι	-u u- uu-u u-uu- uu--	dactylic hexameter	feminine penthemimeral, trithemimeral
χλωρή τ᾽ἀγριέλαιος, Ἀπόλλωνος νομίοιο	-- -uu-u u--- uu--	dactylic hexameter	feminine penthemimeral
ἱερὸν ἁγνόν, ξεῖνε, τελειοτάτοιο θεοῖο.	-uu -- -u u-uu-u u--	dactylic hexameter	feminine penthemimeral
εὐθὺς δὲ σταθμοὶ περιμήκεες ἀγροιώταις	-- - -- uu-uu ----	dactylic hexameter	masculine penthemimeral, trithemimeral
δέδμηνθ᾽, οἳ βασιλῆι πολὺν καὶ ἀθέσφατον ὄλβον	-- - uu-u u- u u-uu --	dactylic hexameter	feminine penthemimeral, hepthemimeral, trithemimeral
ῥυόμεθ᾽ ἐνδυκέως, τριπόλοις σπόρον ἐν νειοῖσιν	-uu -uu- uu- uu - ---	dactylic hexameter	masculine penthemimeral, hepthemimeral
ἔσθ᾽ ὅτε βάλλοντες καὶ τετραπόλοισιν ὁμοίως.	- uu --- - -uu-u u--	dactylic hexameter	masculine penthemimeral
οὔρους μὴν ἴσασι φυτοσκάφοι οἱ πολύεργοι,	-- - uu- --uu - uu--	dactylic hexameter	masculine penthemimeral, trithemimeral
ἐς ληνοὺς δ᾽ἱκνεῦνται, ἐπὴν θέρος ὥριον ἔλθῃ.	- -- --u u- uu -uu --	dactylic hexameter	feminine penthemimeral, hepthemimeral, trithemimeral
πᾶν γὰρ δὴ πεδίον τόδ᾽ ἐπίφρονος Αὐγείαο,	- - - uu- u u-uu ----	dactylic hexameter	masculine penthemimeral, trithemimeral
πυροφόροι τε γύαι καὶ ἀλωαὶ δενδρήεσσαι,	-uu- u u- u u-- ----	dactylic hexameter	masculine penthemimeral, trithemimeral
μέχρις ἐπ᾽ ἐσχατιὰς πολυπίδακος ἀκρωρείης,	-u u -uu- uu-uu ----	dactylic hexameter	masculine penthemimeral
ἃς ἡμεῖς ἔργοισιν ἐποιχόμεθα πρόπαν ἦμαρ,	- -- --u u-uu- uu --	dactylic hexameter	feminine penthemimeral, trithemimeral
ἣ δίκη οἰκήων, οἷσιν βίος ἔπλετ᾽ ἐπ᾽ ἀγροῦ.	- uu --- -- uu -u u --	dactylic hexameter	masculine penthemimeral, hepthemimeral
ἀλλὰ σύ πέρ μοι ἔνισπε, τό τοι καὶ κέρδιον αὐτῷ	-u u - u u-u u - - -uu --	dactylic hexameter	feminine penthemimeral, hepthemimeral, trithemimeral
ἔσσεται, οὗτινος ὧδε κεχρημένος εἰλήλουθας,	-uu -uu -u u-uu ----	dactylic hexameter	feminine penthemimeral
ἠὲ σύγ᾽ Αὐγείην ἢ καὶ δμώων τινὰ κείνου	-u u --- - - -- uu --	dactylic hexameter	masculine penthemimeral, hepthemimeral
δίζεαι, οἵ οἱ ἔασιν. ἐγὼ δέ κέ τοι σάφα εἰδὼς	-uu - u u-u u- u u - uu --	dactylic hexameter	feminine penthemimeral, hepthemimeral, trithemimeral
ἀτρεκέως εἴποιμ᾽, ἐπεὶ οὐ σέγε φημὶ κακῶν ἒξ	-uu- -- uu - uu -u u- -	dactylic hexameter	masculine penthemimeral, hepthemimeral, trithemimeral
ἔμμεναι οὐδὲ κακοῖσιν ἐοικότα φύμεναι αὐτόν,	-uu -u u-u u-uu -uu --	dactylic hexameter	feminine penthemimeral
οἷόν τοι μέγα εἶδος ἐπιπρέπει. ἦ ῥά νυ παῖδες	-- - uu -u u-uu - u u --	dactylic hexameter	feminine penthemimeral, trithemimeral
ἀθανάτων τοιοίδε μετὰ θνητοῖσιν ἔασι."	-uu- --u u- --u u--	dactylic hexameter	feminine penthemimeral, hepthemimeral, trithemimeral
τὸν δ᾽ἀπαμειβόμενος προσέφη Διὸς ἄλκιμος υἱός.	- uu-uu- uu- uu -uu --	dactylic hexameter	masculine penthemimeral, hepthemimeral
"ναὶ γέρον Αὐγείην ἐθέλοιμί κεν ἀρχὸν Ἐπειῶν	- uu --- uu-u u -u u--	dactylic hexameter	masculine penthemimeral
εἰσιδέειν· τοῦ γάρ με καὶ ἤγαγεν ἐνθάδε χρειώ.	-uu- - - u u -uu -uu --	dactylic hexameter	masculine penthemimeral, trithemimeral
εἰ δ᾽ὁ μὲν ἂρ κατὰ ἄστυ μένει παρὰ οἷσι πολίταις	- u u - uu -u u- uu -u u--	dactylic hexameter	feminine penthemimeral, hepthemimeral, trithemimeral
δήμου κηδόμενος, διὰ δὲ κρίνουσι θέμιστας,	-- -uu- uu - --u u--	dactylic hexameter	masculine penthemimeral, hepthemimeral
δμώων δή τινα πρέσβυ σύ μοι φράσον ἡγεμονεύσας,	-- - uu -u u - uu -uu--	dactylic hexameter	feminine penthemimeral, hepthemimeral, trithemimeral
ὅστις ἐπ᾽ ἀγρῶν τῶνδε γεραίτερος αἰσυμνήτης,	-u u -- -u u-uu ----	dactylic hexameter	feminine penthemimeral
ᾧ κε τὸ μὲν εἴποιμι, τὸ δ᾽ἐκ φαμένοιο πυθοίμην.	- u u - --u u - uu-u u--	dactylic hexameter	feminine penthemimeral, hepthemimeral, trithemimeral
ἄλλου δ᾽ἄλλον ἔθηκε θεὸς ἐπιδευέα φωτῶν."	-- -u u-u u- uu-uu --	dactylic hexameter	feminine penthemimeral, hepthemimeral
τὸν δ᾽ὁ γέρων ἐξαῦτις ἀμείβετο δῖος ἀροτρεύς·	- u u- --u u-uu -u u--	dactylic hexameter	feminine penthemimeral, trithemimeral
"Ἀθανάτων ὦ ξεῖνε φραδῇ τινος ἐνθάδ᾽ ἱκάνεις,	-uu- - -u u- uu -u u--	dactylic hexameter	feminine penthemimeral, hepthemimeral, trithemimeral
ὥς τοι πᾶν ὃ θέλεις αἶψα χρέος ἐκτετέλεσται.	- - - u u- -- uu -uu--	dactylic hexameter	masculine penthemimeral, hepthemimeral, trithemimeral
ὧδε γὰρ Αὐγείης, υἱὸς φίλος Ἠελίοιο,	-u u --- -- uu -uu--	dactylic hexameter	masculine penthemimeral, hepthemimeral
σφωιτέρῳ σὺν παιδί, βίῃ Φυλῆος ἀγαυοῦ,	-uu- - -u u- --u u--	dactylic hexameter	feminine penthemimeral, hepthemimeral, trithemimeral
χθιζός γ᾽εἰλήλουθεν ἀπ᾽ ἄστεος, ἤμασι πολλοῖς	-- ---u u -uu -uu --	dactylic hexameter	feminine penthemimeral
κτῆσιν ἐποψόμενος, ἥ οἱ νήριθμος ἐπ᾽ ἀγρῶν·	-u u-uu- - - --u u --	dactylic hexameter	masculine penthemimeral, hepthemimeral
ὥς που καὶ βασιλεῦσιν ἐείδεται ἐν φρεσὶν ᾗσιν	- - - uu-u u-uu - uu --	dactylic hexameter	feminine penthemimeral, trithemimeral
αὐτοῖς κηδομένοισι σαώτερος ἔμμεναι οἶκος.	-- -uu-u u-uu -uu --	dactylic hexameter	feminine penthemimeral
ἀλλ᾽ ἴομεν μάλα πρός μιν· ἐγὼ δέ τοι ἡγεμονεύσω	- uu- uu - u u- u u -uu--	dactylic hexameter	masculine penthemimeral, hepthemimeral, trithemimeral
αὖλιν ἐφ᾽ ἡμετέρην, ἵνα κεν τέτμοιμεν ἄνακτα."	-u u -uu- uu - --u u--	dactylic hexameter	masculine penthemimeral, hepthemimeral
Ὣς εἰπὼν ἡγεῖτο, νόῳ δ᾽ἔτι πόλλ᾽ ἐμενοίνα,	- -- --u u- uu - uu--	dactylic hexameter	feminine penthemimeral, hepthemimeral, trithemimeral
δέρμά τε θηρὸς ὁρῶν χειροπληθῆ τε κορύνην,	-u u -u u- ---- u u--	dactylic hexameter	masculine penthemimeral
ὁππόθεν ὁ ξεῖνος· μέμονεν δέ μιν αἰὲν ἔρεσθαι·	-uu - -- uu- u u -u u--	dactylic hexameter	masculine penthemimeral, hepthemimeral, trithemimeral
ἂψ δ᾽ὄκνῳ ποτὶ χεῖλος ἐλάμβανε μῦθον ἰόντα,	- -- uu -u u-uu -u u--	dactylic hexameter	feminine penthemimeral, trithemimeral
μή τί οἱ οὐ κατὰ καιρὸν ἔπος προτιμυθήσαιτο,	- u u - uu -u u- uu----	dactylic hexameter	feminine penthemimeral, hepthemimeral, trithemimeral
σπερχομένου· χαλεπὸν δ᾽ἑτέρου νόον ἴδμεναι ἀνδρός.	-uu- uu- uu- uu -uu --	dactylic hexameter	masculine penthemimeral, hepthemimeral, trithemimeral
τοὺς δὲ κύνες προσιόντας ἀπόπροθεν αἶψ᾽ ἐνόησαν,	- u u- uu-u u-uu - uu--	dactylic hexameter	feminine penthemimeral, trithemimeral
ἀμφότερον ὀσμῇ τε χροὸς δούπῳ τε ποδοῖιν.	-uu- -- u u- -- u u--	dactylic hexameter	masculine penthemimeral, hepthemimeral, trithemimeral
θεσπέσιον δ᾽ὑλάοντες ἐπέδραμον ἄλλοθεν ἄλλος	-uu- uu-u u-uu -uu --	dactylic hexameter	feminine penthemimeral, trithemimeral
Ἀμφιτρυωνιάδῃ Ἡρακλέι· τὸν δὲ γέροντα	-uu-uu- --uu - u u--	dactylic hexameter	masculine penthemimeral
ἀχρεῖον κλάζοντε περίσσαινον ἑτέρωθεν.	--- --u u--- uu--	dactylic hexameter	feminine penthemimeral, trithemimeral
τοὺς μὲν ὅγε λάεσσιν ἀπὸ χθόνος ὅσσον ἀείρων	- u u- --u u- uu -u u--	dactylic hexameter	feminine penthemimeral, hepthemimeral, trithemimeral
φευγέμεν ἂψ ὀπίσω δειδίσσετο, τρηχὺ δὲ φωνῇ	-uu - uu- --uu -u u --	dactylic hexameter	masculine penthemimeral, trithemimeral
ἠπείλει μάλα πᾶσιν, ἐρητύσασκε δ᾽ὑλαγμοῦ,	--- uu -u u---u u--	dactylic hexameter	feminine penthemimeral, trithemimeral
χαίρων ἐν φρεσὶν ᾗσιν, ὁθούνεκεν αὖλιν ἔρυντο	-- - uu -u u-uu -u u--	dactylic hexameter	feminine penthemimeral, trithemimeral
αὐτοῦ γ᾽οὐ παρεόντος· ἔπος δ᾽ὅγε τοῖον ἔειπεν·	-- - uu-u u- uu -u u--	dactylic hexameter	feminine penthemimeral, hepthemimeral, trithemimeral
"Ὤ πόποι, οἷον τοῦτο θεοὶ ποίησαν ἄνακτες	- uu -- -u u- --u u--	dactylic hexameter	feminine penthemimeral, hepthemimeral
θηρίον ἀνθρώποισι μετέμμεναι, ὡς ἐπιμηθές.	-uu ---u u-uu - uu--	dactylic hexameter	feminine penthemimeral
εἴ οἱ καὶ φρένες ὧδε νοήμονες ἔνδοθεν ἦσαν,	- - - uu -u u-uu -uu --	dactylic hexameter	feminine penthemimeral, trithemimeral
ᾔδει δ᾽,ᾧ τε χρὴ χαλεπαινέμεν ᾧ τε καὶ οὐκί,	-- - - - uu-uu - u u --	dactylic hexameter	masculine penthemimeral, trithemimeral
οὐκ ἄν οἱ θηρῶν τις ἐδήρισεν περὶ τιμῆς·	- - - -- u u--- uu --	dactylic hexameter	masculine penthemimeral, trithemimeral
νῦν δὲ λίην ζάκοτόν τε καὶ ἀρρηνὲς γένετ᾽ αὔτως."	- u u- uu- u u --- uu --	dactylic hexameter	masculine penthemimeral, trithemimeral
Ἠ ῥα, καὶ ἐσσυμένως ποτὶ ταὐλίον ἷξον ἰόντες.	- u u -uu- uu -uu -u u--	dactylic hexameter	masculine penthemimeral
Ἠέλιος μὲν ἔπειτα ποτὶ ζόφον ἔτραπεν ἵππους	-uu- u u-u u- uu -uu --	dactylic hexameter	feminine penthemimeral, hepthemimeral, trithemimeral
δείελον ἦμαρ ἄγων· τὰ δ᾽ἐπήλυθε πίονα μῆλα	-uu -u u- u u-uu -uu --	dactylic hexameter	masculine penthemimeral
ἐκ βοτάνης ἀνιόντα μετ᾽ αὐλία τε σηκούς τε.	- uu- uu-u u -uu - -- -	dactylic hexameter	feminine penthemimeral, trithemimeral
αὐτὰρ ἔπειτα βόες μάλα μυρίαι ἄλλαι ἐπ᾽ ἄλλαις	-u u-u u- uu -uu -u u --	dactylic hexameter	masculine penthemimeral
ἐρχόμεναι φαίνονθ᾽ ὡσεὶ νέφη ὑδατόεντα,	-uu- -- -- uu -uu--	dactylic hexameter	masculine penthemimeral, hepthemimeral, trithemimeral
ἅσσά τ᾽ἐν οὐρανῷ εἶσιν ἐλαυνόμενα προτέρωσε	-u u -uu -u u-uu- uu--	dactylic hexameter	feminine penthemimeral
ἠὲ νότοιο βίῃ ἠὲ Θρῃκὸς βορέαο·	-u u-u u- -- -- uu--	dactylic hexameter	masculine penthemimeral, hepthemimeral
τῶν μέν τ᾽οὔτις ἀριθμὸς ἐν ἠέρι γίνετ᾽ ἰόντων,	- - -u u-u u -uu -u u--	dactylic hexameter	feminine penthemimeral
οὐδ᾽ ἄνυσις· τόσα γάρ τε μετὰ προτέροισι κυλίνδει	- uu- uu - u u- uu-u u--	dactylic hexameter	masculine penthemimeral, hepthemimeral, trithemimeral
ἲς ἀνέμου, τὰ δέ τ᾽ἄλλα κορύσσεται αὖτις ἐπ᾽ ἄλλοις·	- uu- u u -u u-uu -u u --	dactylic hexameter	feminine penthemimeral, trithemimeral
τόσσ᾽ αἰεὶ μετόπισθε βοῶν ἐπὶ βουκόλι᾽ ᾔει.	- -- uu-u u- uu -uu --	dactylic hexameter	feminine penthemimeral, hepthemimeral, trithemimeral
πᾶν δ᾽ἄρ᾽ ἐνεπλήσθη πεδίον, πᾶσαι δὲ κέλευθοι	- u u--- uu- -- u u--	dactylic hexameter	masculine penthemimeral, hepthemimeral
ληίδος ἐρχομένης (στείνοντο δὲ πίονες ἀγροί),	-uu -uu- --u u -uu --	dactylic hexameter	masculine penthemimeral
μυκηθμῷ· σηκοὶ δὲ βοῶν ῥεῖα πλήσθησαν	--- -- u u- -- ---	dactylic hexameter	masculine penthemimeral, hepthemimeral, trithemimeral
εἰλιπόδων, ὄιες δὲ κατ᾽ αὐλὰς ηὐλίζοντο.	-uu- -- u u -- ----	dactylic hexameter	masculine penthemimeral, trithemimeral
ἔνθα μὲν οὔτις ἕκηλος ἀπειρεσίων περ ἐόντων	-u u -u u-u u-uu- u u--	dactylic hexameter	feminine penthemimeral
εἱστήκει παρὰ βουσὶν ἀνὴρ κεχρημένος ἔργου·	--- uu -u u- --uu --	dactylic hexameter	feminine penthemimeral, hepthemimeral, trithemimeral
ἀλλ᾽ ὁ μὲν ἀμφὶ πόδεσσιν ἐυτμήτοισιν ἱμᾶσι	- u u -u u-u u---u u--	dactylic hexameter	feminine penthemimeral
κωλοπέδας ἀράρισκε περισταδὸν ἐγγὺς ἀμέλγειν·	-uu- uu-u u-uu -u u--	dactylic hexameter	feminine penthemimeral, trithemimeral
ἄλλος δ᾽αὖ φίλα τέκνα φίλαις ὑπὸ μητράσιν ἵει	-- - uu -u u- uu -uu --	dactylic hexameter	feminine penthemimeral, hepthemimeral, trithemimeral
πινέμεναι λιαροῖο μεμαότα πάγχυ γάλακτος,	-uu- uu-u u-uu -u u--	dactylic hexameter	feminine penthemimeral, trithemimeral
ἄλλος ἀμόλγιον εἶχ᾽, ἄλλος τρέφε πίονα τυρόν,	-u u-uu - -- uu -uu --	dactylic hexameter	masculine penthemimeral, hepthemimeral
ἄλλος ἐσῆγεν ἔσω ταύρους δίχα θηλειάων.	-u u-u u- -- uu ----	dactylic hexameter	masculine penthemimeral, hepthemimeral
Αὐγείης δ᾽ἐπὶ πάντας ἰὼν θηεῖτο βοαύλους	--- uu -u u- --u u--	dactylic hexameter	feminine penthemimeral, hepthemimeral, trithemimeral
ἥντινά οἱ κτεάνων κομιδὴν ἐτίθεντο νομῆες,	-uu - uu- uu- uu-u u--	dactylic hexameter	masculine penthemimeral, hepthemimeral, trithemimeral
σὺν δ᾽υἱός τε βίη τε βαρύφρονος Ἡρακλῆος	- -- u u- u u-uu ----	dactylic hexameter	masculine penthemimeral, trithemimeral
ὡμάρτευν βασιλῆι διερχομένῳ μέγαν ὄλβον.	--- uu-u u-uu- uu --	dactylic hexameter	feminine penthemimeral, trithemimeral
ἔνθα καὶ ἄρρηκτόν περ ἔχων ἐν στήθεσι θυμὸν	-u u --- u u- - -uu --	dactylic hexameter	masculine penthemimeral, hepthemimeral
Ἀμφιτρυωνιάδης καὶ ἀρηρότα νωλεμὲς αἰεὶ	-uu-uu- u u-uu -uu --	dactylic hexameter	masculine penthemimeral
ἐκπάγλως θαύμαζε θεῶν τόγε μυρίον ἕδνον	--- --u u- uu -uu --	dactylic hexameter	feminine penthemimeral, hepthemimeral, trithemimeral
εἰσορόων. οὐ γάρ κεν ἔφασκέ τις οὐδὲ ἐώλπει	-uu- - - u u-u u -u u--	dactylic hexameter	masculine penthemimeral, trithemimeral
ἀνδρὸς ληίδ᾽ ἑνὸς τόσσην ἔμεν οὐδὲ δέκ᾽ ἄλλων,	-- -u u- -- uu -u u --	dactylic hexameter	masculine penthemimeral, hepthemimeral
οἵτε πολύρρηνες πάντων ἔσαν ἐκ βασιλήων.	-u u--- -- uu - uu--	dactylic hexameter	masculine penthemimeral, hepthemimeral
Ἠέλιος δ᾽ᾧ παιδὶ τόγ᾽ ἔξοχον ὤπασε δῶρον,	-uu- - -u u -uu -uu --	dactylic hexameter	feminine penthemimeral, trithemimeral
ἀφνειὸν μήλοις περὶ πάντων ἔμμεναι ἀνδρῶν,	--- -- uu -- -uu --	dactylic hexameter	masculine penthemimeral, trithemimeral
καί ῥά οἱ αὐτὸς ὄφελλε διαμπερέως βοτὰ πάντα	- u u -u u-u u-uu- uu --	dactylic hexameter	feminine penthemimeral
ἐς τέλος· οὐ μὲν γάρ τις ἐπήλυθε νοῦσος ἐκείνου	- uu - - - u u-uu -u u--	dactylic hexameter	masculine penthemimeral, trithemimeral
βουκολίοις, αἵτ᾽ ἔργα καταφθείρουσι νομήων,	-uu- - -u u---u u--	dactylic hexameter	feminine penthemimeral, trithemimeral
αἰεὶ δὲ πλέονες κερααὶ βόες, αἰὲν ἀμείνους	-- - uu- uu- uu -u u--	dactylic hexameter	masculine penthemimeral, hepthemimeral, trithemimeral
ἐξ ἔτεος γίνοντο μάλ᾽ εἰς ἔτος· ἦ γὰρ ἅπασαι	- uu- --u u - uu - u u--	dactylic hexameter	feminine penthemimeral, hepthemimeral, trithemimeral
ζωοτόκοι τ᾽ἦσαν περιώσια θηλυτόκοι τε.	-uu- -- uu-uu -uu- -	dactylic hexameter	masculine penthemimeral, trithemimeral
ταῖς δὲ τριηκόσιοι ταῦροι συνάμ᾽ ἐστιχόωντο	- u u-uu- -- uu -uu--	dactylic hexameter	masculine penthemimeral, hepthemimeral
κνήμαργοί θ᾽ἕλικές τε, διηκόσιοί γε μὲν ἄλλοι	--- uu- u u-uu- u u --	dactylic hexameter	masculine penthemimeral, trithemimeral
φοίνικες· πάντες δ᾽ἐπιβήτορες οἵγ᾽ ἔσαν ἤδη.	--- -- uu-uu - uu --	dactylic hexameter	masculine penthemimeral, trithemimeral
ἄλλοι δ᾽αὖ μετὰ τοῖσι δυώδεκα βουκολέοντο	-- - uu -u u-uu -uu--	dactylic hexameter	feminine penthemimeral, trithemimeral
ἱεροὶ Ἠελίοιο· χρόην δ᾽ἔσαν ἠύτε κύκνοι	-uu -uu-u u- uu -uu --	dactylic hexameter	feminine penthemimeral, hepthemimeral
ἀργησταί, πᾶσιν δὲ μετέπρεπον εἰλιπόδεσσιν	--- -- u u-uu -uu--	dactylic hexameter	masculine penthemimeral, trithemimeral
οἳ καὶ ἀτιμαγέλαι βόσκοντ᾽ ἐριθηλέα ποίην	- u u-uu- -- uu-uu --	dactylic hexameter	masculine penthemimeral, hepthemimeral
ἐν νομῷ· ὧδ᾽ ἔκπαγλον ἐπὶ σφίσι γαυριόωντο.	- uu - --u u- uu -uu--	dactylic hexameter	feminine penthemimeral, hepthemimeral, trithemimeral
καί ῥ᾽ὁπότ᾽ ἐκ λασίοιο θοοὶ προγενοίατο θῆρες	- uu - uu-u u- uu-uu --	dactylic hexameter	feminine penthemimeral, hepthemimeral, trithemimeral
ἐς πεδίον δρυμοῖο βοῶν ἕνεκ᾽ ἀγροτεράων,	- uu- --u u- uu -uu--	dactylic hexameter	feminine penthemimeral, hepthemimeral, trithemimeral
πρῶτοι τοίγε μάχηνδε κατὰ χροὸς ᾔεσαν ὀσμήν,	-- -u u-u u- uu -uu --	dactylic hexameter	feminine penthemimeral, hepthemimeral
δεινὸν δ᾽ἐβρυχῶντο φόνον λεύσσοντε προσώπῳ.	-- ---u u- --u u--	dactylic hexameter	feminine penthemimeral, hepthemimeral
τῶν μέν τε προφέρεσκε βίηφί τε καὶ σφένεϊ ᾧ	- - - uu-u u-u u - uu- -	dactylic hexameter	feminine penthemimeral, trithemimeral
ἠδ᾽ ὑπεροπλίῃ Φαέθων μέγας, ὅν ῥα βοτῆρες	- uu--- uu- uu - u u--	dactylic hexameter	masculine penthemimeral, hepthemimeral
ἀστέρι πάντες ἔισκον, ὁθούνεκα πολλὸν ἐν ἄλλοις	-uu -- -u u-uu -u u --	dactylic hexameter	feminine penthemimeral
βουσὶν ἰὼν λάμπεσκεν, ἀρίζηλος δ᾽ἐτέτυκτο.	-u u- --u u--- uu--	dactylic hexameter	feminine penthemimeral, trithemimeral
ὃς δή τοι σκύλος αὖον ἰδὼν χαροποῖο λέοντος	- - - uu -u u- uu-u u--	dactylic hexameter	feminine penthemimeral, hepthemimeral, trithemimeral
αὐτῷ ἔπειτ᾽ ἐπόρουσεν ἐυσκόπῳ Ἡρακλῆι	-u u- uu-u u-uu ----	dactylic hexameter	feminine penthemimeral, trithemimeral
χρίμψασθαι ποτὶ πλευρὰ κάρη στιβαρόν τε μέτωπον.	--- uu -u u- uu- u u--	dactylic hexameter	feminine penthemimeral, hepthemimeral, trithemimeral
τοῦ μὲν ἄναξ προσιόντος ἐδράξατο χειρὶ παχείῃ	- u u- uu-u u-uu -u u--	dactylic hexameter	feminine penthemimeral, trithemimeral
σκαιοῦ ἄφαρ κέραος, κατὰ δ᾽αὐχένα νέρθ᾽ ἐπὶ γαίης	-u u- uu- uu -uu - uu --	dactylic hexameter	masculine penthemimeral, trithemimeral
κλάσσε βαρύν περ ἐόντα, πάλιν δέ μιν ὦσεν ὀπίσσω	-u u- u u-u u- u u -u u--	dactylic hexameter	feminine penthemimeral, hepthemimeral, trithemimeral
ὤμῳ ἐπιβρίσας· ὁ δέ οἱ περὶ νεῦρα τανυσθεὶς	-u u-uu - - - uu -u u--	dactylic hexameter	masculine penthemimeral, hepthemimeral
μυὼν ἐξ ὑπάτοιο βραχίονος ὀρθὸς ἀνέστη.	-- - uu-u u-uu -u u--	dactylic hexameter	feminine penthemimeral, trithemimeral
θαύμαζεν δ᾽αὐτός τε ἄναξ υἱός τε δαΐφρων	--- -- u u- -- u u--	dactylic hexameter	masculine penthemimeral, hepthemimeral, trithemimeral
Φυλεὺς οἵ τ᾽ἐπὶ βουσὶ κορωνίσι βουκόλοι ἄνδρες,	-- - uu -u u-uu -uu --	dactylic hexameter	feminine penthemimeral, trithemimeral
Ἀμφιτρυωνιάδαο βίην ὑπέροπλον ἰδόντες.	-uu-uu-u u- uu-u u--	dactylic hexameter	feminine penthemimeral, hepthemimeral
τὼ δ᾽εἰς ἄστυ λιπόντε καταυτόθι πίονας ἀγροὺς	- - -u u-u u-uu -uu --	dactylic hexameter	feminine penthemimeral
ἐστιχέτην, Φυλεύς τε βίη θ᾽Ἡρακληείη.	-uu- -- u u- -----	dactylic hexameter	masculine penthemimeral, hepthemimeral, trithemimeral
λαοφόρου δ᾽ἐπέβησαν ὅθι πρώτιστα κελεύθου,	-uu- uu-u u- --u u--	dactylic hexameter	feminine penthemimeral, hepthemimeral, trithemimeral
λεπτὴν καρπαλίμοισι τρίβον ποσὶν ἐξανύσαντες,	-- -uu-u u- uu -uu--	dactylic hexameter	feminine penthemimeral, hepthemimeral
ἥ ῥα δι᾽ ἀμπελεῶνος ἀπὸ σταθμῶν τετάνυστο	- u u -uu-u u- -- uu--	dactylic hexameter	feminine penthemimeral, hepthemimeral
οὔτι λίην ἀρίσημος ἐν ὕλῃ χλωρὰ θέουσα,	-u u- uu-u u -- -u u--	dactylic hexameter	feminine penthemimeral, trithemimeral
τῇ μιν ἄρα προσέειπε Διὸς γόνον ὑψίστοιο	- u u- uu-u u- uu ----	dactylic hexameter	feminine penthemimeral, hepthemimeral, trithemimeral
Αὐγείω φίλος υἱὸς ἕθεν μετόπισθεν ἰόντα,	--- uu -u u- uu-u u--	dactylic hexameter	feminine penthemimeral, hepthemimeral, trithemimeral
ἦκα παρακλίνας κεφαλὴν κατὰ δεξιὸν ὦμον·	-u u--- uu- uu -uu --	dactylic hexameter	masculine penthemimeral, hepthemimeral
"ξεῖνε, πάλαι τινὰ πάγχυ σέθεν πέρι μῦθον ἀκούσας	-u u- uu -u u- uu -u u--	dactylic hexameter	feminine penthemimeral, hepthemimeral, trithemimeral
ὡσεί περ σφετέρῃσιν ἐνὶ φρεσὶ βάλλομαι ἄρτι.	-- - uu-u u- uu -uu --	dactylic hexameter	feminine penthemimeral, hepthemimeral, trithemimeral
ἤλυθε γὰρ στείχων τις ἀπ᾽ Ἄργεος ὡς μέσος ἀκμῆς	-uu - -- u u -uu - uu --	dactylic hexameter	masculine penthemimeral, trithemimeral
ἐνθάδ᾽ Ἀχαιὸς ἀνὴρ Ἑλίκης ἐξ ἀγχιάλοιο·	-u u-u u- uu- - -uu--	dactylic hexameter	masculine penthemimeral, hepthemimeral
ὃς δή τοι μυθεῖτο καὶ ἐν πλεόνεσσιν Ἐπειῶν,	- - - --u u - uu-u u--	dactylic hexameter	feminine penthemimeral, hepthemimeral, trithemimeral
οὕνεκεν Ἀργείων τις ἕθεν παρεόντος ὄλεσσε	-uu --- u u- uu-u u--	dactylic hexameter	masculine penthemimeral, hepthemimeral
θηρίον, αἰνολέοντα, κακὸν τέρας ἀγροιώταις,	-uu -uu-u u- uu ----	dactylic hexameter	feminine penthemimeral, hepthemimeral
κοίλην αὖλιν ἔχοντα Διὸς Νεμέοιο παρ᾽ ἄλσος,	-- -u u-u u- uu-u u --	dactylic hexameter	feminine penthemimeral, hepthemimeral
οὐκ οἶδ᾽ ἀτρεκέως ἢ Ἄργεος ἐξ ἱεροῖο	- - -uu- - -uu - uu--	dactylic hexameter	masculine penthemimeral
αὐτόθεν ἢ Τίρυνθα νέμων πόλιν ἠὲ Μυκήνην.	-uu - --u u- uu -u u--	dactylic hexameter	feminine penthemimeral, hepthemimeral, trithemimeral
ὣς κεῖνος ἀγόρευε· γένος δέ μιν εἶναι ἔφασκεν,	- -- uu-u u- u u -u u--	dactylic hexameter	feminine penthemimeral, hepthemimeral, trithemimeral
εἰ ἐτεόν περ ἐγὼ μιμνήσκομαι, ἐκ Περσῆος.	- uu- u u- --uu - ---	dactylic hexameter	masculine penthemimeral, trithemimeral
ἔλπομαι οὐχ ἕτερον τόδε τλήμεναι Αἰγιαλήων	-uu - uu- uu -uu -uu--	dactylic hexameter	masculine penthemimeral, trithemimeral
ἠὲ σέ· δέρμα δὲ θηρὸς ἀριφραδέως ἀγορεύει	-u u -u u -u u-uu- uu--	dactylic hexameter	feminine penthemimeral
χειρῶν καρτερὸν ἔργον, ὅ τοι περὶ πλευρὰ καλύπτει.	-- -uu -u u - uu -u u--	dactylic hexameter	feminine penthemimeral, hepthemimeral
εἴπ᾽ ἄγε νῦν μοι πρῶτον, ἵνα γνώω κατὰ θυμόν,	- uu - - -u u- -- uu --	dactylic hexameter	feminine penthemimeral, hepthemimeral, trithemimeral
ἥρως, εἴτ᾽ ἐτύμως μαντεύομαι εἴτε καὶ οὐκί,	-- - uu- --uu -u u --	dactylic hexameter	masculine penthemimeral, trithemimeral
εἰ σύγ᾽ ἐκεῖνος, ὃν ἧμιν ἀκουόντεσσιν ἔειπεν	- u u-u u -u u---u u--	dactylic hexameter	feminine penthemimeral
οὑξ Ἑλίκηθεν Ἀχαιός, ἐγὼ δέ σε φράζομαι ὀρθῶς.	- uu-u u-u u- u u -uu --	dactylic hexameter	feminine penthemimeral, hepthemimeral
εἰπὲ δ᾽ὅπως ὀλοὸν τόδε θηρίον αὐτὸς ἔπεφνες,	-u u- uu- uu -uu -u u--	dactylic hexameter	masculine penthemimeral, trithemimeral
ὅππως τ᾽εὔυδρον Νεμέης εἰσήλυθε χῶρον·	-- --- uu- --uu --	dactylic hexameter	masculine penthemimeral, hepthemimeral
οὐ μὲν γάρ κε τοσόνδε κατ᾽ Ἀπίδα κνώδαλον εὕροις	- - - u u-u u -uu -uu --	dactylic hexameter	feminine penthemimeral, trithemimeral
ἱμείρων ἰδέειν, ἐπεὶ οὐ μάλα τηλίκα βόσκει,	--- uu- uu - uu -uu --	dactylic hexameter	masculine penthemimeral, hepthemimeral, trithemimeral
ἀλλ᾽ ἄρκτους τε σύας τε λύκων τ᾽ὀλοφώιον ἔρνος.	- -- u u- u u- uu-uu --	dactylic hexameter	masculine penthemimeral, hepthemimeral, trithemimeral
τῷ καὶ θαυμάζεσκον ἀκούοντες τότε μῦθον·	- - ---u u--- uu --	dactylic hexameter	feminine penthemimeral
οἱ δέ νυ καὶ ψεύδεσθαι ὁδοιπόρον ἀνέρ᾽ ἔφαντο	- u u - --u u-uu -u u--	dactylic hexameter	feminine penthemimeral, trithemimeral
γλώσσης μαψιδίοιο χαριζόμενον παρεοῦσιν."	-- -uu-u u-uu- uu--	dactylic hexameter	feminine penthemimeral
Ὣς εἰπὼν μέσσης ἐξηρώησε κελεύθου	- -- -- ----u u--	dactylic hexameter	masculine penthemimeral, trithemimeral
Φυλεύς, ὄφρα κιοῦσιν ἅμα σφίσιν ἄρκιος εἴη,	-- -u u-u u- uu -uu --	dactylic hexameter	feminine penthemimeral, hepthemimeral
καί ῥά τε ῥηίτερον φαμένου κλύοι Ἡρακλῆος,	- u u -uu- uu- uu ----	dactylic hexameter	masculine penthemimeral, hepthemimeral
ὅς μιν ὁμαρτήσας τοίῳ προσελέξατο μύθῳ·	- u u--- -- uu-uu --	dactylic hexameter	masculine penthemimeral, hepthemimeral
"̂Ὠ Αὐγηιάδη, τὸ μὲν ὅττί με πρῶτον ἀνήρευ,	- --uu- u u -u u -u u--	dactylic hexameter	masculine penthemimeral
αὐτὸς καὶ μάλα ῥεῖα κατὰ στάθμην ἐνόησας.	-- - uu -u u- -- uu--	dactylic hexameter	feminine penthemimeral, hepthemimeral, trithemimeral
ἀμφὶ δέ σοι τὰ ἕκαστα λέγοιμί κε τοῦδε πελώρου	-u u - u u-u u-u u -u u--	dactylic hexameter	feminine penthemimeral, trithemimeral
ὅππως ἐκράανθεν, ἐπεὶ λελίησαι ἀκούειν,	-- ---u u- uu-u u--	dactylic hexameter	feminine penthemimeral, hepthemimeral
νόσφίν γ᾽ἢ ὅθεν ἦλθε· τὸ γὰρ πολέων περ ἐόντων	-- - uu -u u - uu- u u--	dactylic hexameter	feminine penthemimeral, hepthemimeral, trithemimeral
Ἀργείων οὐδείς κεν ἔχοι σάφα μυθήσασθαι·	--- -- u u- uu ----	dactylic hexameter	masculine penthemimeral, hepthemimeral, trithemimeral
οἶον δ᾽ἀθανάτων τίν᾽ ἐίσκομεν ἀνδράσι πῆμα	-- -uu- - -uu -uu --	dactylic hexameter	masculine penthemimeral
ἱρῶν μηνίσαντα Φορωνείδῃσιν ἐφεῖναι.	-- ---u u---u u--	dactylic hexameter	feminine penthemimeral
πάντας γὰρ πισῆας ἐπικλύζων ποταμὸς ὣς	-- - --u u--- uu- -	dactylic hexameter	feminine penthemimeral, trithemimeral
λῖς ἄμοτον κεράιζε, μάλιστα δὲ Βεμβιναίους,	- uu- uu-u u-u u ----	dactylic hexameter	feminine penthemimeral, trithemimeral
οἵ ἑθεν ἀγχόμοροι ναῖον πασχόντες ἄτλητα.	- uu -uu- -- --u u--	dactylic hexameter	masculine penthemimeral, hepthemimeral
τὸν μὲν ἐμοὶ πρώτιστα τελεῖν ἐπέταξεν ἄεθλον	- u u- --u u- uu-u u--	dactylic hexameter	feminine penthemimeral, hepthemimeral, trithemimeral
Εὐρυσθεύς, κτεῖναι δέ μ᾽ἐφίετο θηρίον αἰνόν.	--- -- u u-uu -uu --	dactylic hexameter	masculine penthemimeral, trithemimeral
αὐτὰρ ἐγὼ κέρας ὑγρὸν ἑλὼν κοίλην τε φαρέτρην	-u u- uu -u u- -- u u--	dactylic hexameter	feminine penthemimeral, hepthemimeral, trithemimeral
ἰῶν ἐμπλείην νεόμην, ἑτέρηφι δὲ βάκτρον	-- --- uu- uu-u u --	dactylic hexameter	masculine penthemimeral, hepthemimeral
εὐπαγὲς αὐτόφλοιον ἐπηρεφέος κοτίνοιο	-uu ---u u-uu- uu--	dactylic hexameter	feminine penthemimeral
ἔμμητρον, τὸ μὲν αὐτὸς ὑπὸ ζαθέῳ Ἑλικῶνι	--- u u -u u- uu- uu--	dactylic hexameter	feminine penthemimeral, hepthemimeral, trithemimeral
εὑρὼν σὺν πυκινῇσιν ὁλοσχερὲς ἔσπασα ῥίζαις.	-- - uu-u u-uu -uu --	dactylic hexameter	feminine penthemimeral, trithemimeral
αὐτὰρ ἐπεὶ τὸν χῶρον, ὅθι λῖς ἦεν, ἵκανον,	-u u- - -u u- - -u u--	dactylic hexameter	feminine penthemimeral, hepthemimeral, trithemimeral
δὴ τότε τόξον ἑλὼν στρεπτὴν ἐπέλασσα κορώνῃ	- uu -u u- -- uu-u u--	dactylic hexameter	masculine penthemimeral, hepthemimeral
νευρειήν, περὶ δ᾽ἰὸν ἐχέστονον εἶθαρ ἔβησα.	--- uu -u u-uu -u u--	dactylic hexameter	feminine penthemimeral, trithemimeral
πάντῃ δ᾽ὄσσε φέρων ὀλοὸν τέρας ἐσκοπίαζον,	-- -u u- uu- uu -uu--	dactylic hexameter	masculine penthemimeral, hepthemimeral
εἴ μιν ἐσαθρήσαιμι, πάρος γ᾽ἐμὲ κεῖνον ἰδέσθαι.	- u u---u u- uu -u u--	dactylic hexameter	feminine penthemimeral, hepthemimeral
ἤματος ἦν τὸ μεσηγύ, καὶ οὐδέ πῃ ἴχνια τοῖο	-uu - u u-u u -u u -uu --	dactylic hexameter	feminine penthemimeral, trithemimeral
φρασθῆναι δυνάμην οὐδ᾽ ὠρυγμοῖο πυθέσθαι.	--- uu- - ---u u--	dactylic hexameter	masculine penthemimeral, trithemimeral
οὐδὲ μὲν ἀνθρώπων τις ἔην ἐπὶ βουσὶ καὶ ἔργοις	-u u --- u u- uu -u u --	dactylic hexameter	masculine penthemimeral, hepthemimeral
φαινόμενος σπορίμοιο δι᾽ αὔλακος, ὅντιν᾽ ἐροίμην·	-uu- uu-u u -uu -u u--	dactylic hexameter	feminine penthemimeral, trithemimeral
ἀλλὰ κατὰ σταθμοὺς χλωρὸν δέος εἶχεν ἕκαστον.	-u u- -- -- uu -u u--	dactylic hexameter	masculine penthemimeral, hepthemimeral, trithemimeral
οὐ μὴν πρὶν πόδας ἔσχον ὄρος τανύφυλλον ἐρευνῶν,	- - - uu -u u- uu-u u--	dactylic hexameter	feminine penthemimeral, hepthemimeral, trithemimeral
πρὶν ἰδέειν ἀλκῆς τε παραυτίκα πειρηθῆναι.	- uu- -- u u-uu ----	dactylic hexameter	masculine penthemimeral, trithemimeral
ἤτοι ὁ μὲν σήραγγα προδείελος ἔστιχεν εἰς ἥν,	-u u - --u u-uu -uu - -	dactylic hexameter	feminine penthemimeral, trithemimeral
βεβρωκὼς κρειῶν τε καὶ αἵματος, ἀμφὶ δὲ χαίτας	--- -- u u -uu -u u --	dactylic hexameter	masculine penthemimeral, trithemimeral
αὐχμηρὰς πεπάλακτο φόνῳ χαροπόν τε πρόσωπον	--- uu-u u- uu- u u--	dactylic hexameter	feminine penthemimeral, hepthemimeral, trithemimeral
στήθεά τε, γλώσσῃ δὲ περιλιχμᾶτο γένειον.	-uu - -- u u---u u--	dactylic hexameter	masculine penthemimeral, trithemimeral
αὐτὰρ ἐγὼ θάμνοισιν ἄφαρ σκιεροῖσιν ἐκρύφθην	-u u- --u u- uu-u u--	dactylic hexameter	feminine penthemimeral, hepthemimeral, trithemimeral
ἐν ῥίῳ ὑλήεντι δεδεγμένος ὁππόθ᾽ ἵκοιτο,	- uu ---u u-uu -u u--	dactylic hexameter	feminine penthemimeral
καὶ βάλον ἆσσον ἰόντος ἀριστερὸν ἐς κενεῶνα	- uu -u u-u u-uu - uu--	dactylic hexameter	feminine penthemimeral
τηϋσίως· οὐ γάρ τι βέλος διὰ σαρκὸς ὄλισθεν	-uu- - - u u- uu -u u--	dactylic hexameter	masculine penthemimeral, hepthemimeral, trithemimeral
ὀκριόεν, χλωρῇ δὲ παλίσσυτον ἔμπεσε ποίῃ.	-uu- -- u u-uu -uu --	dactylic hexameter	masculine penthemimeral, trithemimeral
αὐτὰρ ὁ κρᾶτα δαφοινὸν ἀπὸ χθονὸς ὦκ᾽ ἐπάειρε	-u u -u u-u u- uu - uu--	dactylic hexameter	feminine penthemimeral, hepthemimeral
θαμβήσας, πάντῃ δὲ διέδρακεν ὀφθαλμοῖσι	--- -- u u-uu ----	dactylic hexameter	masculine penthemimeral, trithemimeral
σκεπτόμενος, λαμυροὺς δὲ χανὼν ὑπ᾽ ὀδόντας ἔφηνε.	-uu- uu- u u- u u-u u--	dactylic hexameter	masculine penthemimeral, hepthemimeral, trithemimeral
τῷ δ᾽ἐγὼ ἄλλον ὀιστὸν ἀπὸ νευρῆς προΐαλλον	- uu -u u-u u- -- uu--	dactylic hexameter	feminine penthemimeral, hepthemimeral
ἀσχαλόων, ὅ μοι ὁ πρὶν ἐτώσιος ἔκφυγε χειρός·	-uu- u u - u u-uu -uu --	dactylic hexameter	masculine penthemimeral, trithemimeral
μεσσηγὺς δ᾽ἔβαλον στηθέων, ὅθι πνεύμονος ἕδρη.	--- uu- -- uu -uu --	dactylic hexameter	masculine penthemimeral, hepthemimeral, trithemimeral
ἀλλ᾽ οὐδ᾽ ὣς ὑπὸ βύρσαν ἔδυ πολυώδυνος ἰός,	- - - uu -u u- uu-uu --	dactylic hexameter	feminine penthemimeral, hepthemimeral, trithemimeral
ἀλλ᾽ ἔπεσε προπάροιθε ποδῶν ἀνεμώλιος αὔτως.	- uu- uu-u u- uu-uu --	dactylic hexameter	feminine penthemimeral, hepthemimeral, trithemimeral
τὸ τρίτον αὖ μέλλεσκον ἀσώμενος ἐν φρεσὶν αἰνῶς	- uu - --u u-uu - uu --	dactylic hexameter	feminine penthemimeral, trithemimeral
αὐερύειν· ὁ δέ μ᾽εἶδε περιγληνώμενος ὄσσοις	-uu- u u -u u---uu --	dactylic hexameter	feminine penthemimeral, trithemimeral
θὴρ ἄμοτος, μακρὴν δὲ περ᾽ ἰγνύῃσιν ἕλιξε	- uu- -- u u ---u u--	dactylic hexameter	masculine penthemimeral, trithemimeral
κέρκον, ἄφαρ δὲ μάχης ἐμνήσατο· πᾶς δέ οἱ αὐχὴν	-u u- u u- --uu - u u --	dactylic hexameter	masculine penthemimeral, trithemimeral
θυμοῦ ἐνεπλήσθη, πυρσαὶ δ᾽ἔφριξαν ἔθειραι	-u u--- -- --u u--	dactylic hexameter	masculine penthemimeral, hepthemimeral
σκυζομένῳ, κυρτὴ δὲ ῥάχις γένετ᾽ ἠύτε τόξον,	-uu- -- u u- uu -uu --	dactylic hexameter	masculine penthemimeral, hepthemimeral, trithemimeral
πάντοθεν εἰληθέντος ὑπὸ λαγόνας τε καὶ ἰξύν.	-uu ---u u- uu- u u --	dactylic hexameter	feminine penthemimeral, hepthemimeral
ὡς δ᾽ὅτ᾽ ἂν ἁρματοπηγὸς ἀνὴρ πολέων ἴδρις ἔργων	- u u -uu-u u- uu- uu --	dactylic hexameter	feminine penthemimeral, hepthemimeral
ὄρπηκας κάμπτῃσιν ἐρινεοῦ εὐκεάτοιο,	--- --u u-uu -uu--	dactylic hexameter	feminine penthemimeral, trithemimeral
θάλψας ἐν πυρὶ πρῶτον, ἐπαξονίῳ κύκλα δίφρῳ·	-- - uu -u u-uu- uu --	dactylic hexameter	feminine penthemimeral, trithemimeral
τοῦ μὲν ὑπὲκ χειρῶν ἔφυγεν τανύφλοιος ἐρινεὸς	- u u- -- uu- uu-u u--	dactylic hexameter	masculine penthemimeral, hepthemimeral, trithemimeral
καμπτόμενος, τηλοῦ δὲ μιῇ πήδησε σὺν ὁρμῇ·	-uu- -- u u- --u u --	dactylic hexameter	masculine penthemimeral, hepthemimeral, trithemimeral
ὣς ἐπ᾽ ἐμοὶ λῖς αἰνὸς ἀπόπροθεν ἀθρόος ἆλτο	- u u- - -u u-uu -uu --	dactylic hexameter	feminine penthemimeral, trithemimeral
μαιμώων χροὸς ἆσαι· ἐγὼ δ᾽ἑτέρηφι βέλεμνα	--- uu -u u- uu-u u--	dactylic hexameter	feminine penthemimeral, hepthemimeral, trithemimeral
χειρὶ προεσχεθόμην καὶ ἀπ᾽ ὤμων δίπλακα λώπην,	-u u-uu- u u -- -uu --	dactylic hexameter	masculine penthemimeral
τῇ δ᾽ἑτέρῃ ῥόπαλον κόρσης ὕπερ αὖον ἀείρας	- uu- uu- -- uu -u u--	dactylic hexameter	masculine penthemimeral, hepthemimeral, trithemimeral
ἤλασα κὰκ κεφαλῆς, διὰ δ᾽ἄνδιχα τρηχὺν ἔαξα	-uu - uu- uu -uu -u u--	dactylic hexameter	masculine penthemimeral, trithemimeral
αὐτοῦ ἐπὶ λασίοιο καρήατος ἀγριέλαιον	-u u- uu-u u-uu -uu--	dactylic hexameter	feminine penthemimeral, trithemimeral
θηρὸς ἀμαιμακέτοιο· πέσεν δ᾽ὅγε πρὶν ἔμ᾽ ἱκέσθαι	-u u-uu-u u- uu - u u--	dactylic hexameter	feminine penthemimeral, hepthemimeral
ὑψόθεν ἐν γαίῃ, καὶ ἐπὶ τρομεροῖς ποσὶν ἔστη	-uu - -- u u- uu- uu --	dactylic hexameter	masculine penthemimeral, hepthemimeral, trithemimeral
νευστάζων κεφαλῇ· περὶ γὰρ σκότος ὄσσέ οἱ ἄμφω	--- uu- uu - uu -u u --	dactylic hexameter	masculine penthemimeral, hepthemimeral, trithemimeral
ἦλθε, βίῃ σεισθέντος ἐν ὀστέῳ ἐγκεφάλοιο.	-u u- --u u -uu -uu--	dactylic hexameter	feminine penthemimeral, trithemimeral
τὸν μὲν ἐγὼν ὀδύνῃσι παραφρονέοντα βαρείαις	- u u- uu-u u-uu-u u--	dactylic hexameter	feminine penthemimeral, trithemimeral
νωσάμενος, πρὶν αὖτις ὑπότροπον ἀμπνυνθῆναι,	-uu- - -u u-uu ----	dactylic hexameter	feminine penthemimeral, trithemimeral
αὐχένος ἀρρήκτοιο παρ᾽ ἰνίον ἤλασα προφθάς,	-uu ---u u -uu -uu --	dactylic hexameter	feminine penthemimeral
ῥίψας τόξον ἔραζε πολύρραπτόν τε φαρέτρην·	-- -u u-u u--- u u--	dactylic hexameter	feminine penthemimeral
ἦγχον δ᾽ἐγκρατέως στιβαρὰς σὺν χεῖρας ἐρείσας	-- -uu- uu- - -u u--	dactylic hexameter	masculine penthemimeral, hepthemimeral
ἐξόπιθεν, μὴ σάρκας ὑποδρύψῃ ὀνύχεσσι,	-uu- - -u u--- uu--	dactylic hexameter	feminine penthemimeral, trithemimeral
πρὸς δ᾽οὖδας πτέρνῃσι πόδας στερεῶς ἐπίεζον	- -- --u u- uu- uu--	dactylic hexameter	feminine penthemimeral, hepthemimeral, trithemimeral
οὐραίους ἐπιβάς, μηροῖσί τε πλεύρ᾽ ἐφύλασσον,	--- uu- --u u - uu--	dactylic hexameter	masculine penthemimeral, trithemimeral
μέχρί οἱ ἐξετάνυσσα βραχίονας ὀρθὸν ἀείρας	-u u -uu-u u-uu -u u--	dactylic hexameter	feminine penthemimeral
ἄπνευστον, ψυχὴν δὲ πελώριος ἔλλαχεν Ἅιδης.	--- -- u u-uu -uu --	dactylic hexameter	masculine penthemimeral, trithemimeral
καὶ τότε δὴ βούλευον, ὅπως λασιαύχενα βύρσαν	- uu - --u u- uu-uu --	dactylic hexameter	feminine penthemimeral, hepthemimeral, trithemimeral
θηρὸς τεθνειῶτος ἀπὸ μελέων ἐρυσαίμην,	-- ---u u- uu- uu--	dactylic hexameter	feminine penthemimeral, hepthemimeral
ἀργαλέον μάλα μόχθον, ἐπεὶ οὐκ ἔσκε σιδήρῳ	-uu- uu -u u- - -u u--	dactylic hexameter	feminine penthemimeral, hepthemimeral, trithemimeral
τμητὴ οὐδὲ λίθοις πειρωμένῳ, οὐδὲ μὲν ἄλλῃ	-- -u u- --uu -u u --	dactylic hexameter	masculine penthemimeral
ἔνθά μοι ἀθανάτων τις ἐπὶ φρεσὶ θῆκε νοῆσαι	-u u -uu- u u- uu -u u--	dactylic hexameter	masculine penthemimeral, hepthemimeral
αὐτοῖς δέρμα λέοντος ἀνασχίζειν ὀνύχεσσι.	-- -u u-u u--- uu--	dactylic hexameter	feminine penthemimeral
τοῖσι θοῶς ἀπέδειρα, καὶ ἀμφεθέμην μελέεσσιν	-u u- uu-u u -uu- uu--	dactylic hexameter	feminine penthemimeral, trithemimeral
ἕρκος ἐνυαλίου ταμεσίχροος ἰωχμοῖο.	-u u-uu- uu-uu ----	dactylic hexameter	masculine penthemimeral
οὗτός τοι Νεμέου γένετ᾽ ὦ φίλε θηρὸς ὄλεθρος,	-- - uu- uu - uu -u u--	dactylic hexameter	masculine penthemimeral, hepthemimeral, trithemimeral
πολλὰ πάρος μήλοις τε καὶ ἀνδράσι κήδεα θέντος."	-u u- -- u u -uu -uu --	dactylic hexameter	masculine penthemimeral, trithemimeral
Ἰνὼ καὐτονόα χἁ μαλοπάραυος Ἀγαύα	-- -uu- - -uu-u u--	dactylic hexameter	masculine penthemimeral
τρεῖς θιάσως ἐς ὄρος τρεῖς ἄγαγον αὐταὶ ἐοῖσαι.	- uu- u u- - -uu -u u--	dactylic hexameter	masculine penthemimeral, trithemimeral
χαἱ μὲν ἀμερξάμεναι λασίας δρυὸς ἄγρια φύλλα	- u u-uu- uu- uu -uu --	dactylic hexameter	masculine penthemimeral, hepthemimeral
κισσόν τε ζώοντα καὶ ἀσφόδελον τὸν ὑπὲρ γᾶς	-- - --u u -uu- u u- -	dactylic hexameter	feminine penthemimeral, trithemimeral
ἐν καθαρῷ λειμῶνι κάμον δυοκαίδεκα βωμούς,	- uu- --u u- uu-uu --	dactylic hexameter	feminine penthemimeral, hepthemimeral, trithemimeral
τὼς τρεῖς τᾷ Σεμέλᾳ, τὼς ἐννέα τῷ Διονύσῳ.	- - - uu- - -uu - uu--	dactylic hexameter	masculine penthemimeral, trithemimeral
ἱερὰ δ᾽ἐκ κίστας ποπανεύματα χερσὶν ἑλοῖσαι	-uu - -- uu-uu -u u--	dactylic hexameter	masculine penthemimeral, trithemimeral
εὐφάμως κατέθεντο νεοδρέπτων ἐπὶ βωμῶν,	--- uu-u u--- uu --	dactylic hexameter	feminine penthemimeral, trithemimeral
ὡς ἐδίδασχ᾽, ὡς αὐτὸς ἐθυμάρει Διόνυσος.	- uu- - -u u--- uu--	dactylic hexameter	feminine penthemimeral, trithemimeral
Πενθεὺς δ᾽ἀλιβάτου πέτρας ἄπο πάντ᾽ ἐθεώρει,	-- -uu- -- uu - uu--	dactylic hexameter	masculine penthemimeral, hepthemimeral
σχῖνον ἐς ἀρχαίαν καταδύς, ἐπιχώριον ἔρνος.	-u u --- uu- uu-uu --	dactylic hexameter	masculine penthemimeral, hepthemimeral
Αὐτονόα πράτα νιν ἀνέκραγε δεινὸν ἰδοῖσα,	-uu- uu - --uu -u u--	dactylic hexameter	masculine penthemimeral, trithemimeral
σὺν δ᾽ἐτάραξε ποσὶν μανιώδεος ὄργια Βάκχου,	- uu-u u- uu-uu -uu --	dactylic hexameter	masculine penthemimeral
ἐξαπίνας ἐπιοῖσα, τὰ δ᾽οὐχ ὁρέοντι βέβηλοι.	-uu- uu-u u - uu-u u--	dactylic hexameter	feminine penthemimeral, hepthemimeral, trithemimeral
μαίνετο μέν θ᾽αὕτα, μαίνοντο δ᾽ἄρ᾽ εὐθὺ καὶ ἄλλαι.	-uu - -- --u u -u u --	dactylic hexameter	masculine penthemimeral, trithemimeral
Πενθεὺς μὲν φεῦγεν πεφοβημένος, αἱ δ᾽ἐδίωκον,	-- - -- uu-uu - uu--	dactylic hexameter	masculine penthemimeral, trithemimeral
πέπλως ἐκ ζωστῆρος ἐπ᾽ ἰγνύαν ἐρύσαισαι.	-- - --u u -uu ----	dactylic hexameter	feminine penthemimeral, trithemimeral
Πενθεὺς μὲν τόδ᾽ ἔειπε· "τίνος κέχρησθε γυναῖκες;"	-- - u u-u u- --u u--	dactylic hexameter	feminine penthemimeral, hepthemimeral, trithemimeral
Αὐτονόα τόδ᾽ ἔειπε "τάχα γνώσῃ πρὶν ἀκοῦσαι."	-uu- u u-u u- -- u u--	dactylic hexameter	feminine penthemimeral, hepthemimeral, trithemimeral
μάτηρ μὲν κεφαλὰν μυκήσατο παιδὸς ἑλοῖσα,	-- - uu- --uu -u u--	dactylic hexameter	masculine penthemimeral, trithemimeral
ὅσσόν περ τοκάδος τελέθει μύκημα λεαίνας·	-- - uu- uu- --u u--	dactylic hexameter	masculine penthemimeral, hepthemimeral, trithemimeral
Ἰνὼ δ᾽ἐξέρρηξε σὺν ὠμοπλάτᾳ μέγαν ὦμον	-- ---u u -uu- uu --	dactylic hexameter	feminine penthemimeral
λὰξ ἐπὶ γαστέρα βᾶσα, καὶ Αὐτονόας ῥυθμὸς ωὑτός·	- uu -uu -u u -uu- uu --	dactylic hexameter	feminine penthemimeral
αἱ δ᾽ἄλλαι τὰ περισσὰ κρεανομέοντο γυναῖκες.	- -- u u-u u-uu-u u--	dactylic hexameter	feminine penthemimeral, trithemimeral
ἐς Θήβας δ᾽ἀφίκοντο πεφυρμέναι αἵματι πᾶσαι,	- -- uu-u u-uu -uu --	dactylic hexameter	feminine penthemimeral, trithemimeral
ἐξ ὄρεος πένθημα καὶ οὐ Πενθῆα φέροισαι.	- uu- --u u - --u u--	dactylic hexameter	feminine penthemimeral, hepthemimeral, trithemimeral
οὐκ ἀλέγω· μηδ᾽ ἄλλος ἀπεχθομένω Διονύσῳ	- uu- - -u u-uu- uu--	dactylic hexameter	feminine penthemimeral, trithemimeral
φροντίζοι, μηδ᾽ εἰ χαλεπώτερα τῶνδ᾽ ἐμόγησεν,	--- - - uu-uu - uu--	dactylic hexameter	masculine penthemimeral, trithemimeral
εἴη δ᾽ἐνναέτης ἢ καὶ δεκάτω ἐπιβαίνοι·	-- -uu- - - uu- uu--	dactylic hexameter	masculine penthemimeral, hepthemimeral
αὐτὸς δ᾽εὐαγέοιμι καὶ εὐαγέεσσιν ἅδοιμι.	-- -uu-u u -uu-u u--	dactylic hexameter	feminine penthemimeral
ἐκ Διὸς αἰγιόχω τιμὰν ἔχει αἰετὸς οὗτος.	- uu -uu- uu -- -uu --	dactylic hexameter	masculine penthemimeral
εὐσεβέων παίδεσσι τὰ λώια, δυσσεβέων δ᾽οὔ.	-uu- --u u -uu -uu- -	dactylic hexameter	feminine penthemimeral, trithemimeral
χαίροι μὲν Διόνυσος, ὃν ἐν Δρακάνῳ νιφόεντι	-- - uu-u u - uu- uu--	dactylic hexameter	feminine penthemimeral, hepthemimeral, trithemimeral
Ζεὺς ὕπατος μεγάλαν ἐπιγουνίδα κάτθετο λύσας·	- uu- uu- uu-uu -uu --	dactylic hexameter	masculine penthemimeral, trithemimeral
χαίροι δ᾽εὐειδὴς Σεμέλα καὶ ἀδελφεαὶ αὐτᾶς	-- --- uu- u u-uu --	dactylic hexameter	masculine penthemimeral, hepthemimeral
Καδμεῖαι πολλαῖς μεμελημέναι ἡρωίναις,	--- -- uu-uu ----	dactylic hexameter	masculine penthemimeral, trithemimeral
αἳ τόδε ἔργον ἔρεξαν ὀρίναντος Διονύσου	- uu -u u-u u--- uu--	dactylic hexameter	feminine penthemimeral
οὐκ ἐπιμωματόν. μηδεὶς τὰ θεῶν ὀνόσαιτο.	- uu--- -- u u- uu--	dactylic hexameter	masculine penthemimeral, hepthemimeral
τὰν πινυτὰν Ἑλέναν Πάρις ἥρπασε βουκόλος ἄλλος.	- uu- uu- uu -uu -uu --	dactylic hexameter	masculine penthemimeral, trithemimeral
μᾶλλον ἑκοῖσ᾽ Ἑλένα τὸν βουκόλον ἔσχε φιλεῦσα.	-u u- uu- - -uu -u u--	dactylic hexameter	masculine penthemimeral, trithemimeral
μὴ καυχῶ σατυρίσκε· κενὸν τὸ φίλαμα λέγουσιν.	- -- uu-u u- u u-u u--	dactylic hexameter	feminine penthemimeral, hepthemimeral, trithemimeral
ἔστι καὶ ἐν κενεοῖσι φιλάμασιν ἁδέα τέρψις.	-u u - uu-u u-uu -uu --	dactylic hexameter	feminine penthemimeral, trithemimeral
τὸ στόμα μευ πλύνω καὶ ἀποπτύω τὸ φίλαμα.	- uu - -- u u--- u u--	dactylic hexameter	masculine penthemimeral, trithemimeral
πλύνεις χείλεα σεῖο; δίδου πάλιν ὄφρα φιλάσω.	-- -uu -u u- uu -u u--	dactylic hexameter	feminine penthemimeral, hepthemimeral
καλόν σοι δαμάλας φιλέειν, οὐκ ἄζυγα κώραν.	-- - uu- uu- - -uu --	dactylic hexameter	masculine penthemimeral, hepthemimeral, trithemimeral
μὴ καυχῶ· τάχα γάρ σε παρέρχεται ὡς ὄναρ ἥβη.	- -- uu - u u-uu - uu --	dactylic hexameter	masculine penthemimeral, trithemimeral
ἢν δέ τι γηράσκω, τόδε που μέλι καὶ γάλα πίνω.>	- u u --- uu - uu - uu --	dactylic hexameter	masculine penthemimeral, hepthemimeral
ἁ σταφυλὶς σταφίς ἐστι καὶ οὐ ῥόδον αὖον ὀλεῖται.	- uu- uu -u u - uu -u u--	dactylic hexameter	feminine penthemimeral, hepthemimeral, trithemimeral
δεῦρ᾽ ὑπὸ τὰς κοτίνους, ἵνα σοί τινα μῦθον ἐνίψω.	- uu - uu- uu - uu -u u--	dactylic hexameter	masculine penthemimeral, hepthemimeral, trithemimeral
οὐκ ἐθέλω· καὶ πρίν με παρήπαφες ἁδέι μύθῳ.	- uu- - - u u-uu -uu --	dactylic hexameter	masculine penthemimeral, trithemimeral
δεῦρ᾽ ὑπὸ τὰς πτελέας, ἵν᾽ ἐμᾶς σύριγγος ἀκούσῃς.	- uu - uu- u u- --u u--	dactylic hexameter	masculine penthemimeral, hepthemimeral, trithemimeral
τὴν σαυτοῦ φρένα τέρψον· ὀιζύον οὐδὲν ἀρέσκει.	- -- uu -u u-uu -u u--	dactylic hexameter	feminine penthemimeral, trithemimeral
φεῦ φεῦ τᾶς Παφίας χόλον ἅζεο καὶ σύγε κώρα.	- - - uu- uu -uu - uu --	dactylic hexameter	masculine penthemimeral, trithemimeral
χαιρέτω ἁ Παφία· μόνον ἵλαος Ἄρτεμις εἴη.	-uu - uu- uu -uu -uu --	dactylic hexameter	masculine penthemimeral, trithemimeral
μὴ λέγε, μὴ βάλλῃ σε καὶ ἐς λίνον ἄκριτον ἔνθῃς.	- uu - -- u u - uu -uu --	dactylic hexameter	masculine penthemimeral, hepthemimeral, trithemimeral
βαλλέτω ὡς ἐθέλει· πάλιν Ἄρτεμις ἄμμιν ἀρήγει.	-uu - uu- uu -uu -u u--	dactylic hexameter	masculine penthemimeral, trithemimeral
μἠπιβάλῃς τὰν χεῖρα, καὶ εἰσέτι χεῖλος ἀμύξω.	-uu- - -u u -uu -u u--	dactylic hexameter	feminine penthemimeral, trithemimeral
οὐ φεύγεις τὸν Ἔρωτα, τὸν οὐ φύγε παρθένος ἄλλη.>	- -- u u-u u - uu -uu --	dactylic hexameter	feminine penthemimeral, hepthemimeral, trithemimeral
φεύγω ναὶ τὸν Πᾶνα· σὺ δὲ ζυγὸν αἰὲν ἀείρεις.	-- - - -u u - uu -u u--	dactylic hexameter	feminine penthemimeral, hepthemimeral, trithemimeral
δειμαίνω, μὴ δή σε κακωτέρῳ ἀνέρι δώσει.	--- - - u u-uu -uu --	dactylic hexameter	masculine penthemimeral, trithemimeral
πολλοί μ᾽ἐμνώοντο, νόμον δ᾽ἐμὸν οὔτις ἀείδει.	-- ---u u- uu -u u--	dactylic hexameter	feminine penthemimeral, hepthemimeral
εἶς καὶ ἐγὼ πολλῶν μνηστὴρ τεὸς ἐνθάδ᾽ ἱκάνω.	- u u- -- -- uu -u u--	dactylic hexameter	masculine penthemimeral, hepthemimeral, trithemimeral
καὶ τί φίλος ῥέξαιμι; γάμοι πλήθουσιν ἀνίας.	- u u- --u u- --u u--	dactylic hexameter	feminine penthemimeral, hepthemimeral, trithemimeral
οὐκ ὀδύνην, οὐκ ἄλγος ἔχει γάμος, ἀλλὰ χορείην.	- uu- - -u u- uu -u u--	dactylic hexameter	feminine penthemimeral, hepthemimeral, trithemimeral
ναὶ μάν φασι γυναῖκας ἑοὺς τρομέειν παρακοίτας.	- - -u u-u u- uu- uu--	dactylic hexameter	feminine penthemimeral, hepthemimeral
μᾶλλον ἀεὶ κρατέουσι· τίνα τρομέουσι γυναῖκες;	-u u- uu-u u- uu-u u--	dactylic hexameter	feminine penthemimeral, hepthemimeral, trithemimeral
ὠδίνειν τρομέω· χαλεπὸν βέλος Εἰλειθυίης.	--- uu- uu- uu ----	dactylic hexameter	masculine penthemimeral, hepthemimeral, trithemimeral
ἀλλὰ τεὴ βασίλεια μογοστόκος Ἄρτεμίς ἐστιν.	-u u- uu-u u-uu -uu --	dactylic hexameter	feminine penthemimeral, trithemimeral
ἀλλὰ τεκεῖν τρομέω, μὴ καὶ χρόα καλὸν ὀλέσσω.	-u u- uu- - - uu -u u--	dactylic hexameter	masculine penthemimeral, hepthemimeral, trithemimeral
ἢν δὲ τέκῃς φίλα τέκνα, νέον φάος ὄψεαι υἷας.	- u u- uu -u u- uu -uu --	dactylic hexameter	feminine penthemimeral, hepthemimeral, trithemimeral
καὶ τί μοι ἕδνον ἄγεις γάμου ἄξιον, ἢν ἐπινεύσω;	- u u -u u- uu -uu - uu--	dactylic hexameter	masculine penthemimeral
πᾶσαν τὰν ἀγέλαν, πάντ᾽ ἄλσεα καὶ νομὸν ἕξεις.	-- - uu- - -uu - uu --	dactylic hexameter	masculine penthemimeral, trithemimeral
ὄμνυε μὴ μετὰ λέκτρα λιπὼν ἀέκουσαν ἀπενθεῖν.	-uu - uu -u u- uu-u u--	dactylic hexameter	feminine penthemimeral, hepthemimeral, trithemimeral
οὐκ αὐτὸν τὸν Πᾶνα, καὶ ἢν ἐθέλῃς με διῶξαι.	- -- - -u u - uu- u u--	dactylic hexameter	feminine penthemimeral, hepthemimeral, trithemimeral
τεύχεις μοι θαλάμους, τεύχεις καὶ δῶμα καὶ αὐλάς;	-- - uu- -- - -u u --	dactylic hexameter	masculine penthemimeral, hepthemimeral, trithemimeral
τεύχω σοι θαλάμους· τὰ δὲ πώεα καλὰ νομεύω.	-- - uu- u u -uu -u u--	dactylic hexameter	masculine penthemimeral, trithemimeral
πατρὶ δὲ γηραλέῳ τίνα μάν, τίνα μῦθον ἐνίψω;	-u u -uu- uu - uu -u u--	dactylic hexameter	masculine penthemimeral, hepthemimeral
αἰνήσει σέο λέκτρον, ἐπὴν ἐμὸν οὔνομ᾽ ἀκούσῃ.	--- uu -u u- uu -u u--	dactylic hexameter	feminine penthemimeral, hepthemimeral, trithemimeral
οὔνομα σὸν λέγε τῆνο· καὶ οὔνομα πολλάκι τέρπει.	-uu - uu -u u -uu -uu --	dactylic hexameter	feminine penthemimeral, trithemimeral
Δάφνις ἐγώ, Λυκίδας τε πατήρ, μήτηρ δὲ Νομαία.	-u u- uu- u u- -- u u--	dactylic hexameter	masculine penthemimeral, hepthemimeral, trithemimeral
ἐξ εὐηγενέων· ἀλλ᾽ οὐ σέθεν εἰμὶ χερείων.	- --uu- - - uu -u u--	dactylic hexameter	masculine penthemimeral, hepthemimeral
οἶδ᾽, ἄκρα τιμίη ἐσσί· πατὴρ δέ τοί ἐστι Μενάλκας.	- uu -uu -u u- u u -u u--	dactylic hexameter	feminine penthemimeral, hepthemimeral
