τέρμα πολυκμήτοιο μεταχρόνιον πολέμοιο	-u u---u u-uu- uu--	dactylic hexameter	feminine penthemimeral
καὶ λόχον, Ἀργείης ἱππήλατον ἔργον Ἀθήνης,	- uu --- --uu -u u--	dactylic hexameter	masculine penthemimeral
αὐτίκα μοι σπεύδοντι πολὺν διὰ μῦθον ἀνεῖσα	-uu - --u u- uu -u u--	dactylic hexameter	feminine penthemimeral, hepthemimeral, trithemimeral
ἔννεπε, Καλλιόπεια, καὶ ἀρχαίην ἔριν ἀνδρῶν	-uu -uu-u u --- uu --	dactylic hexameter	feminine penthemimeral
κεκριμένου πολέμοιο ταχείῃ λῦσον ἀοιδῇ.	-uu- uu-u u-- -u u--	dactylic hexameter	feminine penthemimeral, trithemimeral
ἤδη μὲν δεκάτοιο κυλινδομένου λυκάβαντος	-- - uu-u u-uu- uu--	dactylic hexameter	feminine penthemimeral, trithemimeral
γηραλέη τετάνυστο φόνων ἀκόρητος Ἐνυὼ	-uu- uu-u u- uu-u u--	dactylic hexameter	feminine penthemimeral, hepthemimeral, trithemimeral
Τρωσί τε καὶ Δαναοῖσιν· ἐναιρομένων δ᾽ἄρα φωτῶν	-u u - uu-u u-uu- uu --	dactylic hexameter	feminine penthemimeral, trithemimeral
δούρατα κεκμήκει, ξιφέων δ᾽ἔθνῃσκον ἀπειλαί,	-uu --- uu- --u u--	dactylic hexameter	masculine penthemimeral, hepthemimeral
σβέννυτο θωρήκων ἐνοπή, μινύθεσκε δ᾽ἑλικτὴ	-uu --- uu- uu-u u--	dactylic hexameter	masculine penthemimeral, hepthemimeral
ἁρμονίη ῥηχθεῖσα φερεσσακέων τελαμώνων,	-uu- -- --uu- uu--	dactylic hexameter	masculine penthemimeral, trithemimeral
ἀσπίδες οὐκ ἀνέχοντο μένειν ἔτι δοῦπον ἀκόντων,	-uu - uu-u u- uu -u u--	dactylic hexameter	feminine penthemimeral, hepthemimeral, trithemimeral
λύετο καμπύλα τόξα, κατέρρεον ὠκέες ἰοί.	-uu -uu -u u-uu -uu --	dactylic hexameter	feminine penthemimeral
ἵπποι δ᾽οἱ μὲν ἄνευθεν ἀεργηλῆς ἐπὶ φάτνης	-- - u u-u u--- uu --	dactylic hexameter	feminine penthemimeral, trithemimeral
οἰκτρὰ κάτω μύοντες ὁμόζυγας ἔστενον ἵππους,	-u u- --u u-uu -uu --	dactylic hexameter	feminine penthemimeral, trithemimeral
οἱ δ᾽αὐτοὺς ποθέοντες ὀλωλότας ἡνιοχῆας.	- -- uu-u u-uu -uu--	dactylic hexameter	feminine penthemimeral, trithemimeral
κεῖτο δὲ Πηλείδης μὲν ἔχων ἅμα νεκρὸν ἑταῖρον,	-u u --- u u- uu -u u--	dactylic hexameter	masculine penthemimeral, hepthemimeral
Ἀντιλόχῳ δ᾽ἐπὶ παιδὶ γέρων ὠδύρετο Νέστωρ,	-uu- uu -u u- --uu --	dactylic hexameter	feminine penthemimeral, hepthemimeral, trithemimeral
Αἴας δ᾽αὐτοφόνῳ βριαρὸν δέμας ἕλκεϊ λύσας	-- -uu- uu- uu -uu --	dactylic hexameter	masculine penthemimeral, hepthemimeral
φάσγανον ἐχθρὸν ἔλουσε μεμηνότος αἵματος ὄμβρῳ.	-uu - --u u-uu -uu --	dactylic hexameter	feminine penthemimeral, trithemimeral
Τρωσὶ δὲ λωβητῆρσιν ἐφ᾽ Ἕκτορος ἑλκυθμοῖσι	-u u ---u u -uu ----	dactylic hexameter	feminine penthemimeral
μυρομένοις οὐ μοῦνον ἔην ἐπιδήμιον ἄλγος,	-uu- - -u u- uu-uu --	dactylic hexameter	feminine penthemimeral, hepthemimeral, trithemimeral
ἀλλὰ καὶ ἀλλοθρόοις ἐπὶ πένθεσι κωκύοντες	-u u -uu- uu -uu ----	dactylic hexameter	masculine penthemimeral
δάκρυσιν ἠμείβοντο πολυγλώσσων ἐπικούρων.	-uu ---u u--- uu--	dactylic hexameter	feminine penthemimeral
κλαῖον μὲν Λύκιοι Σαρπηδόνα, τόν ποτε μήτηρ	-- - uu- --uu - uu --	dactylic hexameter	masculine penthemimeral, trithemimeral
ἐς Τροίην μὲν ἔπεμψεν ἀγαλλομένη Διὸς εὐνῇ,	- -- u u-u u-uu- uu --	dactylic hexameter	feminine penthemimeral, trithemimeral
δουρὶ δὲ Πατρόκλοιο Μενοιτιάδαο πεσόντα	-u u ---u u-uu-u u--	dactylic hexameter	feminine penthemimeral
αἵματι δακρύσας ἐχύθη πατρώιος ἀήρ.	-uu -uu --- --uu --	dactylic hexameter	hepthemimeral
καὶ δολίην ὑπὸ νύκτα κακῷ πεπεδημένον ὕπνῳ	- uu- uu -u u- uu-uu --	dactylic hexameter	feminine penthemimeral, hepthemimeral, trithemimeral
Ῥῆσον μὲν Θρήικες ἐκώκυον· ἡ δ᾽ἐπὶ πότμῳ	-- - --u u-uu - uu --	dactylic hexameter	feminine penthemimeral, trithemimeral
Μέμνονος οὐρανίην νεφέλην ἀνεδήσατο μήτηρ	-uu -uu- uu- uu-uu --	dactylic hexameter	masculine penthemimeral, hepthemimeral
φέγγος ὑποκλέψασα κατηφέος ἤματος Ἠώς.	-u u---u u-uu -uu --	dactylic hexameter	feminine penthemimeral
αἱ δ᾽ἀπὸ Θερμώδοντος ἀρηιφίλοιο γυναῖκες	- uu ---u u-uu-u u--	dactylic hexameter	feminine penthemimeral
κοπτόμεναι περίκυκλον ἀθηλέος ὄμφακα μαζοῦ	-uu- uu-u u-uu -uu --	dactylic hexameter	feminine penthemimeral, trithemimeral
παρθένον ὠδύροντο δαΐφρονα Πενθεσίλειαν,	-uu ---u u-uu -uu--	dactylic hexameter	feminine penthemimeral
ἥτε πολυξείνοιο χορὸν πολέμοιο μολοῦσα	-u u---u u- uu-u u--	dactylic hexameter	feminine penthemimeral, hepthemimeral
θηλείης ὑπὸ χειρὸς ἀπεσκέδασεν νέφος ἀνδρῶν	--- uu -u u-uu- uu --	dactylic hexameter	feminine penthemimeral, trithemimeral
νῆας ἐς ἀγχιάλους· μελίῃ δέ ἑ μοῦνος ὑποστὰς	-u u -uu- uu- u u -u u--	dactylic hexameter	masculine penthemimeral, hepthemimeral
καὶ κτάνε καὶ σύλησε καὶ ἐκτερέιξεν Ἀχιλλεύς.	- uu - --u u -uu-u u--	dactylic hexameter	feminine penthemimeral, trithemimeral
εἱστήκει δ᾽ἔτι πᾶσα θεοδμήτων ὑπὸ πύργων	--- uu -u u-- -- --	dactylic hexameter	feminine penthemimeral, trithemimeral
Ἴλιος ἀκλινέεσσιν ἐπεμβεβαυῖα θεμέθλοις,	-uu -uu-u u-uu-u u--	dactylic hexameter	feminine penthemimeral
ἀμβολίῃ δ᾽ἤσχαλλε δυσαχθέι λαὸς Ἀχαιῶν.	-uu- --u u-u u- ---	dactylic hexameter	feminine penthemimeral, trithemimeral
καί νύ κεν ὑστατίοισιν ἐποκνήσασα πόνοισιν	- u u -uu-u u---u u--	dactylic hexameter	feminine penthemimeral
ἀκάματός περ ἐοῦσα μάτην ἵδρωσεν Ἀθήνη,	-uu- u u-u u- --u u--	dactylic hexameter	feminine penthemimeral, hepthemimeral, trithemimeral
εἰ μὴ Δηιφόβοιο γαμοκλόπον ὕβριν ἐάσας	- - -uu-u u-uu -u u--	dactylic hexameter	feminine penthemimeral
Ἰλιόθεν Δαναοῖσιν ἐπὶ ξένος ἤλυθε μάντις,	-uu- uu-u u- uu -uu --	dactylic hexameter	feminine penthemimeral, hepthemimeral, trithemimeral
οἷα δέ που μογέοντι χαριζόμενος Μενελάῳ	-u u - uu-u u-uu- uu--	dactylic hexameter	feminine penthemimeral, trithemimeral
ὀψιτέλεστον ὄλεθρον ἑῇ μαντεύσατο πάτρῃ.	-uu-u u-u u- --uu --	dactylic hexameter	feminine penthemimeral, hepthemimeral
οἱ δὲ βαρυζήλοιο θεοπροπίῃς Ἑλένοιο	- u u---u u-uu- uu--	dactylic hexameter	feminine penthemimeral
αὐτίκα μηκεδανοῖο μόθου τέλος ἠρτύναντο.	-uu -uu-u u- uu ----	dactylic hexameter	feminine penthemimeral, hepthemimeral
καὶ Σκῦρον μὲν ἔβαινε λιπὼν εὐπάρθενον ἄστυ	- -- u u-u u- --uu --	dactylic hexameter	feminine penthemimeral, hepthemimeral, trithemimeral
υἱὸς Ἀχιλλῆος καὶ ἐπαινῆς Δηιδαμείης·	-u u--- u u-- -uu--	dactylic hexameter	masculine penthemimeral
μήπω δ᾽εὐφυέεσσιν ἰουλίζων κροτάφοισιν	-- -uu-u u--- uu--	dactylic hexameter	feminine penthemimeral
ἀλκὴν πατρὸς ἔφαινε νέος περ ἐὼν πολεμιστής.	-- -u u-u u- u u- uu--	dactylic hexameter	feminine penthemimeral, hepthemimeral
ἦλθε δὲ καὶ Δαναοῖσιν ἑὸν βρέτας ἁγνὸν ἄγουσα	-u u - uu-u u- uu -u u--	dactylic hexameter	feminine penthemimeral, hepthemimeral, trithemimeral
ληιστὴ μὲν ἐοῦσα, φίλοις δ᾽ἐπίκουρος Ἀθήνη.	--- u u-u u- uu-u u--	dactylic hexameter	feminine penthemimeral, hepthemimeral, trithemimeral
ἤδη καὶ βουλῇσι θεῆς ὑποεργὸς Ἐπειὸς	-- - --u u- uu-u u--	dactylic hexameter	feminine penthemimeral, hepthemimeral, trithemimeral
Τροίης ἐχθρὸν ἄγαλμα πελώριον ἵππον ἐποίει.	-- - --u u-uu -u u--	dactylic hexameter	feminine penthemimeral, trithemimeral
καὶ δὴ τέμνετο δοῦρα καὶ ἐς πεδίον κατέβαινεν	- - -uu -u u - uu- uu--	dactylic hexameter	feminine penthemimeral, hepthemimeral
Ἴδης ἐξ αὐτῆς, ὁπόθεν καὶ πρόσθε Φέρεκλος	-- - -- uu- - -u u--	dactylic hexameter	masculine penthemimeral, hepthemimeral, trithemimeral
νῆας Ἀλεξάνδρῳ τεκτήνατο, πήματος ἀρχήν.	-u u--- --uu -uu --	dactylic hexameter	masculine penthemimeral
ποίει δ᾽εὐρυτάτῃς μὲν ἐπὶ πλευρῇς ἀραρυῖαν	-- -uu- u u- -- uu--	dactylic hexameter	masculine penthemimeral, hepthemimeral
γαστέρα κοιλήνας, ὁπόσον νεὸς ἀμφιελίσσης	-uu --- uu- uu -uu--	dactylic hexameter	masculine penthemimeral, hepthemimeral
ὀρθὸν ἐπὶ στάθμην μέγεθος τορνώσατο τέκτων.	-u u- -- uu- --uu --	dactylic hexameter	masculine penthemimeral, hepthemimeral, trithemimeral
αὐχένα δὲ γλαφυροῖσιν ἐπὶ στήθεσσιν ἔπηξε	-uu - uu-u u- --u u--	dactylic hexameter	feminine penthemimeral, hepthemimeral, trithemimeral
ξανθῷ πορφυρόπεζαν ἐπιρρήνας τρίχα χρυσῷ·	-- -uu-u u--- uu --	dactylic hexameter	feminine penthemimeral
ἡ δ᾽ἐπικυμαίνουσα μετήορος αὐχένι κυρτῷ	- uu---u u-uu -uu --	dactylic hexameter	feminine penthemimeral
ἐκ κορυφῆς λοφόεντι κατεσφρηγίζετο δεσμῷ.	- uu- uu-u u---uu --	dactylic hexameter	feminine penthemimeral, trithemimeral
ὀφθαλμοὺς δ᾽ἐνέθηκε λιθώπεας ἐν δυσὶ κύκλοις	--- uu-u u-uu - uu --	dactylic hexameter	feminine penthemimeral, trithemimeral
γλαυκῆς βηρύλλοιο καὶ αἱμαλέης ἀμεθύσσου·	-- ---u u -uu- uu--	dactylic hexameter	feminine penthemimeral
τῶν δ᾽ἐπιμισγομένων διδύμης ἀμαρύγματι χροιῆς	- uu-uu- uu- uu-uu --	dactylic hexameter	masculine penthemimeral, hepthemimeral
γλαυκῶν φοινίσσοντο λίθων ἑλίκεσσιν ὀπωπαί.	-- ---u u- uu-u u--	dactylic hexameter	feminine penthemimeral, hepthemimeral
ἀργυφέους δ᾽ἐχάραξεν ἐπὶ γναθμοῖσιν ὀδόντας	-uu- uu-u u- --u u--	dactylic hexameter	feminine penthemimeral, hepthemimeral, trithemimeral
ἄκρα δακεῖν σπεύδοντας ἐυστρέπτοιο χαλινοῦ·	-u u- --u u---u u--	dactylic hexameter	feminine penthemimeral, trithemimeral
καὶ στόματος μεγάλοιο λαθὼν ἀνέῳξε κελεύθους	- uu- uu-u u- uu-u u--	dactylic hexameter	feminine penthemimeral, hepthemimeral, trithemimeral
ἀνδράσι κευθομένοισι παλίρροον ἆσθμα φυλάσσων,	-uu -uu-u u-uu -u u--	dactylic hexameter	feminine penthemimeral
καὶ διὰ μυκτήρων φυσίζοος ἔρρεεν ἀήρ.	- uu --- --uu -uu --	dactylic hexameter	masculine penthemimeral
οὔατα δ᾽ἀκροτάτοισιν ἐπὶ κροτάφοισιν ἄρηρεν	-uu -uu-u u- uu-u u--	dactylic hexameter	feminine penthemimeral, hepthemimeral
ὀρθὰ μάλ᾽, αἰὲν ἑτοῖμα μένειν σάλπιγγος ἀκουήν.	-u u -u u-u u- --u u--	dactylic hexameter	feminine penthemimeral, hepthemimeral
νῶτα δ᾽ὁμοῦ λαγόνεσσι συνήρμοσε καὶ ῥάχιν ὑγρήν,	-u u- uu-u u-uu - uu --	dactylic hexameter	feminine penthemimeral, trithemimeral
ἰσχία δὲ γλουτοῖσιν ὀλισθηροῖσι συνῆψε.	-uu - --u u---u u--	dactylic hexameter	feminine penthemimeral, trithemimeral
σύρετο δὲ πρυμνοῖσιν ἐπ᾽ ἴχνεσιν ἔκλυτος οὐρὴ	-uu - --u u -u u-- --	dactylic hexameter	feminine penthemimeral, trithemimeral
ἄμπελος ὣς γναμπτοῖσι καθελκομένη θυσάνοισιν.	-uu - --u u-uu- uu--	dactylic hexameter	feminine penthemimeral, trithemimeral
οἱ δὲ πόδες βαλίοισιν ἐπερχόμενοι γονάτεσσιν	- u u- uu-u u-uu- uu--	dactylic hexameter	feminine penthemimeral, trithemimeral
εὔπτερον ὥσπερ ἔμελλον ἐπὶ δρόμον ὁπλίζεσθαι,	-uu -u u-u u- uu ----	dactylic hexameter	feminine penthemimeral, hepthemimeral
οὕτως ἠπείγοντο· μένειν δ᾽ἐκέλευεν ἀνάγκη.	-- ---u u- uu-u u--	dactylic hexameter	feminine penthemimeral, hepthemimeral
οὐ μὲν ὑπὸ κνήμῃσιν ἀχαλκέες ἔξεχον ὁπλαί,	- u u- --u u-uu -uu --	dactylic hexameter	feminine penthemimeral, trithemimeral
μαρμαρέης δ᾽ἑλίκεσσι κατεσφήκωντο χελώνης	-uu- uu-u u---u u--	dactylic hexameter	feminine penthemimeral, trithemimeral
ἁπτόμεναι πεδίοιο μόγις κρατερώνυχι χαλκῷ.	-uu- uu-u u- uu-uu --	dactylic hexameter	feminine penthemimeral, hepthemimeral, trithemimeral
κληιστὴν δ᾽ἐνέθηκε θύρην καὶ κλίμακα τυκτήν,	--- uu-u u- - -uu --	dactylic hexameter	feminine penthemimeral, hepthemimeral, trithemimeral
ἡ μὲν ὅπως ἀίδηλος ἐπὶ πλευρῇς ἀραρυῖα	- u u- uu-u u- -- uu--	dactylic hexameter	feminine penthemimeral, hepthemimeral, trithemimeral
ἔνθα καὶ ἔνθα φέρῃσι λόχον κλυτόπωλον Ἀχαιῶν,	-u u -u u-u u- uu-u u--	dactylic hexameter	feminine penthemimeral, hepthemimeral
ἡ δ᾽ἵνα λυομένη τε καὶ ἔμπεδον εἰς ἓν ἰοῦσα	- uu -uu- u u -uu - u u--	dactylic hexameter	masculine penthemimeral
εἴη σφιν καθύπερθεν ὁδὸς καὶ νέρθεν ὀροῦσαι.	-- - uu-u u- - -u u--	dactylic hexameter	feminine penthemimeral, hepthemimeral, trithemimeral
ἀμφὶ δέ μιν λευκοῖο κατ᾽ αὐχένος ἠδὲ γενείων	-u u - --u u -uu -u u--	dactylic hexameter	feminine penthemimeral, trithemimeral
ἄνθεσι πορφυρέοισι πέριξ ἔζωσεν ἱμάντων	-uu -uu-u u- --u u--	dactylic hexameter	feminine penthemimeral, hepthemimeral
καὶ σκολιῇς ἑλίκεσσιν ἀναγκαίοιο χαλινοῦ	- uu- uu-u u---u u--	dactylic hexameter	feminine penthemimeral, trithemimeral
κολλήσας ἐλέφαντι καὶ ἀργυροδίνεϊ χαλκῷ.	--- uu-u u -uu-uu --	dactylic hexameter	feminine penthemimeral, trithemimeral
αὐτὰρ ἐπειδὴ πάντα κάμεν μενεδήιον ἵππον,	-u u-- -u u- uu-uu --	dactylic hexameter	feminine penthemimeral, hepthemimeral
κύκλον ἐυκνήμιδα ποδῶν ὑπέθηκεν ἑκάστῳ	-u u---u u- uu-u u--	dactylic hexameter	feminine penthemimeral, hepthemimeral
ἑλκόμενος πεδίοισιν ὅπως πειθήνιος εἴη	-uu- uu-u u- --uu --	dactylic hexameter	feminine penthemimeral, hepthemimeral, trithemimeral
μηδὲ βιαζομένοισι δυσέμβατον οἶμον ὁδεύῃ.	-u u-uu-u u-uu -u u--	dactylic hexameter	feminine penthemimeral
ὣς ὁ μὲν ἐξήστραπτε φόβῳ καὶ κάλλεϊ πολλῷ	- u u ---u u- - -uu --	dactylic hexameter	feminine penthemimeral, hepthemimeral
εὐρύς θ᾽ὑψηλός τε· τὸν οὐδέ κεν ἀρνήσαιτο,	-- --- u u -u u ----	dactylic hexameter	masculine penthemimeral
εἴ μιν ζωὸν ἔτετμεν, ἐλαυνέμεν ἵππιος Ἄρης.	- - -u u-u u-uu -uu --	dactylic hexameter	feminine penthemimeral
ἀμφὶ δέ μιν μέγα τεῖχος ἐλήλατο, μή τις Ἀχαιῶν	-u u - uu -u u-uu - u u--	dactylic hexameter	feminine penthemimeral, trithemimeral
πρίν μιν ἐσαθρήσειε, δόλον δ᾽ἀνάπυστον ἀνάψῃ.	- u u---u u- uu-u u--	dactylic hexameter	feminine penthemimeral, hepthemimeral
οἱ δὲ Μυκηναίης Ἀγαμέμνονος ἐγγύθι νηὸς	- u u--- uu-uu -uu --	dactylic hexameter	masculine penthemimeral
λαῶν ὀρνυμένων ὅμαδον καὶ κῦμα φυγόντες	-- -uu- uu- - -u u--	dactylic hexameter	masculine penthemimeral, hepthemimeral
ἐς βουλὴν βασιλῆες ἀολλίσθησαν Ἀχαιῶν.	- -- uu-u u---u u--	dactylic hexameter	feminine penthemimeral, trithemimeral
ἡ δὲ τανυφθόγγοιο δέμας κήρυκος ἑλοῦσα	- u u---u u- --u u--	dactylic hexameter	feminine penthemimeral, hepthemimeral
συμφράδμων Ὀδυσῆι παρίστατο θοῦρις Ἀθήνη	-- ---u u-uu -u u--	dactylic hexameter	feminine penthemimeral
ἀνδρὸς ἐπιχρίουσα μελίχροϊ νέκταρι φωνήν.	-u u---u u-uu -uu --	dactylic hexameter	feminine penthemimeral
αὐτὰρ ὁ δαιμονίῃσι νόον βουλῇσιν ἑλίσσων	-u u -uu-u u- --u u--	dactylic hexameter	feminine penthemimeral, hepthemimeral
πρῶτα μὲν εἱστήκει κενεόφρονι φωτὶ ἐοικὼς	-u u --- uu-uu -u u--	dactylic hexameter	masculine penthemimeral
ὄμματος ἀτρέπτοιο βολὴν ἐπὶ γαῖαν ἐρείσας,	-uu ---u u- uu -u u--	dactylic hexameter	feminine penthemimeral, hepthemimeral
ἄφνω δ᾽ἀενάων ἐπέων ὠδῖνας ἀνοίξας	-- -uu- uu- --u u--	dactylic hexameter	masculine penthemimeral, hepthemimeral
δεινὸν ἀνεβρόντησε καὶ ἠερίης ἅτε πηγῆς	-u u---u u -uu- uu --	dactylic hexameter	feminine penthemimeral
ἐξέχεεν μέγα λαῖτμα μελισταγέος νιφετοῖο·	-uu- uu -u u-uu- uu--	dactylic hexameter	feminine penthemimeral, trithemimeral
ὦ φίλοι, ἤδη μὲν κρύφιος λόχος ἐκτετέλεσται	- uu -- - uu- uu -uu--	dactylic hexameter	masculine penthemimeral, hepthemimeral
χερσὶ μὲν ἀνδρομέῃσιν, ἀτὰρ βουλῇσιν Ἀθήνης.	-u u -uu-u u- --u u--	dactylic hexameter	feminine penthemimeral, hepthemimeral
ὑμεῖς δ᾽,οἵτε μάλιστα πεποίθατε κάρτεϊ χειρῶν,	-- -u u-u u-uu -uu --	dactylic hexameter	feminine penthemimeral
πρόφρονες ἀλκήεντι νόῳ καὶ τλήμονι θυμῷ	-uu ---u u- - -uu --	dactylic hexameter	feminine penthemimeral, hepthemimeral
σπέσθε μοι· οὐ γὰρ ἔοικε πολὺν χρόνον ἐνθάδ᾽ ἐόντας	-u u - u u-u u- uu -u u--	dactylic hexameter	feminine penthemimeral, hepthemimeral, trithemimeral
μοχθίζειν ἀτέλεστα καὶ ἀχρέα γηράσκοντας,	-- ---u u -uu ----	dactylic hexameter	feminine penthemimeral
ἀλλὰ χρὴ ζώοντας ἀοίδιμον ἔργον ἀνύσσαι	-- - --u u-uu -u u--	dactylic hexameter	feminine penthemimeral, trithemimeral
ἢ θανάτῳ βροτόεντι κακοκλεὲς αἶσχος ἀλύξαι.	- uu- uu-u u-uu -u u--	dactylic hexameter	feminine penthemimeral, trithemimeral
ἡμῖν θαλπωραὶ προφερέστεραι ἤπερ ἐκείνοις,	-- --- uu-uu -u u--	dactylic hexameter	masculine penthemimeral
εἰ μήπω στρουθοῖο καὶ ἀρχαίοιο δράκοντος	- -- --u u ---u u--	dactylic hexameter	feminine penthemimeral, trithemimeral
καὶ καλῆς πλατάνοιο καὶ ὠκυμόροις ἐπὶ τέκνοις	- -- uu-u u -uu- uu --	dactylic hexameter	feminine penthemimeral, trithemimeral
μητέρος ἑλκομένης ἁπαλῶν τ᾽ἐλάθεσθε νεοσσῶν.	-uu -uu- uu- uu-u u--	dactylic hexameter	masculine penthemimeral, hepthemimeral
εἰ δὲ θεοπροπίῃσι γέρων ἀνεβάλλετο Κάλχας,	- u u-uu-u u- uu-uu --	dactylic hexameter	feminine penthemimeral, hepthemimeral
ἀλλὰ καὶ ὣς Ἑλένοιο μετήλυδος ὀμφητῆρος	-u u - uu-u u-uu ----	dactylic hexameter	feminine penthemimeral, trithemimeral
μαντοσύναι καλέουσιν ἑτοιμοτάτην ἐπὶ νίκην.	-uu- uu-u u-uu- uu --	dactylic hexameter	feminine penthemimeral, trithemimeral
τούνεκά μοι πείθεσθε, καὶ ἱππείην ἐπὶ νηδὺν	-uu - --u u --- uu --	dactylic hexameter	feminine penthemimeral, trithemimeral
θαρσαλέοι σπεύδωμεν, ὅπως αὐτάγρετον ἄλγος	-uu- --u u- --uu --	dactylic hexameter	feminine penthemimeral, hepthemimeral, trithemimeral
Τρῶες ἀταρβήτοιο θεῆς ἀπατήνορα τέχνην	-u u---u u- uu-u- -	lyric	
Ἴλιον εἰσανάγωσιν ἑὸν κακὸν ἀμφαγαπῶντες.	-uu -uu-u u- uu -uu--	dactylic hexameter	feminine penthemimeral, hepthemimeral
οἱ δ᾽ἄλλοι πρυμναῖα μεθίετε πείσματα νηῶν	- -- --u u-uu -uu --	dactylic hexameter	feminine penthemimeral, trithemimeral
πῦρ ἴδιον πλεκτῇσιν ἐνὶ κλισίῃσι βαλόντες·	- uu- --u u- uu-u u--	dactylic hexameter	feminine penthemimeral, hepthemimeral, trithemimeral
Ἰλιάδος δὲ λιπόντες ἐρημαίην χθονὸς ἀκτὴν	-uu- u u-u u--- uu --	dactylic hexameter	feminine penthemimeral, trithemimeral
πλώετε πασσυδίῃ ψευδώνυμον οἴκαδε νόστον,	-uu -uu- --uu -uu --	dactylic hexameter	masculine penthemimeral
εἰσόκεν εὐόρμου τετανυσμένον ὲκ περιωπῆς	-uu --- uu-uu - uu--	dactylic hexameter	masculine penthemimeral
ὔμμι συναγρομένοις ἐπὶ γείτονος αἰγιαλοῖο	-u u-uu- uu -uu -uu--	dactylic hexameter	masculine penthemimeral
σημαίνῃ παλίνορσον ἐπὶ πλόον ἑσπέριον πῦρ.	--- uu-u u- uu -uu- -	dactylic hexameter	feminine penthemimeral, hepthemimeral, trithemimeral
καὶ τότε μήτε τις ὄκνος ἐπειγομένων ἐρετάων	- uu -u u -u u-uu- uu--	dactylic hexameter	feminine penthemimeral
γινέσθω μήτ᾽ ἄλλο φόβου νέφος, οἷά τε νύκτες	--- - -u u- uu -u u --	dactylic hexameter	feminine penthemimeral, hepthemimeral, trithemimeral
ἀνθρώποισι φέρουσιν ἐλαφροῦ δείματα θυμοῦ.	---u u-u u-- -uu --	dactylic hexameter	feminine penthemimeral
ἔστω δὲ προτέρης ἀρετῆς ἐμφύλιος αἰδώς,	-- - uu- uu- --uu --	dactylic hexameter	masculine penthemimeral, hepthemimeral, trithemimeral
μηδέ τις αἰσχύνειεν ἑὸν κλέος, ὥς κεν ἕκαστος	-u u ---u u- uu - u u--	dactylic hexameter	feminine penthemimeral, hepthemimeral
ἄξιον ὧν ἐμόγησε λάβῃ γέρας ἱπποσυνάων.	-uu - uu-u u- uu -uu--	dactylic hexameter	feminine penthemimeral, hepthemimeral, trithemimeral
ὣς φάμενος βουλῆς ἐξήρχετο· τοῖο δὲ μύθοις	- uu- -- --uu -u u --	dactylic hexameter	masculine penthemimeral, trithemimeral
πρῶτος ἐφωμάρτησε Νεοπτόλεμος θεοειδής,	-u u---u u-uu- uu--	dactylic hexameter	feminine penthemimeral
πῶλος ἅτε δροσόεντος ἐπειγόμενος πεδίοιο,	-u u- uu-u u-uu- uu--	dactylic hexameter	feminine penthemimeral, trithemimeral
ὅστε νεοζυγέεσσιν ἀγαλλόμενος φαλάροισιν	-u u-uu-u u-uu- uu--	dactylic hexameter	feminine penthemimeral
ἔφθασε καὶ μάστιγα καὶ ἡνιοχῆος ἀπειλήν.	-uu - --u u -uu-u u--	dactylic hexameter	feminine penthemimeral, trithemimeral
Τυδείδης δ᾽ἐπόρουσε Νεοπτολέμῳ Διομήδης	--- uu-u u-uu- uu--	dactylic hexameter	feminine penthemimeral, trithemimeral
θαυμάζων, ὅτι τοῖος ὄην καὶ πρόσθεν Ἀχιλλεύς.	--- uu -u u- - -u u--	dactylic hexameter	feminine penthemimeral, hepthemimeral, trithemimeral
ἕσπετο καὶ Κυάνιππος, ὃν εὐπατέρεια Κομαιθὼ	-uu - uu-u u -uu-u u--	dactylic hexameter	feminine penthemimeral, trithemimeral
Τυδηὶς θαλάμοιο μινυνθαδίοιο τυχοῦσα	--- uu-u u-uu-u u--	dactylic hexameter	feminine penthemimeral, trithemimeral
ὠκυμόρῳ τέκε παῖδα σακεσπάλῳ Αἰγιαλῆι.	-uu- uu -u u-uu -uu--	dactylic hexameter	feminine penthemimeral, trithemimeral
ἔστη καὶ Μενέλαος· ἄγεν δέ μιν ἄγριος ὁρμὴ	-- - uu-u u- u u -uu --	dactylic hexameter	feminine penthemimeral, hepthemimeral, trithemimeral
Δηιφόβου ποτὶ δῆριν, ἀπηνέι δ᾽ἔζεε θυμῷ	-uu- uu -u u-uu -uu --	dactylic hexameter	feminine penthemimeral, trithemimeral
δεύτερον ἁρπακτῆρα γάμου λελιημένος εὑρεῖν.	-uu ---u u- uu-uu --	dactylic hexameter	feminine penthemimeral, hepthemimeral
τῷ δ᾽ἐπὶ Λοκρὸς ὄρουσεν Ὀιλῆος ταχὺς Αἴας,	- uu -u u-- --- uu --	dactylic hexameter	
εἰσέτι θυμὸν ἔχων πεπνυμένον οὐδ᾽ ἐπὶ κούραις	-uu -u u- --uu - uu --	dactylic hexameter	masculine penthemimeral
μαργαίνων ἀθέμιστον· ἀνέστησεν δὲ καὶ ἄλλον,	--- uu-u u--- u u --	dactylic hexameter	feminine penthemimeral, trithemimeral
Κρητῶν Ἰδομενῆα μεσαιπόλιον βασιλῆα.	-- -uu-u u-uu- uu--	dactylic hexameter	feminine penthemimeral
Νεστορίδης δ᾽ἅμα τοῖσιν ἔβη κρατερὸς Θρασυμήδης,	-uu- uu -u u- uu- uu--	dactylic hexameter	feminine penthemimeral, hepthemimeral, trithemimeral
καὶ Τελαμώνιος υἱὸς ἑκηβόλος ἤιε Τεῦκρος	- uu-uu -u u-uu -uu --	dactylic hexameter	feminine penthemimeral
τοῖσι δ᾽ἐπ᾽ Ἀδμήτοιο πάις πολύιππος ἀνέστη	-u u --- -- --u u--	dactylic hexameter	masculine penthemimeral, hepthemimeral
Εὔμηλος· μετὰ τὸν δὲ θεοπρόπος ἔσσυτο Κάλχας	--- uu - u u-uu -uu --	dactylic hexameter	masculine penthemimeral, trithemimeral
εὖ εἰδώς, ὅτι μόχθον ἀμήχανον ἐκτελέσαντες	- -- uu - --uu -uu--	dactylic hexameter	masculine penthemimeral, trithemimeral
ἤδη Τρώιον ἄστυ καθιππεύσουσιν Ἀχαιοί.	-- -uu -u u---u u--	dactylic hexameter	feminine penthemimeral
οὐδὲ μὲν οὐδ᾽ οἳ ἔλειφθεν ἀποστρεφθέντες ἀρωγῆς	-u u - u u-u u---u u--	dactylic hexameter	feminine penthemimeral, trithemimeral
Εὐρύπυλός τ᾽Εὐαιμονίδης ἀγαθός τε Λεοντεύς,	-uu- --uu- uu- u u--	dactylic hexameter	hepthemimeral, trithemimeral
Δημοφόων τ᾽Ἀκάμας τε, δύω Θησήια τέκνα,	-uu- uu- u u- --uu --	dactylic hexameter	masculine penthemimeral, hepthemimeral, trithemimeral
Ὀρτυγίδης τ᾽Ἄντικλος, ὃν αὐτόθι τεθνειῶτα	-uu- --u u -uu ----	dactylic hexameter	feminine penthemimeral, trithemimeral
ἵππῳ δακρύσαντες ἐνεκτερέιξαν Ἀχαιοί,	-- ---u u-uu-u u--	dactylic hexameter	feminine penthemimeral
Πηνέλεώς τε Μέγης τε καὶ Ἀντιφάτης ἀγαπήνωρ	-uu- u u- u u -uu- uu--	dactylic hexameter	masculine penthemimeral, trithemimeral
Ἰφιδάμας τε καὶ Εὐρυδάμας, Πελίαο γενέθλη,	-uu- u u -uu- uu-u u--	dactylic hexameter	hepthemimeral, trithemimeral
τόξῳ δ᾽Ἀμφιδάμας κεκορυθμένος· ὕστατος αὖτε	-- -uu- uu-uu -uu --	dactylic hexameter	masculine penthemimeral
τέχνης ἀγλαόμητις ἑῆς ἐπέβαινεν Ἐπειός.	- uu--- -- uu-u u--	dactylic hexameter	masculine penthemimeral, hepthemimeral
εὐξάμενοι δὴ ἔπειτα Διὸς γλαυκώπιδι κούρῃ	-uu- u u-u u- --uu --	dactylic hexameter	feminine penthemimeral, hepthemimeral, trithemimeral
ἱππείην ἔσπευδον ἐς ὁλκάδα· τοῖσι δ᾽Ἀθήνη	--- --u u -uu -u u--	dactylic hexameter	feminine penthemimeral, trithemimeral
ἀμβροσίῃ κεράσασα θεῶν ἐκόμισσεν ἐδωδὴν	-uu- uu-u u- uu-u u--	dactylic hexameter	feminine penthemimeral, hepthemimeral, trithemimeral
δεῖπνον ἔχειν, ἵνα μή τι πανημέριοι λοχόωντες	-u u- uu - u u-uu- uu--	dactylic hexameter	masculine penthemimeral, trithemimeral
τειρόμενοι βαρύθοιεν ἀτερπέι γούνατα λιμῷ.	-uu- uu-u u-uu -uu --	dactylic hexameter	feminine penthemimeral, trithemimeral
ὣς δ᾽ὁπότε κρυμοῖσιν ἀελλοπόδων νεφελάων	- uu- --u u-uu- uu--	dactylic hexameter	feminine penthemimeral, trithemimeral
ἠέρα παχνώσασα χιὼν ἐπάλυνεν ἀρούρας,	-uu -uu -- -uu- ---	dactylic hexameter	
τηκομένη δ᾽ἀνέηκε πολὺν ῥόον· οἱ δ᾽ἀπὸ πέτρης	-uu- uu-u u- uu - uu --	dactylic hexameter	feminine penthemimeral, hepthemimeral, trithemimeral
ὀξὺ καταθρῴσκοντα κυβιστητῆρι κυδοιμῷ	-u u---u u---u u--	dactylic hexameter	feminine penthemimeral
δοῦπον ὑποπτήξαντες ὀριτρεφέος ποταμοῖο	-u u---u u-uu- uu--	dactylic hexameter	feminine penthemimeral
θῆρες ἐρωήσαντες ὑπὸ πτύχα κοιλάδος εὐνῆς	-u u---u u- uu -uu --	dactylic hexameter	feminine penthemimeral, hepthemimeral
σιγῇ φρικαλέῃσιν ἐπὶ πλευρῇσι μένουσι,	-- -uu-u u- --u u--	dactylic hexameter	feminine penthemimeral, hepthemimeral
πικρὰ δὲ πεινάοντες ὀιζυρῆς ὑπ᾽ ἀνάγκης	-u u ---u u--- u u--	dactylic hexameter	feminine penthemimeral
τλήμονες ἐκδέχαται, πότε παύεται ὄβριμον ὕδωρ·	-uu -uu- uu -uu -uu --	dactylic hexameter	masculine penthemimeral
ὣς οἵγε γλαφυροῖο διὰ ξυλόχοιο θορόντες	- -- uu-u u- uu-u u--	dactylic hexameter	feminine penthemimeral, hepthemimeral, trithemimeral
ἀτλήτους ἀνέχοντο πόνους ἀκμῆτες Ἀχαιοί.	-- ---u u- --u u--	dactylic hexameter	feminine penthemimeral, hepthemimeral
τοῖσι δ᾽ἐπεκλήισσε θύρην ἐγκύμονος ἵππου	-u u---u u- --uu --	dactylic hexameter	feminine penthemimeral, hepthemimeral
πιστὸς ἀτεκμάρτοιο δόλου πυλαωρὸς Ὀδυσσεύς.	-u u---u u- uu-u u--	dactylic hexameter	feminine penthemimeral, hepthemimeral
αὐτὸς δ᾽ἐν κεφαλῇ σκοπὸς ἕζετο· τὼ δέ οἱ ἄμφω	-- - uu- uu -uu - u u --	dactylic hexameter	masculine penthemimeral, trithemimeral
ὀφθαλμὼ ποθέοντες ἐλάνθανον ἐκτὸς ἐόντας.	--- uu-u u-uu -u u--	dactylic hexameter	feminine penthemimeral, trithemimeral
Ἀτρείδης δ᾽ἐκέλευσεν ὑποδρηστῆρας Ἀχαιοὺς	--- uu-u u---u u--	dactylic hexameter	feminine penthemimeral, trithemimeral
λῦσαι λάινον ἕρκος ἐυγνάμπτοισι μακέλλαις,	-- -uu -u u---u u--	dactylic hexameter	feminine penthemimeral
ἵππος ὅπερ κεκάλυπτο· θέλεν δέ ἑ γυμνὸν ἀᾶσαι,	-u u- uu-u u- u u -u u--	dactylic hexameter	feminine penthemimeral, hepthemimeral, trithemimeral
τηλεφανὴς ἴνα πᾶσιν ἑὴν χάριν ἀνδράσι πέμποι.	-uu- uu -u u- uu -uu --	dactylic hexameter	feminine penthemimeral, hepthemimeral, trithemimeral
καὶ τὸ μὲν ἐξελάχαινον ἐφημοσύνῃ βασιλῆος.	- u u -uu-u u-uu- uu--	dactylic hexameter	feminine penthemimeral
ἠέλιος δ᾽ὅτε νύκτα παλίνσκιον ἀνδράσιν ἕλκων	-uu- uu -u u-uu -uu --	dactylic hexameter	feminine penthemimeral, trithemimeral
ἐς δύσιν ἀχλυόπεζαν ἑκηβόλον ἔτραπεν ἠῶ,	- uu -uu-u u-uu -uu --	dactylic hexameter	feminine penthemimeral
δὴ τότε κηρύκων ἀπεκίδνατο λαὸν ἀυτὴ	- uu --- uu-u u- u--	lyric	
φεύγειν ἀγγελέουσα καὶ ἑλκέμεν εἰς ἅλα κοίλην	-- -uu-u u -uu - uu --	dactylic hexameter	feminine penthemimeral
νῆας ἐυκραίρους ἀνά τε πρυμνήσια λῦσαι.	-u u--- uu - --uu --	dactylic hexameter	masculine penthemimeral, hepthemimeral
ἔνθα δὲ πευκήεντος ἀνασχόμενοι πυρὸς ὁρμὴν	-u u ---u u-uu- uu --	dactylic hexameter	feminine penthemimeral
ἕρκεά τε πρήσαντες ἐυσταθέων κλισιάων	-uu - --u u-uu- uu--	dactylic hexameter	feminine penthemimeral, trithemimeral
νηυσὶν ἀνεπλώεσκον ἀπὸ Ῥοιτειάδος ἀκτῆς	-u u---u u- --uu --	dactylic hexameter	feminine penthemimeral, hepthemimeral
ὅρμον ἐς ἀντιπέραιον ἐυστεφάνου Τενέδοιο	-u u -uu-u u-uu- uu--	dactylic hexameter	feminine penthemimeral
γλαυκὸν ἀναπτύσσοντες ὕδωρ Ἀθαμαντίδος Ἕλλης.	-u u---u u- uu-uu --	dactylic hexameter	feminine penthemimeral, hepthemimeral
μοῦνος δὲ πληγῇσιν ἑκούσια γυῖα χαραχθεὶς	-- - --u u-uu -u --	lyric	
Αἰσιμίδης ἐλέλειπτο Σίνων, ἀπατήλιος ἥρως,	-uu- uu-u u- uu-uu --	dactylic hexameter	feminine penthemimeral, hepthemimeral, trithemimeral
κρυπτὸν ἐπὶ Τρώεσσι δόλον καὶ πήματα κεύθων.	-u u- --u u- - -uu --	dactylic hexameter	feminine penthemimeral, hepthemimeral, trithemimeral
ὡς δ᾽ὁπότε σταλίκεσσι λίνον περικυκλώσαντες	- uu- uu-u u- uu----	dactylic hexameter	feminine penthemimeral, hepthemimeral, trithemimeral
θηρσὶν ὀριπλανέεσσι λόχον πολυωπὸν ἔπηξαν	-u u-uu-u u- uu-u u--	dactylic hexameter	feminine penthemimeral, hepthemimeral
ἀνέρες ἀγρευτῆρες· ὁ δ᾽ἐκκριδὸν οἶος ἀπ᾽ ἄλλων,	-uu ---u u -uu -u u --	dactylic hexameter	feminine penthemimeral
λαθρίδιος πυκινοῖσιν ὑπὸ πτόρθοισι δεδυκώς,	-uu- uu-u u- --u u--	dactylic hexameter	feminine penthemimeral, hepthemimeral, trithemimeral
δίκτυα παπταίνων ἔλαθεν θηροσκόπος ἀνήρ·	-uu --- uu- --uu --	dactylic hexameter	masculine penthemimeral, hepthemimeral
ὣς τότε λωβητοῖσι περίστικτος μελέεσσι	- uu ---u u--- uu--	dactylic hexameter	feminine penthemimeral
Τροίῃ λυγρὸν ὄλεθρον ἐμήδετο. κὰδ δέ οἱ ὤμους	-- -u u-u u-uu - u u --	dactylic hexameter	feminine penthemimeral
ἕλκεσι ποιητοῖσι κατέρρεε νήχυτον αἷμα.	-uu ---u u-uu -uu --	dactylic hexameter	feminine penthemimeral
ἡ δὲ περὶ κλισίῃσιν ἐμαίνετο παννυχίη φλὸξ	- u u- uu-u u-uu -uu- -	dactylic hexameter	feminine penthemimeral, trithemimeral
καπνὸν ἐρευγομένη περιδινέα φοιτάδι ῥιπῇ·	-u u-uu- uu-uu -uu --	dactylic hexameter	masculine penthemimeral
Ἥφαιστος δ᾽ἐκέλευεν ἐρίβρομος· ἐκ δὲ θυέλλας	--- uu-u u-uu - u u--	dactylic hexameter	feminine penthemimeral, trithemimeral
παντοίας ἐτίνασσεν ἐπιπνείουσα καὶ αὐτή,	--- uu-u u---u u --	dactylic hexameter	feminine penthemimeral, trithemimeral
μήτηρ ἀθανάτοιο πυρός, φαεσίμβροτος Ἥρη.	-- -uu-u u- uu-uu --	dactylic hexameter	feminine penthemimeral, hepthemimeral
ἤδη δὲ Τρώεσσι καὶ Ἰλιάδεσσι γυναιξὶν	-- - --u u -uu-u u--	dactylic hexameter	feminine penthemimeral, trithemimeral
ὄρθρον ὑπὸ σκιόεντα πολύθροος ἤλυθε φήμη	-u u- uu-u u-uu -uu --	dactylic hexameter	feminine penthemimeral, trithemimeral
δήιον ἀγγέλλουσα φόβον σημάντορι καπνῷ.	-uu ---u u- --uu --	dactylic hexameter	feminine penthemimeral, hepthemimeral
αὐτίκα δ᾽ἐξέθορον πυλέων πετάσαντες ὀχῆας	-uu -uu- uu- uu-u u--	dactylic hexameter	masculine penthemimeral, hepthemimeral
πεζοί θ᾽ἱππῆές τε καὶ ἐς πεδίον προχέοντο	-- --- u u - uu- uu--	dactylic hexameter	masculine penthemimeral, hepthemimeral
διζόμενοι, μή τού τις ἔην δόλος ἄλλος Ἀχαιῶν.	-uu- - - u u- uu -u u--	dactylic hexameter	masculine penthemimeral, hepthemimeral, trithemimeral
οἱ δὲ θοοὺς οὐρῆας ὑποζεύξαντες ἀπήναις	- u u- --u u---u u--	dactylic hexameter	feminine penthemimeral, trithemimeral
ἐκ πόλιος κατέβαινον ἅμα Πριάμῳ βασιλῆι	- uu- uu-u u- uu- uu--	dactylic hexameter	feminine penthemimeral, hepthemimeral, trithemimeral
ἄλλοι δημογέροντες· ἐλαφρότατοι δ᾽ἐγένοντο	-- -uu-u u-uu- uu--	dactylic hexameter	feminine penthemimeral
θαλπόμενοι περὶ παισίν, ὅσους λίπε φοίνιος Ἄρης,	-uu- uu -u u- uu -uu --	dactylic hexameter	feminine penthemimeral, hepthemimeral, trithemimeral
ὀσσόμενοι καὶ γῆρας ἐλεύθερον· οὐ μὲν ἔμελλον	-uu- - -u u-uu - u u--	dactylic hexameter	feminine penthemimeral, trithemimeral
γηθήσειν ἐπὶ δηρόν, ἐπεὶ Διὸς ἤθελε βουλή.	--- uu -u u- uu -uu --	dactylic hexameter	feminine penthemimeral, hepthemimeral, trithemimeral
οἱ δ᾽ὅτε τεχνήεντος ἴδον δέμας αἰόλον ἵππου,	- uu --- -- uu -uu --	dactylic hexameter	masculine penthemimeral, hepthemimeral
θαύμασαν ἀμφιχυθέντες, ἅτ᾽ ἠχήεντες ἰδόντες	-uu -uu-u u ---u u--	dactylic hexameter	feminine penthemimeral
αἰετὸν ἀλκήεντα περικλάζουσι κολοιοί.	-uu ---u u---u u--	dactylic hexameter	feminine penthemimeral
τοῖσι δὲ τετρηχυῖα καὶ ἄκριτος ἔμπεσε βουλή·	-u u ---u u -uu -uu --	dactylic hexameter	feminine penthemimeral
οἱ μὲν γὰρ πολέμῳ βαρυπενθέι κεκμηῶτες,	- - - uu- uu-uu ----	dactylic hexameter	masculine penthemimeral, trithemimeral
ἵππον ἀπεχθήραντες, ἐπεὶ πέλεν ἔργον Ἀχαιῶν,	-u u--- -- uu -u u--	dactylic hexameter	masculine penthemimeral, hepthemimeral
ἤθελον ἢ δολιχοῖσιν ἐπὶ κρημνοῖσιν ἀράξαι	-uu - uu-u u- --u u--	dactylic hexameter	feminine penthemimeral, hepthemimeral, trithemimeral
ἠὲ καὶ ἀμφιτόμοισι διαρρῆξαι πελέκεσσιν·	-u u -uu-u u--- uu--	dactylic hexameter	feminine penthemimeral
οἱ δὲ νεοξέστοιο πεποιθότες ἔργμασι τέχνης	- u u---u u-uu -u- -	lyric	
ἀθανάτοις ἐκέλευον ἀρήιον ἵππον ἀνάψαι,	-uu- uu-u u-uu -u u--	dactylic hexameter	feminine penthemimeral, trithemimeral
ὕστερον Ἀργείοιο μόθου σημήιον εἶναι.	-uu ---u u- --uu --	dactylic hexameter	feminine penthemimeral, hepthemimeral
φραζομένοις δ᾽ἐπὶ τοῖσι παναίολα γυῖα κομίζων	-uu- uu -u u-uu -u u--	dactylic hexameter	feminine penthemimeral, trithemimeral
γυμνὸς ὑπὲρ πεδίοιο φάνη κεκακωμένος ἀνήρ·	-u u- uu-u u- uu-uu --	dactylic hexameter	feminine penthemimeral, hepthemimeral, trithemimeral
αἵματι δὲ σμώδιγγες ἀεικέϊ βεβριθυῖαι	-uu - --u u-uu ----	dactylic hexameter	feminine penthemimeral, trithemimeral
ἴχνια λωβήεντα θοῶν ἀνέφαινον ἱμάντων.	-- ---u u- uu-u u--	dactylic hexameter	feminine penthemimeral, hepthemimeral
αὐτίκα δὲ Πριάμοιο ποδῶν προπάροιθεν ἐλυσθεὶς	-uu - uu-u u- uu-u u--	dactylic hexameter	feminine penthemimeral, hepthemimeral, trithemimeral
ἱκεσίαις παλάμῃσι παλαιῶν ἥψατο γούνων,	-uu- uu-u u-- -uu --	dactylic hexameter	feminine penthemimeral, trithemimeral
λισσόμενος δὲ γέροντα δολοπλόκον ἴαχε μῦθον·	-uu- u u-u u-uu -uu --	dactylic hexameter	feminine penthemimeral, trithemimeral
ἄνδρα μὲν Ἀργείοισιν ὁμόπλοον εἴ μ᾽ἐλεαίρεις,	-u u ---u u-uu - uu--	dactylic hexameter	feminine penthemimeral
Τρώων δὲ ῥυστῆρα καὶ ἄστεος εἴ με σαώσεις,	-- - --u u -uu - u u--	dactylic hexameter	feminine penthemimeral, trithemimeral
Δαρδανίδη σκηπτοῦχε, καὶ ὕστατον ἐχθρὸν Ἀχαιῶν—	-uu- --u u -uu -u u--	dactylic hexameter	feminine penthemimeral, trithemimeral
οἷά με λωβήσαντο θεῶν ὄπιν οὐκ ἀλέγοντες	-u u ---u u- uu - uu--	dactylic hexameter	feminine penthemimeral, hepthemimeral
οὐδὲν ἀλιτραίνοντα, κακοὶ καὶ ἀπηνέες αἰεί·	-u u---u u- u u-uu --	dactylic hexameter	feminine penthemimeral, hepthemimeral
ὣς μέν Ἀχιλλῆος γέρας ἥρπασαν Αἰακίδαο,	- u u--- uu -uu -uu--	dactylic hexameter	masculine penthemimeral
ὣς δὲ Φιλοκτήτην ἔλιπον πεπεδημένον ὕδρῳ,	- u u--- uu- uu-uu --	dactylic hexameter	masculine penthemimeral, hepthemimeral
ἔκτειναν δὲ καὶ αὐτὸν ἀγασσάμενοι Παλαμήδην.	--- u u -u u-uu- uu--	dactylic hexameter	feminine penthemimeral, trithemimeral
καὶ νῦν οἷά μ᾽ἔρεξαν ἀτάσθαλοι, οὕνεκα φεύγειν	- - -u u-u u-uu -uu --	dactylic hexameter	feminine penthemimeral
οὐκ ἔθελον σὺν τοῖσι, μένειν δ᾽ἐκέλευον ἑταίρους·	- uu- - -u u- uu-u u--	dactylic hexameter	feminine penthemimeral, hepthemimeral, trithemimeral
οἱ δὲ νοοπλήγεσσιν ἀτασθαλίῃσι δαμέντες	- u u---u u-uu-u u--	dactylic hexameter	feminine penthemimeral
εἵματα μέν μ᾽ἀπέδυσαν, ἀεικελίῃσι δ᾽ἱμάσθλαις	-uu - uu-u u-uu-u u--	dactylic hexameter	feminine penthemimeral, trithemimeral
πᾶν δέμας οὐτήσαντες ἐπὶ ξείνῃ λίπον ἀκτῇ.	- uu ---u u- -- uu --	dactylic hexameter	feminine penthemimeral, hepthemimeral
ἀλλά, μάκαρ, πεφύλαξο Διὸς σέβας ἱκεσίοιο·	-u u- uu-u u- uu -uu--	dactylic hexameter	feminine penthemimeral, hepthemimeral, trithemimeral
χάρμα γὰρ Ἀργείοισι γενήσομαι, εἴ κεν ἐάσῃς	-u u ---u u-uu - u u--	dactylic hexameter	feminine penthemimeral
χερσὶν ὕπο Τρώων ἱκέτην καὶ ξεῖνον ὀλέσθαι.	-u u- -- uu- - -u u--	dactylic hexameter	masculine penthemimeral, hepthemimeral, trithemimeral
αὐτὰρ ἐγὼ πάντεσσιν ἐπάρκιος ἔσσομαι ὑμῖν	-u u- --u u-uu -uu --	dactylic hexameter	feminine penthemimeral, trithemimeral
μηκέτι δειμαίνειν πόλεμον παλίνορσον Ἀχαιῶν.	-uu --- uu- uu-u u--	dactylic hexameter	masculine penthemimeral, hepthemimeral
ὣς φάτο· τὸν δ᾽ὁ γέρων ἀγανῇ μειλίξατο φωνῇ·	- uu - u u- uu- --uu --	dactylic hexameter	masculine penthemimeral, hepthemimeral, trithemimeral
ξεῖνε, σὲ μὲν Τρώεσσι μεμιγμένον οὐκέτ᾽ ἔοικε	-u u - --u u-uu -u u--	dactylic hexameter	feminine penthemimeral, trithemimeral
τάρβος ἔχειν· ἔφυγες γὰρ ἀνάρσιον ὕβριν Ἀχαιῶν.	-u u- uu- u u-uu -u u--	dactylic hexameter	masculine penthemimeral, trithemimeral
αἰεὶ δ᾽ἡμέτερος φίλος ἔσσεαι, οὐδέ σε πάτρης	-- -uu- uu -uu -u u --	dactylic hexameter	masculine penthemimeral
οὐδὲ πολυκτεάνων θαλάμων γλυκὺς ἵμερος αἱρεῖ.	-u u-uu- uu- uu -uu --	dactylic hexameter	masculine penthemimeral, hepthemimeral
ἀλλ᾽ ἄγε καὶ σύ μοι εἰπέ, τί τοι τόδε θαῦμα τέτυκται,	- uu - u u -u u - uu -u u--	dactylic hexameter	feminine penthemimeral, hepthemimeral, trithemimeral
ἵππος, ἀμειλίκτοιο φόβου τέρας· εἰπὲ δὲ σεῖο	-u u---u u- uu -u u --	dactylic hexameter	feminine penthemimeral, hepthemimeral
οὔνομα καὶ γενεήν, ὁπόθεν δέ σε νῆες ἔνεικαν.	-uu - uu- uu- u u -u u--	dactylic hexameter	masculine penthemimeral, hepthemimeral, trithemimeral
τὸν δ᾽ἐπιθαρσήσας προσέφη πολυμήχανος ἥρως·	- uu--- uu- uu-uu --	dactylic hexameter	masculine penthemimeral, hepthemimeral
ἐξερέω καὶ ταῦτα· σὺ γάρ μ᾽ἐθέλοντα κελεύεις.	-uu- - -u u - uu-u u--	dactylic hexameter	feminine penthemimeral, hepthemimeral, trithemimeral
ἄργός μοι πόλις ἐστί, Σίνων δέ μοι οὔνομα κεῖται·	-- - uu -u u- u u -uu --	dactylic hexameter	feminine penthemimeral, hepthemimeral, trithemimeral
αἴσιμον αὖ καλέουσιν ἐμὸν πολιὸν γενετῆρα·	-uu - uu-u u- uu- uu--	dactylic hexameter	feminine penthemimeral, hepthemimeral, trithemimeral
ἵππον δ᾽Ἀργείοισι παλαίφατον εὗρεν Ἐπειός·	-- ---u u-uu -u u--	dactylic hexameter	feminine penthemimeral
εἰ μὲν γάρ μιν ἐᾶτε μένειν αὐτοῦ ἐνὶ χώρῃ,	- - - u u-u u- -- uu --	dactylic hexameter	feminine penthemimeral, hepthemimeral, trithemimeral
Τροίην θέσφατόν ἐστιν ἑλεῖν πόλιν ἔγχος Ἀχαιῶν·	-- -uu -u u- uu -u u--	dactylic hexameter	feminine penthemimeral, hepthemimeral
εἰ δέ μιν ἁγνὸν ἄγαλμα λάβῃ νηοῖσιν Ἀθήνη,	- u u -u u-u u- --u u--	dactylic hexameter	feminine penthemimeral, hepthemimeral
φεύξονται προφυγόντες ἀνηνύστοις ἐπ᾽ ἀέθλοις.	--- uu-u u--- u u--	dactylic hexameter	feminine penthemimeral, trithemimeral
ἀλλ᾽ ἄγε δὴ σειρῇσι περίπλοκον ἀμφιβαλόντες	- uu - --u u-uu -uu--	dactylic hexameter	feminine penthemimeral, trithemimeral
ἕλκετ᾽ ἐς ἀκρόπολιν μεγάλην χρυσήνιον ἵππον·	-u u -uu- uu- --uu --	dactylic hexameter	masculine penthemimeral, hepthemimeral
ἄμμι δ᾽Ἀθηναίη ἐρυσίπτολις ἡγεμονεύοι	-u u--- uu-uu -uu--	dactylic hexameter	masculine penthemimeral
δαιδάλεον σπεύδουσα λαβεῖν ἀνάθημα καὶ αὐτή.	-uu- --u u- uu-u u --	dactylic hexameter	feminine penthemimeral, hepthemimeral, trithemimeral
ὣς ἄρ᾽ ἔφη· καὶ τὸν μὲν ἄναξ ἐκέλευσε λαβόντα	- u u- - - u u- uu-u u--	dactylic hexameter	masculine penthemimeral, hepthemimeral, trithemimeral
ἕσσασθαι χλαῖνάν τε χιτῶνά τε, τοὶ δέ, βοείαις	--- -- u u-u u - u u--	dactylic hexameter	masculine penthemimeral, trithemimeral
δησάμενοι σειρῇσιν, ἐυπλέκτοισι κάλωσιν	-uu- --u u---u u--	dactylic hexameter	feminine penthemimeral, trithemimeral
εἷλκον ὑπὲρ πεδίοιο, θοῶν ἐπιβήτορα κύκλων,	-u u- uu-u u- uu-uu --	dactylic hexameter	feminine penthemimeral, hepthemimeral, trithemimeral
ἵππον ἀριστήεσσι βεβυσμένον· οἱ δὲ πάροιθεν	-u u---u u-uu - u u--	dactylic hexameter	feminine penthemimeral
αὐλοὶ καὶ φόρμιγγες ὁμὴν ἐλίγαινον ἀοιδήν.	-- - --u u- uu-u u--	dactylic hexameter	feminine penthemimeral, hepthemimeral, trithemimeral
σχέτλιον ἀφραδέων μερόπων γένος, οἷσιν ὁμίχλη	-u u--- uu- uu -u u--	dactylic hexameter	masculine penthemimeral, hepthemimeral
ἄσκοπος ἐσσομένων· κενεῷ δ᾽ὑπὸ χάρματι πολλοὶ	-uu -uu- uu- uu -uu --	dactylic hexameter	masculine penthemimeral, hepthemimeral
πολλάκις ἀγνώσσουσι περιπταίοντες ὀλέθρῳ.	-uu ---u u---u u--	dactylic hexameter	feminine penthemimeral
οἵη καὶ Τρώεσσι τότε φθισίμβροτος ἄτη	-- - --u u- --uu --	dactylic hexameter	feminine penthemimeral, hepthemimeral, trithemimeral
ἐς πόλιν αὐτοκέλευθος ἐκώμασεν· οὐδέ τις ἀνδρῶν	- uu -uu-u u-uu -u u --	dactylic hexameter	feminine penthemimeral
ᾔδεεν, οὕνεκα λάβρον ἐφέλκετο πένθος ἄλαστον.	-uu -uu -u u-uu -u u--	dactylic hexameter	feminine penthemimeral
ἄνθεα δὲ δροσόεντος ἀμησάμενοι ποταμοῖο	-uu - uu-u u-uu- uu--	dactylic hexameter	feminine penthemimeral, trithemimeral
ἔστεφον αὐχενίους πλοκάμους σφετέροιο φονῆος.	-uu -uu- uu- uu-u u--	dactylic hexameter	masculine penthemimeral, hepthemimeral
γαῖα δὲ χαλκείοισιν ἐρεικομένη περὶ κύκλοις	-u u ---u u-uu- uu --	dactylic hexameter	feminine penthemimeral
δεινὸν ὑπεβρυχᾶτο, σιδήρειοι δὲ δι᾽ αὐτῶν	-u u---u u--- u u --	dactylic hexameter	feminine penthemimeral
τριβόμενοι τρηχεῖαν ἀνέστενον ἄξονες ἠχήν·	-uu- --u u-uu -uu --	dactylic hexameter	feminine penthemimeral, trithemimeral
τετρίγει δὲ κάλων ξυνοχή, καὶ πᾶσα ταθεῖσα	--- u u- uu- - -u u--	dactylic hexameter	masculine penthemimeral, hepthemimeral, trithemimeral
λιγνὺν αἰθαλόεσσαν ἕλιξ ἀνεκήκιε σειρή.	-- -uu-u u- uu-uu --	dactylic hexameter	feminine penthemimeral, hepthemimeral
πολλὴ δ᾽ἑλκόντων ἐνοπὴ καὶ κόμπος ὀρώρει·	-- --- uu- - -u u--	dactylic hexameter	masculine penthemimeral, hepthemimeral
ἔβρεμε νυμφαίῃσιν ἅμα δρυσὶ δάσκιος Ἴδη,	-uu ---u u- uu -uu --	dactylic hexameter	feminine penthemimeral, hepthemimeral
ἴαχε καὶ Ξάνθου ποταμοῦ κυκλούμενον ὕδωρ,	-uu - -- uu- --uu --	dactylic hexameter	masculine penthemimeral, hepthemimeral, trithemimeral
καὶ στόμα κεκλήγει Σιμοείσιον· οὐρανίη δὲ	- uu --- uu-uu -uu- -	dactylic hexameter	masculine penthemimeral
ἐκ Διὸς ἑλκόμενον πόλεμον μαντεύετο σάλπιγξ.	- uu -uu- uu- --uu --	dactylic hexameter	masculine penthemimeral, hepthemimeral
οἱ δ᾽ἦγον προπάροιθεν· ὁδὸς δ᾽ἐβαρύνετο μακρὴ	- -- uu-u u- uu-uu --	dactylic hexameter	feminine penthemimeral, hepthemimeral, trithemimeral
σχιζομένη ποταμοῖσι καὶ οὐ πεδίοισιν ὁμοίη.	-uu- uu-u u - uu-u u--	dactylic hexameter	feminine penthemimeral, hepthemimeral, trithemimeral
εἵπετο δ᾽αἰόλος ἵππος ἀρηιφίλους ἐπὶ βωμοὺς	-uu -uu -u u-uu- uu --	dactylic hexameter	feminine penthemimeral
κυδιόων ὑπέροπλα, βίην δ᾽ἐπέρεισεν Ἀθήνη	-uu- uu-u u- uu-u u--	dactylic hexameter	feminine penthemimeral, hepthemimeral, trithemimeral
χεῖρας ἐπιβρίσασα νεογλυφέων ἐπὶ μηρῶν.	-u u-uu- uu--- uu --	dactylic hexameter	masculine penthemimeral
ὧδε θέων ἀκίχητος ἐπέδραμε θᾶσσον ὀιστοῦ	-u u- uu-u u-uu -u u--	dactylic hexameter	feminine penthemimeral, trithemimeral
Τρῶας ἐυσκάρθμοισιν ὁδοιπορίῃσι διώκων,	-u u---u u-uu-u u--	dactylic hexameter	feminine penthemimeral
εἰσόκε δὴ πυλέων ἐπεβήσατο Δαρδανιάων.	-uu - uu- uu-uu -uu--	dactylic hexameter	masculine penthemimeral, trithemimeral
αἱ δέ οἱ ἐρχομένῳ θυρέων πτύχες ἐστείνοντο·	- u u -uu- uu- uu ----	dactylic hexameter	masculine penthemimeral, hepthemimeral
ἀλλ᾽ Ἥρη μὲν ἔλυσεν ἐπὶ δρόμον αὖθις ὁδοῖο	- -- u u-u u- uu -u u--	dactylic hexameter	feminine penthemimeral, hepthemimeral, trithemimeral
πρόσθεν ἀναστέλλουσα, Ποσειδάων δ᾽ἀπὸ πύργων	-u u---u u--- uu --	dactylic hexameter	feminine penthemimeral
σταθμὸν ἀνοιγομένων πυλέων ἀνέκοπτε τριαίνῃ.	-u u-uu- uu- uu-u u--	dactylic hexameter	masculine penthemimeral, hepthemimeral
Τρωιάδες δὲ γυναῖκες ἀνὰ πτόλιν ἄλλοθεν ἄλλαι,	-uu- u u-u u- uu -uu --	dactylic hexameter	feminine penthemimeral, hepthemimeral, trithemimeral
νύμφαι τε πρόγαμοί τε καὶ ἴδμονες Εἰλειθυίης,	-- - uu- u u -- ----	dactylic hexameter	masculine penthemimeral, trithemimeral
μολπῇ τ᾽ὀρχηθμῷ τε περὶ βρέτας εἱλίσσοντο·	-- --- u u- uu ----	dactylic hexameter	masculine penthemimeral, hepthemimeral
ἄλλαι δὲ χνοόωσαν ἀμελγόεναι χάριν ὄμβρου	-- - uu-u u-uu- uu --	dactylic hexameter	feminine penthemimeral, trithemimeral
ὁλκῷ δουρατέῳ ῥοδέους στορέσαντο τάπητας.	-- -uu- uu- uu-u u--	dactylic hexameter	masculine penthemimeral, hepthemimeral
αἱ δὲ θαλασσαίης ἐπιμάζια νήματα μίτρης	- u u--- uu-uu -uu --	dactylic hexameter	masculine penthemimeral
λυσάμεναι κλωστοῖσι κατέπλεκον ἄνθεσιν ἵππον.	-uu- --u u-uu -uu --	dactylic hexameter	feminine penthemimeral, trithemimeral
καί τις ἀπειρεσίοιο πίθου κρήδεμνον ἀνεῖσα	- u u-uu-u u- --u u--	dactylic hexameter	feminine penthemimeral, hepthemimeral
χρυσείῳ προχέουσα κρόκῳ κεκερασμένον οἶνον	--- uu-u u- uu-uu --	dactylic hexameter	feminine penthemimeral, hepthemimeral, trithemimeral
γαῖαν ἀνεκνίσσωσε χυτὴν εὐώδεϊ πηλῷ.	-u u---u u- --uu --	dactylic hexameter	feminine penthemimeral, hepthemimeral
ἀνδρομέῃ δὲ βοῇ συνεβάλλετο θῆλυς ἰωή,	-uu- u u- uu-uu -u u--	dactylic hexameter	masculine penthemimeral, trithemimeral
καὶ παίδων ἀλαλητὸς ἐμίσγετο γήραος ἠχῇ.	- -- uu-u u-uu -uu --	dactylic hexameter	feminine penthemimeral, trithemimeral
οἷαι δ᾽ἀφνειοῖο μετήλυδες Ὠκεανοῖο,	-- ---u u-uu -uu--	dactylic hexameter	feminine penthemimeral
χείματος ἀμφίπολοι, γεράνων στίχες ἠεροφώνων,	-uu -uu- uu- uu -uu--	dactylic hexameter	masculine penthemimeral, hepthemimeral
κύκλον ἐπογμεύουσιν ἀλήμονος ὀρχηθμοῖο	-u u---u u-uu ----	dactylic hexameter	feminine penthemimeral
γειοπόνοις ἀρότῃσιν ἀπεχθέα κεκληγυῖαι·	-uu- uu-u u-u u---	lyric	
ὣς οἵγε κλαγγῇ τε δι᾽ ἄστεος ἠδὲ κυδοιμῷ	- -- -- u u -uu -u u--	dactylic hexameter	masculine penthemimeral, trithemimeral
ἦγον ἐς ἀκρόπολιν βεβαρημένον ἔνδοθεν ἵππον.	-u u -uu- uu-uu -uu --	dactylic hexameter	masculine penthemimeral
κούρη δὲ Πριάμοιο θεήλατος οὐκέτι μίμνειν	-- - uu-u u-uu -uu --	dactylic hexameter	feminine penthemimeral, trithemimeral
ἤθελεν ἐν θαλάμοισι· διαρρήξασα δ᾽ὀχῆας	-uu - uu-u u---u u--	dactylic hexameter	feminine penthemimeral, trithemimeral
ἔδραμεν ἠύτε πόρτις ἀήσυρος, ἥντε τυπεῖσαν	-uu -uu -u u-uu -u u--	dactylic hexameter	feminine penthemimeral
κέντρον ἀνεπτοίησε βοορραίσταο μύωπος·	-u u---u u---u u--	dactylic hexameter	feminine penthemimeral
ἡ δ᾽οὐκ εἰς ἀγέλην ποτιδέρκεται οὐδὲ βοτῆρι	- - - uu- uu-uu -u u--	dactylic hexameter	masculine penthemimeral, trithemimeral
πείθεται οὐδὲ νομοῖο λιλαίεται, ἀλλὰ βελέμνῳ	-uu -u u-u u-uu -u u--	dactylic hexameter	feminine penthemimeral
ὀξέι θηγομένη βοέων ἐξήλυθε θεσμῶν·	-uu -uu- uu- --uu --	dactylic hexameter	masculine penthemimeral, hepthemimeral
τοίη μαντιπόλοιο βολῆς ὑπὸ νύγματι κούρη	-- -uu-u u- uu -uu --	dactylic hexameter	feminine penthemimeral, hepthemimeral
πλαζομένη κραδίην ἱερὴν ἀνεσείετο δάφνην.	-uu- uu- uu- uu-uu --	dactylic hexameter	masculine penthemimeral, hepthemimeral, trithemimeral
πάντη δ᾽ἐβρυχᾶτο κατὰ πτόλιν· οὐδὲ τοκήων	-- ---u u- uu -u u--	dactylic hexameter	feminine penthemimeral, hepthemimeral
οὐδὲ φίλων ἀλέγιζε· λίπεν δέ ἑ παρθένος αἰδώς.	-u u- uu-u u- u u -uu --	dactylic hexameter	feminine penthemimeral, hepthemimeral, trithemimeral
οὐχ οὕτω Θρήισσαν ἐνὶ δρυμοῖσι γυναῖκα	- -- --u u- --u u--	dactylic hexameter	feminine penthemimeral, hepthemimeral, trithemimeral
νήδυμος αὐλὸς ἔτυψεν ὀρειμανέος Διονύσου,	-uu -u u-u u-uu- uu--	dactylic hexameter	feminine penthemimeral
ἥτε θεῷ πληγεῖσα παρήορον ὄμμα τιταίνει	-u u- --u u-uu -u u--	dactylic hexameter	feminine penthemimeral, trithemimeral
γυμνὸν ἐπισσείουσα κάρη κυανάμπυκι κισσῷ,	-u u---u u- uu-uu --	dactylic hexameter	feminine penthemimeral, hepthemimeral
ὡς ἥγε πτερόεντος ἀναΐξασα νόοιο	- -- uu-u u-uu- ---	dactylic hexameter	feminine penthemimeral, trithemimeral
Κασσάνδρη θεόφοιτος ἐμαίνετο· πυκνὰ δὲ χαίτην	--- uu-u u-uu -u u --	dactylic hexameter	feminine penthemimeral, trithemimeral
κοπτομένη καὶ στέρνον ἀνίαχε μαινάδι φωνῇ·	-uu- - -u u-uu -uu --	dactylic hexameter	feminine penthemimeral, trithemimeral
ὦ μέλεοι, τίνα τοῦτον ἀνάρσιον ἵππον ἄγοντες	- uu- uu -u u-uu -u u--	dactylic hexameter	feminine penthemimeral, trithemimeral
δαιμόνιοι μαίνεσθε καὶ ὑστατίην ἐπὶ νύκτα	-uu- --u u -uu- uu --	dactylic hexameter	feminine penthemimeral, trithemimeral
σπεύδετε καὶ πολέμοιο πέρας καὶ νήγρετον ὕπνον;	-uu - uu-u u- - -uu --	dactylic hexameter	feminine penthemimeral, hepthemimeral, trithemimeral
δυσμενέων ὅδε κῶμος ἀρήιος· αἱ δέ που ἤδη	-uu- uu -u u-uu - u u --	dactylic hexameter	feminine penthemimeral, trithemimeral
τίκτουσιν μογερῆς Ἑκάβης ὠδῖνες ὀνείρων,	--- uu- uu- --u u--	dactylic hexameter	masculine penthemimeral, hepthemimeral, trithemimeral
λήγει δ᾽ἀμβολιεργὸν ἔτος πολέμοιο λυθέντος.	-- -uu-u u- uu-u u--	dactylic hexameter	feminine penthemimeral, hepthemimeral
τοῖος ἀριστήων λόχος ἔρχεται, οὓς ἐπὶ χάρμην	-u u--- uu -uu - uu --	dactylic hexameter	masculine penthemimeral
τεύχεσιν ἀστράπτοντας ἀμαυροτάτην ὑπὸ νύκτα	-uu ---u u-uu- uu --	dactylic hexameter	feminine penthemimeral
τέξεται ὄβριμος ἵππος· ἐπὶ χθόνα δ᾽ἄρτι θορόντες	-uu -uu -u u- uu -u u--	dactylic hexameter	feminine penthemimeral, hepthemimeral
ἐς μόθον ὁρμήσουσι τελειότατοι πολεμισταί.	- uu ---u u-uu- uu--	dactylic hexameter	feminine penthemimeral
οὐ γὰρ ἐπ᾽ ὠδίνεσσι μογοστόκον ἵππον ἀνεῖσαι	- u u ---u u-uu -u u--	dactylic hexameter	feminine penthemimeral
ἀνδράσι τικτομένοισιν ἐπισχήσουσι γυναῖκες,	-uu -uu-u u---u u--	dactylic hexameter	feminine penthemimeral
αὐτὴ δ᾽Εἰλείθυια γενήσεται, ἥ μιν ἔτευξε·	-- ---u u-uu - u u--	dactylic hexameter	feminine penthemimeral
γαστέρα δὲ πλήθουσαν ἀνακλίνασα βοήσει	-uu - --u u-uu- ---	dactylic hexameter	feminine penthemimeral, trithemimeral
μαῖα πολυκλαύτοιο τόκου πτολίπορθος Ἀθήνη.	-u u---u u- uu-u u--	dactylic hexameter	feminine penthemimeral, hepthemimeral
καὶ δὴ πορφύρεον μὲν ἑλίσσεται ἔνδοθι πύργων	- - -uu- u u-uu -uu --	dactylic hexameter	masculine penthemimeral
αἵματος ἐκχυμένου πέλαγος καὶ κῦμα φόνοιο,	-uu -uu- uu- - -u u--	dactylic hexameter	masculine penthemimeral, hepthemimeral
δεσμά τε συμπαθέων πλέκεται περὶ χερσὶ γυναικῶν	-u u -uu- uu- uu -u u--	dactylic hexameter	masculine penthemimeral, hepthemimeral
νυμφία, φωλεύει δ᾽ὑπὸ δούρασι κευθόμενον πῦρ.	-uu --- uu -uu -uu- -	dactylic hexameter	masculine penthemimeral
ὤμοι ἐμῶν ἀχέων, ὤμοι σέο, πάτριον ἄστυ,	-u u- uu- -- uu -uu --	dactylic hexameter	masculine penthemimeral, hepthemimeral, trithemimeral
αὐτίκα λεπταλέη κόνις ἔσσεαι, οἴχεται ἔργον	-uu -uu- uu -uu -uu --	dactylic hexameter	masculine penthemimeral
ἀθανάτων, προθέλυμνα θεμείλια Λαομέδοντος.	-uu- uu-u u-uu -uu--	dactylic hexameter	feminine penthemimeral, trithemimeral
καὶ σέ, πάτερ, καὶ μῆτερ, ὀδύρομαι, οἷά μοι ἤδη	- u u- - -u u-uu -u u --	dactylic hexameter	feminine penthemimeral, trithemimeral
ἀμφότεροι πείσεσθε· σὺ μέν, πάτερ, οἰκτρὰ δεδουπὼς	-uu- --u u - uu -u u--	dactylic hexameter	feminine penthemimeral, hepthemimeral, trithemimeral
κείσεαι Ἑρκείοιο Διὸς μεγάλου παρὰ βωμῷ·	-uu ---u u- uu- uu --	dactylic hexameter	feminine penthemimeral, hepthemimeral
μῆτερ ἀριστοτόκεια, σὲ δὲ βροτέης ἀπὸ μορφῆς	-u u-uu-u u - uu- uu --	dactylic hexameter	feminine penthemimeral, hepthemimeral
λυσσαλέην ἐπὶ παισὶ θεοὶ κύνα ποιήσουσι.	-uu- uu -u u- uu ----	dactylic hexameter	feminine penthemimeral, hepthemimeral, trithemimeral
δῖα Πολυξείνη, σὲ δὲ πατρίδος ἐγγύθι γαίης	-u u--- u u -uu -uu --	dactylic hexameter	masculine penthemimeral
κεκλιμένην ὀλίγον δακρύσομαι· ὡς ὄφελέν τις	-uu- uu- uu-- - uu- -	dactylic hexameter	masculine penthemimeral, trithemimeral
Ἀργείων ἐπὶ σοῖσι γόοις ὀλέσαι με καὶ αὐτήν.	--- uu -u u- uu- u u --	dactylic hexameter	feminine penthemimeral, hepthemimeral, trithemimeral
τίς γάρ μοι χρειὼ βιότου πλέον, εἴ με φυλάσσει	- - - -- uu- uu - u u--	dactylic hexameter	masculine penthemimeral, hepthemimeral, trithemimeral
οἰκτροτάτῳ θανάτῳ, ξείνη δέ με γαῖα καλύψει;	-uu- uu- -- u u -u u--	dactylic hexameter	masculine penthemimeral, hepthemimeral, trithemimeral
τοιάδε μοι δέσποινα καὶ αὐτῷ δῶρον ἄνακτι	-uu - --u u -- -u u--	dactylic hexameter	feminine penthemimeral, trithemimeral
ἀντὶ τόσων καμάτων Ἀγαμέμνονι πότμον ὑφαίνει.	-u u- uu- uu-uu -u u--	dactylic hexameter	masculine penthemimeral, trithemimeral
ἀλλ᾽ ἤδη φράζεσθε—τὰ δὲ γνώσεσθε παθόντες—	- -- --uu - --u u--	dactylic hexameter	hepthemimeral, trithemimeral
καὶ νεφέλην ἀπόθεσθε, φίλοι, βλαψίφρονος ἄτης.	- uu- uu-u u- --uu --	dactylic hexameter	feminine penthemimeral, hepthemimeral, trithemimeral
ῥηγνύσθω πελέκεσσι δέμας πολυχανδέος ἵππου	--- uu-u u- uu-uu --	dactylic hexameter	feminine penthemimeral, hepthemimeral, trithemimeral
ἢ πυρὶ καιέσθω· δολόεντα δὲ σώματα κεῦθον	- uu --- uu-u u -uu --	dactylic hexameter	masculine penthemimeral
ὀλλύσθω, μεγάλη δὲ ποθὴ Δαναοῖσι γενέσθω.	--- uu- u u- uu-u u--	dactylic hexameter	masculine penthemimeral, hepthemimeral, trithemimeral
καὶ τότε μοι δαίνυσθε καὶ ἐς χορὸν ὀτρύνεσθε	- uu - --u u - uu ----	dactylic hexameter	feminine penthemimeral, hepthemimeral, trithemimeral
στησάμενοι κρητῆρας ἐλευθερίης ἐρατεινῆς.	-uu- --u u-uu- uu--	dactylic hexameter	feminine penthemimeral, trithemimeral
ἡ μὲν ἔφη· τῇ δ᾽οὔτις ἐπείθετο· τὴν γὰρ Ἀπόλλων	- u u- - -u u-uu - u u--	dactylic hexameter	feminine penthemimeral, trithemimeral
ἀμφότερον μάντιν τ᾽ἀγαθὴν καὶ ἄπιστον ἔθηκεν.	-uu- -- uu- u u-u u--	dactylic hexameter	masculine penthemimeral, hepthemimeral, trithemimeral
τὴν δὲ πατὴρ ἐνένιπεν ὁμοκλήσας ἐπέεσσι·	- u u- uu-u u--- uu--	dactylic hexameter	feminine penthemimeral, trithemimeral
τίς σε πάλιν, κακόμαντι, δυσώνυμος ἤγαγε δαίμων,	- u u- uu-u u-uu -uu --	dactylic hexameter	feminine penthemimeral, trithemimeral
θαρσαλέη κυνόμυια; μάτην ὑλάουσ᾽ ἀπερύκεις.	-uu- uu-u u- uu- uu--	dactylic hexameter	feminine penthemimeral, hepthemimeral, trithemimeral
οὔπω σοι κέκμηκε νόος λυσσώδεϊ νούσῳ,	-- - --u u- --uu --	dactylic hexameter	feminine penthemimeral, hepthemimeral, trithemimeral
οὐδὲ παλιμφήμων ἐκορέσσαο λαβροσυνάων;	-u u--- uu-uu -uu--	dactylic hexameter	masculine penthemimeral
ἀλλὰ καὶ ἡμετέρῃσιν ἐπαχνυμένη θαλίῃσιν	-u u -uu-u u--- uu--	dactylic hexameter	feminine penthemimeral
ἤλυθες, ὁππότε πᾶσιν ἐλεύθερον ἦμαρ ἀνῆψεν	-uu -uu -u u-uu -u u--	dactylic hexameter	feminine penthemimeral
ἡμῖν Ζεὺς Κρονίδης, ἐκέδασσε δὲ νῆας Ἀχαιῶν.	-- - uu- uu-u u -u u--	dactylic hexameter	masculine penthemimeral, trithemimeral
οὐδ᾽ ἔτι δούρατα μακρὰ τινάσσεται, οὐδ᾽ ἔτι τόξα	- uu -uu -u u-uu - uu --	dactylic hexameter	feminine penthemimeral
ἕλκεται, οὐ ξιφέων σελαγή, σιγῶσι δ᾽ὀιστοί,	-uu - uu- uu- --u u--	dactylic hexameter	masculine penthemimeral, hepthemimeral, trithemimeral
ἀλλὰ χοροὶ καὶ μοῦσα μελίπνοος, οὐδ᾽ ἔτι νείκη,	-u u- - -u u-uu - uu --	dactylic hexameter	feminine penthemimeral, trithemimeral
οὐ μήτηρ ἐπὶ παιδὶ κινύρεται, οὐδ᾽ ἐπὶ δῆριν	- -- uu -u u-uu - uu --	dactylic hexameter	feminine penthemimeral, trithemimeral
ἄνδρα γυνὴ πέμψασα νέκυν δακρύσατο χήρη·	-u u- --u u- uu-- --	dactylic hexameter	feminine penthemimeral, hepthemimeral, trithemimeral
ἵππον ἀνελκόμενον δέχεται πολιοῦχος Ἀθήνη.	-u u-uu- uu- uu-u u--	dactylic hexameter	masculine penthemimeral, hepthemimeral
παρθένε τολμήεσσα, σὺ δὲ πρὸ δόμοιο θοροῦσα	-uu ---u u - u u-u u--	dactylic hexameter	feminine penthemimeral, hepthemimeral
ψεύδεα θεσπίζουσα καὶ ἄγρια μαργαίνουσα	-uu ---u u -uu ----	dactylic hexameter	feminine penthemimeral
μοχθίζεις ἀτέλεστα καὶ ἱερὸν ἄστυ μιαίνεις.	-- ---u u -uu -u u--	dactylic hexameter	feminine penthemimeral
ἔρρ᾽ οὕτως· ἡμῖν δὲ χοροὶ θαλίαι τε μέλονται.	- -- -- u u- uu- u u--	dactylic hexameter	masculine penthemimeral, hepthemimeral, trithemimeral
οὐ γὰρ ἔτι Τροίης ὑπὸ τείχεσι δεῖμα λέλειπται,	- u u- -- uu -uu -u u--	dactylic hexameter	masculine penthemimeral, trithemimeral
οὐδ᾽ ἔτι μαντιπόλοιο τεῆς κεχρήμεθα φωνῆς.	- uu -uu-u u- --uu --	dactylic hexameter	feminine penthemimeral, hepthemimeral
ὣς εἰπὼν ἐκέλευσεν ἄγειν ἑτερόφρονα κούρην	- -- uu-u u- uu-uu --	dactylic hexameter	feminine penthemimeral, hepthemimeral, trithemimeral
κεύθων ἐν θαλάμοισι· μόγις δ᾽ἀέκουσα τοκῆι	-- - uu-u u- uu-u u--	dactylic hexameter	feminine penthemimeral, hepthemimeral, trithemimeral
πείθετο, παρθενίῳ δὲ περὶ κλιντῆρι πεσοῦσα	-uu -uu- u u- --u u--	dactylic hexameter	masculine penthemimeral, hepthemimeral
κλαῖεν ἐπισταμένη τὸν ἑὸν μόρον· ἔβλεπε δ᾽ἤδη	-u u-uu- u u- uu -uu --	dactylic hexameter	masculine penthemimeral, hepthemimeral
πατρίδος αἰθομένης ἐπὶ τείχεσι μαρνάμενον πῦρ.	-uu -uu- uu -uu -uu- -	dactylic hexameter	masculine penthemimeral
οἱ δὲ πολισσούχοιο θεῆς ὑπὸ νηὸν Ἀθήνης	- u u---u u- uu -u u--	dactylic hexameter	feminine penthemimeral, hepthemimeral
ἵππον ἀναστήσαντες ἐυξέστων ἐπὶ βάθρων	-u u---u u--- uu --	dactylic hexameter	feminine penthemimeral
ἔφλεγον ἱερὰ καλὰ πολυκνίσσων ἐπὶ βωμῶν·	-uu -uu -u u--- uu --	dactylic hexameter	feminine penthemimeral
ἀθάνατοι δ᾽ἀνένευον ἀνηνύστους ἑκατόμβας.	-uu- uu-u u--- uu--	dactylic hexameter	feminine penthemimeral, trithemimeral
εἰλαπίνη δ᾽ἐπίδημος ἔην καὶ ἀμήχανος ὕβρις,	-uu- uu-u u- u u-uu --	dactylic hexameter	feminine penthemimeral, hepthemimeral, trithemimeral
ὕβρις ἐλαφρίζουσα μέθην λυσήνορος οἴνου.	-u u---u u- --uu --	dactylic hexameter	feminine penthemimeral, hepthemimeral
ἀφραδίῃ τε βέβυστο, μεθημοσύνῃ τε κεχήνει	-uu- u u-u u-uu- u u--	dactylic hexameter	feminine penthemimeral, trithemimeral
πᾶσα πόλις, πυλέων δ᾽ὀλίγοις φυλάκεσσι μεμήλει·	-u u- uu- uu- uu-u u--	dactylic hexameter	masculine penthemimeral, hepthemimeral, trithemimeral
ἤδη γὰρ καὶ φέγγος ἐδύετο, δαιμονίη δὲ	-- - - -u u-uu -uu- -	dactylic hexameter	feminine penthemimeral, trithemimeral
Ἴλιον αἰπεινὴν ὀλεσίπτολις ἀμφέβαλεν νύξ.	-uu --- uu-uu -uu- -	dactylic hexameter	masculine penthemimeral
Ἀργείῃ δ᾽Ἑλένῃ πολιὸν δέμας ἀσκήσασα	--- uu- uu- uu ----	dactylic hexameter	masculine penthemimeral, hepthemimeral, trithemimeral
ἦλθε δολοφρονέουσα πολυφράδμων Ἀφροδίτη,	-u u-uu-u u-- -u--	lyric	
ἐκ δὲ καλεσσαμένη προσέφη πειθήμονι φωνῇ·	- u u-uu- uu- --uu --	dactylic hexameter	masculine penthemimeral, hepthemimeral
νύμφα φίλη, καλέει σε πόσις Μενέλαος ἀγήνωρ	-u u- uu- u u- uu-u u--	dactylic hexameter	masculine penthemimeral, hepthemimeral, trithemimeral
ἵππῳ δουρατέῳ κεκαλυμμένος, ἀμφὶ δ᾽Ἀχαιῶν	-- -uu- uu-uu -u u--	dactylic hexameter	masculine penthemimeral
ἡγεμόνες λοχόωσι τεῶν μνηστῆρες ἀέθλων.	-uu- uu-u u- --u u--	dactylic hexameter	feminine penthemimeral, hepthemimeral, trithemimeral
ἀλλ᾽ ἴθι, μηδ᾽ ἔτι τοι μελέτω Πριάμοιο γέροντος	- uu - uu - uu- uu-u u--	dactylic hexameter	masculine penthemimeral, hepthemimeral, trithemimeral
μήτ᾽ ἄλλων Τρώων μήτ᾽ αὐτοῦ Δηιφόβοιο·	- -- -- - -- -uu--	dactylic hexameter	masculine penthemimeral, trithemimeral
ἤδη γάρ σε δίδωμι πολυτλήτῳ Μενελάῳ.	-- - u u-u u-- -u--	lyric	
ὣς φαμένη θεὸς αὖθις ἀνέδραμεν· ἡ δὲ δόλοισι	- uu- uu -u u-uu - u u--	dactylic hexameter	feminine penthemimeral, trithemimeral
θελγομένη κραδίην θάλαμον λίπε κηώεντα,	-uu- uu- uu- uu ----	dactylic hexameter	masculine penthemimeral, hepthemimeral, trithemimeral
καί οἱ Δηίφοβος πόσις εἴπετο· τὴν δὲ κιοῦσαν	- - -uu- uu -uu - u u--	dactylic hexameter	masculine penthemimeral
Τρῳάδες ἑλκεχίτωνες ἐθηήσαντο γυναῖκες.	-uu -uu-u u---u u--	dactylic hexameter	feminine penthemimeral
ἡ δ᾽ὁπόθ᾽ ὑψιμέλαθρον ἐς ἱερὸν ἦλθεν Ἀθήνης,	- uu -uu-u u -uu -u u--	dactylic hexameter	feminine penthemimeral
ἔστη παπταίνουσα φυὴν εὐήνορος ἵππου.	-- ---u u- --uu --	dactylic hexameter	feminine penthemimeral, hepthemimeral
τρὶς δὲ περιστείχουσα καὶ Ἀργείους ἐρέθουσα	- u u---u u --- uu--	dactylic hexameter	feminine penthemimeral
πάσας ἠυκόμους ἀλόχους ὀνόμαζεν Ἀχαιῶν	-- -uu- uu- uu-u u--	dactylic hexameter	masculine penthemimeral, hepthemimeral
φωνῇ λεπταλέῃ· τοὶ δ᾽ἔνδοθι θυμὸν ἄμυσσον	-- -uu- - -uu -u u--	dactylic hexameter	masculine penthemimeral
ἀλγεινοὶ κατέχοντες ἐεργμένα δάκρυα σιγῇ.	--- uu-u u-uu -uu --	dactylic hexameter	feminine penthemimeral, trithemimeral
ἔστενε μὲν Μενέλαος, ἐπεὶ κλύε Τυνδαρεώνης,	-uu - uu-u u- uu -uu--	dactylic hexameter	feminine penthemimeral, hepthemimeral, trithemimeral
κλαῖε δὲ Τυδείδης μεμνημένος Αἰγιαλείης,	-u u --- --uu -uu--	dactylic hexameter	masculine penthemimeral
οὔνομα δ᾽ἐπτοίησεν Ὀδυσσέα Πηνελοπείης,	-uu ---u u-uu -uu--	dactylic hexameter	feminine penthemimeral
Ἄντικλος δ᾽ὅτε κέντρον ἐδέξατο Λαοδαμείης,	--- uu -u u-uu -uu--	dactylic hexameter	feminine penthemimeral, trithemimeral
μοῦνος ἀμοιβαίην ἀνεβάλλετο γῆρυν ἀνοίξας·	-u u--- uu-uu -u u--	dactylic hexameter	masculine penthemimeral
ἀλλ᾽ Ὀδυσεὺς κατέπαλτο καὶ ἀμφοτέρῃς παλάμῃσιν	- uu- uu-u u -uu- uu--	dactylic hexameter	feminine penthemimeral, trithemimeral
ἀμφιπεσὼν ἐπίεζεν ἐπειγόμενον στόμα λῦσαι.	-uu- uu-u u-uu- uu --	dactylic hexameter	feminine penthemimeral, trithemimeral
μάστακα δ᾽ἀρρήκτοισιν ἀλυκτοπέδῃσι μεμαρπὼς	-uu ---u u-uu-u u--	dactylic hexameter	feminine penthemimeral
εἶχεν ἐπικρατέως· ὁ δ᾽ἐπάλλετο χερσὶ πιεσθείς,	-u u-uu- u u-uu -u u--	dactylic hexameter	masculine penthemimeral
φεύγων ἀνδροφόνοιο πελώρια δεσμὰ σιωπῆς.	-- -uu-u u-uu -u u--	dactylic hexameter	feminine penthemimeral
καὶ τὸν μὲν λίπεν ἆσθμα φερέσβιον· οἱ δέ μιν ἄλλοι	- - - uu -u u-uu - u u --	dactylic hexameter	feminine penthemimeral, trithemimeral
δάκρυσι λαθριδίοισι κατακλαύσαντες Ἀχαιοὶ	-uu -uu-u u---u u--	dactylic hexameter	feminine penthemimeral
κοῖλον ἀποκρύψαντες ἐς ἰσχίον ἔνθεσαν ἵππου	-u u---u u -uu -uu --	dactylic hexameter	feminine penthemimeral
καὶ χλαῖναν μελέεσσιν ἐπὶ ψυχροῖσι βαλόντες.	- -- uu-u u- --u u--	dactylic hexameter	feminine penthemimeral, hepthemimeral, trithemimeral
καί νύ κεν ἄλλον ἔθελγε γυνὴ δολόμητις Ἀχαιῶν,	- u u -u u-u u- uu-u u--	dactylic hexameter	feminine penthemimeral, hepthemimeral
εἰ μή οἱ βλοσυρῶπις ἀπ᾽ αἰθέρος ἀντήσασα	- - - uu-u u -uu ----	dactylic hexameter	feminine penthemimeral, trithemimeral
Παλλὰς ἐπηπείλησε, φίλου δ᾽ἐξήγαγε νηοῦ	-u u---u u- --uu --	dactylic hexameter	feminine penthemimeral, hepthemimeral
μούνῃ φαινομένη, στερεῇ δ᾽ἀπεπέμψατο φωνῇ·	-- -uu- uu- uu-uu --	dactylic hexameter	masculine penthemimeral, hepthemimeral
δειλαίη, τέο μέχρις ἀλιτροσύναι σε φέρουσι	--- uu -u u-uu- u u--	dactylic hexameter	feminine penthemimeral, trithemimeral
καὶ πόθος ἀλλοτρίων λεχέων καὶ Κύπριδος ἄτη;	- uu -uu- uu- - -uu --	dactylic hexameter	masculine penthemimeral, hepthemimeral
οὔποτε δ᾽οἰκτείρεις πρότερον πόσιν οὐδὲ θύγατρα	-uu --- uu- uu -u u--	dactylic hexameter	masculine penthemimeral, hepthemimeral
Ἑρμιόνην ποθέεις; ἔτι δὲ Τρώεσσιν ἀρήγεις;	-uu- uu- uu - --u u--	dactylic hexameter	masculine penthemimeral, hepthemimeral, trithemimeral
χάζεο καὶ θαλάμων ὑπερώιον εἰσαναβᾶσα	-uu - uu- uu-uu -uu--	dactylic hexameter	masculine penthemimeral, trithemimeral
σὺν πυρὶ μειλιχίῳ ποτιδέχνυσο νῆας Ἀχαιῶν.	- uu -uu- uu-- -u u--	dactylic hexameter	masculine penthemimeral
ὣς φαμένη κενεὴν ἀπάτην ἐκέδασσε γυναικός.	- uu- uu- uu- uu-u u--	dactylic hexameter	masculine penthemimeral, hepthemimeral, trithemimeral
καὶ τὴν μὲν θαλαμόνδε πόδες φέρον· οἱ δὲ χοροῖο	- - - uu-u u- uu - u u--	dactylic hexameter	feminine penthemimeral, hepthemimeral, trithemimeral
παυσάμενοι καμάτῳ ἀδδηκότες ἤριπον ὕπνῳ.	-uu- uu- --uu -uu --	dactylic hexameter	masculine penthemimeral, trithemimeral
καὶ δή που φόρμιγξ ἀνεπαύσατο, κεῖτο δὲ κάμνων	- - - -- uu-uu -u u --	dactylic hexameter	masculine penthemimeral, trithemimeral
αὐλὸς ἐπὶ κρητῆρι, κύπελλα δὲ πολλὰ χυθέντα	-u u- --u u-u u -u u--	dactylic hexameter	feminine penthemimeral, trithemimeral
αὐτομάτως ῥείεσκε καθελκομένων ἀπὸ χειρῶν.	-uu- --u u-uu- uu --	dactylic hexameter	feminine penthemimeral, trithemimeral
ἡσυχίη δὲ πόλιν κατεβόσκετο, νυκτὸς ἑταίρη,	-uu- u u- uu-uu -u u--	dactylic hexameter	masculine penthemimeral, trithemimeral
οὐδ᾽ ὑλακὴ σκυλάκων ἠκούετο, πᾶσα δὲ σιγὴ	- uu- uu- --uu -u u --	dactylic hexameter	masculine penthemimeral, trithemimeral
εἱστήκει καλέουσα φόνον πνείουσαν ἀυτήν.	--- uu-u u- --u u--	dactylic hexameter	feminine penthemimeral, hepthemimeral, trithemimeral
ἤδη δὲ Τρώεσσιν ὀλέθριον εἷλκε τάλαντον	-- - --u u-uu -u u--	dactylic hexameter	feminine penthemimeral, trithemimeral
Ζεὺς ταμίης πολέμοιο, μόγις δ᾽ἐλέλιξεν Ἀχαιούς·	- uu- uu-u u- uu-u u--	dactylic hexameter	feminine penthemimeral, hepthemimeral, trithemimeral
χάζετο δ᾽Ἰλιόθεν Λυκίης ἐπὶ πίονα νηὸν	-uu -uu- uu- uu -uu --	dactylic hexameter	masculine penthemimeral, hepthemimeral
ἀχνύμενος μεγάλοις ἐπὶ τείχεσι Φοῖβος Ἀπάλλων.	--- uu- uu -uu -u u--	dactylic hexameter	masculine penthemimeral, trithemimeral
αὐτίκα δ᾽ Ἀργείοισιν Ἀχιλλῆος παρὰ τύμβον	-uu ---u u--- uu --	dactylic hexameter	feminine penthemimeral
ἀγγελίην ἀνάφαινε Σίνων εὐφεγγέι δαλῷ	-uu- uu-u u- --uu --	dactylic hexameter	feminine penthemimeral, hepthemimeral, trithemimeral
παννυχίη δ᾽ἑτάροισιν ὑπὲρ θαλάμοιο καὶ αὐτὴ	-uu- uu-u u- uu-u u --	dactylic hexameter	feminine penthemimeral, hepthemimeral, trithemimeral
εὐειδής Ἑλένη χρυσέην ἐπεδείκνυτο πεύκην.	--- uu- uu- uu-uu --	dactylic hexameter	masculine penthemimeral, hepthemimeral, trithemimeral
ὡς δ᾽ὁπότε πλήθουσα πυρὸς γλαυκοῖο σελήνη	- uu- --u u- --u u--	dactylic hexameter	feminine penthemimeral, hepthemimeral, trithemimeral
οὐρανὸν αἰγλήεντα κατεχρύσωσε προσώπῳ·	-uu ---u u---u u--	dactylic hexameter	feminine penthemimeral
οὐχ ὅτε που γλωχῖνας ἀποξύνουσα κεραίης	- uu - --u u---u u--	dactylic hexameter	feminine penthemimeral, trithemimeral
πρωτοφαὴς ὑπὸ μηνὸς ἀνίσταται ἄσκιον ἀχλύν,	-uu- uu -u u-uu -uu --	dactylic hexameter	feminine penthemimeral, trithemimeral
ἀλλ᾽ ὅτε κυκλώσασα περίτροχον ὄμματος αὐγὴν	- uu ---u u-uu -uu --	dactylic hexameter	feminine penthemimeral
ἀντιτύπους ἀκτῖνας ἐφέλκεται ἠελίοιο·	-uu- --u u-uu -uu--	dactylic hexameter	feminine penthemimeral, trithemimeral
τοίη μαρμαίρουσα Θεραπναίη τότε νύμφη	-- ---u u--- uu --	dactylic hexameter	feminine penthemimeral
οἴνοπα πῆχυν ἀνεῖλκε, φίλου πυρὸς ἡνιοχῆα.	-uu -u u-u u- uu -uu--	dactylic hexameter	feminine penthemimeral, hepthemimeral
οἱ δὲ σέλας πυρσοῖο μετήορον ἀθρήσαντες	- u u- --u u-uu ----	dactylic hexameter	feminine penthemimeral, trithemimeral
νῆας ἀνεκρούσαντο παλιγγνάμπτοισι κελεύθοις	-u u---u u---u u--	dactylic hexameter	feminine penthemimeral
Ἀργεῖοι σπεύδοντες, ἅπας δ᾽ἠπείγετο ναύτης	--- --u u- --uu --	dactylic hexameter	feminine penthemimeral, hepthemimeral, trithemimeral
δηναιοῦ πολέμοιο τέλος διζήμενος εὑρεῖν.	--- uu-u u- --uu --	dactylic hexameter	feminine penthemimeral, hepthemimeral, trithemimeral
οἱ δ᾽αὐτοὶ πλωτῆρες ἔσαν κρατεροί τε μαχηταὶ	- -- --u u- uu- u u--	dactylic hexameter	feminine penthemimeral, hepthemimeral, trithemimeral
ἀλλήλοις τ᾽ἐκέλευον ἐλαυνέμεν· αἱ δ᾽ἄρα νῆες	--- uu-u u-uu - uu --	dactylic hexameter	feminine penthemimeral, trithemimeral
ὠκύτεραι κραιπνῶν ἀνέμων ταχυπειθέι ῥιπῇ	-uu- -- uu- uu-uu --	dactylic hexameter	masculine penthemimeral, hepthemimeral, trithemimeral
Ἴλιον εἰσανάγοντο Ποσειδάωνος ἀρωγῇ.	-uu -uu-u u---u u--	dactylic hexameter	feminine penthemimeral
ἐνθάδε δὴ πεζοί πρότεροι κίον, οἱ δ᾽ἐπέλειφθεν	-uu - -- uu- uu - uu--	dactylic hexameter	masculine penthemimeral, hepthemimeral, trithemimeral
ἱππῆες κατόπισθεν, ὅπως μὴ Τρώιον ἵπποι	--- uu-u u- - -uu --	dactylic hexameter	feminine penthemimeral, hepthemimeral, trithemimeral
λαὸν ἀναστήσωσιν ἀειρομένῳ χρεμετισμῷ.	-u u---u u-uu- uu--	dactylic hexameter	feminine penthemimeral
οἱ δ᾽ἕτεροι γλαφυρῆς ἀπὸ γαστέρος ἔρρεον ἵππου,	- uu- uu- uu -uu -uu --	dactylic hexameter	masculine penthemimeral, trithemimeral
τευχησταὶ βασιλῆες, ἀπὸ δρυὸς οἶα μέλισσαι,	--- uu-u u- uu -u u--	dactylic hexameter	feminine penthemimeral, hepthemimeral, trithemimeral
αἵτ᾽ ἐπεὶ οὖν ἔκαμον πολυχανδέος ἔνδοθι σίμβλου	- uu - uu- uu-uu -uu --	dactylic hexameter	masculine penthemimeral, trithemimeral
κηρὸν ὑφαίνουσαι μελιηδέα ποικιλοτέχναι,	-u u--- uu-uu -u--	lyric	
ἐς νομὸν εὐγυάλοιο κατ᾽ ἄγγεος ἀμφιχυθεῖσαι	- uu -uu-u u -uu -uu--	dactylic hexameter	feminine penthemimeral
νύγμασι πημαίνουσι παραστείχοντας ὁδίτας·	-uu ---u u---u u--	dactylic hexameter	feminine penthemimeral
ὣς Δαναοὶ κρυφίοιο λόχου κληῖδας ἀνέντες	- uu- uu-u u- --u u--	dactylic hexameter	feminine penthemimeral, hepthemimeral, trithemimeral
θρῷσκον ἐπὶ Τρώεσσι καὶ εἰσέτι κοῖτον ἔχοντας	-u u- --u u -uu -u u--	dactylic hexameter	feminine penthemimeral, trithemimeral
χαλκείου θανάτοιο κακοῖς ἐκάλυψαν ὀνείροις.	--- uu-u u- uu-u u--	dactylic hexameter	feminine penthemimeral, hepthemimeral, trithemimeral
νήχετο δ᾽αἵματι γαῖα, βοὴ δ᾽ἄλληκτος ὀρώρει	-uu -uu -u u- --u u--	dactylic hexameter	feminine penthemimeral, hepthemimeral
Τρώων φευγόντων, ἐστείνετο δ᾽Ἴλιος ἱρὴ	-- --- --uu -uu --	dactylic hexameter	masculine penthemimeral
πιπτόντων νεκύων, οἱ δ᾽ἀνδροφόνῳ κολοσυρτῷ	--- uu- - -uu- uu--	dactylic hexameter	masculine penthemimeral, trithemimeral
ἔζεον ἔνθα καὶ ἔνθα μεμηνότες οἶα λέοντες	-uu -- - -u u-uu -u u--	lyric	
σώμασιν ἀρτιφάτοισι γεφυρώσαντες ἀγυιάς.	-uu -uu-u u---u u--	dactylic hexameter	feminine penthemimeral
Τρωιάδες δὲ γυναῖκες ὑπέρ τεγέων ἀίουσαι	-uu- u u-u u- uu- uu--	dactylic hexameter	feminine penthemimeral, hepthemimeral, trithemimeral
αἱ μὲν ἐλευθερίης ἐρατῆς ἔτι διψώουσαι	- u u-uu- uu- uu ----	dactylic hexameter	masculine penthemimeral, hepthemimeral
αὐχένας ἐς θάνατον δειλοῖς ὑπέβαλλον ἀκοίταις,	-uu - uu- -- uu-u u--	dactylic hexameter	masculine penthemimeral, hepthemimeral, trithemimeral
αἱ δὲ φίλοις ἐπὶ παισί, χελιδόνες οἷάτε κοῦφαι,	- u u- uu -u u-uu -uu --	dactylic hexameter	feminine penthemimeral, trithemimeral
μητέρες ὠδύροντο· νέη δέ τις ἀσπαίροντα	-uu ---u u- u u ----	dactylic hexameter	feminine penthemimeral, hepthemimeral
ἠίθεον κλαύσασα θανεῖν ἔσπευδε καὶ αὐτὴ	-uu- --u u- --u u --	dactylic hexameter	feminine penthemimeral, hepthemimeral, trithemimeral
οὐδὲ δορυκτήτοισιν ὁμοῦ δεσμοῖσιν ἕπεσθαι	-u u---u u- --u u--	dactylic hexameter	feminine penthemimeral, hepthemimeral
ἤθελεν, ἀλλ᾽ ἐχόλωσε καὶ οὐκ ἐθέλοντα φονῆα	-uu - uu-u u - uu-u u--	dactylic hexameter	feminine penthemimeral, hepthemimeral, trithemimeral
καὶ ξυνὸν λέχος ἔσχεν ὀφειλόμενον παρακοίτῃ.	- -- uu -u u-uu- uu--	dactylic hexameter	feminine penthemimeral, trithemimeral
πολλαὶ δ᾽ἠλιτόμηνα καὶ ἄπνοα τέκνα φέρουσαι	-- -uu-u u -uu -u u--	dactylic hexameter	feminine penthemimeral
γαστέρος ὠμοτόκοιο χύδην ὠδῖνα μεθεῖσαι	-uu -uu-u u- --u u--	dactylic hexameter	feminine penthemimeral, hepthemimeral
ῥιγεδανῶς σὺν παισὶν ἀπεψύχοντο καὶ αὐταί.	-uu- - -u u---u u --	dactylic hexameter	feminine penthemimeral, trithemimeral
παννυχίη δ᾽ἐχόρευσεν ἀνὰ πτόλιν, οἷα θύελλα,	-uu- uu-u u- uu -u u--	dactylic hexameter	feminine penthemimeral, hepthemimeral, trithemimeral
κύμασι παφλάζουσα πολυφλοίσβου πολέμοιο	-uu ---u u--- uu--	dactylic hexameter	feminine penthemimeral
αἵματος ἀκρήτοιο μέθης ἐπίκωμος Ἐνυώ.	-uu ---u u- uu-u u--	dactylic hexameter	feminine penthemimeral, hepthemimeral
σὺν δ᾽Ἔρις οὐρανόμηκες ἀναστήσασα κάρηνον	- uu -uu-u u---u u--	dactylic hexameter	feminine penthemimeral
Ἀργείους ὀρόθυνεν, ἐπεὶ καὶ φοίνιος Ἄρης	--- uu-u u- - -uu --	dactylic hexameter	feminine penthemimeral, hepthemimeral, trithemimeral
ὀψὲ μὲν ἀλλὰ καὶ ὣς πολέμων ἑτεραλκέα νίκην	-u u -u u - uu- uu-uu --	dactylic hexameter	masculine penthemimeral, hepthemimeral
ἦλθε φέρων Δαναοῖσι καὶ ἀλλοπρόσαλλον ἀρωγήν.	-u u- uu-u u -uu-u u--	dactylic hexameter	feminine penthemimeral, trithemimeral
ἴαχε δὲ γλαυκῶπις ἐπ᾽ ἀκροπόληος Ἀθήνη	-uu - --u u -uu-u u--	dactylic hexameter	feminine penthemimeral, trithemimeral
αἰγίδα κινήσασα, Διὸς σάκος, ἔτρεμε δ᾽αἰθὴρ	-uu ---u u- uu -uu --	dactylic hexameter	feminine penthemimeral, hepthemimeral
Ἥρης σπερχομένης, ἐπὶ δ᾽ἔβραχε γαῖα βαρεῖα	-- -uu- uu -uu -u u--	dactylic hexameter	masculine penthemimeral
παλλομένη τριόδοντι Ποσειδάωνος ἀκωκῇ,	-uu- uu-u u---u u--	dactylic hexameter	feminine penthemimeral, trithemimeral
ἔφριξεν δ᾽Ἀίδης, χθονίων δ᾽ἐξέδρακε θώκων	--- uu- uu- --uu --	dactylic hexameter	masculine penthemimeral, hepthemimeral, trithemimeral
ταρβήσας, μή πού τι Διὸς μέγα χωσαμένοιο	--- - - u u- uu -uu--	dactylic hexameter	masculine penthemimeral, hepthemimeral, trithemimeral
πᾶν γένος ἀνθρώπων κατάγοι ψυχοστόλος Ἑρμῆς.	- uu --- uu- --uu --	dactylic hexameter	masculine penthemimeral, hepthemimeral
πάντα δ᾽ὁμοῦ κεκύκητο, φόνος δέ τις ἄκριτος ἦεν·	-u u- uu-u u- u u -uu --	dactylic hexameter	feminine penthemimeral, hepthemimeral, trithemimeral
τοὺς μὲν γὰρ φεύγοντας ἐπὶ Σκαιῇσι πύλῃσι	- - - --u u- --u u--	dactylic hexameter	feminine penthemimeral, hepthemimeral, trithemimeral
κτεῖνον ἐφεστηῶτες, ὁ δ᾽ἐξ εὐνῆς ἀνορούσας	-u u---u u - -- uu--	dactylic hexameter	feminine penthemimeral, hepthemimeral
τεύχεα μαστεύων δνοφερῇ περικάππεσεν αἰχμῇ.	-uu --- uu- uu-uu --	dactylic hexameter	masculine penthemimeral, hepthemimeral
καί τις ὑπὸ σκιόεντι δόμῳ κεκρυμμένος ἀνήρ,	- u u- uu-u u- --uu --	dactylic hexameter	feminine penthemimeral, hepthemimeral, trithemimeral
ξεῖνος ἐών, ἐκάλεσσεν ὀιόμενος φίλον εἶναι·	-u u- uu-u u-uu- uu --	dactylic hexameter	feminine penthemimeral, trithemimeral
νήπιος, οὐ μὲν ἔμελλεν ἐνηέι φωτὶ μιγῆναι,	-uu - u u-u u-uu -u u--	dactylic hexameter	feminine penthemimeral, trithemimeral
ξείνια δ᾽ἐχθρὰ κόμισσεν· ὑπέρ τέγεος δέ τις ἄλλος	-uu - --u u- uu- u u --	dactylic hexameter	feminine penthemimeral, hepthemimeral, trithemimeral
μήπω παπταίνων τι θοῷ διέπιπτεν ὀιστῷ.	-- --- u u- uu-u u--	dactylic hexameter	masculine penthemimeral, hepthemimeral
καί τινες ἀλγεινῷ κραδίην βεβαρηότες οἴνῳ,	- uu --- uu- uu-uu --	dactylic hexameter	masculine penthemimeral, hepthemimeral
ἐκπλαγέες ποτὶ δοῦπον, ἐπειγόμενοι καταβῆναι,	-uu- uu -u u-uu- uu--	dactylic hexameter	feminine penthemimeral, trithemimeral
κλίμακος ἐξελάθοντο καθ᾽ ὑψηλῶν τε μελάθρων	-uu -uu-u u --- u u--	dactylic hexameter	feminine penthemimeral
ἔκπεσον ἀγνώσσοντες, ἐπαυχενίους δὲ λυθέντες	-uu ---u u-uu- u u--	dactylic hexameter	feminine penthemimeral
ἀστραγάλους ἐάγησαν, ὁμοῦ δ᾽ἐξήρυγον οἶνον.	-uu- uu-u u- --uu --	dactylic hexameter	feminine penthemimeral, hepthemimeral, trithemimeral
πολλοὶ δ᾽εἰς ἕνα χῶρον ἀολλέες ἐκτείνοντο	-- - uu -u u-uu ----	dactylic hexameter	feminine penthemimeral, trithemimeral
μαρνάμενοι, πολλοὶ δὲ διωκόμενοι κατὰ πύργων	-uu- -- u u-uu- uu --	dactylic hexameter	masculine penthemimeral, trithemimeral
ἤριπον εἰς Ἀίδαο πανύστατον ἅλμα θορόντες.	-uu - uu-u u-uu -u u--	dactylic hexameter	feminine penthemimeral, trithemimeral
παῦροι δὲ στεινῆς διὰ κοιλάδος, οἷάτε φῶρες,	-- - -- uu -uu -uu --	dactylic hexameter	masculine penthemimeral, trithemimeral
πατρίδος ὀλλυμένης ἔλαθον χειμῶνα φυγόντες.	-uu -uu- uu- --u u--	dactylic hexameter	masculine penthemimeral, hepthemimeral
οἱ δ᾽ἔνδον πολέμῳ τε καὶ ἀχλύι κυμαίνοντες,	- -- uu- u u -- ----	dactylic hexameter	masculine penthemimeral, trithemimeral
ἀνδράσιν οἰχομένοισι καὶ οὐ φεύγουσιν ὁμοῖοι,	-uu -uu-u u - --u u--	dactylic hexameter	feminine penthemimeral, hepthemimeral
πίπτον ἐπ᾽ ἀλλήλοισι· πόλις δ᾽οὐ χάνδανε λύθρον	-u u ---u u- - -uu --	dactylic hexameter	feminine penthemimeral, hepthemimeral
ἀνδρῶν χηρεύουσα, περιπλήθουσα δὲ νεκρῶν.	-- ---u u---u u --	dactylic hexameter	feminine penthemimeral
οὐδέ τι φειδωλή τις ἐγίνετο· φοιταλέῃ δὲ	-u u --- u u-uu -uu- -	dactylic hexameter	masculine penthemimeral
σπερχόμενοι μάστιγι φιλαγρύπνοιο κυδοιμοῦ	-uu- --u u---u u--	dactylic hexameter	feminine penthemimeral, trithemimeral
οὐδὲ θεῶν ὄπιν εἶχον, ἀθεσμοτάτης δ᾽ὑπὸ ῥιπῆς	-u u- uu -u u-uu- uu --	dactylic hexameter	feminine penthemimeral, trithemimeral
ἀθανάτων ἔχραινον ἀπενθέας αἵματι βωμούς.	-uu- --u u-uu -uu --	dactylic hexameter	feminine penthemimeral, trithemimeral
οἰκτρότατοι δὲ γέροντες ἀτιμοτάτοισι φόνοισιν	-uu- u u-u u-uu-u u--	dactylic hexameter	feminine penthemimeral, trithemimeral
οὐδ᾽ ὀρθοὶ κτείνοντο, χαμαὶ δ᾽ἱκετήσια γυῖα	- -- --u u- uu-uu --	dactylic hexameter	feminine penthemimeral, hepthemimeral, trithemimeral
τεινάμενοι πολιοῖσι κατεκλίνοντο καρήνοις.	-uu- uu-u u---u u--	dactylic hexameter	feminine penthemimeral, trithemimeral
πολλὰ δὲ νήπια τέκνα μινυνθαδίων ἀπὸ μαζῶν	-u u -uu -u u-uu- uu --	dactylic hexameter	feminine penthemimeral
μητέρος ἡρπάζοντο καὶ οὐ νοέοντα τοκήων	-uu ---u u - uu-u u--	dactylic hexameter	feminine penthemimeral, hepthemimeral
ἀμπλακίας ἀπέτινον, ἀνημέλκτου δὲ γάλακτος	-uu- uu-u u--- u u--	dactylic hexameter	feminine penthemimeral, trithemimeral
παιδὶ μάτην ὀρέγουσα χοὰς ἐκόμισσε τιθήνη.	-u u- uu-u u- uu-u u--	dactylic hexameter	feminine penthemimeral, hepthemimeral, trithemimeral
οἰωνοί τε κύνες τε κατὰ πτόλιν ἄλλοθεν ἄλλοι,	--- u u- u u- uu -uu --	dactylic hexameter	masculine penthemimeral, hepthemimeral, trithemimeral
ἠέριοι πεζοί τε συνέστιοι εἰλαπινασταί,	-uu- -- u u-uu -uu--	dactylic hexameter	masculine penthemimeral, trithemimeral
αἷμα μέλαν πίνοντες ἀμείλιχον εἶχον ἐδωδήν,	-u u- --u u-uu -u u--	dactylic hexameter	feminine penthemimeral, trithemimeral
καὶ τῶν μὲν κλαγγὴ φόνον ἔπνεεν, οἱ δ᾽ὑλάοντες	- - - -- uu -uu - uu--	dactylic hexameter	masculine penthemimeral, trithemimeral
ἄγρια κοπτομένοισιν ἐπ᾽ ἀνδράσιν ὠρύοντο,	-uu -uu-u u -uu ----	dactylic hexameter	feminine penthemimeral
νηλέες, οὐδ᾽ ἀλέγιζον ἑοὺς ἐρύοντες ἄνακτας.	-uu - uu-u u- uu-u u--	dactylic hexameter	feminine penthemimeral, hepthemimeral, trithemimeral
τὼ δὲ γυναιμανέος ποτὶ δώματα Δηιφόβοιο	- u u-uu- uu -uu -uu--	dactylic hexameter	masculine penthemimeral
στελλέσθην Ὀδυσεύς τε καὶ εὐχαίτης Μενέλαος	--- uu- u u --- uu--	dactylic hexameter	masculine penthemimeral, trithemimeral
καρχαλέοισι λύκοισιν ἐοικότες, οἵθ᾽ ὑπὸ νύκτα	-uu-u u-u u-uu - uu --	dactylic hexameter	feminine penthemimeral
χειμερίην φονόωντες ἀσημάντοις ἐπὶ μήλοις	-uu- uu-u u--- uu --	dactylic hexameter	feminine penthemimeral, trithemimeral
οἴχονται, κάματον δὲ κατατρύχουσι νομήων.	--- uu- u u---u u--	dactylic hexameter	masculine penthemimeral, trithemimeral
ἔνθα δύω περ ἐόντες ἀπειρεσίοισιν ἔμιχθεν	-u u- u u-u u-uu-u --	lyric	
ἀνδράσι δυσμενέεσσι· νέη δ᾽ἠγείρετο χάρμη	-uu -uu-u u- --uu --	dactylic hexameter	feminine penthemimeral, hepthemimeral
τῶν μὲν ἐπορνυμένων, τῶν δ᾽ὑψόθεν ἐκ θαλάμοιο	- u u-uu- - -uu - uu--	dactylic hexameter	masculine penthemimeral
βαλλόντων λιθάκεσσι καὶ ὠκυμόροισιν ὀιστοῖς.	--- uu-u u -uu-u u--	dactylic hexameter	feminine penthemimeral, trithemimeral
ἀλλὰ καὶ ὣς ὑπέροπλα καρήατα πυργώσαντες	-u u - uu-u u-uu ----	dactylic hexameter	feminine penthemimeral, trithemimeral
ἀρρήκτοις κορύθεσσι καὶ ἀσπίσι κυκλώσαντες	--- uu-u u -uu ----	dactylic hexameter	feminine penthemimeral, trithemimeral
εἰσέθορον μέγα δῶμα· καὶ ἀντίβιον μὲν ὅμιλον,	-uu- uu -u u -uu- u u--	dactylic hexameter	feminine penthemimeral, trithemimeral
θῆρας δειμαλέους, ἐλάων ἐδάιξεν Ὀδυσσεύς,	-- -uu- uu- uu-u u--	dactylic hexameter	masculine penthemimeral, hepthemimeral
Ἀτρείδης δ᾽ἑτέρωθεν ὑποπτήξαντα διώξας	--- uu-u u---u u--	dactylic hexameter	feminine penthemimeral, trithemimeral
Δηίφοβον κατέμαρψε, μέσην κατὰ γαστέρα τύψας	-uu- uu-u u- uu -uu --	dactylic hexameter	feminine penthemimeral, hepthemimeral, trithemimeral
ἧπαρ ὀλισθηρῇσι συνεξέχεεν χολάδεσσιν.	-u u---u u-uu- uu--	dactylic hexameter	feminine penthemimeral
ὣς ὁ μὲν αὐτόθι κεῖτο λελασμένος ἱπποσυνάων,	- u u -uu -u u-uu -uu--	dactylic hexameter	feminine penthemimeral
τῷ δ᾽ἕπετο τρομέουσα δορυκτήτη παράκοιτις	- uu- uu-u u--- uu--	dactylic hexameter	feminine penthemimeral, trithemimeral
ἄλλοτε μὲν χαίρουσα κακῶν ἐπὶ τέρματι μόχθων,	-uu - --u u- uu -u- -	lyric	
ἄλλοτε δ᾽αἰδομένη, τοτὲ δ᾽ὀψέ περ ὡς ἐν ὀνείρῳ	-uu -uu- uu -u u - u u--	dactylic hexameter	masculine penthemimeral
λαθρίδιον στενάχουσα φίλης μιμνῄσκετο πάτρης.	-uu- uu-u u- --uu --	dactylic hexameter	feminine penthemimeral, hepthemimeral, trithemimeral
Αἰακίδης δὲ γέροντα Νεοπτόλεμος βασιλῆα	-uu- u u-u u-uu- uu--	dactylic hexameter	feminine penthemimeral, trithemimeral
πήμασι κεκμηῶτα παρ᾽ Ἑρκείῳ κτάνε βωμῷ	-uu ---u u --- uu --	dactylic hexameter	feminine penthemimeral
οἶκτον ἀπωσάμενος πατρώιον· οὐδὲ λιτάων	-u u-uu- --uu -u u--	dactylic hexameter	masculine penthemimeral
ἔκλυεν, οὐ Πηλῆος ὁρώμενος ἥλικα χαίτην	-uu - --u u-uu -uu --	dactylic hexameter	feminine penthemimeral, trithemimeral
ᾐδέσαθ᾽, ἧς ὕπο θυμὸν ἀπέκλασεν ἠδὲ γέροντος	-uu - uu -u u-uu -u u--	dactylic hexameter	feminine penthemimeral, trithemimeral
καίπερ ἐὼν βαρύμηνις ἐφείσατο τὸ πρὶν Ἀχιλλεύς.	-u u- uu-u u-uu - u u--	dactylic hexameter	feminine penthemimeral, trithemimeral
σχέτλιος, ἦ μὲν ἔμελλε καὶ αὐτῷ πότμος ὁμοῖος	-- - u u-u u -- -u u--	dactylic hexameter	feminine penthemimeral, trithemimeral
ἑσπέσθαι παρὰ βωμὸν ἀληθέος Ἀπόλλωνος	--- uu -u u-uu ----	dactylic hexameter	feminine penthemimeral, trithemimeral
ὕστερον, ὁππότε μιν ζαθέου δηλήμονα νηοῦ	-uu -uu - uu- --uu --	dactylic hexameter	masculine penthemimeral, hepthemimeral
Δελφὸς ἀνὴρ ἐλάσας ἱερῇ κατέπεφνε μαχαίρῃ.	-u u- uu- uu- uu-u u--	dactylic hexameter	masculine penthemimeral, hepthemimeral, trithemimeral
ἡ δὲ κυβιστήσαντα διηερίων ἀπὸ πύργων—	- u u---u u-uu- uu --	dactylic hexameter	feminine penthemimeral
χειρὸς Ὀδυσσείης ὀλοὸν βέλος—ἀθρήσασα	-u u--- uu- uu----	dactylic hexameter	masculine penthemimeral, hepthemimeral
Ἀνδρομάχη μινύωρον ἐκώκυεν Ἀστυάνακτα.	-uu- uu-u u-uu -uu--	dactylic hexameter	feminine penthemimeral, trithemimeral
Κασσάνδρην δ᾽ᾔσχυνεν Ὀιλῆος ταχὺς Αἴας	--- --- --- uu --	dactylic hexameter	trithemimeral
Παλλάδος ἀχράντοιο θεῆς ὑπὸ γοῦνα πεσοῦσαν·	-uu ---u u- uu -u u--	dactylic hexameter	feminine penthemimeral, hepthemimeral
ἡ δὲ βίην ἀνένευσε θεή, τὸ πρόσθεν ἀρηγὼν	- u u- uu-u u- - -u u--	dactylic hexameter	feminine penthemimeral, hepthemimeral, trithemimeral
ἀνθ᾽ ἑνὸς Ἀργείοισιν ἐχώσατο πᾶσιν Ἀθήνη.	- uu ---u u-uu -u u--	dactylic hexameter	feminine penthemimeral
Αἰνείαν δ᾽ἔκλεψε καὶ Ἀγχίσην Ἀφροδίτη	--- --u u --- uu--	dactylic hexameter	feminine penthemimeral, trithemimeral
οἰκτείρουσα γέροντα καὶ υἱέα, τῆλε δὲ πάτρης	---u u-u u -uu -u u --	dactylic hexameter	feminine penthemimeral
Αὐσονίην ἀπένασσε· θεῶν δ᾽ἐτελείετο βουλὴ	-uu- uu-u u- uu-uu --	dactylic hexameter	feminine penthemimeral, hepthemimeral, trithemimeral
Ζηνὸς ἐπαινήσαντος, ἵνα κράτος ἄφθιτον εἴη	-u u---u u- uu -uu --	dactylic hexameter	feminine penthemimeral, hepthemimeral
παισὶ καὶ υἱωνοῖσιν ἀρηιφίλης Ἀφροδίτης.	-u u ---u u-uu- uu--	dactylic hexameter	feminine penthemimeral
τέκνα δὲ καὶ γενεὴν Ἀντήνορος ἀντιθέοιο	-u u - uu- --uu -uu--	dactylic hexameter	masculine penthemimeral, trithemimeral
Ἀτρείδης ἐφύλαξε, φιλοξείνοιο γέροντος,	--- uu-u u---u u--	dactylic hexameter	feminine penthemimeral, trithemimeral
μειλιχίης προτέρης τίνων χάριν ἠδὲ τραπέζης	-uu- uu- -- uu -u u--	dactylic hexameter	masculine penthemimeral, hepthemimeral, trithemimeral
κείνης, ᾗ μιν ἔδεκτο γυνὴ πρηεῖα Θεανώ.	-- - u u-u u- --u u--	dactylic hexameter	feminine penthemimeral, hepthemimeral, trithemimeral
δειλὴ Λαοδίκη, σὲ δὲ πατρίδος ἐγγύθι γαίης	-- -uu- u u -uu -uu --	dactylic hexameter	masculine penthemimeral
γαῖα περιπτύξασα κεχηνότι δέξατο κόλπῳ·	-u u---u u-uu -uu --	dactylic hexameter	feminine penthemimeral
οὐδέ σε Θησείδης Ἀκάμας οὐδ᾽ ἄλλος Ἀχαιῶν	-u u --- uu- - -u u--	dactylic hexameter	masculine penthemimeral, hepthemimeral
ἤγαγε ληιδίην, ἔθανες δ᾽ἅμα πατρίδι γαίῃ.	-uu -uu- uu- uu -uu --	dactylic hexameter	masculine penthemimeral, hepthemimeral
πᾶσαν δ᾽οὐκ ἂν ἔγωγε μόθου χύσιν ἀείσαιμι	-- - u u-u u- uu ----	dactylic hexameter	feminine penthemimeral, hepthemimeral, trithemimeral
κρινάμενος τὰ ἕκαστα καὶ ἄλγεα νυκτὸς ἐκείνης·	-uu- u u-u u -uu -u u--	dactylic hexameter	feminine penthemimeral, trithemimeral
Μουσάων ὅδε μόχθος, ἐγὼ δ᾽ἅπερ ἵππον ἐλάσσω	--- uu - -- uu -u u--	dactylic hexameter	masculine penthemimeral, hepthemimeral, trithemimeral
τέρματος ἀμφιέλισσαν ἐπιψαύουσαν ἀοιδήν.	-uu -uu-u u---u u--	dactylic hexameter	feminine penthemimeral
ἄρτι γὰρ ἀντολίηθεν ἀπόσσυτος Ὠκεανοῖο	-u u -uu-u u-uu -uu--	dactylic hexameter	feminine penthemimeral
ἠρέμα λευκαίνουσα κατέγραφεν ἠέρα πολλήν,	-uu ---u u-uu -uu --	dactylic hexameter	feminine penthemimeral
νύκτα διαρρήξασα μιαιφόνον ἱππότις Ἠώς·	-u u---u u-uu -uu --	dactylic hexameter	feminine penthemimeral
οἱ δ᾽ἐπαγαλλόμενοι πολέμων ὑπεραυχέι νίκῃ	- uu-uu- uu- uu-uu --	dactylic hexameter	masculine penthemimeral, hepthemimeral
πάντοσε παπταίνεσκον ἀνὰ πτόλιν, εἴ τινες ἄλλοι	-uu ---u u- uu - uu --	dactylic hexameter	feminine penthemimeral, hepthemimeral
κλεπτόμενοι φεύγουσι φόνου πάνδημον ἀυτήν.	-uu- --u u- --u u--	dactylic hexameter	feminine penthemimeral, hepthemimeral, trithemimeral
ἀλλ᾽ οἱ μὲν δέδμηντο λίνῳ θανάτοιο πανάγρῳ,	- - - -- -- uu-u u--	dactylic hexameter	masculine penthemimeral, hepthemimeral, trithemimeral
ἰχθύες ὡς ἁλίῃσιν ἐπὶ ψαμάθοισι χυθέντες,	-- - uu-u u- uu-u u--	dactylic hexameter	feminine penthemimeral, hepthemimeral, trithemimeral
Ἀργεῖοι δ᾽ἀπὸ μὲν μεγάρων νεοτευχέα κόσμον	--- uu - uu- uu-uu --	dactylic hexameter	masculine penthemimeral, hepthemimeral, trithemimeral
ἐξέφερον, νηῶν ἀναθήματα, πολλὰ δ᾽ἐρήμων	-uu- -- uu-uu -u u--	dactylic hexameter	masculine penthemimeral, trithemimeral
ἥρπαζον θαλάμων κειμήλια· σὺν δὲ γυναῖκας	--- uu- --uu - u u--	dactylic hexameter	masculine penthemimeral, trithemimeral
ληιδίας σὺν παισὶν ἄγον ποτὶ νῆας ἀνάγκῃ.	-uu- - -u u- uu -u u--	dactylic hexameter	feminine penthemimeral, hepthemimeral, trithemimeral
τείχεσι δὲ πτολίπορθον ἐπὶ φλόγα θωρήξαντες	-uu - uu-u u- uu ----	dactylic hexameter	feminine penthemimeral, hepthemimeral, trithemimeral
ἔργα Ποσειδάωνος ἰῇ συνέχευον ἀυτμῇ.	-u u---u u- uu-u u--	dactylic hexameter	feminine penthemimeral, hepthemimeral
αὐτοῦ καὶ μέγα σῆμα φίλοις ἀστοῖσιν ἐτύχθη	-- - uu -u u- --u --	lyric	
Ἴλιος αἰθαλόεσσα· πυρὸς δ᾽ὀλεσίπτολιν ἄτην	-uu -uu-u u- uu-uu --	dactylic hexameter	feminine penthemimeral, hepthemimeral
Ξάνθος ἰδὼν ἔκλαυσε γόων ἁλιμυρέι πηγῇ,	-u u- --u u- uu-uu --	dactylic hexameter	feminine penthemimeral, hepthemimeral, trithemimeral
Ἡφαίστῳ δ᾽ὑπόεικεν ἀτυζόμενος χόλον Ἥρης.	--- uu-u u-uu- uu --	dactylic hexameter	feminine penthemimeral, trithemimeral
οἱ δὲ Πολυξείνης ἐπιτύμβιον αἷμα χέαντες,	- u u--- uu-uu -u u--	dactylic hexameter	masculine penthemimeral
μῆνιν ἱλασσάμενοι τεθνειότος Αἰακίδαο	-u u-uu- --uu -uu--	dactylic hexameter	masculine penthemimeral
Τρωιάδας τε γυναῖκας ἐλάγχανον, ἄλλα τε πάντα	-uu- u u-u u-uu -u u --	dactylic hexameter	feminine penthemimeral, trithemimeral
χρυσὸν ἐμοιρήσαντο καὶ ἄργυρον· οἷσι βαθείας	-u u---u u -uu -u u--	dactylic hexameter	feminine penthemimeral
νῆας ἐπαχθήσαντες ἐριγδούπου διὰ πόντου	-u u--- ---- uu --	dactylic hexameter	masculine penthemimeral
ἐκ Τροίης ἀνάγοντο μόθον τελέσαντες Ἀχαιοί.	- -- uu-u u- uu-u u--	dactylic hexameter	feminine penthemimeral, hepthemimeral, trithemimeral
