μοῦσαι Πιερίηθεν ἀοιδῇσι κλείουσαι,	-- -uu-u u--- ---	dactylic hexameter	feminine penthemimeral
δεῦτε Δί’ ἐννέπετε, σφέτερον πατέρ’ ὑμνείουσαι.	-u u -uu- uu- uu ----	dactylic hexameter	masculine penthemimeral, hepthemimeral
ὅν τε διὰ βροτοὶ ἄνδρες ὁμῶς ἄφατοί τε φατοί τε,	- u u- uu -u u- uu- u u- -	dactylic hexameter	feminine penthemimeral, hepthemimeral, trithemimeral
ῥητοί τ’ἄρρητοί τε Διὸς μεγάλοιο ἕκητι.	-- --- u u- uu-u u--	dactylic hexameter	masculine penthemimeral, hepthemimeral
ῥέα μὲν γὰρ βριάει, ῥέα δὲ βριάοντα χαλέπτει,	- - - uu- uu - uu-u u--	dactylic hexameter	masculine penthemimeral, hepthemimeral, trithemimeral
ῥεῖα δ’ἀρίζηλον μινύθει καὶ ἄδηλον ἀέξει,	-u u--- uu- u u-u u--	dactylic hexameter	masculine penthemimeral, hepthemimeral
ῥεῖα δέ τ’ἰθύνεισκολιὸν καὶ ἀγήνορα κάρφει	-u u ---uu- u u-uu --	dactylic hexameter	hepthemimeral
Ζεὺς ὑψιβρεμέτης, ὃς ὑπέρτατα δώματα ναίει.	- --uu- u u-uu -uu --	dactylic hexameter	masculine penthemimeral
κλῦθι ἰδὼν ἀΐων τε, δίκῃ δ’ἴθυνε θέμιστας	-u u- uu- u u- --u u--	dactylic hexameter	masculine penthemimeral, hepthemimeral, trithemimeral
τύνη· ἐγὼ δέ κε Πέρσῃ ἐτήτυμα μυθησαίμην.	-u u- u u -u u-uu ----	dactylic hexameter	feminine penthemimeral, trithemimeral
οὐκ ἄρα μοῦνον ἔην Ἐρίδων γένος, ἀλλ’ ἐπὶ γαῖαν	- uu -u u- uu- uu - uu --	dactylic hexameter	masculine penthemimeral, hepthemimeral
εἰσὶ δύω· τὴν μέν κεν ἐπαινήσειε νοήσας,	-u u- - - u u---u u--	dactylic hexameter	masculine penthemimeral, trithemimeral
ἣ δ’ἐπιμωμητή· διὰ δ’ἄνδιχα θυμὸν ἔχουσιν.	- uu--- uu -uu -u u--	dactylic hexameter	masculine penthemimeral
ἣ μὲν γὰρ πόλεμόν τε κακὸν καὶ δῆριν ὀφέλλει,	- - - uu- u u- - -u u--	dactylic hexameter	masculine penthemimeral, hepthemimeral, trithemimeral
σχετλίη· οὔ τις τήν γε φιλεῖ βροτός, ἀλλ’ ὑπ’ ἀνάγκης	-uu - - - u u- uu - u u--	dactylic hexameter	masculine penthemimeral, hepthemimeral, trithemimeral
ἀθανάτων βουλῇσιν Ἔριν τιμῶσι βαρεῖαν.	-uu- --u u- --u u--	dactylic hexameter	feminine penthemimeral, hepthemimeral, trithemimeral
τὴν δ’ἑτέρην προτέρην μὲν ἐγείνατο Νὺξ ἐρεβεννή,	- uu- uu- u u-uu - uu--	dactylic hexameter	masculine penthemimeral, trithemimeral
θῆκε δέ μιν Κρονίδης ὑψίζυγος, αἰθέρι ναίων,	-u u - uu- --uu -uu --	dactylic hexameter	masculine penthemimeral, trithemimeral
γαίης τ’ἐν ῥίζῃσι καὶ ἀνδράσι πολλὸν ἀμείνω·	-- - --u u -uu -u u--	dactylic hexameter	feminine penthemimeral, trithemimeral
ἥ τε καὶ ἀπάλαμόν περ ὁμῶς ἐπὶ ἔργον ἐγείρει·	- u u -uu- u u- uu -u u--	dactylic hexameter	masculine penthemimeral, hepthemimeral
εἰς ἕτερον γάρ τίς τε ἴδεν ἔργοιο χατίζων	- uu- - - u u- --u u--	dactylic hexameter	masculine penthemimeral, hepthemimeral, trithemimeral
πλούσιον, ὃς σπεύδειμὲν ἀρώμεναι ἠδὲ φυτεύειν	-uu - --u u-uu -u u--	dactylic hexameter	feminine penthemimeral, trithemimeral
οἶκόν τ’εὖ θέσθαι·ζηλοῖ δέ τε γείτονα γείτων	-- - ---- u u -uu --	dactylic hexameter	hepthemimeral, trithemimeral
εἰς ἄφενος σπεύδοντ’· ἀγαθὴ δ’Ἔρις ἥδε βροτοῖσιν.	- uu- -- uu- uu -u u--	dactylic hexameter	masculine penthemimeral, hepthemimeral, trithemimeral
καὶ κεραμεὺς κεραμεῖκοτέει καὶ τέκτονι τέκτων,	- uu- uu-uu- - -uu --	dactylic hexameter	hepthemimeral, trithemimeral
καὶ πτωχὸς πτωχῷ φθονέει καὶ ἀοιδὸς ἀοιδῷ.	- -- -- uu- u u-u u--	dactylic hexameter	masculine penthemimeral, hepthemimeral, trithemimeral
ὦ Πέρση, σὺ δὲ ταῦτα τεῷ ἐνικάτθεο θυμῷ,	- -- u u -u u- uu-uu --	dactylic hexameter	feminine penthemimeral, hepthemimeral, trithemimeral
μηδέ σ’Ἔρις κακόχαρτος ἀπ’ ἔργου θυμὸν ἐρύκοι	-u u- uu-u u -- -u u--	dactylic hexameter	feminine penthemimeral, trithemimeral
νείκε’ ὀπιπεύοντ’ ἀγορῆς ἐπακουὸν ἐόντα.	-u u--- uu- uu-u u--	dactylic hexameter	masculine penthemimeral, hepthemimeral
ὤρη γάρ τ’ὀλίγη πέλεται νεικέων τ’ἀγορέων	-- - uu- uu- --u u--	dactylic hexameter	masculine penthemimeral, hepthemimeral, trithemimeral
ᾧτινι μὴ βίος ἔνδον ἐπηετανὸς κατάκειται	-uu - uu -u u-uu- uu--	dactylic hexameter	feminine penthemimeral, trithemimeral
ὡραῖος, τὸν γαῖα φέρει, Δημήτερος ἀκτήν.	--- - -u u- --uu --	dactylic hexameter	feminine penthemimeral, hepthemimeral, trithemimeral
τοῦ κε κορεσσάμενος νείκεα καὶ δῆριν ὀφέλλοις	- u u-uu- -- - -u u--	dactylic hexameter	masculine penthemimeral, hepthemimeral
κτήμασ’ ἐπ’ ἀλλοτρίοις.σοὶ δ’οὐκέτι δεύτερον ἔσται	-u u -uu-- -uu -uu --	dactylic hexameter	
ὧδ’ ἔρδειν· ἀλλ’ αὖθι διακρινώμεθα νεῖκος	- -- - -u u---uu --	dactylic hexameter	feminine penthemimeral, trithemimeral
ἰθείῃσι δίκῃς, αἵ τ’ἐκ Διός εἰσιν ἄρισται.	---u u- - - uu -u u--	dactylic hexameter	masculine penthemimeral, hepthemimeral
ἤδη μὲν γὰρ κλῆρον ἐδασσάμεθ’, ἄλλα τε πολλὰ	-- - - -u u-uu -u u --	dactylic hexameter	feminine penthemimeral, trithemimeral
ἁρπάζων ἐφόρειςμέγα κυδαίνων βασιλῆας	--- uu-uu --- uu--	dactylic hexameter	trithemimeral
δωροφάγους, οἳ τήνδε δίκην ἐθέλουσι δικάσσαι.	-uu- - -u u- uu-u u--	dactylic hexameter	feminine penthemimeral, hepthemimeral, trithemimeral
νήπιοι, οὐδὲ ἴσασιν ὅσῳ πλέον ἥμισυ παντὸς	-uu -u u-u u- uu -uu --	dactylic hexameter	feminine penthemimeral, hepthemimeral
οὐδ’ ὅσον ἐν μαλάχῃ τε καὶ ἀσφοδέλῳ μέγ’ ὄνειαρ.	- uu - uu- u u -uu- u u--	dactylic hexameter	masculine penthemimeral, trithemimeral
κρύψαντες γὰρ ἔχουσι θεοὶ βίον ἀνθρώποισιν.	--- u u-u u- uu ----	dactylic hexameter	feminine penthemimeral, hepthemimeral, trithemimeral
ῥηϊδίως γάρ κεν καὶ ἐπ’ ἤματι ἐργάσσαιο,	-uu- - - u u -uu ----	dactylic hexameter	masculine penthemimeral, trithemimeral
ὥστε σε κεἰς ἐνιαυτὸν ἔχειν καὶ ἀεργὸν ἐόντα·	-u u - uu-u u- u u-u u--	dactylic hexameter	feminine penthemimeral, hepthemimeral, trithemimeral
αἶψά κε πηδάλιον μὲν ὑπὲρ καπνοῦ καταθεῖο,	-u u -uu- u u- -- uu--	dactylic hexameter	masculine penthemimeral, hepthemimeral
ἔργα βοῶν δ’ἀπόλοιτο καὶ ἡμιόνων ταλαεργῶν.	-u u- uu-u u -uu- uu--	dactylic hexameter	feminine penthemimeral, trithemimeral
ἀλλὰ Ζεὺς ἔκρυψε χολωσάμενος φρεσὶ ᾗσιν,	-- - --u u-uu- uu --	dactylic hexameter	feminine penthemimeral, trithemimeral
ὅττι μιν ἐξαπάτησε Προμηθεὺς ἀγκυλομήτης·	-u u -uu-u u-- -uu--	dactylic hexameter	feminine penthemimeral
τοὔνεκ’ ἄρ’ ἀνθρώποισιν ἐμήσατο κήδεα λυγρά,	-u u ---u u-uu -uu --	dactylic hexameter	feminine penthemimeral
κρύψε δὲ πῦρ· τὸ μὲν αὖτις ἐῢς πάϊς Ἰαπετοῖο	-u u - u u -u u- uu -uu--	dactylic hexameter	feminine penthemimeral, hepthemimeral, trithemimeral
ἔκλεψ’ ἀνθρώποισι Διὸς παρὰ μητιόεντος	-- ---u u- uu -uu--	dactylic hexameter	feminine penthemimeral, hepthemimeral
ἐν κοίλῳ νάρθηκι, λαθὼν Δία τερπικέραυνον.	- -- --u u- uu -uu--	dactylic hexameter	feminine penthemimeral, hepthemimeral, trithemimeral
τὸν δὲ χολωσάμενος προσέφη νεφεληγερέτα Ζεύς·	- u u-uu- uu- uu-uu- -	dactylic hexameter	masculine penthemimeral, hepthemimeral
"Ἰαπετιονίδη, πάντων πέρι μήδεα εἰδώς,	-uu-uu- -- uu -uu --	dactylic hexameter	masculine penthemimeral, hepthemimeral
χαίρεις πῦρ κλέψας καὶ ἐμὰς φρένας ἠπεροπεύσας,	-- - -- u u- uu -uu--	dactylic hexameter	masculine penthemimeral, hepthemimeral, trithemimeral
σοί τ’αὐτῷ μέγα πῆμα καὶ ἀνδράσιν ἐσσομένοισιν.	- -- uu -u u -uu -uu--	dactylic hexameter	feminine penthemimeral, trithemimeral
τοῖς δ’ἐγὼ ἀντὶ πυρὸς δώσω κακόν, ᾧ κεν ἅπαντες	- uu -u u- -- uu - u u--	dactylic hexameter	masculine penthemimeral, hepthemimeral
τέρπωνται κατὰ θυμὸν ἑὸν κακὸν ἀμφαγαπῶντες."	--- -- uu - uu -uu--	dactylic hexameter	masculine penthemimeral, hepthemimeral, trithemimeral
ὣς ἔφατ’, ἐκ δ’ἐγέλασσε πατὴρ ἀνδρῶν τε θεῶν τε·	- uu - uu-u u- -- u u- -	dactylic hexameter	feminine penthemimeral, hepthemimeral, trithemimeral
Ἥφαιστον δ’ἐκέλευσε περικλυτὸν ὅττι τάχιστα	--- uu-u u-uu -u u--	dactylic hexameter	feminine penthemimeral, trithemimeral
γαῖαν ὕδει φύρειν,ἐν δ’ἀνθρώπου θέμεν αὐδὴν	-u u- --- --- uu --	dactylic hexameter	trithemimeral
καὶ σθένος, ἀθανάτῃς δὲ θεῇς εἰς ὦπα ἐΐσκειν	- uu -uu- u u- - -u u--	dactylic hexameter	masculine penthemimeral, hepthemimeral
παρθενικῆς καλὸν εἶδος ἐπήρατον· αὐτὰρ Ἀθήνην	-uu- uu -u u-uu -u u--	dactylic hexameter	feminine penthemimeral, trithemimeral
ἔργα διδασκῆσαι, πολυδαίδαλον ἱστὸν ὑφαίνειν·	-u u--- uu-uu -u u--	dactylic hexameter	masculine penthemimeral
καὶ χάριν ἀμφιχέαι κεφαλῇ χρυσέην Ἀφροδίτην	- uu -uu- uu- uu- uu--	dactylic hexameter	masculine penthemimeral, hepthemimeral
καὶ πόθον ἀργαλέον καὶ γυιοβόρους μελεδώνας·	- uu -uu- - -uu- uu--	dactylic hexameter	masculine penthemimeral
ἐν δὲ θέμεν κύνεόν τε νόον καὶ ἐπίκλοπον ἦθος	- u u- uu- u u- u u-uu --	dactylic hexameter	masculine penthemimeral, hepthemimeral, trithemimeral
Ἑρμείην ἤνωγε, διάκτορον ἀργεϊφόντην.	--- --u u-uu -uu--	dactylic hexameter	feminine penthemimeral, trithemimeral
ὣς ἔφαθ’, οἳ δ’ἐπίθοντο Διῒ Κρονίωνι ἄνακτι	- uu - uu-u u- uu-u u--	dactylic hexameter	feminine penthemimeral, hepthemimeral, trithemimeral
αὐτίκα δ’ἐκ γαίης πλάσσε κλυτὸς Ἀμφιγυήεις	-uu - -- -- uu -uu--	dactylic hexameter	masculine penthemimeral, hepthemimeral, trithemimeral
παρθένῳ αἰδοίῃ ἴκελον Κρονίδεω διὰ βουλάς·	-uu --- uu- uu- uu --	dactylic hexameter	masculine penthemimeral, hepthemimeral
ζῶσε δὲ καὶ κόσμησε θεὰ γλαυκῶπις Ἀθήνη·	-u u - --u u- --u u--	dactylic hexameter	feminine penthemimeral, hepthemimeral, trithemimeral
ἀμφὶ δέ οἱ Χάριτές τε θεαὶ καὶ πότνια Πειθὼ	-u u - uu- u u- - -uu --	dactylic hexameter	masculine penthemimeral, hepthemimeral, trithemimeral
ὅρμους χρυσείουςἔθεσαν χροΐ· ἀμφὶ δὲ τήν γε	-- ---uu- uu -u u - -	dactylic hexameter	hepthemimeral
Ὧραι καλλίκομοιστέφον ἄνθεσι εἰαρινοῖσιν·	-- -uu-uu -uu -uu--	dactylic hexameter	
πάντα δέ οἱ χροῒ κόσμον ἐφήρμοσε Παλλὰς Ἀθήνη·	-u u - uu -u u-uu -u u--	dactylic hexameter	feminine penthemimeral, trithemimeral
ἐν δ’ἄρα οἱ στήθεσσι διάκτορος ἀργεϊφόντης	- uu - --u u-uu -uu--	dactylic hexameter	feminine penthemimeral, trithemimeral
ψεύδεά θ’αἱμυλίους τε λόγους καὶ ἐπίκλοπον ἦθος	-uu -uu- u u- u u-uu --	dactylic hexameter	masculine penthemimeral, hepthemimeral
τεῦξε Διὸς βουλῇσι βαρυκτύπου· ἐν δ’ἄρα φωνὴν	-u u- --u u-uu - uu --	dactylic hexameter	feminine penthemimeral, trithemimeral
θῆκε θεῶν κῆρυξ, ὀνόμηνε δὲ τήνδε γυναῖκα	-u u- -- uu-u u -u u--	dactylic hexameter	masculine penthemimeral, trithemimeral
Πανδώρην, ὅτι πάντες Ὀλύμπια δώματ’ ἔχοντες	--- uu -u u-uu -u u--	dactylic hexameter	feminine penthemimeral, trithemimeral
δῶρον ἐδώρησαν, πῆμ’ ἀνδράσιν ἀλφηστῇσιν.	-u u--- - -uu ----	dactylic hexameter	masculine penthemimeral
αὐτὰρ ἐπεὶ δόλον αἰπὺν ἀμήχανον ἐξετέλεσσεν,	-u u- uu -u u-uu -uu--	dactylic hexameter	feminine penthemimeral, trithemimeral
εἰς Ἐπιμηθέα πέμπε πατὴρ κλυτὸν ἀργεϊφόντην	- uu-uu -u u- uu -uu--	dactylic hexameter	feminine penthemimeral, hepthemimeral
δῶρον ἄγοντα, θεῶν ταχὺν ἄγγελον· οὐδ’ Ἐπιμηθεὺς	-u u-u u- uu -uu - uu--	dactylic hexameter	masculine penthemimeral
ἐφράσαθ’ ὥς οἱ ἔειπε Προμηθεὺς μή ποτε δῶρον	-uu - u u-u u-- - uu --	dactylic hexameter	feminine penthemimeral, trithemimeral
δέξασθαι πὰρ Ζηνὸς Ὀλυμπίου, ἀλλ’ ἀποπέμπειν	--- - -u u-uu - uu--	dactylic hexameter	feminine penthemimeral, trithemimeral
ἐξοπίσω, μή πού τι κακὸν θνητοῖσι γένηται·	-uu- - - u u- --u u--	dactylic hexameter	masculine penthemimeral, hepthemimeral, trithemimeral
αὐτὰρ ὃ δεξάμενος, ὅτε δὴ κακὸν εἶχ’, ἐνόησε.	-u u -uu- uu - uu - uu--	dactylic hexameter	masculine penthemimeral, hepthemimeral
πρὶν μὲν γὰρ ζώεσκον ἐπὶ χθονὶ φῦλ’ ἀνθρώπων	- - - --u u- uu - ---	dactylic hexameter	feminine penthemimeral, hepthemimeral, trithemimeral
νόσφιν ἄτερ τε κακῶν καὶ ἄτερ χαλεποῖο πόνοιο	-u u- u u- u u- uu-u u--	dactylic hexameter	masculine penthemimeral, hepthemimeral, trithemimeral
νούσων τ’ἀργαλέων, αἵ τ’ἀνδράσι κῆρας ἔδωκαν.	-- -uu- - -uu -u u--	dactylic hexameter	masculine penthemimeral
αἶψα γὰρ ἐν κακότητι βροτοὶ καταγηράσκουσιν.	-u u - uu-u u- uu----	dactylic hexameter	feminine penthemimeral, hepthemimeral, trithemimeral
ἀλλὰ γυνὴ χείρεσσι πίθου μέγα πῶμ’ ἀφελοῦσα	-u u- --u u- uu - uu--	dactylic hexameter	feminine penthemimeral, hepthemimeral, trithemimeral
ἐσκέδασ’, ἀνθρώποισι δ’ ἐμήσατο κήδεα λυγρά.	-uu ---u u-uu -uu --	dactylic hexameter	feminine penthemimeral
μούνη δ’αὐτόθι Ἐλπὶς ἐν ἀρρήκτοισι δόμοισιν	-- -uu -u u ---u u--	dactylic hexameter	feminine penthemimeral
ἔνδον ἔμεινε πίθουὑπὸ χείλεσιν οὐδὲ θύραζε	-u u-u u-uu -uu -u u--	dactylic hexameter	
ἐξέπτη· πρόσθεν γὰρ ἐπέμβαλε πῶμα πίθοιο	--- -- u u-uu -u u--	dactylic hexameter	masculine penthemimeral, trithemimeral
αἰγιόχου βουλῇσι Διὸς νεφεληγερέταο.	-uu- --u u- uu-uu--	dactylic hexameter	feminine penthemimeral, hepthemimeral, trithemimeral
ἄλλα δὲ μυρία λυγρὰ κατ’ ἀνθρώπους ἀλάληται·	-u u -uu -u u --- uu--	dactylic hexameter	feminine penthemimeral
πλείη μὲν γὰρ γαῖα κακῶν, πλείη δὲ θάλασσα·	-- - - -u u- -- u u--	dactylic hexameter	feminine penthemimeral, hepthemimeral, trithemimeral
νοῦσοι δ’ἀνθρώποισιν ἐφ’ ἡμέρῃ, αἳ δ’ἐπὶ νυκτὶ	-- ---u u -uu - uu --	dactylic hexameter	feminine penthemimeral
αὐτόματοι φοιτῶσι κακὰ θνητοῖσι φέρουσαι	-uu- --u u- --u u--	dactylic hexameter	feminine penthemimeral, hepthemimeral, trithemimeral
σιγῇ, ἐπεὶ φωνὴν ἐξείλετο μητίετα Ζεύς.	-u u- -- --uu -uu- -	dactylic hexameter	masculine penthemimeral, trithemimeral
οὕτως οὔ τί πη ἔστι Διὸς νόον ἐξαλέασθαι.	-- - u u -u u- uu -uu--	dactylic hexameter	feminine penthemimeral, hepthemimeral, trithemimeral
εἰ δ’ἐθέλεις, ἕτερόν τοι ἐγὼ λόγον ἐκκορυφώσω	- uu- uu- u u- uu -uu--	dactylic hexameter	masculine penthemimeral, hepthemimeral, trithemimeral
εὖ καὶ ἐπισταμένως· σὺ δ’ἐνὶ φρεσὶ βάλλεο σῇσιν	- u u-uu- u u- uu -uu --	dactylic hexameter	masculine penthemimeral, hepthemimeral
ὡς ὁμόθεν γεγάασι θεοὶ θνητοί τ’ἄνθρωποι.	- uu- uu-u u- -- ---	dactylic hexameter	feminine penthemimeral, hepthemimeral, trithemimeral
χρύσεον μὲν πρώτιστα γένος μερόπων ἀνθρώπων	-- - --u u- uu- ---	dactylic hexameter	feminine penthemimeral, hepthemimeral, trithemimeral
ἀθάνατοι ποίησαν Ὀλύμπια δώματ’ ἔχοντες.	-uu- --u u-uu -u u--	dactylic hexameter	feminine penthemimeral, trithemimeral
οἳ μὲν ἐπὶ Κρόνου ἦσαν, ὅτ’ οὐρανῷ ἐμβασίλευεν·	- u u- uu -u u -uu -uu--	dactylic hexameter	feminine penthemimeral, trithemimeral
ὥστε θεοὶ δ’ἔζωον ἀκηδέα θυμὸν ἔχοντες	-u u- --u u-uu -u u--	dactylic hexameter	feminine penthemimeral, trithemimeral
νόσφιν ἄτερ τε πόνων καὶ ὀϊζύος, οὐδέ τι δειλὸν	-u u- u u- u u-uu -u u --	dactylic hexameter	masculine penthemimeral, trithemimeral
γῆρας ἐπῆν, αἰεὶ δὲ πόδας καὶ χεῖρας ὁμοῖοι	-u u- -- u u- - -u u--	dactylic hexameter	masculine penthemimeral, hepthemimeral, trithemimeral
τέρποντ’ ἐν θαλίῃσι, κακῶν ἔκτοσθεν ἁπάντων·	-- - uu-u u- --u u--	dactylic hexameter	feminine penthemimeral, hepthemimeral, trithemimeral
θνῆσκον δ’ὥσθ’ ὕπνῳ δεδμημένοι· ἐσθλὰ δὲ πάντα	-- - -- --uu -u u --	dactylic hexameter	masculine penthemimeral, trithemimeral
τοῖσιν ἔην· καρπὸνδ’ἔφερε ζείδωρος ἄρουρα	-u u- --uu- --u u--	dactylic hexameter	hepthemimeral, trithemimeral
αὐτομάτη πολλόν τε καὶ ἄφθονον· οἳ δ’ἐθελημοὶ	-uu- -- u u -uu - uu--	dactylic hexameter	masculine penthemimeral, trithemimeral
ἥσυχοι ἔργ’ ἐνέμοντο σὺν ἐσθλοῖσιν πολέεσσιν.	-uu - uu-u u --- uu--	dactylic hexameter	feminine penthemimeral, trithemimeral
αὐτὰρ ἐπεὶ δὴ τοῦτο γένος κατὰ γαῖα κάλυψε,	-u u- - -u u- uu -u u--	dactylic hexameter	feminine penthemimeral, hepthemimeral, trithemimeral
τοὶ μὲν δαίμονες ἁγνοὶ ἐπιχθόνιοι τελέθουσιν	- - -uu -u u-uu- uu--	dactylic hexameter	feminine penthemimeral
ἐσθλοί, ἀλεξίκακοι,φύλακες θνητῶν ἀνθρώπων,	-u u-uu-uu- -- ---	dactylic hexameter	hepthemimeral
οἵ ῥα φυλάσσουσίν τε δίκας καὶ σχέτλια ἔργα	- u u--- u u- - -uu --	dactylic hexameter	masculine penthemimeral, hepthemimeral
ἠέρα ἑσσάμενοιπάντη φοιτῶντες ἐπ’ αἶαν,	-uu -uu--- --u u --	dactylic hexameter	hepthemimeral
πλουτοδόται· καὶ τοῦτο γέρας βασιλήϊον ἔσχον.	-uu- - -u u- uu-uu --	dactylic hexameter	feminine penthemimeral, hepthemimeral, trithemimeral
δεύτερον αὖτε γένος πολὺ χειρότερον μετόπισθεν	-uu -u u- uu -uu- uu--	dactylic hexameter	masculine penthemimeral
ἀργύρεον ποίησαν Ὀλύμπια δώματ’ ἔχοντες,	-uu- --u u-uu -u u--	dactylic hexameter	feminine penthemimeral, trithemimeral
χρυσέῳ οὔτε φυὴν ἐναλίγκιον οὔτε νόημα·	-uu -u u- uu-uu -u u--	dactylic hexameter	masculine penthemimeral
ἀλλ’ ἑκατὸν μὲν παῖς ἔτεα παρὰ μητέρι κεδνῇ	- uu- - - uu- uu -uu --	dactylic hexameter	masculine penthemimeral, hepthemimeral, trithemimeral
ἐτρέφετ’ ἀτάλλων, μέγα νήπιος, ᾧ ἐνὶ οἴκῳ·	-uu --- uu -uu - uu --	dactylic hexameter	masculine penthemimeral
ἀλλ’ ὅτ’ ἄρ’ ἡβήσαι τε καὶ ἥβης μέτρον ἵκοιτο,	- u u --- u u -- -u u--	dactylic hexameter	masculine penthemimeral
παυρίδιον ζώεσκον ἐπὶ χρόνον, ἄλγε’ ἔχοντες	-uu- --u u- uu -u u--	dactylic hexameter	feminine penthemimeral, hepthemimeral, trithemimeral
ἀφραδίῃς· ὕβριν γὰρ ἀτάσθαλον οὐκ ἐδύναντο	-uu- -- u u-uu - uu--	dactylic hexameter	masculine penthemimeral, trithemimeral
ἀλλήλων ἀπέχειν,οὐδ’ ἀθανάτους θεραπεύειν	--- uu-- -uu- uu--	dactylic hexameter	trithemimeral
ἤθελον οὐδ’ ἔρδεινμακάρων ἱεροῖς ἐπὶ βωμοῖς,	-uu - --uu- uu- uu --	dactylic hexameter	hepthemimeral, trithemimeral
ᾗ θέμις ἀνθρώποιςκατὰ ἤθεα. τοὺς μὲν ἔπειτα	- uu ---uu -uu - u u--	dactylic hexameter	
Ζεὺς Κρονίδης ἔκρυψε χολούμενος, οὕνεκα τιμὰς	- uu- --u u-uu -uu --	dactylic hexameter	feminine penthemimeral, trithemimeral
οὐκ ἔδιδον μακάρεσσι θεοῖς οἳ Ὄλυμπον ἔχουσιν.	- uu- uu-u u- u u-u u--	dactylic hexameter	feminine penthemimeral, hepthemimeral, trithemimeral
αὐτὰρ ἐπεὶ καὶ τοῦτο γένος κατὰ γαῖα κάλυψε,	-u u- - -u u- uu -u u--	dactylic hexameter	feminine penthemimeral, hepthemimeral, trithemimeral
τοὶ μὲν ὑποχθόνιοιμάκαρες θνητοὶ καλέονται,	- u u-uu-uu- -- uu--	dactylic hexameter	hepthemimeral
δεύτεροι, ἀλλ’ ἔμπης τιμὴ καὶ τοῖσιν ὀπηδεῖ.	-uu - -- -- - -u u--	dactylic hexameter	masculine penthemimeral, hepthemimeral, trithemimeral
Ζεὺς δὲ πατὴρ τρίτον ἄλλο γένος μερόπων ἀνθρώπων	- u u- uu -u u- uu- ---	dactylic hexameter	feminine penthemimeral, hepthemimeral, trithemimeral
χάλκειον ποίησ’, οὐκ ἀργυρέῳ οὐδὲν ὁμοῖον,	--- -- - -uu -u u--	dactylic hexameter	masculine penthemimeral, trithemimeral
ἐκ μελιᾶν, δεινόν τε καὶ ὄβριμον· οἷσιν Ἄρηος	- uu- -- u u -uu -u u--	dactylic hexameter	masculine penthemimeral, trithemimeral
ἔργ’ ἔμελε στονόεντα καὶ ὕβριες, οὐδέ τι σῖτον	- uu- uu-u u -uu -u u --	dactylic hexameter	feminine penthemimeral, trithemimeral
ἤσθιον, ἀλλ’ ἀδάμαντος ἔχον κρατερόφρονα θυμόν.	-uu - uu-u u- uu-uu --	dactylic hexameter	feminine penthemimeral, hepthemimeral, trithemimeral
ἄπλαστοι· μεγάλη δὲ βίη καὶ χεῖρες ἄαπτοι	--- uu- u u- - -u u--	dactylic hexameter	masculine penthemimeral, hepthemimeral, trithemimeral
ἐξ ὤμων ἐπέφυκον ἐπὶ στιβαροῖσι μέλεσσι.	- -- uu-u u- uu-u u--	dactylic hexameter	feminine penthemimeral, hepthemimeral, trithemimeral
τῶν δ’ἦν χάλκεα μὲν τεύχεα, χάλκεοι δέ τε οἶκοι,	- - -uu - -- -- u u --	dactylic hexameter	masculine penthemimeral, hepthemimeral
χαλκῷ δ’εἰργάζοντο· μέλας δ’οὐκ ἔσκε σίδηρος.	-- ---u u- - -u u--	dactylic hexameter	feminine penthemimeral, hepthemimeral
καὶ τοὶ μὲν χείρεσσιν ὑπὸ σφετέρῃσι δαμέντες	- - - --u u- uu-u u--	dactylic hexameter	feminine penthemimeral, hepthemimeral, trithemimeral
βῆσαν ἐς εὐρώεντα δόμον κρυεροῦ Ἀΐδαο,	-u u ---u u- uu- uu--	dactylic hexameter	feminine penthemimeral, hepthemimeral
νώνυμνοι· θάνατος δὲ καὶ ἐκπάγλους περ ἐόντας	--- uu- u u --- u u--	dactylic hexameter	masculine penthemimeral, trithemimeral
εἷλε μέλας, λαμπρὸνδ’ἔλιπον φάος ἠελίοιο.	-u u- --uu- uu -uu--	dactylic hexameter	hepthemimeral, trithemimeral
αὐτὰρ ἐπεὶ καὶ τοῦτο γένος κατὰ γαῖα κάλυψεν,	-u u- - -u u- uu -u u--	dactylic hexameter	feminine penthemimeral, hepthemimeral, trithemimeral
αὖτις ἔτ’ ἄλλο τέταρτον ἐπὶ χθονὶ πουλυβοτείρῃ	-u u -u u-u u- uu -uu--	dactylic hexameter	feminine penthemimeral, hepthemimeral
Ζεὺς Κρονίδης ποίησε, δικαιότερον καὶ ἄρειον,	- uu- --u u-uu- u u--	dactylic hexameter	feminine penthemimeral, trithemimeral
ἀνδρῶν ἡρώων θεῖον γένος, οἳ καλέονται	-- --- -- uu - uu--	dactylic hexameter	masculine penthemimeral, hepthemimeral
ἡμίθεοι, προτέρη γενεὴ κατ’ ἀπείρονα γαῖαν.	-uu- uu- uu- u u-uu --	dactylic hexameter	masculine penthemimeral, hepthemimeral, trithemimeral
καὶ τοὺς μὲν πόλεμός τε κακὸς καὶ φύλοπις αἰνὴ	- - - uu- u u- - -uu --	dactylic hexameter	masculine penthemimeral, hepthemimeral, trithemimeral
τοὺς μὲν ὑφ’ ἑπταπύλῳ Θήβῃ, Καδμηΐδι γαίῃ,	- u u -uu- -- --uu --	dactylic hexameter	masculine penthemimeral, hepthemimeral
ὤλεσε μαρναμένουςμήλων ἕνεκ’ Οἰδιπόδαο,	-uu -uu--- uu -uu--	dactylic hexameter	hepthemimeral
τοὺς δὲ καὶ ἐν νήεσσιν ὑπὲρ μέγα λαῖτμα θαλάσσης	- u u - --u u- uu -u u--	dactylic hexameter	feminine penthemimeral, hepthemimeral, trithemimeral
ἐς Τροίην ἀγαγὼν Ἑλένης ἕνεκ’ ἠϋκόμοιο.	- -- uu- uu- uu -uu--	dactylic hexameter	masculine penthemimeral, hepthemimeral, trithemimeral
ἔνθ’ ἦ τοι τοὺς μὲν θανάτου τέλος ἀμφεκάλυψε	- - - - - uu- uu -uu--	dactylic hexameter	masculine penthemimeral, hepthemimeral, trithemimeral
τοῖς δὲ δίχ’ ἀνθρώπων βίοτον καὶ ἤθε’ ὀπάσσας	- u u --- uu- - -u u--	dactylic hexameter	masculine penthemimeral, hepthemimeral
Ζεὺς Κρονίδης κατένασσε πατὴρ ἐς πείρατα γαίης.	- uu- uu-u u- - -uu --	dactylic hexameter	feminine penthemimeral, hepthemimeral, trithemimeral
καὶ τοὶ μὲν ναίουσιν ἀκηδέα θυμὸν ἔχοντες	- - - --u u-uu -u u--	dactylic hexameter	feminine penthemimeral, trithemimeral
ἐν μακάρων νήσοισι παρ’ Ὠκεανὸν βαθυδίνην,	- uu- --u u -uu- uu--	dactylic hexameter	feminine penthemimeral, trithemimeral
ὄλβιοι ἥρωες, τοῖσιν μελιηδέα καρπὸν	-uu --- -- uu-uu --	dactylic hexameter	masculine penthemimeral, hepthemimeral
τρὶς ἔτεος θάλλοντα φέρει ζείδωρος ἄρουρα.	- uu- --u u- --u u--	dactylic hexameter	feminine penthemimeral, hepthemimeral, trithemimeral
μηκέτ’ ἔπειτ’ ὤφελλον ἐγὼ πέμπτοισι μετεῖναι	-u u- --u u- --u u--	dactylic hexameter	feminine penthemimeral, hepthemimeral, trithemimeral
ἀνδράσιν, ἀλλ’ ἢ πρόσθε θανεῖν ἢ ἔπειτα γενέσθαι.	-uu - - -u u- u u-u u--	dactylic hexameter	feminine penthemimeral, hepthemimeral, trithemimeral
νῦν γὰρ δὴ γένος ἐστὶ σιδήρεον· οὐδέ ποτ’ ἦμαρ	- - - uu -u u-uu -u u --	dactylic hexameter	feminine penthemimeral, trithemimeral
παύσονται καμάτου καὶ ὀϊζύος οὐδέ τι νύκτωρ	--- uu- u u-uu -u u --	dactylic hexameter	masculine penthemimeral, trithemimeral
φθειρόμενοι· χαλεπὰς δὲ θεοὶ δώσουσι μερίμνας.	-uu- uu- u u- --u u--	dactylic hexameter	masculine penthemimeral, hepthemimeral, trithemimeral
ἀλλ’ ἔμπης καὶ τοῖσι μεμείξεται ἐσθλὰ κακοῖσιν.	- -- - -u u-uu -u u--	dactylic hexameter	feminine penthemimeral, trithemimeral
Ζεὺς δ’ὀλέσει καὶ τοῦτο γένος μερόπων ἀνθρώπων,	- uu- - -u u- uu- ---	dactylic hexameter	feminine penthemimeral, hepthemimeral, trithemimeral
εὖτ’ ἂν γεινόμενοι πολιοκρόταφοι τελέθωσιν.	- - -uu- uu-uu- uu--	dactylic hexameter	masculine penthemimeral
οὐδὲ πατὴρ παίδεσσιν ὁμοίϊος οὐδέ τι παῖδες	-u u- --u u-uu -u u --	dactylic hexameter	feminine penthemimeral, trithemimeral
οὐδὲ ξεῖνος ξεινοδόκῳ καὶ ἑταῖρος ἑταίρῳ,	-- -- -uu- u u-u u--	dactylic hexameter	hepthemimeral
οὐδὲ κασίγνητος φίλος ἔσσεται, ὡς τὸ πάρος περ.	-u u--- uu -uu - u u- -	dactylic hexameter	masculine penthemimeral
αἶψα δὲ γηράσκοντας ἀτιμήσουσι τοκῆας·	-u u ---u u---u u--	dactylic hexameter	feminine penthemimeral
μέμψονται δ’ἄρα τοὺς χαλεποῖς βάζοντες ἔπεσσι,	--- uu - uu- --u u--	dactylic hexameter	masculine penthemimeral, hepthemimeral, trithemimeral
σχέτλιοι, οὐδὲ θεῶν ὄπιν εἰδότες· οὐδέ κεν οἵ γε	-uu -u u- uu -uu -u u - -	dactylic hexameter	masculine penthemimeral
γηράντεσσι τοκεῦσιν ἀπὸ θρεπτήρια δοῖεν·	---u u-u u- --uu --	dactylic hexameter	feminine penthemimeral, hepthemimeral
χειροδίκαι· ἕτεροςδ’ἑτέρου πόλιν ἐξαλαπάξει·	-uu- uu-uu- uu -uu--	dactylic hexameter	hepthemimeral, trithemimeral
οὐδέ τις εὐόρκουχάρις ἔσσεται οὐδὲ δικαίου	-u u ---uu -uu -u u--	dactylic hexameter	
οὐδ’ ἀγαθοῦ, μᾶλλον δὲ κακῶν ῥεκτῆρα καὶ ὕβριν	- uu- -- u u- --u u --	dactylic hexameter	masculine penthemimeral, hepthemimeral, trithemimeral
ἀνέρα τιμήσουσι· δίκη δ’ἐν χερσί· καὶ αἰδὼς	-uu ---u u- - -u u --	dactylic hexameter	feminine penthemimeral, hepthemimeral
οὐκ ἔσται, βλάψειδ’ὁ κακὸς τὸν ἀρείονα φῶτα	- -- --u u- u u-uu --	dactylic hexameter	feminine penthemimeral, hepthemimeral, trithemimeral
μύθοισι σκολιοῖςἐνέπων, ἐπὶ δ’ὅρκον ὀμεῖται.	--- uu-uu- uu -u u--	dactylic hexameter	hepthemimeral, trithemimeral
ζῆλος δ’ἀνθρώποισιν ὀϊζυροῖσιν ἅπασι	-- ---u u---u u--	dactylic hexameter	feminine penthemimeral
δυσκέλαδος κακόχαρτος ὁμαρτήσει στυγερώπης.	-uu- uu-u u--- uu--	dactylic hexameter	feminine penthemimeral, trithemimeral
καὶ τότε δὴ πρὸς Ὄλυμπον ἀπὸ χθονὸς εὐρυοδείης	- uu - u u-u u- uu -uu--	dactylic hexameter	feminine penthemimeral, hepthemimeral, trithemimeral
λευκοῖσιν φάρεσσι καλυψαμένω χρόα καλὸν	--- --u u-uu- uu --	dactylic hexameter	feminine penthemimeral, trithemimeral
ἀθανάτων μετὰ φῦλον ἴτον προλιπόντ’ ἀνθρώπους	-uu- uu -u u- uu- ---	dactylic hexameter	feminine penthemimeral, hepthemimeral, trithemimeral
Αἰδὼς καὶ Νέμεσις· τὰ δὲ λείψεται ἄλγεα λυγρὰ	-- - uu- u u -uu -uu --	dactylic hexameter	masculine penthemimeral, trithemimeral
θνητοῖς ἀνθρώποισι· κακοῦ δ’οὐκ ἔσσεται ἀλκή.	-- ---u u- - -uu --	dactylic hexameter	feminine penthemimeral, hepthemimeral
νῦν δ’αἶνον βασιλεῦσιν ἐρέω φρονέουσι καὶ αὐτοῖς·	- -- uu-u u- uu-u u --	dactylic hexameter	feminine penthemimeral, hepthemimeral, trithemimeral
ὧδ’ ἴρηξ προσέειπεν ἀηδόνα ποικιλόδειρον	- -- uu-u u-uu -uu--	dactylic hexameter	feminine penthemimeral, trithemimeral
ὕψι μάλ’ ἐν νεφέεσσι φέρων ὀνύχεσσι μεμαρπώς·	-u u - uu-u u- uu-u u--	dactylic hexameter	feminine penthemimeral, hepthemimeral, trithemimeral
ἣ δ’ἐλεόν, γναμπτοῖσι πεπαρμένη ἀμφ’ ὀνύχεσσι,	- uu- --u u-uu - uu--	dactylic hexameter	feminine penthemimeral, trithemimeral
μύρετο· τὴν ὅ γ’ἐπικρατέως πρὸς μῦθον ἔειπεν·	-uu - u u-uu- - -u u--	dactylic hexameter	hepthemimeral, trithemimeral
"δαιμονίη, τί λέληκας; ἔχει νύ σε πολλὸν ἀρείων·	-uu- u u-u u- u u -u u--	dactylic hexameter	feminine penthemimeral, hepthemimeral, trithemimeral
τῇ δ’εἶς ᾗ σ’ἂν ἐγώ περ ἄγω καὶ ἀοιδὸν ἐοῦσαν·	- - - u u- u u- u u-u u--	dactylic hexameter	masculine penthemimeral, hepthemimeral, trithemimeral
δεῖπνον δ’,αἴ κ’ἐθέλω, ποιήσομαι ἠὲ μεθήσω.	-- - uu- --uu -u u--	dactylic hexameter	masculine penthemimeral, trithemimeral
ἄφρων δ’,ὅς κ’ἐθέλῃ πρὸς κρείσσονας ἀντιφερίζειν·	-- - uu- - -uu -uu--	dactylic hexameter	masculine penthemimeral, trithemimeral
νίκης τε στέρεταιπρός τ’αἴσχεσιν ἄλγεα πάσχει."	-- - uu-- -uu -uu --	dactylic hexameter	trithemimeral
ὣς ἔφατ’ ὠκυπέτης ἴρηξ, τανυσίπτερος ὄρνις.	- uu -uu- -- uu-uu --	dactylic hexameter	masculine penthemimeral, hepthemimeral
ὦ Πέρση, σὺ δ’ἄκουε δίκης μηδ’ ὕβριν ὄφελλε·	- -- u u-u u- - -u u--	dactylic hexameter	feminine penthemimeral, hepthemimeral, trithemimeral
ὕβρις γάρ τε κακὴ δειλῷ βροτῷ, οὐδὲ μὲν ἐσθλὸς	-- - u u- -- uu -u u --	dactylic hexameter	masculine penthemimeral, hepthemimeral, trithemimeral
ῥηϊδίως φερέμεν δύναται, βαρύθει δέ θ’ὑπ’ αὐτῆς	-uu- uu- uu- uu- u u --	dactylic hexameter	masculine penthemimeral, hepthemimeral, trithemimeral
ἐγκύρσας ἄτῃσιν· ὁδὸς δ’ἑτέρηφι παρελθεῖν	--- --u u- uu-u u--	dactylic hexameter	feminine penthemimeral, hepthemimeral, trithemimeral
κρείσσων ἐς τὰ δίκαια· δίκη δ’ὑπὲρ ὕβριος ἴσχει	-- - u u-u u- uu -uu --	dactylic hexameter	feminine penthemimeral, hepthemimeral, trithemimeral
ἐς τέλος ἐξελθοῦσα· παθὼν δέ τε νήπιος ἔγνω.	- uu ---u u- u u -uu --	dactylic hexameter	feminine penthemimeral, hepthemimeral
αὐτίκα γὰρ τρέχει Ὅρκος ἅμα σκολιῇσι δίκῃσιν·	-uu - uu -u u- uu-u u--	dactylic hexameter	feminine penthemimeral, hepthemimeral, trithemimeral
τῆς δὲ Δίκης ῥόθος ἑλκομένης ᾗ κ’ἄνδρες ἄγωσι	- u u- uu -uu- - -u u--	dactylic hexameter	hepthemimeral, trithemimeral
δωροφάγοι, σκολιῇς δὲ δίκῃς κρίνωσι θέμιστας·	-uu- uu- u u- --u u--	dactylic hexameter	masculine penthemimeral, hepthemimeral, trithemimeral
ἣ δ’ἕπεται κλαίουσα πόλιν καὶ ἤθεα λαῶν,	- uu- --u u- - -uu --	dactylic hexameter	feminine penthemimeral, hepthemimeral, trithemimeral
ἠέρα ἑσσαμένη, κακὸν ἀνθρώποισι φέρουσα,	-uu -uu- uu ---u u--	dactylic hexameter	masculine penthemimeral
οἵ τέ μιν ἐξελάσωσι καὶ οὐκ ἰθεῖαν ἔνειμαν.	- u u -uu-u u - --u u--	dactylic hexameter	feminine penthemimeral, hepthemimeral
οἳ δὲ δίκας ξείνοισι καὶ ἐνδήμοισι διδοῦσιν	- u u- --u u ---u u--	dactylic hexameter	feminine penthemimeral, trithemimeral
ἰθείας καὶ μή τι παρεκβαίνουσι δικαίου,	--- - - u u---u u--	dactylic hexameter	masculine penthemimeral, trithemimeral
τοῖσι τέθηλε πόλις, λαοὶ δ’ἀνθεῦσιν ἐν αὐτῇ·	-u u-u u- -- --u u --	dactylic hexameter	masculine penthemimeral, hepthemimeral
εἰρήνη δ’ἀνὰ γῆν κουροτρόφος, οὐδέ ποτ’ αὐτοῖς	--- uu - --uu -u u --	dactylic hexameter	masculine penthemimeral, trithemimeral
ἀργαλέον πόλεμον τεκμαίρεται εὐρύοπα Ζεύς·	-uu- uu- --uu -uu- -	dactylic hexameter	masculine penthemimeral, trithemimeral
οὐδέ ποτ’ ἰθυδίκῃσι μετ’ ἀνδράσι λιμὸς ὀπηδεῖ	-u u -uu-u u -uu -u u--	dactylic hexameter	feminine penthemimeral
οὐδ’ ἄτη, θαλίῃς δὲ μεμηλότα ἔργα νέμονται.	- -- uu- u u-uu -u u--	dactylic hexameter	masculine penthemimeral, trithemimeral
τοῖσι φέρει μὲν γαῖα πολὺν βίον, οὔρεσι δὲ δρῦς	-u u- - -u u- uu -uu - -	dactylic hexameter	feminine penthemimeral, hepthemimeral, trithemimeral
ἄκρη μέν τε φέρειβαλάνους, μέσση δὲ μελίσσας·	-- - u u-uu- -- u u--	dactylic hexameter	hepthemimeral, trithemimeral
εἰροπόκοι δ’ὄϊες μαλλοῖς καταβεβρίθασι·	-uu- uu- -- uu----	dactylic hexameter	masculine penthemimeral, hepthemimeral, trithemimeral
τίκτουσιν δὲ γυναῖκες ἐοικότα τέκνα γονεῦσι·	--- u u-u u-uu -u u--	dactylic hexameter	feminine penthemimeral, trithemimeral
θάλλουσιν δ’ἀγαθοῖσι διαμπερές· οὐδ’ ἐπὶ νηῶν	--- uu-u u-uu - uu --	dactylic hexameter	feminine penthemimeral, trithemimeral
νίσονται, καρπὸν δὲ φέρει ζείδωρος ἄρουρα.	--- -- u u- --u u--	dactylic hexameter	masculine penthemimeral, hepthemimeral, trithemimeral
οἷς δ’ὕβρις τε μέμηλε κακὴ καὶ σχέτλια ἔργα,	- -- u u-u u- - -uu --	dactylic hexameter	feminine penthemimeral, hepthemimeral, trithemimeral
τοῖς δὲ δίκην Κρονίδης τεκμαίρεται εὐρύοπα Ζεύς.	- u u- uu- --uu -uu- -	dactylic hexameter	masculine penthemimeral, trithemimeral
πολλάκι καὶ ξύμπασα πόλις κακοῦ ἀνδρὸς ἀπηύρα,	-uu - --u u- uu -u u--	dactylic hexameter	feminine penthemimeral, hepthemimeral, trithemimeral
ὅστις ἀλιτραίνῃ καὶ ἀτάσθαλα μηχανάαται.	-u u--- u u-uu -uu--	dactylic hexameter	masculine penthemimeral
τοῖσιν δ’οὐρανόθεν μέγ’ ἐπήγαγε πῆμα Κρονίων,	-- -uu- u u-uu -u u--	dactylic hexameter	masculine penthemimeral
λιμὸν ὁμοῦ καὶ λοιμόν, ἀποφθινύθουσι δὲ λαοί·	-u u- - -u u-uu-u u --	dactylic hexameter	feminine penthemimeral, trithemimeral
οὐδὲ γυναῖκες τίκτουσιν, μινύθουσι δὲ οἶκοι	-u u-- --- uu-u u --	dactylic hexameter	hepthemimeral
Ζηνὸς φραδμοσύνῃσιν Ὀλυμπίου· ἄλλοτε δ’αὖτε	-- -uu-u u-uu -uu --	dactylic hexameter	feminine penthemimeral
ἢ τῶν γε στρατὸν εὐρὺν ἀπώλεσεν ἢ ὅ γε τεῖχος	- - - uu -u u-uu - u u --	dactylic hexameter	feminine penthemimeral, trithemimeral
ἢ νέας ἐν πόντῳ Κρονίδης ἀποτείνυται αὐτῶν.	- uu - -- uu- uu-uu --	dactylic hexameter	masculine penthemimeral, hepthemimeral, trithemimeral
ὦ βασιλῆς, ὑμεῖς δὲ καταφράζεσθε καὶ αὐτοὶ	- uu- -- u u---u u --	dactylic hexameter	masculine penthemimeral, trithemimeral
τήνδε δίκην· ἐγγὺς γὰρ ἐν ἀνθρώποισιν ἐόντες	-u u- -- u u ---u u--	dactylic hexameter	masculine penthemimeral, trithemimeral
ἀθάνατοι φράζονται ὅσοι σκολιῇσι δίκῃσιν	-uu- --u u- uu-u u--	dactylic hexameter	feminine penthemimeral, hepthemimeral, trithemimeral
ἀλλήλους τρίβουσι θεῶν ὄπιν οὐκ ἀλέγοντες.	--- --u u- uu - uu--	dactylic hexameter	feminine penthemimeral, hepthemimeral, trithemimeral
τρὶς γὰρ μύριοί εἰσιν ἐπὶ χθονὶ πουλυβοτείρῃ	- - -uu -u u- uu -uu--	dactylic hexameter	feminine penthemimeral, hepthemimeral
ἀθάνατοι Ζηνὸς φύλακες θνητῶν ἀνθρώπων,	-uu- -- uu- -- ---	dactylic hexameter	masculine penthemimeral, hepthemimeral, trithemimeral
οἵ ῥα φυλάσσουσίν τε δίκας καὶ σχέτλια ἔργα	- u u--- u u- - -uu --	dactylic hexameter	masculine penthemimeral, hepthemimeral
ἠέρα ἑσσάμενοι,πάντη φοιτῶντες ἐπ’ αἶαν.	-uu -uu--- --u u --	dactylic hexameter	hepthemimeral
ἡ δέ τε παρθένος ἐστὶ Δίκη, Διὸς ἐκγεγαυῖα,	- u u -uu -u u- uu -uu--	dactylic hexameter	feminine penthemimeral, hepthemimeral
κυδρή τ’αἰδοίη τε θεοῖς οἳ Ὄλυμπον ἔχουσιν,	-- --- u u- u u-u u--	dactylic hexameter	masculine penthemimeral, hepthemimeral
καί ῥ’ὁπότ’ ἄν τίς μιν βλάπτῃ σκολιῶς ὀνοτάζων,	- uu - - - -- uu- uu--	dactylic hexameter	masculine penthemimeral, hepthemimeral, trithemimeral
αὐτίκα πὰρ Διῒ πατρὶ καθεζομένη Κρονίωνι	-uu - uu -u u-uu- uu--	dactylic hexameter	feminine penthemimeral, trithemimeral
γηρύετ’ ἀνθρώπων ἀδίκων νόον, ὄφρ’ ἀποτείσῃ	-uu --- uu- uu - uu--	dactylic hexameter	masculine penthemimeral, hepthemimeral
δῆμος ἀτασθαλίας βασιλέων οἳ λυγρὰ νοεῦντες	-u u-uu- uu- - -u u--	dactylic hexameter	masculine penthemimeral, hepthemimeral
ἄλλῃ παρκλίνωσι δίκας σκολιῶς ἐνέποντες.	-- ---u u- uu- uu--	dactylic hexameter	feminine penthemimeral, hepthemimeral
ταῦτα φυλασσόμενοι, βασιλῆς, ἰθύνετε μύθους,	-u u-uu- uu- --uu --	dactylic hexameter	masculine penthemimeral, hepthemimeral
δωροφάγοι, σκολιέων δὲ δικέων ἐπὶ πάγχυ λάθεσθ	-uu- uu-u u -u u- uu --	dactylic hexameter	feminine penthemimeral, trithemimeral
οἷ αὐτῷ κακὰ τεύχει ἀνὴρ ἄλλῳ κακὰ τεύχων,	- -- uu -u u- -- uu --	dactylic hexameter	feminine penthemimeral, hepthemimeral, trithemimeral
ἡ δὲ κακὴ βουλὴ τῷ βουλεύσαντι κακίστη.	- u u- -- - ---u u--	dactylic hexameter	masculine penthemimeral, trithemimeral
πάντα ἰδὼν Διὸς ὀφθαλμὸς καὶ πάντα νοήσας	-u u- uu --- - -u u--	dactylic hexameter	hepthemimeral, trithemimeral
καί νυ τάδ’, αἴ κ’ἐθέλῃσ’, ἐπιδέρκεται, οὐδέ ἑ λήθει	- u u - uu- uu-uu -u u --	dactylic hexameter	masculine penthemimeral, trithemimeral
οἵην δὴ καὶ τήνδε δίκην πόλις ἐντὸς ἐέργει.	-- - - -u u- uu -u u--	dactylic hexameter	feminine penthemimeral, hepthemimeral, trithemimeral
νῦν δὴ ἐγὼ μήτ’ αὐτὸς ἐν ἀνθρώποισι δίκαιος	- u u- - -u u ---u u--	dactylic hexameter	feminine penthemimeral, trithemimeral
εἴην μήτ’ ἐμὸς υἱός, ἐπεὶ κακὸν ἄνδρα δίκαιον	-- - uu -u u- uu -u u--	dactylic hexameter	feminine penthemimeral, hepthemimeral, trithemimeral
ἔμμεναι, εἰ μείζω γε δίκην ἀδικώτερος ἕξει.	-uu - -- u u- uu-uu --	dactylic hexameter	masculine penthemimeral, hepthemimeral, trithemimeral
ἀλλὰ τά γ’οὔπω ἔολπα τελεῖν Δία μητιόεντα.	-u u -u u-u u- uu -uu--	dactylic hexameter	feminine penthemimeral, hepthemimeral
ὦ Πέρση, σὺ δὲ ταῦτα μετὰ φρεσὶ βάλλεο σῇσι	- -- u u -u u- uu -uu --	dactylic hexameter	feminine penthemimeral, hepthemimeral, trithemimeral
καί νυ δίκης ἐπάκουε, βίης δ’ἐπιλήθεο πάμπαν.	- u u- uu-u u- uu-uu --	dactylic hexameter	feminine penthemimeral, hepthemimeral, trithemimeral
τόνδε γὰρ ἀνθρώποισι νόμον διέταξε Κρονίων,	-u u ---u u- uu-u u--	dactylic hexameter	feminine penthemimeral, hepthemimeral
ἰχθύσι μὲν καὶ θηρσὶ καὶ οἰωνοῖς πετεηνοῖς	-uu - - -u u --- uu--	dactylic hexameter	feminine penthemimeral, trithemimeral
ἔσθειν ἀλλήλους,ἐπεὶ οὐ δίκη ἐστὶ μετ’ αὐτοῖς·	-- ---uu - uu -u u --	dactylic hexameter	hepthemimeral
ἀνθρώποισι δ’ἔδωκε δίκην, ἣ πολλὸν ἀρίστη	---u u-u u- - -u u--	dactylic hexameter	feminine penthemimeral, hepthemimeral
γίνεται· εἰ γάρ τίς κ’ἐθέλῃ τὰ δίκαι’ ἀγορεῦσαι	-uu - - - uu- u u- uu--	dactylic hexameter	masculine penthemimeral, hepthemimeral, trithemimeral
γινώσκων, τῷ μέν τ’ὄλβον διδοῖ εὐρύοπα Ζεύς·	--- - - -- uu -uu- -	dactylic hexameter	masculine penthemimeral, hepthemimeral, trithemimeral
ὃς δέ κε μαρτυρίῃσιν ἑκὼν ἐπίορκον ὀμόσσας	- u u -uu-u u- uu-u u--	dactylic hexameter	feminine penthemimeral, hepthemimeral
ψεύσεται, ἐν δὲ δίκην βλάψας νήκεστον ἀασθῇ,	-uu - u u- -- --u u--	dactylic hexameter	masculine penthemimeral, hepthemimeral, trithemimeral
τοῦ δέ τ’ἀμαυροτέρη γενεὴ μετόπισθε λέλειπται·	- u u-uu- uu- uu-u u--	dactylic hexameter	masculine penthemimeral, hepthemimeral
ἀνδρὸς δ’εὐόρκουγενεὴ μετόπισθεν ἀμείνων.	-- ---uu- uu-u u--	dactylic hexameter	hepthemimeral
σοὶ δ’ἐγὼ ἐσθλὰ νοέωνἐρέω, μέγα νήπιε Πέρση·	- uu -u u-uu- uu -uu --	dactylic hexameter	hepthemimeral
τὴν μέν τοι κακότητα καὶ ἰλαδὸν ἔστιν ἑλέσθαι	- - - uu-u u -uu -u u--	dactylic hexameter	feminine penthemimeral, trithemimeral
ῥηϊδίως· λείη μὲν ὁδός, μάλα δ’ἐγγύθι ναίει·	-uu- -- u u- uu -uu --	dactylic hexameter	masculine penthemimeral, hepthemimeral, trithemimeral
τῆς δ’ἀρετῆς ἱδρῶτα θεοὶ προπάροιθεν ἔθηκαν	- uu- --u u- uu-u u--	dactylic hexameter	feminine penthemimeral, hepthemimeral, trithemimeral
ἀθάνατοι· μακρὸς δὲ καὶ ὄρθιος οἶμος ἐς αὐτὴν	-uu- -- u u -uu -u u --	dactylic hexameter	masculine penthemimeral, trithemimeral
καὶ τρηχὺς τὸ πρῶτον· ἐπὴν δ’εἰς ἄκρον ἵκηται,	- -- - -u u- - -u u--	dactylic hexameter	feminine penthemimeral, hepthemimeral, trithemimeral
ῥηϊδίη δὴ ἔπειτα πέλει, χαλεπή περ ἐοῦσα.	-uu- u u-u u- uu- u u--	dactylic hexameter	feminine penthemimeral, hepthemimeral, trithemimeral
οὗτος μὲν πανάριστος, ὃς αὐτῷ πάντα νοήσει	-- - uu-u u -- -u u--	dactylic hexameter	feminine penthemimeral, trithemimeral
φρασσάμενος τά κ’ἔπειτα καὶ ἐς τέλος ᾖσιν ἀμείνω·	-uu- u u-u u - uu -u u--	dactylic hexameter	feminine penthemimeral, hepthemimeral, trithemimeral
ἐσθλὸς δ’αὖ κἀκεῖνος ὃς εὖ εἰπόντι πίθηται·	-- - --u u - --u u--	dactylic hexameter	feminine penthemimeral, hepthemimeral, trithemimeral
ὃς δέ κε μήτ’ αὐτῷ νοέῃ μήτ’ ἄλλου ἀκούων	- u u - -- uu- - -u u--	dactylic hexameter	masculine penthemimeral, hepthemimeral, trithemimeral
ἐν θυμῷ βάλληται, ὃ δ’αὖτ’ ἀχρήϊος ἀνήρ.	- -- --u u - --uu --	dactylic hexameter	feminine penthemimeral, hepthemimeral, trithemimeral
ἀλλὰ σύ γ’ἡμετέρης μεμνημένος αἰὲν ἐφετμῆς	-u u -uu- --uu -u u--	dactylic hexameter	masculine penthemimeral
ἐργάζευ, Πέρση, δῖον γένος, ὄφρα σε Λιμὸς	--- -- -- uu -u u --	dactylic hexameter	masculine penthemimeral, hepthemimeral, trithemimeral
ἐχθαίρῃ, φιλέῃ δέ σ’ἐϋστέφανος Δημήτηρ	--- uu- u u-uu- ---	dactylic hexameter	masculine penthemimeral, trithemimeral
αἰδοίη, βιότου δὲ τεὴν πιμπλῇσι καλιήν·	--- uu- u u- --u u--	dactylic hexameter	masculine penthemimeral, hepthemimeral, trithemimeral
Λιμὸς γάρ τοι πάμπαν ἀεργῷ σύμφορος ἀνδρί·	-- - - -u u-- -uu --	dactylic hexameter	feminine penthemimeral, trithemimeral
τῷ δὲ θεοὶ νεμεσῶσι καὶ ἀνέρες ὅς κεν ἀεργὸς	- u u- uu-u u -uu - u u--	dactylic hexameter	feminine penthemimeral, trithemimeral
ζώῃ, κηφήνεσσι κοθούροις εἴκελος ὀργήν,	-- ---u u-- -uu --	dactylic hexameter	feminine penthemimeral
οἵ τε μελισσάων κάματον τρύχουσιν ἀεργοὶ	- u u--- uu- --u u--	dactylic hexameter	masculine penthemimeral, hepthemimeral
ἔσθοντες· σοὶ δ’ἔργα φίλ’ ἔστω μέτρια κοσμεῖν,	--- - -u u -- -uu --	dactylic hexameter	feminine penthemimeral, trithemimeral
ὥς κέ τοι ὡραίουβιότου πλήθωσι καλιαί.	- u u ---uu- --u u--	dactylic hexameter	hepthemimeral
ἐξ ἔργων δ’ἄνδρες πολύμηλοί τ’ἀφνειοί τε,	- -- -- uu-- --- -	dactylic hexameter	masculine penthemimeral, trithemimeral
καί τ’ἐργαζόμενος πολὺ φίλτερος ἀθανάτοισιν	- --uu- uu -uu -uu--	dactylic hexameter	masculine penthemimeral
ἔσσεαι ἠδὲ βροτοῖς·μάλα γὰρ στυγέουσιν ἀεργούς.	-uu -u u-uu - uu-u u--	dactylic hexameter	hepthemimeral
ἔργον δ’οὐδὲν ὄνειδος, ἀεργίη δέ τ’ὄνειδος.	-- -u u-u u--- u u--	dactylic hexameter	feminine penthemimeral
εἰ δέ κεν ἐργάζῃ, τάχα σε ζηλώσει ἀεργὸς	- u u --- uu - --u u--	dactylic hexameter	masculine penthemimeral, hepthemimeral
πλουτεῦντα· πλούτῳδ’ἀρετὴ καὶ κῦδος ὀπηδεῖ.	--- --uu- - -u u--	dactylic hexameter	hepthemimeral, trithemimeral
δαίμονι δ’οἷος ἔησθα, τὸ ἐργάζεσθαι ἄμεινον,	-uu -u u-u u ---u u--	dactylic hexameter	feminine penthemimeral
εἴ κεν ἀπ’ ἀλλοτρίων κτεάνων ἀεσίφρονα θυμὸν	- u u -uu- uu- uu-uu --	dactylic hexameter	masculine penthemimeral, hepthemimeral
ἐς ἔργον τρέψας μελετᾷς βίου, ὥς σε κελεύω.	- -- -- uu- uu - u u--	dactylic hexameter	masculine penthemimeral, hepthemimeral, trithemimeral
αἰδὼς δ’οὐκ ἀγαθὴ κεχρημένον ἄνδρα κομίζει,	-- - uu- --uu -u u--	dactylic hexameter	masculine penthemimeral, trithemimeral
αἰδώς, ἥ τ’ἄνδρας μέγα σίνεται ἠδ’ ὀνίνησιν·	-- - -- uu -uu - uu--	dactylic hexameter	masculine penthemimeral, trithemimeral
αἰδώς τοι πρὸς ἀνολβίῃ, θάρσος δὲ πρὸς ὄλβῳ.	-- - u u--- -- u u --	dactylic hexameter	hepthemimeral, trithemimeral
χρήματα δ’οὐχ ἁρπακτά, θεόσδοτα πολλὸν ἀμείνω·	-uu - --u u-uu -u u--	dactylic hexameter	feminine penthemimeral, trithemimeral
εἰ γάρ τις καὶ χερσὶ βίῃ μέγαν ὄλβον ἕληται,	- - - - -u u- uu -u u--	dactylic hexameter	feminine penthemimeral, hepthemimeral, trithemimeral
ἢ ὅ γ’ἀπὸ γλώσσης ληΐσσεται, οἷά τε πολλὰ	- u u- -- --uu -u u --	dactylic hexameter	masculine penthemimeral, trithemimeral
γίνεται, εὖτ’ ἂν δὴ κέρδος νόον ἐξαπατήσῃ	-uu - - - -- uu -uu--	dactylic hexameter	masculine penthemimeral, hepthemimeral, trithemimeral
ἀνθρώπων, αἰδῶ δέ τ’ἀναιδείη κατοπάζῃ,	--- -- u u--- uu--	dactylic hexameter	masculine penthemimeral, trithemimeral
ῥεῖα δέ μιν μαυροῦσι θεοί, μινύθουσι δὲ οἶκον	-u u - --u u- uu-u u --	dactylic hexameter	feminine penthemimeral, hepthemimeral, trithemimeral
ἀνέρι τῷ, παῦρον δέ τ’ἐπὶ χρόνον ὄλβος ὀπηδεῖ.	-uu - -- u u- uu -u u--	dactylic hexameter	masculine penthemimeral, hepthemimeral, trithemimeral
̓̂ισον δ’ὅς θ’ἱκέτην ὅς τε ξεῖνον κακὸν ἔρξει,	-- - uu- - - -- uu --	dactylic hexameter	masculine penthemimeral, hepthemimeral, trithemimeral
ὅς τε κασιγνήτοιο ἑοῦ ἀνὰ δέμνια βαίνῃ	- u u---u u -- -uu --	dactylic hexameter	feminine penthemimeral
κρυπταδίῃς εὐνῇς ἀλόχου, παρακαίρια ῥέζων,	-uu- -- uu- uu-uu --	dactylic hexameter	masculine penthemimeral, hepthemimeral, trithemimeral
ὅς τέ τευ ἀφραδίῃς ἀλιταίνητ’ ὀρφανὰ τέκνα,	- u u -uu- uu-- -uu --	dactylic hexameter	masculine penthemimeral
ὅς τε γονῆα γέροντα κακῷ ἐπὶ γήραος οὐδῷ	- u u-u u-u u- uu -uu --	dactylic hexameter	feminine penthemimeral, hepthemimeral
νεικείῃ χαλεποῖσι καθαπτόμενος ἐπέεσσι·	--- uu-u u-uu- uu--	dactylic hexameter	feminine penthemimeral, trithemimeral
τῷ δ’ἦ τοι Ζεὺς αὐτὸς ἀγαίεται, ἐς δὲ τελευτὴν	- - - - -u u-uu - u u--	dactylic hexameter	feminine penthemimeral, trithemimeral
ἔργων ἀντ’ ἀδίκων χαλεπὴν ἐπέθηκεν ἀμοιβήν.	-- - uu- uu- uu-u u--	dactylic hexameter	masculine penthemimeral, hepthemimeral, trithemimeral
ἀλλὰ σὺ τῶν μὲν πάμπαν ἔεργ’ ἀεσίφρονα θυμόν.	-u u - - -u u- uu-uu --	dactylic hexameter	feminine penthemimeral, hepthemimeral, trithemimeral
κὰδ δύναμιν δ’ἔρδεινἱέρ’ ἀθανάτοισι θεοῖσιν	- uu- --uu -uu-u u--	dactylic hexameter	trithemimeral
ἁγνῶς καὶ καθαρῶς, ἐπὶ δ’ἀγλαὰ μηρία καίειν·	-- - uu- uu -uu -uu --	dactylic hexameter	masculine penthemimeral, trithemimeral
ἄλλοτε δὲ σπονδῇσι θύεσσί τε ἱλάσκεσθαι,	-uu - --u u-u u ----	dactylic hexameter	feminine penthemimeral, trithemimeral
ἠμὲν ὅτ’ εὐνάζῃ καὶ ὅτ’ ἂν φάος ἱερὸν ἔλθῃ,	-u u --- u u - uu -uu --	dactylic hexameter	masculine penthemimeral, hepthemimeral
ὥς κέ τοι ἵλαον κραδίην καὶ θυμὸν ἔχωσιν,	- u u --- uu- - -u u--	dactylic hexameter	masculine penthemimeral, hepthemimeral
ὄφρ’ ἄλλων ὠνῇ κλῆρον, μὴ τὸν τεὸν ἄλλος.	- -- -- -- - - uu --	dactylic hexameter	masculine penthemimeral, hepthemimeral, trithemimeral
τὸν φιλέοντ’ ἐπὶ δαῖτα καλεῖν, τὸν δ’ἐχθρὸν ἐᾶσαι·	- uu- uu -u u- - -u u--	dactylic hexameter	feminine penthemimeral, hepthemimeral, trithemimeral
τὸν δὲ μάλιστα καλεῖνὅστις σέθεν ἐγγύθι ναίει·	- u u-u u--- uu -uu --	dactylic hexameter	hepthemimeral
εἰ γάρ τοι καὶ χρῆμ’ ἐγκώμιον ἄλλο γένηται,	- - - - - --uu -u u--	dactylic hexameter	masculine penthemimeral, trithemimeral
γείτονες ἄζωστοιἔκιον, ζώσαντο δὲ πηοί.	-uu ---uu- --u u --	dactylic hexameter	hepthemimeral
πῆμα κακὸς γείτων, ὅσσον τ’ἀγαθὸς μέγ’ ὄνειαρ·	-u u- -- -- uu- u u--	dactylic hexameter	masculine penthemimeral, hepthemimeral, trithemimeral
ἔμμορέ τοι τιμῆς ὅς τ’ἔμμορε γείτονος ἐσθλοῦ·	-uu - -- - -uu -uu --	dactylic hexameter	masculine penthemimeral, trithemimeral
οὐδ’ ἂν βοῦς ἀπόλοιτ’,εἰ μὴ γείτων κακὸς εἴη.	- - - uu-- - -- uu --	dactylic hexameter	hepthemimeral, trithemimeral
εὖ μὲν μετρεῖσθαιπαρὰ γείτονος, εὖ δ’ἀποδοῦναι,	- - ---uu -uu - uu--	dactylic hexameter	
αὐτῷ τῷ μέτρῳ, καὶ λώιον αἴ κε δύνηαι,	-- - -- - -uu - u u--	dactylic hexameter	masculine penthemimeral, trithemimeral
ὡς ἂν χρηΐζων καὶ ἐς ὕστερον ἄρκιον εὕρῃς.	- - --- u u -uu -uu --	dactylic hexameter	masculine penthemimeral
μὴ κακὰ κερδαίνειν·κακὰ κέρδεα ἶσ’ ἄτῃσι.	- uu ---uu -uu - ---	dactylic hexameter	
τὸν φιλέοντα φιλεῖν,καὶ τῷ προσιόντι προσεῖναι.	- uu-u u-- - uu-u u--	dactylic hexameter	hepthemimeral
καὶ δόμεν ὅς κεν δῷ καὶ μὴ δόμεν ὅς κεν μὴ δῷ·	- uu - - - - - uu - - - -	dactylic hexameter	masculine penthemimeral, hepthemimeral, trithemimeral
δώτῃ μέν τις ἔδωκεν, ἀδώτῃ δ’οὔ τις ἔδωκεν·	-- - u u-u u-- - u u--	dactylic hexameter	feminine penthemimeral, trithemimeral
δὼς ἀγαθή, ἅρπαξ δὲ κακή, θανάτοιο δότειρα·	- uu- -- u u- uu-u u--	dactylic hexameter	masculine penthemimeral, hepthemimeral, trithemimeral
ὃς μὲν γάρ κεν ἀνὴρ ἐθέλων, ὅ γε καὶ μέγα, δώῃ,	- - - u u- uu- u u - uu --	dactylic hexameter	masculine penthemimeral, hepthemimeral, trithemimeral
χαίρει τῷ δώρῳ καὶ τέρπεται ὃν κατὰ θυμόν·	-- - -- - -uu - uu --	dactylic hexameter	masculine penthemimeral, trithemimeral
ὃς δέ κεν αὐτὸς ἕληται ἀναιδείηφι πιθήσας,	- u u -u u-u u---u u--	dactylic hexameter	feminine penthemimeral
καί τε σμικρὸν ἐόν, τό γ’ἐπάχνωσεν φίλον ἦτορ.	- - -u u- u u--- uu --	dactylic hexameter	masculine penthemimeral
εἰ γάρ κεν καὶ σμικρὸν ἐπὶ σμικρῷ καταθεῖο	- - - - -u u- -- uu--	dactylic hexameter	feminine penthemimeral, hepthemimeral, trithemimeral
καὶ θαμὰ τοῦτ’ ἔρδοις,τάχα κεν μέγα καὶ τὸ γένοιτο·	- uu - --uu - uu - u u--	dactylic hexameter	hepthemimeral, trithemimeral
ὃς δ’ἐπ’ ἐόντι φέρει,ὃ δ’ἀλέξεται αἴθοπα λιμόν.	- u u-u u-u u-uu -uu --	dactylic hexameter	feminine penthemimeral
οὐδὲ τό γ’εἰν οἴκῳ κατακείμενον ἀνέρα κήδει·	-u u - -- uu-uu -uu --	dactylic hexameter	masculine penthemimeral, trithemimeral
οἴκοι βέλτερον εἶναι, ἐπεὶ βλαβερὸν τὸ θύρηφιν.	-- -uu -u u- uu- u u--	dactylic hexameter	feminine penthemimeral, hepthemimeral
ἐσθλὸν μὲν παρεόντος ἑλέσθαι, πῆμα δὲ θυμῷ	-- - uu-u u-- -u u --	dactylic hexameter	feminine penthemimeral, trithemimeral
χρηΐζειν ἀπεόντος· ἅ σε φράζεσθαι ἄνωγα.	--- uu-u u - --u u--	dactylic hexameter	feminine penthemimeral, hepthemimeral, trithemimeral
ἀρχομένου δὲ πίθουκαὶ λήγοντος κορέσασθαι,	-uu- u u-- --- uu--	dactylic hexameter	trithemimeral
μεσσόθι φείδεσθαι·δειλὴ δ’ἐν πυθμένι φειδώ.	-uu ----- - -uu --	dactylic hexameter	hepthemimeral
μισθὸς δ’ἀνδρὶ φίλῳ εἰρημένος ἄρκιος ἔστω·	-- -u u- --uu -uu --	dactylic hexameter	masculine penthemimeral
καί τε κασιγνήτῳ γελάσας ἐπὶ μάρτυρα θέσθαι·	- u u--- uu- uu -uu --	dactylic hexameter	masculine penthemimeral, hepthemimeral
πίστεις δ’ἄρα ὁμῶς καὶ ἀπιστίαι ὤλεσαν ἄνδρας.	-- -u u- u u-uu -uu --	dactylic hexameter	masculine penthemimeral
μηδὲ γυνή σε νόον πυγοστόλος ἐξαπατάτω	-u u- u u- --uu -uu--	dactylic hexameter	masculine penthemimeral, trithemimeral
αἱμύλα κωτίλλουσα, τεὴν διφῶσα καλιήν·	-uu ---u u- --u u--	dactylic hexameter	feminine penthemimeral, hepthemimeral
ὃς δὲ γυναικὶ πέποιθε, πέποιθ’ ὅ γε φιλήτῃσιν.	- u u-u u-u u- u u ----	dactylic hexameter	feminine penthemimeral, hepthemimeral
μουνογενὴς δὲ πάϊς εἴη πατρώϊον οἶκον	-uu- u u- -- --uu --	dactylic hexameter	masculine penthemimeral, hepthemimeral, trithemimeral
φερβέμεν· ὣς γὰρ πλοῦτος ἀέξεται ἐν μεγάροισιν·	-uu - - -u u-uu - uu--	dactylic hexameter	feminine penthemimeral, trithemimeral
γηραιὸς δὲ θάνοιἕτερον παῖδ’ ἐγκαταλείπων.	--- u u-uu- - -uu--	dactylic hexameter	hepthemimeral, trithemimeral
ῥεῖα δέ κεν πλεόνεσσι πόροι Ζεὺς ἄσπετον ὄλβον·	-u u - uu-u u- - -uu --	dactylic hexameter	feminine penthemimeral, hepthemimeral, trithemimeral
πλείων μὲν πλεόνων μελέτη, μείζων δ’ἐπιθήκη.	-- - uu- uu- -- uu--	dactylic hexameter	masculine penthemimeral, hepthemimeral, trithemimeral
σοὶ δ’εἰ πλούτου θυμὸς ἐέλδεται ἐν φρεσὶ σῇσιν,	- - -- -u u-uu - uu --	dactylic hexameter	feminine penthemimeral
ὧδ’ ἔρδειν, καὶ ἔργον ἐπ’ ἔργῳ ἐργάζεσθαι.	- -- - -u u -- ----	dactylic hexameter	feminine penthemimeral, trithemimeral
Πληϊάδων Ἀτλαγενέων ἐπιτελλομενάων	-uu- --uu- uu-uu--	dactylic hexameter	hepthemimeral, trithemimeral
ἄρχεσθ’ ἀμήτου,ἀρότοιο δὲ δυσομενάων.	-- ---uu-u u -uu--	dactylic hexameter	
αἳ δή τοι νύκτας τε καὶ ἤματα τεσσαράκοντα	- - - -- u u -uu -uu--	dactylic hexameter	masculine penthemimeral, trithemimeral
κεκρύφαται, αὖτις δὲ περιπλομένου ἐνιαυτοῦ	-uu- -- u u-uu- uu--	dactylic hexameter	masculine penthemimeral, trithemimeral
φαίνονται τὰ πρῶτα χαρασσομένοιο σιδήρου.	--- - -u u-uu-u u--	dactylic hexameter	feminine penthemimeral, trithemimeral
οὗτός τοι πεδίων πέλεται νόμος οἵ τε θαλάσσης	-- - uu- uu- uu - u u--	dactylic hexameter	masculine penthemimeral, hepthemimeral, trithemimeral
ἐγγύθι ναιετάουσ’οἵ τ’ἄγκεα βησσήεντα	-uu -uu-- -uu ----	dactylic hexameter	
πόντου κυμαίνοντος ἀπόπροθι, πίονα χῶρον,	-- ---u u-uu -uu --	dactylic hexameter	feminine penthemimeral
ναίουσιν· γυμνὸν σπείρειν, γυμνὸν δὲ βοωτεῖν,	--- -- -- -- u u--	dactylic hexameter	masculine penthemimeral, hepthemimeral, trithemimeral
γυμνὸν δ’ἀμάειν,εἴ χ’ὥρια πάντ’ ἐθέλῃσθα	-- ---- -uu - uu--	dactylic hexameter	
ἔργα κομίζεσθαιΔημήτερος, ὥς τοι ἕκαστα	-u u-----uu - u u--	dactylic hexameter	
ὥρι’ ἀέξηται,μή πως τὰ μέταζε χατίζων	-u u---- - u u-u u--	dactylic hexameter	hepthemimeral
πτώσσῃς ἀλλοτρίουςοἴκους καὶ μηδὲν ἀνύσσῃς.	-- -uu--- - -u u--	dactylic hexameter	hepthemimeral
ὡς καὶ νῦν ἐπ’ ἔμ’ ἦλθες· ἐγὼ δέ τοι οὐκ ἐπιδώσω	- - - u u -u u- u u - uu--	dactylic hexameter	feminine penthemimeral, hepthemimeral, trithemimeral
οὐδ’ ἐπιμετρήσω· ἐργάζευ, νήπιε Πέρση,	- uu--- --- -uu --	dactylic hexameter	masculine penthemimeral
ἔργα τά τ’ἀνθρώποισι θεοὶ διετεκμήραντο,	-u u ---u u- uu----	dactylic hexameter	feminine penthemimeral, hepthemimeral
μή ποτε σὺν παίδεσσι γυναικί τε θυμὸν ἀχεύων	- uu - --u u-u u -u u--	dactylic hexameter	feminine penthemimeral, trithemimeral
ζητεύῃς βίοτον κατὰ γείτονας, οἳ δ’ἀμελῶσιν.	--- uu- uu -uu - uu--	dactylic hexameter	masculine penthemimeral, trithemimeral
δὶς μὲν γὰρ καὶ τρὶς τάχα τεύξεαι· ἢν δ’ἔτι λυπῇς,	- - - - - uu -uu - uu --	dactylic hexameter	masculine penthemimeral, trithemimeral
χρῆμα μὲν οὐ πρήξεις,σὺ δ’ἐτώσια πόλλ’ ἀγορεύσεις,	-u u - --u u-uu - uu--	dactylic hexameter	feminine penthemimeral, trithemimeral
ἀχρεῖος δ’ἔσταιἐπέων νομός. ἀλλά σ’ἄνωγα	--- --uu- uu -u u--	dactylic hexameter	hepthemimeral, trithemimeral
φράζεσθαι χρειῶν τε λύσιν λιμοῦ τ’ἀλεωρήν.	--- -- u u- -- uu--	dactylic hexameter	masculine penthemimeral, hepthemimeral, trithemimeral
οἶκον μὲν πρώτιστα γυναῖκά τε βοῦν τ’ἀροτῆρα,	-- - --u u-u u - uu--	dactylic hexameter	feminine penthemimeral, trithemimeral
κτητήν, οὐ γαμετήν, ἥτις καὶ βουσὶν ἕποιτο,	-- - uu- -- - -u u--	dactylic hexameter	masculine penthemimeral, hepthemimeral, trithemimeral
χρήματα δ’εἰν οἴκῳ πάντ’ ἄρμενα ποιήσασθαι,	-uu - -- - -uu ----	dactylic hexameter	masculine penthemimeral, trithemimeral
μὴ σὺ μὲν αἰτῇς ἄλλον, ὃ δ’ἀρνῆται, σὺ δὲ τητᾷ,	- u u -- -u u --- u u --	dactylic hexameter	feminine penthemimeral
ἡ δ’ὥρη παραμείβηται, μινύθῃ δέ τοι ἔργον.	- -- uu--- uu- u u --	dactylic hexameter	hepthemimeral, trithemimeral
μηδ’ ἀναβάλλεσθαιἔς τ’αὔριον ἔς τε ἔνηφι·	- uu---- -uu - u u--	dactylic hexameter	
οὐ γὰρ ἐτωσιοεργὸς ἀνὴρ πίμπλησι καλιὴν	- u u-uu-u u- --u u--	dactylic hexameter	feminine penthemimeral, hepthemimeral
οὐδ’ ἀναβαλλόμενος· μελέτη δέ τοι ἔργον ὀφέλλει·	- uu-uu- uu- u u -u u--	dactylic hexameter	masculine penthemimeral, hepthemimeral
αἰεὶ δ’ἀμβολιεργὸς ἀνὴρ ἄτῃσι παλαίει.	-- -uu-u u- --u u--	dactylic hexameter	feminine penthemimeral, hepthemimeral
ἦμος δὴ λήγειμένος ὀξέος ἠελίοιο	-- - --uu -uu -uu--	dactylic hexameter	trithemimeral
καύματος ἰδαλίμου,μετοπωρινὸν ὀμβρήσαντος	-uu -uu-uu-uu ----	dactylic hexameter	
Ζηνὸς ἐρισθενέος, μετὰ δὲ τρέπεται βρότεος χρὼς	-u u-uu- uu - uu- uu- -	dactylic hexameter	masculine penthemimeral, hepthemimeral
πολλὸν ἐλαφρότερος· δὴ γὰρ τότε Σείριος ἀστὴρ	-u u-uu- - - uu -uu --	dactylic hexameter	masculine penthemimeral, hepthemimeral
βαιὸν ὑπὲρ κεφαλῆς κηριτρεφέων ἀνθρώπων	-u u- uu- --uu- ---	dactylic hexameter	masculine penthemimeral, trithemimeral
ἔρχεται ἠμάτιος, πλεῖον δέ τε νυκτὸς ἐπαυρεῖ·	-uu -uu- -- u u -u u--	dactylic hexameter	masculine penthemimeral, hepthemimeral
τῆμος ἀδηκτοτάτη πέλεται τμηθεῖσα σιδήρῳ	-u u-uu- uu- --u u--	dactylic hexameter	masculine penthemimeral, hepthemimeral
ὕλη, φύλλα δ’ἔραζε χέει, πτόρθοιό τε λήγει·	-- -u u-u u- --u u --	dactylic hexameter	feminine penthemimeral, hepthemimeral
τῆμος ἄρ’ ὑλοτομεῖνμεμνημένος ὥρια ἔργα·	-u u -uu---uu -uu --	dactylic hexameter	
ὄλμον μὲν τριπόδην τάμνειν, ὕπερον δὲ τρίπηχυν,	-- - uu- -- uu- u u--	dactylic hexameter	masculine penthemimeral, hepthemimeral, trithemimeral
ἄξονα δ’ἑπταπόδην· μάλα γάρ νύ τοι ἄρμενον οὕτω·	-uu -uu- uu - u u -uu --	dactylic hexameter	masculine penthemimeral, hepthemimeral
εἰ δέ κεν ὀκταπόδην, ἀπὸ καὶ σφῦράν κε τάμοιο.	- u u -uu- uu - -- u u--	dactylic hexameter	masculine penthemimeral, hepthemimeral
τρισπίθαμον δ’ἅψιν τάμνειν δεκαδώρῳ ἀμάξῃ,	-uu- -- -- uu-u u--	dactylic hexameter	masculine penthemimeral, hepthemimeral, trithemimeral
πόλλ’ ἐπικαμπύλα κᾶλα· φέρειν δὲ γύην, ὅτ’ ἂν εὕρῃς,	- uu-uu -u u- u u- u u --	dactylic hexameter	feminine penthemimeral, hepthemimeral
εἰς οἶκον, κατ’ ὄρος διζήμενος ἢ κατ’ ἄρουραν,	- -- u u- --uu - u u--	dactylic hexameter	masculine penthemimeral, trithemimeral
πρίνινον· ὃς γὰρ βουσὶν ἀροῦν ὀχυρώτατός ἐστιν,	-uu - - -u u- uu-uu --	dactylic hexameter	feminine penthemimeral, hepthemimeral, trithemimeral
εὖτ’ ἂν Ἀθηναίης δμῶος ἐν ἐλύματι πήξας	- u u--- -- u u-uu --	dactylic hexameter	masculine penthemimeral, hepthemimeral
γόμφοισιν πελάσας προσαρήρεται ἱστοβοῆι.	--- uu- uu-uu -uu--	dactylic hexameter	masculine penthemimeral, trithemimeral
δοιὰ δὲ θέσθαι ἄροτρα, πονησάμενος κατὰ οἶκον,	-u u -u u-u u-uu- uu --	dactylic hexameter	feminine penthemimeral
αὐτόγυον καὶ πηκτόν, ἐπεὶ πολὺ λώιον οὕτω·	-uu- - -u u- uu -uu --	dactylic hexameter	feminine penthemimeral, hepthemimeral, trithemimeral
εἴ χ’ἕτερον γ’ἄξαις,ἕτερόν κ’ἐπὶ βουσὶ βάλοιο.	- uu- --uu- uu -u u--	dactylic hexameter	hepthemimeral, trithemimeral
δάφνης δ’ἢ πτελέης ἀκιώτατοι ἱστοβοῆες.	-- - uu- uu-uu -uu--	dactylic hexameter	masculine penthemimeral, trithemimeral
δρυὸς ἔλυμα, πρίνου δὲ γύην. βόε δ’ἐνναετήρω	-u u-u u- u u- uu -uu--	dactylic hexameter	masculine penthemimeral, hepthemimeral
ἄρσενε κεκτῆσθαι·τῶν γὰρ σθένος οὐκ ἀλαπαδνόν·	-uu ---- - uu - uu--	dactylic hexameter	hepthemimeral
ἥβης μέτρον ἔχοντε· τὼ ἐργάζεσθαι ἀρίστω.	-- -u u-u u ---u u--	dactylic hexameter	feminine penthemimeral
οὐκ ἂν τώ γ’ἐρίσαντε ἐν αὔλακι κὰμ μὲν ἄροτρον	- - - uu-u u -uu - u u--	dactylic hexameter	feminine penthemimeral, trithemimeral
ἄξειαν, τὸ δὲ ἔργον ἐτώσιον αὖθι λίποιεν.	--- u u -u u-uu -u u--	dactylic hexameter	feminine penthemimeral, trithemimeral
τοῖς δ’ἅμα τεσσαρακονταετὴς αἰζηὸς ἕποιτο	- uu -uu-uu- --u u--	dactylic hexameter	hepthemimeral
ἄρτον δειπνήσας τετράτρυφον, ὀκτάβλωμον,	-- --- --uu ----	dactylic hexameter	masculine penthemimeral
ὅς κ’ἔργου μελετῶν ἰθείην αὔλακ’ ἐλαύνοι,	- -- uu- --- -u u--	dactylic hexameter	masculine penthemimeral, trithemimeral
μηκέτι παπταίνων μεθ’ ὁμήλικας, ἀλλ’ ἐπὶ ἔργῳ	-uu --- u u-uu - uu --	dactylic hexameter	masculine penthemimeral
θυμὸν ἔχων· τοῦ δ’οὔ τι νεώτερος ἄλλος ἀμείνων	-u u- - - u u-uu -u u--	dactylic hexameter	masculine penthemimeral, trithemimeral
σπέρματα δάσσασθαι καὶ ἐπισπορίην ἀλέασθαι·	-uu --- u u-uu- uu--	dactylic hexameter	masculine penthemimeral
κουρότερος γὰρ ἀνὴρ μεθ’ ὁμήλικας ἐπτοίηται.	-uu- u u- u u-uu ----	dactylic hexameter	masculine penthemimeral, trithemimeral
φράζεσθαι δ’,εὖτ’ ἂν γεράνου φωνὴν ἐπακούσῃς	--- - - uu- -- uu--	dactylic hexameter	masculine penthemimeral, hepthemimeral, trithemimeral
ὑψόθεν ἐκ νεφέων ἐνιαύσια κεκληγυίης,	-uu - uu- uu-uu ----	dactylic hexameter	masculine penthemimeral, trithemimeral
ἥ τ’ἀρότοιό τε σῆμα φέρει καὶ χείματος ὥρην	- uu-u u -u u- - -uu --	dactylic hexameter	feminine penthemimeral, hepthemimeral
δεικνύει ὀμβρηροῦ,κραδίην δ’ἔδακ’ ἀνδρὸς ἀβούτεω·	-uu ---uu- uu -u u--	dactylic hexameter	hepthemimeral
δὴ τότε χορτάζεινἕλικας βόας ἔνδον ἐόντας·	- uu ---uu- uu -u u--	dactylic hexameter	hepthemimeral
ῥηΐδιον γὰρ ἔπος εἰπεῖν· "βόε δὸς καὶ ἄμαξαν·"	-uu- u u- -- uu - u u--	dactylic hexameter	masculine penthemimeral, hepthemimeral, trithemimeral
ῥηΐδιον δ’ἀπανήνασθαι· "πάρα δ’ἔργα βόεσσιν."	-uu- uu--- uu -u u--	dactylic hexameter	hepthemimeral, trithemimeral
φησὶ δ’ἀνὴρ φρένας ἀφνειὸς πήξασθαι ἄμαξαν·	-u u- uu --- --u u--	dactylic hexameter	hepthemimeral, trithemimeral
νήπιος, οὐδὲ τὸ οἶδ’· ἑκατὸν δέ τε δούρατ’ ἀμάξης,	-uu -u u - uu- u u -u u--	dactylic hexameter	masculine penthemimeral, hepthemimeral
τῶν πρόσθεν μελέτην ἐχέμεν οἰκήϊα θέσθαι.	- -- uu- uu- --uu --	dactylic hexameter	masculine penthemimeral, hepthemimeral, trithemimeral
εὖτ’ ἂν δὴ πρώτιστ’ ἄροτος θνητοῖσι φανήῃ,	- - - -- uu- --u u--	dactylic hexameter	masculine penthemimeral, hepthemimeral, trithemimeral
δὴ τότ’ ἐφορμηθῆναι, ὁμῶς δμῶές τε καὶ αὐτός,	- u u---u u- -- u u --	dactylic hexameter	feminine penthemimeral, hepthemimeral
αὔην καὶ διερὴν ἀρόων ἀρότοιο καθ’ ὥρην,	-- - uu- uu- uu-u u --	dactylic hexameter	masculine penthemimeral, hepthemimeral, trithemimeral
πρῶϊ μάλα σπεύδων, ἵνα τοι πλήθωσιν ἄρουραι.	-u u- -- uu - --u u--	dactylic hexameter	masculine penthemimeral, hepthemimeral, trithemimeral
ἔαρι πολεῖν· θέρεος δὲ νεωμένη οὔ σ’ἀπατήσει·	-u u- uu- u u-uu - uu--	dactylic hexameter	masculine penthemimeral, trithemimeral
νειὸν δὲ σπείρεινἔτι κουφίζουσαν ἄρουραν.	-- - --uu ---u u--	dactylic hexameter	trithemimeral
νειὸς ἀλεξιάρη παίδων εὐκηλήτειρα.	-u u-uu- -- -----	dactylic hexameter	masculine penthemimeral, hepthemimeral
εὔχεσθαι δὲ Διῒ χθονίῳ Δημήτερί θ’ἁγνῇ	--- u u- uu- --uu --	dactylic hexameter	masculine penthemimeral, hepthemimeral, trithemimeral
ἐκτελέα βρίθεινΔημήτερος ἱερὸν ἀκτήν,	-uu- ----uu -uu --	dactylic hexameter	trithemimeral
ἀρχόμενος τὰ πρῶτ’ ἀρότου, ὅτ’ ἂν ἄκρον ἐχέτλης	-uu- - - uu- u u -u u--	dactylic hexameter	masculine penthemimeral, hepthemimeral, trithemimeral
χειρὶ λαβὼν ὅρπηκι βοῶν ἐπὶ νῶτον ἵκηαι	-u u- --u u- uu -u u--	dactylic hexameter	feminine penthemimeral, hepthemimeral, trithemimeral
ἔνδρυον ἑλκόντων μεσάβων. ὁ δὲ τυτθὸς ὄπισθε	-uu --- uu- u u -u u--	dactylic hexameter	masculine penthemimeral, hepthemimeral
δμῶος ἔχων μακέλην πόνον ὀρνίθεσσι τιθείη	-u u- uu- uu ---u u--	dactylic hexameter	masculine penthemimeral, trithemimeral
σπέρμα κατακρύπτων· εὐθημοσύνη γὰρ ἀρίστη	-u u--- --uu- u u--	dactylic hexameter	masculine penthemimeral
θνητοῖς ἀνθρώποις, κακοθημοσύνη δὲ κακίστη.	-- --- uu-uu- u u--	dactylic hexameter	masculine penthemimeral
ὧδέ κεν ἁδροσύνῃ στάχυες νεύοιεν ἔραζε,	-u u -uu- uu- --u u--	dactylic hexameter	masculine penthemimeral, hepthemimeral
εἰ τέλος αὐτὸς ὄπισθεν Ὀλύμπιος ἐσθλὸν ὀπάζοι,	- uu -u u-u u-uu -u u--	dactylic hexameter	feminine penthemimeral
ἐκ δ’ἀγγέων ἐλάσειας ἀράχνια, καί σε ἔολπα	- -- uu-u u-uu - u u--	dactylic hexameter	feminine penthemimeral, trithemimeral
γηθήσειν βιότουαἰρεύμενον ἔνδον ἐόντος.	--- uu---uu -u u--	dactylic hexameter	trithemimeral
εὐοχθέων δ’ἵξεαι πολιὸν ἔαρ οὐδὲ πρὸς ἄλλ	--- -- u-- uu -u u -	lyric	
αὐγάσεαι· σέο δ’ἄλλος ἀνὴρ κεχρημένος ἔσται.	-uu- uu -u u- --uu --	dactylic hexameter	feminine penthemimeral, hepthemimeral, trithemimeral
εἰ δέ κεν ἠελίοιο τροπῇς ἀρόῳς χθόνα δῖαν,	- u u -uu-u u- uu- uu --	dactylic hexameter	feminine penthemimeral, hepthemimeral
ἥμενος ἀμήσειςὀλίγον περὶ χειρὸς ἐέργων,	-uu ---uu- uu -u u--	dactylic hexameter	hepthemimeral
ἀντία δεσμεύων κεκονιμένος, οὐ μάλα χαίρων,	-uu --- uu-uu - uu --	dactylic hexameter	masculine penthemimeral
οἴσεις δ’ἐν φορμῷ· παῦροι δέ σε θηήσονται.	-- - -- -- u u ----	dactylic hexameter	masculine penthemimeral, hepthemimeral, trithemimeral
ἄλλοτε δ’ἀλλοῖος Ζηνὸς νόος αἰγιόχοιο,	-uu --- -- uu -uu--	dactylic hexameter	masculine penthemimeral, hepthemimeral
ἀργαλέος δ’ἄνδρεσσι καταθνητοῖσι νοῆσαι.	-uu- --u u---u u--	dactylic hexameter	feminine penthemimeral, trithemimeral
εἰ δή κ’ὄψ’ ἀρόσῃς, τόδε κέν τοι φάρμακον εἴη·	- - - uu- uu - - -uu --	dactylic hexameter	masculine penthemimeral, hepthemimeral, trithemimeral
ἦμος κόκκυξ κοκκύζει δρυὸς ἐν πετάλοισι	-- -- --- uu - uu--	dactylic hexameter	hepthemimeral
τὸ πρῶτον, τέρπει δὲ βροτοὺς ἐπ’ ἀπείρονα γαῖαν,	- -- -- u u- u u-uu --	dactylic hexameter	masculine penthemimeral, hepthemimeral, trithemimeral
τῆμος Ζεὺς ὕοιτρίτῳ ἤματι μηδ’ ἀπολήγοι,	-- - --uu -uu - uu--	dactylic hexameter	trithemimeral
μήτ’ ἄρ’ ὑπερβάλλων βοὸς ὁπλὴν μήτ’ ἀπολείπων·	- u u--- uu -- - uu--	dactylic hexameter	masculine penthemimeral
οὕτω κ’ὀψαρότης πρῳηρότῃ ἰσοφαρίζοι.	-- -uu- --uu -uu--	dactylic hexameter	masculine penthemimeral
ἐν θυμῷ δ’εὖ πάντα φυλάσσεο· μηδέ σε λήθοι	- -- - -u u-uu -u u --	dactylic hexameter	feminine penthemimeral, trithemimeral
μήτ’ ἔαρ γινόμενον πολιὸν μήθ’ ὥριος ὄμβρος.	- - -uu- uu- - -uu --	dactylic hexameter	masculine penthemimeral, hepthemimeral
πὰρ δ’ἴθι χάλκειον θῶκον καὶ ἐπαλέα λέσχην	- uu --- -- u u-uu --	dactylic hexameter	masculine penthemimeral, hepthemimeral
ὥρῃ χειμερίῃ, ὁπότε κρύος ἀνέρα ἔργων	-- -uu- uu- uu -uu --	dactylic hexameter	masculine penthemimeral, hepthemimeral
ἰσχάνει, ἔνθα κ’ἄοκνος ἀνὴρ μέγα οἶκον ὀφέλλοι,	-uu -u u-u u- uu -u u--	dactylic hexameter	feminine penthemimeral, hepthemimeral
μή σε κακοῦ χειμῶνος ἀμηχανίη καταμάρψῃ	- u u- --u u-uu- uu--	dactylic hexameter	feminine penthemimeral, trithemimeral
σὺν πενίῃ, λεπτῇ δὲ παχὺν πόδα χειρὶ πιέζῃς.	- uu- -- u u- uu -u u--	dactylic hexameter	masculine penthemimeral, hepthemimeral, trithemimeral
πολλὰ δ’ἀεργὸς ἀνήρ, κενεὴν ἐπὶ ἐλπίδα μίμνων,	-u u-u u- uu- uu -uu --	dactylic hexameter	masculine penthemimeral, hepthemimeral
χρηΐζων βιότοιο, κακὰ προσελέξατο θυμῷ.	--- uu-u u- uu-uu --	dactylic hexameter	feminine penthemimeral, hepthemimeral, trithemimeral
ἐλπὶς δ’οὐκ ἀγαθὴ κεχρημένον ἄνδρα κομίζει,	-- - uu- --uu -u u--	dactylic hexameter	masculine penthemimeral, trithemimeral
ἥμενον ἐν λέσχῃ, τῷ μὴ βίος ἄρκιος εἴη.	-uu - -- - - uu -uu --	dactylic hexameter	masculine penthemimeral, hepthemimeral, trithemimeral
δείκνυε δὲ δμώεσσι θέρευς ἔτι μέσσου ἐόντος·	-uu - --u u- uu -u u--	dactylic hexameter	feminine penthemimeral, hepthemimeral, trithemimeral
"οὐκ αἰεὶ θέρος ἐσσεῖται, ποιεῖσθε καλιάς."	- -- uu --- --u u--	dactylic hexameter	hepthemimeral, trithemimeral
μῆνα δὲ Ληναιῶνα, κάκ’ ἤματα, βουδόρα πάντα,	-u u ---u u -uu -uu --	dactylic hexameter	feminine penthemimeral
τοῦτον ἀλεύασθαικαὶ πηγάδας, αἵ τ’ἐπὶ γαῖαν	-u u---- -uu - uu --	dactylic hexameter	
πνεύσαντος Βορέαο δυσηλεγέες τελέθουσιν,	--- uu-u u-uu- uu--	dactylic hexameter	feminine penthemimeral, trithemimeral
ὅς τε διὰ Θρῄκης ἱπποτρόφου εὐρέϊ πόντῳ	- u u- -- --uu -uu --	dactylic hexameter	masculine penthemimeral, trithemimeral
ἐμπνεύσας ὤρινε, μέμυκε δὲ γαῖα καὶ ὕλη·	--- --u u-u u -u u --	dactylic hexameter	feminine penthemimeral, trithemimeral
πολλὰς δὲ δρῦς ὑψικόμους ἐλάτας τε παχείας	-- - - -uu- uu- u u--	dactylic hexameter	hepthemimeral, trithemimeral
οὔρεος ἐν βήσσῃς πιλνᾷ χθονὶ πουλυβοτείρῃ	-uu - -- -- uu -uu--	dactylic hexameter	masculine penthemimeral, hepthemimeral, trithemimeral
ἐμπίπτων, καὶ πᾶσα βοᾷ τότε νήριτος ὕλη·	--- - -u u- uu -uu --	dactylic hexameter	feminine penthemimeral, hepthemimeral, trithemimeral
θῆρες δὲ φρίσσουσ’,οὐρὰς δ’ὑπὸ μέζε’ ἔθεντο·	-- - ---- uu -u u--	dactylic hexameter	hepthemimeral, trithemimeral
τῶν καὶ λάχνῃ δέρμα κατάσκιον· ἀλλά νυ καὶ τῶν	- - -- -u u-uu -u u - -	dactylic hexameter	feminine penthemimeral
ψυχρὸς ἐὼν διάησι δασυστέρνων περ ἐόντων·	-u u- uu-u u--- u u--	dactylic hexameter	feminine penthemimeral, trithemimeral
καί τε διὰ ῥινοῦβοὸς ἔρχεται οὐδέ μιν ἴσχει,	- u u- --uu -uu -u u --	dactylic hexameter	trithemimeral
καί τε δι’ αἶγα ἄησι τανύτριχα· πώεα δ’οὔτι,	- u u -u u-u u-uu -uu --	dactylic hexameter	feminine penthemimeral
οὕνεκ’ ἐπηεταναὶτρίχες αὐτῶν, οὐ διάησι	-u u-uu-uu -- - uu--	dactylic hexameter	
ἲς ἀνέμου Βορέω· τροχαλὸν δὲ γέροντα τίθησιν	- uu- uu- uu- u u-u u--	dactylic hexameter	masculine penthemimeral, hepthemimeral, trithemimeral
καὶ διὰ παρθενικῆς ἁπαλόχροος οὐ διάησιν,	- uu -uu- uu-uu - uu--	dactylic hexameter	masculine penthemimeral
ἥ τε δόμων ἔντοσθε φίλῃ παρὰ μητέρι μίμνει,	- u u- --u u- uu -uu --	dactylic hexameter	feminine penthemimeral, hepthemimeral, trithemimeral
οὔπω ἔργα ἰδυῖα πολυχρύσου Ἀφροδίτης,	-- -u u-u u--- uu--	dactylic hexameter	feminine penthemimeral
εὖ τε λοεσσαμένη τέρενα χρόα καὶ λίπ’ ἐλαίῳ	- u u-uu- uu- uu - u u--	dactylic hexameter	masculine penthemimeral, hepthemimeral
χρισαμένη μυχίη καταλέξεται ἔνδοθι οἴκου,	-uu- uu- uu-uu -uu --	dactylic hexameter	masculine penthemimeral, trithemimeral
ἤματι χειμερίῳ, ὅτ’ ἀνόστεος ὃν πόδα τένδει	-uu -uu- u u-uu - uu --	dactylic hexameter	masculine penthemimeral
ἔν τ’ἀπύρῳ οἴκῳ καὶ ἤθεσι λευγαλέοισιν·	- uu- -- - -uu -uu--	dactylic hexameter	masculine penthemimeral, trithemimeral
οὐ γάρ οἱ ἠέλιος δείκνυ νομὸν ὁρμηθῆναι,	- u u -uu- -- uu ----	dactylic hexameter	masculine penthemimeral, hepthemimeral
ἀλλ’ ἐπὶ κυανέων ἀνδρῶν δῆμόν τε πόλιν τε	- uu -uu- -- -- u u- -	dactylic hexameter	masculine penthemimeral, hepthemimeral
στρωφᾶται, βράδιον δὲ Πανελλήνεσσι φαείνει.	--- uu- u u---u u--	dactylic hexameter	masculine penthemimeral, trithemimeral
καὶ τότε δὴ κεραοὶκαὶ νήκεροι ὑληκοῖται	- uu - uu-- -uu ----	dactylic hexameter	trithemimeral
λυγρὸν μυλιόωντες ἀνὰ δρία βησσήεντα,	-- -uu-u u- uu ----	dactylic hexameter	feminine penthemimeral, hepthemimeral
φεύγουσιν, καὶ πᾶσιν ἐνὶ φρεσὶ τοῦτο μέμηλεν,	--- - -u u- uu -u u--	dactylic hexameter	feminine penthemimeral, hepthemimeral, trithemimeral
οἷ σκέπα μαιόμενοιπυκινοὺς κευθμῶνας ἔχουσι	- uu -uu-uu- --u u--	dactylic hexameter	hepthemimeral
κὰκ γλάφυ πετρῆεν· τότε δὴ τρίποδι βροτοὶ ἶσοι,	- uu --- uu - uu- uu --	dactylic hexameter	masculine penthemimeral, hepthemimeral
οὗ τ’ἐπὶ νῶτα ἔαγε, κάρη δ’εἰς οὖδας ὁρᾶται·	- uu -u u-u u- - -u u--	dactylic hexameter	feminine penthemimeral, hepthemimeral
τῷ ἴκελοι φοιτῶσιν, ἀλευόμενοι νίφα λευκήν.	- uu- --u u-uu- uu --	dactylic hexameter	feminine penthemimeral, trithemimeral
καὶ τότε ἕσσασθαιἔρυμα χροός, ὥς σε κελεύω,	- uu ---uu- uu - u u--	dactylic hexameter	hepthemimeral
χλαῖνάν τε μαλακὴν καὶ τερμιόεντα χιτῶνα·	-- - uu- - -uu-u u--	dactylic hexameter	masculine penthemimeral, trithemimeral
στήμονι δ’ἐν παύρῳ πολλὴν κρόκα μηρύσασθαι·	-uu - -- -- uu ----	dactylic hexameter	masculine penthemimeral, hepthemimeral, trithemimeral
τὴν περιέσσασθαι,ἵνα τοι τρίχες ἀτρεμέωσι	- uu---uu - uu -uu--	dactylic hexameter	hepthemimeral
μηδ’ ὀρθαὶ φρίσσωσιν ἀειρόμεναι κατὰ σῶμα·	- -- --u u-uu- uu --	dactylic hexameter	feminine penthemimeral, trithemimeral
ἀμφὶ δὲ ποσσὶ πέδιλα βοὸς ἶφι κταμένοιο	-u u -u u-u u- -- uu--	dactylic hexameter	feminine penthemimeral, hepthemimeral
ἄρμενα δήσασθαι,πίλοις ἔντοσθε πυκάσσας·	-uu ----- --u u--	dactylic hexameter	hepthemimeral
πρωτογόνων δ’ἐρίφων, ὁπότ’ ἂν κρύος ὥριον ἔλθῃ,	-uu- uu- uu - uu -uu --	dactylic hexameter	masculine penthemimeral, hepthemimeral, trithemimeral
δέρματα συρράπτειννεύρῳ βοός, ὄφρ’ ἐπὶ νώτῳ	-uu ----- uu - uu --	dactylic hexameter	hepthemimeral
ὑετοῦ ἀμφιβάλῃ ἀλέην· κεφαλῆφι δ’ὕπερθεν	-uu -uu- uu- uu-u u--	dactylic hexameter	masculine penthemimeral, hepthemimeral
πῖλον ἔχειν ἀσκητόν, ἵν’ οὔατα μὴ καταδεύῃ.	-u u- --u u -uu - uu--	dactylic hexameter	feminine penthemimeral, trithemimeral
ψυχρὴ γάρ τ’ἠὼς πέλεται Βορέαο πεσόντος,	-- - -- uu- uu-u u--	dactylic hexameter	masculine penthemimeral, hepthemimeral, trithemimeral
ἠῷος δ’ἐπὶ γαῖαν ἀπ’ οὐρανοῦ ἀστερόεντος	--- uu -u u -uu -uu--	dactylic hexameter	feminine penthemimeral, trithemimeral
ἀὴρ πυροφόροιςτέταται μακάρων ἐπὶ ἔργοις,	-- -uu-uu- uu- uu --	dactylic hexameter	hepthemimeral
ὅς τε ἀρυσσάμενος ποταμῶν ἀπὸ αἰεναόντων,	- u u-uu- uu- uu -uu--	dactylic hexameter	masculine penthemimeral, hepthemimeral
ὑψοῦ ὑπὲρ γαίης ἀρθεὶς ἀνέμοιο θυέλλῃ,	-u u- -- -- uu-u u--	dactylic hexameter	masculine penthemimeral, hepthemimeral, trithemimeral
ἄλλοτε μέν θ’ὕειποτὶ ἕσπερον, ἄλλοτ’ ἄησι,	-uu - --uu -uu -u u--	dactylic hexameter	trithemimeral
πυκνὰ ΘρηϊκίουΒορέω νέφεα κλονέοντος.	-- -uu-uu- uu- uu--	dactylic hexameter	hepthemimeral
τὸν φθάμενος ἔργον τελέσας οἶκόνδε νέεσθαι,	- uu- -- uu- --u u--	dactylic hexameter	masculine penthemimeral, hepthemimeral, trithemimeral
μή ποτέ σ’οὐρανόθεν σκοτόεν νέφος ἀμφικαλύψῃ,	- uu -uu- uu- uu -uu--	dactylic hexameter	masculine penthemimeral, hepthemimeral
χρῶτα δὲ μυδαλέον θήῃ κατά θ’εἵματα δεύσῃ·	-u u -uu- -- uu -uu --	dactylic hexameter	masculine penthemimeral, hepthemimeral
ἀλλ’ ὑπαλεύασθαι·μεὶς γὰρ χαλεπώτατος οὗτος,	- uu---- - uu-uu --	dactylic hexameter	hepthemimeral
χειμέριος, χαλεπὸς προβάτοις, χαλεπὸς δ’ἀνθρώποις.	-uu- uu- uu- uu- ---	dactylic hexameter	masculine penthemimeral, hepthemimeral, trithemimeral
τῆμος τὤμισυ βουσίν, ἐπ’ ἀνέρι δὲ πλέον εἴη	-- -uu -u u -uu - uu --	dactylic hexameter	feminine penthemimeral
ἁρμαλιῆς· μακραὶγὰρ ἐπίρροθοι εὐφρόναι εἰσίν.	-uu- --u u-uu -uu --	dactylic hexameter	feminine penthemimeral, trithemimeral
ταῦτα φυλασσόμενος τετελεσμένον εἰς ἐνιαυτὸν	-u u-uu- uu-uu - uu--	dactylic hexameter	masculine penthemimeral
ἰσοῦσθαι νύκτας τε καὶ ἤματα, εἰς ὅ κεν αὖτις	--- -- u u -uu - u u --	dactylic hexameter	masculine penthemimeral, trithemimeral
γῆ πάντων μήτηρ καρπὸν σύμμικτον ἐνείκῃ.	- -- -- -- --u u--	dactylic hexameter	masculine penthemimeral, hepthemimeral, trithemimeral
εὖτ’ ἂν δ’ἑξήκοντα μετὰ τροπὰς ἠελίοιο	- - ---u u- uu -uu--	dactylic hexameter	feminine penthemimeral, hepthemimeral
χειμέρι’ ἐκτελέσῃ Ζεὺς ἤματα, δή ῥα τότ’ ἀστὴρ	-uu -uu- - -uu - u u --	dactylic hexameter	masculine penthemimeral
Ἀρκτοῦρος προλιπὼν ἱερὸν ῥόον Ὠκεανοῖο	--- uu- uu- uu -uu--	dactylic hexameter	masculine penthemimeral, hepthemimeral, trithemimeral
πρῶτον παμφαίνων ἐπιτέλλεται ἀκροκνέφαιος.	-- --- uu-uu -uu--	dactylic hexameter	masculine penthemimeral
τὸν δὲ μέτ’ ὀρθογόη Πανδιονὶς ὦρτο χελιδὼν	- u u -uu- --uu -u u--	dactylic hexameter	masculine penthemimeral
ἐς φάος ἀνθρώποιςἔαρος νέον ἱσταμένοιο·	- uu ---uu- uu -uu--	dactylic hexameter	hepthemimeral
τὴν φθάμενος οἴνας περιταμνέμεν· ὣς γὰρ ἄμεινον.	- uu- -- uu-uu - u u--	dactylic hexameter	masculine penthemimeral, trithemimeral
ἀλλ’ ὁπότ’ ἂν φερέοικος ἀπὸ χθονὸς ἂμ φυτὰ βαίνῃ	- uu - uu-u u- uu - uu --	dactylic hexameter	feminine penthemimeral, hepthemimeral, trithemimeral
Πληϊάδας φεύγων, τότε δὴ σκάφος οὐκέτι οἰνέων,	-uu- -- uu - uu -uu --	dactylic hexameter	masculine penthemimeral, hepthemimeral, trithemimeral
ἀλλ’ ἅρπας τε χαρασσέμεναι καὶ δμῶας ἐγείρειν·	- -- u u-uu- - -u u--	dactylic hexameter	hepthemimeral, trithemimeral
φεύγειν δὲ σκιεροὺςθώκους καὶ ἐπ’ ἠόα κοῖτον	-- - uu--- u u -uu --	dactylic hexameter	hepthemimeral, trithemimeral
ὥρῃ ἐν ἀμήτου,ὅτε τ’ἠέλιος χρόα κάρφει·	-u u ---uu -uu- uu --	dactylic hexameter	
τημοῦτος σπεύδεινκαὶ οἴκαδε καρπὸν ἀγινεῖν	--- --- -uu -u u--	dactylic hexameter	trithemimeral
ὄρθρου ἀνιστάμενος, ἵνα τοι βίος ἄρκιος εἴη.	-u u-uu- uu - uu -uu --	dactylic hexameter	masculine penthemimeral, hepthemimeral
ἠὼς γὰρ τ’ἔργοιο τρίτην ἀπομείρεται αἶσαν,	-- - --u u- uu-uu --	dactylic hexameter	feminine penthemimeral, hepthemimeral, trithemimeral
ἠώς τοι προφέρειμὲν ὁδοῦ, προφέρει δὲ καὶ ἔργου,	-- - uu-u u- uu- u u --	dactylic hexameter	feminine penthemimeral, hepthemimeral, trithemimeral
ἠώς, ἥ τε φανεῖσα πολέας ἐπέβησε κελεύθου	-- - u u-u u- uu-u u--	dactylic hexameter	feminine penthemimeral, hepthemimeral, trithemimeral
ἀνθρώπους πολλοῖσί τ’ ἐπὶ ζυγὰ βουσὶ τίθησιν.	--- --u u- uu -u u--	dactylic hexameter	feminine penthemimeral, hepthemimeral, trithemimeral
ἦμος δὲ σκόλυμός τ’ἀνθεῖ καὶ ἠχέτα τέττιξ	-- - uu- -- - -uu --	dactylic hexameter	masculine penthemimeral, hepthemimeral, trithemimeral
δενδρέῳ ἐφεζόμενος λιγυρὴν καταχεύετ’ ἀοιδὴν	-u u-uu- uu- uu-u u--	dactylic hexameter	masculine penthemimeral, hepthemimeral
πυκνὸν ὑπὸ πτερύγων, θέρεος καματώδεος ὥρῃ,	-u u- uu- uu- uu-uu --	dactylic hexameter	masculine penthemimeral, hepthemimeral, trithemimeral
τῆμος πιόταταί τ’αἶγες, καὶ οἶνος ἄριστος,	-- -uu- -- - -u u--	dactylic hexameter	masculine penthemimeral, hepthemimeral
μαχλόταται δὲ γυναῖκες, ἀφαυρότατοι δέ τοι ἄνδρες	-uu- u u-u u-uu- u u --	dactylic hexameter	feminine penthemimeral, trithemimeral
εἰσίν, ἐπεὶ κεφαλὴν καὶ γούνατα Σείριος ἄζει,	-u u- uu- - -uu -uu --	dactylic hexameter	masculine penthemimeral, trithemimeral
αὐαλέος δέ τε χρὼς ὑπὸ καύματος· ἀλλὰ τότ’ ἤδη	-uu- u u - uu -uu -u u --	dactylic hexameter	masculine penthemimeral, trithemimeral
εἴη πετραίη τε σκιὴ καὶ βίβλινος οἶνος	-- --- u u- - -uu --	dactylic hexameter	masculine penthemimeral, hepthemimeral
μάζα τ’ἀμολγαίη γάλα τ’αἰγῶν σβεννυμενάων	-u u--- uu -- -uu--	dactylic hexameter	masculine penthemimeral
καὶ βοὸς ὑλοφάγοιο κρέας μή πω τετοκυίης	- uu -uu-u u- - - uu--	dactylic hexameter	feminine penthemimeral, hepthemimeral
πρωτογόνων τ’ἐρίφων· ἐπὶ δ’αἴθοπα πινέμεν οἶνον,	-uu- uu- uu -uu -uu --	dactylic hexameter	masculine penthemimeral, trithemimeral
ἐν σκιῇ ἑζόμενον, κεκορημένον ἦτορ ἐδωδῆς,	- uu -uu- uu-uu -u u--	dactylic hexameter	masculine penthemimeral
ἀντίον ἀκραέοςΖεφύρου τρέψαντα πρόσωπα·	-uu ---uu- --u u--	dactylic hexameter	hepthemimeral
κρήνης δ’ἀενάου καὶ ἀπορρύτου ἥ τ’ἀθόλωτος	-- -uu- u u-uu - uu--	dactylic hexameter	masculine penthemimeral
τρὶς ὕδατος προχέειν,τὸ δὲ τέτρατον ἱέμεν οἴνου.	- uu- uu-u u -uu -uu --	dactylic hexameter	feminine penthemimeral, trithemimeral
δμωσὶ δ’ἐποτρύνειν Δημήτερος ἱερὸν ἀκτὴν	-u u--- --uu -uu --	dactylic hexameter	masculine penthemimeral
δινέμεν, εὖτ’ ἂν πρῶτα φανῇ σθένος Ὠρίωνος,	-uu - - -u u- uu ----	dactylic hexameter	feminine penthemimeral, hepthemimeral, trithemimeral
χώρῳ ἐν εὐαεῖ καὶ ἐϋτροχάλῳ ἐν ἀλωῇ.	-u u --- u u-uu- u u--	dactylic hexameter	masculine penthemimeral
μέτρῳ δ’εὖ κομίσασθαι ἐν ἄγγεσιν· αὐτὰρ ἐπὴν δὴ	-- - uu-u u -uu -u u- -	dactylic hexameter	feminine penthemimeral, trithemimeral
πάντα βίον κατάθηαι ἐπάρμενον ἔνδοθι οἴκου,	-u u- uu-u u-uu -uu --	dactylic hexameter	feminine penthemimeral, trithemimeral
θῆτά τ’ἄοικον ποιεῖσθαι καὶ ἄτεκνον ἔριθον	-u u-- --- u u-u u--	dactylic hexameter	hepthemimeral
δίζησθαι κέλομαι·χαλεπὴ δ’ὑπόπορτις ἔριθος·	--- uu-uu- uu-u u--	dactylic hexameter	hepthemimeral, trithemimeral
καὶ κύνα καρχαρόδοντα κομεῖν, μὴ φείδεο σίτου,	- uu -uu-u u- - -uu --	dactylic hexameter	feminine penthemimeral, hepthemimeral
μή ποτέ σ’ἡμερόκοιτος ἀνὴρ ἀπὸ χρήμαθ’ ἕληται.	- uu -uu-u u- uu -u u--	dactylic hexameter	feminine penthemimeral, hepthemimeral
χόρτον δ’ἐσκομίσαικαὶ συρφετόν, ὄφρα τοι εἴη	-- -uu-- -uu -u u --	dactylic hexameter	
βουσὶ καὶ ἡμιόνοισιν ἐπηετανόν. αὐτὰρ ἔπειτα	-u u -uu-u u-uu -u u--	dactylic hexameter	feminine penthemimeral
δμῶας ἀναψῦξαιφίλα γούνατα καὶ βόε λῦσαι.	-u u---uu -uu - uu --	dactylic hexameter	
εὖτ’ ἂν δ’Ὠρίων καὶ Σείριος ἐς μέσον ἔλθῃ	- - --- - -uu - uu --	dactylic hexameter	masculine penthemimeral
οὐρανόν, Ἀρκτοῦρον δὲ ἴδῃ ῥοδοδάκτυλος Ἠώς,	-uu --- u u- uu-uu --	dactylic hexameter	masculine penthemimeral, hepthemimeral
ὦ Πέρση, τότε πάντας ἀποδρέπεν οἴκαδε βότρυς,	- -- uu -u u-uu -uu --	dactylic hexameter	feminine penthemimeral, trithemimeral
δεῖξαι δ’ἠελίῳ δέκα τ’ἤματα καὶ δέκα νύκτας,	-- -uu- uu -uu - uu --	dactylic hexameter	masculine penthemimeral
πέντε δὲ συσκιάσαι,ἕκτῳ δ’εἰς ἄγγε’ ἀφύσσαι	-u u -uu--- - -u u--	dactylic hexameter	hepthemimeral
δῶρα Διωνύσουπολυγηθέος. αὐτὰρ ἐπὴν δὴ	-u u---uu-uu -u u- -	dactylic hexameter	
Πληϊάδες θ’Ὑάδες τε τό τε σθένος Ὠρίωνος	-uu- uu- u u - uu ----	dactylic hexameter	masculine penthemimeral, hepthemimeral, trithemimeral
δύνωσιν, τότ’ ἔπειτ’ἀρότου μεμνημένος εἶναι	--- u u-uu- --uu --	dactylic hexameter	hepthemimeral, trithemimeral
ὡραίου· πλειὼν δὲ κατὰ χθονὸς ἄρμενος εἴη.	--- -- u u- uu -uu --	dactylic hexameter	masculine penthemimeral, hepthemimeral, trithemimeral
εἰ δέ σε ναυτιλίης δυσπεμφέλου ἵμερος αἱρεῖ·	- u u -uu- --uu -uu --	dactylic hexameter	masculine penthemimeral
εὖτ’ ἂν Πληϊάδες σθένος ὄβριμον Ὠρίωνος	- - -uu- uu -uu ----	dactylic hexameter	masculine penthemimeral
φεύγουσαι πίπτωσιν ἐς ἠεροειδέα πόντον,	--- --u u -uu-uu --	dactylic hexameter	feminine penthemimeral, trithemimeral
δὴ τότε παντοίων ἀνέμων θυίουσιν ἀῆται·	- uu --- uu- --u u--	dactylic hexameter	masculine penthemimeral, hepthemimeral
καὶ τότε μηκέτι νῆα ἔχειν ἐνὶ οἴνοπι πόντῳ,	- uu -uu -u u- uu -uu --	dactylic hexameter	feminine penthemimeral, hepthemimeral
γῆν δ’ἐργάζεσθαι μεμνημένος ὥς σε κελεύω·	- ---- --uu - u u--	dactylic hexameter	masculine penthemimeral
νῆα δ’ἐπ’ ἠπείρουἐρύσαι πυκάσαι τε λίθοισι	-u u ---uu- uu- u u--	dactylic hexameter	hepthemimeral
πάντοθεν, ὄφρ’ ἴσχωσ’ ἀνέμων μένος ὑγρὸν ἀέντων,	-uu - -- uu- uu -u u--	dactylic hexameter	masculine penthemimeral, hepthemimeral, trithemimeral
χείμαρον ἐξερύσας, ἵνα μὴ πύθῃ Διὸς ὄμβρος.	-uu -uu- uu - -- uu --	dactylic hexameter	masculine penthemimeral, hepthemimeral
ὅπλα δ’ἐπάρμενα πάντα τεῷ ἐγκάτθεο οἴκῳ,	-u u-uu -u u- --uu --	dactylic hexameter	feminine penthemimeral, hepthemimeral
εὐκόσμως στολίσας νηὸς πτερὰ ποντοπόροιο·	--- uu- -- uu -uu--	dactylic hexameter	masculine penthemimeral, hepthemimeral, trithemimeral
πηδάλιον δ’εὐεργὲς ὑπὲρ καπνοῦ κρεμάσασθαι.	-uu- --u u- -- uu--	dactylic hexameter	feminine penthemimeral, hepthemimeral, trithemimeral
αὐτὸς δ’ὡραῖον μίμνειν πλόον εἰς ὅ κεν ἔλθῃ·	-- --- -- uu - u u --	dactylic hexameter	masculine penthemimeral, hepthemimeral
καὶ τότε νῆα θοὴν ἅλαδ’ ἑλκέμεν, ἐν δέ τε φόρτον	- uu -u u- uu -uu - u u --	dactylic hexameter	masculine penthemimeral
ἄρμενον ἐντύνασθαι, ἵν’ οἴκαδε κέρδος ἄρηαι,	-uu ---u u -uu -u u--	dactylic hexameter	feminine penthemimeral
ὥς περ ἐμός τε πατὴρ καὶ σός, μέγα νήπιε Πέρση,	- u u- u u- - - uu -uu --	dactylic hexameter	masculine penthemimeral, hepthemimeral, trithemimeral
πλωίζεσκ’ ἐν νηυσί, βίου κεχρημένος ἐσθλοῦ·	--- - -u u- --uu --	dactylic hexameter	feminine penthemimeral, hepthemimeral, trithemimeral
ὅς ποτε καὶ τεῖδ’ ἦλθε πολὺν διὰ πόντον ἀνύσσας,	- uu - - -u u- uu -u u--	dactylic hexameter	feminine penthemimeral, hepthemimeral, trithemimeral
Κύμην Αἰολίδα προλιπὼν ἐν νηὶ μελαίνῃ,	-- -uu- uu- - -u u--	dactylic hexameter	masculine penthemimeral, hepthemimeral
οὐκ ἄφενος φεύγων οὐδὲ πλοῦτόν τε καὶ ὄλβον,	- uu- -- -- -- u u --	dactylic hexameter	masculine penthemimeral, hepthemimeral, trithemimeral
ἀλλὰ κακὴν πενίην, τὴν Ζεὺς ἄνδρεσσι δίδωσιν.	-u u- uu- - - --u u--	dactylic hexameter	masculine penthemimeral, hepthemimeral, trithemimeral
νάσσατο δ’ἄγχ’ Ἑλικῶνος ὀϊζυρῇ ἐνὶ κώμῃ,	-uu - uu-u u--- uu --	dactylic hexameter	feminine penthemimeral, trithemimeral
Ἄσκρῃ, χεῖμα κακῇ, θέρει ἀργαλῇ, οὐδέ ποτ’ ἐσθλῇ.	-- -u u- uu -uu -u u --	dactylic hexameter	masculine penthemimeral
τύνη δ’,ὦ Πέρση, ἔργων μεμνημένος εἶναι	-- - -- -- --uu --	dactylic hexameter	masculine penthemimeral, hepthemimeral, trithemimeral
ὡραίων πάντων, περὶ ναυτιλίης δὲ μάλιστα.	--- -- uu -uu- u u--	dactylic hexameter	masculine penthemimeral, trithemimeral
νῆ’ ὀλίγην αἰνεῖν,μεγάλῃ δ’ἐνὶ φορτία θέσθαι·	- uu- --uu- uu -uu --	dactylic hexameter	hepthemimeral, trithemimeral
μείζων μὲν φόρτος, μεῖζον δ’ἐπὶ κέρδεϊ κέρδος	-- - -- -- uu -uu --	dactylic hexameter	masculine penthemimeral, hepthemimeral, trithemimeral
ἔσσεται, εἴ κ’ἄνεμοί γε κακὰς ἀπέχωσιν ἀήτας.	-uu - uu- u u- uu-u u--	dactylic hexameter	masculine penthemimeral, hepthemimeral, trithemimeral
εὖτ’ ἂν ἐπ’ ἐμπορίην τρέψας ἀεσίφρονα θυμὸν	- u u -uu- -- uu-uu --	dactylic hexameter	masculine penthemimeral, hepthemimeral
βούληαι χρέα τε προφυγεῖν καὶ λιμὸν ἀτερπέα,	--- uu - uu- - -u u--	dactylic hexameter	masculine penthemimeral, hepthemimeral, trithemimeral
δείξω δή τοι μέτρα πολυφλοίσβοιο θαλάσσης,	-- - - -u u---u u--	dactylic hexameter	feminine penthemimeral, trithemimeral
οὔτε τι ναυτιλίης σεσοφισμένος οὔτε τι νηῶν.	-u u -uu- uu-uu -u u --	dactylic hexameter	masculine penthemimeral
οὐ γάρ πώ ποτε νηὶ γ’ ἐπέπλων εὐρέα πόντον,	- - - uu -u u-- -uu --	dactylic hexameter	feminine penthemimeral, trithemimeral
εἰ μὴ ἐς Εὔβοιαν ἐξ Αὐλίδος, ᾗ ποτ’ Ἀχαιοὶ	- u u --- - -uu - u u--	dactylic hexameter	masculine penthemimeral
μείναντες χειμῶνα πολὺν σὺν λαὸν ἄγειραν	--- --u u- - -u u--	dactylic hexameter	feminine penthemimeral, hepthemimeral, trithemimeral
Ἑλλάδος ἐξ ἱερῆς Τροίην ἐς καλλιγύναικα.	-uu - uu- -- - -uu--	dactylic hexameter	masculine penthemimeral, hepthemimeral, trithemimeral
ἔνθα δ’ἐγὼν ἐπ’ ἄεθλα δαΐφρονος Ἀμφιδάμαντος	-u u- u u-u u-uu -uu--	dactylic hexameter	feminine penthemimeral, trithemimeral
Χαλκίδα τ’εἰσεπέρησα· τὰ δὲ προπεφραδμένα πολλὰ	-uu -uu-u u - uu-uu --	dactylic hexameter	feminine penthemimeral, hepthemimeral
ἄθλ’ ἔθεσαν παῖδες μεγαλήτορες· ἔνθα μέ φημι	- uu- -- uu-uu -u u --	dactylic hexameter	masculine penthemimeral, trithemimeral
ὕμνῳ νικήσαντα φέρειν τρίποδ’ ὠτώεντα.	-- ---u u- uu ----	dactylic hexameter	feminine penthemimeral, hepthemimeral
τὸν μὲν ἐγὼ Μούσῃσ’ Ἑλικωνιάδεσσ’ ἀνέθηκα	- u u- -- uu-uu- uu--	dactylic hexameter	masculine penthemimeral, trithemimeral
ἔνθα με τὸ πρῶτον λιγυρῆς ἐπέβησαν ἀοιδῆς.	-u u - -- uu- uu-u u--	dactylic hexameter	masculine penthemimeral, hepthemimeral, trithemimeral
τόσσον τοι νηῶν γε πεπείρημαι πολυγόμφων·	-- - -- u u--- uu--	dactylic hexameter	masculine penthemimeral, trithemimeral
ἀλλὰ καὶ ὣς ἐρέω Ζηνὸς νόον αἰγιόχοιο·	-u u - uu- -- uu -uu--	dactylic hexameter	masculine penthemimeral, hepthemimeral, trithemimeral
Μοῦσαι γάρ μ’ἐδίδαξαν ἀθέσφατον ὕμνον ἀείδειν.	-- - uu-u u-uu -u u--	dactylic hexameter	feminine penthemimeral, trithemimeral
ἤματα πεντήκοντα μετὰ τροπὰς ἠελίοιο,	-uu ---u u- uu -uu--	dactylic hexameter	feminine penthemimeral, hepthemimeral
ἐς τέλος ἐλθόντος θέρεος, καματώδεος ὥρης,	- uu --- uu- uu-uu --	dactylic hexameter	masculine penthemimeral, hepthemimeral
ὡραῖος πέλεταιθνητοῖς πλόος· οὔτε κε νῆα	--- uu--- uu -u u --	dactylic hexameter	hepthemimeral, trithemimeral
καυάξαις οὔτ’ ἄνδρας ἀποφθείσειε θάλασσα,	--- - -u u---u u--	dactylic hexameter	feminine penthemimeral, trithemimeral
εἰ δὴ μὴ πρόφρων γε Ποσειδάων ἐνοσίχθων	- - - -- u u--- uu--	dactylic hexameter	masculine penthemimeral, trithemimeral
ἢ Ζεὺς ἀθανάτων βασιλεὺς ἐθέλῃσιν ὀλέσσαι·	- - -uu- uu- uu-u u--	dactylic hexameter	masculine penthemimeral, hepthemimeral
ἐν τοῖς γὰρ τέλος ἐστὶν ὁμῶς ἀγαθῶν τε κακῶν τε.	- - - uu -u u- uu- u u- -	dactylic hexameter	feminine penthemimeral, hepthemimeral, trithemimeral
τῆμος δ’εὐκρινέεςτ’αὖραι καὶ πόντος ἀπήμων·	-- -uu--- - -u u--	dactylic hexameter	hepthemimeral
εὔκηλος τότε νῆα θοὴν ἀνέμοισι πιθήσας	--- uu -u u- uu-u u--	dactylic hexameter	feminine penthemimeral, hepthemimeral, trithemimeral
ἑλκέμεν ἐς πόντον φόρτον τ’ἐς πάντα τίθεσθαι·	-uu - -- -- - -u u--	dactylic hexameter	masculine penthemimeral, hepthemimeral, trithemimeral
σπεύδειν δ’ὅττι τάχιστα πάλιν οἶκόνδε νέεσθαι	-- -u u-u u- --u u--	dactylic hexameter	feminine penthemimeral, hepthemimeral
μηδὲ μένειν οἶνόν τε νέον καὶ ὀπωρινὸν ὄμβρον	-u u- -- u u- u u-uu --	dactylic hexameter	masculine penthemimeral, hepthemimeral, trithemimeral
καὶ χειμῶν’ ἐπιόντα Νότοιό τε δεινὰς ἀήτας,	- -- uu-u u-u u -u u--	dactylic hexameter	feminine penthemimeral, trithemimeral
ὅς τ’ὤρινε θάλασσαν ὁμαρτήσας Διὸς ὄμβρῳ	- --u u-u u--- uu --	dactylic hexameter	feminine penthemimeral
πολλῷ ὀπωρινῷ, χαλεπὸν δέ τε πόντον ἔθηκεν.	-u u--- uu- u u -u u--	dactylic hexameter	masculine penthemimeral, hepthemimeral
ἄλλος δ’εἰαρινὸς πέλεται πλόος ἀνθρώποισιν·	-- -uu- uu- uu ----	dactylic hexameter	masculine penthemimeral, hepthemimeral
ἦμος δὴ τὸ πρῶτον, ὅσον τ’ἐπιβᾶσα κορώνη	-- - - -u u- uu-u u--	dactylic hexameter	feminine penthemimeral, hepthemimeral, trithemimeral
ἴχνος ἐποίησεν, τόσσον πέταλ’ ἀνδρὶ φανήῃ	-u u--- -- uu -u u--	dactylic hexameter	masculine penthemimeral, hepthemimeral
ἐν κράδῃ ἀκροτάτῃ, τότε δ’ἄμβατός ἐστι θάλασσα·	- uu -uu- uu -uu -u u--	dactylic hexameter	masculine penthemimeral
εἰαρινὸς δ’οὗτος πέλεται πλόος· οὔ μιν ἔγωγε	-uu- -- uu- uu - u u--	dactylic hexameter	masculine penthemimeral, hepthemimeral, trithemimeral
αἴνημ’, οὐ γὰρ ἐμῷ θυμῷ κεχαρισμένος ἐστίν·	-- - u u- -- uu-uu --	dactylic hexameter	masculine penthemimeral, hepthemimeral, trithemimeral
ἁρπακτός· χαλεπῶς κε φύγοις κακόν· ἀλλά νυ καὶ τὰ	--- uu- u u- uu -u u - -	dactylic hexameter	masculine penthemimeral, hepthemimeral, trithemimeral
ἄνθρωποι ῥέζουσιν ἀϊδρείῃσι νόοιο·	--- --u u---u u--	dactylic hexameter	feminine penthemimeral, trithemimeral
χρήματα γὰρ ψυχὴ πέλεται δειλοῖσι βροτοῖσιν.	-uu - -- uu- --u u--	dactylic hexameter	masculine penthemimeral, hepthemimeral, trithemimeral
δεινὸν δ’ἐστὶ θανεῖνμετὰ κύμασιν· ἀλλά σ’ἄνωγα	-- -u u-uu -uu -u u--	dactylic hexameter	
φράζεσθαι τάδε πάντα μετὰ φρεσὶν ὡς ἀγορεύω.	--- uu -u u- uu - uu--	dactylic hexameter	feminine penthemimeral, hepthemimeral, trithemimeral
μηδ’ ἐν νηυσὶν ἅπαντα βίον κοίλῃσι τίθεσθαι,	- - -u u-u u- --u u--	dactylic hexameter	feminine penthemimeral, hepthemimeral
ἀλλὰ πλέω λείπειν,τὰ δὲ μείονα φορτίζεσθαι·	-u u- --u u -uu ----	dactylic hexameter	feminine penthemimeral, trithemimeral
δεινὸν γὰρ πόντουμετὰ κύμασι πήματι κύρσαι·	-- - --uu -uu -uu --	dactylic hexameter	trithemimeral
δεινὸν δ’εἴ κ’ἐπ’ ἄμαξαν ὑπέρβιον ἄχθος ἀείρας	-- - u u-u u-uu -u u--	dactylic hexameter	feminine penthemimeral, trithemimeral
ἄξονα καυάξαιςκαὶ φορτία μαυρωθείη.	-uu ---- -uu ----	dactylic hexameter	
μέτρα φυλάσσεσθαι·καιρὸς δ’ἐπὶ πᾶσιν ἄριστος.	-u u----- uu -u u--	dactylic hexameter	hepthemimeral
ὡραῖος δὲ γυναῖκα τεὸν ποτὶ οἶκον ἄγεσθαι,	--- u u-u u- uu -u u--	dactylic hexameter	feminine penthemimeral, hepthemimeral, trithemimeral
μήτε τριηκόντων ἐτέων μάλα πόλλ’ ἀπολείπων	-u u--- uu- uu - uu--	dactylic hexameter	masculine penthemimeral, hepthemimeral
μήτ’ ἐπιθεὶς μάλα πολλά· γάμος δέ τοι ὥριος οὗτος·	- uu- uu -u u- u u -uu --	dactylic hexameter	feminine penthemimeral, hepthemimeral, trithemimeral
ἡ δὲ γυνὴ τέτορ’ ἡβώοι, πέμπτῳ δὲ γαμοῖτο.	- u u- uu --- -- u u--	dactylic hexameter	hepthemimeral, trithemimeral
παρθενικὴν δὲ γαμεῖν,ὥς κ’ἤθεα κεδνὰ διδάξῃς,	-uu- u u-- -uu -u u--	dactylic hexameter	trithemimeral
τὴν δὲ μάλιστα γαμεῖν,ἥτις σέθεν ἐγγύθι ναίει	- u u-u u--- uu -uu --	dactylic hexameter	hepthemimeral
πάντα μάλ’ ἀμφὶς ἰδών, μὴ γείτοσι χάρματα γήμῃς.	-u u -u u- - -uu -uu --	dactylic hexameter	masculine penthemimeral
οὐ μὲν γάρ τι γυναικὸς ἀνὴρ ληΐζετ’ ἄμεινον	- - - u u-u u- --u u--	dactylic hexameter	feminine penthemimeral, hepthemimeral, trithemimeral
τῆς ἀγαθῆς, τῆς δ’αὖτε κακῆς οὐ ῥίγιον ἄλλο,	- uu- - -u u- - -uu --	dactylic hexameter	feminine penthemimeral, hepthemimeral, trithemimeral
δειπνολόχης, ἥ τ’ἄνδρα καὶ ἴφθιμόν περ ἐόντα	-uu- - -u u --- u u--	dactylic hexameter	feminine penthemimeral, trithemimeral
εὕει ἄτερ δαλοῖο καὶ ὠμῷ γήραϊ δῶκεν.	-u u- --u u -- -uu --	dactylic hexameter	feminine penthemimeral, trithemimeral
εὖ δ’ὄπιν ἀθανάτων μακάρων πεφυλαγμένος εἶναι.	- uu -uu- uu- uu-uu --	dactylic hexameter	masculine penthemimeral, hepthemimeral
μὴ δὲ κασιγνήτῳ ἶσον ποιεῖσθαι ἑταῖρον·	- u u--- -- --u u--	dactylic hexameter	masculine penthemimeral, hepthemimeral
εἰ δέ κε ποιήσῃς, μή μιν πρότερος κακὸν ἔρξαι	- u u --- - - uu- uu --	dactylic hexameter	masculine penthemimeral, hepthemimeral
μηδὲ ψεύδεσθαιγλώσσης χάριν· εἰ δέ σέ γ’ἄρχῃ	-- ----- uu - u u --	dactylic hexameter	hepthemimeral
ἤ τι ἔπος εἰπὼν ἀποθύμιον ἠὲ καὶ ἔρξας,	- u u- -- uu-uu -u u --	dactylic hexameter	masculine penthemimeral, trithemimeral
δὶς τόσα τείνυσθαιμεμνημένος· εἰ δέ κεν αὖτις	- uu -----uu - u u --	dactylic hexameter	
ἡγῆτ’ ἐς φιλότητα, δίκην δ’ἐθέλῃσι παρασχεῖν,	-- - uu-u u- uu-u u--	dactylic hexameter	feminine penthemimeral, hepthemimeral, trithemimeral
δέξασθαι· δειλός τοι ἀνὴρ φίλον ἄλλοτε ἄλλον	--- -- u u- uu -uu --	dactylic hexameter	masculine penthemimeral, hepthemimeral, trithemimeral
ποιεῖται· σὲ δὲ μή τι νόος κατελεγχέτω εἶδος.	--- u u - u u- uu-uu --	dactylic hexameter	masculine penthemimeral, hepthemimeral, trithemimeral
μηδὲ πολύξεινον μηδ’ ἄξεινον καλέεσθαι,	-u u--- - --- uu--	dactylic hexameter	masculine penthemimeral
μηδὲ κακῶν ἕταρον μηδ’ ἐσθλῶν νεικεστῆρα.	-u u- uu- - -- ----	dactylic hexameter	masculine penthemimeral, trithemimeral
μηδέ ποτ’ οὐλομένην πενίην θυμοφθόρον ἀνδρὶ	-u u -uu- uu- --uu --	dactylic hexameter	masculine penthemimeral, hepthemimeral
τέτλαθ’ ὀνειδίζειν,μακάρων δόσιν αἰὲν ἐόντων.	-u u---uu- uu -u u--	dactylic hexameter	hepthemimeral
γλώσσης τοι θησαυρὸς ἐν ἀνθρώποισιν ἄριστος	-- - --u u ---u u--	dactylic hexameter	feminine penthemimeral, trithemimeral
φειδωλῆς, πλείστη δὲ χάρις κατὰ μέτρον ἰούσης·	--- -- u u- uu -u u--	dactylic hexameter	masculine penthemimeral, hepthemimeral, trithemimeral
εἰ δὲ κακὸν εἴποις,τάχα κ’αὐτὸς μεῖζον ἀκούσαις.	- u u- --uu -- -u u--	dactylic hexameter	trithemimeral
μηδὲ πολυξείνουδαιτὸς δυσπέμφελος εἶναι·	-u u----- --uu --	dactylic hexameter	hepthemimeral
ἐκ κοινοῦ πλείστη τε χάρις δαπάνη τ’ὀλιγίστη.	- -- -- u u- uu- uu--	dactylic hexameter	masculine penthemimeral, hepthemimeral, trithemimeral
μηδέ ποτ’ ἐξ ἠοῦςΔιῒ λείβειν αἴθοπα οἶνον	-u u - --uu -- -uu --	dactylic hexameter	trithemimeral
χερσὶν ἀνίπτοισιν μηδ’ ἄλλοις ἀθανάτοισιν·	-u u--- - -- -uu--	dactylic hexameter	masculine penthemimeral
οὐ γὰρ τοί γε κλύουσιν, ἀποπτύουσι δέ τ’ἀράς.	- - - u u-u u---u u --	dactylic hexameter	feminine penthemimeral, trithemimeral
μηδ’ ἄντ’ ἠελίουτετραμμένος ὀρθὸς ὀμιχεῖν,	- - -uu---uu -u u--	dactylic hexameter	
αὐτὰρ ἐπεί κε δύῃ, μεμνημένος, ἔς τ’ἀνιόντα,	-u u- u u- --uu - uu--	dactylic hexameter	masculine penthemimeral, trithemimeral
μὴ δ’ἀπογυμνωθείς· μακάρων τοι νύκτες ἔασιν.	- uu--- uu- - -u u--	dactylic hexameter	masculine penthemimeral, hepthemimeral
μήτ’ ἐν ὁδῷ μήτ’ ἐκτὸς ὁδοῦ προβάδην οὐρήσῃς·	- u u- - -u u- uu- ---	dactylic hexameter	feminine penthemimeral, hepthemimeral, trithemimeral
ἑζόμενος δ’ὅ γε θεῖος ἀνήρ, πεπνυμένα εἰδώς,	-uu- u u -u u- --uu --	dactylic hexameter	feminine penthemimeral, hepthemimeral, trithemimeral
ἢ ὅ γε πρὸς τοῖχον πελάσας εὐερκέος αὐλῆς.	- u u - -- uu- --uu --	dactylic hexameter	masculine penthemimeral, hepthemimeral, trithemimeral
μηδ’ αἰδοῖα γονῇ πεπαλαγμένος ἔνδοθι οἴκου	- --u u- uu-uu -uu --	dactylic hexameter	masculine penthemimeral
ἱστίῃ ἐμπελαδὸν παραφαινέμεν, ἀλλ’ ἀλέασθαι.	-uu -uu- uu-uu - uu--	dactylic hexameter	masculine penthemimeral
μηδ’ ἀπὸ δυσφήμοιο τάφου ἀπονοστήσαντα	- uu ---u u- uu----	dactylic hexameter	feminine penthemimeral, hepthemimeral
σπερμαίνειν γενεήν, ἀλλ’ ἀθανάτων ἀπὸ δαιτός.	--- uu- - -uu- uu --	dactylic hexameter	masculine penthemimeral, trithemimeral
μηδ’ ἐπὶ κρηνάων οὐρεῖν, μάλα δ’ἐξαλέασθαι.	- uu --- -- uu -uu--	dactylic hexameter	masculine penthemimeral, hepthemimeral
μηδέ ποτ’ ἀενάων ποταμῶν καλλίρροον ὕδωρ	-u u -uu- uu- --uu --	dactylic hexameter	masculine penthemimeral, hepthemimeral
ποσσὶ περᾶν πρίν γ’εὔξῃ ἰδὼν ἐς καλὰ ῥέεθρα	-u u- - -u u- - -u u--	dactylic hexameter	feminine penthemimeral, hepthemimeral, trithemimeral
χεῖρας νιψάμενος πολυηράτῳ ὕδατι λευκῷ.	-- -uu- uu-uu -uu --	dactylic hexameter	masculine penthemimeral
ὃς ποταμὸν διαβῇ κακότητ’ ἰδὲ χεῖρας ἄνιπτος,	- uu- uu- uu- uu -u u--	dactylic hexameter	masculine penthemimeral, hepthemimeral, trithemimeral
τῷ δὲ θεοὶ νεμεσῶσι καὶ ἄλγεα δῶκαν ὀπίσσω.	- u u- uu-u u -uu -u u--	dactylic hexameter	feminine penthemimeral, trithemimeral
μηδ’ ἀπὸ πεντόζοιο θεῶν ἐν δαιτὶ θαλείῃ	- uu ---u u- - -u u--	dactylic hexameter	feminine penthemimeral, hepthemimeral
αὖον ἀπὸ χλωροῦτάμνειν αἴθωνι σιδήρῳ.	-u u- ---- --u u--	dactylic hexameter	hepthemimeral, trithemimeral
μηδέ ποτ’ οἰνοχόην τιθέμεν κρητῆρος ὕπερθεν	-u u -uu- uu- --u u--	dactylic hexameter	masculine penthemimeral, hepthemimeral
πινόντων· ὀλοὴ γὰρ ἐπ’ αὐτῷ μοῖρα τέτυκται.	--- uu- u u -- -u u--	dactylic hexameter	masculine penthemimeral, trithemimeral
μηδὲ δόμον ποιῶν ἀνεπίξεστον καταλείπειν,	-u u- -- uu--- uu--	dactylic hexameter	masculine penthemimeral, trithemimeral
μή τοι ἐφεζομένη κρώξῃ λακέρυζα κορώνη.	- u u-uu- -- uu-u u--	dactylic hexameter	masculine penthemimeral, hepthemimeral
μηδ’ ἀπὸ χυτροπόδων ἀνεπιρρέκτων ἀνελόντα	- uu -uu- uu--- uu--	dactylic hexameter	masculine penthemimeral
ἔσθειν μηδὲ λόεσθαι· ἐπεὶ καὶ τοῖς ἔπι ποινή.	-- -u u-u u- - - uu --	dactylic hexameter	feminine penthemimeral, hepthemimeral
μηδ’ ἐπ’ ἀκινήτοισι καθίζειν, οὐ γὰρ ἄμεινον,	- u u---u u-- - u u--	dactylic hexameter	feminine penthemimeral
παῖδα δυωδεκαταῖον, ὅ τ’ἀνέρ’ ἀνήνορα ποιεῖ,	-u u-uu-u u -u u-uu --	dactylic hexameter	feminine penthemimeral
μηδὲ δυωδεκάμηνον· ἴσον καὶ τοῦτο τέτυκται.	-u u-uu-u u- - -u u--	dactylic hexameter	feminine penthemimeral, hepthemimeral
μηδὲ γυναικείῳ λουτρῷ χρόα φαιδρύνεσθαι	-u u--- -- uu ----	dactylic hexameter	masculine penthemimeral, hepthemimeral
ἀνέρα· λευγαλέη γὰρ ἐπὶ χρόνον ἔστ’ ἐπὶ καὶ τῷ	-uu -uu- u u- uu - uu - -	dactylic hexameter	masculine penthemimeral, hepthemimeral
ποινή. μηδ’ ἱεροῖσιν ἐπ’ αἰθομένοισι κυρήσας	-- - uu-u u -uu-u u--	dactylic hexameter	feminine penthemimeral, trithemimeral
μωμεύειν ἀΐδηλα· θεός νύ τι καὶ τὰ νεμεσσᾷ.	--- uu-u u- u u - u u--	dactylic hexameter	feminine penthemimeral, hepthemimeral, trithemimeral
μηδέ ποτ’ ἐν προχοῇς ποταμῶν ἅλαδε προρεόντων	-u u - uu- uu- uu- uu--	dactylic hexameter	masculine penthemimeral, hepthemimeral, trithemimeral
μηδ’ ἐπὶ κρηνάων οὐρεῖν, μάλα δ’ἐξαλέασθαι·	- uu --- -- uu -uu--	dactylic hexameter	masculine penthemimeral, hepthemimeral
μηδ’ ἐναποψύχειν·τὸ γὰρ οὔ τοι λώιόν ἐστιν.	- uu---u u - - -uu --	dactylic hexameter	feminine penthemimeral, hepthemimeral
ὧδ’ ἔρδειν· δεινὴν δὲ βροτῶν ὑπαλεύεο φήμην·	- -- -- u u- uu-uu --	dactylic hexameter	masculine penthemimeral, hepthemimeral, trithemimeral
φήμη γάρ τε κακὴ πέλεται κούφη μὲν ἀεῖραι	-- - u u- uu- -- u u--	dactylic hexameter	masculine penthemimeral, hepthemimeral, trithemimeral
ῥεῖα μάλ’, ἀργαλέη δὲ φέρειν, χαλεπὴ δ’ἀποθέσθαι.	-u u -uu- u u- uu- uu--	dactylic hexameter	masculine penthemimeral, hepthemimeral
φήμη δ’οὔ τις πάμπαν ἀπόλλυται, ἥντινα πολλοὶ	-- - - -u u-uu -uu --	dactylic hexameter	feminine penthemimeral, trithemimeral
λαοὶ φημίξουσι· θεός νύ τίς ἐστι καὶ αὐτή.	-- ---u u- u u -u u --	dactylic hexameter	feminine penthemimeral, hepthemimeral
ἤματα δ’ἐκ Διόθεν πεφυλαγμένος εὖ κατὰ μοῖραν	-uu - uu- uu-uu - uu --	dactylic hexameter	masculine penthemimeral, trithemimeral
πεφραδέμεν δμώεσσι τριηκάδα μηνὸς ἀρίστην	-uu- --u u-uu -u u--	dactylic hexameter	feminine penthemimeral, trithemimeral
ἔργα τ’ἐποπτεύεινἠδ’ ἁρμαλιὴν δατέασθαι.	-u u---- -uu- uu--	dactylic hexameter	
αἵδε γὰρ ἡμέραι εἰσὶ Διὸς παρὰ μητιόεντος,	-u u -uu -u u- uu -uu--	dactylic hexameter	feminine penthemimeral, hepthemimeral
εὖτ’ ἂν ἀληθείην λαοὶ κρίνοντες ἄγωσιν·	- u u--- -- --u u--	dactylic hexameter	masculine penthemimeral, hepthemimeral
πρῶτον ἔνη τετράς τε καὶ ἑβδόμη ἱερὸν ἦμαρ·	-u u- -- u u -uu -uu --	dactylic hexameter	masculine penthemimeral, trithemimeral
τῇ γὰρ Ἀπόλλωνα χρυσάορα γείνατο Λητώ·	- u u--- --uu -uu --	dactylic hexameter	masculine penthemimeral
ὀγδοάτη δ’ἐνάτη τε δύω γε μὲν ἤματα μηνὸς	-uu- uu- u u- u u -uu --	dactylic hexameter	masculine penthemimeral, hepthemimeral, trithemimeral
ἔξοχ’ ἀεξομένοιο βροτήσια ἔργα πένεσθαι·	-u u-uu-u u-uu -u u--	dactylic hexameter	feminine penthemimeral
ἑνδεκάτη δὲ δυωδεκάτη τ’ἄμφω γε μὲν ἐσθλαὶ	-uu- u u-uu- -- u u --	dactylic hexameter	hepthemimeral, trithemimeral
ἠμὲν ὄϊς πείκεινἠδ’ εὔφρονα καρπὸν ἀμᾶσθαι·	-u u- --- -uu -u u--	dactylic hexameter	trithemimeral
ἡ δὲ δυωδεκάτη τῆς ἑνδεκάτης μέγ’ ἀμείνων·	- u u-uu- - -uu- u u--	dactylic hexameter	masculine penthemimeral
τῇ γάρ τοι νεῖ νήματ’ ἀερσιπότητος ἀράχνης	- - - - -u u-uu-u u--	dactylic hexameter	feminine penthemimeral, trithemimeral
ἤματος ἐκ πλείου,ὅτε τ’ἴδρις σωρὸν ἀμᾶται·	-uu - --uu -- -u u--	dactylic hexameter	trithemimeral
τῇ δ’ἱστὸν στήσαιτο γυνὴ προβάλοιτό τε ἔργον.	- -- --u u- uu-u u --	dactylic hexameter	feminine penthemimeral, hepthemimeral, trithemimeral
μηνὸς δ’ἱσταμένου τρεισκαιδεκάτην ἀλέασθαι	-- -uu- --uu- uu--	dactylic hexameter	masculine penthemimeral
σπέρματος ἄρξασθαι·φυτὰ δ’ἐνθρέψασθαι ἀρίστη.	-uu ---uu ---u u--	dactylic hexameter	
ἕκτη δ’ἡ μέσση μάλ’ ἀσύμφορός ἐστι φυτοῖσιν,	-- - -- u u-uu -u u--	dactylic hexameter	masculine penthemimeral, trithemimeral
ἀνδρογόνος δ’ἀγαθή· κούρῃ δ’οὐ σύμφορός ἐστιν	-uu- uu- -- - -uu --	dactylic hexameter	masculine penthemimeral, hepthemimeral, trithemimeral
οὔτε γενέσθαι πρῶτ’ οὔτ’ ἂρ γάμου ἀντιβολῆσαι.	-u u-- - - - uu -uu--	dactylic hexameter	masculine penthemimeral, hepthemimeral
οὐδὲ μὲν ἡ πρώτη ἕκτη κούρῃ γε γενέσθαι	-u u - -- -- -- u u--	dactylic hexameter	masculine penthemimeral, hepthemimeral, trithemimeral
ἄρμενος, ἀλλ’ ἐρίφουςτάμνειν καὶ πώεα μήλων,	-uu - uu--- - -uu --	dactylic hexameter	hepthemimeral, trithemimeral
σηκόν τ’ἀμφιβαλεῖν ποιμνήϊον ἤπιον ἦμαρ·	-- -uu- --uu -uu --	dactylic hexameter	masculine penthemimeral
ἐσθλὴ δ’ἀνδρογόνος· φιλέοι δ’ὅ γε κέρτομα βάζειν	-- -uu- uu- u u -uu --	dactylic hexameter	masculine penthemimeral, hepthemimeral
ψεύδεά θ’αἱμυλίους τε λόγους κρυφίους τ’ὀαρισμούς.	-uu -uu- u u- uu- uu--	dactylic hexameter	masculine penthemimeral, hepthemimeral
μηνὸς δ’ὀγδοάτῃ κάπρον καὶ βοῦν ἐρίμυκον	-- -uu- -- - - uu--	dactylic hexameter	masculine penthemimeral, hepthemimeral
ταμνέμεν, οὐρῆας δὲ δυωδεκάτῃ ταλαεργούς.	-uu --- u u-uu- uu--	dactylic hexameter	masculine penthemimeral
εἰκάδι δ’ἐν μεγάλῃ, πλέῳ ἤματι, ἵστορα φῶτα	-uu - uu- uu -uu -uu --	dactylic hexameter	masculine penthemimeral, trithemimeral
γείνασθαι· μάλα γάρ τε νόον πεπυκασμένος ἔσται.	--- uu - u u- uu-uu --	dactylic hexameter	masculine penthemimeral, hepthemimeral, trithemimeral
ἐσθλὴ δ’ἀνδρογόνος δεκάτη, κούρῃ δέ τε τετρὰς	-- -uu- uu- -- u u --	dactylic hexameter	masculine penthemimeral, hepthemimeral
μέσση· τῇ δέ τε μῆλα καὶ εἰλίποδας ἕλικας βοῦς	-- - u u -u u -uu- uu- -	dactylic hexameter	feminine penthemimeral, trithemimeral
καὶ κύνα καρχαρόδοντα καὶ οὐρῆας ταλαεργοὺς	- uu -uu-u u --- uu--	dactylic hexameter	feminine penthemimeral
πρηΰνειν ἐπὶ χεῖρα τιθείς· πεφύλαξο δὲ θυμῷ	--- uu -u u- uu-u u --	dactylic hexameter	feminine penthemimeral, hepthemimeral, trithemimeral
τετράδ’ ἀλεύασθαιφθίνοντός θ’ἱσταμένου τε	-u u------ -uu- -	dactylic hexameter	
ἄλγεα· θυμοβορεῖνμάλα τοι τετελεσμένον ἦμαρ.	-uu -uu-uu - uu-uu --	dactylic hexameter	hepthemimeral
ἐν δὲ τετάρτῃ μηνὸς ἄγεσθ’ εἰς οἶκον ἄκοιτιν	- u u-- -u u- - -u u--	dactylic hexameter	feminine penthemimeral, hepthemimeral
οἰωνοὺς κρίνας οἳ ἐπ’ ἔργματι τούτῳ ἄριστοι.	--- -- u u -uu -u u--	dactylic hexameter	masculine penthemimeral, trithemimeral
πέμπτας δ’ἐξαλέασθαι, ἐπεὶ χαλεπαί τε καὶ αἰναί·	-- -uu-u u- uu- u u --	dactylic hexameter	feminine penthemimeral, hepthemimeral
ἐν πέμπτῃ γάρ φασιν Ἐρινύας ἀμφιπολεύειν	- -- - -u u-uu -uu--	dactylic hexameter	feminine penthemimeral, trithemimeral
ὅρκον γεινόμενον, τὸν Ἔρις τέκε πῆμ’ ἐπιόρκοις.	-- -uu- u u- uu - uu--	dactylic hexameter	masculine penthemimeral, hepthemimeral
μέσσῃ δ’ἑβδομάτῃ Δημήτερος ἱερὸν ἀκτὴν	-- -uu- --uu -uu --	dactylic hexameter	masculine penthemimeral
εὖ μάλ’ ὀπιπεύοντα ἐϋτροχάλῳ ἐν ἀλωῇ	- u u---u u-uu- u u--	dactylic hexameter	feminine penthemimeral
βάλλειν, ὑλοτόμον τε ταμεῖν θαλαμήϊα δοῦρα	-- -uu- u u- uu-uu --	dactylic hexameter	masculine penthemimeral, hepthemimeral
νήϊά τε ξύλα πολλά, τά τ’ἄρμενα νηυσὶ πέλονται.	-uu - uu -u u -uu -u u--	dactylic hexameter	feminine penthemimeral, trithemimeral
τετράδι δ’ἄρχεσθαινῆας πήγνυσθαι ἀραιάς.	-uu ----- --u u--	dactylic hexameter	hepthemimeral
εἰνὰς δ’ἡ μέσση ἐπὶ δείελα λώιον ἦμαρ·	-- - -- uu -uu -uu --	dactylic hexameter	masculine penthemimeral, trithemimeral
πρωτίστη δ’εἰνὰς παναπήμων ἀνθρώποισιν·	--- -- uu-- ----	dactylic hexameter	masculine penthemimeral, trithemimeral
ἐσθλὴ μὲν γάρ θ’ἥ γε φυτευέμεν ἠδὲ γενέσθαι	-- - - - u u-uu -u u--	dactylic hexameter	masculine penthemimeral, trithemimeral
ἀνέρι τ’ἠδὲ γυναικί, καὶ οὔποτε πάγκακον ἦμαρ.	-uu -u u-u u -uu -uu --	dactylic hexameter	feminine penthemimeral
παῦροι δ’αὖτε ἴσασι τρισεινάδα μηνὸς ἀρίστην	-- -u u-u u-uu -u u--	dactylic hexameter	feminine penthemimeral
ἄρξασθαί τε πίθου καὶ ἐπὶ ζυγὸν αὐχένι θεῖναι	--- u u- u u- uu -uu --	dactylic hexameter	masculine penthemimeral, hepthemimeral, trithemimeral
βουσὶ καὶ ἡμιόνοισι καὶ ἵπποις ὠκυπόδεσσι,	-u u -uu-u u -- -uu--	dactylic hexameter	feminine penthemimeral
νῆα πολυκλήϊδα θοὴν εἰς οἴνοπα πόντον	-u u---u u- - -uu --	dactylic hexameter	feminine penthemimeral, hepthemimeral
εἰρύμεναι· παῦροιδέ τ’ἀληθέα κικλήσκουσιν.	-uu- --u u-uu ----	dactylic hexameter	feminine penthemimeral, trithemimeral
τετράδι δ’οἶγε πίθον· περὶ πάντων ἱερὸν ἦμαρ	-uu -u u- uu -- -uu --	dactylic hexameter	masculine penthemimeral
μέσση· παῦροι δ’αὖτε μετ’ εἰκάδα μηνὸς ἀρίστην	-- -- -u u -uu -u u--	dactylic hexameter	feminine penthemimeral
ἠοῦς γεινομένης· ἐπὶ δείελα δ’ἐστὶ χερείων.	-- -uu- uu -uu -u u--	dactylic hexameter	masculine penthemimeral
αἵδε μὲν ἡμέραι εἰσὶν ἐπιχθονίοις μέγ’ ὄνειαρ·	-u u -uu -u u-uu- u u--	dactylic hexameter	feminine penthemimeral
αἱ δ’ἄλλαι μετάδουποι, ἀκήριοι, οὔ τι φέρουσαι.	- -- uu-u u-uu - u u--	dactylic hexameter	feminine penthemimeral, trithemimeral
ἄλλος δ’ἀλλοίην αἰνεῖ, παῦροι δὲ ἴσασιν.	-- --- -- -- u u--	dactylic hexameter	masculine penthemimeral, hepthemimeral
ἄλλοτε μητρυιὴ πέλει ἡμέρη, ἄλλοτε μήτηρ.	-uu --- uu -uu -uu --	dactylic hexameter	masculine penthemimeral
τάων εὐδαίμων τε καὶ ὄλβιος ὃς τάδε πάντα	-- --- u u -uu - uu --	dactylic hexameter	masculine penthemimeral
εἰδὼς ἐργάζηται ἀναίτιος ἀθανάτοισιν,	-- ---u u-uu -uu--	dactylic hexameter	feminine penthemimeral
ὄρνιθας κρίνων καὶ ὑπερβασίας ἀλεείνων.	--- -- u u-uu- uu--	dactylic hexameter	masculine penthemimeral, trithemimeral
